Bowler,Team,BowlType,Start Date,Ground,Host Country,year,Inn,Runs,Balls,Wickets,Matches,Runs_grouped,Balls_grouped,Wickets_grouped,run_diff,ball_diff,wickets_diff,AveforWicket,AveWicket,Home,HomeorAway,Period
A Athanaze,WI,Spin,2023-07-12,Roseau,West Indies,2023,1,53,96,1,1,411,1014,20,358,918,19,20.55,<=30,WI,Home,After 1965
A Athanaze,WI,Spin,2023-07-20,Port of Spain,West Indies,2023,1,12,24,0,1,279,750,9,267,726,9,31.0,>30,WI,Home,After 1965
A Athanaze,WI,Spin,2024-08-07,Port of Spain,West Indies,2024,1,5,6,0,1,492,926,15,487,920,15,32.8,>30,WI,Home,After 1965
A Athanaze,WI,Spin,2024-11-22,North Sound,West Indies,2024,1,9,30,0,1,296,631,6,287,601,6,49.333333333333336,>30,WI,Home,After 1965
A Balbirnie,IRE,Spin,2019-03-15,Dehradun,India,2019,1,8,6,0,1,656,1295,22,648,1289,22,29.818181818181817,<=30,IND,Away,After 1965
A Brown,ENG,Pace,1961-10-21,Lahore,Pakistan,1961,2,71,179,3,1,400,1080,13,329,901,10,30.76923076923077,>30,PAK,Away,Upto 2014
A Brown,ENG,Pace,1961-11-11,Brabourne,India,1961,2,79,144,0,1,444,942,9,365,798,9,49.333333333333336,>30,IND,Away,Upto 2014
A Coningham,AUS,Pace,1894-12-29,Melbourne,Australia,1894,2,76,186,2,1,653,1784,28,577,1598,26,23.321428571428573,<=30,AUS,Home,After 1965
A Cotter,AUS,Pace,1904-02-26,Sydney,Australia,1904,2,85,195,3,1,327,845,17,242,650,14,19.235294117647058,<=30,AUS,Home,Upto 2014
A Cotter,AUS,Pace,1904-03-05,Melbourne,Australia,1904,2,65,122,8,1,250,529,16,185,407,8,15.625,<=30,AUS,Home,Upto 2014
A Cotter,AUS,Pace,1905-05-29,Nottingham,England,1905,2,123,240,4,1,577,1196,21,454,956,17,27.476190476190474,<=30,ENG,Away,Upto 2014
A Cotter,AUS,Pace,1905-07-24,Manchester,England,1905,1,83,156,0,1,572,1050,20,489,894,20,28.6,<=30,ENG,Away,Upto 2014
A Cotter,AUS,Pace,1905-08-14,The Oval,England,1905,2,221,366,9,1,775,1333,24,554,967,15,32.291666666666664,>30,ENG,Away,Upto 2014
A Cotter,AUS,Pace,1907-12-13,Sydney,Australia,1907,2,202,287,8,1,509,946,20,307,659,12,25.45,<=30,AUS,Home,Upto 2014
A Cotter,AUS,Pace,1908-01-01,Melbourne,Australia,1908,2,224,366,6,1,477,963,14,253,597,8,34.07142857142857,>30,AUS,Home,Upto 2014
A Cotter,AUS,Pace,1909-06-14,Lord's,England,1909,2,115,246,4,1,465,1001,12,350,755,8,38.75,>30,ENG,Away,Upto 2014
A Cotter,AUS,Pace,1909-07-01,Leeds,England,1909,2,83,198,6,1,393,1142,20,310,944,14,19.65,<=30,ENG,Away,Upto 2014
A Cotter,AUS,Pace,1909-07-26,Manchester,England,1909,2,51,78,1,1,310,803,19,259,725,18,16.31578947368421,<=30,ENG,Away,Upto 2014
A Cotter,AUS,Pace,1909-08-09,The Oval,England,1909,2,116,214,6,1,457,871,15,341,657,9,30.466666666666665,>30,ENG,Away,Upto 2014
A Cotter,AUS,Pace,1910-12-09,Sydney,Australia,1910,2,142,222,8,1,517,899,22,375,677,14,23.5,<=30,AUS,Home,Upto 2014
A Cotter,AUS,Pace,1910-12-31,Melbourne,Australia,1910,2,205,348,6,1,540,1002,17,335,654,11,31.764705882352942,>30,AUS,Home,Upto 2014
A Cotter,AUS,Pace,1911-01-07,Adelaide,Australia,1911,2,164,366,2,1,771,1501,18,607,1135,16,42.833333333333336,>30,AUS,Home,Upto 2014
A Cotter,AUS,Pace,1911-02-17,Melbourne,Australia,1911,2,38,77,4,1,399,623,10,361,546,6,39.9,>30,AUS,Home,Upto 2014
A Cotter,AUS,Pace,1911-03-03,Sydney,Australia,1911,2,84,156,2,1,447,806,13,363,650,11,34.38461538461539,>30,AUS,Home,Upto 2014
A Cotter,AUS,Pace,1911-12-15,Sydney,Australia,1911,2,159,276,3,1,824,1814,23,665,1538,20,35.82608695652174,>30,AUS,Home,Upto 2014
A Cotter,AUS,Pace,1911-12-30,Melbourne,Australia,1911,2,118,210,5,1,685,1483,24,567,1273,19,28.541666666666668,<=30,AUS,Home,Upto 2014
A Cotter,AUS,Pace,1912-01-12,Adelaide,Australia,1912,2,146,288,4,1,730,1756,27,584,1468,23,27.037037037037038,<=30,AUS,Home,Upto 2014
A Cotter,AUS,Pace,1912-02-09,Melbourne,Australia,1912,1,125,222,0,1,546,1146,23,421,924,23,23.73913043478261,<=30,AUS,Home,Upto 2014
A Coxon,ENG,Pace,1948-06-24,Lord's,England,1948,2,172,378,3,1,703,1601,26,531,1223,23,27.03846153846154,<=30,ENG,Home,Upto 2014
A D'Souza,PAK,Spin,1959-02-20,Karachi,Pakistan,1959,2,78,162,2,1,375,1262,15,297,1100,13,25.0,<=30,PAK,Home,Upto 2014
A D'Souza,PAK,Spin,1962-01-19,Dhaka,Bangladesh,1962,1,94,276,4,1,862,2494,25,768,2218,21,34.48,>30,BAN,Away,Upto 2014
A D'Souza,PAK,Spin,1962-02-02,Karachi,Pakistan,1962,1,112,347,5,1,769,2063,17,657,1716,12,45.23529411764706,>30,PAK,Home,Upto 2014
A D'Souza,PAK,Spin,1962-05-31,Birmingham,England,1962,1,161,276,1,1,664,1386,13,503,1110,12,51.07692307692308,>30,ENG,Away,Upto 2014
A D'Souza,PAK,Spin,1962-06-21,Lord's,England,1962,2,176,256,3,1,359,496,6,183,240,3,59.833333333333336,>30,ENG,Away,Upto 2014
A D'Souza,PAK,Spin,1962-08-16,The Oval,England,1962,2,124,270,2,1,452,1071,6,328,801,4,75.33333333333333,>30,ENG,Away,Upto 2014
A Dananjaya,SL,Spin,2018-02-08,Mirpur,Bangladesh,2018,2,44,90,8,1,561,1029,30,517,939,22,18.7,<=30,BAN,Away,After 1965
A Dananjaya,SL,Spin,2018-06-14,Gros Islet,West Indies,2018,2,114,264,2,1,246,492,2,132,228,0,123.0,>30,WI,Away,After 1965
A Dananjaya,SL,Spin,2018-07-20,Colombo (SSC),Sri Lanka,2018,2,119,192,7,1,722,1323,32,603,1131,25,22.5625,<=30,SL,Home,After 1965
A Dananjaya,SL,Spin,2018-11-06,Galle,Sri Lanka,2018,2,183,233,2,1,876,1627,28,693,1394,26,31.285714285714285,>30,SL,Home,After 1965
A Dananjaya,SL,Spin,2018-11-14,Pallekele,Sri Lanka,2018,2,195,234,8,1,1031,1760,38,836,1526,30,27.13157894736842,<=30,SL,Home,After 1965
A Dananjaya,SL,Spin,2019-08-14,Galle,Sri Lanka,2019,2,164,372,6,1,786,1622,23,622,1250,17,34.17391304347826,>30,SL,Home,After 1965
A Fielder,ENG,Pace,1904-01-15,Adelaide,Australia,1904,2,84,192,1,1,683,1465,19,599,1273,18,35.94736842105263,>30,AUS,Away,Upto 2014
A Fielder,ENG,Pace,1907-12-13,Sydney,Australia,1907,2,170,347,9,1,509,946,20,339,599,11,25.45,<=30,AUS,Away,Upto 2014
A Fielder,ENG,Pace,1908-01-01,Melbourne,Australia,1908,2,151,329,3,1,477,963,14,326,634,11,34.07142857142857,>30,AUS,Away,Upto 2014
A Fielder,ENG,Pace,1908-01-10,Adelaide,Australia,1908,2,161,305,5,1,493,1139,20,332,834,15,24.65,<=30,AUS,Away,Upto 2014
A Fielder,ENG,Pace,1908-02-07,Melbourne,Australia,1908,2,145,318,8,1,373,840,14,228,522,6,26.642857142857142,<=30,AUS,Away,Upto 2014
A Flintoff,ENG,Pace,1998-07-23,Nottingham,England,1998,2,68,138,1,1,995,2152,32,927,2014,31,31.09375,>30,ENG,Home,Upto 2014
A Flintoff,ENG,Pace,1998-08-06,Leeds,England,1998,2,44,72,0,1,826,2084,40,782,2012,40,20.65,<=30,ENG,Home,Upto 2014
A Flintoff,ENG,Pace,1999-11-25,Johannesburg,South Africa,1999,1,45,84,0,1,668,1442,28,623,1358,28,23.857142857142858,<=30,SA,Away,Upto 2014
A Flintoff,ENG,Pace,1999-12-09,Gqeberha,South Africa,1999,2,55,95,3,1,939,2119,25,884,2024,22,37.56,>30,SA,Away,Upto 2014
A Flintoff,ENG,Pace,1999-12-26,Durban,South Africa,1999,2,74,198,2,1,784,1865,22,710,1667,20,35.63636363636363,>30,SA,Away,Upto 2014
A Flintoff,ENG,Pace,2000-01-02,Cape Town,South Africa,2000,1,16,24,0,1,594,1440,24,578,1416,24,24.75,<=30,SA,Away,Upto 2014
A Flintoff,ENG,Pace,2000-05-18,Lord's,England,2000,1,2,18,0,1,527,1078,29,525,1060,29,18.17241379310345,<=30,ENG,Home,Upto 2014
A Flintoff,ENG,Pace,2000-06-01,Nottingham,England,2000,1,33,60,0,1,655,1521,23,622,1461,23,28.47826086956522,<=30,ENG,Home,Upto 2014
A Flintoff,ENG,Pace,2000-06-15,Birmingham,England,2000,1,48,138,1,1,606,1373,25,558,1235,24,24.24,<=30,ENG,Home,Upto 2014
A Flintoff,ENG,Pace,2001-12-03,Mohali,India,2001,1,80,204,0,1,398,794,9,318,590,9,44.22222222222222,>30,IND,Away,Upto 2014
A Flintoff,ENG,Pace,2001-12-11,Ahmedabad,India,2001,2,59,180,2,1,368,804,6,309,624,4,61.333333333333336,>30,IND,Away,Upto 2014
A Flintoff,ENG,Pace,2001-12-19,Bengaluru,India,2001,1,50,168,4,1,273,609,12,223,441,8,22.75,<=30,IND,Away,Upto 2014
A Flintoff,ENG,Pace,2002-03-13,Christchurch,New Zealand,2002,2,123,168,2,1,1052,1583,35,929,1415,33,30.057142857142857,>30,NZ,Away,Upto 2014
A Flintoff,ENG,Pace,2002-03-21,Wellington,New Zealand,2002,2,33,156,1,1,587,1212,18,554,1056,17,32.611111111111114,>30,NZ,Away,Upto 2014
A Flintoff,ENG,Pace,2002-03-30,Auckland,New Zealand,2002,2,157,234,6,1,809,1459,39,652,1225,33,20.743589743589745,<=30,NZ,Away,Upto 2014
A Flintoff,ENG,Pace,2002-05-16,Lord's,England,2002,2,119,264,2,1,1188,2251,20,1069,1987,18,59.4,>30,ENG,Home,Upto 2014
A Flintoff,ENG,Pace,2002-05-30,Birmingham,England,2002,2,50,66,2,1,687,1192,22,637,1126,20,31.227272727272727,>30,ENG,Home,Upto 2014
A Flintoff,ENG,Pace,2002-06-13,Manchester,England,2002,2,143,312,2,1,775,1409,20,632,1097,18,38.75,>30,ENG,Home,Upto 2014
A Flintoff,ENG,Pace,2002-07-25,Lord's,England,2002,2,109,216,2,1,837,1449,22,728,1233,20,38.04545454545455,>30,ENG,Home,Upto 2014
A Flintoff,ENG,Pace,2002-08-08,Nottingham,England,2002,2,180,294,2,1,996,1602,22,816,1308,20,45.27272727272727,>30,ENG,Home,Upto 2014
A Flintoff,ENG,Pace,2002-08-22,Leeds,England,2002,1,68,162,1,1,769,1387,15,701,1225,14,51.266666666666666,>30,ENG,Home,Upto 2014
A Flintoff,ENG,Pace,2003-07-24,Birmingham,England,2003,2,113,162,0,1,873,1408,14,760,1246,14,62.357142857142854,>30,ENG,Home,Upto 2014
A Flintoff,ENG,Pace,2003-07-31,Lord's,England,2003,1,115,240,1,1,967,1600,24,852,1360,23,40.291666666666664,>30,ENG,Home,Upto 2014
A Flintoff,ENG,Pace,2003-08-14,Nottingham,England,2003,2,145,300,3,1,935,1991,38,790,1691,35,24.605263157894736,<=30,ENG,Home,Upto 2014
A Flintoff,ENG,Pace,2003-08-21,Leeds,England,2003,2,118,240,4,1,1130,2145,39,1012,1905,35,28.974358974358974,<=30,ENG,Home,Upto 2014
A Flintoff,ENG,Pace,2003-09-04,The Oval,England,2003,2,101,150,2,1,1075,1870,24,974,1720,22,44.791666666666664,>30,ENG,Home,Upto 2014
A Flintoff,ENG,Pace,2003-12-02,Galle,Sri Lanka,2003,2,74,240,4,1,348,780,10,274,540,6,34.8,>30,SL,Away,Upto 2014
A Flintoff,ENG,Pace,2003-12-10,Kandy,Sri Lanka,2003,2,100,234,3,1,489,1010,13,389,776,10,37.61538461538461,>30,SL,Away,Upto 2014
A Flintoff,ENG,Pace,2003-12-18,Colombo (SSC),Sri Lanka,2003,1,47,108,2,1,444,738,12,397,630,10,37.0,>30,SL,Away,Upto 2014
A Flintoff,ENG,Pace,2004-03-11,Kingston,West Indies,2004,1,45,96,1,1,561,1123,25,516,1027,24,22.44,<=30,WI,Away,Upto 2014
A Flintoff,ENG,Pace,2004-03-19,Port of Spain,West Indies,2004,2,65,132,2,1,720,1489,29,655,1357,27,24.82758620689655,<=30,WI,Away,Upto 2014
A Flintoff,ENG,Pace,2004-04-01,Bridgetown,West Indies,2004,2,78,176,7,1,550,1209,31,472,1033,24,17.741935483870968,<=30,WI,Away,Upto 2014
A Flintoff,ENG,Pace,2004-04-10,St John's,West Indies,2004,1,109,210,1,1,955,1635,13,846,1425,12,73.46153846153847,>30,WI,Away,Upto 2014
A Flintoff,ENG,Pace,2004-05-20,Lord's,England,2004,2,103,227,3,1,1118,2072,26,1015,1845,23,43.0,>30,ENG,Home,Upto 2014
A Flintoff,ENG,Pace,2004-06-03,Leeds,England,2004,2,80,198,3,1,915,1695,27,835,1497,24,33.888888888888886,>30,ENG,Home,Upto 2014
A Flintoff,ENG,Pace,2004-06-10,Nottingham,England,2004,2,108,204,4,1,1015,1836,30,907,1632,26,33.833333333333336,>30,ENG,Home,Upto 2014
A Flintoff,ENG,Pace,2004-07-22,Lord's,England,2004,2,25,69,4,1,966,1493,22,941,1424,18,43.90909090909091,>30,ENG,Home,Upto 2014
A Flintoff,ENG,Pace,2004-07-29,Birmingham,England,2004,2,71,120,2,1,971,1389,23,900,1269,21,42.21739130434783,>30,ENG,Home,Upto 2014
A Flintoff,ENG,Pace,2004-08-12,Manchester,England,2004,2,105,192,6,1,785,1467,28,680,1275,22,28.035714285714285,<=30,ENG,Home,Upto 2014
A Flintoff,ENG,Pace,2004-08-19,The Oval,England,2004,2,96,150,2,1,794,1252,26,698,1102,24,30.53846153846154,>30,ENG,Home,Upto 2014
A Flintoff,ENG,Pace,2004-12-17,Gqeberha,South Africa,2004,2,119,222,5,1,915,1720,27,796,1498,22,33.888888888888886,>30,SA,Away,Upto 2014
A Flintoff,ENG,Pace,2004-12-26,Durban,South Africa,2004,2,104,222,3,1,968,1978,29,864,1756,26,33.37931034482759,>30,SA,Away,Upto 2014
A Flintoff,ENG,Pace,2005-01-02,Cape Town,South Africa,2005,2,125,295,6,1,830,1832,29,705,1537,23,28.620689655172413,<=30,SA,Away,Upto 2014
A Flintoff,ENG,Pace,2005-01-13,Johannesburg,South Africa,2005,2,136,277,3,1,1212,2062,34,1076,1785,31,35.64705882352941,>30,SA,Away,Upto 2014
A Flintoff,ENG,Pace,2005-01-21,Centurion,South Africa,2005,2,90,192,6,1,788,1589,28,698,1397,22,28.142857142857142,<=30,SA,Away,Upto 2014
A Flintoff,ENG,Pace,2005-05-26,Lord's,England,2005,2,66,89,5,1,522,823,21,456,734,16,24.857142857142858,<=30,ENG,Home,Upto 2014
A Flintoff,ENG,Pace,2005-06-03,Chester-le-Street,England,2005,2,72,132,4,1,697,946,22,625,814,18,31.681818181818183,>30,ENG,Home,Upto 2014
A Flintoff,ENG,Pace,2005-07-21,Lord's,England,2005,2,173,228,4,1,726,1256,32,553,1028,28,22.6875,<=30,ENG,Home,Upto 2014
A Flintoff,ENG,Pace,2005-08-04,Birmingham,England,2005,2,131,222,7,1,817,1095,24,686,873,17,34.041666666666664,>30,ENG,Home,Upto 2014
A Flintoff,ENG,Pace,2005-08-11,Manchester,England,2005,2,136,270,5,1,929,1432,27,793,1162,22,34.407407407407405,>30,ENG,Home,Upto 2014
A Flintoff,ENG,Pace,2005-08-25,Nottingham,England,2005,2,137,240,3,1,944,1543,26,807,1303,23,36.30769230769231,>30,ENG,Home,Upto 2014
A Flintoff,ENG,Pace,2005-09-08,The Oval,England,2005,1,78,204,5,1,707,1205,18,629,1001,13,39.27777777777778,>30,ENG,Home,Upto 2014
A Flintoff,ENG,Pace,2005-11-12,Multan,Pakistan,2005,2,156,288,8,1,730,1407,32,574,1119,24,22.8125,<=30,PAK,Away,Upto 2014
A Flintoff,ENG,Pace,2005-11-20,Faisalabad,Pakistan,2005,2,142,337,4,1,802,1439,26,660,1102,22,30.846153846153847,>30,PAK,Away,Upto 2014
A Flintoff,ENG,Pace,2005-11-29,Lahore,Pakistan,2005,1,111,216,1,1,870,1496,17,759,1280,16,51.1764705882353,>30,PAK,Away,Upto 2014
A Flintoff,ENG,Pace,2006-03-01,Nagpur,India,2006,2,147,276,3,1,629,1284,22,482,1008,19,28.59090909090909,<=30,IND,Away,Upto 2014
A Flintoff,ENG,Pace,2006-03-09,Mohali,India,2006,2,107,162,4,1,422,800,12,315,638,8,35.166666666666664,>30,IND,Away,Upto 2014
A Flintoff,ENG,Pace,2006-03-18,Wankhede,India,2006,2,82,192,4,1,416,973,19,334,781,15,21.894736842105264,<=30,IND,Away,Upto 2014
A Flintoff,ENG,Pace,2006-05-11,Lord's,England,2006,2,186,411,4,1,982,1899,19,796,1488,15,51.68421052631579,>30,ENG,Home,Upto 2014
A Flintoff,ENG,Pace,2006-05-25,Birmingham,England,2006,2,78,194,4,1,504,1093,20,426,899,16,25.2,<=30,ENG,Home,Upto 2014
A Flintoff,ENG,Pace,2006-06-02,Nottingham,England,2006,2,90,168,4,1,634,1203,19,544,1035,15,33.36842105263158,>30,ENG,Home,Upto 2014
A Flintoff,ENG,Pace,2006-11-23,Brisbane,Australia,2006,2,110,210,4,1,985,1659,24,875,1449,20,41.041666666666664,>30,AUS,Away,Upto 2014
A Flintoff,ENG,Pace,2006-12-01,Adelaide,Australia,2006,2,126,210,3,1,876,1646,21,750,1436,18,41.714285714285715,>30,AUS,Away,Upto 2014
A Flintoff,ENG,Pace,2006-12-14,W.A.C.A,Australia,2006,2,112,168,0,1,846,1471,19,734,1303,19,44.526315789473685,>30,AUS,Away,Upto 2014
A Flintoff,ENG,Pace,2006-12-26,Melbourne,Australia,2006,1,77,132,3,1,551,1154,23,474,1022,20,23.956521739130434,<=30,AUS,Away,Upto 2014
A Flintoff,ENG,Pace,2007-01-02,Sydney,Australia,2007,1,56,102,1,1,646,1259,24,590,1157,23,26.916666666666668,<=30,AUS,Away,Upto 2014
A Flintoff,ENG,Pace,2008-07-18,Leeds,England,2008,1,77,240,1,1,905,1732,27,828,1492,26,33.51851851851852,>30,ENG,Home,Upto 2014
A Flintoff,ENG,Pace,2008-07-30,Birmingham,England,2008,2,161,300,6,1,903,1618,29,742,1318,23,31.137931034482758,>30,ENG,Home,Upto 2014
A Flintoff,ENG,Pace,2008-08-07,The Oval,England,2008,2,90,198,2,1,862,1540,26,772,1342,24,33.15384615384615,>30,ENG,Home,Upto 2014
A Flintoff,ENG,Pace,2008-12-11,Chennai,India,2008,2,113,244,4,1,452,1045,16,339,801,12,28.25,<=30,IND,Away,Upto 2014
A Flintoff,ENG,Pace,2008-12-19,Mohali,India,2008,2,93,260,3,1,522,1070,12,429,810,9,43.5,>30,IND,Away,Upto 2014
A Flintoff,ENG,Pace,2009-02-04,Kingston,West Indies,2009,1,72,198,2,1,444,1066,20,372,868,18,22.2,<=30,WI,Away,Upto 2014
A Flintoff,ENG,Pace,2009-02-15,St John's,West Indies,2009,2,79,176,3,1,803,1574,19,724,1398,16,42.26315789473684,>30,WI,Away,Upto 2014
A Flintoff,ENG,Pace,2009-07-08,Cardiff,England,2009,1,128,210,1,1,832,1434,18,704,1224,17,46.22222222222222,>30,ENG,Home,Upto 2014
A Flintoff,ENG,Pace,2009-07-16,Lord's,England,2009,2,119,234,6,1,1009,1590,27,890,1356,21,37.370370370370374,>30,ENG,Home,Upto 2014
A Flintoff,ENG,Pace,2009-07-30,Birmingham,England,2009,2,93,180,0,1,806,1353,22,713,1173,22,36.63636363636363,>30,ENG,Home,Upto 2014
A Flintoff,ENG,Pace,2009-08-20,The Oval,England,2009,2,77,149,1,1,842,1408,23,765,1259,22,36.608695652173914,>30,ENG,Home,Upto 2014
A Flintoff,ICC,Pace,2005-10-14,Sydney,Australia,2005,2,107,204,7,1,422,699,17,315,495,10,24.823529411764707,<=30,AUS,Away,Upto 2014
A Flower,ZIM,Spin,1993-12-16,Lahore,Pakistan,1993,1,0,1,0,1,31,97,0,31,96,0,inf,>30,PAK,Away,Upto 2014
A Flower,ZIM,Spin,2002-11-16,Bulawayo,Zimbabwe,2002,1,4,2,0,1,335,808,14,331,806,14,23.928571428571427,<=30,ZIM,Home,Upto 2014
A Gandotra,IND,Spin,1969-11-15,Kanpur,India,1969,1,5,6,0,1,657,2057,13,652,2051,13,50.53846153846154,>30,IND,Home,Upto 2014
A Hill,ENG,Pace,1877-03-15,Melbourne,Australia,1877,2,60,148,2,1,194,465,7,134,317,5,27.714285714285715,<=30,AUS,Away,After 1965
A Hill,ENG,Pace,1877-03-31,Melbourne,Australia,1877,2,70,192,5,1,269,577,12,199,385,7,22.416666666666668,<=30,AUS,Away,After 1965
A Hurwood,AUS,Spin,1930-12-12,Adelaide,Australia,1930,2,141,421,7,1,578,1434,23,437,1013,16,25.130434782608695,<=30,AUS,Home,Upto 2014
A Hurwood,AUS,Spin,1931-01-01,Sydney,Australia,1931,2,29,96,4,1,251,536,17,222,440,13,14.764705882352942,<=30,AUS,Home,Upto 2014
A Khan,ENG,Pace,2009-03-06,Port of Spain,West Indies,2009,2,122,174,1,1,770,1390,15,648,1216,14,51.333333333333336,>30,WI,Away,Upto 2014
A Kumble,IND,Spin,1990-08-09,Manchester,England,1990,2,170,360,3,1,724,1465,14,554,1105,11,51.714285714285715,>30,ENG,Away,Upto 2014
A Kumble,IND,Spin,1992-10-18,Harare,Zimbabwe,1992,2,94,266,3,1,383,1070,9,289,804,6,42.55555555555556,>30,ZIM,Away,Upto 2014
A Kumble,IND,Spin,1992-11-13,Durban,South Africa,1992,2,87,264,3,1,210,547,7,123,283,4,30.0,<=30,SA,Away,Upto 2014
A Kumble,IND,Spin,1992-11-26,Johannesburg,South Africa,1992,2,113,420,8,1,138,480,8,25,60,0,17.25,<=30,SA,Away,Upto 2014
A Kumble,IND,Spin,1992-12-26,Gqeberha,South Africa,1992,2,146,423,3,1,329,957,7,183,534,4,47.0,>30,SA,Away,Upto 2014
A Kumble,IND,Spin,1993-01-02,Cape Town,South Africa,1993,2,121,420,4,1,326,1020,6,205,600,2,54.333333333333336,>30,SA,Away,Upto 2014
A Kumble,IND,Spin,1993-01-29,Eden Gardens,India,1993,2,126,414,6,1,470,1482,23,344,1068,17,20.434782608695652,<=30,IND,Home,Upto 2014
A Kumble,IND,Spin,1993-02-11,Chennai,India,1993,2,125,276,8,1,792,1720,20,667,1444,12,39.6,>30,IND,Home,Upto 2014
A Kumble,IND,Spin,1993-02-19,Wankhede,India,1993,2,165,396,7,1,804,1796,20,639,1400,13,40.2,>30,IND,Home,Upto 2014
A Kumble,IND,Spin,1993-03-13,Delhi,India,1993,2,160,491,8,1,645,1548,21,485,1057,13,30.714285714285715,>30,IND,Home,Upto 2014
A Kumble,IND,Spin,1993-07-27,Colombo (SSC),Sri Lanka,1993,2,172,373,8,1,544,1136,16,372,763,8,34.0,>30,SL,Away,Upto 2014
A Kumble,IND,Spin,1993-08-04,Colombo (PSS),Sri Lanka,1993,2,203,470,5,1,715,1623,16,512,1153,11,44.6875,>30,SL,Away,Upto 2014
A Kumble,IND,Spin,1994-01-18,Lucknow,India,1994,2,128,387,11,1,633,1538,23,505,1151,12,27.52173913043478,<=30,IND,Home,Upto 2014
A Kumble,IND,Spin,1994-01-26,Bengaluru,India,1994,2,114,174,6,1,625,1188,15,511,1014,9,41.666666666666664,>30,IND,Home,Upto 2014
A Kumble,IND,Spin,1994-02-08,Ahmedabad,India,1994,2,75,258,1,1,473,1433,26,398,1175,25,18.192307692307693,<=30,IND,Home,Upto 2014
A Kumble,IND,Spin,1994-03-19,Hamilton,New Zealand,1994,2,102,300,2,1,491,1160,14,389,860,12,35.07142857142857,>30,NZ,Away,Upto 2014
A Kumble,IND,Spin,1994-11-18,Wankhede,India,1994,2,87,215,3,1,528,1096,17,441,881,14,31.058823529411764,>30,IND,Home,Upto 2014
A Kumble,IND,Spin,1994-12-01,Nagpur,India,1994,2,176,444,6,1,761,1735,22,585,1291,16,34.59090909090909,>30,IND,Home,Upto 2014
A Kumble,IND,Spin,1994-12-10,Mohali,India,1994,2,146,216,4,1,470,841,10,324,625,6,47.0,>30,IND,Home,Upto 2014
A Kumble,IND,Spin,1995-10-18,Bengaluru,India,1995,2,120,272,9,1,388,811,15,268,539,6,25.866666666666667,<=30,IND,Home,Upto 2014
A Kumble,IND,Spin,1995-11-08,Cuttack,India,1995,1,32,162,1,1,195,570,8,163,408,7,24.375,<=30,IND,Home,Upto 2014
A Kumble,IND,Spin,1996-06-06,Birmingham,England,1996,2,86,174,1,1,130,258,1,44,84,0,130.0,>30,ENG,Away,Upto 2014
A Kumble,IND,Spin,1996-06-20,Lord's,England,1996,2,150,474,3,1,159,498,3,9,24,0,53.0,>30,ENG,Away,Upto 2014
A Kumble,IND,Spin,1996-07-04,Nottingham,England,1996,1,98,234,1,1,381,828,3,283,594,2,127.0,>30,ENG,Away,Upto 2014
A Kumble,IND,Spin,1996-10-10,Delhi,India,1996,2,130,390,9,1,528,1278,19,398,888,10,27.789473684210527,<=30,IND,Home,Upto 2014
A Kumble,IND,Spin,1996-11-20,Ahmedabad,India,1996,2,110,258,5,1,390,956,20,280,698,15,19.5,<=30,IND,Home,Upto 2014
A Kumble,IND,Spin,1996-11-27,Eden Gardens,India,1996,2,179,313,3,1,508,781,6,329,468,3,84.66666666666667,>30,IND,Home,Upto 2014
A Kumble,IND,Spin,1996-12-08,Kanpur,India,1996,2,98,306,5,1,503,1168,19,405,862,14,26.473684210526315,<=30,IND,Home,Upto 2014
A Kumble,IND,Spin,1996-12-26,Durban,South Africa,1996,2,87,188,2,1,87,204,2,0,16,0,43.5,>30,SA,Away,Upto 2014
A Kumble,IND,Spin,1997-01-02,Cape Town,South Africa,1997,2,194,456,2,1,351,752,7,157,296,5,50.142857142857146,>30,SA,Away,Upto 2014
A Kumble,IND,Spin,1997-01-16,Johannesburg,South Africa,1997,2,103,288,4,1,289,570,8,186,282,4,36.125,>30,SA,Away,Upto 2014
A Kumble,IND,Spin,1997-03-06,Kingston,West Indies,1997,2,196,394,8,1,464,982,9,268,588,1,51.55555555555556,>30,WI,Away,Upto 2014
A Kumble,IND,Spin,1997-03-14,Port of Spain,West Indies,1997,2,213,474,7,1,443,1095,13,230,621,6,34.07692307692308,>30,WI,Away,Upto 2014
A Kumble,IND,Spin,1997-03-27,Bridgetown,West Indies,1997,1,44,96,1,1,72,144,1,28,48,0,72.0,>30,WI,Away,Upto 2014
A Kumble,IND,Spin,1997-04-04,St John's,West Indies,1997,1,93,216,2,1,268,532,5,175,316,3,53.6,>30,WI,Away,Upto 2014
A Kumble,IND,Spin,1997-04-17,Georgetown,West Indies,1997,1,30,24,1,1,131,336,6,101,312,5,21.833333333333332,<=30,WI,Away,Upto 2014
A Kumble,IND,Spin,1997-08-02,Colombo (RPS),Sri Lanka,1997,1,223,432,1,1,1044,2082,8,821,1650,7,130.5,>30,SL,Away,Upto 2014
A Kumble,IND,Spin,1997-08-09,Colombo (SSC),Sri Lanka,1997,2,207,382,4,1,450,1036,11,243,654,7,40.90909090909091,>30,SL,Away,Upto 2014
A Kumble,IND,Spin,1997-11-19,Mohali,India,1997,2,147,318,2,1,502,1356,8,355,1038,6,62.75,>30,IND,Home,Upto 2014
A Kumble,IND,Spin,1997-12-03,Wankhede,India,1997,2,132,414,4,1,533,1312,21,401,898,17,25.38095238095238,<=30,IND,Home,Upto 2014
A Kumble,IND,Spin,1998-03-06,Chennai,India,1998,2,149,407,8,1,809,1753,28,660,1346,20,28.892857142857142,<=30,IND,Home,Upto 2014
A Kumble,IND,Spin,1998-03-18,Eden Gardens,India,1998,2,106,354,8,1,634,1306,12,528,952,4,52.833333333333336,>30,IND,Home,Upto 2014
A Kumble,IND,Spin,1998-03-25,Bengaluru,India,1998,2,161,385,7,1,817,1511,22,656,1126,15,37.13636363636363,>30,IND,Home,Upto 2014
A Kumble,IND,Spin,1998-10-07,Harare,Zimbabwe,1998,2,129,322,7,1,303,670,13,174,348,6,23.307692307692307,<=30,ZIM,Away,Upto 2014
A Kumble,IND,Spin,1998-12-26,Wellington,New Zealand,1998,2,153,412,6,1,442,922,12,289,510,6,36.833333333333336,>30,NZ,Away,Upto 2014
A Kumble,IND,Spin,1999-01-02,Hamilton,New Zealand,1999,2,188,437,3,1,438,743,6,250,306,3,73.0,>30,NZ,Away,Upto 2014
A Kumble,IND,Spin,1999-01-28,Chennai,India,1999,2,163,281,7,1,572,1226,24,409,945,17,23.833333333333332,<=30,IND,Home,Upto 2014
A Kumble,IND,Spin,1999-02-04,Delhi,India,1999,2,149,306,14,1,634,1395,31,485,1089,17,20.451612903225808,<=30,IND,Home,Upto 2014
A Kumble,IND,Spin,1999-02-16,Eden Gardens,India,1999,2,139,278,1,1,375,758,8,236,480,7,46.875,>30,IND,Home,Upto 2014
A Kumble,IND,Spin,1999-02-24,Colombo (SSC),Sri Lanka,1999,1,134,325,4,1,484,1002,12,350,677,8,40.333333333333336,>30,SL,Away,Upto 2014
A Kumble,IND,Spin,1999-10-10,Mohali,India,1999,2,91,354,4,1,393,1249,10,302,895,6,39.3,>30,IND,Home,Upto 2014
A Kumble,IND,Spin,1999-10-22,Kanpur,India,1999,2,134,358,10,1,568,1375,24,434,1017,14,23.666666666666668,<=30,IND,Home,Upto 2014
A Kumble,IND,Spin,1999-10-29,Ahmedabad,India,1999,2,139,474,6,1,599,1348,12,460,874,6,49.916666666666664,>30,IND,Home,Upto 2014
A Kumble,IND,Spin,1999-12-10,Adelaide,Australia,1999,2,174,396,3,1,301,744,9,127,348,6,33.44444444444444,>30,AUS,Away,Upto 2014
A Kumble,IND,Spin,1999-12-26,Melbourne,Australia,1999,2,150,282,2,1,307,606,6,157,324,4,51.166666666666664,>30,AUS,Away,Upto 2014
A Kumble,IND,Spin,2000-01-02,Sydney,Australia,2000,1,126,200,0,1,279,470,1,153,270,1,279.0,>30,AUS,Away,Upto 2014
A Kumble,IND,Spin,2000-02-24,Wankhede,India,2000,2,118,300,6,1,274,666,12,156,366,6,22.833333333333332,<=30,IND,Home,Upto 2014
A Kumble,IND,Spin,2000-03-02,Bengaluru,India,2000,1,143,412,6,1,474,1252,16,331,840,10,29.625,<=30,IND,Home,Upto 2014
A Kumble,IND,Spin,2001-11-03,Bloemfontein,South Africa,2001,2,155,324,4,1,225,426,4,70,102,0,56.25,>30,SA,Away,Upto 2014
A Kumble,IND,Spin,2001-11-16,Gqeberha,South Africa,2001,2,89,228,1,1,330,708,5,241,480,4,66.0,>30,SA,Away,Upto 2014
A Kumble,IND,Spin,2001-12-03,Mohali,India,2001,2,133,286,8,1,507,1147,21,374,861,13,24.142857142857142,<=30,IND,Home,Upto 2014
A Kumble,IND,Spin,2001-12-11,Ahmedabad,India,2001,2,233,534,10,1,727,1868,25,494,1334,15,29.08,<=30,IND,Home,Upto 2014
A Kumble,IND,Spin,2001-12-19,Bengaluru,India,2001,1,74,177,1,1,308,742,5,234,565,4,61.6,>30,IND,Home,Upto 2014
A Kumble,IND,Spin,2002-02-21,Nagpur,India,2002,2,145,425,9,1,556,1425,18,411,1000,9,30.88888888888889,>30,IND,Home,Upto 2014
A Kumble,IND,Spin,2002-02-28,Delhi,India,2002,2,146,381,7,1,467,1232,22,321,851,15,21.227272727272727,<=30,IND,Home,Upto 2014
A Kumble,IND,Spin,2002-04-11,Georgetown,West Indies,2002,1,145,271,2,1,369,751,4,224,480,2,92.25,>30,WI,Away,Upto 2014
A Kumble,IND,Spin,2002-05-10,St John's,West Indies,2002,1,29,84,1,1,261,672,7,232,588,6,37.285714285714285,>30,WI,Away,Upto 2014
A Kumble,IND,Spin,2002-07-25,Lord's,England,2002,2,212,398,6,1,509,942,14,297,544,8,36.357142857142854,>30,ENG,Away,Upto 2014
A Kumble,IND,Spin,2002-08-22,Leeds,England,2002,2,159,377,7,1,393,893,12,234,516,5,32.75,>30,ENG,Away,Upto 2014
A Kumble,IND,Spin,2002-09-05,The Oval,England,2002,2,133,270,1,1,410,922,9,277,652,8,45.55555555555556,>30,ENG,Away,Upto 2014
A Kumble,IND,Spin,2002-10-09,Wankhede,India,2002,2,101,299,7,1,416,1045,19,315,746,12,21.894736842105264,<=30,IND,Home,Upto 2014
A Kumble,IND,Spin,2002-10-17,Chennai,India,2002,2,117,297,6,1,464,965,17,347,668,11,27.294117647058822,<=30,IND,Home,Upto 2014
A Kumble,IND,Spin,2002-10-30,Eden Gardens,India,2002,1,169,324,3,1,592,1269,12,423,945,9,49.333333333333336,>30,IND,Home,Upto 2014
A Kumble,IND,Spin,2003-10-08,Ahmedabad,India,2003,2,153,445,6,1,719,1566,18,566,1121,12,39.94444444444444,>30,IND,Home,Upto 2014
A Kumble,IND,Spin,2003-10-16,Mohali,India,2003,1,181,396,3,1,664,1623,9,483,1227,6,73.77777777777777,>30,IND,Home,Upto 2014
A Kumble,IND,Spin,2003-12-12,Adelaide,Australia,2003,2,212,360,6,1,609,1006,16,397,646,10,38.0625,>30,AUS,Away,Upto 2014
A Kumble,IND,Spin,2003-12-26,Melbourne,Australia,2003,2,219,344,6,1,455,739,13,236,395,7,35.0,>30,AUS,Away,Upto 2014
A Kumble,IND,Spin,2004-01-02,Sydney,Australia,2004,2,279,533,12,1,831,1277,14,552,744,2,59.357142857142854,>30,AUS,Away,Upto 2014
A Kumble,IND,Spin,2004-03-28,Multan,Pakistan,2004,2,172,417,8,1,510,902,13,338,485,5,39.23076923076923,>30,PAK,Away,Upto 2014
A Kumble,IND,Spin,2004-04-05,Lahore,Pakistan,2004,1,146,265,2,1,269,480,8,123,215,6,33.625,>30,PAK,Away,Upto 2014
A Kumble,IND,Spin,2004-04-13,Rawalpindi,Pakistan,2004,2,71,101,5,1,324,559,10,253,458,5,32.4,>30,PAK,Away,Upto 2014
A Kumble,IND,Spin,2004-10-06,Bengaluru,India,2004,2,221,372,5,1,685,1243,20,464,871,15,34.25,>30,IND,Home,Upto 2014
A Kumble,IND,Spin,2004-10-14,Chennai,India,2004,2,181,387,13,1,557,1169,24,376,782,11,23.208333333333332,<=30,IND,Home,Upto 2014
A Kumble,IND,Spin,2004-10-26,Nagpur,India,2004,2,188,276,3,1,469,867,12,281,591,9,39.083333333333336,>30,IND,Home,Upto 2014
A Kumble,IND,Spin,2004-11-03,Wankhede,India,2004,2,95,150,6,1,365,706,29,270,556,23,12.586206896551724,<=30,IND,Home,Upto 2014
A Kumble,IND,Spin,2004-11-20,Kanpur,India,2004,2,183,450,6,1,586,1360,13,403,910,7,45.07692307692308,>30,IND,Home,Upto 2014
A Kumble,IND,Spin,2004-11-28,Eden Gardens,India,2004,2,158,388,4,1,470,978,15,312,590,11,31.333333333333332,>30,IND,Home,Upto 2014
A Kumble,IND,Spin,2004-12-10,Dhaka,Bangladesh,2004,2,87,161,4,1,324,603,8,237,442,4,40.5,>30,BAN,Away,Upto 2014
A Kumble,IND,Spin,2004-12-17,Chattogram,Bangladesh,2004,2,57,180,6,1,442,811,15,385,631,9,29.466666666666665,<=30,BAN,Away,Upto 2014
A Kumble,IND,Spin,2005-03-08,Mohali,India,2005,2,236,456,6,1,471,904,13,235,448,7,36.23076923076923,>30,IND,Home,Upto 2014
A Kumble,IND,Spin,2005-03-16,Eden Gardens,India,2005,2,161,451,10,1,693,1450,23,532,999,13,30.130434782608695,>30,IND,Home,Upto 2014
A Kumble,IND,Spin,2005-03-24,Bengaluru,India,2005,2,247,402,1,1,834,1659,22,587,1257,21,37.90909090909091,>30,IND,Home,Upto 2014
A Kumble,IND,Spin,2005-09-13,Bulawayo,Zimbabwe,2005,2,114,228,3,1,509,995,11,395,767,8,46.27272727272727,>30,ZIM,Away,Upto 2014
A Kumble,IND,Spin,2005-09-20,Harare,Zimbabwe,2005,2,71,108,1,1,178,258,3,107,150,2,59.333333333333336,>30,ZIM,Away,Upto 2014
A Kumble,IND,Spin,2005-12-02,Chennai,India,2005,1,41,90,3,1,150,362,6,109,272,3,25.0,<=30,IND,Home,Upto 2014
A Kumble,IND,Spin,2005-12-10,Delhi,India,2005,2,157,384,10,1,668,1353,25,511,969,15,26.72,<=30,IND,Home,Upto 2014
A Kumble,IND,Spin,2005-12-18,Ahmedabad,India,2005,2,176,357,7,1,765,1419,29,589,1062,22,26.379310344827587,<=30,IND,Home,Upto 2014
A Kumble,IND,Spin,2006-01-13,Lahore,Pakistan,2006,1,178,237,2,1,588,687,2,410,450,0,294.0,>30,PAK,Away,Upto 2014
A Kumble,IND,Spin,2006-01-21,Faisalabad,Pakistan,2006,2,268,338,4,1,770,1194,9,502,856,5,85.55555555555556,>30,PAK,Away,Upto 2014
A Kumble,IND,Spin,2006-01-29,Karachi,Pakistan,2006,2,183,283,3,1,322,481,6,139,198,3,53.666666666666664,>30,PAK,Away,Upto 2014
A Kumble,IND,Spin,2006-03-01,Nagpur,India,2006,2,189,432,2,1,588,1296,7,399,864,5,84.0,>30,IND,Home,Upto 2014
A Kumble,IND,Spin,2006-03-09,Mohali,India,2006,2,146,352,9,1,492,1055,19,346,703,10,25.894736842105264,<=30,IND,Home,Upto 2014
A Kumble,IND,Spin,2006-03-18,Wankhede,India,2006,2,133,418,5,1,517,1300,19,384,882,14,27.210526315789473,<=30,IND,Home,Upto 2014
A Kumble,IND,Spin,2006-06-02,St John's,West Indies,2006,2,193,369,7,1,672,1196,20,479,827,13,33.6,>30,WI,Away,Upto 2014
A Kumble,IND,Spin,2006-06-10,Gros Islet,West Indies,2006,2,155,432,6,1,473,1177,17,318,745,11,27.823529411764707,<=30,WI,Away,Upto 2014
A Kumble,IND,Spin,2006-06-22,Basseterre,West Indies,2006,2,200,354,3,1,722,1248,13,522,894,10,55.53846153846154,>30,WI,Away,Upto 2014
A Kumble,IND,Spin,2006-06-30,Kingston,West Indies,2006,2,110,184,7,1,275,517,14,165,333,7,19.642857142857142,<=30,WI,Away,Upto 2014
A Kumble,IND,Spin,2006-12-15,Johannesburg,South Africa,2006,2,56,132,5,1,82,150,5,26,18,0,16.4,<=30,SA,Away,Upto 2014
A Kumble,IND,Spin,2006-12-26,Durban,South Africa,2006,2,99,267,4,1,106,283,5,7,16,1,21.2,<=30,SA,Away,Upto 2014
A Kumble,IND,Spin,2007-01-02,Cape Town,South Africa,2007,2,191,405,5,1,487,1042,13,296,637,8,37.46153846153846,>30,SA,Away,Upto 2014
A Kumble,IND,Spin,2007-05-25,Mirpur,Bangladesh,2007,2,104,146,5,1,453,725,12,349,579,7,37.75,>30,BAN,Away,Upto 2014
A Kumble,IND,Spin,2007-07-19,Lord's,England,2007,2,130,240,3,1,243,486,5,113,246,2,48.6,>30,ENG,Away,Upto 2014
A Kumble,IND,Spin,2007-07-27,Nottingham,England,2007,2,136,225,6,1,275,482,10,139,257,4,27.5,<=30,ENG,Away,Upto 2014
A Kumble,IND,Spin,2007-08-09,The Oval,England,2007,2,217,397,5,1,584,973,9,367,576,4,64.88888888888889,>30,ENG,Away,Upto 2014
A Kumble,IND,Spin,2007-11-22,Delhi,India,2007,2,106,291,7,1,425,937,15,319,646,8,28.333333333333332,<=30,IND,Home,Upto 2014
A Kumble,IND,Spin,2007-11-30,Eden Gardens,India,2007,2,195,432,5,1,851,1606,18,656,1174,13,47.27777777777778,>30,IND,Home,Upto 2014
A Kumble,IND,Spin,2007-12-08,Bengaluru,India,2007,2,176,348,6,1,712,1214,14,536,866,8,50.857142857142854,>30,IND,Home,Upto 2014
A Kumble,IND,Spin,2007-12-26,Melbourne,Australia,2007,2,186,300,7,1,518,912,15,332,612,8,34.53333333333333,>30,AUS,Away,Upto 2014
A Kumble,IND,Spin,2008-01-02,Sydney,Australia,2008,2,254,393,8,1,764,1280,20,510,887,12,38.2,>30,AUS,Away,Upto 2014
A Kumble,IND,Spin,2008-01-16,W.A.C.A,Australia,2008,2,140,216,4,1,288,498,9,148,282,5,32.0,>30,AUS,Away,Upto 2014
A Kumble,IND,Spin,2008-01-24,Adelaide,Australia,2008,1,109,180,1,1,579,1086,9,470,906,8,64.33333333333333,>30,AUS,Away,Upto 2014
A Kumble,IND,Spin,2008-03-26,Chennai,India,2008,2,163,390,3,1,758,1458,16,595,1068,13,47.375,>30,IND,Home,Upto 2014
A Kumble,IND,Spin,2008-04-03,Ahmedabad,India,2008,1,78,198,1,1,281,588,6,203,390,5,46.833333333333336,>30,IND,Home,Upto 2014
A Kumble,IND,Spin,2008-07-23,Colombo (SSC),Sri Lanka,2008,1,121,222,0,1,529,1031,21,408,809,21,25.19047619047619,<=30,SL,Away,Upto 2014
A Kumble,IND,Spin,2008-07-31,Galle,Sri Lanka,2008,2,122,279,5,1,684,1286,30,562,1007,25,22.8,<=30,SL,Away,Upto 2014
A Kumble,IND,Spin,2008-08-08,Colombo (PSS),Sri Lanka,2008,2,157,308,3,1,613,1402,20,456,1094,17,30.65,>30,SL,Away,Upto 2014
A Kumble,IND,Spin,2008-10-09,Bengaluru,India,2008,2,160,306,0,1,536,1200,6,376,894,6,89.33333333333333,>30,IND,Home,Upto 2014
A Kumble,IND,Spin,2008-10-29,Delhi,India,2008,2,126,285,3,1,668,1278,12,542,993,9,55.666666666666664,>30,IND,Home,Upto 2014
A Kuruvilla,IND,Pace,1997-03-06,Kingston,West Indies,1997,2,138,282,4,1,612,1409,17,474,1127,13,36.0,>30,WI,Away,Upto 2014
A Kuruvilla,IND,Pace,1997-03-14,Port of Spain,West Indies,1997,2,83,270,1,1,527,1480,12,444,1210,11,43.916666666666664,>30,WI,Away,Upto 2014
A Kuruvilla,IND,Pace,1997-03-27,Bridgetown,West Indies,1997,2,156,294,6,1,738,1569,38,582,1275,32,19.42105263157895,<=30,WI,Away,Upto 2014
A Kuruvilla,IND,Pace,1997-04-04,St John's,West Indies,1997,1,69,144,2,1,268,546,4,199,402,2,67.0,>30,WI,Away,Upto 2014
A Kuruvilla,IND,Pace,1997-04-17,Georgetown,West Indies,1997,1,34,42,0,1,344,855,6,310,813,6,57.333333333333336,>30,WI,Away,Upto 2014
A Kuruvilla,IND,Pace,1997-08-02,Colombo (RPS),Sri Lanka,1997,1,74,84,0,1,398,549,5,324,465,5,79.6,>30,SL,Away,Upto 2014
A Kuruvilla,IND,Pace,1997-08-09,Colombo (SSC),Sri Lanka,1997,2,158,264,4,1,927,1577,19,769,1313,15,48.78947368421053,>30,SL,Away,Upto 2014
A Kuruvilla,IND,Pace,1997-11-19,Mohali,India,1997,2,117,253,6,1,565,1196,16,448,943,10,35.3125,>30,IND,Home,Upto 2014
A Kuruvilla,IND,Pace,1997-12-03,Wankhede,India,1997,2,63,132,2,1,639,1269,12,576,1137,10,53.25,>30,IND,Home,Upto 2014
A Lyth,ENG,Spin,2015-07-16,Lord's,England,2015,1,0,6,0,1,392,582,8,392,576,8,49.0,>30,ENG,Home,After 1965
A McGrath,ENG,Pace,2003-05-22,Lord's,England,2003,1,16,36,3,1,641,1236,26,625,1200,23,24.653846153846153,<=30,ENG,Home,Upto 2014
A McGrath,ENG,Pace,2003-07-31,Lord's,England,2003,1,40,66,1,1,967,1600,24,927,1534,23,40.291666666666664,>30,ENG,Home,Upto 2014
A Mishra,IND,Spin,2008-10-17,Mohali,India,2008,2,106,230,7,1,362,764,15,256,534,8,24.133333333333333,<=30,IND,Home,Upto 2014
A Mishra,IND,Spin,2008-10-29,Delhi,India,2008,2,146,294,2,1,668,1278,12,522,984,10,55.666666666666664,>30,IND,Home,Upto 2014
A Mishra,IND,Spin,2008-11-06,Nagpur,India,2008,2,85,208,5,1,751,1259,24,666,1051,19,31.291666666666668,>30,IND,Home,Upto 2014
A Mishra,IND,Spin,2008-12-11,Chennai,India,2008,2,165,306,4,1,742,1371,17,577,1065,13,43.64705882352941,>30,IND,Home,Upto 2014
A Mishra,IND,Spin,2008-12-19,Mohali,India,2008,2,91,192,2,1,508,989,13,417,797,11,39.07692307692308,>30,IND,Home,Upto 2014
A Mishra,IND,Spin,2009-11-16,Ahmedabad,India,2009,1,203,348,1,1,904,1575,9,701,1227,8,100.44444444444444,>30,IND,Home,Upto 2014
A Mishra,IND,Spin,2010-01-17,Chattogram,Bangladesh,2010,2,158,232,7,1,565,949,23,407,717,16,24.565217391304348,<=30,BAN,Away,Upto 2014
A Mishra,IND,Spin,2010-02-06,Nagpur,India,2010,1,140,318,0,1,517,1080,7,377,762,7,73.85714285714286,>30,IND,Home,Upto 2014
A Mishra,IND,Spin,2010-02-14,Eden Gardens,India,2010,2,148,366,4,1,547,1263,14,399,897,10,39.07142857142857,>30,IND,Home,Upto 2014
A Mishra,IND,Spin,2010-08-03,Colombo (PSS),Sri Lanka,2010,2,187,356,4,1,813,1539,26,626,1183,22,31.26923076923077,>30,SL,Away,Upto 2014
A Mishra,IND,Spin,2011-06-20,Kingston,West Indies,2011,2,113,161,4,1,367,624,15,254,463,11,24.466666666666665,<=30,WI,Away,Upto 2014
A Mishra,IND,Spin,2011-08-10,Birmingham,England,2011,1,150,258,3,1,372,564,6,222,306,3,62.0,>30,ENG,Away,Upto 2014
A Mishra,IND,Spin,2011-08-18,The Oval,England,2011,1,170,228,0,1,491,822,11,321,594,11,44.63636363636363,>30,ENG,Away,Upto 2014
A Mishra,IND,Spin,2015-08-12,Galle,Sri Lanka,2015,2,81,138,5,1,627,1167,31,546,1029,26,20.225806451612904,<=30,SL,Away,After 1965
A Mishra,IND,Spin,2015-08-20,Colombo (PSS),Sri Lanka,2015,2,72,184,7,1,596,1144,22,524,960,15,27.09090909090909,<=30,SL,Away,After 1965
A Mishra,IND,Spin,2015-08-28,Colombo (SSC),Sri Lanka,2015,2,72,152,3,1,433,759,12,361,607,9,36.083333333333336,>30,SL,Away,After 1965
A Mishra,IND,Spin,2015-11-05,Mohali,India,2015,2,61,120,3,1,466,1004,34,405,884,31,13.705882352941176,<=30,IND,Home,After 1965
A Mishra,IND,Spin,2015-11-25,Nagpur,India,2015,2,60,138,4,1,483,1096,33,423,958,29,14.636363636363637,<=30,IND,Home,After 1965
A Mishra,IND,Spin,2016-07-21,North Sound,West Indies,2016,2,104,206,3,1,560,1009,16,456,803,13,35.0,>30,WI,Away,After 1965
A Mishra,IND,Spin,2016-07-30,Kingston,West Indies,2016,2,128,213,3,1,562,982,15,434,769,12,37.46666666666667,>30,WI,Away,After 1965
A Mishra,IND,Spin,2016-11-09,Rajkot,India,2016,2,158,219,3,1,954,1677,22,796,1458,19,43.36363636363637,>30,IND,Home,After 1965
A Mishra,IND,Spin,2016-12-16,Chennai,India,2016,2,117,236,2,1,966,1770,17,849,1534,15,56.8235294117647,>30,IND,Home,After 1965
A Mitchell,ENG,Spin,1935-07-13,Leeds,England,1935,1,4,6,0,1,260,741,11,256,735,11,23.636363636363637,<=30,ENG,Home,Upto 2014
A Mithun,IND,Pace,2010-07-18,Galle,Sri Lanka,2010,2,138,198,4,1,560,768,16,422,570,12,35.0,>30,SL,Away,Upto 2014
A Mithun,IND,Pace,2010-07-26,Colombo (SSC),Sri Lanka,2010,2,134,174,1,1,508,710,3,374,536,2,169.33333333333334,>30,SL,Away,Upto 2014
A Mithun,IND,Pace,2010-08-03,Colombo (PSS),Sri Lanka,2010,2,100,180,1,1,534,849,8,434,669,7,66.75,>30,SL,Away,Upto 2014
A Mithun,IND,Pace,2011-06-28,Bridgetown,West Indies,2011,2,84,168,3,1,639,1424,28,555,1256,25,22.821428571428573,<=30,WI,Away,Upto 2014
A Mukund,IND,Spin,2011-07-06,Roseau,West Indies,2011,1,14,12,0,1,478,1095,12,464,1083,12,39.833333333333336,>30,WI,Away,Upto 2014
A Ndlovu,ZIM,Spin,2020-01-19,Harare,Zimbabwe,2020,1,107,168,0,1,523,1058,12,416,890,12,43.583333333333336,>30,ZIM,Home,After 1965
A Ndlovu,ZIM,Spin,2020-02-22,Mirpur,Bangladesh,2020,1,170,252,2,1,601,1116,18,431,864,16,33.388888888888886,>30,BAN,Away,After 1965
A Nehra,IND,Pace,1999-02-24,Colombo (SSC),Sri Lanka,1999,1,94,168,1,1,790,1434,9,696,1266,8,87.77777777777777,>30,SL,Away,Upto 2014
A Nehra,IND,Pace,2001-06-07,Bulawayo,Zimbabwe,2001,2,100,232,5,1,658,1325,23,558,1093,18,28.608695652173914,<=30,ZIM,Away,Upto 2014
A Nehra,IND,Pace,2001-06-15,Harare,Zimbabwe,2001,2,117,222,6,1,726,1580,27,609,1358,21,26.88888888888889,<=30,ZIM,Away,Upto 2014
A Nehra,IND,Pace,2001-11-03,Bloemfontein,South Africa,2001,2,130,150,2,1,966,1509,27,836,1359,25,35.77777777777778,>30,SA,Away,Upto 2014
A Nehra,IND,Pace,2002-04-19,Port of Spain,West Indies,2002,2,124,306,5,1,849,1915,33,725,1609,28,25.727272727272727,<=30,WI,Away,Upto 2014
A Nehra,IND,Pace,2002-05-02,Bridgetown,West Indies,2002,1,112,192,4,1,655,1356,22,543,1164,18,29.772727272727273,<=30,WI,Away,Upto 2014
A Nehra,IND,Pace,2002-05-10,St John's,West Indies,2002,1,122,294,0,1,856,1992,11,734,1698,11,77.81818181818181,>30,WI,Away,Upto 2014
A Nehra,IND,Pace,2002-05-18,Kingston,West Indies,2002,2,95,234,3,1,844,1737,30,749,1503,27,28.133333333333333,<=30,WI,Away,Upto 2014
A Nehra,IND,Pace,2002-07-25,Lord's,England,2002,2,181,264,3,1,837,1449,22,656,1185,19,38.04545454545455,>30,ENG,Away,Upto 2014
A Nehra,IND,Pace,2002-08-08,Nottingham,England,2002,1,138,192,2,1,996,1602,22,858,1410,20,45.27272727272727,>30,ENG,Away,Upto 2014
A Nehra,IND,Pace,2002-10-30,Eden Gardens,India,2002,1,66,138,1,1,701,1322,15,635,1184,14,46.733333333333334,>30,IND,Home,Upto 2014
A Nehra,IND,Pace,2002-12-12,Wellington,New Zealand,2002,2,71,141,0,1,505,1071,28,434,930,28,18.035714285714285,<=30,NZ,Away,Upto 2014
A Nehra,IND,Pace,2002-12-19,Hamilton,New Zealand,2002,2,54,146,5,1,426,959,32,372,813,27,13.3125,<=30,NZ,Away,Upto 2014
A Nehra,IND,Pace,2003-12-04,Brisbane,Australia,2003,2,140,204,1,1,735,1213,18,595,1009,17,40.833333333333336,>30,AUS,Away,Upto 2014
A Nehra,IND,Pace,2003-12-12,Adelaide,Australia,2003,2,136,192,3,1,872,1501,19,736,1309,16,45.89473684210526,>30,AUS,Away,Upto 2014
A Nehra,IND,Pace,2003-12-26,Melbourne,Australia,2003,2,106,210,0,1,819,1520,17,713,1310,17,48.1764705882353,>30,AUS,Away,Upto 2014
A Nehra,IND,Pace,2004-04-13,Rawalpindi,Pakistan,2004,2,80,162,3,1,687,1266,18,607,1104,15,38.166666666666664,>30,PAK,Away,Upto 2014
A Nel,SA,Pace,2001-09-07,Harare,Zimbabwe,2001,2,86,185,5,1,919,1718,19,833,1533,14,48.36842105263158,>30,ZIM,Away,Upto 2014
A Nel,SA,Pace,2001-09-14,Bulawayo,Zimbabwe,2001,2,82,144,1,1,548,1308,7,466,1164,6,78.28571428571429,>30,ZIM,Away,Upto 2014
A Nel,SA,Pace,2002-02-22,Johannesburg,South Africa,2002,1,121,184,2,1,698,1059,20,577,875,18,34.9,>30,SA,Home,Upto 2014
A Nel,SA,Pace,2003-10-17,Lahore,Pakistan,2003,2,80,192,2,1,569,1080,10,489,888,8,56.9,>30,PAK,Away,Upto 2014
A Nel,SA,Pace,2003-12-12,Johannesburg,South Africa,2003,2,127,275,5,1,1112,2121,34,985,1846,29,32.705882352941174,>30,SA,Home,Upto 2014
A Nel,SA,Pace,2003-12-26,Durban,South Africa,2003,2,111,186,6,1,1030,1831,26,919,1645,20,39.61538461538461,>30,SA,Home,Upto 2014
A Nel,SA,Pace,2004-01-02,Cape Town,South Africa,2004,2,144,295,6,1,1140,1873,23,996,1578,17,49.56521739130435,>30,SA,Home,Upto 2014
A Nel,SA,Pace,2004-01-16,Centurion,South Africa,2004,2,128,202,5,1,1068,1800,24,940,1598,19,44.5,>30,SA,Home,Upto 2014
A Nel,SA,Pace,2004-03-10,Hamilton,New Zealand,2004,2,106,186,1,1,760,1661,15,654,1475,14,50.666666666666664,>30,NZ,Away,Upto 2014
A Nel,SA,Pace,2004-03-26,Wellington,New Zealand,2004,2,135,288,3,1,820,1651,25,685,1363,22,32.8,>30,NZ,Away,Upto 2014
A Nel,SA,Pace,2005-01-21,Centurion,South Africa,2005,2,105,246,6,1,788,1589,28,683,1343,22,28.142857142857142,<=30,SA,Home,Upto 2014
A Nel,SA,Pace,2005-03-11,Centurion,South Africa,2005,2,59,168,3,1,611,1095,23,552,927,20,26.565217391304348,<=30,SA,Home,Upto 2014
A Nel,SA,Pace,2005-03-31,Georgetown,West Indies,2005,1,93,198,3,1,687,1530,15,594,1332,12,45.8,>30,WI,Away,Upto 2014
A Nel,SA,Pace,2005-04-08,Port of Spain,West Indies,2005,2,113,298,4,1,854,1820,25,741,1522,21,34.16,>30,WI,Away,Upto 2014
A Nel,SA,Pace,2005-04-21,Bridgetown,West Indies,2005,2,88,226,10,1,712,1449,24,624,1223,14,29.666666666666668,<=30,WI,Away,Upto 2014
A Nel,SA,Pace,2005-12-16,W.A.C.A,Australia,2005,2,133,272,4,1,1099,2050,27,966,1778,23,40.7037037037037,>30,AUS,Away,Upto 2014
A Nel,SA,Pace,2005-12-26,Melbourne,Australia,2005,2,155,306,6,1,712,1466,23,557,1160,17,30.956521739130434,>30,AUS,Away,Upto 2014
A Nel,SA,Pace,2006-01-02,Sydney,Australia,2006,2,127,187,4,1,752,1301,17,625,1114,13,44.23529411764706,>30,AUS,Away,Upto 2014
A Nel,SA,Pace,2006-03-16,Cape Town,South Africa,2006,2,70,176,2,1,563,1099,28,493,923,26,20.107142857142858,<=30,SA,Home,Upto 2014
A Nel,SA,Pace,2006-03-24,Durban,South Africa,2006,2,141,270,3,1,838,1637,23,697,1367,20,36.43478260869565,>30,SA,Home,Upto 2014
A Nel,SA,Pace,2006-03-31,Johannesburg,South Africa,2006,2,46,102,1,1,824,1490,30,778,1388,29,27.466666666666665,<=30,SA,Home,Upto 2014
A Nel,SA,Pace,2006-04-27,Cape Town,South Africa,2006,2,139,222,1,1,739,1386,13,600,1164,12,56.84615384615385,>30,SA,Home,Upto 2014
A Nel,SA,Pace,2006-07-27,Colombo (SSC),Sri Lanka,2006,1,114,151,1,1,781,1191,14,667,1040,13,55.785714285714285,>30,SL,Away,Upto 2014
A Nel,SA,Pace,2006-12-15,Johannesburg,South Africa,2006,2,103,227,4,1,728,1389,33,625,1162,29,22.060606060606062,<=30,SA,Home,Upto 2014
A Nel,SA,Pace,2006-12-26,Durban,South Africa,2006,2,117,234,5,1,879,1470,33,762,1236,28,26.636363636363637,<=30,SA,Home,Upto 2014
A Nel,SA,Pace,2007-01-11,Centurion,South Africa,2007,2,169,293,3,1,894,1492,25,725,1199,22,35.76,>30,SA,Home,Upto 2014
A Nel,SA,Pace,2007-01-19,Gqeberha,South Africa,2007,2,131,222,1,1,653,1296,27,522,1074,26,24.185185185185187,<=30,SA,Home,Upto 2014
A Nel,SA,Pace,2007-10-01,Karachi,Pakistan,2007,2,118,234,4,1,523,1031,16,405,797,12,32.6875,>30,PAK,Away,Upto 2014
A Nel,SA,Pace,2007-10-08,Lahore,Pakistan,2007,2,114,216,1,1,635,1158,14,521,942,13,45.357142857142854,>30,PAK,Away,Upto 2014
A Nel,SA,Pace,2007-11-08,Johannesburg,South Africa,2007,2,58,126,2,1,740,1372,29,682,1246,27,25.517241379310345,<=30,SA,Home,Upto 2014
A Nel,SA,Pace,2007-11-16,Centurion,South Africa,2007,2,62,120,2,1,609,994,26,547,874,24,23.423076923076923,<=30,SA,Home,Upto 2014
A Nel,SA,Pace,2007-12-26,Gqeberha,South Africa,2007,2,106,196,3,1,900,1655,32,794,1459,29,28.125,<=30,SA,Home,Upto 2014
A Nel,SA,Pace,2008-01-02,Cape Town,South Africa,2008,2,123,294,6,1,787,1720,28,664,1426,22,28.107142857142858,<=30,SA,Home,Upto 2014
A Nel,SA,Pace,2008-01-10,Durban,South Africa,2008,2,112,141,4,1,883,1304,22,771,1163,18,40.13636363636363,>30,SA,Home,Upto 2014
A Nel,SA,Pace,2008-07-30,Birmingham,England,2008,2,126,222,4,1,903,1618,29,777,1396,25,31.137931034482758,>30,ENG,Away,Upto 2014
A Nel,SA,Pace,2008-08-07,The Oval,England,2008,2,77,146,0,1,862,1540,26,785,1394,26,33.15384615384615,>30,ENG,Away,Upto 2014
A Nortje,SA,Pace,2019-10-10,Pune,India,2019,1,100,150,0,1,453,864,13,353,714,13,34.84615384615385,>30,IND,Away,After 1965
A Nortje,SA,Pace,2019-10-19,Ranchi,India,2019,1,79,147,1,1,354,633,14,275,486,13,25.285714285714285,<=30,IND,Away,After 1965
A Nortje,SA,Pace,2019-12-26,Centurion,South Africa,2019,2,103,174,5,1,888,1593,38,785,1419,33,23.36842105263158,<=30,SA,Home,After 1965
A Nortje,SA,Pace,2020-01-03,Cape Town,South Africa,2020,2,117,216,5,1,689,1635,31,572,1419,26,22.225806451612904,<=30,SA,Home,After 1965
A Nortje,SA,Pace,2020-01-16,Gqeberha,South Africa,2020,1,97,150,1,1,517,1029,13,420,879,12,39.76923076923077,>30,SA,Home,After 1965
A Nortje,SA,Pace,2020-01-24,Johannesburg,South Africa,2020,2,171,210,7,1,1022,1773,39,851,1563,32,26.205128205128204,<=30,SA,Home,After 1965
A Nortje,SA,Pace,2020-12-26,Centurion,South Africa,2020,2,135,193,3,1,827,1226,23,692,1033,20,35.95652173913044,>30,SA,Home,After 1965
A Nortje,SA,Pace,2021-01-03,Johannesburg,South Africa,2021,2,120,201,8,1,660,1080,30,540,879,22,22.0,<=30,SA,Home,After 1965
A Nortje,SA,Pace,2021-01-26,Karachi,Pakistan,2021,2,129,204,4,1,546,968,13,417,764,9,42.0,>30,PAK,Away,After 1965
A Nortje,SA,Pace,2021-02-04,Rawalpindi,Pakistan,2021,2,113,249,5,1,534,1105,24,421,856,19,22.25,<=30,PAK,Away,After 1965
A Nortje,SA,Pace,2021-06-10,Gros Islet,West Indies,2021,2,81,150,7,1,458,958,27,377,808,20,16.962962962962962,<=30,WI,Away,After 1965
A Nortje,SA,Pace,2021-06-18,Gros Islet,West Indies,2021,2,76,138,1,1,606,1318,31,530,1180,30,19.548387096774192,<=30,WI,Away,After 1965
A Nortje,SA,Pace,2022-08-17,Lord's,England,2022,2,110,120,6,1,531,875,27,421,755,21,19.666666666666668,<=30,ENG,Away,After 1965
A Nortje,SA,Pace,2022-08-25,Manchester,England,2022,1,82,120,3,1,514,991,25,432,871,22,20.56,<=30,ENG,Away,After 1965
A Nortje,SA,Pace,2022-09-08,The Oval,England,2022,2,56,78,1,1,547,897,31,491,819,30,17.64516129032258,<=30,ENG,Away,After 1965
A Nortje,SA,Pace,2022-12-17,Brisbane,Australia,2022,2,70,101,2,1,432,770,30,362,669,28,14.4,<=30,AUS,Away,After 1965
A Nortje,SA,Pace,2022-12-26,Melbourne,Australia,2022,1,92,150,3,1,684,1223,19,592,1073,16,36.0,>30,AUS,Away,After 1965
A Nortje,SA,Pace,2023-01-04,Sydney,Australia,2023,1,55,132,2,1,386,804,12,331,672,10,32.166666666666664,>30,AUS,Away,After 1965
A Nortje,SA,Pace,2023-02-28,Centurion,South Africa,2023,2,84,174,6,1,738,1209,39,654,1035,33,18.923076923076923,<=30,SA,Home,After 1965
A Phillip,WI,Pace,2022-06-24,Gros Islet,West Indies,2022,2,53,84,2,1,658,1090,26,605,1006,24,25.307692307692307,<=30,WI,Home,After 1965
A Phillip,WI,Pace,2022-12-08,Adelaide,Australia,2022,2,159,192,1,1,712,1214,23,553,1022,22,30.956521739130434,>30,AUS,Away,After 1965
A Ranatunga,SL,Pace,1982-09-17,Chennai,India,1982,1,12,6,0,1,686,896,18,674,890,18,38.111111111111114,>30,IND,Away,Upto 2014
A Ranatunga,SL,Pace,1983-04-22,Kandy,Sri Lanka,1983,1,72,114,1,1,440,696,7,368,582,6,62.857142857142854,>30,SL,Home,Upto 2014
A Ranatunga,SL,Pace,1984-03-09,Kandy,Sri Lanka,1984,2,31,78,2,1,359,767,20,328,689,18,17.95,<=30,SL,Home,Upto 2014
A Ranatunga,SL,Pace,1984-03-16,Colombo (SSC),Sri Lanka,1984,2,40,132,2,1,563,1643,28,523,1511,26,20.107142857142858,<=30,SL,Home,Upto 2014
A Ranatunga,SL,Pace,1984-03-24,Colombo (CCC),Sri Lanka,1984,1,18,96,0,1,479,1056,21,461,960,21,22.80952380952381,<=30,SL,Home,Upto 2014
A Ranatunga,SL,Pace,1984-08-23,Lord's,England,1984,1,0,6,0,1,850,1633,19,850,1627,19,44.73684210526316,>30,ENG,Away,Upto 2014
A Ranatunga,SL,Pace,1985-08-30,Colombo (SSC),Sri Lanka,1985,2,13,96,0,1,634,1521,27,621,1425,27,23.48148148148148,<=30,SL,Home,Upto 2014
A Ranatunga,SL,Pace,1985-09-06,Colombo (PSS),Sri Lanka,1985,2,27,54,1,1,740,1533,28,713,1479,27,26.428571428571427,<=30,SL,Home,Upto 2014
A Ranatunga,SL,Pace,1985-09-14,Kandy,Sri Lanka,1985,2,62,144,1,1,808,1515,25,746,1371,24,32.32,>30,SL,Home,Upto 2014
A Ranatunga,SL,Pace,1985-10-16,Faisalabad,Pakistan,1985,1,74,108,0,1,718,1505,9,644,1397,9,79.77777777777777,>30,PAK,Away,Upto 2014
A Ranatunga,SL,Pace,1985-10-27,Sialkot,Pakistan,1985,1,18,18,0,1,662,1204,31,644,1186,31,21.35483870967742,<=30,PAK,Away,Upto 2014
A Ranatunga,SL,Pace,1985-11-07,Karachi,Pakistan,1985,1,1,6,0,1,402,787,17,401,781,17,23.647058823529413,<=30,PAK,Away,Upto 2014
A Ranatunga,SL,Pace,1986-02-23,Kandy,Sri Lanka,1986,1,30,87,1,1,238,611,14,208,524,13,17.0,<=30,SL,Home,Upto 2014
A Ranatunga,SL,Pace,1986-03-14,Colombo (CCC),Sri Lanka,1986,1,12,6,0,1,530,1137,31,518,1131,31,17.096774193548388,<=30,SL,Home,Upto 2014
A Ranatunga,SL,Pace,1986-03-22,Colombo (PSS),Sri Lanka,1986,1,26,66,1,1,728,1538,20,702,1472,19,36.4,>30,SL,Home,Upto 2014
A Ranatunga,SL,Pace,1986-12-17,Kanpur,India,1986,1,58,90,0,1,810,1291,13,752,1201,13,62.30769230769231,>30,IND,Away,Upto 2014
A Ranatunga,SL,Pace,1986-12-27,Nagpur,India,1986,1,34,36,0,1,372,581,7,338,545,7,53.142857142857146,>30,IND,Away,Upto 2014
A Ranatunga,SL,Pace,1987-01-04,Cuttack,India,1987,1,5,24,0,1,333,711,12,328,687,12,27.75,<=30,IND,Away,Upto 2014
A Ranatunga,SL,Pace,1987-04-16,Colombo (CCC),Sri Lanka,1987,1,43,138,0,1,574,1325,10,531,1187,10,57.4,>30,SL,Home,Upto 2014
A Ranatunga,SL,Pace,1988-02-12,W.A.C.A,Australia,1988,1,18,48,0,1,710,1536,29,692,1488,29,24.482758620689655,<=30,AUS,Away,Upto 2014
A Ranatunga,SL,Pace,1988-08-25,Lord's,England,1988,2,20,88,2,1,947,1904,31,927,1816,29,30.548387096774192,>30,ENG,Away,Upto 2014
A Ranatunga,SL,Pace,1989-12-08,Brisbane,Australia,1989,2,74,114,0,1,901,1884,23,827,1770,23,39.17391304347826,>30,AUS,Away,Upto 2014
A Ranatunga,SL,Pace,1990-11-23,Chandigarh,India,1990,1,4,30,0,1,244,603,12,240,573,12,20.333333333333332,<=30,IND,Away,Upto 2014
A Ranatunga,SL,Pace,1991-01-31,Wellington,New Zealand,1991,1,60,117,2,1,940,1788,23,880,1671,21,40.869565217391305,>30,NZ,Away,Upto 2014
A Ranatunga,SL,Pace,1991-02-22,Hamilton,New Zealand,1991,1,34,82,1,1,916,2000,25,882,1918,24,36.64,>30,NZ,Away,Upto 2014
A Ranatunga,SL,Pace,1991-03-01,Auckland,New Zealand,1991,1,23,42,0,1,890,1772,29,867,1730,29,30.689655172413794,>30,NZ,Away,Upto 2014
A Ranatunga,SL,Pace,1991-12-20,Gujranwala,Pakistan,1991,1,0,6,0,1,97,210,2,97,204,2,48.5,>30,PAK,Away,Upto 2014
A Ranatunga,SL,Pace,1992-01-02,Faisalabad,Pakistan,1992,1,2,18,0,1,743,1706,36,741,1688,36,20.63888888888889,<=30,PAK,Away,Upto 2014
A Ranatunga,SL,Pace,1992-09-08,Moratuwa,Sri Lanka,1992,1,9,6,0,1,511,1044,22,502,1038,22,23.227272727272727,<=30,SL,Home,Upto 2014
A Ranatunga,SL,Pace,1992-11-27,Moratuwa,Sri Lanka,1992,2,31,60,0,1,602,1223,13,571,1163,13,46.30769230769231,>30,SL,Home,Upto 2014
A Ranatunga,SL,Pace,1993-03-13,Colombo (SSC),Sri Lanka,1993,1,11,18,0,1,382,857,11,371,839,11,34.72727272727273,>30,SL,Home,Upto 2014
A Ranatunga,SL,Pace,1993-07-27,Colombo (SSC),Sri Lanka,1993,1,5,12,0,1,627,1409,18,622,1397,18,34.833333333333336,>30,SL,Home,Upto 2014
A Ranatunga,SL,Pace,1993-08-04,Colombo (PSS),Sri Lanka,1993,1,2,24,0,1,384,1057,10,382,1033,10,38.4,>30,SL,Home,Upto 2014
A Ranatunga,SL,Pace,1993-09-06,Colombo (SSC),Sri Lanka,1993,1,6,12,0,1,464,972,21,458,960,21,22.095238095238095,<=30,SL,Home,Upto 2014
A Ranatunga,SL,Pace,1993-12-08,Moratuwa,Sri Lanka,1993,1,6,24,0,1,179,537,9,173,513,9,19.88888888888889,<=30,SL,Home,Upto 2014
A Ranatunga,SL,Pace,1994-01-18,Lucknow,India,1994,1,1,18,0,1,249,514,6,248,496,6,41.5,>30,IND,Away,Upto 2014
A Ranatunga,SL,Pace,1994-01-26,Bengaluru,India,1994,1,14,24,0,1,326,460,11,312,436,11,29.636363636363637,<=30,IND,Away,Upto 2014
A Ranatunga,SL,Pace,1994-02-08,Ahmedabad,India,1994,1,15,48,0,1,174,408,3,159,360,3,58.0,>30,IND,Away,Upto 2014
A Ranatunga,SL,Pace,1994-10-11,Harare,Zimbabwe,1994,1,9,12,0,1,445,1241,16,436,1229,16,27.8125,<=30,ZIM,Away,Upto 2014
A Ranatunga,SL,Pace,1994-10-26,Harare,Zimbabwe,1994,1,22,54,0,1,659,1576,19,637,1522,19,34.68421052631579,>30,ZIM,Away,Upto 2014
A Ranatunga,SL,Pace,1997-03-07,Dunedin,New Zealand,1997,1,29,30,1,1,739,1295,21,710,1265,20,35.19047619047619,>30,NZ,Away,Upto 2014
A Ranatunga,SL,Pace,1997-04-19,Colombo (RPS),Sri Lanka,1997,1,5,18,0,1,337,618,3,332,600,3,112.33333333333333,>30,SL,Home,Upto 2014
A Ranatunga,SL,Pace,1997-04-26,Colombo (SSC),Sri Lanka,1997,1,8,25,0,1,378,693,12,370,668,12,31.5,>30,SL,Home,Upto 2014
A Ranatunga,SL,Pace,1997-11-19,Mohali,India,1997,1,0,18,0,1,565,1196,16,565,1178,16,35.3125,>30,IND,Away,Upto 2014
A Ranatunga,SL,Pace,1997-11-26,Nagpur,India,1997,1,8,6,0,1,210,384,7,202,378,7,30.0,<=30,IND,Away,Upto 2014
A Ranatunga,SL,Pace,1997-12-03,Wankhede,India,1997,1,35,102,1,1,639,1269,12,604,1167,11,53.25,>30,IND,Away,Upto 2014
A Ranatunga,SL,Pace,2000-06-14,Colombo (SSC),Sri Lanka,2000,1,0,6,0,1,461,1090,17,461,1084,17,27.11764705882353,<=30,SL,Home,Upto 2014
A Ranatunga,SL,Pace,2000-06-21,Galle,Sri Lanka,2000,1,13,6,0,1,578,1128,20,565,1122,20,28.9,<=30,SL,Home,Upto 2014
A Ratra,IND,Pace,2002-05-10,St John's,West Indies,2002,1,1,6,0,1,856,1992,11,855,1986,11,77.81818181818181,>30,WI,Away,Upto 2014
A Rose-Innes,SA,Spin,1889-03-12,Gqeberha,South Africa,1889,2,59,80,5,1,137,346,12,78,266,7,11.416666666666666,<=30,SA,Home,After 1965
A Rose-Innes,SA,Spin,1889-03-25,Cape Town,South Africa,1889,1,30,48,0,1,74,207,15,44,159,15,4.933333333333334,<=30,SA,Home,After 1965
A Sanford,WI,Pace,2002-04-11,Georgetown,West Indies,2002,1,81,150,2,1,506,1071,12,425,921,10,42.166666666666664,>30,WI,Home,Upto 2014
A Sanford,WI,Pace,2002-04-19,Port of Spain,West Indies,2002,2,157,276,5,1,849,1915,33,692,1639,28,25.727272727272727,<=30,WI,Home,Upto 2014
A Sanford,WI,Pace,2002-05-02,Bridgetown,West Indies,2002,2,98,124,4,1,655,1356,22,557,1232,18,29.772727272727273,<=30,WI,Home,Upto 2014
A Sanford,WI,Pace,2002-05-10,St John's,West Indies,2002,1,113,192,0,1,856,1992,11,743,1800,11,77.81818181818181,>30,WI,Home,Upto 2014
A Sanford,WI,Pace,2002-05-18,Kingston,West Indies,2002,2,75,168,4,1,844,1737,30,769,1569,26,28.133333333333333,<=30,WI,Home,Upto 2014
A Sanford,WI,Pace,2002-06-21,Bridgetown,West Indies,2002,2,169,274,4,1,787,1616,30,618,1342,26,26.233333333333334,<=30,WI,Home,Upto 2014
A Sanford,WI,Pace,2002-06-28,St George's,West Indies,2002,2,101,221,1,1,623,1356,15,522,1135,14,41.53333333333333,>30,WI,Home,Upto 2014
A Sanford,WI,Pace,2003-12-26,Durban,South Africa,2003,1,170,230,3,1,1030,1831,26,860,1601,23,39.61538461538461,>30,SA,Away,Upto 2014
A Sanford,WI,Pace,2004-01-02,Cape Town,South Africa,2004,2,170,270,4,1,1140,1873,23,970,1603,19,49.56521739130435,>30,SA,Away,Upto 2014
A Sanford,WI,Pace,2004-03-11,Kingston,West Indies,2004,1,90,132,1,1,561,1123,25,471,991,24,22.44,<=30,WI,Home,Upto 2014
A Sanford,WI,Pace,2004-03-19,Port of Spain,West Indies,2004,2,92,180,2,1,720,1489,29,628,1309,27,24.82758620689655,<=30,WI,Home,Upto 2014
A Shahzad,ENG,Pace,2010-06-04,Manchester,England,2010,2,63,102,4,1,268,480,16,205,378,12,16.75,<=30,ENG,Home,Upto 2014
A Shaw,ENG,Spin,1877-03-15,Melbourne,Australia,1877,2,89,359,8,1,437,1296,31,348,937,23,14.096774193548388,<=30,AUS,Away,After 1965
A Shaw,ENG,Spin,1877-03-31,Melbourne,Australia,1877,2,57,296,0,1,437,1222,21,380,926,21,20.80952380952381,<=30,AUS,Away,After 1965
A Shaw,ENG,Spin,1880-09-06,The Oval,England,1880,2,63,184,2,1,721,1528,21,658,1344,19,34.333333333333336,>30,ENG,Home,After 1965
A Shaw,ENG,Spin,1881-12-31,Melbourne,Australia,1881,1,21,80,0,1,812,2321,24,791,2241,24,33.833333333333336,>30,AUS,Away,After 1965
A Shaw,ENG,Spin,1882-02-17,Sydney,Australia,1882,1,12,81,1,1,520,1846,24,508,1765,23,21.666666666666668,<=30,AUS,Away,After 1965
A Shaw,ENG,Spin,1882-03-03,Sydney,Australia,1882,1,14,32,0,1,374,1277,25,360,1245,25,14.96,<=30,AUS,Away,After 1965
A Shaw,ENG,Spin,1882-03-10,Melbourne,Australia,1882,1,29,64,1,1,397,773,12,368,709,11,33.083333333333336,>30,AUS,Away,After 1965
A Shrewsbury snr,ENG,Spin,1884-08-11,The Oval,England,1884,1,2,12,0,1,469,1036,14,467,1024,14,33.5,>30,ENG,Home,After 1965
A Sidebottom,ENG,Pace,1985-07-11,Nottingham,England,1985,1,65,112,1,1,706,1344,15,641,1232,14,47.06666666666667,>30,ENG,Home,Upto 2014
A Symonds,AUS,Spin,2004-03-08,Galle,Sri Lanka,2004,1,68,114,1,1,953,1791,32,885,1677,31,29.78125,<=30,SL,Away,Upto 2014
A Symonds,AUS,Spin,2004-03-16,Kandy,Sri Lanka,2004,2,17,30,0,1,537,881,19,520,851,19,28.263157894736842,<=30,SL,Away,Upto 2014
A Symonds,AUS,Spin,2005-11-17,Hobart,Australia,2005,2,26,90,0,1,310,697,10,284,607,10,31.0,>30,AUS,Home,Upto 2014
A Symonds,AUS,Spin,2005-11-25,Adelaide,Australia,2005,2,53,108,1,1,347,668,10,294,560,9,34.7,>30,AUS,Home,Upto 2014
A Symonds,AUS,Spin,2005-12-16,W.A.C.A,Australia,2005,1,6,18,0,1,218,526,6,212,508,6,36.333333333333336,>30,AUS,Home,Upto 2014
A Symonds,AUS,Spin,2005-12-26,Melbourne,Australia,2005,2,56,144,5,1,426,859,14,370,715,9,30.428571428571427,>30,AUS,Home,Upto 2014
A Symonds,AUS,Spin,2006-01-02,Sydney,Australia,2006,1,69,138,1,1,507,813,9,438,675,8,56.333333333333336,>30,AUS,Home,Upto 2014
A Symonds,AUS,Spin,2006-03-16,Cape Town,South Africa,2006,1,22,60,0,1,224,354,5,202,294,5,44.8,>30,SA,Away,Upto 2014
A Symonds,AUS,Spin,2006-03-24,Durban,South Africa,2006,2,48,114,0,1,362,753,11,314,639,11,32.90909090909091,>30,SA,Away,Upto 2014
A Symonds,AUS,Spin,2006-03-31,Johannesburg,South Africa,2006,2,44,78,1,1,258,450,7,214,372,6,36.857142857142854,>30,SA,Away,Upto 2014
A Symonds,AUS,Spin,2006-12-14,W.A.C.A,Australia,2006,2,36,78,2,1,460,746,15,424,668,13,30.666666666666668,>30,AUS,Home,Upto 2014
A Symonds,AUS,Spin,2006-12-26,Melbourne,Australia,2006,1,17,42,0,1,167,338,7,150,296,7,23.857142857142858,<=30,AUS,Home,Upto 2014
A Symonds,AUS,Spin,2007-01-02,Sydney,Australia,2007,2,26,66,0,1,208,355,4,182,289,4,52.0,>30,AUS,Home,Upto 2014
A Symonds,AUS,Spin,2007-11-08,Brisbane,Australia,2007,2,31,66,2,1,370,696,6,339,630,4,61.666666666666664,>30,AUS,Home,Upto 2014
A Symonds,AUS,Spin,2007-12-26,Melbourne,Australia,2007,2,33,96,1,1,518,912,15,485,816,14,34.53333333333333,>30,AUS,Home,Upto 2014
A Symonds,AUS,Spin,2008-01-02,Sydney,Australia,2008,2,70,156,3,1,764,1280,20,694,1124,17,38.2,>30,AUS,Home,Upto 2014
A Symonds,AUS,Spin,2008-01-16,W.A.C.A,Australia,2008,2,72,120,3,1,288,498,9,216,378,6,32.0,>30,AUS,Home,Upto 2014
A Symonds,AUS,Spin,2008-01-24,Adelaide,Australia,2008,2,72,174,2,1,579,1086,9,507,912,7,64.33333333333333,>30,AUS,Home,Upto 2014
A Symonds,AUS,Spin,2008-05-22,Kingston,West Indies,2008,1,15,66,0,1,254,420,5,239,354,5,50.8,>30,WI,Away,Upto 2014
A Symonds,AUS,Spin,2008-05-30,North Sound,West Indies,2008,2,35,90,0,1,298,516,3,263,426,3,99.33333333333333,>30,WI,Away,Upto 2014
A Symonds,AUS,Spin,2008-06-12,Bridgetown,West Indies,2008,2,23,60,1,1,440,864,10,417,804,9,44.0,>30,WI,Away,Upto 2014
A Symonds,AUS,Spin,2008-11-20,Brisbane,Australia,2008,2,16,30,0,1,95,204,3,79,174,3,31.666666666666668,>30,AUS,Home,Upto 2014
A Symonds,AUS,Spin,2008-11-28,Adelaide,Australia,2008,1,17,72,1,1,283,706,9,266,634,8,31.444444444444443,>30,AUS,Home,Upto 2014
A Symonds,AUS,Spin,2008-12-17,W.A.C.A,Australia,2008,1,10,18,0,1,404,648,6,394,630,6,67.33333333333333,>30,AUS,Home,Upto 2014
A Symonds,AUS,Spin,2008-12-26,Melbourne,Australia,2008,1,14,66,0,1,278,678,5,264,612,5,55.6,>30,AUS,Home,Upto 2014
A Waddington,ENG,Pace,1920-12-17,Sydney,Australia,1920,2,88,246,1,1,483,1134,15,395,888,14,32.2,>30,AUS,Away,Upto 2014
A Waddington,ENG,Pace,1921-02-11,Melbourne,Australia,1921,1,31,30,0,1,517,1056,6,486,1026,6,86.16666666666667,>30,AUS,Away,Upto 2014
A Ward,ENG,Pace,1969-07-24,Lord's,England,1969,2,97,149,4,1,463,1142,17,366,993,13,27.235294117647058,<=30,ENG,Home,Upto 2014
A Ward,ENG,Pace,1969-08-07,Nottingham,England,1969,2,75,156,4,1,534,1193,14,459,1037,10,38.142857142857146,>30,ENG,Home,Upto 2014
A Ward,ENG,Pace,1969-08-21,The Oval,England,1969,2,38,138,2,1,397,1023,15,359,885,13,26.466666666666665,<=30,ENG,Home,Upto 2014
A Ward,ENG,Pace,1971-06-03,Birmingham,England,1971,1,115,174,0,1,653,1403,13,538,1229,13,50.23076923076923,>30,ENG,Home,Upto 2014
A Ward,ENG,Pace,1976-07-22,Leeds,England,1976,2,128,144,4,1,969,1786,39,841,1642,35,24.846153846153847,<=30,ENG,Home,Upto 2014
A Warren,ENG,Pace,1905-07-03,Leeds,England,1905,2,113,236,6,1,525,1232,17,412,996,11,30.88235294117647,>30,ENG,Home,Upto 2014
AA Baig,IND,Spin,1960-01-01,Brabourne,India,1960,1,13,12,0,1,351,876,9,338,864,9,39.0,>30,IND,Home,Upto 2014
AA Baig,IND,Spin,1960-12-16,Kanpur,India,1960,1,2,6,0,1,619,1984,16,617,1978,16,38.6875,>30,IND,Home,Upto 2014
AA Donald,SA,Pace,1992-04-18,Bridgetown,West Indies,1992,2,144,270,6,1,919,1991,34,775,1721,28,27.029411764705884,<=30,WI,Away,Upto 2014
AA Donald,SA,Pace,1992-11-13,Durban,South Africa,1992,1,69,174,1,1,480,1371,14,411,1197,13,34.285714285714285,>30,SA,Home,Upto 2014
AA Donald,SA,Pace,1992-11-26,Johannesburg,South Africa,1992,2,121,306,5,1,741,2035,23,620,1729,18,32.21739130434783,>30,SA,Home,Upto 2014
AA Donald,SA,Pace,1992-12-26,Gqeberha,South Africa,1992,2,139,330,12,1,485,1194,23,346,864,11,21.08695652173913,<=30,SA,Home,Upto 2014
AA Donald,SA,Pace,1993-01-02,Cape Town,South Africa,1993,2,65,240,2,1,434,1582,19,369,1342,17,22.842105263157894,<=30,SA,Home,Upto 2014
AA Donald,SA,Pace,1993-08-25,Moratuwa,Sri Lanka,1993,2,142,300,6,1,501,1154,19,359,854,13,26.36842105263158,<=30,SL,Away,Upto 2014
AA Donald,SA,Pace,1993-09-06,Colombo (SSC),Sri Lanka,1993,2,28,132,4,1,464,972,21,436,840,17,22.095238095238095,<=30,SL,Away,Upto 2014
AA Donald,SA,Pace,1993-09-14,Colombo (PSS),Sri Lanka,1993,1,62,180,2,1,422,1175,13,360,995,11,32.46153846153846,>30,SL,Away,Upto 2014
AA Donald,SA,Pace,1993-12-26,Melbourne,Australia,1993,1,108,180,1,1,399,858,6,291,678,5,66.5,>30,AUS,Away,Upto 2014
AA Donald,SA,Pace,1994-01-02,Sydney,Australia,1994,2,117,290,7,1,459,1326,25,342,1036,18,18.36,<=30,AUS,Away,Upto 2014
AA Donald,SA,Pace,1994-01-28,Adelaide,Australia,1994,2,148,294,5,1,661,1638,23,513,1344,18,28.73913043478261,<=30,AUS,Away,Upto 2014
AA Donald,SA,Pace,1994-03-04,Johannesburg,South Africa,1994,2,157,252,5,1,852,1646,28,695,1394,23,30.428571428571427,>30,SA,Home,Upto 2014
AA Donald,SA,Pace,1994-03-17,Cape Town,South Africa,1994,2,131,240,1,1,830,1910,22,699,1670,21,37.72727272727273,>30,SA,Home,Upto 2014
AA Donald,SA,Pace,1994-03-25,Durban,South Africa,1994,2,137,276,6,1,810,2116,20,673,1840,14,40.5,>30,SA,Home,Upto 2014
AA Donald,SA,Pace,1994-07-21,Lord's,England,1994,2,103,189,7,1,636,1408,31,533,1219,24,20.516129032258064,<=30,ENG,Away,Upto 2014
AA Donald,SA,Pace,1994-08-04,Leeds,England,1994,1,135,174,1,1,1145,2209,21,1010,2035,20,54.523809523809526,>30,ENG,Away,Upto 2014
AA Donald,SA,Pace,1994-08-18,The Oval,England,1994,2,172,174,4,1,962,1490,30,790,1316,26,32.06666666666667,>30,ENG,Away,Upto 2014
AA Donald,SA,Pace,1995-01-19,Johannesburg,South Africa,1995,2,116,192,4,1,915,1724,33,799,1532,29,27.727272727272727,<=30,SA,Home,Upto 2014
AA Donald,SA,Pace,1995-03-04,Auckland,New Zealand,1995,2,132,244,5,1,789,1800,31,657,1556,26,25.451612903225808,<=30,NZ,Away,Upto 2014
AA Donald,SA,Pace,1995-10-13,Harare,Zimbabwe,1995,2,113,301,11,1,728,1549,32,615,1248,21,22.75,<=30,ZIM,Away,Upto 2014
AA Donald,SA,Pace,1995-11-16,Centurion,South Africa,1995,1,92,198,2,1,364,846,9,272,648,7,40.44444444444444,>30,SA,Home,Upto 2014
AA Donald,SA,Pace,1995-11-30,Johannesburg,South Africa,1995,2,144,300,4,1,999,2058,30,855,1758,26,33.3,>30,SA,Home,Upto 2014
AA Donald,SA,Pace,1995-12-14,Durban,South Africa,1995,1,57,73,2,1,320,703,12,263,630,10,26.666666666666668,<=30,SA,Home,Upto 2014
AA Donald,SA,Pace,1995-12-26,Gqeberha,South Africa,1995,2,109,268,4,1,681,1783,21,572,1515,17,32.42857142857143,>30,SA,Home,Upto 2014
AA Donald,SA,Pace,1996-01-02,Cape Town,South Africa,1996,2,95,204,7,1,418,1109,22,323,905,15,19.0,<=30,SA,Home,Upto 2014
AA Donald,SA,Pace,1996-11-20,Ahmedabad,India,1996,2,69,252,7,1,335,936,19,266,684,12,17.63157894736842,<=30,IND,Away,Upto 2014
AA Donald,SA,Pace,1996-11-27,Eden Gardens,India,1996,1,72,128,3,1,704,1315,23,632,1187,20,30.608695652173914,>30,IND,Away,Upto 2014
AA Donald,SA,Pace,1996-12-26,Durban,South Africa,1996,2,54,163,9,1,537,1172,37,483,1009,28,14.513513513513514,<=30,SA,Home,Upto 2014
AA Donald,SA,Pace,1997-01-02,Cape Town,South Africa,1997,2,139,252,5,1,897,1609,22,758,1357,17,40.77272727272727,>30,SA,Home,Upto 2014
AA Donald,SA,Pace,1997-01-16,Johannesburg,South Africa,1997,2,126,301,6,1,895,1774,26,769,1473,20,34.42307692307692,>30,SA,Home,Upto 2014
AA Donald,SA,Pace,1997-02-28,Johannesburg,South Africa,1997,1,136,210,2,1,660,1282,14,524,1072,12,47.142857142857146,>30,SA,Home,Upto 2014
AA Donald,SA,Pace,1997-03-14,Gqeberha,South Africa,1997,2,93,294,1,1,528,1387,24,435,1093,23,22.0,<=30,SA,Home,Upto 2014
AA Donald,SA,Pace,1997-03-21,Centurion,South Africa,1997,2,96,228,8,1,500,1229,28,404,1001,20,17.857142857142858,<=30,SA,Home,Upto 2014
AA Donald,SA,Pace,1997-10-06,Rawalpindi,Pakistan,1997,2,133,264,4,1,556,1227,14,423,963,10,39.714285714285715,>30,PAK,Away,Upto 2014
AA Donald,SA,Pace,1997-10-24,Faisalabad,Pakistan,1997,2,93,142,3,1,482,896,25,389,754,22,19.28,<=30,PAK,Away,Upto 2014
AA Donald,SA,Pace,1997-12-26,Melbourne,Australia,1997,2,133,336,9,1,627,1621,23,494,1285,14,27.26086956521739,<=30,AUS,Away,Upto 2014
AA Donald,SA,Pace,1998-01-02,Sydney,Australia,1998,1,81,184,3,1,405,1054,13,324,870,10,31.153846153846153,>30,AUS,Away,Upto 2014
AA Donald,SA,Pace,1998-02-14,Johannesburg,South Africa,1998,1,89,138,2,1,551,982,15,462,844,13,36.733333333333334,>30,SA,Home,Upto 2014
AA Donald,SA,Pace,1998-02-26,Durban,South Africa,1998,2,99,176,6,1,733,1519,29,634,1343,23,25.275862068965516,<=30,SA,Home,Upto 2014
AA Donald,SA,Pace,1998-03-06,Gqeberha,South Africa,1998,2,74,168,8,1,625,1400,33,551,1232,25,18.939393939393938,<=30,SA,Home,Upto 2014
AA Donald,SA,Pace,1998-03-19,Cape Town,South Africa,1998,2,130,249,6,1,757,1378,22,627,1129,16,34.40909090909091,>30,SA,Home,Upto 2014
AA Donald,SA,Pace,1998-03-27,Centurion,South Africa,1998,2,127,279,8,1,463,1134,19,336,855,11,24.36842105263158,<=30,SA,Home,Upto 2014
AA Donald,SA,Pace,1998-06-04,Birmingham,England,1998,2,143,270,6,1,706,1575,23,563,1305,17,30.695652173913043,>30,ENG,Away,Upto 2014
AA Donald,SA,Pace,1998-06-18,Lord's,England,1998,2,114,237,5,1,618,1463,26,504,1226,21,23.76923076923077,<=30,ENG,Away,Upto 2014
AA Donald,SA,Pace,1998-07-02,Manchester,England,1998,2,116,318,8,1,671,1668,18,555,1350,10,37.27777777777778,>30,ENG,Away,Upto 2014
AA Donald,SA,Pace,1998-07-23,Nottingham,England,1998,2,165,336,6,1,995,2152,32,830,1816,26,31.09375,>30,ENG,Away,Upto 2014
AA Donald,SA,Pace,1998-08-06,Leeds,England,1998,2,115,299,8,1,826,2084,40,711,1785,32,20.65,<=30,ENG,Away,Upto 2014
AA Donald,SA,Pace,1998-11-26,Johannesburg,South Africa,1998,2,119,228,4,1,642,1519,31,523,1291,27,20.70967741935484,<=30,SA,Home,Upto 2014
AA Donald,SA,Pace,1998-12-10,Gqeberha,South Africa,1998,2,82,146,7,1,639,1208,36,557,1062,29,17.75,<=30,SA,Home,Upto 2014
AA Donald,SA,Pace,1998-12-26,Durban,South Africa,1998,2,117,204,3,1,645,1347,28,528,1143,25,23.035714285714285,<=30,SA,Home,Upto 2014
AA Donald,SA,Pace,1999-01-02,Cape Town,South Africa,1999,1,20,36,3,1,785,1771,27,765,1735,24,29.074074074074073,<=30,SA,Home,Upto 2014
AA Donald,SA,Pace,1999-01-15,Centurion,South Africa,1999,2,57,90,6,1,776,1416,26,719,1326,20,29.846153846153847,<=30,SA,Home,Upto 2014
AA Donald,SA,Pace,1999-02-27,Auckland,New Zealand,1999,2,60,216,2,1,841,1949,13,781,1733,11,64.6923076923077,>30,NZ,Away,Upto 2014
AA Donald,SA,Pace,1999-03-11,Christchurch,New Zealand,1999,1,54,107,3,1,581,1404,8,527,1297,5,72.625,>30,NZ,Away,Upto 2014
AA Donald,SA,Pace,1999-10-29,Bloemfontein,South Africa,1999,2,83,198,1,1,728,1549,24,645,1351,23,30.333333333333332,>30,SA,Home,Upto 2014
AA Donald,SA,Pace,1999-11-11,Harare,Zimbabwe,1999,2,35,114,2,1,560,1277,25,525,1163,23,22.4,<=30,ZIM,Away,Upto 2014
AA Donald,SA,Pace,1999-11-25,Johannesburg,South Africa,1999,2,127,228,11,1,668,1442,28,541,1214,17,23.857142857142858,<=30,SA,Home,Upto 2014
AA Donald,SA,Pace,1999-12-09,Gqeberha,South Africa,1999,2,146,282,3,1,939,2119,25,793,1837,22,37.56,>30,SA,Home,Upto 2014
AA Donald,SA,Pace,1999-12-26,Durban,South Africa,1999,1,67,142,2,1,784,1865,22,717,1723,20,35.63636363636363,>30,SA,Home,Upto 2014
AA Donald,SA,Pace,2000-01-02,Cape Town,South Africa,2000,2,82,220,6,1,594,1440,24,512,1220,18,24.75,<=30,SA,Home,Upto 2014
AA Donald,SA,Pace,2000-02-24,Wankhede,India,2000,2,46,180,4,1,367,874,21,321,694,17,17.476190476190474,<=30,IND,Away,Upto 2014
AA Donald,SA,Pace,2000-03-02,Bengaluru,India,2000,2,87,168,3,1,357,999,12,270,831,9,29.75,<=30,IND,Away,Upto 2014
AA Donald,SA,Pace,2000-11-17,Bloemfontein,South Africa,2000,2,112,294,6,1,906,1955,31,794,1661,25,29.225806451612904,<=30,SA,Home,Upto 2014
AA Donald,SA,Pace,2000-11-30,Gqeberha,South Africa,2000,2,85,201,5,1,698,1864,30,613,1663,25,23.266666666666666,<=30,SA,Home,Upto 2014
AA Donald,SA,Pace,2001-01-20,Centurion,South Africa,2001,2,67,96,3,1,628,1061,26,561,965,23,24.153846153846153,<=30,SA,Home,Upto 2014
AA Donald,SA,Pace,2001-03-09,Georgetown,West Indies,2001,2,94,258,3,1,709,1722,18,615,1464,15,39.388888888888886,>30,WI,Away,Upto 2014
AA Donald,SA,Pace,2001-03-17,Port of Spain,West Indies,2001,2,123,270,6,1,814,1972,34,691,1702,28,23.941176470588236,<=30,WI,Away,Upto 2014
AA Donald,SA,Pace,2001-03-29,Bridgetown,West Indies,2001,1,30,84,0,1,750,1752,22,720,1668,22,34.09090909090909,>30,WI,Away,Upto 2014
AA Donald,SA,Pace,2001-04-19,Kingston,West Indies,2001,2,108,270,5,1,641,1770,33,533,1500,28,19.424242424242426,<=30,WI,Away,Upto 2014
AA Donald,SA,Pace,2001-12-26,Melbourne,Australia,2001,2,107,186,3,1,710,1446,22,603,1260,19,32.27272727272727,>30,AUS,Away,Upto 2014
AA Donald,SA,Pace,2002-01-02,Sydney,Australia,2002,2,131,204,1,1,596,1002,11,465,798,10,54.18181818181818,>30,AUS,Away,Upto 2014
AA Donald,SA,Pace,2002-02-22,Johannesburg,South Africa,2002,1,72,92,1,1,698,1059,20,626,967,19,34.9,>30,SA,Home,Upto 2014
AA Mailey,AUS,Spin,1920-12-17,Sydney,Australia,1920,2,200,282,6,1,783,1682,19,583,1400,13,41.21052631578947,>30,AUS,Home,Upto 2014
AA Mailey,AUS,Spin,1921-01-14,Adelaide,Australia,1921,2,302,369,10,1,920,1706,23,618,1337,13,40.0,>30,AUS,Home,Upto 2014
AA Mailey,AUS,Spin,1921-02-11,Melbourne,Australia,1921,2,236,458,13,1,636,1301,23,400,843,10,27.652173913043477,<=30,AUS,Home,Upto 2014
AA Mailey,AUS,Spin,1921-02-25,Sydney,Australia,1921,2,208,356,7,1,605,1063,17,397,707,10,35.588235294117645,>30,AUS,Home,Upto 2014
AA Mailey,AUS,Spin,1921-06-11,Lord's,England,1921,2,127,236,6,1,448,876,15,321,640,9,29.866666666666667,<=30,ENG,Away,Upto 2014
AA Mailey,AUS,Spin,1921-07-02,Leeds,England,1921,2,109,224,4,1,678,1167,22,569,943,18,30.818181818181817,>30,ENG,Away,Upto 2014
AA Mailey,AUS,Spin,1921-08-13,The Oval,England,1921,2,162,288,2,1,509,810,8,347,522,6,63.625,>30,ENG,Away,Upto 2014
AA Mailey,AUS,Spin,1921-11-05,Durban,South Africa,1921,2,109,288,2,1,340,702,10,231,414,8,34.0,>30,SA,Away,Upto 2014
AA Mailey,AUS,Spin,1921-11-12,Johannesburg,South Africa,1921,2,185,390,5,1,332,785,12,147,395,7,27.666666666666668,<=30,SA,Away,Upto 2014
AA Mailey,AUS,Spin,1921-11-26,Cape Town,South Africa,1921,2,129,240,6,1,400,850,17,271,610,11,23.529411764705884,<=30,SA,Away,Upto 2014
AA Mailey,AUS,Spin,1924-12-19,Sydney,Australia,1924,2,308,504,7,1,978,2361,24,670,1857,17,40.75,>30,AUS,Home,Upto 2014
AA Mailey,AUS,Spin,1925-01-01,Melbourne,Australia,1925,2,233,464,7,1,988,2427,24,755,1963,17,41.166666666666664,>30,AUS,Home,Upto 2014
AA Mailey,AUS,Spin,1925-01-16,Adelaide,Australia,1925,2,259,594,6,1,1079,2740,29,820,2146,23,37.206896551724135,>30,AUS,Home,Upto 2014
AA Mailey,AUS,Spin,1925-02-13,Melbourne,Australia,1925,1,186,350,4,1,718,1606,23,532,1256,19,31.217391304347824,>30,AUS,Home,Upto 2014
AA Mailey,AUS,Spin,1925-02-27,Sydney,Australia,1925,1,13,40,0,1,638,1899,28,625,1859,28,22.785714285714285,<=30,AUS,Home,Upto 2014
AA Mailey,AUS,Spin,1926-06-26,Lord's,England,1926,1,96,180,0,1,556,1523,10,460,1343,10,55.6,>30,ENG,Away,Upto 2014
AA Mailey,AUS,Spin,1926-07-10,Leeds,England,1926,2,143,234,2,1,810,1836,19,667,1602,17,42.63157894736842,>30,ENG,Away,Upto 2014
AA Mailey,AUS,Spin,1926-07-24,Manchester,England,1926,1,87,162,3,1,479,1184,11,392,1022,8,43.54545454545455,>30,ENG,Away,Upto 2014
AA Mailey,AUS,Spin,1926-08-14,The Oval,England,1926,2,266,460,9,1,808,2213,28,542,1753,19,28.857142857142858,<=30,ENG,Away,Upto 2014
AA Mallett,AUS,Spin,1968-08-22,The Oval,England,1968,2,164,366,5,1,604,1754,22,440,1388,17,27.454545454545453,<=30,ENG,Away,Upto 2014
AA Mallett,AUS,Spin,1968-12-06,Brisbane,Australia,1968,2,86,144,1,1,799,2162,28,713,2018,27,28.535714285714285,<=30,AUS,Home,Upto 2014
AA Mallett,AUS,Spin,1969-11-04,Brabourne,India,1969,2,65,306,2,1,483,1714,20,418,1408,18,24.15,<=30,IND,Away,Upto 2014
AA Mallett,AUS,Spin,1969-11-15,Kanpur,India,1969,2,120,527,4,1,657,2057,13,537,1530,9,50.53846153846154,>30,IND,Away,Upto 2014
AA Mallett,AUS,Spin,1969-11-28,Delhi,India,1969,2,124,369,8,1,604,1737,30,480,1368,22,20.133333333333333,<=30,IND,Away,Upto 2014
AA Mallett,AUS,Spin,1969-12-12,Eden Gardens,India,1969,2,82,264,4,1,380,1033,12,298,769,8,31.666666666666668,>30,IND,Away,Upto 2014
AA Mallett,AUS,Spin,1969-12-24,Chennai,India,1969,2,144,326,10,1,490,1347,28,346,1021,18,17.5,<=30,IND,Away,Upto 2014
AA Mallett,AUS,Spin,1970-01-22,Cape Town,South Africa,1970,2,205,523,6,1,547,1442,19,342,919,13,28.789473684210527,<=30,SA,Away,Upto 2014
AA Mallett,AUS,Spin,1971-01-09,Sydney,Australia,1971,2,125,287,6,1,467,1239,15,342,952,9,31.133333333333333,>30,AUS,Home,Upto 2014
AA Mallett,AUS,Spin,1971-01-29,Adelaide,Australia,1971,2,63,168,0,1,449,1176,4,386,1008,4,112.25,>30,AUS,Home,Upto 2014
AA Mallett,AUS,Spin,1972-07-27,Leeds,England,1972,2,123,342,5,1,321,1171,22,198,829,17,14.590909090909092,<=30,ENG,Away,Upto 2014
AA Mallett,AUS,Spin,1972-08-10,The Oval,England,1972,2,146,276,5,1,544,1256,15,398,980,10,36.266666666666666,>30,ENG,Away,Upto 2014
AA Mallett,AUS,Spin,1972-12-22,Adelaide,Australia,1972,2,111,286,9,1,497,880,15,386,594,6,33.13333333333333,>30,AUS,Home,Upto 2014
AA Mallett,AUS,Spin,1972-12-29,Melbourne,Australia,1972,2,180,445,4,1,666,1379,10,486,934,6,66.6,>30,AUS,Home,Upto 2014
AA Mallett,AUS,Spin,1973-12-29,Melbourne,Australia,1973,2,109,327,6,1,322,917,12,213,590,6,26.833333333333332,<=30,AUS,Home,Upto 2014
AA Mallett,AUS,Spin,1974-01-05,Sydney,Australia,1974,2,95,176,0,1,161,344,2,66,168,2,80.5,>30,AUS,Home,Upto 2014
AA Mallett,AUS,Spin,1974-01-26,Adelaide,Australia,1974,2,93,357,4,1,351,1069,16,258,712,12,21.9375,<=30,AUS,Home,Upto 2014
AA Mallett,AUS,Spin,1974-03-01,Wellington,New Zealand,1974,1,117,328,1,1,424,1008,5,307,680,4,84.8,>30,NZ,Away,Upto 2014
AA Mallett,AUS,Spin,1974-03-08,Christchurch,New Zealand,1974,2,38,128,2,1,60,216,2,22,88,0,30.0,<=30,NZ,Away,Upto 2014
AA Mallett,AUS,Spin,1974-03-22,Auckland,New Zealand,1974,2,73,146,6,1,164,410,11,91,264,5,14.909090909090908,<=30,NZ,Away,Upto 2014
AA Mallett,AUS,Spin,1974-12-13,W.A.C.A,Australia,1974,2,67,169,2,1,230,481,6,163,312,4,38.333333333333336,>30,AUS,Home,Upto 2014
AA Mallett,AUS,Spin,1974-12-26,Melbourne,Australia,1974,2,97,312,6,1,428,1384,16,331,1072,10,26.75,<=30,AUS,Home,Upto 2014
AA Mallett,AUS,Spin,1975-01-04,Sydney,Australia,1975,2,29,141,4,1,427,863,11,398,722,7,38.81818181818182,>30,AUS,Home,Upto 2014
AA Mallett,AUS,Spin,1975-01-25,Adelaide,Australia,1975,2,50,272,5,1,485,1136,17,435,864,12,28.529411764705884,<=30,AUS,Home,Upto 2014
AA Mallett,AUS,Spin,1975-02-08,Melbourne,Australia,1975,1,96,232,0,1,308,798,5,212,566,5,61.6,>30,AUS,Home,Upto 2014
AA Mallett,AUS,Spin,1975-07-10,Birmingham,England,1975,2,42,98,1,1,95,230,3,53,132,2,31.666666666666668,>30,ENG,Away,Upto 2014
AA Mallett,AUS,Spin,1975-07-31,Lord's,England,1975,2,183,352,5,1,451,980,12,268,628,7,37.583333333333336,>30,ENG,Away,Upto 2014
AA Mallett,AUS,Spin,1975-08-14,Leeds,England,1975,1,50,114,3,1,242,624,11,192,510,8,22.0,<=30,ENG,Away,Upto 2014
AA Mallett,AUS,Spin,1975-08-28,The Oval,England,1975,2,111,402,0,1,533,1243,6,422,841,6,88.83333333333333,>30,ENG,Away,Upto 2014
AA Mallett,AUS,Spin,1975-11-28,Brisbane,Australia,1975,2,71,177,3,1,448,1067,12,377,890,9,37.333333333333336,>30,AUS,Home,Upto 2014
AA Mallett,AUS,Spin,1975-12-12,W.A.C.A,Australia,1975,1,103,208,0,1,157,364,1,54,156,1,157.0,>30,AUS,Home,Upto 2014
AA Mallett,AUS,Spin,1975-12-26,Melbourne,Australia,1975,2,79,152,1,1,182,449,4,103,297,3,45.5,>30,AUS,Home,Upto 2014
AA Mallett,AUS,Spin,1976-01-03,Sydney,Australia,1976,2,52,112,1,1,129,289,2,77,177,1,64.5,>30,AUS,Home,Upto 2014
AA Mallett,AUS,Spin,1976-01-23,Adelaide,Australia,1976,2,128,200,3,1,343,701,9,215,501,6,38.111111111111114,>30,AUS,Home,Upto 2014
AA Mallett,AUS,Spin,1976-01-31,Melbourne,Australia,1976,1,73,104,3,1,294,648,6,221,544,3,49.0,>30,AUS,Home,Upto 2014
AA Mallett,AUS,Spin,1980-01-26,Adelaide,Australia,1980,2,211,390,4,1,228,426,5,17,36,1,45.6,>30,AUS,Home,Upto 2014
AA Mallett,AUS,Spin,1980-02-01,Melbourne,Australia,1980,2,149,294,1,1,381,798,5,232,504,4,76.2,>30,AUS,Home,Upto 2014
AA Mallett,AUS,Spin,1980-08-28,Lord's,England,1980,2,86,170,2,1,326,734,3,240,564,1,108.66666666666667,>30,ENG,Away,Upto 2014
AAP Atkinson,ENG,Pace,2024-07-10,Lord's,England,2024,2,106,156,12,1,552,962,27,446,806,15,20.444444444444443,<=30,ENG,Home,After 1965
AAP Atkinson,ENG,Pace,2024-07-18,Nottingham,England,2024,2,156,203,4,1,1038,1453,27,882,1250,23,38.44444444444444,>30,ENG,Home,After 1965
AAP Atkinson,ENG,Pace,2024-07-26,Birmingham,England,2024,2,95,174,6,1,712,994,27,617,820,21,26.37037037037037,<=30,ENG,Home,After 1965
AAP Atkinson,ENG,Pace,2024-08-21,Manchester,England,2024,2,137,198,4,1,733,1160,25,596,962,21,29.32,<=30,ENG,Home,After 1965
AAP Atkinson,ENG,Pace,2024-08-29,Lord's,England,2024,2,102,147,7,1,781,1252,34,679,1105,27,22.970588235294116,<=30,ENG,Home,After 1965
AAP Atkinson,ENG,Pace,2024-09-06,The Oval,England,2024,2,90,120,1,1,809,1069,28,719,949,27,28.892857142857142,<=30,ENG,Home,After 1965
AAP Atkinson,ENG,Pace,2024-10-07,Multan,Pakistan,2024,2,145,234,4,1,658,930,10,513,696,6,65.8,>30,PAK,Away,After 1965
AAP Atkinson,ENG,Pace,2024-10-24,Rawalpindi,Pakistan,2024,1,22,72,2,1,22,72,2,0,0,0,11.0,<=30,PAK,Away,After 1965
AAP Atkinson,ENG,Pace,2024-11-28,Christchurch,New Zealand,2024,2,118,213,3,1,709,1026,15,591,813,12,47.266666666666666,>30,NZ,Away,After 1965
AAP Atkinson,ENG,Pace,2024-12-06,Wellington,New Zealand,2024,2,99,125,5,1,601,832,22,502,707,17,27.318181818181817,<=30,NZ,Away,After 1965
AAP Atkinson,ENG,Pace,2024-12-14,Hamilton,New Zealand,2024,2,82,210,4,1,652,1099,24,570,889,20,27.166666666666668,<=30,NZ,Away,After 1965
AB Agarkar,IND,Pace,1998-10-07,Harare,Zimbabwe,1998,2,100,204,2,1,643,1431,26,543,1227,24,24.73076923076923,<=30,ZIM,Away,Upto 2014
AB Agarkar,IND,Pace,1999-12-10,Adelaide,Australia,1999,2,129,264,5,1,755,1459,27,626,1195,22,27.962962962962962,<=30,AUS,Away,Upto 2014
AB Agarkar,IND,Pace,1999-12-26,Melbourne,Australia,1999,2,127,270,6,1,715,1451,26,588,1181,20,27.5,<=30,AUS,Away,Upto 2014
AB Agarkar,IND,Pace,2000-01-02,Sydney,Australia,2000,1,95,114,0,1,643,1127,22,548,1013,22,29.227272727272727,<=30,AUS,Away,Upto 2014
AB Agarkar,IND,Pace,2000-02-24,Wankhede,India,2000,2,30,66,0,1,367,874,21,337,808,21,17.476190476190474,<=30,IND,Home,Upto 2014
AB Agarkar,IND,Pace,2000-11-10,Dhaka,Bangladesh,2000,2,84,252,4,1,382,888,12,298,636,8,31.833333333333332,>30,BAN,Away,Upto 2014
AB Agarkar,IND,Pace,2000-11-18,Delhi,India,2000,2,137,306,2,1,620,1261,15,483,955,13,41.333333333333336,>30,IND,Home,Upto 2014
AB Agarkar,IND,Pace,2000-11-25,Nagpur,India,2000,2,88,222,2,1,629,1195,8,541,973,6,78.625,>30,IND,Home,Upto 2014
AB Agarkar,IND,Pace,2001-02-27,Wankhede,India,2001,2,58,78,2,1,373,790,15,315,712,13,24.866666666666667,<=30,IND,Home,Upto 2014
AB Agarkar,IND,Pace,2001-06-15,Harare,Zimbabwe,2001,2,84,192,1,1,726,1580,27,642,1388,26,26.88888888888889,<=30,ZIM,Away,Upto 2014
AB Agarkar,IND,Pace,2001-11-16,Gqeberha,South Africa,2001,2,156,270,2,1,644,1436,22,488,1166,20,29.272727272727273,<=30,SA,Away,Upto 2014
AB Agarkar,IND,Pace,2002-07-25,Lord's,England,2002,2,151,196,3,1,837,1449,22,686,1253,19,38.04545454545455,>30,ENG,Away,Upto 2014
AB Agarkar,IND,Pace,2002-08-08,Nottingham,England,2002,1,93,149,2,1,996,1602,22,903,1453,20,45.27272727272727,>30,ENG,Away,Upto 2014
AB Agarkar,IND,Pace,2002-08-22,Leeds,England,2002,2,118,198,3,1,769,1387,15,651,1189,12,51.266666666666666,>30,ENG,Away,Upto 2014
AB Agarkar,IND,Pace,2002-09-05,The Oval,England,2002,2,126,168,0,1,664,1200,10,538,1032,10,66.4,>30,ENG,Away,Upto 2014
AB Agarkar,IND,Pace,2002-12-12,Wellington,New Zealand,2002,1,54,79,1,1,505,1071,28,451,992,27,18.035714285714285,<=30,NZ,Away,Upto 2014
AB Agarkar,IND,Pace,2003-12-04,Brisbane,Australia,2003,2,135,223,4,1,735,1213,18,600,990,14,40.833333333333336,>30,AUS,Away,Upto 2014
AB Agarkar,IND,Pace,2003-12-12,Adelaide,Australia,2003,2,160,254,8,1,872,1501,19,712,1247,11,45.89473684210526,>30,AUS,Away,Upto 2014
AB Agarkar,IND,Pace,2003-12-26,Melbourne,Australia,2003,2,140,242,4,1,819,1520,17,679,1278,13,48.1764705882353,>30,AUS,Away,Upto 2014
AB Agarkar,IND,Pace,2004-01-02,Sydney,Australia,2004,2,161,210,0,1,876,1379,11,715,1169,11,79.63636363636364,>30,AUS,Away,Upto 2014
AB Agarkar,IND,Pace,2004-04-05,Lahore,Pakistan,2004,1,80,138,1,1,744,1284,22,664,1146,21,33.81818181818182,>30,PAK,Away,Upto 2014
AB Agarkar,IND,Pace,2004-10-26,Nagpur,India,2004,2,167,264,1,1,596,1196,23,429,932,22,25.91304347826087,<=30,IND,Home,Upto 2014
AB Agarkar,IND,Pace,2005-12-02,Chennai,India,2005,1,29,60,0,1,166,336,6,137,276,6,27.666666666666668,<=30,IND,Home,Upto 2014
AB Agarkar,IND,Pace,2005-12-10,Delhi,India,2005,2,85,192,2,1,417,906,10,332,714,8,41.7,>30,IND,Home,Upto 2014
AB Agarkar,IND,Pace,2005-12-18,Ahmedabad,India,2005,2,36,102,1,1,356,678,10,320,576,9,35.6,>30,IND,Home,Upto 2014
AB Agarkar,IND,Pace,2006-01-13,Lahore,Pakistan,2006,1,122,144,2,1,476,638,4,354,494,2,119.0,>30,PAK,Away,Upto 2014
AB Barath,WI,Spin,2009-12-04,Adelaide,Australia,2009,1,4,6,0,1,454,1020,7,450,1014,7,64.85714285714286,>30,AUS,Away,Upto 2014
AB Fudadin,WI,Pace,2012-07-25,North Sound,West Indies,2012,1,11,30,0,1,734,1446,19,723,1416,19,38.63157894736842,>30,WI,Home,Upto 2014
AB Howard,WI,Spin,1972-04-06,Georgetown,West Indies,1972,1,140,372,2,1,489,1488,3,349,1116,1,163.0,>30,WI,Home,Upto 2014
AB McDonald,AUS,Pace,2009-01-03,Sydney,Australia,2009,2,73,210,3,1,952,2011,26,879,1801,23,36.61538461538461,>30,AUS,Home,Upto 2014
AB McDonald,AUS,Pace,2009-02-26,Johannesburg,South Africa,2009,2,53,192,2,1,938,1937,36,885,1745,34,26.055555555555557,<=30,SA,Away,Upto 2014
AB McDonald,AUS,Pace,2009-03-06,Durban,South Africa,2009,2,72,168,3,1,857,1739,26,785,1571,23,32.96153846153846,>30,SA,Away,Upto 2014
AB McDonald,AUS,Pace,2009-03-19,Cape Town,South Africa,2009,1,102,162,1,1,890,1587,18,788,1425,17,49.44444444444444,>30,SA,Away,Upto 2014
AB de Villiers,SA,Pace,2005-03-11,Centurion,South Africa,2005,1,16,42,0,1,611,1095,23,595,1053,23,26.565217391304348,<=30,SA,Home,Upto 2014
AB de Villiers,SA,Pace,2005-04-29,St John's,West Indies,2005,1,49,126,2,1,1036,1736,12,987,1610,10,86.33333333333333,>30,WI,Away,Upto 2014
AB de Villiers,SA,Pace,2006-03-31,Johannesburg,South Africa,2006,1,12,6,0,1,824,1490,30,812,1484,30,27.466666666666665,<=30,SA,Home,Upto 2014
AB de Villiers,SA,Pace,2006-07-27,Colombo (SSC),Sri Lanka,2006,1,22,24,0,1,781,1191,14,759,1167,14,55.785714285714285,>30,SL,Away,Upto 2014
AB de Villiers,SA,Pace,2013-12-18,Johannesburg,South Africa,2013,1,5,6,0,1,1012,2037,30,1007,2031,30,33.733333333333334,>30,SA,Home,Upto 2014
AC Agar,AUS,Spin,2013-07-10,Nottingham,England,2013,2,106,252,2,1,277,642,7,171,390,5,39.57142857142857,>30,ENG,Away,Upto 2014
AC Agar,AUS,Spin,2013-07-18,Lord's,England,2013,2,142,252,0,1,356,726,15,214,474,15,23.733333333333334,<=30,ENG,Away,Upto 2014
AC Agar,AUS,Spin,2017-08-27,Mirpur,Bangladesh,2017,2,101,202,5,1,693,1433,34,592,1231,29,20.38235294117647,<=30,BAN,Away,After 1965
AC Agar,AUS,Spin,2017-09-04,Chattogram,Bangladesh,2017,2,61,168,2,1,709,1537,24,648,1369,22,29.541666666666668,<=30,BAN,Away,After 1965
AC Agar,AUS,Spin,2023-01-04,Sydney,Australia,2023,2,58,132,0,1,437,881,4,379,749,4,109.25,>30,AUS,Home,After 1965
AC Bannerman,AUS,Spin,1880-09-06,The Oval,England,1880,1,111,200,3,1,721,1528,21,610,1328,18,34.333333333333336,>30,ENG,Away,After 1965
AC Bannerman,AUS,Spin,1881-12-31,Melbourne,Australia,1881,1,23,40,0,1,812,2321,24,789,2281,24,33.833333333333336,>30,AUS,Home,After 1965
AC Bannerman,AUS,Spin,1882-03-10,Melbourne,Australia,1882,1,12,8,0,1,397,773,12,385,765,12,33.083333333333336,>30,AUS,Home,After 1965
AC Bannerman,AUS,Spin,1883-01-26,Sydney,Australia,1883,1,17,44,1,1,194,600,10,177,556,9,19.4,<=30,AUS,Home,After 1965
AC Cummins,WI,Pace,1993-01-30,W.A.C.A,Australia,1993,2,55,90,1,1,518,1062,27,463,972,26,19.185185185185187,<=30,AUS,Away,Upto 2014
AC Cummins,WI,Pace,1993-04-16,Port of Spain,West Indies,1993,2,35,60,0,1,566,1117,30,531,1057,30,18.866666666666667,<=30,WI,Home,Upto 2014
AC Cummins,WI,Pace,1993-05-01,St John's,West Indies,1993,1,54,120,4,1,577,1130,21,523,1010,17,27.476190476190474,<=30,WI,Home,Upto 2014
AC Cummins,WI,Pace,1994-12-01,Nagpur,India,1994,2,153,252,1,1,503,867,8,350,615,7,62.875,>30,IND,Away,Upto 2014
AC Cummins,WI,Pace,1994-12-10,Mohali,India,1994,1,45,96,2,1,720,1337,21,675,1241,19,34.285714285714285,>30,IND,Away,Upto 2014
AC Dale,AUS,Pace,1998-03-25,Bengaluru,India,1998,2,92,168,3,1,319,612,10,227,444,7,31.9,>30,IND,Away,Upto 2014
AC Dale,AUS,Pace,1999-04-03,St John's,West Indies,1999,2,95,180,3,1,621,1546,25,526,1366,22,24.84,<=30,WI,Away,Upto 2014
AC Dawson,SA,Pace,2003-04-24,Chattogram,Bangladesh,2003,2,85,150,2,1,514,1056,11,429,906,9,46.72727272727273,>30,BAN,Away,Upto 2014
AC Dawson,SA,Pace,2003-05-01,Dhaka,Bangladesh,2003,2,32,102,3,1,304,666,13,272,564,10,23.384615384615383,<=30,BAN,Away,Upto 2014
AC Voges,AUS,Spin,2015-06-03,Roseau,West Indies,2015,1,15,12,0,1,294,570,11,279,558,11,26.727272727272727,<=30,WI,Away,After 1965
AC Voges,AUS,Spin,2015-11-05,Brisbane,Australia,2015,1,3,6,0,1,385,554,8,382,548,8,48.125,>30,AUS,Home,After 1965
AC Voges,AUS,Spin,2016-07-26,Pallekele,Sri Lanka,2016,1,3,10,0,1,503,1219,26,500,1209,26,19.346153846153847,<=30,SL,Away,After 1965
AC Voges,AUS,Spin,2016-08-04,Galle,Sri Lanka,2016,1,4,6,0,1,555,873,24,551,867,24,23.125,<=30,SL,Away,After 1965
AC Voges,AUS,Spin,2016-08-13,Colombo (SSC),Sri Lanka,2016,1,11,12,0,1,860,1808,28,849,1796,28,30.714285714285715,>30,SL,Away,After 1965
AC Voges,AUS,Spin,2016-11-03,W.A.C.A,Australia,2016,1,8,30,0,1,396,754,8,388,724,8,49.5,>30,AUS,Home,After 1965
ACB Langton,SA,Pace,1935-06-15,Nottingham,England,1935,1,117,234,1,1,248,671,10,131,437,9,24.8,<=30,ENG,Away,Upto 2014
ACB Langton,SA,Pace,1935-06-29,Lord's,England,1935,2,89,195,6,1,344,844,15,255,649,9,22.933333333333334,<=30,ENG,Away,Upto 2014
ACB Langton,SA,Pace,1935-07-13,Leeds,England,1935,2,154,342,4,1,570,1397,20,416,1055,16,28.5,<=30,ENG,Away,Upto 2014
ACB Langton,SA,Pace,1935-07-27,Manchester,England,1935,2,139,216,2,1,592,1081,17,453,865,15,34.8235294117647,>30,ENG,Away,Upto 2014
ACB Langton,SA,Pace,1935-08-17,The Oval,England,1935,1,124,228,2,1,741,1240,14,617,1012,12,52.92857142857143,>30,ENG,Away,Upto 2014
ACB Langton,SA,Pace,1935-12-14,Durban,South Africa,1935,2,142,344,4,1,348,794,8,206,450,4,43.5,>30,SA,Home,Upto 2014
ACB Langton,SA,Pace,1935-12-24,Johannesburg,South Africa,1935,2,139,324,4,1,547,996,13,408,672,9,42.07692307692308,>30,SA,Home,Upto 2014
ACB Langton,SA,Pace,1936-01-01,Cape Town,South Africa,1936,1,94,180,1,1,144,300,3,50,120,2,48.0,>30,SA,Home,Upto 2014
ACB Langton,SA,Pace,1936-02-15,Johannesburg,South Africa,1936,1,88,180,1,1,303,592,11,215,412,10,27.545454545454547,<=30,SA,Home,Upto 2014
ACB Langton,SA,Pace,1936-02-28,Durban,South Africa,1936,1,69,198,2,1,320,685,7,251,487,5,45.714285714285715,>30,SA,Home,Upto 2014
ACB Langton,SA,Pace,1938-12-24,Johannesburg,South Africa,1938,2,138,344,0,1,680,1468,10,542,1124,10,68.0,>30,SA,Home,Upto 2014
ACB Langton,SA,Pace,1938-12-31,Cape Town,South Africa,1938,1,117,247,3,1,456,999,10,339,752,7,45.6,>30,SA,Home,Upto 2014
ACB Langton,SA,Pace,1939-01-20,Durban,South Africa,1939,1,107,189,1,1,487,999,14,380,810,13,34.785714285714285,>30,SA,Home,Upto 2014
ACB Langton,SA,Pace,1939-02-18,Johannesburg,South Africa,1939,2,107,250,5,1,381,1034,15,274,784,10,25.4,<=30,SA,Home,Upto 2014
ACB Langton,SA,Pace,1939-03-03,Durban,South Africa,1939,2,203,728,4,1,1100,3449,18,897,2721,14,61.111111111111114,>30,SA,Home,Upto 2014
ACI Lock,ZIM,Pace,1995-10-13,Harare,Zimbabwe,1995,2,105,180,5,1,728,1549,32,623,1369,27,22.75,<=30,ZIM,Home,Upto 2014
ACS Pigott,ENG,Pace,1984-02-03,Christchurch,New Zealand,1984,1,75,102,2,1,404,927,25,329,825,23,16.16,<=30,NZ,Away,Upto 2014
AD Gaekwad,IND,Spin,1975-01-23,Wankhede,India,1975,1,1,6,0,1,833,1734,13,832,1728,13,64.07692307692308,>30,IND,Home,Upto 2014
AD Gaekwad,IND,Spin,1976-03-10,Bridgetown,West Indies,1976,1,14,24,0,1,501,996,16,487,972,16,31.3125,>30,WI,Away,Upto 2014
AD Gaekwad,IND,Spin,1976-12-17,Delhi,India,1976,1,1,6,0,1,485,1319,16,484,1313,16,30.3125,>30,IND,Home,Upto 2014
AD Gaekwad,IND,Spin,1978-01-28,Adelaide,Australia,1978,1,37,40,0,1,820,1960,16,783,1920,16,51.25,>30,AUS,Away,Upto 2014
AD Gaekwad,IND,Spin,1978-12-15,Bengaluru,India,1978,1,10,6,0,1,411,996,8,401,990,8,51.375,>30,IND,Home,Upto 2014
AD Gaekwad,IND,Spin,1979-01-24,Delhi,India,1979,1,5,6,0,1,226,544,8,221,538,8,28.25,<=30,IND,Home,Upto 2014
AD Gaekwad,IND,Spin,1979-07-12,Birmingham,England,1979,1,12,18,0,1,393,774,2,381,756,2,196.5,>30,ENG,Away,Upto 2014
AD Gaekwad,IND,Spin,1983-04-15,Bridgetown,West Indies,1983,1,0,6,0,1,302,625,5,302,619,5,60.4,>30,WI,Away,Upto 2014
AD Gaekwad,IND,Spin,1983-04-28,St John's,West Indies,1983,1,3,6,0,1,460,934,5,457,928,5,92.0,>30,WI,Away,Upto 2014
AD Gaekwad,IND,Spin,1983-10-05,Nagpur,India,1983,1,3,6,0,1,396,1114,18,393,1108,18,22.0,<=30,IND,Home,Upto 2014
AD Gaekwad,IND,Spin,1983-10-21,Kanpur,India,1983,1,6,6,0,1,219,474,3,213,468,3,73.0,>30,IND,Home,Upto 2014
AD Gaekwad,IND,Spin,1983-10-29,Delhi,India,1983,2,11,24,0,1,373,864,8,362,840,8,46.625,>30,IND,Home,Upto 2014
AD Gaekwad,IND,Spin,1983-11-24,Wankhede,India,1983,1,4,6,0,1,386,913,10,382,907,10,38.6,>30,IND,Home,Upto 2014
AD Gaekwad,IND,Spin,1984-10-17,Lahore,Pakistan,1984,1,4,6,1,1,362,1073,9,358,1067,8,40.22222222222222,>30,PAK,Away,Upto 2014
AD Gaekwad,IND,Spin,1984-10-24,Faisalabad,Pakistan,1984,1,75,162,1,1,475,1147,7,400,985,6,67.85714285714286,>30,PAK,Away,Upto 2014
AD Gaekwad,IND,Spin,1984-11-28,Wankhede,India,1984,1,1,6,0,1,629,1557,23,628,1551,23,27.347826086956523,<=30,IND,Home,Upto 2014
AD Hales,ENG,Pace,2016-01-02,Cape Town,South Africa,2016,1,2,18,0,1,994,1661,14,992,1643,14,71.0,>30,SA,Away,After 1965
AD Mathews,SL,Pace,2009-07-04,Galle,Sri Lanka,2009,2,39,72,2,1,560,942,21,521,870,19,26.666666666666668,<=30,SL,Home,Upto 2014
AD Mathews,SL,Pace,2009-07-12,Colombo (PSS),Sri Lanka,2009,2,35,54,1,1,365,700,17,330,646,16,21.470588235294116,<=30,SL,Home,Upto 2014
AD Mathews,SL,Pace,2009-07-20,Colombo (SSC),Sri Lanka,2009,2,64,108,1,1,669,1180,14,605,1072,13,47.785714285714285,>30,SL,Home,Upto 2014
AD Mathews,SL,Pace,2009-11-16,Ahmedabad,India,2009,2,79,162,1,1,648,1044,12,569,882,11,54.0,>30,IND,Away,Upto 2014
AD Mathews,SL,Pace,2009-11-24,Kanpur,India,2009,1,49,102,0,1,388,624,8,339,522,8,48.5,>30,IND,Away,Upto 2014
AD Mathews,SL,Pace,2009-12-02,Brabourne,India,2009,1,36,36,0,1,532,750,10,496,714,10,53.2,>30,IND,Away,Upto 2014
AD Mathews,SL,Pace,2010-07-18,Galle,Sri Lanka,2010,2,32,72,0,1,560,768,16,528,696,16,35.0,>30,SL,Home,Upto 2014
AD Mathews,SL,Pace,2010-07-26,Colombo (SSC),Sri Lanka,2010,1,24,54,0,1,508,710,3,484,656,3,169.33333333333334,>30,SL,Home,Upto 2014
AD Mathews,SL,Pace,2010-08-03,Colombo (PSS),Sri Lanka,2010,2,18,36,1,1,534,849,8,516,813,7,66.75,>30,SL,Home,Upto 2014
AD Mathews,SL,Pace,2010-11-15,Galle,Sri Lanka,2010,1,10,12,0,1,602,992,8,592,980,8,75.25,>30,SL,Home,Upto 2014
AD Mathews,SL,Pace,2010-11-23,Colombo (RPS),Sri Lanka,2010,1,1,18,0,1,389,758,12,388,740,12,32.416666666666664,>30,SL,Home,Upto 2014
AD Mathews,SL,Pace,2010-12-01,Pallekele,Sri Lanka,2010,1,34,60,0,1,147,255,2,113,195,2,73.5,>30,SL,Home,Upto 2014
AD Mathews,SL,Pace,2011-12-15,Centurion,South Africa,2011,1,13,54,1,1,635,1013,25,622,959,24,25.4,<=30,SA,Away,Upto 2014
AD Mathews,SL,Pace,2011-12-26,Durban,South Africa,2011,2,20,30,0,1,674,1304,26,654,1274,26,25.923076923076923,<=30,SA,Away,Upto 2014
AD Mathews,SL,Pace,2012-01-03,Cape Town,South Africa,2012,1,47,72,0,1,828,1318,18,781,1246,18,46.0,>30,SA,Away,Upto 2014
AD Mathews,SL,Pace,2012-06-22,Galle,Sri Lanka,2012,2,8,36,0,1,350,768,9,342,732,9,38.888888888888886,>30,SL,Home,Upto 2014
AD Mathews,SL,Pace,2012-06-30,Colombo (SSC),Sri Lanka,2012,1,55,90,1,1,504,822,6,449,732,5,84.0,>30,SL,Home,Upto 2014
AD Mathews,SL,Pace,2012-07-08,Pallekele,Sri Lanka,2012,2,58,120,1,1,780,1418,19,722,1298,18,41.05263157894737,>30,SL,Home,Upto 2014
AD Mathews,SL,Pace,2012-11-17,Galle,Sri Lanka,2012,1,11,18,0,1,371,706,14,360,688,14,26.5,<=30,SL,Home,Upto 2014
AD Mathews,SL,Pace,2012-11-25,Colombo (PSS),Sri Lanka,2012,1,25,60,0,1,530,1109,22,505,1049,22,24.09090909090909,<=30,SL,Home,Upto 2014
AD Mathews,SL,Pace,2012-12-14,Hobart,Australia,2012,2,46,120,0,1,927,1883,26,881,1763,26,35.65384615384615,>30,AUS,Away,Upto 2014
AD Mathews,SL,Pace,2012-12-26,Melbourne,Australia,2012,1,60,96,2,1,518,864,21,458,768,19,24.666666666666668,<=30,AUS,Away,Upto 2014
AD Mathews,SL,Pace,2013-01-03,Sydney,Australia,2013,1,11,12,0,1,729,1200,20,718,1188,20,36.45,>30,AUS,Away,Upto 2014
AD Mathews,SL,Pace,2013-03-08,Galle,Sri Lanka,2013,1,18,54,0,1,420,696,6,402,642,6,70.0,>30,SL,Home,Upto 2014
AD Mathews,SL,Pace,2013-03-16,Colombo (RPS),Sri Lanka,2013,2,15,36,0,1,510,982,14,495,946,14,36.42857142857143,>30,SL,Home,Upto 2014
AD Mathews,SL,Pace,2013-12-31,Abu Dhabi,UAE,2013,2,52,90,1,1,807,1581,20,755,1491,19,40.35,>30,UAE,Away,Upto 2014
AD Mathews,SL,Pace,2014-01-08,Dubai (DICS),UAE,2014,1,9,30,0,1,719,1539,21,710,1509,21,34.23809523809524,>30,UAE,Away,After 1965
AD Mathews,SL,Pace,2014-01-16,Sharjah,UAE,2014,2,63,108,1,1,610,1197,18,547,1089,17,33.888888888888886,>30,UAE,Away,After 1965
AD Mathews,SL,Pace,2014-01-27,Mirpur,Bangladesh,2014,2,28,54,1,1,519,875,13,491,821,12,39.92307692307692,>30,BAN,Away,After 1965
AD Mathews,SL,Pace,2014-02-04,Chattogram,Bangladesh,2014,1,33,66,0,1,379,646,2,346,580,2,189.5,>30,BAN,Away,After 1965
AD Mathews,SL,Pace,2014-06-12,Lord's,England,2014,1,39,66,0,1,1099,1996,30,1060,1930,30,36.63333333333333,>30,ENG,Away,After 1965
AD Mathews,SL,Pace,2014-06-20,Leeds,England,2014,2,60,156,4,1,1059,2060,34,999,1904,30,31.147058823529413,>30,ENG,Away,After 1965
AD Mathews,SL,Pace,2014-07-16,Galle,Sri Lanka,2014,1,36,66,1,1,420,962,20,384,896,19,21.0,<=30,SL,Home,After 1965
AD Mathews,SL,Pace,2014-08-06,Galle,Sri Lanka,2014,1,25,90,0,1,513,974,10,488,884,10,51.3,>30,SL,Home,After 1965
AD Mathews,SL,Pace,2014-08-14,Colombo (SSC),Sri Lanka,2014,1,21,54,0,1,441,792,14,420,738,14,31.5,>30,SL,Home,After 1965
AD Mathews,SL,Pace,2014-12-26,Christchurch,New Zealand,2014,1,39,72,3,1,757,1417,28,718,1345,25,27.035714285714285,<=30,NZ,Away,After 1965
AD Mathews,SL,Pace,2015-01-03,Wellington,New Zealand,2015,2,58,120,1,1,987,1835,28,929,1715,27,35.25,>30,NZ,Away,After 1965
AD Mathews,SL,Pace,2015-06-17,Galle,Sri Lanka,2015,1,12,36,0,1,383,708,10,371,672,10,38.3,>30,SL,Home,After 1965
AD Mathews,SL,Pace,2015-06-25,Colombo (PSS),Sri Lanka,2015,2,31,120,2,1,390,800,14,359,680,12,27.857142857142858,<=30,SL,Home,After 1965
AD Mathews,SL,Pace,2015-07-03,Pallekele,Sri Lanka,2015,2,37,102,0,1,740,1384,19,703,1282,19,38.94736842105263,>30,SL,Home,After 1965
AD Mathews,SL,Pace,2015-08-12,Galle,Sri Lanka,2015,2,15,30,1,1,393,630,9,378,600,8,43.666666666666664,>30,SL,Home,After 1965
AD Mathews,SL,Pace,2015-08-20,Colombo (PSS),Sri Lanka,2015,2,25,102,2,1,525,996,16,500,894,14,32.8125,>30,SL,Home,After 1965
AD Mathews,SL,Pace,2015-08-28,Colombo (SSC),Sri Lanka,2015,2,35,114,1,1,606,1122,27,571,1008,26,22.444444444444443,<=30,SL,Home,After 1965
AD Mathews,SL,Pace,2015-12-10,Dunedin,New Zealand,2015,2,32,78,1,1,942,1677,26,910,1599,25,36.23076923076923,>30,NZ,Away,After 1965
AD Mathews,SL,Pace,2015-12-18,Hamilton,New Zealand,2015,2,29,72,0,1,667,1250,30,638,1178,30,22.233333333333334,<=30,NZ,Away,After 1965
AD Mathews,SL,Pace,2016-05-19,Leeds,England,2016,1,31,66,0,1,468,901,27,437,835,27,17.333333333333332,<=30,ENG,Away,After 1965
AD Mathews,SL,Pace,2016-05-27,Chester-le-Street,England,2016,1,16,36,0,1,773,1433,25,757,1397,25,30.92,>30,ENG,Away,After 1965
AD Mathews,SL,Pace,2016-06-09,Lord's,England,2016,2,51,132,1,1,770,1481,24,719,1349,23,32.083333333333336,>30,ENG,Away,After 1965
AD Mathews,SL,Pace,2016-07-26,Pallekele,Sri Lanka,2016,1,6,18,0,1,306,556,14,300,538,14,21.857142857142858,<=30,SL,Home,After 1965
AD Mathews,SL,Pace,2016-08-04,Galle,Sri Lanka,2016,1,13,18,0,1,224,424,15,211,406,15,14.933333333333334,<=30,SL,Home,After 1965
AD Mathews,SL,Pace,2016-08-13,Colombo (SSC),Sri Lanka,2016,1,5,24,0,1,336,652,8,331,628,8,42.0,>30,SL,Home,After 1965
AD Mathews,SL,Pace,2016-12-26,Gqeberha,South Africa,2016,2,36,102,0,1,798,1468,25,762,1366,25,31.92,>30,SA,Away,After 1965
AD Mathews,SL,Pace,2017-01-02,Cape Town,South Africa,2017,1,41,102,0,1,701,1233,30,660,1131,30,23.366666666666667,<=30,SA,Away,After 1965
AD Mathews,SL,Pace,2017-01-12,Johannesburg,South Africa,2017,1,52,120,2,1,621,1136,30,569,1016,28,20.7,<=30,SA,Away,After 1965
AD Mathews,SL,Pace,2018-12-15,Wellington,New Zealand,2018,1,1,24,0,1,859,1641,18,858,1617,18,47.72222222222222,>30,NZ,Away,After 1965
AD Mathews,SL,Pace,2018-12-26,Christchurch,New Zealand,2018,1,6,24,0,1,838,1658,30,832,1634,30,27.933333333333334,<=30,NZ,Away,After 1965
AD Mathews,SL,Pace,2021-04-21,Pallekele,Sri Lanka,2021,1,14,42,0,1,611,1140,12,597,1098,12,50.916666666666664,>30,SL,Home,After 1965
AD Mathews,SL,Pace,2021-04-29,Pallekele,Sri Lanka,2021,1,7,12,0,1,391,680,8,384,668,8,48.875,>30,SL,Home,After 1965
AD Mathews,SL,Pace,2023-03-09,Christchurch,New Zealand,2023,1,18,18,0,1,1067,1960,32,1049,1942,32,33.34375,>30,NZ,Away,After 1965
AD Mathews,SL,Pace,2024-09-06,The Oval,England,2024,1,14,18,0,1,809,1069,28,795,1051,28,28.892857142857142,<=30,ENG,Away,After 1965
AD Mathews,SL,Pace,2024-11-27,Durban,South Africa,2024,1,0,12,0,1,556,1001,29,556,989,29,19.17241379310345,<=30,SA,Away,After 1965
AD Mullally,ENG,Pace,1996-06-06,Birmingham,England,1996,2,103,222,5,1,677,1326,30,574,1104,25,22.566666666666666,<=30,ENG,Home,Upto 2014
AD Mullally,ENG,Pace,1996-06-20,Lord's,England,1996,1,71,234,3,1,826,2028,26,755,1794,23,31.76923076923077,>30,ENG,Home,Upto 2014
AD Mullally,ENG,Pace,1996-07-04,Nottingham,England,1996,2,124,318,4,1,859,1781,24,735,1463,20,35.791666666666664,>30,ENG,Home,Upto 2014
AD Mullally,ENG,Pace,1996-07-25,Lord's,England,1996,2,114,326,4,1,850,1771,26,736,1445,22,32.69230769230769,>30,ENG,Home,Upto 2014
AD Mullally,ENG,Pace,1996-08-08,Leeds,England,1996,2,142,336,2,1,963,1933,22,821,1597,20,43.77272727272727,>30,ENG,Home,Upto 2014
AD Mullally,ENG,Pace,1996-08-22,The Oval,England,1996,2,121,241,4,1,690,1195,17,569,954,13,40.588235294117645,>30,ENG,Home,Upto 2014
AD Mullally,ENG,Pace,1996-12-18,Bulawayo,Zimbabwe,1996,2,118,246,2,1,665,1230,17,547,984,15,39.11764705882353,>30,ZIM,Away,Upto 2014
AD Mullally,ENG,Pace,1996-12-26,Harare,Zimbabwe,1996,1,32,138,1,1,330,1045,15,298,907,14,22.0,<=30,ZIM,Away,Upto 2014
AD Mullally,ENG,Pace,1997-01-24,Auckland,New Zealand,1997,2,102,318,3,1,815,1797,20,713,1479,17,40.75,>30,NZ,Away,Upto 2014
AD Mullally,ENG,Pace,1998-11-20,Brisbane,Australia,1998,2,143,324,5,1,919,1808,20,776,1484,15,45.95,>30,AUS,Away,Upto 2014
AD Mullally,ENG,Pace,1998-11-28,W.A.C.A,Australia,1998,2,60,180,2,1,564,1246,31,504,1066,29,18.193548387096776,<=30,AUS,Away,Upto 2014
AD Mullally,ENG,Pace,1998-12-11,Adelaide,Australia,1998,2,77,252,0,1,622,1222,21,545,970,21,29.61904761904762,<=30,AUS,Away,Upto 2014
AD Mullally,ENG,Pace,1998-12-26,Melbourne,Australia,1998,2,84,189,5,1,840,1515,33,756,1326,28,25.454545454545453,<=30,AUS,Away,Upto 2014
AD Mullally,ENG,Pace,1999-07-01,Birmingham,England,1999,2,120,256,5,1,580,1146,27,460,890,22,21.48148148148148,<=30,ENG,Home,Upto 2014
AD Mullally,ENG,Pace,1999-07-22,Lord's,England,1999,2,119,192,2,1,642,1427,25,523,1235,23,25.68,<=30,ENG,Home,Upto 2014
AD Mullally,ENG,Pace,1999-08-19,The Oval,England,1999,2,61,222,4,1,501,1268,29,440,1046,25,17.275862068965516,<=30,ENG,Home,Upto 2014
AD Mullally,ENG,Pace,1999-11-25,Johannesburg,South Africa,1999,1,80,204,3,1,668,1442,28,588,1238,25,23.857142857142858,<=30,SA,Away,Upto 2014
AD Mullally,ENG,Pace,2000-01-14,Centurion,South Africa,2000,1,42,144,2,1,437,835,14,395,691,12,31.214285714285715,>30,SA,Away,Upto 2014
AD Mullally,ENG,Pace,2001-08-16,Leeds,England,2001,2,99,183,2,1,1054,1608,26,955,1425,24,40.53846153846154,>30,ENG,Home,Upto 2014
AD Nourse,SA,Spin,1950-02-10,Johannesburg,South Africa,1950,1,0,8,0,1,517,1176,4,517,1168,4,129.25,>30,SA,Home,Upto 2014
AD Nourse,SA,Spin,1951-06-21,Lord's,England,1951,1,9,12,0,1,361,954,17,352,942,17,21.235294117647058,<=30,ENG,Away,Upto 2014
AD Pougher,ENG,Pace,1892-03-19,Cape Town,South Africa,1892,1,26,105,3,1,379,805,14,353,700,11,27.071428571428573,<=30,SA,Away,After 1965
AD Russell,WI,Pace,2010-11-15,Galle,Sri Lanka,2010,2,104,138,1,1,602,992,8,498,854,7,75.25,>30,SL,Away,Upto 2014
ADG Matthews,ENG,Pace,1937-08-14,The Oval,England,1937,2,65,180,2,1,359,810,13,294,630,11,27.615384615384617,<=30,ENG,Home,Upto 2014
ADG Roberts,NZ,Pace,1976-02-05,Christchurch,New Zealand,1976,1,12,40,1,1,616,1431,23,604,1391,22,26.782608695652176,<=30,NZ,Home,Upto 2014
ADG Roberts,NZ,Pace,1976-10-23,Hyderabad (Sind),Pakistan,1976,1,23,64,1,1,398,904,11,375,840,10,36.18181818181818,>30,PAK,Away,Upto 2014
ADG Roberts,NZ,Pace,1976-10-30,Karachi,Pakistan,1976,1,18,36,1,1,1003,1506,20,985,1470,19,50.15,>30,PAK,Away,Upto 2014
ADG Roberts,NZ,Pace,1976-11-10,Wankhede,India,1976,2,40,72,0,1,455,894,10,415,822,10,45.5,>30,IND,Away,Upto 2014
ADG Roberts,NZ,Pace,1976-11-18,Kanpur,India,1976,1,53,114,1,1,425,720,6,372,606,5,70.83333333333333,>30,IND,Away,Upto 2014
ADG Roberts,NZ,Pace,1976-11-26,Chennai,India,1976,2,36,114,0,1,298,829,13,262,715,13,22.923076923076923,<=30,IND,Away,Upto 2014
ADR Campbell,ZIM,Spin,1993-12-16,Lahore,Pakistan,1993,1,3,6,0,1,31,97,0,28,91,0,inf,>30,PAK,Away,Upto 2014
ADR Campbell,ZIM,Spin,1994-10-20,Bulawayo,Zimbabwe,1994,1,1,12,0,1,318,948,5,317,936,5,63.6,>30,ZIM,Home,Upto 2014
ADR Campbell,ZIM,Spin,1996-01-20,Auckland,New Zealand,1996,1,3,12,0,1,314,606,5,311,594,5,62.8,>30,NZ,Away,Upto 2014
ADR Campbell,ZIM,Spin,1997-09-25,Bulawayo,Zimbabwe,1997,1,13,12,0,1,722,1402,21,709,1390,21,34.38095238095238,>30,ZIM,Home,Upto 2014
ADR Campbell,ZIM,Spin,2000-09-12,Bulawayo,Zimbabwe,2000,1,3,6,0,1,456,1365,20,453,1359,20,22.8,<=30,ZIM,Home,Upto 2014
ADR Campbell,ZIM,Spin,2000-11-18,Delhi,India,2000,1,5,18,0,1,622,1309,9,617,1291,9,69.11111111111111,>30,IND,Away,Upto 2014
AE Hall,SA,Pace,1923-01-01,Cape Town,South Africa,1923,2,112,375,11,1,417,1260,23,305,885,12,18.130434782608695,<=30,SA,Home,Upto 2014
AE Hall,SA,Pace,1923-01-18,Durban,South Africa,1923,2,107,335,5,1,496,1373,16,389,1038,11,31.0,>30,SA,Home,Upto 2014
AE Hall,SA,Pace,1923-02-09,Johannesburg,South Africa,1923,2,196,484,7,1,723,1725,22,527,1241,15,32.86363636363637,>30,SA,Home,Upto 2014
AE Hall,SA,Pace,1923-02-16,Durban,South Africa,1923,2,86,311,4,1,724,2332,33,638,2021,29,21.939393939393938,<=30,SA,Home,Upto 2014
AE Hall,SA,Pace,1928-01-28,Johannesburg,South Africa,1928,2,167,412,9,1,503,1258,23,336,846,14,21.869565217391305,<=30,SA,Home,Upto 2014
AE Hall,SA,Pace,1928-02-04,Durban,South Africa,1928,2,66,168,0,1,338,797,16,272,629,16,21.125,<=30,SA,Home,Upto 2014
AE Hall,SA,Pace,1931-02-13,Johannesburg,South Africa,1931,2,152,276,4,1,670,1471,21,518,1195,17,31.904761904761905,>30,SA,Home,Upto 2014
AE Moss,ENG,Pace,1954-01-15,Kingston,West Indies,1954,2,114,216,2,1,630,1500,20,516,1284,18,31.5,>30,WI,Away,Upto 2014
AE Moss,ENG,Pace,1956-06-07,Nottingham,England,1956,1,1,24,0,1,363,976,12,362,952,12,30.25,>30,ENG,Home,Upto 2014
AE Moss,ENG,Pace,1959-06-04,Nottingham,England,1959,2,46,216,2,1,398,1106,18,352,890,16,22.11111111111111,<=30,ENG,Home,Upto 2014
AE Moss,ENG,Pace,1959-06-18,Lord's,England,1959,2,61,222,2,1,428,1122,20,367,900,18,21.4,<=30,ENG,Home,Upto 2014
AE Moss,ENG,Pace,1959-07-02,Leeds,England,1959,2,40,168,3,1,379,911,14,339,743,11,27.071428571428573,<=30,ENG,Home,Upto 2014
AE Moss,ENG,Pace,1960-01-06,Bridgetown,West Indies,1960,1,116,282,0,1,552,1376,10,436,1094,10,55.2,>30,WI,Away,Upto 2014
AE Moss,ENG,Pace,1960-03-25,Port of Spain,West Indies,1960,2,110,228,3,1,604,1109,11,494,881,8,54.90909090909091,>30,WI,Away,Upto 2014
AE Moss,ENG,Pace,1960-06-23,Lord's,England,1960,2,76,147,5,1,549,1209,28,473,1062,23,19.607142857142858,<=30,ENG,Home,Upto 2014
AE Moss,ENG,Pace,1960-07-07,Nottingham,England,1960,2,62,154,4,1,545,1319,26,483,1165,22,20.96153846153846,<=30,ENG,Home,Upto 2014
AE Relf,ENG,Spin,1903-12-11,Sydney,Australia,1903,2,62,114,0,1,839,1769,19,777,1655,19,44.1578947368421,>30,AUS,Away,Upto 2014
AE Relf,ENG,Spin,1904-01-01,Melbourne,Australia,1904,2,17,18,1,1,442,925,27,425,907,26,16.37037037037037,<=30,AUS,Away,Upto 2014
AE Relf,ENG,Spin,1906-01-02,Johannesburg,South Africa,1906,1,47,131,2,1,455,1132,23,408,1001,21,19.782608695652176,<=30,SA,Away,Upto 2014
AE Relf,ENG,Spin,1906-03-06,Johannesburg,South Africa,1906,1,36,108,1,1,287,726,15,251,618,14,19.133333333333333,<=30,SA,Away,Upto 2014
AE Relf,ENG,Spin,1906-03-10,Johannesburg,South Africa,1906,2,84,138,1,1,622,1254,10,538,1116,9,62.2,>30,SA,Away,Upto 2014
AE Relf,ENG,Spin,1906-03-24,Cape Town,South Africa,1906,1,17,36,1,1,339,907,20,322,871,19,16.95,<=30,SA,Away,Upto 2014
AE Relf,ENG,Spin,1906-03-30,Cape Town,South Africa,1906,1,40,126,3,1,364,776,15,324,650,12,24.266666666666666,<=30,SA,Away,Upto 2014
AE Relf,ENG,Spin,1909-06-14,Lord's,England,1909,2,94,316,6,1,254,821,16,160,505,10,15.875,<=30,ENG,Home,Upto 2014
AE Relf,ENG,Spin,1913-12-13,Durban,South Africa,1913,2,40,128,3,1,212,468,8,172,340,5,26.5,<=30,SA,Away,Upto 2014
AE Relf,ENG,Spin,1913-12-26,Johannesburg,South Africa,1913,2,53,138,1,1,283,660,6,230,522,5,47.166666666666664,>30,SA,Away,Upto 2014
AE Relf,ENG,Spin,1914-01-01,Johannesburg,South Africa,1914,2,64,258,3,1,388,857,18,324,599,15,21.555555555555557,<=30,SA,Away,Upto 2014
AE Relf,ENG,Spin,1914-02-14,Durban,South Africa,1914,1,15,48,0,1,337,984,14,322,936,14,24.071428571428573,<=30,SA,Away,Upto 2014
AE Relf,ENG,Spin,1914-02-27,Gqeberha,South Africa,1914,2,55,205,3,1,377,889,10,322,684,7,37.7,>30,SA,Away,Upto 2014
AE Stoddart,ENG,Pace,1892-01-01,Melbourne,Australia,1892,1,10,30,0,1,677,2425,30,667,2395,30,22.566666666666666,<=30,AUS,Away,After 1965
AE Stoddart,ENG,Pace,1892-01-29,Sydney,Australia,1892,1,12,24,0,1,735,2292,31,723,2268,31,23.70967741935484,<=30,AUS,Away,After 1965
AE Stoddart,ENG,Pace,1894-12-14,Sydney,Australia,1894,1,31,18,1,1,993,2418,24,962,2400,23,41.375,>30,AUS,Away,After 1965
AE Stoddart,ENG,Pace,1896-07-16,Manchester,England,1896,1,9,30,0,1,587,1233,20,578,1203,20,29.35,<=30,ENG,Home,After 1965
AE Stoddart,ENG,Pace,1898-01-14,Adelaide,Australia,1898,1,10,24,1,1,674,1910,19,664,1886,18,35.473684210526315,>30,AUS,Away,After 1965
AE Stoddart,ENG,Pace,1898-01-29,Melbourne,Australia,1898,1,22,36,0,1,528,1140,21,506,1104,21,25.142857142857142,<=30,AUS,Away,After 1965
AE Trott,AUS,Spin,1895-01-11,Adelaide,Australia,1895,2,52,180,8,1,335,726,15,283,546,7,22.333333333333332,<=30,AUS,Home,After 1965
AE Trott,AUS,Spin,1895-03-01,Melbourne,Australia,1895,2,140,294,1,1,689,1631,19,549,1337,18,36.26315789473684,>30,AUS,Home,After 1965
AE Trott,ENG,Spin,1899-02-14,Johannesburg,South Africa,1899,2,110,317,9,1,466,1319,30,356,1002,21,15.533333333333333,<=30,SA,Away,After 1965
AE Trott,ENG,Spin,1899-04-01,Cape Town,South Africa,1899,2,88,157,8,1,347,777,19,259,620,11,18.263157894736842,<=30,SA,Away,After 1965
AEE Vogler,SA,Spin,1906-01-02,Johannesburg,South Africa,1906,2,34,84,3,1,455,1132,23,421,1048,20,19.782608695652176,<=30,SA,Home,Upto 2014
AEE Vogler,SA,Spin,1906-03-06,Johannesburg,South Africa,1906,2,25,90,2,1,287,726,15,262,636,13,19.133333333333333,<=30,SA,Home,Upto 2014
AEE Vogler,SA,Spin,1906-03-10,Johannesburg,South Africa,1906,2,42,156,0,1,622,1254,10,580,1098,10,62.2,>30,SA,Home,Upto 2014
AEE Vogler,SA,Spin,1906-03-24,Cape Town,South Africa,1906,2,20,66,1,1,339,907,20,319,841,19,16.95,<=30,SA,Home,Upto 2014
AEE Vogler,SA,Spin,1906-03-30,Cape Town,South Africa,1906,2,80,162,3,1,364,776,15,284,614,12,24.266666666666666,<=30,SA,Home,Upto 2014
AEE Vogler,SA,Spin,1907-07-01,Lord's,England,1907,1,128,284,7,1,478,962,15,350,678,8,31.866666666666667,>30,ENG,Away,Upto 2014
AEE Vogler,SA,Spin,1907-07-29,Leeds,England,1907,2,32,72,2,1,289,661,31,257,589,29,9.32258064516129,<=30,ENG,Away,Upto 2014
AEE Vogler,SA,Spin,1907-08-19,The Oval,England,1907,2,135,273,6,1,462,1059,21,327,786,15,22.0,<=30,ENG,Away,Upto 2014
AEE Vogler,SA,Spin,1910-01-01,Johannesburg,South Africa,1910,2,181,313,12,1,593,1077,29,412,764,17,20.448275862068964,<=30,SA,Home,Upto 2014
AEE Vogler,SA,Spin,1910-01-21,Durban,South Africa,1910,2,176,354,7,1,565,1312,24,389,958,17,23.541666666666668,<=30,SA,Home,Upto 2014
AEE Vogler,SA,Spin,1910-02-26,Johannesburg,South Africa,1910,2,207,318,8,1,662,1226,24,455,908,16,27.583333333333332,<=30,SA,Home,Upto 2014
AEE Vogler,SA,Spin,1910-03-07,Cape Town,South Africa,1910,2,100,195,7,1,379,765,17,279,570,10,22.294117647058822,<=30,SA,Home,Upto 2014
AEE Vogler,SA,Spin,1910-03-11,Cape Town,South Africa,1910,2,119,169,2,1,488,932,19,369,763,17,25.68421052631579,<=30,SA,Home,Upto 2014
AEE Vogler,SA,Spin,1910-12-09,Sydney,Australia,1910,1,87,90,0,1,388,570,5,301,480,5,77.6,>30,AUS,Away,Upto 2014
AEE Vogler,SA,Spin,1911-02-17,Melbourne,Australia,1911,2,89,138,4,1,844,1322,23,755,1184,19,36.69565217391305,>30,AUS,Away,Upto 2014
AER Gilligan,ENG,Pace,1922-12-23,Johannesburg,South Africa,1922,2,92,162,3,1,634,1476,30,542,1314,27,21.133333333333333,<=30,SA,Away,Upto 2014
AER Gilligan,ENG,Pace,1923-02-16,Durban,South Africa,1923,2,113,354,6,1,724,2332,33,611,1978,27,21.939393939393938,<=30,SA,Away,Upto 2014
AER Gilligan,ENG,Pace,1924-06-14,Birmingham,England,1924,2,90,207,11,1,406,735,19,316,528,8,21.36842105263158,<=30,ENG,Home,Upto 2014
AER Gilligan,ENG,Pace,1924-06-28,Lord's,England,1924,2,124,330,5,1,434,750,7,310,420,2,62.0,>30,ENG,Home,Upto 2014
AER Gilligan,ENG,Pace,1924-07-12,Leeds,England,1924,2,64,168,1,1,303,630,5,239,462,4,60.6,>30,ENG,Home,Upto 2014
AER Gilligan,ENG,Pace,1924-08-16,The Oval,England,1924,1,44,96,0,1,298,576,2,254,480,2,149.0,>30,ENG,Home,Upto 2014
AER Gilligan,ENG,Pace,1924-12-19,Sydney,Australia,1924,2,206,400,3,1,590,1278,15,384,878,12,39.333333333333336,>30,AUS,Away,Upto 2014
AER Gilligan,ENG,Pace,1925-01-01,Melbourne,Australia,1925,2,154,296,3,1,573,1360,13,419,1064,10,44.07692307692308,>30,AUS,Away,Upto 2014
AER Gilligan,ENG,Pace,1925-01-16,Adelaide,Australia,1925,1,17,63,1,1,326,857,11,309,794,10,29.636363636363637,<=30,AUS,Away,Upto 2014
AER Gilligan,ENG,Pace,1925-02-13,Melbourne,Australia,1925,2,50,104,1,1,305,712,6,255,608,5,50.833333333333336,>30,AUS,Away,Upto 2014
AER Gilligan,ENG,Pace,1925-02-27,Sydney,Australia,1925,2,92,224,2,1,265,608,9,173,384,7,29.444444444444443,<=30,AUS,Away,Upto 2014
AEV Hartkopf,AUS,Spin,1925-01-01,Melbourne,Australia,1925,2,134,240,1,1,988,2427,24,854,2187,23,41.166666666666664,>30,AUS,Home,Upto 2014
AF Giles,ENG,Spin,1998-07-02,Manchester,England,1998,1,106,216,1,1,380,1050,6,274,834,5,63.333333333333336,>30,ENG,Home,Upto 2014
AF Giles,ENG,Spin,2000-11-15,Lahore,Pakistan,2000,1,113,354,4,1,697,1762,20,584,1408,16,34.85,>30,PAK,Away,Upto 2014
AF Giles,ENG,Spin,2000-11-29,Faisalabad,Pakistan,2000,2,165,366,6,1,641,1582,20,476,1216,14,32.05,>30,PAK,Away,Upto 2014
AF Giles,ENG,Spin,2000-12-07,Karachi,Pakistan,2000,2,132,372,7,1,624,1582,18,492,1210,11,34.666666666666664,>30,PAK,Away,Upto 2014
AF Giles,ENG,Spin,2001-02-22,Galle,Sri Lanka,2001,1,134,288,1,1,636,1872,18,502,1584,17,35.333333333333336,>30,SL,Away,Upto 2014
AF Giles,ENG,Spin,2001-03-07,Kandy,Sri Lanka,2001,2,105,180,0,1,679,1658,18,574,1478,18,37.72222222222222,>30,SL,Away,Upto 2014
AF Giles,ENG,Spin,2001-03-15,Colombo (SSC),Sri Lanka,2001,2,70,259,6,1,375,1120,19,305,861,13,19.736842105263158,<=30,SL,Away,Upto 2014
AF Giles,ENG,Spin,2001-07-05,Birmingham,England,2001,1,108,150,1,1,315,491,10,207,341,9,31.5,>30,ENG,Home,Upto 2014
AF Giles,ENG,Spin,2001-12-11,Ahmedabad,India,2001,2,124,447,5,1,727,1868,25,603,1421,20,29.08,<=30,IND,Away,Upto 2014
AF Giles,ENG,Spin,2001-12-19,Bengaluru,India,2001,1,74,204,1,1,308,742,5,234,538,4,61.6,>30,IND,Away,Upto 2014
AF Giles,ENG,Spin,2002-03-13,Christchurch,New Zealand,2002,1,73,168,1,1,196,354,1,123,186,0,196.0,>30,NZ,Away,Upto 2014
AF Giles,ENG,Spin,2002-03-21,Wellington,New Zealand,2002,2,156,420,5,1,323,744,10,167,324,5,32.3,>30,NZ,Away,Upto 2014
AF Giles,ENG,Spin,2002-03-30,Auckland,New Zealand,2002,2,7,12,0,1,12,24,0,5,12,0,inf,>30,NZ,Away,Upto 2014
AF Giles,ENG,Spin,2002-05-30,Birmingham,England,2002,2,64,181,1,1,264,643,6,200,462,5,44.0,>30,ENG,Home,Upto 2014
AF Giles,ENG,Spin,2002-06-13,Manchester,England,2002,2,126,284,5,1,309,728,8,183,444,3,38.625,>30,ENG,Home,Upto 2014
AF Giles,ENG,Spin,2002-07-25,Lord's,England,2002,2,122,228,2,1,509,942,14,387,714,12,36.357142857142854,>30,ENG,Home,Upto 2014
AF Giles,ENG,Spin,2002-08-22,Leeds,England,2002,1,134,234,1,1,393,893,12,259,659,11,32.75,>30,ENG,Home,Upto 2014
AF Giles,ENG,Spin,2002-09-05,The Oval,England,2002,1,98,294,2,1,410,922,9,312,628,7,45.55555555555556,>30,ENG,Home,Upto 2014
AF Giles,ENG,Spin,2002-11-07,Brisbane,Australia,2002,2,191,320,6,1,484,801,12,293,481,6,40.333333333333336,>30,AUS,Away,Upto 2014
AF Giles,ENG,Spin,2003-05-22,Lord's,England,2003,1,15,48,1,1,157,306,4,142,258,3,39.25,>30,ENG,Home,Upto 2014
AF Giles,ENG,Spin,2003-06-05,Chester-le-Street,England,2003,2,52,156,1,1,179,420,2,127,264,1,89.5,>30,ENG,Home,Upto 2014
AF Giles,ENG,Spin,2003-07-24,Birmingham,England,2003,2,198,300,4,1,314,558,6,116,258,2,52.333333333333336,>30,ENG,Home,Upto 2014
AF Giles,ENG,Spin,2003-07-31,Lord's,England,2003,1,142,258,1,1,235,397,2,93,139,1,117.5,>30,ENG,Home,Upto 2014
AF Giles,ENG,Spin,2003-08-14,Nottingham,England,2003,1,24,60,0,1,70,225,2,46,165,2,35.0,>30,ENG,Home,Upto 2014
AF Giles,ENG,Spin,2003-09-04,The Oval,England,2003,2,138,234,2,1,289,420,3,151,186,1,96.33333333333333,>30,ENG,Home,Upto 2014
AF Giles,ENG,Spin,2003-10-21,Dhaka,Bangladesh,2003,2,99,192,1,1,443,953,10,344,761,9,44.3,>30,BAN,Away,Upto 2014
AF Giles,ENG,Spin,2003-10-29,Chattogram,Bangladesh,2003,2,13,42,0,1,331,702,7,318,660,7,47.285714285714285,>30,BAN,Away,Upto 2014
AF Giles,ENG,Spin,2003-12-02,Galle,Sri Lanka,2003,2,132,437,8,1,603,1823,28,471,1386,20,21.535714285714285,<=30,SL,Away,Upto 2014
AF Giles,ENG,Spin,2003-12-10,Kandy,Sri Lanka,2003,2,217,358,8,1,692,1702,20,475,1344,12,34.6,>30,SL,Away,Upto 2014
AF Giles,ENG,Spin,2003-12-18,Colombo (SSC),Sri Lanka,2003,1,190,390,2,1,552,1368,13,362,978,11,42.46153846153846,>30,SL,Away,Upto 2014
AF Giles,ENG,Spin,2004-03-11,Kingston,West Indies,2004,1,67,72,2,1,110,185,4,43,113,2,27.5,<=30,WI,Away,Upto 2014
AF Giles,ENG,Spin,2004-03-19,Port of Spain,West Indies,2004,2,49,60,0,1,72,167,2,23,107,2,36.0,>30,WI,Away,Upto 2014
AF Giles,ENG,Spin,2004-04-01,Bridgetown,West Indies,2004,1,21,54,0,1,60,156,0,39,102,0,inf,>30,WI,Away,Upto 2014
AF Giles,ENG,Spin,2004-05-20,Lord's,England,2004,2,119,264,3,1,241,540,5,122,276,2,48.2,>30,ENG,Home,Upto 2014
AF Giles,ENG,Spin,2004-06-03,Leeds,England,2004,1,67,114,0,1,153,264,2,86,150,2,76.5,>30,ENG,Home,Upto 2014
AF Giles,ENG,Spin,2004-06-10,Nottingham,England,2004,2,116,306,6,1,125,318,6,9,12,0,20.833333333333332,<=30,ENG,Home,Upto 2014
AF Giles,ENG,Spin,2004-07-22,Lord's,England,2004,2,210,454,9,1,526,874,12,316,420,3,43.833333333333336,>30,ENG,Home,Upto 2014
AF Giles,ENG,Spin,2004-07-29,Birmingham,England,2004,2,122,309,9,1,350,688,15,228,379,6,23.333333333333332,<=30,ENG,Home,Upto 2014
AF Giles,ENG,Spin,2004-08-12,Manchester,England,2004,2,113,222,3,1,277,526,4,164,304,1,69.25,>30,ENG,Home,Upto 2014
AF Giles,ENG,Spin,2004-08-19,The Oval,England,2004,1,64,132,1,1,104,218,2,40,86,1,52.0,>30,ENG,Home,Upto 2014
AF Giles,ENG,Spin,2004-12-17,Gqeberha,South Africa,2004,2,108,256,4,1,172,364,5,64,108,1,34.4,>30,SA,Away,Upto 2014
AF Giles,ENG,Spin,2004-12-26,Durban,South Africa,2004,1,84,114,1,1,324,528,5,240,414,4,64.8,>30,SA,Away,Upto 2014
AF Giles,ENG,Spin,2005-01-02,Cape Town,South Africa,2005,2,146,288,3,1,243,528,7,97,240,4,34.714285714285715,>30,SA,Away,Upto 2014
AF Giles,ENG,Spin,2005-01-13,Johannesburg,South Africa,2005,2,49,79,2,1,150,235,2,101,156,0,75.0,>30,SA,Away,Upto 2014
AF Giles,ENG,Spin,2005-01-21,Centurion,South Africa,2005,2,62,102,1,1,140,288,1,78,186,0,140.0,>30,SA,Away,Upto 2014
AF Giles,ENG,Spin,2005-07-21,Lord's,England,2005,1,56,66,0,1,139,228,6,83,162,6,23.166666666666668,<=30,ENG,Home,Upto 2014
AF Giles,ENG,Spin,2005-08-04,Birmingham,England,2005,2,146,246,5,1,308,537,15,162,291,10,20.533333333333335,<=30,ENG,Home,Upto 2014
AF Giles,ENG,Spin,2005-08-11,Manchester,England,2005,2,193,342,3,1,423,776,8,230,434,5,52.875,>30,ENG,Home,Upto 2014
AF Giles,ENG,Spin,2005-08-25,Nottingham,England,2005,1,107,168,2,1,240,426,10,133,258,8,24.0,<=30,ENG,Home,Upto 2014
AF Giles,ENG,Spin,2005-09-08,The Oval,England,2005,1,76,138,0,1,342,624,12,266,486,12,28.5,<=30,ENG,Home,Upto 2014
AF Giles,ENG,Spin,2005-11-12,Multan,Pakistan,2005,2,111,228,1,1,438,798,8,327,570,7,54.75,>30,PAK,Away,Upto 2014
AF Giles,ENG,Spin,2005-11-20,Faisalabad,Pakistan,2005,2,136,222,2,1,496,897,7,360,675,5,70.85714285714286,>30,PAK,Away,Upto 2014
AF Giles,ENG,Spin,2006-11-23,Brisbane,Australia,2006,2,113,180,1,1,304,510,5,191,330,4,60.8,>30,AUS,Away,Upto 2014
AF Giles,ENG,Spin,2006-12-01,Adelaide,Australia,2006,2,149,312,2,1,457,990,7,308,678,5,65.28571428571429,>30,AUS,Away,Upto 2014
AF Kippax,AUS,Spin,1928-12-14,Sydney,Australia,1928,1,11,30,0,1,782,1986,12,771,1956,12,65.16666666666667,>30,AUS,Home,Upto 2014
AF Kippax,AUS,Spin,1929-02-01,Adelaide,Australia,1929,1,3,12,0,1,757,2268,26,754,2256,26,29.115384615384617,<=30,AUS,Home,Upto 2014
AF Kippax,AUS,Spin,1929-03-08,Melbourne,Australia,1929,1,2,18,0,1,660,1893,8,658,1875,8,82.5,>30,AUS,Home,Upto 2014
AF Kippax,AUS,Spin,1932-12-02,Sydney,Australia,1932,1,3,12,0,1,288,900,4,285,888,4,72.0,>30,AUS,Home,Upto 2014
AF Lissette,NZ,Spin,1956-02-03,Dunedin,New Zealand,1956,1,73,168,2,1,439,1372,20,366,1204,18,21.95,<=30,NZ,Home,Upto 2014
AF Lissette,NZ,Spin,1956-02-18,Christchurch,New Zealand,1956,1,51,120,1,1,464,1136,24,413,1016,23,19.333333333333332,<=30,NZ,Home,Upto 2014
AFA Lilley,ENG,Pace,1896-07-16,Manchester,England,1896,1,23,25,1,1,587,1233,20,564,1208,19,29.35,<=30,ENG,Home,After 1965
AG Barrett,WI,Spin,1971-02-18,Kingston,West Indies,1971,1,86,210,1,1,757,1901,17,671,1691,16,44.529411764705884,>30,WI,Home,Upto 2014
AG Barrett,WI,Spin,1971-03-06,Port of Spain,West Indies,1971,2,108,274,3,1,708,1890,29,600,1616,26,24.413793103448278,<=30,WI,Home,Upto 2014
AG Barrett,WI,Spin,1974-02-16,Kingston,West Indies,1974,2,173,558,6,1,880,2436,16,707,1878,10,55.0,>30,WI,Home,Upto 2014
AG Barrett,WI,Spin,1974-03-22,Georgetown,West Indies,1974,1,87,186,1,1,367,917,8,280,731,7,45.875,>30,WI,Home,Upto 2014
AG Barrett,WI,Spin,1974-11-22,Bengaluru,India,1974,2,46,132,1,1,592,1136,16,546,1004,15,37.0,>30,IND,Away,Upto 2014
AG Barrett,WI,Spin,1975-01-23,Wankhede,India,1975,2,103,252,1,1,833,1734,13,730,1482,12,64.07692307692308,>30,IND,Away,Upto 2014
AG Chipperfield,AUS,Spin,1934-06-08,Nottingham,England,1934,2,24,42,0,1,499,1663,22,475,1621,22,22.681818181818183,<=30,ENG,Away,Upto 2014
AG Chipperfield,AUS,Spin,1934-06-22,Lord's,England,1934,1,91,204,3,1,377,1128,20,286,924,17,18.85,<=30,ENG,Away,Upto 2014
AG Chipperfield,AUS,Spin,1934-07-06,Manchester,England,1934,1,29,42,0,1,477,1272,12,448,1230,12,39.75,>30,ENG,Away,Upto 2014
AG Chipperfield,AUS,Spin,1934-07-20,Leeds,England,1934,2,56,162,2,1,569,1652,17,513,1490,15,33.470588235294116,>30,ENG,Away,Upto 2014
AG Chipperfield,AUS,Spin,1934-08-18,The Oval,England,1934,1,22,24,0,1,526,1194,12,504,1170,12,43.833333333333336,>30,ENG,Away,Upto 2014
AG Chipperfield,AUS,Spin,1935-12-14,Durban,South Africa,1935,1,8,6,0,1,684,1775,22,676,1769,22,31.09090909090909,>30,SA,Away,Upto 2014
AG Chipperfield,AUS,Spin,1936-02-28,Durban,South Africa,1936,1,20,48,0,1,543,1530,23,523,1482,23,23.608695652173914,<=30,SA,Away,Upto 2014
AG Chipperfield,AUS,Spin,1936-12-04,Brisbane,Australia,1936,2,65,168,0,1,566,1790,14,501,1622,14,40.42857142857143,>30,AUS,Home,Upto 2014
AG Chipperfield,AUS,Spin,1936-12-18,Sydney,Australia,1936,1,47,104,0,1,468,1160,7,421,1056,7,66.85714285714286,>30,AUS,Home,Upto 2014
AG Chipperfield,AUS,Spin,1937-01-29,Adelaide,Australia,1937,1,24,72,0,1,554,1660,17,530,1588,17,32.588235294117645,>30,AUS,Home,Upto 2014
AG Chipperfield,AUS,Spin,1938-06-24,Lord's,England,1938,1,51,52,0,1,622,1129,16,571,1077,16,38.875,>30,ENG,Away,Upto 2014
AG Cremer,ZIM,Spin,2005-01-06,Chattogram,Bangladesh,2005,1,86,99,2,1,450,957,14,364,858,12,32.142857142857146,>30,BAN,Away,Upto 2014
AG Cremer,ZIM,Spin,2005-01-14,Dhaka,Bangladesh,2005,2,93,280,4,1,497,1234,18,404,954,14,27.61111111111111,<=30,BAN,Away,Upto 2014
AG Cremer,ZIM,Spin,2005-03-04,Cape Town,South Africa,2005,1,86,54,3,1,206,230,7,120,176,4,29.428571428571427,<=30,SA,Away,Upto 2014
AG Cremer,ZIM,Spin,2005-03-11,Centurion,South Africa,2005,1,106,161,3,1,252,431,4,146,270,1,63.0,>30,SA,Away,Upto 2014
AG Cremer,ZIM,Spin,2005-08-07,Harare,Zimbabwe,2005,1,113,132,1,1,156,237,7,43,105,6,22.285714285714285,<=30,ZIM,Home,Upto 2014
AG Cremer,ZIM,Spin,2005-08-15,Bulawayo,Zimbabwe,2005,1,111,144,0,1,320,589,7,209,445,7,45.714285714285715,>30,ZIM,Home,Upto 2014
AG Cremer,ZIM,Spin,2012-01-26,Napier,New Zealand,2012,1,112,132,2,1,163,234,4,51,102,2,40.75,>30,NZ,Away,Upto 2014
AG Cremer,ZIM,Spin,2013-03-12,Bridgetown,West Indies,2013,1,103,120,0,1,270,496,14,167,376,14,19.285714285714285,<=30,WI,Away,Upto 2014
AG Cremer,ZIM,Spin,2013-03-20,Roseau,West Indies,2013,1,102,204,2,1,314,673,21,212,469,19,14.952380952380953,<=30,WI,Away,Upto 2014
AG Cremer,ZIM,Spin,2013-04-17,Harare,Zimbabwe,2013,2,4,38,4,1,326,755,9,322,717,5,36.22222222222222,>30,ZIM,Home,Upto 2014
AG Cremer,ZIM,Spin,2013-04-25,Harare,Zimbabwe,2013,2,179,252,3,1,425,789,13,246,537,10,32.69230769230769,>30,ZIM,Home,Upto 2014
AG Cremer,ZIM,Spin,2016-07-28,Bulawayo,Zimbabwe,2016,1,187,318,1,1,461,827,6,274,509,5,76.83333333333333,>30,ZIM,Home,After 1965
AG Cremer,ZIM,Spin,2016-08-06,Bulawayo,Zimbabwe,2016,2,206,282,1,1,624,1160,15,418,878,14,41.6,>30,ZIM,Home,After 1965
AG Cremer,ZIM,Spin,2016-10-29,Harare,Zimbabwe,2016,2,209,336,4,1,573,1161,19,364,825,15,30.157894736842106,>30,ZIM,Home,After 1965
AG Cremer,ZIM,Spin,2016-11-06,Harare,Zimbabwe,2016,2,227,370,7,1,564,968,25,337,598,18,22.56,<=30,ZIM,Home,After 1965
AG Cremer,ZIM,Spin,2017-07-14,Colombo (RPS),Sri Lanka,2017,2,275,525,9,1,1059,1917,28,784,1392,19,37.82142857142857,>30,SL,Away,After 1965
AG Cremer,ZIM,Spin,2017-10-21,Bulawayo,Zimbabwe,2017,2,178,347,8,1,674,1311,28,496,964,20,24.071428571428573,<=30,ZIM,Home,After 1965
AG Cremer,ZIM,Spin,2017-10-29,Bulawayo,Zimbabwe,2017,1,161,312,1,1,706,1640,15,545,1328,14,47.06666666666667,>30,ZIM,Home,After 1965
AG Cremer,ZIM,Spin,2017-12-26,Gqeberha,South Africa,2017,1,66,108,2,1,150,243,7,84,135,5,21.428571428571427,<=30,SA,Away,After 1965
AG Fairfax,AUS,Pace,1929-03-08,Melbourne,Australia,1929,2,104,204,2,1,826,2351,25,722,2147,23,33.04,>30,AUS,Home,Upto 2014
AG Fairfax,AUS,Pace,1930-06-13,Nottingham,England,1930,2,109,220,2,1,383,898,10,274,678,8,38.3,>30,ENG,Away,Upto 2014
AG Fairfax,AUS,Pace,1930-06-27,Lord's,England,1930,2,138,262,6,1,579,1102,10,441,840,4,57.9,>30,ENG,Away,Upto 2014
AG Fairfax,AUS,Pace,1930-07-25,Manchester,England,1930,1,15,78,0,1,183,630,11,168,552,11,16.636363636363637,<=30,ENG,Away,Upto 2014
AG Fairfax,AUS,Pace,1930-08-16,The Oval,England,1930,2,73,246,4,1,505,1314,10,432,1068,6,50.5,>30,ENG,Away,Upto 2014
AG Fairfax,AUS,Pace,1930-12-12,Adelaide,Australia,1930,2,42,84,0,1,453,957,5,411,873,5,90.6,>30,AUS,Home,Upto 2014
AG Fairfax,AUS,Pace,1931-01-01,Sydney,Australia,1931,2,40,108,3,1,284,648,9,244,540,6,31.555555555555557,>30,AUS,Home,Upto 2014
AG Fairfax,AUS,Pace,1931-01-16,Brisbane,Australia,1931,2,19,78,0,1,443,984,16,424,906,16,27.6875,<=30,AUS,Home,Upto 2014
AG Fairfax,AUS,Pace,1931-02-13,Melbourne,Australia,1931,2,45,114,4,1,238,438,7,193,324,3,34.0,>30,AUS,Home,Upto 2014
AG Fairfax,AUS,Pace,1931-02-27,Sydney,Australia,1931,1,60,126,0,1,407,995,14,347,869,14,29.071428571428573,<=30,AUS,Home,Upto 2014
AG Huckle,ZIM,Spin,1997-09-18,Harare,Zimbabwe,1997,2,116,270,5,1,277,714,8,161,444,3,34.625,>30,ZIM,Home,Upto 2014
AG Huckle,ZIM,Spin,1997-09-25,Bulawayo,Zimbabwe,1997,2,255,436,11,1,722,1402,21,467,966,10,34.38095238095238,>30,ZIM,Home,Upto 2014
AG Huckle,ZIM,Spin,1998-01-07,Kandy,Sri Lanka,1998,1,88,126,1,1,546,1374,23,458,1248,22,23.73913043478261,<=30,SL,Away,Upto 2014
AG Huckle,ZIM,Spin,1998-02-19,Wellington,New Zealand,1998,2,108,251,3,1,396,984,10,288,733,7,39.6,>30,NZ,Away,Upto 2014
AG Huckle,ZIM,Spin,1998-02-26,Auckland,New Zealand,1998,1,66,78,0,1,314,511,5,248,433,5,62.8,>30,NZ,Away,Upto 2014
AG Huckle,ZIM,Spin,1998-03-21,Harare,Zimbabwe,1998,2,136,239,2,1,303,593,6,167,354,4,50.5,>30,ZIM,Home,Upto 2014
AG Huckle,ZIM,Spin,1998-10-07,Harare,Zimbabwe,1998,2,63,126,1,1,303,670,13,240,544,12,23.307692307692307,<=30,ZIM,Home,Upto 2014
AG Huckle,ZIM,Spin,1998-12-10,Lahore,Pakistan,1998,1,40,42,2,1,77,131,7,37,89,5,11.0,<=30,PAK,Away,Upto 2014
AG Hurst,AUS,Pace,1974-01-26,Adelaide,Australia,1974,2,73,232,1,1,505,1312,13,432,1080,12,38.84615384615385,>30,AUS,Home,Upto 2014
AG Hurst,AUS,Pace,1977-12-02,Brisbane,Australia,1977,2,81,176,2,1,540,1279,27,459,1103,25,20.0,<=30,AUS,Home,Upto 2014
AG Hurst,AUS,Pace,1978-12-01,Brisbane,Australia,1978,2,110,300,4,1,633,1750,28,523,1450,24,22.607142857142858,<=30,AUS,Home,Upto 2014
AG Hurst,AUS,Pace,1978-12-15,W.A.C.A,Australia,1978,2,113,344,4,1,652,1878,31,539,1534,27,21.032258064516128,<=30,AUS,Home,Upto 2014
AG Hurst,AUS,Pace,1978-12-29,Melbourne,Australia,1978,2,63,184,2,1,456,1463,27,393,1279,25,16.88888888888889,<=30,AUS,Home,Upto 2014
AG Hurst,AUS,Pace,1979-01-06,Sydney,Australia,1979,2,71,238,5,1,452,1414,19,381,1176,14,23.789473684210527,<=30,AUS,Home,Upto 2014
AG Hurst,AUS,Pace,1979-01-27,Adelaide,Australia,1979,2,162,408,7,1,561,1654,30,399,1246,23,18.7,<=30,AUS,Home,Upto 2014
AG Hurst,AUS,Pace,1979-02-10,Sydney,Australia,1979,1,58,160,3,1,293,735,11,235,575,8,26.636363636363637,<=30,AUS,Home,Upto 2014
AG Hurst,AUS,Pace,1979-03-10,Melbourne,Australia,1979,2,170,317,6,1,679,1863,29,509,1546,23,23.413793103448278,<=30,AUS,Home,Upto 2014
AG Hurst,AUS,Pace,1979-03-24,W.A.C.A,Australia,1979,2,155,383,9,1,924,2172,25,769,1789,16,36.96,>30,AUS,Home,Upto 2014
AG Hurst,AUS,Pace,1979-09-11,Chennai,India,1979,1,51,138,0,1,448,938,6,397,800,6,74.66666666666667,>30,IND,Away,Upto 2014
AG Hurst,AUS,Pace,1979-09-19,Bengaluru,India,1979,1,93,174,0,1,384,678,4,291,504,4,96.0,>30,IND,Away,Upto 2014
AG Kripal Singh,IND,Spin,1955-11-19,Hyderabad (Deccan),India,1955,1,5,6,0,1,665,1888,11,660,1882,11,60.45454545454545,>30,IND,Home,Upto 2014
AG Kripal Singh,IND,Spin,1955-12-16,Delhi,India,1955,1,10,42,0,1,540,1398,4,530,1356,4,135.0,>30,IND,Home,Upto 2014
AG Kripal Singh,IND,Spin,1959-01-21,Chennai,India,1959,1,1,12,0,1,586,1441,19,585,1429,19,30.842105263157894,>30,IND,Home,Upto 2014
AG Kripal Singh,IND,Spin,1959-06-18,Lord's,England,1959,2,19,24,0,1,208,491,11,189,467,11,18.90909090909091,<=30,ENG,Away,Upto 2014
AG Kripal Singh,IND,Spin,1961-11-11,Brabourne,India,1961,2,97,282,0,1,727,1890,18,630,1608,18,40.388888888888886,>30,IND,Home,Upto 2014
AG Kripal Singh,IND,Spin,1961-12-01,Kanpur,India,1961,2,83,222,0,1,792,2016,16,709,1794,16,49.5,>30,IND,Home,Upto 2014
AG Kripal Singh,IND,Spin,1961-12-13,Delhi,India,1961,1,27,72,1,1,505,1242,8,478,1170,7,63.125,>30,IND,Home,Upto 2014
AG Kripal Singh,IND,Spin,1964-01-10,Chennai,India,1964,2,118,306,3,1,876,2493,27,758,2187,24,32.44444444444444,>30,IND,Home,Upto 2014
AG Kripal Singh,IND,Spin,1964-02-08,Delhi,India,1964,1,90,216,3,1,1001,2631,20,911,2415,17,50.05,>30,IND,Home,Upto 2014
AG Kripal Singh,IND,Spin,1964-10-02,Chennai,India,1964,2,134,336,3,1,735,1918,23,601,1582,20,31.956521739130434,>30,IND,Home,Upto 2014
AG Milkha Singh,IND,Pace,1961-01-13,Chennai,India,1961,1,2,6,0,1,342,929,6,340,923,6,57.0,>30,IND,Home,Upto 2014
AG Prince,SA,Spin,2005-04-29,St John's,West Indies,2005,1,22,54,0,1,410,840,3,388,786,3,136.66666666666666,>30,WI,Away,Upto 2014
AG Prince,SA,Spin,2006-04-27,Cape Town,South Africa,2006,1,2,12,1,1,434,954,6,432,942,5,72.33333333333333,>30,SA,Home,Upto 2014
AG Prince,SA,Spin,2006-07-27,Colombo (SSC),Sri Lanka,2006,1,7,12,0,1,531,1166,11,524,1154,11,48.27272727272727,>30,SL,Away,Upto 2014
AG Prince,SA,Spin,2008-03-26,Chennai,India,2008,1,16,18,0,1,758,1458,16,742,1440,16,47.375,>30,IND,Away,Upto 2014
AG Steel,ENG,Spin,1880-09-06,The Oval,England,1880,2,131,240,5,1,721,1528,21,590,1288,16,34.333333333333336,>30,ENG,Home,After 1965
AG Steel,ENG,Spin,1882-08-28,The Oval,England,1882,2,16,36,2,1,130,428,15,114,392,13,8.666666666666666,<=30,ENG,Home,After 1965
AG Steel,ENG,Spin,1882-12-30,Melbourne,Australia,1882,2,85,168,2,1,291,692,13,206,524,11,22.384615384615383,<=30,AUS,Away,After 1965
AG Steel,ENG,Spin,1883-01-26,Sydney,Australia,1883,1,27,104,3,1,194,600,10,167,496,7,19.4,<=30,AUS,Away,After 1965
AG Steel,ENG,Spin,1883-02-17,Sydney,Australia,1883,2,83,244,6,1,484,1391,24,401,1147,18,20.166666666666668,<=30,AUS,Away,After 1965
AG Steel,ENG,Spin,1884-07-10,Manchester,England,1884,1,32,52,2,1,222,640,17,190,588,15,13.058823529411764,<=30,ENG,Home,After 1965
AG Steel,ENG,Spin,1884-07-21,Lord's,England,1884,2,32,46,2,1,320,694,15,288,648,13,21.333333333333332,<=30,ENG,Home,After 1965
AG Steel,ENG,Spin,1884-08-11,The Oval,England,1884,1,71,136,0,1,469,1036,14,398,900,14,33.5,>30,ENG,Home,After 1965
AG Steel,ENG,Spin,1886-07-05,Manchester,England,1886,2,56,140,3,1,205,538,9,149,398,6,22.77777777777778,<=30,ENG,Home,After 1965
AG Steel,ENG,Spin,1886-07-19,Lord's,England,1886,2,48,148,2,1,231,789,16,183,641,14,14.4375,<=30,ENG,Home,After 1965
AG Steel,ENG,Spin,1886-08-12,The Oval,England,1886,1,20,28,1,1,247,704,10,227,676,9,24.7,<=30,ENG,Home,After 1965
AG Steel,ENG,Spin,1888-07-16,Lord's,England,1888,2,4,18,1,1,134,420,21,130,402,20,6.380952380952381,<=30,ENG,Home,After 1965
AH Bakewell,ENG,Pace,1935-07-27,Manchester,England,1935,1,8,18,0,1,592,1081,17,584,1063,17,34.8235294117647,>30,ENG,Home,Upto 2014
AH Gray,WI,Pace,1986-10-24,Faisalabad,Pakistan,1986,2,121,203,6,1,582,1145,28,461,942,22,20.785714285714285,<=30,PAK,Away,Upto 2014
AH Gray,WI,Pace,1986-11-07,Lahore,Pakistan,1986,2,48,180,4,1,247,794,22,199,614,18,11.227272727272727,<=30,PAK,Away,Upto 2014
AH Gray,WI,Pace,1986-11-20,Karachi,Pakistan,1986,2,58,211,4,1,343,1168,21,285,957,17,16.333333333333332,<=30,PAK,Away,Upto 2014
AH Gray,WI,Pace,1987-02-27,Auckland,New Zealand,1987,2,89,168,5,1,550,1311,24,461,1143,19,22.916666666666668,<=30,NZ,Away,Upto 2014
AH Gray,WI,Pace,1987-03-12,Christchurch,New Zealand,1987,2,61,126,3,1,630,1188,33,569,1062,30,19.09090909090909,<=30,NZ,Away,Upto 2014
AH Jones,NZ,Spin,1989-02-24,Auckland,New Zealand,1989,1,16,18,0,1,705,1609,10,689,1591,10,70.5,>30,NZ,Home,Upto 2014
AH Jones,NZ,Spin,1990-02-22,Auckland,New Zealand,1990,1,28,54,0,1,382,711,6,354,657,6,63.666666666666664,>30,NZ,Home,Upto 2014
AH Jones,NZ,Spin,1990-03-15,Wellington,New Zealand,1990,1,4,6,0,1,227,624,10,223,618,10,22.7,<=30,NZ,Home,Upto 2014
AH Jones,NZ,Spin,1990-06-21,Lord's,England,1990,1,40,72,1,1,264,588,7,224,516,6,37.714285714285715,>30,ENG,Away,Upto 2014
AH Jones,NZ,Spin,1990-07-05,Birmingham,England,1990,1,2,6,0,1,288,747,13,286,741,13,22.153846153846153,<=30,ENG,Away,Upto 2014
AH Jones,NZ,Spin,1991-01-31,Wellington,New Zealand,1991,1,6,12,0,1,378,792,0,372,780,0,inf,>30,NZ,Home,Upto 2014
AH Jones,NZ,Spin,1991-02-22,Hamilton,New Zealand,1991,1,15,24,0,1,304,672,6,289,648,6,50.666666666666664,>30,NZ,Home,Upto 2014
AH Jones,NZ,Spin,1992-01-18,Christchurch,New Zealand,1992,1,8,18,0,1,362,1021,13,354,1003,13,27.846153846153847,<=30,NZ,Home,Upto 2014
AH Jones,NZ,Spin,1992-02-06,Wellington,New Zealand,1992,1,7,6,0,1,491,1353,13,484,1347,13,37.76923076923077,>30,NZ,Home,Upto 2014
AH Jones,NZ,Spin,1992-11-01,Bulawayo,Zimbabwe,1992,1,1,6,0,1,469,976,10,468,970,10,46.9,>30,ZIM,Away,Upto 2014
AH Jones,NZ,Spin,1992-11-27,Moratuwa,Sri Lanka,1992,1,3,6,0,1,176,750,7,173,744,7,25.142857142857142,<=30,SL,Away,Upto 2014
AH Jones,NZ,Spin,1992-12-06,Colombo (SSC),Sri Lanka,1992,1,8,10,0,1,505,1022,18,497,1012,18,28.055555555555557,<=30,SL,Away,Upto 2014
AH Jones,NZ,Spin,1993-12-03,Brisbane,Australia,1993,1,6,12,0,1,392,909,12,386,897,12,32.666666666666664,>30,AUS,Away,Upto 2014
AH Jones,NZ,Spin,1995-02-10,Wellington,New Zealand,1995,1,50,78,0,1,377,624,4,327,546,4,94.25,>30,NZ,Home,Upto 2014
AH Kardar,PAK,Spin,1952-10-16,Delhi,India,1952,1,53,204,2,1,404,1143,24,351,939,22,16.833333333333332,<=30,IND,Away,Upto 2014
AH Kardar,PAK,Spin,1952-10-23,Lucknow,India,1952,2,17,96,0,1,185,666,5,168,570,5,37.0,>30,IND,Away,Upto 2014
AH Kardar,PAK,Spin,1952-11-13,Brabourne,India,1952,2,56,96,1,1,433,1202,15,377,1106,14,28.866666666666667,<=30,IND,Away,Upto 2014
AH Kardar,PAK,Spin,1952-11-28,Chennai,India,1952,1,37,126,2,1,261,594,8,224,468,6,32.625,>30,IND,Away,Upto 2014
AH Kardar,PAK,Spin,1952-12-12,Eden Gardens,India,1952,1,43,90,1,1,455,1230,13,412,1140,12,35.0,>30,IND,Away,Upto 2014
AH Kardar,PAK,Spin,1954-07-01,Nottingham,England,1954,1,110,168,1,1,279,522,7,169,354,6,39.857142857142854,>30,ENG,Away,Upto 2014
AH Kardar,PAK,Spin,1955-01-01,Dhaka,Bangladesh,1955,1,17,72,0,1,438,1378,15,421,1306,15,29.2,<=30,BAN,Away,Upto 2014
AH Kardar,PAK,Spin,1955-01-15,Bahawalpur,Pakistan,1955,1,19,42,0,1,306,1050,8,287,1008,8,38.25,>30,PAK,Home,Upto 2014
AH Kardar,PAK,Spin,1955-01-29,Lahore,Pakistan,1955,1,20,72,2,1,591,2024,18,571,1952,16,32.833333333333336,>30,PAK,Home,Upto 2014
AH Kardar,PAK,Spin,1955-02-12,Peshawar,Pakistan,1955,2,34,120,0,1,400,1761,19,366,1641,19,21.05263157894737,<=30,PAK,Home,Upto 2014
AH Kardar,PAK,Spin,1955-10-13,Karachi,Pakistan,1955,2,57,348,3,1,294,1463,19,237,1115,16,15.473684210526315,<=30,PAK,Home,Upto 2014
AH Kardar,PAK,Spin,1955-10-26,Lahore,Pakistan,1955,2,73,312,5,1,672,1787,23,599,1475,18,29.217391304347824,<=30,PAK,Home,Upto 2014
AH Kardar,PAK,Spin,1955-11-07,Dhaka,Bangladesh,1955,1,21,168,2,1,131,558,6,110,390,4,21.833333333333332,<=30,BAN,Away,Upto 2014
AH Kardar,PAK,Spin,1956-10-11,Karachi,Pakistan,1956,1,12,72,0,1,132,398,5,120,326,5,26.4,<=30,PAK,Home,Upto 2014
AH Kardar,PAK,Spin,1958-01-17,Bridgetown,West Indies,1958,2,120,210,1,1,679,1898,11,559,1688,10,61.72727272727273,>30,WI,Away,Upto 2014
AH Kardar,PAK,Spin,1958-02-05,Port of Spain,West Indies,1958,2,90,246,1,1,477,1223,18,387,977,17,26.5,<=30,WI,Away,Upto 2014
AH Kardar,PAK,Spin,1958-02-26,Kingston,West Indies,1958,1,141,222,0,1,450,846,3,309,624,3,150.0,>30,WI,Away,Upto 2014
AH Kardar,PAK,Spin,1958-03-13,Georgetown,West Indies,1958,2,34,48,0,1,1032,2327,20,998,2279,20,51.6,>30,WI,Away,Upto 2014
AH McKinnon,SA,Spin,1960-08-18,The Oval,England,1960,2,64,156,2,1,312,852,6,248,696,4,52.0,>30,ENG,Away,Upto 2014
AH McKinnon,SA,Spin,1962-01-01,Cape Town,South Africa,1962,2,74,216,3,1,569,1566,23,495,1350,20,24.73913043478261,<=30,SA,Home,Upto 2014
AH McKinnon,SA,Spin,1965-01-22,Johannesburg,South Africa,1965,2,172,516,7,1,443,1146,10,271,630,3,44.3,>30,SA,Home,Upto 2014
AH McKinnon,SA,Spin,1965-02-12,Gqeberha,South Africa,1965,1,99,276,1,1,437,1309,10,338,1033,9,43.7,>30,SA,Home,Upto 2014
AH McKinnon,SA,Spin,1965-08-05,Nottingham,England,1965,2,104,330,4,1,259,688,8,155,358,4,32.375,>30,ENG,Away,Upto 2014
AH McKinnon,SA,Spin,1965-08-26,The Oval,England,1965,2,120,348,4,1,295,744,6,175,396,2,49.166666666666664,>30,ENG,Away,Upto 2014
AH McKinnon,SA,Spin,1966-12-23,Johannesburg,South Africa,1966,2,137,344,3,1,549,1041,11,412,697,8,49.90909090909091,>30,SA,Home,Upto 2014
AH McKinnon,SA,Spin,1966-12-31,Cape Town,South Africa,1966,2,155,360,2,1,643,1501,10,488,1141,8,64.3,>30,SA,Home,Upto 2014
AH Omarshah,ZIM,Pace,1992-11-01,Bulawayo,Zimbabwe,1992,2,82,126,1,1,481,878,7,399,752,6,68.71428571428571,>30,ZIM,Home,Upto 2014
AH Omarshah,ZIM,Pace,1993-03-13,Delhi,India,1993,1,43,60,0,1,351,630,4,308,570,4,87.75,>30,IND,Away,Upto 2014
AHP Scott,WI,Spin,1953-03-28,Kingston,West Indies,1953,2,140,264,0,1,921,2154,20,781,1890,20,46.05,>30,WI,Home,Upto 2014
AI Kallicharran,WI,Spin,1972-04-06,Georgetown,West Indies,1972,1,17,36,0,1,489,1488,3,472,1452,3,163.0,>30,WI,Home,Upto 2014
AI Kallicharran,WI,Spin,1972-04-20,Port of Spain,West Indies,1972,1,0,6,0,1,509,1648,17,509,1642,17,29.941176470588236,<=30,WI,Home,Upto 2014
AI Kallicharran,WI,Spin,1974-02-16,Kingston,West Indies,1974,1,12,18,0,1,880,2436,16,868,2418,16,55.0,>30,WI,Home,Upto 2014
AI Kallicharran,WI,Spin,1974-03-06,Bridgetown,West Indies,1974,1,5,6,0,1,534,1195,11,529,1189,11,48.54545454545455,>30,WI,Home,Upto 2014
AI Kallicharran,WI,Spin,1975-11-28,Brisbane,Australia,1975,1,1,2,0,1,448,1067,12,447,1065,12,37.333333333333336,>30,AUS,Away,Upto 2014
AI Kallicharran,WI,Spin,1975-12-26,Melbourne,Australia,1975,1,13,7,0,1,182,449,4,169,442,4,45.5,>30,AUS,Away,Upto 2014
AI Kallicharran,WI,Spin,1976-01-03,Sydney,Australia,1976,1,7,16,1,1,129,289,2,122,273,1,64.5,>30,AUS,Away,Upto 2014
AI Kallicharran,WI,Spin,1976-06-03,Nottingham,England,1976,1,18,60,0,1,293,652,6,275,592,6,48.833333333333336,>30,ENG,Away,Upto 2014
AI Kallicharran,WI,Spin,1978-12-01,Wankhede,India,1978,2,9,35,0,1,556,1295,9,547,1260,9,61.77777777777778,>30,IND,Away,Upto 2014
AI Kallicharran,WI,Spin,1979-12-01,Brisbane,Australia,1979,1,32,108,0,1,171,384,1,139,276,1,171.0,>30,AUS,Away,Upto 2014
AI Kallicharran,WI,Spin,1980-02-22,Christchurch,New Zealand,1980,1,16,40,2,1,117,178,4,101,138,2,29.25,<=30,NZ,Away,Upto 2014
AI Kallicharran,WI,Spin,1980-02-29,Auckland,New Zealand,1980,1,0,24,1,1,35,72,1,35,48,0,35.0,>30,NZ,Away,Upto 2014
AI Kallicharran,WI,Spin,1980-07-10,Manchester,England,1980,1,2,6,0,1,55,171,3,53,165,3,18.333333333333332,<=30,ENG,Away,Upto 2014
AI Kallicharran,WI,Spin,1980-07-24,The Oval,England,1980,1,22,36,0,1,102,312,2,80,276,2,51.0,>30,ENG,Away,Upto 2014
AI Kallicharran,WI,Spin,1980-11-24,Lahore,Pakistan,1980,1,4,6,0,1,274,622,12,270,616,12,22.833333333333332,<=30,PAK,Away,Upto 2014
AIC Dodemaide,AUS,Pace,1987-12-26,Melbourne,Australia,1987,2,106,291,7,1,846,1960,31,740,1669,24,27.29032258064516,<=30,AUS,Home,Upto 2014
AIC Dodemaide,AUS,Pace,1988-01-29,Sydney,Australia,1988,1,98,216,1,1,421,1098,12,323,882,11,35.083333333333336,>30,AUS,Home,Upto 2014
AIC Dodemaide,AUS,Pace,1988-02-12,W.A.C.A,Australia,1988,2,98,250,7,1,710,1536,29,612,1286,22,24.482758620689655,<=30,AUS,Home,Upto 2014
AIC Dodemaide,AUS,Pace,1988-09-15,Karachi,Pakistan,1988,1,35,174,0,1,264,678,7,229,504,7,37.714285714285715,>30,PAK,Away,Upto 2014
AIC Dodemaide,AUS,Pace,1988-09-23,Faisalabad,Pakistan,1988,2,135,324,5,1,528,1164,17,393,840,12,31.058823529411764,>30,PAK,Away,Upto 2014
AIC Dodemaide,AUS,Pace,1988-10-07,Lahore,Pakistan,1988,2,76,228,4,1,344,894,11,268,666,7,31.272727272727273,>30,PAK,Away,Upto 2014
AIC Dodemaide,AUS,Pace,1988-11-18,Brisbane,Australia,1988,2,75,132,3,1,708,1383,27,633,1251,24,26.22222222222222,<=30,AUS,Home,Upto 2014
AIC Dodemaide,AUS,Pace,1988-12-02,W.A.C.A,Australia,1988,2,180,246,1,1,1183,2020,32,1003,1774,31,36.96875,>30,AUS,Home,Upto 2014
AIC Dodemaide,AUS,Pace,1992-08-28,Colombo (RPS),Sri Lanka,1992,2,85,180,2,1,531,1227,20,446,1047,18,26.55,<=30,SL,Away,Upto 2014
AIC Dodemaide,AUS,Pace,1992-09-08,Moratuwa,Sri Lanka,1992,1,65,143,4,1,511,1044,22,446,901,18,23.227272727272727,<=30,SL,Away,Upto 2014
AJ Bell,SA,Pace,1929-06-29,Lord's,England,1929,2,159,294,6,1,601,1182,21,442,888,15,28.61904761904762,<=30,ENG,Away,Upto 2014
AJ Bell,SA,Pace,1929-07-13,Leeds,England,1929,2,70,96,1,1,359,767,10,289,671,9,35.9,>30,ENG,Away,Upto 2014
AJ Bell,SA,Pace,1929-07-27,Manchester,England,1929,1,113,192,1,1,396,1059,11,283,867,10,36.0,>30,ENG,Away,Upto 2014
AJ Bell,SA,Pace,1931-01-01,Cape Town,South Africa,1931,2,111,336,4,1,323,942,8,212,606,4,40.375,>30,SA,Home,Upto 2014
AJ Bell,SA,Pace,1931-01-16,Durban,South Africa,1931,1,45,132,0,1,276,836,9,231,704,9,30.666666666666668,>30,SA,Home,Upto 2014
AJ Bell,SA,Pace,1931-02-21,Durban,South Africa,1931,2,77,198,3,1,308,822,11,231,624,8,28.0,<=30,SA,Home,Upto 2014
AJ Bell,SA,Pace,1931-11-27,Brisbane,Australia,1931,1,120,252,4,1,377,952,14,257,700,10,26.928571428571427,<=30,AUS,Away,Upto 2014
AJ Bell,SA,Pace,1931-12-18,Sydney,Australia,1931,1,140,281,5,1,383,911,14,243,630,9,27.357142857142858,<=30,AUS,Away,Upto 2014
AJ Bell,SA,Pace,1931-12-31,Melbourne,Australia,1931,2,170,373,6,1,596,1454,16,426,1081,10,37.25,>30,AUS,Away,Upto 2014
AJ Bell,SA,Pace,1932-01-29,Adelaide,Australia,1932,1,142,240,5,1,508,1020,9,366,780,4,56.44444444444444,>30,AUS,Away,Upto 2014
AJ Bell,SA,Pace,1932-02-12,Melbourne,Australia,1932,1,52,96,3,1,107,351,12,55,255,9,8.916666666666666,<=30,AUS,Away,Upto 2014
AJ Bell,SA,Pace,1932-02-27,Christchurch,New Zealand,1932,2,75,246,3,1,481,1211,11,406,965,8,43.72727272727273,>30,NZ,Away,Upto 2014
AJ Bell,SA,Pace,1932-03-04,Wellington,New Zealand,1932,2,77,156,0,1,449,1052,12,372,896,12,37.416666666666664,>30,NZ,Away,Upto 2014
AJ Bell,SA,Pace,1935-06-29,Lord's,England,1935,2,37,108,1,1,344,844,15,307,736,14,22.933333333333334,<=30,ENG,Away,Upto 2014
AJ Bell,SA,Pace,1935-07-13,Leeds,England,1935,2,86,180,3,1,570,1397,20,484,1217,17,28.5,<=30,ENG,Away,Upto 2014
AJ Bell,SA,Pace,1935-07-27,Manchester,England,1935,2,93,162,3,1,592,1081,17,499,919,14,34.8235294117647,>30,ENG,Away,Upto 2014
AJ Bichel,AUS,Pace,1997-01-25,Adelaide,Australia,1997,2,47,108,1,1,488,1017,11,441,909,10,44.36363636363637,>30,AUS,Home,Upto 2014
AJ Bichel,AUS,Pace,1997-02-01,W.A.C.A,Australia,1997,2,96,117,0,1,699,1242,25,603,1125,25,27.96,<=30,AUS,Home,Upto 2014
AJ Bichel,AUS,Pace,1998-01-30,Adelaide,Australia,1998,2,154,294,1,1,879,2002,24,725,1708,23,36.625,>30,AUS,Home,Upto 2014
AJ Bichel,AUS,Pace,2000-11-23,Brisbane,Australia,2000,2,46,144,2,1,456,1175,24,410,1031,22,19.0,<=30,AUS,Home,Upto 2014
AJ Bichel,AUS,Pace,2000-12-26,Melbourne,Australia,2000,2,78,117,5,1,686,1407,27,608,1290,22,25.40740740740741,<=30,AUS,Home,Upto 2014
AJ Bichel,AUS,Pace,2001-12-26,Melbourne,Australia,2001,2,96,192,4,1,710,1446,22,614,1254,18,32.27272727272727,>30,AUS,Home,Upto 2014
AJ Bichel,AUS,Pace,2002-10-11,Sharjah,UAE,2002,2,32,78,4,1,167,426,14,135,348,10,11.928571428571429,<=30,UAE,Away,Upto 2014
AJ Bichel,AUS,Pace,2002-10-19,Sharjah,UAE,2002,2,74,122,4,1,365,713,15,291,591,11,24.333333333333332,<=30,UAE,Away,Upto 2014
AJ Bichel,AUS,Pace,2002-11-07,Brisbane,Australia,2002,1,74,138,2,1,677,1218,20,603,1080,18,33.85,>30,AUS,Home,Upto 2014
AJ Bichel,AUS,Pace,2002-11-21,Adelaide,Australia,2002,2,109,150,3,1,643,1143,16,534,993,13,40.1875,>30,AUS,Home,Upto 2014
AJ Bichel,AUS,Pace,2003-01-02,Sydney,Australia,2003,2,168,279,5,1,1004,1656,32,836,1377,27,31.375,>30,AUS,Home,Upto 2014
AJ Bichel,AUS,Pace,2003-04-10,Georgetown,West Indies,2003,2,95,126,3,1,811,1248,21,716,1122,18,38.61904761904762,>30,WI,Away,Upto 2014
AJ Bichel,AUS,Pace,2003-04-19,Port of Spain,West Indies,2003,2,79,150,3,1,913,1617,20,834,1467,17,45.65,>30,WI,Away,Upto 2014
AJ Bichel,AUS,Pace,2003-05-01,Bridgetown,West Indies,2003,2,70,168,2,1,652,1455,15,582,1287,13,43.46666666666667,>30,WI,Away,Upto 2014
AJ Bichel,AUS,Pace,2003-05-09,St John's,West Indies,2003,2,102,174,3,1,870,1573,29,768,1399,26,30.0,<=30,WI,Away,Upto 2014
AJ Bichel,AUS,Pace,2003-10-09,W.A.C.A,Australia,2003,2,125,296,6,1,658,1277,15,533,981,9,43.86666666666667,>30,AUS,Home,Upto 2014
AJ Bichel,AUS,Pace,2003-10-17,Sydney,Australia,2003,2,130,260,4,1,646,1058,15,516,798,11,43.06666666666667,>30,AUS,Home,Upto 2014
AJ Bichel,AUS,Pace,2003-12-04,Brisbane,Australia,2003,2,142,186,1,1,735,1213,18,593,1027,17,40.833333333333336,>30,AUS,Home,Upto 2014
AJ Bichel,AUS,Pace,2003-12-12,Adelaide,Australia,2003,2,153,238,5,1,872,1501,19,719,1263,14,45.89473684210526,>30,AUS,Home,Upto 2014
AJ Finch,AUS,Spin,2018-12-26,Melbourne,Australia,2018,1,8,12,0,1,293,756,6,285,744,6,48.833333333333336,>30,AUS,Home,After 1965
AJ Fothergill,ENG,Pace,1889-03-12,Gqeberha,South Africa,1889,2,34,169,5,1,261,668,19,227,499,14,13.736842105263158,<=30,SA,Away,After 1965
AJ Fothergill,ENG,Pace,1889-03-25,Cape Town,South Africa,1889,2,56,152,3,1,290,589,13,234,437,10,22.307692307692307,<=30,SA,Away,After 1965
AJ Hall,SA,Pace,2002-03-08,Cape Town,South Africa,2002,2,53,84,0,1,927,1517,20,874,1433,20,46.35,>30,SA,Home,Upto 2014
AJ Hall,SA,Pace,2002-03-15,Durban,South Africa,2002,2,55,79,1,1,733,1239,21,678,1160,20,34.904761904761905,>30,SA,Home,Upto 2014
AJ Hall,SA,Pace,2002-11-08,Johannesburg,South Africa,2002,2,20,78,5,1,582,1139,26,562,1061,21,22.384615384615383,<=30,SA,Home,Upto 2014
AJ Hall,SA,Pace,2002-11-15,Centurion,South Africa,2002,2,63,132,1,1,905,1840,32,842,1708,31,28.28125,<=30,SA,Home,Upto 2014
AJ Hall,SA,Pace,2003-07-31,Lord's,England,2003,2,84,204,5,1,967,1600,24,883,1396,19,40.291666666666664,>30,ENG,Away,Upto 2014
AJ Hall,SA,Pace,2003-08-14,Nottingham,England,2003,2,94,180,5,1,935,1991,38,841,1811,33,24.605263157894736,<=30,ENG,Away,Upto 2014
AJ Hall,SA,Pace,2003-08-21,Leeds,England,2003,2,141,274,4,1,1130,2145,39,989,1871,35,28.974358974358974,<=30,ENG,Away,Upto 2014
AJ Hall,SA,Pace,2003-09-04,The Oval,England,2003,1,111,210,2,1,1075,1870,24,964,1660,22,44.791666666666664,>30,ENG,Away,Upto 2014
AJ Hall,SA,Pace,2003-12-26,Durban,South Africa,2003,2,71,138,1,1,1030,1831,26,959,1693,25,39.61538461538461,>30,SA,Home,Upto 2014
AJ Hall,SA,Pace,2004-01-16,Centurion,South Africa,2004,2,69,68,0,1,1068,1800,24,999,1732,24,44.5,>30,SA,Home,Upto 2014
AJ Hall,SA,Pace,2004-11-20,Kanpur,India,2004,1,93,154,3,1,487,976,10,394,822,7,48.7,>30,IND,Away,Upto 2014
AJ Hall,SA,Pace,2004-11-28,Eden Gardens,India,2004,2,70,180,1,1,537,1338,17,467,1158,16,31.58823529411765,>30,IND,Away,Upto 2014
AJ Hall,SA,Pace,2004-12-17,Gqeberha,South Africa,2004,2,109,186,2,1,915,1720,27,806,1534,25,33.888888888888886,>30,SA,Home,Upto 2014
AJ Hall,SA,Pace,2005-01-21,Centurion,South Africa,2005,2,67,128,1,1,788,1589,28,721,1461,27,28.142857142857142,<=30,SA,Home,Upto 2014
AJ Hall,SA,Pace,2005-03-31,Georgetown,West Indies,2005,1,53,96,0,1,687,1530,15,634,1434,15,45.8,>30,WI,Away,Upto 2014
AJ Hall,SA,Pace,2006-03-16,Cape Town,South Africa,2006,2,82,126,1,1,563,1099,28,481,973,27,20.107142857142858,<=30,SA,Home,Upto 2014
AJ Hall,SA,Pace,2006-05-05,Johannesburg,South Africa,2006,2,71,131,3,1,757,1280,36,686,1149,33,21.02777777777778,<=30,SA,Home,Upto 2014
AJ Hall,SA,Pace,2006-07-27,Colombo (SSC),Sri Lanka,2006,1,99,150,1,1,781,1191,14,682,1041,13,55.785714285714285,>30,SL,Away,Upto 2014
AJ Hall,SA,Pace,2006-08-04,Colombo (PSS),Sri Lanka,2006,2,106,240,3,1,843,1453,20,737,1213,17,42.15,>30,SL,Away,Upto 2014
AJ Hall,SA,Pace,2006-12-26,Durban,South Africa,2006,2,54,73,3,1,879,1470,33,825,1397,30,26.636363636363637,<=30,SA,Home,Upto 2014
AJ Hall,SA,Pace,2007-01-26,Cape Town,South Africa,2007,2,52,90,3,1,527,865,27,475,775,24,19.51851851851852,<=30,SA,Home,Upto 2014
AJ Hollioake,ENG,Pace,1997-08-07,Nottingham,England,1997,2,55,114,2,1,974,1617,31,919,1503,29,31.419354838709676,>30,ENG,Home,Upto 2014
AJ Hollioake,ENG,Pace,1998-02-05,Port of Spain,West Indies,1998,1,12,30,0,1,715,1728,33,703,1698,33,21.666666666666668,<=30,WI,Away,Upto 2014
AJ Lamb,ENG,Pace,1982-11-12,W.A.C.A,Australia,1982,1,0,6,0,1,850,1760,19,850,1754,19,44.73684210526316,>30,AUS,Away,Upto 2014
AJ Lamb,ENG,Pace,1984-08-23,Lord's,England,1984,1,6,6,0,1,850,1633,19,844,1627,19,44.73684210526316,>30,ENG,Home,Upto 2014
AJ Lamb,ENG,Pace,1984-12-31,Eden Gardens,India,1984,1,6,6,1,1,288,729,8,282,723,7,36.0,>30,IND,Away,Upto 2014
AJ Lamb,ENG,Pace,1985-08-01,Manchester,England,1985,1,10,6,0,1,622,1074,12,612,1068,12,51.833333333333336,>30,ENG,Home,Upto 2014
AJ Lamb,ENG,Pace,1986-11-28,W.A.C.A,Australia,1986,1,0,6,0,1,963,1802,22,963,1796,22,43.77272727272727,>30,AUS,Away,Upto 2014
AJ McKay,NZ,Pace,2010-11-20,Nagpur,India,2010,1,120,186,1,1,407,788,13,287,602,12,31.307692307692307,>30,IND,Away,Upto 2014
AJ Pithey,SA,Spin,1965-01-01,Cape Town,South Africa,1965,1,5,12,0,1,605,1499,14,600,1487,14,43.214285714285715,>30,SA,Home,Upto 2014
AJ Redmond,NZ,Spin,2008-05-23,Manchester,England,2008,1,4,12,0,1,323,648,13,319,636,13,24.846153846153847,<=30,ENG,Away,Upto 2014
AJ Redmond,NZ,Spin,2008-10-17,Chattogram,Bangladesh,2008,1,8,15,1,1,669,1820,29,661,1805,28,23.06896551724138,<=30,BAN,Away,Upto 2014
AJ Redmond,NZ,Spin,2008-10-25,Mirpur,Bangladesh,2008,1,3,12,0,1,361,720,10,358,708,10,36.1,>30,BAN,Away,Upto 2014
AJ Redmond,NZ,Spin,2008-11-28,Adelaide,Australia,2008,1,47,36,2,1,283,706,9,236,670,7,31.444444444444443,>30,AUS,Away,Upto 2014
AJ Redmond,NZ,Spin,2013-12-03,Dunedin,New Zealand,2013,1,18,30,0,1,483,925,11,465,895,11,43.90909090909091,>30,NZ,Home,Upto 2014
AJ Richardson,AUS,Spin,1924-12-19,Sydney,Australia,1924,2,13,48,0,1,978,2361,24,965,2313,24,40.75,>30,AUS,Home,Upto 2014
AJ Richardson,AUS,Spin,1925-01-01,Melbourne,Australia,1925,2,55,288,3,1,988,2427,24,933,2139,21,41.166666666666664,>30,AUS,Home,Upto 2014
AJ Richardson,AUS,Spin,1925-01-16,Adelaide,Australia,1925,2,104,368,4,1,1079,2740,29,975,2372,25,37.206896551724135,>30,AUS,Home,Upto 2014
AJ Richardson,AUS,Spin,1925-02-13,Melbourne,Australia,1925,1,76,208,1,1,718,1606,23,642,1398,22,31.217391304347824,>30,AUS,Home,Upto 2014
AJ Richardson,AUS,Spin,1926-06-12,Nottingham,England,1926,1,0,6,0,1,14,56,0,14,50,0,inf,>30,ENG,Away,Upto 2014
AJ Richardson,AUS,Spin,1926-06-26,Lord's,England,1926,1,73,288,1,1,556,1523,10,483,1235,9,55.6,>30,ENG,Away,Upto 2014
AJ Richardson,AUS,Spin,1926-07-10,Leeds,England,1926,2,66,216,1,1,810,1836,19,744,1620,18,42.63157894736842,>30,ENG,Away,Upto 2014
AJ Richardson,AUS,Spin,1926-07-24,Manchester,England,1926,1,43,102,0,1,479,1184,11,436,1082,11,43.54545454545455,>30,ENG,Away,Upto 2014
AJ Richardson,AUS,Spin,1926-08-14,The Oval,England,1926,2,91,288,2,1,808,2213,28,717,1925,26,28.857142857142858,<=30,ENG,Away,Upto 2014
AJ Stewart,ENG,Pace,1994-02-19,Kingston,West Indies,1994,1,5,14,0,1,877,1820,28,872,1806,28,31.321428571428573,>30,WI,Away,Upto 2014
AJ Stewart,ENG,Pace,1994-04-16,St John's,West Indies,1994,1,8,6,0,1,833,1731,12,825,1725,12,69.41666666666667,>30,WI,Away,Upto 2014
AJ Traicos,SA,Spin,1970-02-05,Durban,South Africa,1970,2,97,230,3,1,348,698,8,251,468,5,43.5,>30,SA,Home,Upto 2014
AJ Traicos,SA,Spin,1970-02-19,Johannesburg,South Africa,1970,2,72,138,1,1,258,538,9,186,400,8,28.666666666666668,<=30,SA,Home,Upto 2014
AJ Traicos,SA,Spin,1970-03-05,Gqeberha,South Africa,1970,2,38,102,0,1,276,494,3,238,392,3,92.0,>30,SA,Home,Upto 2014
AJ Traicos,ZIM,Spin,1992-10-18,Harare,Zimbabwe,1992,1,86,300,5,1,383,1070,9,297,770,4,42.55555555555556,>30,ZIM,Home,Upto 2014
AJ Traicos,ZIM,Spin,1992-11-01,Bulawayo,Zimbabwe,1992,2,138,241,2,1,469,976,10,331,735,8,46.9,>30,ZIM,Home,Upto 2014
AJ Traicos,ZIM,Spin,1992-11-07,Harare,Zimbabwe,1992,2,152,300,4,1,372,723,13,220,423,9,28.615384615384617,<=30,ZIM,Home,Upto 2014
AJ Traicos,ZIM,Spin,1993-03-13,Delhi,India,1993,1,186,300,3,1,645,1548,21,459,1248,18,30.714285714285715,>30,IND,Away,Upto 2014
AJ Tudor,ENG,Pace,1998-11-28,W.A.C.A,Australia,1998,2,108,152,5,1,564,1246,31,456,1094,26,18.193548387096776,<=30,AUS,Away,Upto 2014
AJ Tudor,ENG,Pace,1999-01-02,Sydney,Australia,1999,2,72,102,2,1,361,687,17,289,585,15,21.235294117647058,<=30,AUS,Away,Upto 2014
AJ Tudor,ENG,Pace,1999-07-01,Birmingham,England,1999,2,59,96,1,1,580,1146,27,521,1050,26,21.48148148148148,<=30,ENG,Home,Upto 2014
AJ Tudor,ENG,Pace,2001-08-02,Nottingham,England,2001,2,81,137,6,1,583,930,24,502,793,18,24.291666666666668,<=30,ENG,Home,Upto 2014
AJ Tudor,ENG,Pace,2001-08-16,Leeds,England,2001,2,114,132,1,1,1054,1608,26,940,1476,25,40.53846153846154,>30,ENG,Home,Upto 2014
AJ Tudor,ENG,Pace,2002-05-30,Birmingham,England,2002,2,50,113,2,1,687,1192,22,637,1079,20,31.227272727272727,>30,ENG,Home,Upto 2014
AJ Tudor,ENG,Pace,2002-06-13,Manchester,England,2002,2,109,276,7,1,775,1409,20,666,1133,13,38.75,>30,ENG,Home,Upto 2014
AJ Tudor,ENG,Pace,2002-08-22,Leeds,England,2002,1,146,216,2,1,769,1387,15,623,1171,13,51.266666666666666,>30,ENG,Home,Upto 2014
AJ Tudor,ENG,Pace,2002-09-05,The Oval,England,2002,1,80,114,0,1,664,1200,10,584,1086,10,66.4,>30,ENG,Home,Upto 2014
AJ Tudor,ENG,Pace,2002-11-29,W.A.C.A,Australia,2002,1,144,174,2,1,590,1095,16,446,921,14,36.875,>30,AUS,Away,Upto 2014
AJ Watkins,ENG,Pace,1948-08-14,The Oval,England,1948,1,19,24,0,1,239,753,15,220,729,15,15.933333333333334,<=30,ENG,Home,Upto 2014
AJ Watkins,ENG,Pace,1948-12-16,Durban,South Africa,1948,1,11,24,0,1,290,749,16,279,725,16,18.125,<=30,SA,Away,Upto 2014
AJ Watkins,ENG,Pace,1948-12-27,Johannesburg,South Africa,1948,2,53,136,1,1,428,1173,8,375,1037,7,53.5,>30,SA,Away,Upto 2014
AJ Watkins,ENG,Pace,1949-01-01,Cape Town,South Africa,1949,1,36,80,1,1,484,1256,6,448,1176,5,80.66666666666667,>30,SA,Away,Upto 2014
AJ Watkins,ENG,Pace,1949-02-12,Johannesburg,South Africa,1949,2,25,40,2,1,558,1385,18,533,1345,16,31.0,>30,SA,Away,Upto 2014
AJ Watkins,ENG,Pace,1949-03-05,Gqeberha,South Africa,1949,1,24,40,0,1,319,1001,10,295,961,10,31.9,>30,SA,Away,Upto 2014
AJ Watkins,ENG,Pace,1949-06-25,Lord's,England,1949,1,11,18,0,1,435,853,4,424,835,4,108.75,>30,ENG,Home,Upto 2014
AJ Watkins,ENG,Pace,1951-11-02,Delhi,India,1951,1,60,186,0,1,354,1056,2,294,870,2,177.0,>30,IND,Away,Upto 2014
AJ Watkins,ENG,Pace,1951-12-14,Brabourne,India,1951,2,117,270,3,1,609,1495,17,492,1225,14,35.8235294117647,>30,IND,Away,Upto 2014
AJ Watkins,ENG,Pace,1951-12-30,Eden Gardens,India,1951,1,31,126,0,1,283,907,5,252,781,5,56.6,>30,IND,Away,Upto 2014
AJ Watkins,ENG,Pace,1952-01-12,Kanpur,India,1952,1,6,30,0,1,37,120,0,31,90,0,inf,>30,IND,Away,Upto 2014
AJ Watkins,ENG,Pace,1952-02-06,Chennai,India,1952,1,50,84,1,1,228,540,4,178,456,3,57.0,>30,IND,Away,Upto 2014
AJ Watkins,ENG,Pace,1952-06-05,Leeds,England,1952,2,53,132,0,1,376,1124,14,323,992,14,26.857142857142858,<=30,ENG,Home,Upto 2014
AJ Watkins,ENG,Pace,1952-06-19,Lord's,England,1952,2,57,150,3,1,486,1206,17,429,1056,14,28.58823529411765,<=30,ENG,Home,Upto 2014
AJ Watkins,ENG,Pace,1952-07-17,Manchester,England,1952,1,1,24,0,1,188,520,17,187,496,17,11.058823529411764,<=30,ENG,Home,Upto 2014
AJL Hill,ENG,Spin,1896-03-21,Cape Town,South Africa,1896,1,8,40,4,1,223,529,14,215,489,10,15.928571428571429,<=30,SA,Away,After 1965
AJY Hopkins,AUS,Pace,1902-05-29,Birmingham,England,1902,1,28,36,0,1,229,582,9,201,546,9,25.444444444444443,<=30,ENG,Away,Upto 2014
AJY Hopkins,AUS,Pace,1902-06-12,Lord's,England,1902,1,18,54,2,1,82,168,2,64,114,0,41.0,>30,ENG,Away,Upto 2014
AJY Hopkins,AUS,Pace,1902-07-24,Manchester,England,1902,1,3,12,0,1,194,433,13,191,421,13,14.923076923076923,<=30,ENG,Away,Upto 2014
AJY Hopkins,AUS,Pace,1902-10-11,Johannesburg,South Africa,1902,2,76,84,3,1,545,690,15,469,606,12,36.333333333333336,>30,SA,Away,Upto 2014
AJY Hopkins,AUS,Pace,1902-10-18,Johannesburg,South Africa,1902,1,2,12,0,1,466,648,16,464,636,16,29.125,<=30,SA,Away,Upto 2014
AJY Hopkins,AUS,Pace,1902-11-08,Cape Town,South Africa,1902,1,37,48,2,1,317,563,15,280,515,13,21.133333333333333,<=30,SA,Away,Upto 2014
AJY Hopkins,AUS,Pace,1903-12-11,Sydney,Australia,1903,1,40,66,0,1,649,1476,14,609,1410,14,46.357142857142854,>30,AUS,Home,Upto 2014
AJY Hopkins,AUS,Pace,1904-01-01,Melbourne,Australia,1904,2,53,132,1,1,196,525,10,143,393,9,19.6,<=30,AUS,Home,Upto 2014
AJY Hopkins,AUS,Pace,1904-01-15,Adelaide,Australia,1904,2,149,313,7,1,683,1465,19,534,1152,12,35.94736842105263,>30,AUS,Home,Upto 2014
AJY Hopkins,AUS,Pace,1904-02-26,Sydney,Australia,1904,2,53,132,3,1,327,845,17,274,713,14,19.235294117647058,<=30,AUS,Home,Upto 2014
AJY Hopkins,AUS,Pace,1905-06-15,Lord's,England,1905,2,51,102,3,1,344,822,16,293,720,13,21.5,<=30,ENG,Away,Upto 2014
AJY Hopkins,AUS,Pace,1905-07-03,Leeds,England,1905,1,21,54,0,1,525,1232,17,504,1178,17,30.88235294117647,>30,ENG,Away,Upto 2014
AJY Hopkins,AUS,Pace,1905-08-14,The Oval,England,1905,2,43,72,1,1,775,1333,24,732,1261,23,32.291666666666664,>30,ENG,Away,Upto 2014
AJY Hopkins,AUS,Pace,1909-07-26,Manchester,England,1909,1,31,72,2,1,310,803,19,279,731,17,16.31578947368421,<=30,ENG,Away,Upto 2014
AJY Hopkins,AUS,Pace,1909-08-09,The Oval,England,1909,2,91,138,2,1,457,871,15,366,733,13,30.466666666666665,>30,ENG,Away,Upto 2014
AK Davidson,AUS,Pace,1953-06-11,Nottingham,England,1953,2,29,120,2,1,325,969,23,296,849,21,14.130434782608695,<=30,ENG,Away,Upto 2014
AK Davidson,AUS,Pace,1953-06-25,Lord's,England,1953,2,38,149,1,1,553,1514,19,515,1365,18,29.105263157894736,<=30,ENG,Away,Upto 2014
AK Davidson,AUS,Pace,1953-07-09,Manchester,England,1953,1,60,120,2,1,352,924,14,292,804,12,25.142857142857142,<=30,ENG,Away,Upto 2014
AK Davidson,AUS,Pace,1953-07-23,Leeds,England,1953,2,59,301,3,1,617,1986,30,558,1685,27,20.566666666666666,<=30,ENG,Away,Upto 2014
AK Davidson,AUS,Pace,1953-08-15,The Oval,England,1953,1,26,60,0,1,504,1206,15,478,1146,15,33.6,>30,ENG,Away,Upto 2014
AK Davidson,AUS,Pace,1954-12-17,Sydney,Australia,1954,2,86,200,2,1,649,1696,33,563,1496,31,19.666666666666668,<=30,AUS,Home,Upto 2014
AK Davidson,AUS,Pace,1955-01-28,Adelaide,Australia,1955,2,62,216,1,1,511,1397,23,449,1181,22,22.217391304347824,<=30,AUS,Home,Upto 2014
AK Davidson,AUS,Pace,1955-02-25,Sydney,Australia,1955,1,72,152,0,1,382,806,7,310,654,7,54.57142857142857,>30,AUS,Home,Upto 2014
AK Davidson,AUS,Pace,1956-06-07,Nottingham,England,1956,1,22,58,1,1,363,976,12,341,918,11,30.25,>30,ENG,Away,Upto 2014
AK Davidson,AUS,Pace,1956-08-23,The Oval,England,1956,2,34,60,1,1,409,1082,18,375,1022,17,22.72222222222222,<=30,ENG,Away,Upto 2014
AK Davidson,AUS,Pace,1956-10-11,Karachi,Pakistan,1956,2,15,90,2,1,382,1421,26,367,1331,24,14.692307692307692,<=30,PAK,Away,Upto 2014
AK Davidson,AUS,Pace,1956-10-26,Brabourne,India,1956,2,42,138,1,1,321,854,10,279,716,9,32.1,>30,IND,Away,Upto 2014
AK Davidson,AUS,Pace,1957-12-23,Johannesburg,South Africa,1957,2,149,396,7,1,682,1716,24,533,1320,17,28.416666666666668,<=30,SA,Away,Upto 2014
AK Davidson,AUS,Pace,1957-12-31,Cape Town,South Africa,1957,2,49,264,4,1,357,1102,8,308,838,4,44.625,>30,SA,Away,Upto 2014
AK Davidson,AUS,Pace,1958-01-24,Durban,South Africa,1958,1,62,272,2,1,460,1804,17,398,1532,15,27.058823529411764,<=30,SA,Away,Upto 2014
AK Davidson,AUS,Pace,1958-02-07,Johannesburg,South Africa,1958,2,83,312,3,1,425,1453,14,342,1141,11,30.357142857142858,>30,SA,Away,Upto 2014
AK Davidson,AUS,Pace,1958-02-28,Gqeberha,South Africa,1958,2,82,369,9,1,429,1409,18,347,1040,9,23.833333333333332,<=30,SA,Away,Upto 2014
AK Davidson,AUS,Pace,1958-12-05,Brisbane,Australia,1958,2,66,352,5,1,361,1352,20,295,1000,15,18.05,<=30,AUS,Home,Upto 2014
AK Davidson,AUS,Pace,1958-12-31,Melbourne,Australia,1958,2,105,325,9,1,456,1361,29,351,1036,20,15.724137931034482,<=30,AUS,Home,Upto 2014
AK Davidson,AUS,Pace,1959-01-09,Sydney,Australia,1959,2,86,360,2,1,297,1016,5,211,656,3,59.4,>30,AUS,Home,Upto 2014
AK Davidson,AUS,Pace,1959-01-30,Adelaide,Australia,1959,2,66,163,3,1,681,1789,20,615,1626,17,34.05,>30,AUS,Home,Upto 2014
AK Davidson,AUS,Pace,1959-02-13,Melbourne,Australia,1959,2,133,269,5,1,613,1344,20,480,1075,15,30.65,>30,AUS,Home,Upto 2014
AK Davidson,AUS,Pace,1959-11-13,Dhaka,Bangladesh,1959,2,65,209,4,1,428,1301,20,363,1092,16,21.4,<=30,BAN,Away,Upto 2014
AK Davidson,AUS,Pace,1959-11-21,Lahore,Pakistan,1959,2,104,324,4,1,401,960,14,297,636,10,28.642857142857142,<=30,PAK,Away,Upto 2014
AK Davidson,AUS,Pace,1959-12-04,Karachi,Pakistan,1959,2,129,360,4,1,568,1464,19,439,1104,15,29.894736842105264,<=30,PAK,Away,Upto 2014
AK Davidson,AUS,Pace,1959-12-12,Delhi,India,1959,2,38,168,3,1,410,963,10,372,795,7,41.0,>30,IND,Away,Upto 2014
AK Davidson,AUS,Pace,1959-12-19,Kanpur,India,1959,2,124,466,12,1,231,796,13,107,330,1,17.76923076923077,<=30,IND,Away,Upto 2014
AK Davidson,AUS,Pace,1960-01-01,Brabourne,India,1960,2,87,293,4,1,552,1475,15,465,1182,11,36.8,>30,IND,Away,Upto 2014
AK Davidson,AUS,Pace,1960-01-13,Chennai,India,1960,2,69,228,5,1,260,780,12,191,552,7,21.666666666666668,<=30,IND,Away,Upto 2014
AK Davidson,AUS,Pace,1960-01-23,Eden Gardens,India,1960,2,113,314,5,1,523,1340,17,410,1026,12,30.764705882352942,>30,IND,Away,Upto 2014
AK Davidson,AUS,Pace,1960-12-09,Brisbane,Australia,1960,2,222,438,11,1,640,1184,22,418,746,11,29.09090909090909,<=30,AUS,Home,Upto 2014
AK Davidson,AUS,Pace,1960-12-30,Melbourne,Australia,1960,2,104,300,8,1,364,824,18,260,524,10,20.22222222222222,<=30,AUS,Home,Upto 2014
AK Davidson,AUS,Pace,1961-01-13,Sydney,Australia,1961,2,113,238,8,1,402,914,14,289,676,6,28.714285714285715,<=30,AUS,Home,Upto 2014
AK Davidson,AUS,Pace,1961-02-10,Melbourne,Australia,1961,2,173,415,6,1,407,855,11,234,440,5,37.0,>30,AUS,Home,Upto 2014
AK Davidson,AUS,Pace,1961-06-08,Birmingham,England,1961,2,130,342,1,1,708,1529,14,578,1187,13,50.57142857142857,>30,ENG,Away,Upto 2014
AK Davidson,AUS,Pace,1961-06-22,Lord's,England,1961,2,92,291,7,1,687,1676,33,595,1385,26,20.818181818181817,<=30,ENG,Away,Upto 2014
AK Davidson,AUS,Pace,1961-07-06,Leeds,England,1961,2,80,348,6,1,372,1169,24,292,821,18,15.5,<=30,ENG,Away,Upto 2014
AK Davidson,AUS,Pace,1961-07-27,Manchester,England,1961,2,120,322,5,1,869,2028,25,749,1706,20,34.76,>30,ENG,Away,Upto 2014
AK Davidson,AUS,Pace,1961-08-17,The Oval,England,1961,2,150,379,4,1,680,1860,19,530,1481,15,35.78947368421053,>30,ENG,Away,Upto 2014
AK Davidson,AUS,Pace,1962-11-30,Brisbane,Australia,1962,2,120,328,3,1,871,1952,19,751,1624,16,45.8421052631579,>30,AUS,Home,Upto 2014
AK Davidson,AUS,Pace,1962-12-29,Melbourne,Australia,1962,2,128,337,6,1,758,2009,23,630,1672,17,32.95652173913044,>30,AUS,Home,Upto 2014
AK Davidson,AUS,Pace,1963-01-11,Sydney,Australia,1963,2,79,283,9,1,454,1207,16,375,924,7,28.375,<=30,AUS,Home,Upto 2014
AK Davidson,AUS,Pace,1963-01-25,Adelaide,Australia,1963,1,30,28,0,1,686,1693,27,656,1665,27,25.40740740740741,<=30,AUS,Home,Upto 2014
AK Davidson,AUS,Pace,1963-02-15,Sydney,Australia,1963,2,123,430,6,1,466,1318,15,343,888,9,31.066666666666666,>30,AUS,Home,Upto 2014
AK Kuruppuarachchi,SL,Pace,1986-03-14,Colombo (CCC),Sri Lanka,1986,2,85,152,7,1,530,1137,31,445,985,24,17.096774193548388,<=30,SL,Home,Upto 2014
AK Kuruppuarachchi,SL,Pace,1987-04-16,Colombo (CCC),Sri Lanka,1987,1,64,120,1,1,574,1325,10,510,1205,9,57.4,>30,SL,Home,Upto 2014
AK Markram,SA,Spin,2017-09-28,Potchefstroom,South Africa,2017,1,13,12,0,1,504,803,10,491,791,10,50.4,>30,SA,Home,After 1965
AK Markram,SA,Spin,2018-03-01,Durban,South Africa,2018,1,2,6,0,1,376,722,13,374,716,13,28.923076923076923,<=30,SA,Home,After 1965
AK Markram,SA,Spin,2018-03-09,Gqeberha,South Africa,2018,1,3,18,0,1,252,456,5,249,438,5,50.4,>30,SA,Home,After 1965
AK Markram,SA,Spin,2018-03-30,Johannesburg,South Africa,2018,2,6,16,0,1,456,724,9,450,708,9,50.666666666666664,>30,SA,Home,After 1965
AK Markram,SA,Spin,2018-07-20,Colombo (SSC),Sri Lanka,2018,2,42,94,0,1,722,1323,32,680,1229,32,22.5625,<=30,SL,Away,After 1965
AK Markram,SA,Spin,2019-02-13,Durban,South Africa,2019,1,4,6,0,1,237,390,9,233,384,9,26.333333333333332,<=30,SA,Home,After 1965
AK Markram,SA,Spin,2019-10-10,Pune,India,2019,1,17,12,0,1,587,1113,12,570,1101,12,48.916666666666664,>30,IND,Away,After 1965
AK Markram,SA,Spin,2020-12-26,Centurion,South Africa,2020,1,6,18,0,1,312,480,4,306,462,4,78.0,>30,SA,Home,After 1965
AK Markram,SA,Spin,2021-01-26,Karachi,Pakistan,2021,1,10,18,0,1,369,904,18,359,886,18,20.5,<=30,PAK,Away,After 1965
AK Markram,SA,Spin,2022-02-17,Christchurch,New Zealand,2022,1,27,48,2,1,27,48,2,0,0,0,13.5,<=30,NZ,Away,After 1965
AK Markram,SA,Spin,2023-03-08,Johannesburg,South Africa,2023,1,0,1,0,1,406,700,11,406,699,11,36.90909090909091,>30,SA,Home,After 1965
AK Markram,SA,Spin,2024-08-07,Port of Spain,West Indies,2024,2,68,126,1,1,492,926,15,424,800,14,32.8,>30,WI,Away,After 1965
AK Markram,SA,Spin,2024-10-21,Mirpur,Bangladesh,2024,1,7,18,0,1,586,1001,17,579,983,17,34.470588235294116,>30,BAN,Away,After 1965
AK Markram,SA,Spin,2024-10-29,Chattogram,Bangladesh,2024,2,14,42,0,1,583,920,17,569,878,17,34.294117647058826,>30,BAN,Away,After 1965
AK Markram,SA,Spin,2024-12-05,Gqeberha,South Africa,2024,2,21,30,0,1,411,788,13,390,758,13,31.615384615384617,>30,SA,Home,After 1965
AK Markram,SA,Spin,2025-01-03,Cape Town,South Africa,2025,1,14,18,0,1,445,729,11,431,711,11,40.45454545454545,>30,SA,Home,After 1965
AK Sharma,IND,Spin,1988-01-11,Chennai,India,1988,1,9,24,0,1,536,1127,23,527,1103,23,23.304347826086957,<=30,IND,Home,Upto 2014
AL Hassett,AUS,Pace,1938-08-20,The Oval,England,1938,1,52,78,0,1,391,703,13,339,625,13,30.076923076923077,>30,ENG,Away,Upto 2014
AL Hassett,AUS,Pace,1950-02-10,Johannesburg,South Africa,1950,1,5,8,0,1,524,1232,15,519,1224,15,34.93333333333333,>30,SA,Away,Upto 2014
AL Hassett,AUS,Pace,1951-02-23,Melbourne,Australia,1951,1,4,6,0,1,340,912,18,336,906,18,18.88888888888889,<=30,AUS,Home,Upto 2014
AL Hassett,AUS,Pace,1953-01-24,Adelaide,Australia,1953,1,1,8,0,1,427,785,5,426,777,5,85.4,>30,AUS,Home,Upto 2014
AL Hassett,AUS,Pace,1953-02-06,Melbourne,Australia,1953,1,12,5,0,1,486,1431,11,474,1426,11,44.18181818181818,>30,AUS,Home,Upto 2014
AL Hassett,AUS,Pace,1953-08-15,The Oval,England,1953,1,4,6,0,1,504,1206,15,500,1200,15,33.6,>30,ENG,Away,Upto 2014
AL Logie,WI,Spin,1984-03-16,Port of Spain,West Indies,1984,1,4,1,0,1,293,601,6,289,600,6,48.833333333333336,>30,WI,Home,Upto 2014
AL Logie,WI,Spin,1985-03-29,Port of Spain,West Indies,1985,1,0,6,0,1,167,462,3,167,456,3,55.666666666666664,>30,WI,Home,Upto 2014
AL Mann,AUS,Spin,1977-12-02,Brisbane,Australia,1977,2,64,168,3,1,389,908,12,325,740,9,32.416666666666664,>30,AUS,Home,Upto 2014
AL Mann,AUS,Spin,1977-12-16,W.A.C.A,Australia,1977,2,112,152,0,1,719,1592,15,607,1440,15,47.93333333333333,>30,AUS,Home,Upto 2014
AL Mann,AUS,Spin,1977-12-30,Melbourne,Australia,1977,2,39,72,1,1,349,802,20,310,730,19,17.45,<=30,AUS,Home,Upto 2014
AL Mann,AUS,Spin,1978-01-07,Sydney,Australia,1978,1,101,160,0,1,426,1124,16,325,964,16,26.625,<=30,AUS,Home,Upto 2014
AL Ochse,SA,Pace,1928-01-21,Durban,South Africa,1928,1,45,66,0,1,482,1079,8,437,1013,8,60.25,>30,SA,Home,Upto 2014
AL Ochse,SA,Pace,1929-06-15,Birmingham,England,1929,2,167,319,6,1,506,1355,18,339,1036,12,28.11111111111111,<=30,ENG,Away,Upto 2014
AL Ochse,SA,Pace,1929-06-29,Lord's,England,1929,2,150,264,4,1,601,1182,21,451,918,17,28.61904761904762,<=30,ENG,Away,Upto 2014
AL Padmore,WI,Spin,1976-04-07,Port of Spain,West Indies,1976,2,134,456,1,1,858,2099,21,724,1643,20,40.857142857142854,>30,WI,Home,Upto 2014
AL Padmore,WI,Spin,1976-07-08,Manchester,England,1976,1,1,18,0,1,286,618,6,285,600,6,47.666666666666664,>30,ENG,Away,Upto 2014
AL Phehlukwayo,SA,Pace,2017-09-28,Potchefstroom,South Africa,2017,2,18,42,1,1,634,1140,16,616,1098,15,39.625,>30,SA,Home,After 1965
AL Phehlukwayo,SA,Pace,2017-10-06,Bloemfontein,South Africa,2017,2,64,88,3,1,638,933,23,574,845,20,27.73913043478261,<=30,SA,Home,After 1965
AL Phehlukwayo,SA,Pace,2017-12-26,Gqeberha,South Africa,2017,2,25,60,5,1,327,664,21,302,604,16,15.571428571428571,<=30,SA,Home,After 1965
AL Phehlukwayo,SA,Pace,2018-01-24,Johannesburg,South Africa,2018,2,40,60,2,1,749,1777,40,709,1717,38,18.725,<=30,SA,Home,After 1965
AL Thomson,AUS,Pace,1970-11-27,Brisbane,Australia,1970,2,156,376,1,1,624,1629,19,468,1253,18,32.8421052631579,>30,AUS,Home,Upto 2014
AL Thomson,AUS,Pace,1970-12-11,W.A.C.A,Australia,1970,2,189,392,3,1,852,2129,21,663,1737,18,40.57142857142857,>30,AUS,Home,Upto 2014
AL Thomson,AUS,Pace,1971-01-21,Melbourne,Australia,1971,2,136,360,3,1,660,1712,13,524,1352,10,50.76923076923077,>30,AUS,Home,Upto 2014
AL Thomson,AUS,Pace,1971-01-29,Adelaide,Australia,1971,2,173,391,5,1,768,1851,22,595,1460,17,34.90909090909091,>30,AUS,Home,Upto 2014
AL Valentine,WI,Spin,1950-06-08,Manchester,England,1950,2,204,636,11,1,787,2271,35,583,1635,24,22.485714285714284,<=30,ENG,Away,Upto 2014
AL Valentine,WI,Spin,1950-06-24,Lord's,England,1950,2,127,696,7,1,844,2771,30,717,2075,23,28.133333333333333,<=30,ENG,Away,Upto 2014
AL Valentine,WI,Spin,1950-07-20,Nottingham,England,1950,2,183,660,5,1,728,2103,19,545,1443,14,38.31578947368421,>30,ENG,Away,Upto 2014
AL Valentine,WI,Spin,1950-08-12,The Oval,England,1950,2,160,543,10,1,654,1981,25,494,1438,15,26.16,<=30,ENG,Away,Upto 2014
AL Valentine,WI,Spin,1951-11-09,Brisbane,Australia,1951,2,216,527,6,1,714,1815,27,498,1288,21,26.444444444444443,<=30,AUS,Away,Upto 2014
AL Valentine,WI,Spin,1951-11-30,Sydney,Australia,1951,2,156,325,4,1,842,1964,19,686,1639,15,44.31578947368421,>30,AUS,Away,Upto 2014
AL Valentine,WI,Spin,1951-12-22,Adelaide,Australia,1951,1,102,221,6,1,501,1145,26,399,924,20,19.26923076923077,<=30,AUS,Away,Upto 2014
AL Valentine,WI,Spin,1951-12-31,Melbourne,Australia,1951,2,138,424,6,1,557,1523,18,419,1099,12,30.944444444444443,>30,AUS,Away,Upto 2014
AL Valentine,WI,Spin,1952-01-25,Sydney,Australia,1952,1,79,240,2,1,474,1237,15,395,997,13,31.6,>30,AUS,Away,Upto 2014
AL Valentine,WI,Spin,1952-02-08,Christchurch,New Zealand,1952,2,124,474,5,1,593,1754,25,469,1280,20,23.72,<=30,NZ,Away,Upto 2014
AL Valentine,WI,Spin,1952-02-15,Auckland,New Zealand,1952,1,29,208,3,1,442,1192,12,413,984,9,36.833333333333336,>30,NZ,Away,Upto 2014
AL Valentine,WI,Spin,1953-01-21,Port of Spain,West Indies,1953,2,139,504,3,1,842,2177,19,703,1673,16,44.31578947368421,>30,WI,Home,Upto 2014
AL Valentine,WI,Spin,1953-02-07,Bridgetown,West Indies,1953,2,111,456,6,1,692,2028,31,581,1572,25,22.322580645161292,<=30,WI,Home,Upto 2014
AL Valentine,WI,Spin,1953-02-19,Port of Spain,West Indies,1953,2,167,524,2,1,777,2186,14,610,1662,12,55.5,>30,WI,Home,Upto 2014
AL Valentine,WI,Spin,1953-03-11,Georgetown,West Indies,1953,2,198,527,8,1,639,1831,18,441,1304,10,35.5,>30,WI,Home,Upto 2014
AL Valentine,WI,Spin,1953-03-28,Kingston,West Indies,1953,2,213,569,9,1,921,2154,20,708,1585,11,46.05,>30,WI,Home,Upto 2014
AL Valentine,WI,Spin,1954-01-15,Kingston,West Indies,1954,2,121,336,3,1,426,1149,15,305,813,12,28.4,<=30,WI,Home,Upto 2014
AL Valentine,WI,Spin,1954-02-06,Bridgetown,West Indies,1954,2,148,545,3,1,772,2250,20,624,1705,17,38.6,>30,WI,Home,Upto 2014
AL Valentine,WI,Spin,1954-02-24,Georgetown,West Indies,1954,1,109,264,1,1,666,2079,21,557,1815,20,31.714285714285715,>30,WI,Home,Upto 2014
AL Valentine,WI,Spin,1955-03-26,Kingston,West Indies,1955,1,113,324,3,1,550,1394,11,437,1070,8,50.0,>30,WI,Home,Upto 2014
AL Valentine,WI,Spin,1955-04-11,Port of Spain,West Indies,1955,1,133,294,2,1,545,1044,8,412,750,6,68.125,>30,WI,Home,Upto 2014
AL Valentine,WI,Spin,1955-05-14,Bridgetown,West Indies,1955,2,103,222,0,1,1042,2444,22,939,2222,22,47.36363636363637,>30,WI,Home,Upto 2014
AL Valentine,WI,Spin,1956-02-03,Dunedin,New Zealand,1956,2,79,360,4,1,439,1372,20,360,1012,16,21.95,<=30,NZ,Away,Upto 2014
AL Valentine,WI,Spin,1956-02-18,Christchurch,New Zealand,1956,2,80,268,7,1,464,1136,24,384,868,17,19.333333333333332,<=30,NZ,Away,Upto 2014
AL Valentine,WI,Spin,1956-03-03,Wellington,New Zealand,1956,2,49,300,1,1,421,1506,19,372,1206,18,22.157894736842106,<=30,NZ,Away,Upto 2014
AL Valentine,WI,Spin,1956-03-09,Auckland,New Zealand,1956,2,75,282,3,1,420,1482,16,345,1200,13,26.25,<=30,NZ,Away,Upto 2014
AL Valentine,WI,Spin,1957-06-20,Lord's,England,1957,1,20,18,0,1,343,654,7,323,636,7,49.0,>30,ENG,Away,Upto 2014
AL Valentine,WI,Spin,1957-07-04,Nottingham,England,1957,1,68,138,0,1,731,1812,9,663,1674,9,81.22222222222223,>30,ENG,Away,Upto 2014
AL Valentine,WI,Spin,1958-01-17,Bridgetown,West Indies,1958,2,124,272,3,1,679,1898,11,555,1626,8,61.72727272727273,>30,WI,Home,Upto 2014
AL Valentine,WI,Spin,1960-12-09,Brisbane,Australia,1960,2,109,272,1,1,778,1958,13,669,1686,12,59.84615384615385,>30,AUS,Away,Upto 2014
AL Valentine,WI,Spin,1960-12-30,Melbourne,Australia,1960,1,55,89,1,1,443,1051,13,388,962,12,34.07692307692308,>30,AUS,Away,Upto 2014
AL Valentine,WI,Spin,1961-01-13,Sydney,Australia,1961,2,153,396,8,1,670,1732,26,517,1336,18,25.76923076923077,<=30,AUS,Away,Upto 2014
AL Valentine,WI,Spin,1961-01-27,Adelaide,Australia,1961,2,114,328,1,1,1001,2526,24,887,2198,23,41.708333333333336,>30,AUS,Away,Upto 2014
AL Valentine,WI,Spin,1961-02-10,Melbourne,Australia,1961,2,102,279,3,1,762,2498,25,660,2219,22,30.48,>30,AUS,Away,Upto 2014
AL Valentine,WI,Spin,1962-03-23,Bridgetown,West Indies,1962,2,54,276,1,1,596,2431,22,542,2155,21,27.09090909090909,<=30,WI,Home,Upto 2014
AL Valentine,WI,Spin,1962-04-13,Kingston,West Indies,1962,2,60,156,1,1,527,1208,20,467,1052,19,26.35,<=30,WI,Home,Upto 2014
AL Wadekar,IND,Spin,1966-12-13,Brabourne,India,1966,2,9,7,0,1,1023,2319,28,1014,2312,28,36.535714285714285,>30,IND,Home,Upto 2014
AL Wadekar,IND,Spin,1967-06-08,Leeds,England,1967,2,17,18,0,1,861,2089,19,844,2071,19,45.31578947368421,>30,ENG,Away,Upto 2014
AL Wadekar,IND,Spin,1969-11-15,Kanpur,India,1969,1,0,6,0,1,657,2057,13,657,2051,13,50.53846153846154,>30,IND,Home,Upto 2014
AL Wadekar,IND,Spin,1969-12-12,Eden Gardens,India,1969,1,17,12,0,1,380,1033,12,363,1021,12,31.666666666666668,>30,IND,Home,Upto 2014
AL Wadekar,IND,Spin,1971-03-19,Georgetown,West Indies,1971,1,12,18,0,1,785,2232,14,773,2214,14,56.07142857142857,>30,WI,Away,Upto 2014
ALF de Mel,SL,Pace,1982-02-17,Colombo (PSS),Sri Lanka,1982,2,103,181,5,1,292,600,11,189,419,6,26.545454545454547,<=30,SL,Home,Upto 2014
ALF de Mel,SL,Pace,1982-03-05,Karachi,Pakistan,1982,2,224,308,4,1,440,708,10,216,400,6,44.0,>30,PAK,Away,Upto 2014
ALF de Mel,SL,Pace,1982-03-14,Faisalabad,Pakistan,1982,2,144,240,4,1,305,474,6,161,234,2,50.833333333333336,>30,PAK,Away,Upto 2014
ALF de Mel,SL,Pace,1982-03-22,Lahore,Pakistan,1982,1,120,168,3,1,456,794,20,336,626,17,22.8,<=30,PAK,Away,Upto 2014
ALF de Mel,SL,Pace,1982-09-17,Chennai,India,1982,2,201,258,7,1,686,896,18,485,638,11,38.111111111111114,>30,IND,Away,Upto 2014
ALF de Mel,SL,Pace,1983-04-22,Kandy,Sri Lanka,1983,1,113,138,2,1,440,696,7,327,558,5,62.857142857142854,>30,SL,Home,Upto 2014
ALF de Mel,SL,Pace,1984-08-23,Lord's,England,1984,1,110,222,4,1,850,1633,19,740,1411,15,44.73684210526316,>30,ENG,Away,Upto 2014
ALF de Mel,SL,Pace,1985-08-30,Colombo (SSC),Sri Lanka,1985,2,148,348,5,1,634,1521,27,486,1173,22,23.48148148148148,<=30,SL,Home,Upto 2014
ALF de Mel,SL,Pace,1985-09-06,Colombo (PSS),Sri Lanka,1985,2,127,318,5,1,740,1533,28,613,1215,23,26.428571428571427,<=30,SL,Home,Upto 2014
ALF de Mel,SL,Pace,1985-09-14,Kandy,Sri Lanka,1985,2,163,237,2,1,808,1515,25,645,1278,23,32.32,>30,SL,Home,Upto 2014
ALF de Mel,SL,Pace,1985-10-16,Faisalabad,Pakistan,1985,1,106,162,0,1,718,1505,9,612,1343,9,79.77777777777777,>30,PAK,Away,Upto 2014
ALF de Mel,SL,Pace,1985-10-27,Sialkot,Pakistan,1985,2,106,150,1,1,662,1204,31,556,1054,30,21.35483870967742,<=30,PAK,Away,Upto 2014
ALF de Mel,SL,Pace,1985-11-07,Karachi,Pakistan,1985,2,137,150,6,1,402,787,17,265,637,11,23.647058823529413,<=30,PAK,Away,Upto 2014
ALF de Mel,SL,Pace,1986-02-23,Kandy,Sri Lanka,1986,1,50,98,3,1,238,611,14,188,513,11,17.0,<=30,SL,Home,Upto 2014
ALF de Mel,SL,Pace,1986-03-14,Colombo (CCC),Sri Lanka,1986,2,118,192,6,1,530,1137,31,412,945,25,17.096774193548388,<=30,SL,Home,Upto 2014
ALF de Mel,SL,Pace,1986-03-22,Colombo (PSS),Sri Lanka,1986,1,91,162,1,1,728,1538,20,637,1376,19,36.4,>30,SL,Home,Upto 2014
ALF de Mel,SL,Pace,1986-12-17,Kanpur,India,1986,1,119,186,1,1,810,1291,13,691,1105,12,62.30769230769231,>30,IND,Away,Upto 2014
AM Bacher,SA,Pace,1997-01-16,Johannesburg,South Africa,1997,1,4,6,0,1,895,1774,26,891,1768,26,34.42307692307692,>30,SA,Home,Upto 2014
AM Blignaut,ZIM,Pace,2001-04-19,Bulawayo,Zimbabwe,2001,2,110,222,8,1,731,1458,26,621,1236,18,28.115384615384617,<=30,ZIM,Home,Upto 2014
AM Blignaut,ZIM,Pace,2001-04-26,Harare,Zimbabwe,2001,2,94,252,0,1,669,1497,14,575,1245,14,47.785714285714285,>30,ZIM,Home,Upto 2014
AM Blignaut,ZIM,Pace,2001-06-07,Bulawayo,Zimbabwe,2001,2,93,168,3,1,658,1325,23,565,1157,20,28.608695652173914,<=30,ZIM,Home,Upto 2014
AM Blignaut,ZIM,Pace,2001-06-15,Harare,Zimbabwe,2001,2,158,311,6,1,726,1580,27,568,1269,21,26.88888888888889,<=30,ZIM,Home,Upto 2014
AM Blignaut,ZIM,Pace,2001-07-19,Bulawayo,Zimbabwe,2001,1,116,180,0,1,603,1276,18,487,1096,18,33.5,>30,ZIM,Home,Upto 2014
AM Blignaut,ZIM,Pace,2001-07-27,Harare,Zimbabwe,2001,2,116,144,2,1,709,1347,18,593,1203,16,39.388888888888886,>30,ZIM,Home,Upto 2014
AM Blignaut,ZIM,Pace,2002-11-09,Harare,Zimbabwe,2002,2,160,246,8,1,875,1422,31,715,1176,23,28.225806451612904,<=30,ZIM,Home,Upto 2014
AM Blignaut,ZIM,Pace,2002-11-16,Bulawayo,Zimbabwe,2002,1,75,136,2,1,555,1011,16,480,875,14,34.6875,>30,ZIM,Home,Upto 2014
AM Blignaut,ZIM,Pace,2003-05-22,Lord's,England,2003,1,96,157,3,1,641,1236,26,545,1079,23,24.653846153846153,<=30,ENG,Away,Upto 2014
AM Blignaut,ZIM,Pace,2003-06-05,Chester-le-Street,England,2003,1,95,138,2,1,554,1098,27,459,960,25,20.51851851851852,<=30,ENG,Away,Upto 2014
AM Blignaut,ZIM,Pace,2003-10-09,W.A.C.A,Australia,2003,1,115,168,0,1,658,1277,15,543,1109,15,43.86666666666667,>30,AUS,Away,Upto 2014
AM Blignaut,ZIM,Pace,2003-10-17,Sydney,Australia,2003,2,118,144,3,1,646,1058,15,528,914,12,43.06666666666667,>30,AUS,Away,Upto 2014
AM Blignaut,ZIM,Pace,2003-11-04,Harare,Zimbabwe,2003,2,118,168,2,1,904,1627,24,786,1459,22,37.666666666666664,>30,ZIM,Home,Upto 2014
AM Blignaut,ZIM,Pace,2003-11-12,Bulawayo,Zimbabwe,2003,2,115,208,7,1,595,1210,25,480,1002,18,23.8,<=30,ZIM,Home,Upto 2014
AM Blignaut,ZIM,Pace,2004-02-19,Harare,Zimbabwe,2004,2,85,160,5,1,617,1260,23,532,1100,18,26.82608695652174,<=30,ZIM,Home,Upto 2014
AM Blignaut,ZIM,Pace,2005-03-04,Cape Town,South Africa,2005,1,44,36,0,1,443,710,15,399,674,15,29.533333333333335,<=30,SA,Away,Upto 2014
AM Blignaut,ZIM,Pace,2005-03-11,Centurion,South Africa,2005,1,74,96,0,1,611,1095,23,537,999,23,26.565217391304348,<=30,SA,Away,Upto 2014
AM Blignaut,ZIM,Pace,2005-09-13,Bulawayo,Zimbabwe,2005,1,96,114,1,1,492,794,18,396,680,17,27.333333333333332,<=30,ZIM,Home,Upto 2014
AM Blignaut,ZIM,Pace,2005-09-20,Harare,Zimbabwe,2005,2,86,125,1,1,559,997,27,473,872,26,20.703703703703702,<=30,ZIM,Home,Upto 2014
AM Fernando,SL,Pace,2021-01-03,Johannesburg,South Africa,2021,2,81,138,2,1,660,1080,30,579,942,28,22.0,<=30,SA,Away,After 1965
AM Fernando,SL,Pace,2021-01-14,Galle,Sri Lanka,2021,1,44,84,2,1,215,534,7,171,450,5,30.714285714285715,>30,SL,Home,After 1965
AM Fernando,SL,Pace,2021-01-22,Galle,Sri Lanka,2021,1,31,60,0,1,261,633,10,230,573,10,26.1,<=30,SL,Home,After 1965
AM Fernando,SL,Pace,2022-05-15,Chattogram,Bangladesh,2022,1,72,156,3,1,332,607,7,260,451,4,47.42857142857143,>30,BAN,Away,After 1965
AM Fernando,SL,Pace,2022-05-23,Mirpur,Bangladesh,2022,2,144,261,10,1,494,899,21,350,638,11,23.523809523809526,<=30,BAN,Away,After 1965
AM Fernando,SL,Pace,2022-06-29,Galle,Sri Lanka,2022,1,37,53,2,1,116,191,4,79,138,2,29.0,<=30,SL,Home,After 1965
AM Fernando,SL,Pace,2022-07-24,Galle,Sri Lanka,2022,2,82,156,1,1,287,503,6,205,347,5,47.833333333333336,>30,SL,Home,After 1965
AM Fernando,SL,Pace,2023-03-09,Christchurch,New Zealand,2023,2,148,291,7,1,1067,1960,32,919,1669,25,33.34375,>30,NZ,Away,After 1965
AM Fernando,SL,Pace,2023-03-17,Wellington,New Zealand,2023,1,110,156,0,1,761,1427,16,651,1271,16,47.5625,>30,NZ,Away,After 1965
AM Fernando,SL,Pace,2023-04-16,Galle,Sri Lanka,2023,2,24,48,0,1,244,399,7,220,351,7,34.857142857142854,>30,SL,Home,After 1965
AM Fernando,SL,Pace,2023-04-24,Galle,Sri Lanka,2023,2,108,201,5,1,403,633,9,295,432,4,44.77777777777778,>30,SL,Home,After 1965
AM Fernando,SL,Pace,2023-07-24,Colombo (SSC),Sri Lanka,2023,1,133,150,3,1,369,580,10,236,430,7,36.9,>30,SL,Home,After 1965
AM Fernando,SL,Pace,2024-02-02,Colombo (SSC),Sri Lanka,2024,2,87,217,6,1,535,897,18,448,680,12,29.72222222222222,<=30,SL,Home,After 1965
AM Fernando,SL,Pace,2024-03-30,Chattogram,Bangladesh,2024,2,96,154,4,1,504,886,22,408,732,18,22.90909090909091,<=30,BAN,Away,After 1965
AM Fernando,SL,Pace,2024-08-21,Manchester,England,2024,2,128,180,6,1,733,1160,25,605,980,19,29.32,<=30,ENG,Away,After 1965
AM Fernando,SL,Pace,2024-08-29,Lord's,England,2024,2,154,222,8,1,781,1252,34,627,1030,26,22.970588235294116,<=30,ENG,Away,After 1965
AM Fernando,SL,Pace,2024-09-06,The Oval,England,2024,2,137,192,3,1,809,1069,28,672,877,25,28.892857142857142,<=30,ENG,Away,After 1965
AM Fernando,SL,Pace,2024-09-18,Galle,Sri Lanka,2024,2,30,54,1,1,264,533,10,234,479,9,26.4,<=30,SL,Home,After 1965
AM Fernando,SL,Pace,2024-09-26,Galle,Sri Lanka,2024,2,22,54,1,1,205,300,2,183,246,1,102.5,>30,SL,Home,After 1965
AM Fernando,SL,Pace,2024-11-27,Durban,South Africa,2024,2,98,194,4,1,556,1001,29,458,807,25,19.17241379310345,<=30,SA,Away,After 1965
AM Fernando,SL,Pace,2024-12-05,Gqeberha,South Africa,2024,2,154,228,4,1,793,1361,26,639,1133,22,30.5,>30,SA,Away,After 1965
AM Fernando,SL,Pace,2025-01-29,Galle,Sri Lanka,2025,1,77,90,0,1,104,168,3,27,78,3,34.666666666666664,>30,SL,Home,After 1965
AM Ghazanfar,AFG,Spin,2024-12-26,Bulawayo,Zimbabwe,2024,2,161,218,4,1,1189,1856,20,1028,1638,16,59.45,>30,ZIM,Away,After 1965
AM Matheson,NZ,Pace,1930-02-21,Auckland,New Zealand,1930,2,96,210,2,1,366,961,11,270,751,9,33.27272727272727,>30,NZ,Home,Upto 2014
AM Matheson,NZ,Pace,1931-08-15,Manchester,England,1931,1,40,72,0,1,73,168,1,33,96,1,73.0,>30,ENG,Away,Upto 2014
AM Moir,NZ,Spin,1951-03-17,Christchurch,New Zealand,1951,1,155,339,6,1,586,1337,15,431,998,9,39.06666666666667,>30,NZ,Home,Upto 2014
AM Moir,NZ,Spin,1951-03-24,Wellington,New Zealand,1951,2,84,204,2,1,366,1136,25,282,932,23,14.64,<=30,NZ,Home,Upto 2014
AM Moir,NZ,Spin,1952-02-08,Christchurch,New Zealand,1952,2,119,228,2,1,593,1754,25,474,1526,23,23.72,<=30,NZ,Home,Upto 2014
AM Moir,NZ,Spin,1952-02-15,Auckland,New Zealand,1952,1,69,96,0,1,442,1192,12,373,1096,12,36.833333333333336,>30,NZ,Home,Upto 2014
AM Moir,NZ,Spin,1953-03-06,Wellington,New Zealand,1953,1,159,210,0,1,540,1494,12,381,1284,12,45.0,>30,NZ,Home,Upto 2014
AM Moir,NZ,Spin,1955-03-11,Dunedin,New Zealand,1955,1,42,54,0,1,162,483,7,120,429,7,23.142857142857142,<=30,NZ,Home,Upto 2014
AM Moir,NZ,Spin,1955-03-25,Auckland,New Zealand,1955,1,62,151,5,1,138,529,7,76,378,2,19.714285714285715,<=30,NZ,Home,Upto 2014
AM Moir,NZ,Spin,1955-10-13,Karachi,Pakistan,1955,1,87,222,1,1,294,1463,19,207,1241,18,15.473684210526315,<=30,PAK,Away,Upto 2014
AM Moir,NZ,Spin,1955-10-26,Lahore,Pakistan,1955,1,114,234,4,1,672,1787,23,558,1553,19,29.217391304347824,<=30,PAK,Away,Upto 2014
AM Moir,NZ,Spin,1955-11-07,Dhaka,Bangladesh,1955,1,17,36,0,1,131,558,6,114,522,6,21.833333333333332,<=30,BAN,Away,Upto 2014
AM Moir,NZ,Spin,1955-12-02,Brabourne,India,1955,1,51,72,0,1,470,1277,17,419,1205,17,27.647058823529413,<=30,IND,Away,Upto 2014
AM Moir,NZ,Spin,1956-01-06,Chennai,India,1956,1,114,156,1,1,610,1887,20,496,1731,19,30.5,>30,IND,Away,Upto 2014
AM Moir,NZ,Spin,1956-02-03,Dunedin,New Zealand,1956,1,79,114,0,1,439,1372,20,360,1258,20,21.95,<=30,NZ,Home,Upto 2014
AM Moir,NZ,Spin,1958-07-24,Manchester,England,1958,1,47,102,1,1,295,909,16,248,807,15,18.4375,<=30,ENG,Away,Upto 2014
AM Moir,NZ,Spin,1958-08-21,The Oval,England,1958,1,52,48,1,1,171,485,8,119,437,7,21.375,<=30,ENG,Away,Upto 2014
AM Moir,NZ,Spin,1959-02-27,Christchurch,New Zealand,1959,1,83,216,2,1,315,1017,18,232,801,16,17.5,<=30,NZ,Home,Upto 2014
AM Moir,NZ,Spin,1959-03-14,Auckland,New Zealand,1959,1,84,168,3,1,206,465,5,122,297,2,41.2,>30,NZ,Home,Upto 2014
AM Pai,IND,Pace,1969-09-25,Brabourne,India,1969,2,31,114,2,1,336,982,18,305,868,16,18.666666666666668,<=30,IND,Home,Upto 2014
AM Smith,ENG,Pace,1997-07-24,Leeds,England,1997,1,89,138,0,1,800,1403,28,711,1265,28,28.571428571428573,<=30,ENG,Home,Upto 2014
AMB Rowan,SA,Spin,1947-06-07,Nottingham,England,1947,2,145,356,3,1,885,2189,17,740,1833,14,52.05882352941177,>30,ENG,Away,Upto 2014
AMB Rowan,SA,Spin,1947-06-21,Lord's,England,1947,1,174,390,1,1,699,1857,18,525,1467,17,38.833333333333336,>30,ENG,Away,Upto 2014
AMB Rowan,SA,Spin,1947-07-05,Manchester,England,1947,2,76,126,1,1,418,900,10,342,774,9,41.8,>30,ENG,Away,Upto 2014
AMB Rowan,SA,Spin,1947-07-26,Leeds,England,1947,1,89,276,1,1,420,1282,10,331,1006,9,42.0,>30,ENG,Away,Upto 2014
AMB Rowan,SA,Spin,1947-08-16,The Oval,England,1947,2,187,378,6,1,893,1980,23,706,1602,17,38.82608695652174,>30,ENG,Away,Upto 2014
AMB Rowan,SA,Spin,1948-12-16,Durban,South Africa,1948,2,123,384,4,1,426,1415,21,303,1031,17,20.285714285714285,<=30,SA,Home,Upto 2014
AMB Rowan,SA,Spin,1948-12-27,Johannesburg,South Africa,1948,1,155,328,1,1,725,1588,13,570,1260,12,55.76923076923077,>30,SA,Home,Upto 2014
AMB Rowan,SA,Spin,1949-01-01,Cape Town,South Africa,1949,2,145,490,6,1,568,1444,18,423,954,12,31.555555555555557,>30,SA,Home,Upto 2014
AMB Rowan,SA,Spin,1949-02-12,Johannesburg,South Africa,1949,2,139,456,5,1,470,1288,10,331,832,5,47.0,>30,SA,Home,Upto 2014
AMB Rowan,SA,Spin,1949-03-05,Gqeberha,South Africa,1949,2,232,560,8,1,750,1935,20,518,1375,12,37.5,>30,SA,Home,Upto 2014
AMB Rowan,SA,Spin,1951-06-07,Nottingham,England,1951,2,169,440,6,1,552,1676,17,383,1236,11,32.470588235294116,>30,ENG,Away,Upto 2014
AMB Rowan,SA,Spin,1951-06-21,Lord's,England,1951,1,63,78,0,1,361,954,17,298,876,17,21.235294117647058,<=30,ENG,Away,Upto 2014
AMB Rowan,SA,Spin,1951-07-05,Manchester,England,1951,2,92,216,3,1,293,819,11,201,603,8,26.636363636363637,<=30,ENG,Away,Upto 2014
AMB Rowan,SA,Spin,1951-07-26,Leeds,England,1951,1,174,408,5,1,749,2072,16,575,1664,11,46.8125,>30,ENG,Away,Upto 2014
AMB Rowan,SA,Spin,1951-08-16,The Oval,England,1951,2,121,307,4,1,352,1033,18,231,726,14,19.555555555555557,<=30,ENG,Away,Upto 2014
AME Roberts,WI,Pace,1974-03-06,Bridgetown,West Indies,1974,2,124,300,3,1,627,1356,14,503,1056,11,44.785714285714285,>30,WI,Home,Upto 2014
AME Roberts,WI,Pace,1974-11-22,Bengaluru,India,1974,2,89,197,6,1,351,694,15,262,497,9,23.4,<=30,IND,Away,Upto 2014
AME Roberts,WI,Pace,1974-12-11,Delhi,India,1974,2,94,201,4,1,263,477,8,169,276,4,32.875,>30,IND,Away,Upto 2014
AME Roberts,WI,Pace,1974-12-27,Eden Gardens,India,1974,2,138,303,8,1,424,954,21,286,651,13,20.19047619047619,<=30,IND,Away,Upto 2014
AME Roberts,WI,Pace,1975-01-11,Chennai,India,1975,2,121,255,12,1,381,795,19,260,540,7,20.05263157894737,<=30,IND,Away,Upto 2014
AME Roberts,WI,Pace,1975-01-23,Wankhede,India,1975,2,143,295,2,1,510,1022,16,367,727,14,31.875,>30,IND,Away,Upto 2014
AME Roberts,WI,Pace,1975-02-15,Lahore,Pakistan,1975,2,187,392,9,1,757,1707,25,570,1315,16,30.28,>30,PAK,Away,Upto 2014
AME Roberts,WI,Pace,1975-03-01,Karachi,Pakistan,1975,2,135,328,3,1,655,1306,12,520,978,9,54.583333333333336,>30,PAK,Away,Upto 2014
AME Roberts,WI,Pace,1975-11-28,Brisbane,Australia,1975,2,132,312,4,1,663,1224,17,531,912,13,39.0,>30,AUS,Away,Upto 2014
AME Roberts,WI,Pace,1975-12-12,W.A.C.A,Australia,1975,2,119,216,9,1,857,1286,28,738,1070,19,30.607142857142858,>30,AUS,Away,Upto 2014
AME Roberts,WI,Pace,1975-12-26,Melbourne,Australia,1975,2,145,280,5,1,804,1499,27,659,1219,22,29.77777777777778,<=30,AUS,Away,Upto 2014
AME Roberts,WI,Pace,1976-01-03,Sydney,Australia,1976,2,106,198,3,1,784,1539,30,678,1341,27,26.133333333333333,<=30,AUS,Away,Upto 2014
AME Roberts,WI,Pace,1976-01-23,Adelaide,Australia,1976,2,78,128,1,1,939,1486,26,861,1358,25,36.11538461538461,>30,AUS,Away,Upto 2014
AME Roberts,WI,Pace,1976-03-10,Bridgetown,West Indies,1976,2,99,150,5,1,313,600,12,214,450,7,26.083333333333332,<=30,WI,Home,Upto 2014
AME Roberts,WI,Pace,1976-03-24,Port of Spain,West Indies,1976,1,77,168,1,1,260,654,5,183,486,4,52.0,>30,WI,Home,Upto 2014
AME Roberts,WI,Pace,1976-06-03,Nottingham,England,1976,2,73,258,2,1,773,1761,21,700,1503,19,36.80952380952381,>30,ENG,Away,Upto 2014
AME Roberts,WI,Pace,1976-06-17,Lord's,England,1976,2,123,317,10,1,584,1335,24,461,1018,14,24.333333333333332,<=30,ENG,Away,Upto 2014
AME Roberts,WI,Pace,1976-07-08,Manchester,England,1976,2,59,197,9,1,437,1066,29,378,869,20,15.068965517241379,<=30,ENG,Away,Upto 2014
AME Roberts,WI,Pace,1976-07-22,Leeds,England,1976,2,143,318,6,1,969,1786,39,826,1468,33,24.846153846153847,<=30,ENG,Away,Upto 2014
AME Roberts,WI,Pace,1976-08-12,The Oval,England,1976,2,139,240,1,1,768,1323,20,629,1083,19,38.4,>30,ENG,Away,Upto 2014
AME Roberts,WI,Pace,1977-02-18,Bridgetown,West Indies,1977,2,190,330,4,1,1045,1954,34,855,1624,30,30.735294117647058,>30,WI,Home,Upto 2014
AME Roberts,WI,Pace,1977-03-04,Port of Spain,West Indies,1977,2,119,258,4,1,520,1242,24,401,984,20,21.666666666666668,<=30,WI,Home,Upto 2014
AME Roberts,WI,Pace,1977-03-18,Georgetown,West Indies,1977,2,223,369,5,1,1085,2006,25,862,1637,20,43.4,>30,WI,Home,Upto 2014
AME Roberts,WI,Pace,1977-04-01,Port of Spain,West Indies,1977,2,138,270,4,1,547,1241,19,409,971,15,28.789473684210527,<=30,WI,Home,Upto 2014
AME Roberts,WI,Pace,1977-04-15,Kingston,West Indies,1977,2,93,192,2,1,849,1372,30,756,1180,28,28.3,<=30,WI,Home,Upto 2014
AME Roberts,WI,Pace,1978-03-03,Port of Spain,West Indies,1978,2,82,170,7,1,396,789,19,314,619,12,20.842105263157894,<=30,WI,Home,Upto 2014
AME Roberts,WI,Pace,1978-03-17,Bridgetown,West Indies,1978,2,129,216,5,1,577,955,26,448,739,21,22.192307692307693,<=30,WI,Home,Upto 2014
AME Roberts,WI,Pace,1979-12-01,Brisbane,Australia,1979,2,120,271,3,1,937,2006,27,817,1735,24,34.7037037037037,>30,AUS,Away,Upto 2014
AME Roberts,WI,Pace,1979-12-29,Melbourne,Australia,1979,2,103,210,3,1,659,1369,27,556,1159,24,24.40740740740741,<=30,AUS,Away,Upto 2014
AME Roberts,WI,Pace,1980-01-26,Adelaide,Australia,1980,2,73,191,5,1,844,1627,35,771,1436,30,24.114285714285714,<=30,AUS,Away,Upto 2014
AME Roberts,WI,Pace,1980-02-22,Christchurch,New Zealand,1980,1,82,174,2,1,946,1857,20,864,1683,18,47.3,>30,NZ,Away,Upto 2014
AME Roberts,WI,Pace,1980-02-29,Auckland,New Zealand,1980,2,114,258,1,1,786,1985,29,672,1727,28,27.103448275862068,<=30,NZ,Away,Upto 2014
AME Roberts,WI,Pace,1980-06-05,Nottingham,England,1980,2,129,294,8,1,897,2129,36,768,1835,28,24.916666666666668,<=30,ENG,Away,Upto 2014
AME Roberts,WI,Pace,1980-06-19,Lord's,England,1980,2,74,186,0,1,667,1407,18,593,1221,18,37.05555555555556,>30,ENG,Away,Upto 2014
AME Roberts,WI,Pace,1980-07-10,Manchester,England,1980,2,59,152,3,1,678,1412,23,619,1260,20,29.47826086956522,<=30,ENG,Away,Upto 2014
AME Roberts,WI,Pace,1981-02-13,Port of Spain,West Indies,1981,2,82,204,5,1,521,1338,21,439,1134,16,24.80952380952381,<=30,WI,Home,Upto 2014
AME Roberts,WI,Pace,1981-03-13,Bridgetown,West Indies,1981,2,71,186,3,1,801,1640,34,730,1454,31,23.558823529411764,<=30,WI,Home,Upto 2014
AME Roberts,WI,Pace,1981-03-27,St John's,West Indies,1981,2,98,234,0,1,702,1430,20,604,1196,20,35.1,>30,WI,Home,Upto 2014
AME Roberts,WI,Pace,1981-12-26,Melbourne,Australia,1981,2,71,198,1,1,642,1526,35,571,1328,34,18.34285714285714,<=30,AUS,Away,Upto 2014
AME Roberts,WI,Pace,1982-01-30,Adelaide,Australia,1982,2,107,258,5,1,872,1878,30,765,1620,25,29.066666666666666,<=30,AUS,Away,Upto 2014
AME Roberts,WI,Pace,1983-02-23,Kingston,West Indies,1983,2,100,279,9,1,545,1266,30,445,987,21,18.166666666666668,<=30,WI,Home,Upto 2014
AME Roberts,WI,Pace,1983-03-11,Port of Spain,West Indies,1983,2,172,282,5,1,669,1364,18,497,1082,13,37.166666666666664,>30,WI,Home,Upto 2014
AME Roberts,WI,Pace,1983-03-31,Georgetown,West Indies,1983,1,38,90,0,1,361,700,8,323,610,8,45.125,>30,WI,Home,Upto 2014
AME Roberts,WI,Pace,1983-04-15,Bridgetown,West Indies,1983,2,79,212,8,1,618,1146,24,539,934,16,25.75,<=30,WI,Home,Upto 2014
AME Roberts,WI,Pace,1983-04-28,St John's,West Indies,1983,2,156,264,2,1,719,1355,18,563,1091,16,39.94444444444444,>30,WI,Home,Upto 2014
AME Roberts,WI,Pace,1983-12-10,Eden Gardens,India,1983,2,67,166,4,1,475,988,25,408,822,21,19.0,<=30,IND,Away,Upto 2014
AME Roberts,WI,Pace,1983-12-24,Chennai,India,1983,1,81,168,1,1,443,882,12,362,714,11,36.916666666666664,>30,IND,Away,Upto 2014
AMJG Amerasinghe,SL,Spin,1984-03-09,Kandy,Sri Lanka,1984,2,77,120,1,1,410,807,17,333,687,16,24.11764705882353,<=30,SL,Home,Upto 2014
AMJG Amerasinghe,SL,Spin,1984-03-24,Colombo (CCC),Sri Lanka,1984,1,73,180,2,1,342,828,8,269,648,6,42.75,>30,SL,Home,Upto 2014
AN Connolly,AUS,Pace,1963-12-06,Brisbane,Australia,1963,2,48,160,1,1,562,1265,13,514,1105,12,43.23076923076923,>30,AUS,Home,Upto 2014
AN Connolly,AUS,Pace,1964-01-01,Melbourne,Australia,1964,2,111,288,3,1,870,1955,24,759,1667,21,36.25,>30,AUS,Home,Upto 2014
AN Connolly,AUS,Pace,1964-01-10,Sydney,Australia,1964,2,107,256,2,1,926,1995,29,819,1739,27,31.93103448275862,>30,AUS,Home,Upto 2014
AN Connolly,AUS,Pace,1964-10-10,Brabourne,India,1964,2,90,243,6,1,329,735,10,239,492,4,32.9,>30,IND,Away,Upto 2014
AN Connolly,AUS,Pace,1964-10-17,Eden Gardens,India,1964,1,10,48,0,1,116,312,5,106,264,5,23.2,<=30,IND,Away,Upto 2014
AN Connolly,AUS,Pace,1965-12-30,Melbourne,Australia,1965,2,128,304,1,1,657,1479,19,529,1175,18,34.578947368421055,>30,AUS,Home,Upto 2014
AN Connolly,AUS,Pace,1967-12-23,Adelaide,Australia,1967,2,75,124,4,1,596,1119,26,521,995,22,22.923076923076923,<=30,AUS,Home,Upto 2014
AN Connolly,AUS,Pace,1967-12-30,Melbourne,Australia,1967,2,81,199,1,1,704,1270,18,623,1071,17,39.111111111111114,>30,AUS,Home,Upto 2014
AN Connolly,AUS,Pace,1968-01-19,Brisbane,Australia,1968,2,94,264,3,1,552,1226,17,458,962,14,32.470588235294116,>30,AUS,Home,Upto 2014
AN Connolly,AUS,Pace,1968-06-06,Manchester,England,1968,2,61,246,3,1,493,1497,18,432,1251,15,27.38888888888889,<=30,ENG,Away,Upto 2014
AN Connolly,AUS,Pace,1968-06-20,Lord's,England,1968,1,55,159,2,1,427,1141,15,372,982,13,28.466666666666665,<=30,ENG,Away,Upto 2014
AN Connolly,AUS,Pace,1968-07-11,Birmingham,England,1968,2,143,300,5,1,595,1325,15,452,1025,10,39.666666666666664,>30,ENG,Away,Upto 2014
AN Connolly,AUS,Pace,1968-07-25,Leeds,England,1968,2,140,420,7,1,706,1746,18,566,1326,11,39.22222222222222,>30,ENG,Away,Upto 2014
AN Connolly,AUS,Pace,1968-08-22,The Oval,England,1968,2,192,478,6,1,485,1288,15,293,810,9,32.333333333333336,>30,ENG,Away,Upto 2014
AN Connolly,AUS,Pace,1968-12-06,Brisbane,Australia,1968,2,135,320,5,1,316,792,11,181,472,6,28.727272727272727,<=30,AUS,Home,Upto 2014
AN Connolly,AUS,Pace,1968-12-26,Melbourne,Australia,1968,2,69,248,0,1,513,1176,14,444,928,14,36.642857142857146,>30,AUS,Home,Upto 2014
AN Connolly,AUS,Pace,1969-01-03,Sydney,Australia,1969,2,108,312,3,1,677,1377,20,569,1065,17,33.85,>30,AUS,Home,Upto 2014
AN Connolly,AUS,Pace,1969-01-24,Adelaide,Australia,1969,2,183,376,7,1,674,1285,19,491,909,12,35.473684210526315,>30,AUS,Home,Upto 2014
AN Connolly,AUS,Pace,1969-02-14,Sydney,Australia,1969,2,133,280,5,1,820,1525,21,687,1245,16,39.04761904761905,>30,AUS,Home,Upto 2014
AN Connolly,AUS,Pace,1969-11-04,Brabourne,India,1969,2,75,306,5,1,298,821,12,223,515,7,24.833333333333332,<=30,IND,Away,Upto 2014
AN Connolly,AUS,Pace,1969-11-15,Kanpur,India,1969,2,160,432,6,1,379,992,12,219,560,6,31.583333333333332,>30,IND,Away,Upto 2014
AN Connolly,AUS,Pace,1969-11-28,Delhi,India,1969,2,78,216,2,1,173,466,3,95,250,1,57.666666666666664,>30,IND,Away,Upto 2014
AN Connolly,AUS,Pace,1969-12-12,Eden Gardens,India,1969,2,58,199,4,1,336,899,15,278,700,11,22.4,<=30,IND,Away,Upto 2014
AN Connolly,AUS,Pace,1969-12-24,Chennai,India,1969,2,44,138,0,1,213,718,10,169,580,10,21.3,<=30,IND,Away,Upto 2014
AN Connolly,AUS,Pace,1970-01-22,Cape Town,South Africa,1970,2,109,330,7,1,471,1312,21,362,982,14,22.428571428571427,<=30,SA,Away,Upto 2014
AN Connolly,AUS,Pace,1970-02-05,Durban,South Africa,1970,1,104,198,2,1,686,1387,21,582,1189,19,32.666666666666664,>30,SA,Away,Upto 2014
AN Connolly,AUS,Pace,1970-02-19,Johannesburg,South Africa,1970,2,132,372,4,1,766,1822,28,634,1450,24,27.357142857142858,<=30,SA,Away,Upto 2014
AN Connolly,AUS,Pace,1970-03-05,Gqeberha,South Africa,1970,2,177,386,7,1,887,1974,33,710,1588,26,26.87878787878788,<=30,SA,Away,Upto 2014
AN Connolly,AUS,Pace,1971-01-09,Sydney,Australia,1971,2,81,216,1,1,480,1339,18,399,1123,17,26.666666666666668,<=30,AUS,Home,Upto 2014
AN Cook,ENG,Spin,2008-07-10,Lord's,England,2008,1,1,6,0,1,341,797,8,340,791,8,42.625,>30,ENG,Home,Upto 2014
AN Cook,ENG,Spin,2014-07-09,Nottingham,England,2014,1,6,12,1,1,324,594,5,318,582,4,64.8,>30,ENG,Home,After 1965
AN Hornby,ENG,Spin,1879-01-02,Melbourne,Australia,1879,1,0,28,1,1,184,410,8,184,382,7,23.0,<=30,AUS,Away,After 1965
AN Petersen,SA,Spin,2010-06-10,Port of Spain,West Indies,2010,1,2,12,1,1,480,983,16,478,971,15,30.0,<=30,WI,Away,Upto 2014
AN Petersen,SA,Spin,2010-06-18,Basseterre,West Indies,2010,1,19,30,0,1,665,1266,8,646,1236,8,83.125,>30,WI,Away,Upto 2014
AN Petersen,SA,Spin,2010-11-20,Abu Dhabi,UAE,2010,1,1,6,0,1,553,1225,14,552,1219,14,39.5,>30,UAE,Away,Upto 2014
AN Petersen,SA,Spin,2011-01-02,Cape Town,South Africa,2011,2,14,24,0,1,346,804,9,332,780,9,38.44444444444444,>30,SA,Home,Upto 2014
AN Petersen,SA,Spin,2012-11-09,Brisbane,Australia,2012,1,20,18,0,1,246,390,4,226,372,4,61.5,>30,AUS,Away,Upto 2014
AN Petersen,SA,Spin,2013-01-11,Gqeberha,South Africa,2013,1,6,24,0,1,217,449,5,211,425,5,43.4,>30,SA,Home,Upto 2014
AN Ranasinghe,SL,Spin,1982-03-14,Faisalabad,Pakistan,1982,2,40,72,1,1,699,1740,27,659,1668,26,25.88888888888889,<=30,PAK,Away,Upto 2014
AN Ranasinghe,SL,Spin,1982-09-17,Chennai,India,1982,1,29,42,0,1,682,1194,13,653,1152,13,52.46153846153846,>30,IND,Away,Upto 2014
AO Jones,ENG,Spin,1899-08-14,The Oval,England,1899,2,116,210,3,1,465,899,10,349,689,7,46.5,>30,ENG,Home,After 1965
AO Jones,ENG,Spin,1902-01-01,Melbourne,Australia,1902,1,2,6,0,1,445,1043,26,443,1037,26,17.115384615384617,<=30,AUS,Away,Upto 2014
AO Jones,ENG,Spin,1909-06-14,Lord's,England,1909,1,15,12,0,1,254,821,16,239,809,16,15.875,<=30,ENG,Home,Upto 2014
AO Malhotra,IND,Pace,1983-11-24,Wankhede,India,1983,1,0,6,0,1,698,1403,16,698,1397,16,43.625,>30,IND,Home,Upto 2014
AO Malhotra,IND,Pace,1985-01-31,Kanpur,India,1985,1,3,12,0,1,413,773,9,410,761,9,45.888888888888886,>30,IND,Home,Upto 2014
AP Freeman,ENG,Spin,1924-12-19,Sydney,Australia,1924,2,258,688,5,1,978,2361,24,720,1673,19,40.75,>30,AUS,Away,Upto 2014
AP Freeman,ENG,Spin,1925-01-16,Adelaide,Australia,1925,2,201,280,3,1,1079,2740,29,878,2460,26,37.206896551724135,>30,AUS,Away,Upto 2014
AP Freeman,ENG,Spin,1927-12-31,Cape Town,South Africa,1927,2,124,306,7,1,504,1376,23,380,1070,16,21.91304347826087,<=30,SA,Away,Upto 2014
AP Freeman,ENG,Spin,1928-01-21,Durban,South Africa,1928,2,166,297,4,1,719,1581,22,553,1284,18,32.68181818181818,>30,SA,Away,Upto 2014
AP Freeman,ENG,Spin,1928-01-28,Johannesburg,South Africa,1928,2,52,96,2,1,407,779,13,355,683,11,31.307692307692307,>30,SA,Away,Upto 2014
AP Freeman,ENG,Spin,1928-02-04,Durban,South Africa,1928,1,57,96,1,1,423,969,13,366,873,12,32.53846153846154,>30,SA,Away,Upto 2014
AP Freeman,ENG,Spin,1928-06-23,Lord's,England,1928,2,77,238,6,1,284,808,17,207,570,11,16.705882352941178,<=30,ENG,Home,Upto 2014
AP Freeman,ENG,Spin,1928-07-21,Manchester,England,1928,2,93,310,10,1,291,903,19,198,593,9,15.31578947368421,<=30,ENG,Home,Upto 2014
AP Freeman,ENG,Spin,1928-08-11,The Oval,England,1928,2,132,292,6,1,308,610,14,176,318,8,22.0,<=30,ENG,Home,Upto 2014
AP Freeman,ENG,Spin,1929-07-13,Leeds,England,1929,2,207,405,10,1,624,1466,25,417,1061,15,24.96,<=30,ENG,Home,Upto 2014
AP Freeman,ENG,Spin,1929-07-27,Manchester,England,1929,2,171,430,12,1,374,874,16,203,444,4,23.375,<=30,ENG,Home,Upto 2014
AP Freeman,ENG,Spin,1929-08-17,The Oval,England,1929,1,169,294,0,1,557,1110,10,388,816,10,55.7,>30,ENG,Home,Upto 2014
AP Gurusinha,SL,Pace,1986-12-17,Kanpur,India,1986,1,42,42,0,1,810,1291,13,768,1249,13,62.30769230769231,>30,IND,Away,Upto 2014
AP Gurusinha,SL,Pace,1986-12-27,Nagpur,India,1986,1,25,11,2,1,372,581,7,347,570,5,53.142857142857146,>30,IND,Away,Upto 2014
AP Gurusinha,SL,Pace,1987-04-16,Colombo (CCC),Sri Lanka,1987,1,17,54,0,1,574,1325,10,557,1271,10,57.4,>30,SL,Home,Upto 2014
AP Gurusinha,SL,Pace,1989-12-08,Brisbane,Australia,1989,2,68,111,4,1,901,1884,23,833,1773,19,39.17391304347826,>30,AUS,Away,Upto 2014
AP Gurusinha,SL,Pace,1989-12-16,Hobart,Australia,1989,1,20,36,1,1,998,1920,27,978,1884,26,36.96296296296296,>30,AUS,Away,Upto 2014
AP Gurusinha,SL,Pace,1991-01-31,Wellington,New Zealand,1991,1,16,42,0,1,940,1788,23,924,1746,23,40.869565217391305,>30,NZ,Away,Upto 2014
AP Gurusinha,SL,Pace,1991-02-22,Hamilton,New Zealand,1991,2,48,110,1,1,916,2000,25,868,1890,24,36.64,>30,NZ,Away,Upto 2014
AP Gurusinha,SL,Pace,1991-03-01,Auckland,New Zealand,1991,2,16,48,0,1,890,1772,29,874,1724,29,30.689655172413794,>30,NZ,Away,Upto 2014
AP Gurusinha,SL,Pace,1991-12-20,Gujranwala,Pakistan,1991,1,9,12,0,1,97,210,2,88,198,2,48.5,>30,PAK,Away,Upto 2014
AP Gurusinha,SL,Pace,1992-01-02,Faisalabad,Pakistan,1992,2,37,162,3,1,743,1706,36,706,1544,33,20.63888888888889,<=30,PAK,Away,Upto 2014
AP Gurusinha,SL,Pace,1992-08-17,Colombo (SSC),Sri Lanka,1992,1,17,12,0,1,793,1548,19,776,1536,19,41.73684210526316,>30,SL,Home,Upto 2014
AP Gurusinha,SL,Pace,1992-08-28,Colombo (RPS),Sri Lanka,1992,1,18,54,2,1,531,1227,20,513,1173,18,26.55,<=30,SL,Home,Upto 2014
AP Gurusinha,SL,Pace,1992-09-08,Moratuwa,Sri Lanka,1992,2,20,24,0,1,511,1044,22,491,1020,22,23.227272727272727,<=30,SL,Home,Upto 2014
AP Gurusinha,SL,Pace,1992-11-27,Moratuwa,Sri Lanka,1992,1,6,6,0,1,602,1223,13,596,1217,13,46.30769230769231,>30,SL,Home,Upto 2014
AP Gurusinha,SL,Pace,1992-12-06,Colombo (SSC),Sri Lanka,1992,2,34,72,1,1,402,864,12,368,792,11,33.5,>30,SL,Home,Upto 2014
AP Gurusinha,SL,Pace,1993-03-13,Colombo (SSC),Sri Lanka,1993,2,19,66,2,1,382,857,11,363,791,9,34.72727272727273,>30,SL,Home,Upto 2014
AP Gurusinha,SL,Pace,1993-07-27,Colombo (SSC),Sri Lanka,1993,2,73,138,2,1,627,1409,18,554,1271,16,34.833333333333336,>30,SL,Home,Upto 2014
AP Gurusinha,SL,Pace,1993-08-04,Colombo (PSS),Sri Lanka,1993,1,27,66,0,1,384,1057,10,357,991,10,38.4,>30,SL,Home,Upto 2014
AP Gurusinha,SL,Pace,1993-08-25,Moratuwa,Sri Lanka,1993,1,3,18,0,1,501,1154,19,498,1136,19,26.36842105263158,<=30,SL,Home,Upto 2014
AP Gurusinha,SL,Pace,1994-08-09,Colombo (PSS),Sri Lanka,1994,1,24,24,0,1,293,474,11,269,450,11,26.636363636363637,<=30,SL,Home,Upto 2014
AP Gurusinha,SL,Pace,1994-10-20,Bulawayo,Zimbabwe,1994,1,15,24,0,1,524,1630,17,509,1606,17,30.823529411764707,>30,ZIM,Away,Upto 2014
AP Gurusinha,SL,Pace,1994-10-26,Harare,Zimbabwe,1994,1,39,78,0,1,659,1576,19,620,1498,19,34.68421052631579,>30,ZIM,Away,Upto 2014
AP Gurusinha,SL,Pace,1995-03-18,Dunedin,New Zealand,1995,1,10,36,0,1,657,1600,18,647,1564,18,36.5,>30,NZ,Away,Upto 2014
AP Gurusinha,SL,Pace,1995-09-08,Peshawar,Pakistan,1995,1,5,18,0,1,562,1039,16,557,1021,16,35.125,>30,PAK,Away,Upto 2014
AP Gurusinha,SL,Pace,1995-09-15,Faisalabad,Pakistan,1995,1,30,48,2,1,465,1059,21,435,1011,19,22.142857142857142,<=30,PAK,Away,Upto 2014
AP Gurusinha,SL,Pace,1995-09-22,Sialkot,Pakistan,1995,2,22,36,0,1,584,1401,24,562,1365,24,24.333333333333332,<=30,PAK,Away,Upto 2014
AP Gurusinha,SL,Pace,1995-12-26,Melbourne,Australia,1995,2,14,30,0,1,608,1377,17,594,1347,17,35.76470588235294,>30,AUS,Away,Upto 2014
AP Gurusinha,SL,Pace,1996-09-11,Colombo (RPS),Sri Lanka,1996,2,7,30,0,1,295,564,9,288,534,9,32.77777777777778,>30,SL,Home,Upto 2014
AP Igglesden,ENG,Pace,1989-08-24,The Oval,England,1989,2,146,222,3,1,921,1691,26,775,1469,23,35.42307692307692,>30,ENG,Home,Upto 2014
AP Igglesden,ENG,Pace,1994-02-19,Kingston,West Indies,1994,2,89,186,2,1,877,1820,28,788,1634,26,31.321428571428573,>30,WI,Away,Upto 2014
AP Igglesden,ENG,Pace,1994-03-17,Georgetown,West Indies,1994,1,94,147,1,1,724,1622,26,630,1475,25,27.846153846153847,<=30,WI,Away,Upto 2014
AP Lucas,ENG,Spin,1879-01-02,Melbourne,Australia,1879,1,31,72,0,1,184,410,8,153,338,8,23.0,<=30,AUS,Away,After 1965
AP Lucas,ENG,Spin,1880-09-06,The Oval,England,1880,1,23,48,0,1,721,1528,21,698,1480,21,34.333333333333336,>30,ENG,Home,After 1965
AP Marr,AUS,Pace,1885-01-01,Melbourne,Australia,1885,2,14,48,0,1,410,1218,21,396,1170,21,19.523809523809526,<=30,AUS,Home,After 1965
APF Chapman,ENG,Spin,1924-12-19,Sydney,Australia,1924,2,20,40,0,1,978,2361,24,958,2321,24,40.75,>30,AUS,Away,Upto 2014
AR Adams,NZ,Pace,2002-03-30,Auckland,New Zealand,2002,2,105,190,6,1,809,1459,39,704,1269,33,20.743589743589745,<=30,NZ,Home,Upto 2014
AR Bhat,IND,Spin,1983-10-05,Nagpur,India,1983,1,65,234,2,1,396,1114,18,331,880,16,22.0,<=30,IND,Home,Upto 2014
AR Bhat,IND,Spin,1983-10-21,Kanpur,India,1983,1,86,204,2,1,219,474,3,133,270,1,73.0,>30,IND,Home,Upto 2014
AR Border,AUS,Spin,1978-12-29,Melbourne,Australia,1978,1,14,40,0,1,223,866,11,209,826,11,20.272727272727273,<=30,AUS,Home,Upto 2014
AR Border,AUS,Spin,1979-01-06,Sydney,Australia,1979,1,31,184,1,1,399,1440,18,368,1256,17,22.166666666666668,<=30,AUS,Home,Upto 2014
AR Border,AUS,Spin,1979-01-27,Adelaide,Australia,1979,1,5,24,0,1,239,776,7,234,752,7,34.142857142857146,>30,AUS,Home,Upto 2014
AR Border,AUS,Spin,1979-03-10,Melbourne,Australia,1979,1,35,112,2,1,258,519,6,223,407,4,43.0,>30,AUS,Home,Upto 2014
AR Border,AUS,Spin,1979-03-24,W.A.C.A,Australia,1979,1,9,32,0,1,123,288,2,114,256,2,61.5,>30,AUS,Home,Upto 2014
AR Border,AUS,Spin,1979-09-11,Chennai,India,1979,1,30,84,0,1,518,1389,19,488,1305,19,27.263157894736842,<=30,IND,Away,Upto 2014
AR Border,AUS,Spin,1979-10-02,Kanpur,India,1979,2,7,30,1,1,449,1116,12,442,1086,11,37.416666666666664,>30,IND,Away,Upto 2014
AR Border,AUS,Spin,1979-10-13,Delhi,India,1979,1,5,24,0,1,604,1308,12,599,1284,12,50.333333333333336,>30,IND,Away,Upto 2014
AR Border,AUS,Spin,1979-10-26,Eden Gardens,India,1979,1,8,12,0,1,581,1386,14,573,1374,14,41.5,>30,IND,Away,Upto 2014
AR Border,AUS,Spin,1979-11-03,Wankhede,India,1979,1,60,162,2,1,457,1061,17,397,899,15,26.88235294117647,<=30,IND,Away,Upto 2014
AR Border,AUS,Spin,1979-12-01,Brisbane,Australia,1979,1,19,30,0,1,171,384,1,152,354,1,171.0,>30,AUS,Home,Upto 2014
AR Border,AUS,Spin,1979-12-14,W.A.C.A,Australia,1979,1,7,12,0,1,247,666,5,240,654,5,49.4,>30,AUS,Home,Upto 2014
AR Border,AUS,Spin,1980-01-26,Adelaide,Australia,1980,1,10,24,1,1,228,426,5,218,402,4,45.6,>30,AUS,Home,Upto 2014
AR Border,AUS,Spin,1980-02-01,Melbourne,Australia,1980,1,16,24,0,1,381,798,5,365,774,5,76.2,>30,AUS,Home,Upto 2014
AR Border,AUS,Spin,1980-03-06,Faisalabad,Pakistan,1980,1,3,18,0,1,592,1272,6,589,1254,6,98.66666666666667,>30,PAK,Away,Upto 2014
AR Border,AUS,Spin,1980-12-26,Melbourne,Australia,1980,2,11,36,0,1,182,426,4,171,390,4,45.5,>30,AUS,Home,Upto 2014
AR Border,AUS,Spin,1981-01-23,Adelaide,Australia,1981,2,20,78,1,1,543,1406,16,523,1328,15,33.9375,>30,AUS,Home,Upto 2014
AR Border,AUS,Spin,1981-02-07,Melbourne,Australia,1981,1,8,12,0,1,474,1128,11,466,1116,11,43.09090909090909,>30,AUS,Home,Upto 2014
AR Border,AUS,Spin,1981-11-27,Brisbane,Australia,1981,1,1,6,0,1,312,546,7,311,540,7,44.57142857142857,>30,AUS,Home,Upto 2014
AR Border,AUS,Spin,1981-12-11,Melbourne,Australia,1981,1,16,24,0,1,491,1248,15,475,1224,15,32.733333333333334,>30,AUS,Home,Upto 2014
AR Border,AUS,Spin,1982-01-02,Sydney,Australia,1982,1,0,6,0,1,278,654,13,278,648,13,21.384615384615383,<=30,AUS,Home,Upto 2014
AR Border,AUS,Spin,1982-01-30,Adelaide,Australia,1982,1,19,30,0,1,305,605,5,286,575,5,61.0,>30,AUS,Home,Upto 2014
AR Border,AUS,Spin,1982-03-12,Auckland,New Zealand,1982,2,14,30,1,1,260,652,9,246,622,8,28.88888888888889,<=30,NZ,Away,Upto 2014
AR Border,AUS,Spin,1982-03-19,Christchurch,New Zealand,1982,1,20,63,3,1,110,255,7,90,192,4,15.714285714285714,<=30,NZ,Away,Upto 2014
AR Border,AUS,Spin,1982-09-22,Karachi,Pakistan,1982,1,4,6,0,1,480,981,15,476,975,15,32.0,>30,PAK,Away,Upto 2014
AR Border,AUS,Spin,1982-09-30,Faisalabad,Pakistan,1982,1,47,66,1,1,662,1534,17,615,1468,16,38.94117647058823,>30,PAK,Away,Upto 2014
AR Border,AUS,Spin,1982-10-14,Lahore,Pakistan,1982,1,12,24,1,1,305,636,6,293,612,5,50.833333333333336,>30,PAK,Away,Upto 2014
AR Border,AUS,Spin,1982-11-12,W.A.C.A,Australia,1982,1,21,42,0,1,325,796,12,304,754,12,27.083333333333332,<=30,AUS,Home,Upto 2014
AR Border,AUS,Spin,1982-12-10,Adelaide,Australia,1982,1,14,48,0,1,299,810,4,285,762,4,74.75,>30,AUS,Home,Upto 2014
AR Border,AUS,Spin,1983-01-02,Sydney,Australia,1983,1,36,96,0,1,585,1269,15,549,1173,15,39.0,>30,AUS,Home,Upto 2014
AR Border,AUS,Spin,1983-04-22,Kandy,Sri Lanka,1983,1,11,29,1,1,499,919,15,488,890,14,33.266666666666666,>30,SL,Away,Upto 2014
AR Border,AUS,Spin,1983-12-09,Adelaide,Australia,1983,1,9,6,0,1,433,870,5,424,864,5,86.6,>30,AUS,Home,Upto 2014
AR Border,AUS,Spin,1983-12-26,Melbourne,Australia,1983,1,9,30,0,1,391,853,9,382,823,9,43.44444444444444,>30,AUS,Home,Upto 2014
AR Border,AUS,Spin,1984-03-30,Bridgetown,West Indies,1984,1,8,18,0,1,192,492,2,184,474,2,96.0,>30,WI,Away,Upto 2014
AR Border,AUS,Spin,1984-11-23,Brisbane,Australia,1984,1,25,30,0,1,123,198,2,98,168,2,61.5,>30,AUS,Home,Upto 2014
AR Border,AUS,Spin,1984-12-07,Adelaide,Australia,1984,1,24,24,0,1,299,561,7,275,537,7,42.714285714285715,>30,AUS,Home,Upto 2014
AR Border,AUS,Spin,1985-06-13,Leeds,England,1985,1,16,18,0,1,123,334,7,107,316,7,17.571428571428573,<=30,ENG,Away,Upto 2014
AR Border,AUS,Spin,1985-08-15,Birmingham,England,1985,1,13,36,0,1,208,528,4,195,492,4,52.0,>30,ENG,Away,Upto 2014
AR Border,AUS,Spin,1985-08-29,The Oval,England,1985,1,8,12,0,1,236,426,4,228,414,4,59.0,>30,ENG,Away,Upto 2014
AR Border,AUS,Spin,1985-11-08,Brisbane,Australia,1985,1,0,1,0,1,336,547,4,336,546,4,84.0,>30,AUS,Home,Upto 2014
AR Border,AUS,Spin,1986-02-21,Wellington,New Zealand,1986,1,1,24,0,1,108,246,2,107,222,2,54.0,>30,NZ,Away,Upto 2014
AR Border,AUS,Spin,1986-09-18,Chennai,India,1986,1,12,18,0,1,1032,1788,27,1020,1770,27,38.22222222222222,>30,IND,Away,Upto 2014
AR Border,AUS,Spin,1986-10-15,Wankhede,India,1986,1,29,60,0,1,676,1768,13,647,1708,13,52.0,>30,IND,Away,Upto 2014
AR Border,AUS,Spin,1986-11-28,W.A.C.A,Australia,1986,1,6,12,0,1,361,930,7,355,918,7,51.57142857142857,>30,AUS,Home,Upto 2014
AR Border,AUS,Spin,1986-12-12,Adelaide,Australia,1986,1,1,6,0,1,609,1398,9,608,1392,9,67.66666666666667,>30,AUS,Home,Upto 2014
AR Border,AUS,Spin,1987-01-10,Sydney,Australia,1987,1,25,78,1,1,596,1662,26,571,1584,25,22.923076923076923,<=30,AUS,Home,Upto 2014
AR Border,AUS,Spin,1988-09-15,Karachi,Pakistan,1988,1,33,102,0,1,427,1461,22,394,1359,22,19.40909090909091,<=30,PAK,Away,Upto 2014
AR Border,AUS,Spin,1988-09-23,Faisalabad,Pakistan,1988,2,14,42,0,1,520,1112,15,506,1070,15,34.666666666666664,>30,PAK,Away,Upto 2014
AR Border,AUS,Spin,1988-10-07,Lahore,Pakistan,1988,1,1,24,0,1,510,1394,19,509,1370,19,26.842105263157894,<=30,PAK,Away,Upto 2014
AR Border,AUS,Spin,1988-11-18,Brisbane,Australia,1988,1,8,6,0,1,172,348,4,164,342,4,43.0,>30,AUS,Home,Upto 2014
AR Border,AUS,Spin,1988-12-24,Melbourne,Australia,1988,1,0,6,0,1,69,126,0,69,120,0,inf,>30,AUS,Home,Upto 2014
AR Border,AUS,Spin,1989-01-26,Sydney,Australia,1989,2,96,268,11,1,632,1677,20,536,1409,9,31.6,>30,AUS,Home,Upto 2014
AR Border,AUS,Spin,1989-02-03,Adelaide,Australia,1989,2,17,90,0,1,439,1030,5,422,940,5,87.8,>30,AUS,Home,Upto 2014
AR Border,AUS,Spin,1989-06-08,Leeds,England,1989,2,9,42,0,1,41,78,0,32,36,0,inf,>30,ENG,Away,Upto 2014
AR Border,AUS,Spin,1989-06-22,Lord's,England,1989,1,23,54,0,1,161,444,4,138,390,4,40.25,>30,ENG,Away,Upto 2014
AR Border,AUS,Spin,1989-07-27,Manchester,England,1989,1,12,48,0,1,359,881,8,347,833,8,44.875,>30,ENG,Away,Upto 2014
AR Border,AUS,Spin,1989-11-24,W.A.C.A,Australia,1989,2,18,36,0,1,104,222,1,86,186,1,104.0,>30,AUS,Home,Upto 2014
AR Border,AUS,Spin,1989-12-08,Brisbane,Australia,1989,1,36,42,0,1,218,426,2,182,384,2,109.0,>30,AUS,Home,Upto 2014
AR Border,AUS,Spin,1989-12-16,Hobart,Australia,1989,1,2,30,0,1,264,618,8,262,588,8,33.0,>30,AUS,Home,Upto 2014
AR Border,AUS,Spin,1990-01-19,Adelaide,Australia,1990,2,15,48,1,1,427,941,7,412,893,6,61.0,>30,AUS,Home,Upto 2014
AR Border,AUS,Spin,1990-03-15,Wellington,New Zealand,1990,2,39,100,1,1,227,624,10,188,524,9,22.7,<=30,NZ,Away,Upto 2014
AR Border,AUS,Spin,1991-01-04,Sydney,Australia,1991,2,82,168,1,1,645,1458,16,563,1290,15,40.3125,>30,AUS,Home,Upto 2014
AR Border,AUS,Spin,1991-03-01,Kingston,West Indies,1991,1,21,60,0,1,221,516,2,200,456,2,110.5,>30,WI,Away,Upto 2014
AR Border,AUS,Spin,1991-03-23,Georgetown,West Indies,1991,1,68,180,5,1,331,635,8,263,455,3,41.375,>30,WI,Away,Upto 2014
AR Border,AUS,Spin,1991-04-05,Port of Spain,West Indies,1991,1,28,114,1,1,152,384,2,124,270,1,76.0,>30,WI,Away,Upto 2014
AR Border,AUS,Spin,1991-04-27,St John's,West Indies,1991,1,71,90,1,1,399,618,7,328,528,6,57.0,>30,WI,Away,Upto 2014
AR Border,AUS,Spin,1992-01-02,Sydney,Australia,1992,1,39,78,0,1,301,666,6,262,588,6,50.166666666666664,>30,AUS,Home,Upto 2014
AR Border,AUS,Spin,1992-01-25,Adelaide,Australia,1992,1,8,18,0,1,316,796,8,308,778,8,39.5,>30,AUS,Home,Upto 2014
AR Border,AUS,Spin,1992-08-17,Colombo (SSC),Sri Lanka,1992,1,8,24,0,1,598,1075,17,590,1051,17,35.1764705882353,>30,SL,Away,Upto 2014
AR Border,AUS,Spin,1992-08-28,Colombo (RPS),Sri Lanka,1992,2,43,90,1,1,357,918,7,314,828,6,51.0,>30,SL,Away,Upto 2014
AR Border,AUS,Spin,1992-11-27,Brisbane,Australia,1992,1,7,6,0,1,220,633,7,213,627,7,31.428571428571427,>30,AUS,Home,Upto 2014
AR Border,AUS,Spin,1993-01-02,Sydney,Australia,1993,1,41,84,0,1,617,1258,8,576,1174,8,77.125,>30,AUS,Home,Upto 2014
AR Border,AUS,Spin,1993-03-04,Wellington,New Zealand,1993,1,15,72,0,1,142,558,5,127,486,5,28.4,<=30,NZ,Away,Upto 2014
AR Border,AUS,Spin,1993-03-12,Auckland,New Zealand,1993,1,11,36,0,1,187,516,12,176,480,12,15.583333333333334,<=30,NZ,Away,Upto 2014
AR Border,AUS,Spin,1993-06-03,Manchester,England,1993,1,4,6,0,1,496,1275,19,492,1269,19,26.105263157894736,<=30,ENG,Away,Upto 2014
AR Border,AUS,Spin,1993-06-17,Lord's,England,1993,2,19,114,1,1,634,1745,17,615,1631,16,37.294117647058826,>30,ENG,Away,Upto 2014
AR Border,AUS,Spin,1993-07-01,Nottingham,England,1993,1,11,30,0,1,460,1186,11,449,1156,11,41.81818181818182,>30,ENG,Away,Upto 2014
AR Border,AUS,Spin,1993-08-05,Birmingham,England,1993,1,1,12,0,1,613,1738,21,612,1726,21,29.19047619047619,<=30,ENG,Away,Upto 2014
AR Border,AUS,Spin,1993-11-12,W.A.C.A,Australia,1993,1,0,12,0,1,339,721,5,339,709,5,67.8,>30,AUS,Home,Upto 2014
AR Border,AUS,Spin,1994-01-02,Sydney,Australia,1994,1,8,18,0,1,327,960,14,319,942,14,23.357142857142858,<=30,AUS,Home,Upto 2014
AR Border,AUS,Spin,1994-01-28,Adelaide,Australia,1994,1,1,24,0,1,289,1015,8,288,991,8,36.125,>30,AUS,Home,Upto 2014
AR Border,AUS,Spin,1994-03-17,Cape Town,South Africa,1994,2,9,36,0,1,182,607,6,173,571,6,30.333333333333332,>30,SA,Away,Upto 2014
AR Border,AUS,Spin,1994-03-25,Durban,South Africa,1994,1,8,18,0,1,158,468,4,150,450,4,39.5,>30,SA,Away,Upto 2014
AR Butcher,ENG,Spin,1979-08-30,The Oval,England,1979,1,9,12,0,1,489,1222,10,480,1210,10,48.9,>30,ENG,Home,Upto 2014
AR Caddick,ENG,Pace,1993-06-03,Manchester,England,1993,2,117,210,1,1,704,1351,14,587,1141,13,50.285714285714285,>30,ENG,Home,Upto 2014
AR Caddick,ENG,Pace,1993-06-17,Lord's,England,1993,1,120,228,0,1,536,1020,6,416,792,6,89.33333333333333,>30,ENG,Home,Upto 2014
AR Caddick,ENG,Pace,1993-07-01,Nottingham,England,1993,2,113,228,4,1,786,1563,21,673,1335,17,37.42857142857143,>30,ENG,Home,Upto 2014
AR Caddick,ENG,Pace,1993-07-22,Leeds,England,1993,1,138,252,0,1,901,1757,18,763,1505,18,50.05555555555556,>30,ENG,Home,Upto 2014
AR Caddick,ENG,Pace,1994-02-19,Kingston,West Indies,1994,2,113,210,4,1,877,1820,28,764,1610,24,31.321428571428573,>30,WI,Away,Upto 2014
AR Caddick,ENG,Pace,1994-03-25,Port of Spain,West Indies,1994,2,108,270,6,1,673,1600,36,565,1330,30,18.694444444444443,<=30,WI,Away,Upto 2014
AR Caddick,ENG,Pace,1994-04-08,Bridgetown,West Indies,1994,2,155,246,5,1,996,1767,31,841,1521,26,32.12903225806452,>30,WI,Away,Upto 2014
AR Caddick,ENG,Pace,1994-04-16,St John's,West Indies,1994,2,169,296,3,1,833,1731,12,664,1435,9,69.41666666666667,>30,WI,Away,Upto 2014
AR Caddick,ENG,Pace,1996-08-08,Leeds,England,1996,2,165,344,6,1,963,1933,22,798,1589,16,43.77272727272727,>30,ENG,Home,Upto 2014
AR Caddick,ENG,Pace,1997-02-06,Wellington,New Zealand,1997,2,85,275,6,1,457,1115,23,372,840,17,19.869565217391305,<=30,NZ,Away,Upto 2014
AR Caddick,ENG,Pace,1997-02-14,Christchurch,New Zealand,1997,2,89,252,2,1,695,1595,19,606,1343,17,36.578947368421055,>30,NZ,Away,Upto 2014
AR Caddick,ENG,Pace,1997-06-05,Birmingham,England,1997,2,137,251,5,1,837,1443,24,700,1192,19,34.875,>30,ENG,Home,Upto 2014
AR Caddick,ENG,Pace,1997-06-19,Lord's,England,1997,1,71,132,4,1,411,849,18,340,717,14,22.833333333333332,<=30,ENG,Home,Upto 2014
AR Caddick,ENG,Pace,1997-07-03,Manchester,England,1997,2,121,210,2,1,664,1429,26,543,1219,24,25.53846153846154,<=30,ENG,Home,Upto 2014
AR Caddick,ENG,Pace,1997-08-07,Nottingham,England,1997,2,187,300,5,1,974,1617,31,787,1317,26,31.419354838709676,>30,ENG,Home,Upto 2014
AR Caddick,ENG,Pace,1997-08-21,The Oval,England,1997,2,118,186,8,1,435,825,24,317,639,16,18.125,<=30,ENG,Home,Upto 2014
AR Caddick,ENG,Pace,1998-02-05,Port of Spain,West Indies,1998,2,99,180,0,1,715,1728,33,616,1548,33,21.666666666666668,<=30,WI,Away,Upto 2014
AR Caddick,ENG,Pace,1998-02-13,Port of Spain,West Indies,1998,2,131,246,7,1,618,1619,31,487,1373,24,19.93548387096774,<=30,WI,Away,Upto 2014
AR Caddick,ENG,Pace,1998-03-12,Bridgetown,West Indies,1998,2,47,138,3,1,686,1395,17,639,1257,14,40.35294117647059,>30,WI,Away,Upto 2014
AR Caddick,ENG,Pace,1998-03-20,St John's,West Indies,1998,1,111,156,3,1,587,1147,18,476,991,15,32.611111111111114,>30,WI,Away,Upto 2014
AR Caddick,ENG,Pace,1999-07-01,Birmingham,England,1999,2,89,246,8,1,580,1146,27,491,900,19,21.48148148148148,<=30,ENG,Home,Upto 2014
AR Caddick,ENG,Pace,1999-07-22,Lord's,England,1999,2,110,264,4,1,642,1427,25,532,1163,21,25.68,<=30,ENG,Home,Upto 2014
AR Caddick,ENG,Pace,1999-08-05,Manchester,England,1999,1,112,234,2,1,505,1189,11,393,955,9,45.90909090909091,>30,ENG,Home,Upto 2014
AR Caddick,ENG,Pace,1999-08-19,The Oval,England,1999,2,101,301,6,1,501,1268,29,400,967,23,17.275862068965516,<=30,ENG,Home,Upto 2014
AR Caddick,ENG,Pace,1999-11-25,Johannesburg,South Africa,1999,1,81,204,1,1,668,1442,28,587,1238,27,23.857142857142858,<=30,SA,Away,Upto 2014
AR Caddick,ENG,Pace,1999-12-09,Gqeberha,South Africa,1999,2,129,294,3,1,939,2119,25,810,1825,22,37.56,>30,SA,Away,Upto 2014
AR Caddick,ENG,Pace,1999-12-26,Durban,South Africa,1999,2,116,312,8,1,784,1865,22,668,1553,14,35.63636363636363,>30,SA,Away,Upto 2014
AR Caddick,ENG,Pace,2000-01-02,Cape Town,South Africa,2000,1,95,186,2,1,594,1440,24,499,1254,22,24.75,<=30,SA,Away,Upto 2014
AR Caddick,ENG,Pace,2000-01-14,Centurion,South Africa,2000,1,47,114,2,1,437,835,14,390,721,12,31.214285714285715,>30,SA,Away,Upto 2014
AR Caddick,ENG,Pace,2000-05-18,Lord's,England,2000,2,66,146,7,1,527,1078,29,461,932,22,18.17241379310345,<=30,ENG,Home,Upto 2014
AR Caddick,ENG,Pace,2000-06-01,Nottingham,England,2000,2,66,123,1,1,655,1521,23,589,1398,22,28.47826086956522,<=30,ENG,Home,Upto 2014
AR Caddick,ENG,Pace,2000-06-15,Birmingham,England,2000,1,94,180,2,1,606,1373,25,512,1193,23,24.24,<=30,ENG,Home,Upto 2014
AR Caddick,ENG,Pace,2000-06-29,Lord's,England,2000,2,74,201,6,1,573,1340,36,499,1139,30,15.916666666666666,<=30,ENG,Home,Upto 2014
AR Caddick,ENG,Pace,2000-08-03,Manchester,England,2000,2,109,282,4,1,672,1537,23,563,1255,19,29.217391304347824,<=30,ENG,Home,Upto 2014
AR Caddick,ENG,Pace,2000-08-17,Leeds,England,2000,2,49,128,5,1,405,817,24,356,689,19,16.875,<=30,ENG,Home,Upto 2014
AR Caddick,ENG,Pace,2000-08-31,The Oval,England,2000,2,96,234,5,1,613,1636,30,517,1402,25,20.433333333333334,<=30,ENG,Home,Upto 2014
AR Caddick,ENG,Pace,2000-11-15,Lahore,Pakistan,2000,1,68,144,1,1,230,588,2,162,444,1,115.0,>30,PAK,Away,Upto 2014
AR Caddick,ENG,Pace,2000-11-29,Faisalabad,Pakistan,2000,2,98,198,0,1,365,711,8,267,513,8,45.625,>30,PAK,Away,Upto 2014
AR Caddick,ENG,Pace,2000-12-07,Karachi,Pakistan,2000,2,116,228,2,1,458,1000,15,342,772,13,30.533333333333335,>30,PAK,Away,Upto 2014
AR Caddick,ENG,Pace,2001-02-22,Galle,Sri Lanka,2001,1,46,180,0,1,243,606,5,197,426,5,48.6,>30,SL,Away,Upto 2014
AR Caddick,ENG,Pace,2001-03-07,Kandy,Sri Lanka,2001,2,110,228,5,1,362,762,19,252,534,14,19.05263157894737,<=30,SL,Away,Upto 2014
AR Caddick,ENG,Pace,2001-03-15,Colombo (SSC),Sri Lanka,2001,2,69,115,4,1,242,462,16,173,347,12,15.125,<=30,SL,Away,Upto 2014
AR Caddick,ENG,Pace,2001-05-17,Lord's,England,2001,2,106,210,8,1,714,1443,30,608,1233,22,23.8,<=30,ENG,Home,Upto 2014
AR Caddick,ENG,Pace,2001-05-31,Manchester,England,2001,2,203,300,6,1,1134,1996,31,931,1696,25,36.58064516129032,>30,ENG,Home,Upto 2014
AR Caddick,ENG,Pace,2001-07-05,Birmingham,England,2001,1,163,216,1,1,685,933,19,522,717,18,36.05263157894737,>30,ENG,Home,Upto 2014
AR Caddick,ENG,Pace,2001-07-19,Lord's,England,2001,2,110,200,6,1,636,1130,28,526,930,22,22.714285714285715,<=30,ENG,Home,Upto 2014
AR Caddick,ENG,Pace,2001-08-02,Nottingham,England,2001,2,141,194,4,1,583,930,24,442,736,20,24.291666666666668,<=30,ENG,Home,Upto 2014
AR Caddick,ENG,Pace,2001-08-16,Leeds,England,2001,2,188,240,4,1,1054,1608,26,866,1368,22,40.53846153846154,>30,ENG,Home,Upto 2014
AR Caddick,ENG,Pace,2001-08-23,The Oval,England,2001,1,146,216,0,1,586,1029,9,440,813,9,65.11111111111111,>30,ENG,Home,Upto 2014
AR Caddick,ENG,Pace,2002-03-13,Christchurch,New Zealand,2002,2,172,258,9,1,1052,1583,35,880,1325,26,30.057142857142857,>30,NZ,Away,Upto 2014
AR Caddick,ENG,Pace,2002-03-21,Wellington,New Zealand,2002,2,94,273,6,1,587,1212,18,493,939,12,32.611111111111114,>30,NZ,Away,Upto 2014
AR Caddick,ENG,Pace,2002-03-30,Auckland,New Zealand,2002,2,111,216,4,1,809,1459,39,698,1243,35,20.743589743589745,<=30,NZ,Away,Upto 2014
AR Caddick,ENG,Pace,2002-05-16,Lord's,England,2002,2,145,273,1,1,1188,2251,20,1043,1978,19,59.4,>30,ENG,Home,Upto 2014
AR Caddick,ENG,Pace,2002-05-30,Birmingham,England,2002,2,114,252,6,1,687,1192,22,573,940,16,31.227272727272727,>30,ENG,Home,Upto 2014
AR Caddick,ENG,Pace,2002-06-13,Manchester,England,2002,1,17,33,0,1,775,1409,20,758,1376,20,38.75,>30,ENG,Home,Upto 2014
AR Caddick,ENG,Pace,2002-08-22,Leeds,England,2002,1,150,241,3,1,769,1387,15,619,1146,12,51.266666666666666,>30,ENG,Home,Upto 2014
AR Caddick,ENG,Pace,2002-09-05,The Oval,England,2002,1,114,258,4,1,664,1200,10,550,942,6,66.4,>30,ENG,Home,Upto 2014
AR Caddick,ENG,Pace,2002-11-07,Brisbane,Australia,2002,2,203,348,6,1,677,1218,20,474,870,14,33.85,>30,AUS,Away,Upto 2014
AR Caddick,ENG,Pace,2002-11-21,Adelaide,Australia,2002,1,95,120,0,1,643,1143,16,548,1023,16,40.1875,>30,AUS,Away,Upto 2014
AR Caddick,ENG,Pace,2002-12-26,Melbourne,Australia,2002,2,177,288,4,1,740,1406,19,563,1118,15,38.94736842105263,>30,AUS,Away,Upto 2014
AR Caddick,ENG,Pace,2003-01-02,Sydney,Australia,2003,2,215,270,10,1,1004,1656,32,789,1386,22,31.375,>30,AUS,Away,Upto 2014
AR Dell,AUS,Pace,1971-02-12,Sydney,Australia,1971,2,97,343,5,1,479,1333,21,382,990,16,22.80952380952381,<=30,AUS,Home,Upto 2014
AR Dell,AUS,Pace,1973-12-29,Melbourne,Australia,1973,2,63,216,1,1,539,1189,14,476,973,13,38.5,>30,AUS,Home,Upto 2014
AR Gover,ENG,Pace,1936-07-25,Manchester,England,1936,2,100,210,0,1,650,1176,8,550,966,8,81.25,>30,ENG,Home,Upto 2014
AR Gover,ENG,Pace,1937-06-26,Lord's,England,1937,2,76,240,3,1,544,1216,20,468,976,17,27.2,<=30,ENG,Home,Upto 2014
AR Gover,ENG,Pace,1937-08-14,The Oval,England,1937,2,127,240,4,1,359,810,13,232,570,9,27.615384615384617,<=30,ENG,Home,Upto 2014
AR Gover,ENG,Pace,1946-08-17,The Oval,England,1946,1,56,126,1,1,220,560,7,164,434,6,31.428571428571427,>30,ENG,Home,Upto 2014
AR Kapoor,IND,Spin,1994-12-10,Mohali,India,1994,2,122,222,1,1,470,841,10,348,619,9,47.0,>30,IND,Home,Upto 2014
AR Kapoor,IND,Spin,1995-11-08,Cuttack,India,1995,1,32,102,0,1,195,570,8,163,468,8,24.375,<=30,IND,Home,Upto 2014
AR Kapoor,IND,Spin,1996-10-10,Delhi,India,1996,2,72,192,3,1,528,1278,19,456,1086,16,27.789473684210527,<=30,IND,Home,Upto 2014
AR Kapoor,IND,Spin,1996-12-08,Kanpur,India,1996,2,29,126,2,1,503,1168,19,474,1042,17,26.473684210526315,<=30,IND,Home,Upto 2014
AR MacGibbon,NZ,Pace,1951-03-17,Christchurch,New Zealand,1951,1,74,162,0,1,365,1014,6,291,852,6,60.833333333333336,>30,NZ,Home,Upto 2014
AR MacGibbon,NZ,Pace,1951-03-24,Wellington,New Zealand,1951,1,32,42,0,1,192,572,8,160,530,8,24.0,<=30,NZ,Home,Upto 2014
AR MacGibbon,NZ,Pace,1953-03-13,Auckland,New Zealand,1953,2,89,264,1,1,316,1056,6,227,792,5,52.666666666666664,>30,NZ,Home,Upto 2014
AR MacGibbon,NZ,Pace,1953-12-11,Durban,South Africa,1953,1,73,216,3,1,403,1104,13,330,888,10,31.0,>30,SA,Away,Upto 2014
AR MacGibbon,NZ,Pace,1953-12-24,Johannesburg,South Africa,1953,2,123,336,7,1,463,1350,29,340,1014,22,15.96551724137931,<=30,SA,Away,Upto 2014
AR MacGibbon,NZ,Pace,1954-01-01,Cape Town,South Africa,1954,2,86,328,4,1,315,963,9,229,635,5,35.0,>30,SA,Away,Upto 2014
AR MacGibbon,NZ,Pace,1954-01-29,Johannesburg,South Africa,1954,2,73,232,3,1,358,1413,20,285,1181,17,17.9,<=30,SA,Away,Upto 2014
AR MacGibbon,NZ,Pace,1954-02-05,Gqeberha,South Africa,1954,2,99,257,5,1,339,985,18,240,728,13,18.833333333333332,<=30,SA,Away,Upto 2014
AR MacGibbon,NZ,Pace,1955-03-11,Dunedin,New Zealand,1955,2,55,193,3,1,287,993,22,232,800,19,13.045454545454545,<=30,NZ,Home,Upto 2014
AR MacGibbon,NZ,Pace,1955-03-25,Auckland,New Zealand,1955,1,33,120,1,1,296,880,23,263,760,22,12.869565217391305,<=30,NZ,Home,Upto 2014
AR MacGibbon,NZ,Pace,1955-10-13,Karachi,Pakistan,1955,1,98,223,4,1,260,769,8,162,546,4,32.5,>30,PAK,Away,Upto 2014
AR MacGibbon,NZ,Pace,1955-10-26,Lahore,Pakistan,1955,2,155,270,2,1,619,1402,11,464,1132,9,56.27272727272727,>30,PAK,Away,Upto 2014
AR MacGibbon,NZ,Pace,1955-11-07,Dhaka,Bangladesh,1955,1,64,120,1,1,196,674,16,132,554,15,12.25,<=30,BAN,Away,Upto 2014
AR MacGibbon,NZ,Pace,1955-11-19,Hyderabad (Deccan),India,1955,1,102,259,1,1,344,973,5,242,714,4,68.8,>30,IND,Away,Upto 2014
AR MacGibbon,NZ,Pace,1955-12-02,Brabourne,India,1955,1,56,138,2,1,320,942,10,264,804,8,32.0,>30,IND,Away,Upto 2014
AR MacGibbon,NZ,Pace,1955-12-16,Delhi,India,1955,1,121,359,2,1,511,1457,6,390,1098,4,85.16666666666667,>30,IND,Away,Upto 2014
AR MacGibbon,NZ,Pace,1955-12-28,Eden Gardens,India,1955,2,119,336,1,1,465,1398,12,346,1062,11,38.75,>30,IND,Away,Upto 2014
AR MacGibbon,NZ,Pace,1956-01-06,Chennai,India,1956,1,97,228,1,1,296,750,1,199,522,0,296.0,>30,IND,Away,Upto 2014
AR MacGibbon,NZ,Pace,1956-02-18,Christchurch,New Zealand,1956,1,81,198,2,1,198,504,4,117,306,2,49.5,>30,NZ,Home,Upto 2014
AR MacGibbon,NZ,Pace,1956-03-03,Wellington,New Zealand,1956,2,81,162,3,1,372,822,9,291,660,6,41.333333333333336,>30,NZ,Home,Upto 2014
AR MacGibbon,NZ,Pace,1956-03-09,Auckland,New Zealand,1956,2,60,162,4,1,188,741,21,128,579,17,8.952380952380953,<=30,NZ,Home,Upto 2014
AR MacGibbon,NZ,Pace,1958-06-05,Birmingham,England,1958,2,105,306,8,1,493,1493,26,388,1187,18,18.96153846153846,<=30,ENG,Away,Upto 2014
AR MacGibbon,NZ,Pace,1958-06-19,Lord's,England,1958,1,86,220,4,1,233,706,14,147,486,10,16.642857142857142,<=30,ENG,Away,Upto 2014
AR MacGibbon,NZ,Pace,1958-07-03,Leeds,England,1958,1,47,162,1,1,193,612,2,146,450,1,96.5,>30,ENG,Away,Upto 2014
AR MacGibbon,NZ,Pace,1958-07-24,Manchester,England,1958,1,86,204,3,1,389,953,12,303,749,9,32.416666666666664,>30,ENG,Away,Upto 2014
AR MacGibbon,NZ,Pace,1958-08-21,The Oval,England,1958,1,65,162,4,1,285,708,12,220,546,8,23.75,<=30,ENG,Away,Upto 2014
AR McBrine,IRE,Spin,2019-03-15,Dehradun,India,2019,2,112,240,3,1,656,1295,22,544,1055,19,29.818181818181817,<=30,IND,Away,After 1965
AR McBrine,IRE,Spin,2019-07-24,Lord's,England,2019,1,47,60,0,1,87,104,1,40,44,1,87.0,>30,ENG,Away,After 1965
AR McBrine,IRE,Spin,2023-04-04,Mirpur,Bangladesh,2023,2,170,247,7,1,595,1200,23,425,953,16,25.869565217391305,<=30,BAN,Away,After 1965
AR McBrine,IRE,Spin,2023-04-16,Galle,Sri Lanka,2023,1,162,240,1,1,643,1027,18,481,787,17,35.72222222222222,>30,SL,Away,After 1965
AR McBrine,IRE,Spin,2023-04-24,Galle,Sri Lanka,2023,1,191,342,1,1,963,1611,14,772,1269,13,68.78571428571429,>30,SL,Away,After 1965
AR McBrine,IRE,Spin,2023-06-01,Lord's,England,2023,1,99,82,2,1,283,346,7,184,264,5,40.42857142857143,>30,ENG,Away,After 1965
AR McBrine,IRE,Spin,2024-02-28,Tolerance Oval,UAE,2024,2,60,144,0,1,298,624,8,238,480,8,37.25,>30,UAE,Away,After 1965
AR McBrine,IRE,Spin,2024-07-25,Belfast,Northern Ireland,2024,2,75,216,7,1,127,307,10,52,91,3,12.7,<=30,Northern Ireland,Away,After 1965
AR Morris,AUS,Spin,1948-06-10,Nottingham,England,1948,1,4,18,0,1,552,1614,15,548,1596,15,36.8,>30,ENG,Away,Upto 2014
AR Morris,AUS,Spin,1948-07-22,Leeds,England,1948,1,20,30,0,1,708,1260,12,688,1230,12,59.0,>30,ENG,Away,Upto 2014
AR Morris,AUS,Spin,1953-01-24,Adelaide,Australia,1953,1,11,40,1,1,857,2379,23,846,2339,22,37.26086956521739,>30,AUS,Home,Upto 2014
AR Morris,AUS,Spin,1953-06-11,Nottingham,England,1953,1,5,12,0,1,277,894,8,272,882,8,34.625,>30,ENG,Away,Upto 2014
AR Morris,AUS,Spin,1953-07-09,Manchester,England,1953,1,5,6,1,1,250,603,14,245,597,13,17.857142857142858,<=30,ENG,Away,Upto 2014
AR Morris,AUS,Spin,1953-08-15,The Oval,England,1953,1,5,5,0,1,335,826,14,330,821,14,23.928571428571427,<=30,ENG,Away,Upto 2014
AR Patel,IND,Spin,2021-02-13,Chennai,India,2021,2,100,246,7,1,686,1393,32,586,1147,25,21.4375,<=30,IND,Home,After 1965
AR Patel,IND,Spin,2021-02-24,Ahmedabad,India,2021,2,70,220,11,1,247,614,28,177,394,17,8.821428571428571,<=30,IND,Home,After 1965
AR Patel,IND,Spin,2021-03-04,Ahmedabad,India,2021,2,116,300,9,1,456,994,20,340,694,11,22.8,<=30,IND,Home,After 1965
AR Patel,IND,Spin,2021-11-25,Kanpur,India,2021,2,85,330,6,1,592,1744,20,507,1414,14,29.6,<=30,IND,Home,After 1965
AR Patel,IND,Spin,2021-12-03,Wankhede,India,2021,2,56,115,3,1,600,1113,33,544,998,30,18.181818181818183,<=30,IND,Home,After 1965
AR Patel,IND,Spin,2022-03-12,Bengaluru,India,2022,2,58,96,3,1,625,968,26,567,872,23,24.03846153846154,<=30,IND,Home,After 1965
AR Patel,IND,Spin,2022-12-14,Chattogram,Bangladesh,2022,2,87,247,5,1,800,1534,23,713,1287,18,34.78260869565217,>30,BAN,Away,After 1965
AR Patel,IND,Spin,2022-12-22,Mirpur,Bangladesh,2022,2,100,188,3,1,578,1084,25,478,896,22,23.12,<=30,BAN,Away,After 1965
AR Patel,IND,Spin,2023-02-09,Nagpur,India,2023,2,34,78,1,1,475,1061,24,441,983,23,19.791666666666668,<=30,IND,Home,After 1965
AR Patel,IND,Spin,2023-02-17,Delhi,India,2023,2,36,78,0,1,582,1082,28,546,1004,28,20.785714285714285,<=30,IND,Home,After 1965
AR Patel,IND,Spin,2023-03-01,Indore,India,2023,1,33,78,0,1,438,973,26,405,895,26,16.846153846153847,<=30,IND,Home,After 1965
AR Patel,IND,Spin,2023-03-09,Ahmedabad,India,2023,2,83,282,2,1,725,1892,17,642,1610,15,42.64705882352941,>30,IND,Home,After 1965
AR Patel,IND,Spin,2024-01-25,Hyderabad,India,2024,2,107,174,3,1,1067,1778,32,960,1604,29,33.34375,>30,IND,Home,After 1965
AR Patel,IND,Spin,2024-02-02,Visakhapatnam,India,2024,2,99,108,2,1,935,1413,24,836,1305,22,38.958333333333336,>30,IND,Home,After 1965
AR Whittall,ZIM,Spin,1996-09-11,Colombo (RPS),Sri Lanka,1996,1,40,78,0,1,302,952,21,262,874,21,14.380952380952381,<=30,SL,Away,Upto 2014
AR Whittall,ZIM,Spin,1996-09-18,Colombo (SSC),Sri Lanka,1996,1,75,186,0,1,399,1111,19,324,925,19,21.0,<=30,SL,Away,Upto 2014
AR Whittall,ZIM,Spin,1996-10-17,Sheikhupura,Pakistan,1996,1,146,272,2,1,616,1340,14,470,1068,12,44.0,>30,PAK,Away,Upto 2014
AR Whittall,ZIM,Spin,1998-01-07,Kandy,Sri Lanka,1998,1,73,180,3,1,546,1374,23,473,1194,20,23.73913043478261,<=30,SL,Away,Upto 2014
AR Whittall,ZIM,Spin,1998-01-14,Colombo (SSC),Sri Lanka,1998,2,123,378,1,1,688,1695,18,565,1317,17,38.22222222222222,>30,SL,Away,Upto 2014
AR Whittall,ZIM,Spin,1998-02-19,Wellington,New Zealand,1998,1,50,72,0,1,396,984,10,346,912,10,39.6,>30,NZ,Away,Upto 2014
AR Whittall,ZIM,Spin,1998-02-26,Auckland,New Zealand,1998,1,37,66,0,1,314,511,5,277,445,5,62.8,>30,NZ,Away,Upto 2014
AR Whittall,ZIM,Spin,1998-03-14,Bulawayo,Zimbabwe,1998,2,57,90,0,1,364,712,5,307,622,5,72.8,>30,ZIM,Home,Upto 2014
AR Whittall,ZIM,Spin,1998-11-27,Peshawar,Pakistan,1998,1,30,30,0,1,65,84,1,35,54,1,65.0,>30,PAK,Away,Upto 2014
AR Whittall,ZIM,Spin,1999-11-18,Bulawayo,Zimbabwe,1999,1,105,210,1,1,248,534,3,143,324,2,82.66666666666667,>30,ZIM,Home,Upto 2014
ARA Murray,SA,Spin,1952-12-05,Brisbane,Australia,1952,2,76,216,0,1,592,1609,17,516,1393,17,34.8235294117647,>30,AUS,Away,Upto 2014
ARA Murray,SA,Spin,1952-12-24,Melbourne,Australia,1952,2,70,208,1,1,730,1899,24,660,1691,23,30.416666666666668,>30,AUS,Away,Upto 2014
ARA Murray,SA,Spin,1953-01-09,Sydney,Australia,1953,1,169,410,4,1,515,1280,12,346,870,8,42.916666666666664,>30,AUS,Away,Upto 2014
ARA Murray,SA,Spin,1953-02-06,Melbourne,Australia,1953,1,84,200,1,1,952,2221,20,868,2021,19,47.6,>30,AUS,Away,Upto 2014
ARA Murray,SA,Spin,1953-03-06,Wellington,New Zealand,1953,2,49,306,5,1,540,1494,12,491,1188,7,45.0,>30,NZ,Away,Upto 2014
ARA Murray,SA,Spin,1953-03-13,Auckland,New Zealand,1953,1,29,186,1,1,495,1529,18,466,1343,17,27.5,<=30,NZ,Away,Upto 2014
ARA Murray,SA,Spin,1953-12-11,Durban,South Africa,1953,2,17,112,1,1,371,1319,16,354,1207,15,23.1875,<=30,SA,Home,Upto 2014
ARA Murray,SA,Spin,1953-12-24,Johannesburg,South Africa,1953,2,40,160,2,1,206,522,9,166,362,7,22.88888888888889,<=30,SA,Home,Upto 2014
ARA Murray,SA,Spin,1954-01-01,Cape Town,South Africa,1954,1,93,272,1,1,639,1815,13,546,1543,12,49.15384615384615,>30,SA,Home,Upto 2014
ARA Murray,SA,Spin,1954-02-05,Gqeberha,South Africa,1954,2,83,304,2,1,529,1620,15,446,1316,13,35.266666666666666,>30,SA,Home,Upto 2014
ARC Fraser,ENG,Pace,1989-07-06,Birmingham,England,1989,2,92,270,4,1,670,1413,17,578,1143,13,39.411764705882355,>30,ENG,Home,Upto 2014
ARC Fraser,ENG,Pace,1989-07-27,Manchester,England,1989,2,123,281,3,1,673,1605,23,550,1324,20,29.26086956521739,<=30,ENG,Home,Upto 2014
ARC Fraser,ENG,Pace,1989-08-10,Nottingham,England,1989,1,108,315,2,1,695,1373,18,587,1058,16,38.611111111111114,>30,ENG,Home,Upto 2014
ARC Fraser,ENG,Pace,1990-02-24,Kingston,West Indies,1990,2,59,204,6,1,668,1460,29,609,1256,23,23.03448275862069,<=30,WI,Away,Upto 2014
ARC Fraser,ENG,Pace,1990-03-23,Port of Spain,West Indies,1990,2,102,223,5,1,773,1811,34,671,1588,29,22.735294117647058,<=30,WI,Away,Upto 2014
ARC Fraser,ENG,Pace,1990-07-26,Lord's,England,1990,2,143,367,8,1,1076,1683,21,933,1316,13,51.23809523809524,>30,ENG,Home,Upto 2014
ARC Fraser,ENG,Pace,1990-08-09,Manchester,England,1990,2,205,336,6,1,835,1242,15,630,906,9,55.666666666666664,>30,ENG,Home,Upto 2014
ARC Fraser,ENG,Pace,1990-08-23,The Oval,England,1990,1,112,252,2,1,853,1642,16,741,1390,14,53.3125,>30,ENG,Home,Upto 2014
ARC Fraser,ENG,Pace,1990-11-23,Brisbane,Australia,1990,2,82,210,3,1,544,1327,29,462,1117,26,18.75862068965517,<=30,AUS,Away,Upto 2014
ARC Fraser,ENG,Pace,1990-12-26,Melbourne,Australia,1990,2,115,354,7,1,741,1809,29,626,1455,22,25.551724137931036,<=30,AUS,Away,Upto 2014
ARC Fraser,ENG,Pace,1991-01-25,Adelaide,Australia,1991,2,114,294,1,1,1030,2159,28,916,1865,27,36.785714285714285,>30,AUS,Away,Upto 2014
ARC Fraser,ENG,Pace,1993-08-19,The Oval,England,1993,2,131,275,8,1,872,1626,33,741,1351,25,26.424242424242426,<=30,ENG,Home,Upto 2014
ARC Fraser,ENG,Pace,1994-03-17,Georgetown,West Indies,1994,1,85,174,2,1,724,1622,26,639,1448,24,27.846153846153847,<=30,WI,Away,Upto 2014
ARC Fraser,ENG,Pace,1994-03-25,Port of Spain,West Indies,1994,2,120,294,4,1,673,1600,36,553,1306,32,18.694444444444443,<=30,WI,Away,Upto 2014
ARC Fraser,ENG,Pace,1994-04-08,Bridgetown,West Indies,1994,2,115,275,8,1,996,1767,31,881,1492,23,32.12903225806452,>30,WI,Away,Upto 2014
ARC Fraser,ENG,Pace,1994-04-16,St John's,West Indies,1994,2,123,270,2,1,833,1731,12,710,1461,10,69.41666666666667,>30,WI,Away,Upto 2014
ARC Fraser,ENG,Pace,1994-06-02,Nottingham,England,1994,2,93,264,4,1,704,1313,20,611,1049,16,35.2,>30,ENG,Home,Upto 2014
ARC Fraser,ENG,Pace,1994-06-16,Lord's,England,1994,2,152,306,2,1,756,1458,24,604,1152,22,31.5,>30,ENG,Home,Upto 2014
ARC Fraser,ENG,Pace,1994-06-30,Manchester,England,1994,2,51,186,1,1,638,1439,22,587,1253,21,29.0,<=30,ENG,Home,Upto 2014
ARC Fraser,ENG,Pace,1994-07-21,Lord's,England,1994,2,134,287,5,1,636,1408,31,502,1121,26,20.516129032258064,<=30,ENG,Home,Upto 2014
ARC Fraser,ENG,Pace,1994-08-04,Leeds,England,1994,2,111,228,2,1,1145,2209,21,1034,1981,19,54.523809523809526,>30,ENG,Home,Upto 2014
ARC Fraser,ENG,Pace,1995-01-01,Sydney,Australia,1995,2,99,216,7,1,651,1345,27,552,1129,20,24.11111111111111,<=30,AUS,Away,Upto 2014
ARC Fraser,ENG,Pace,1995-01-26,Adelaide,Australia,1995,2,132,245,4,1,823,1644,27,691,1399,23,30.48148148148148,>30,AUS,Away,Upto 2014
ARC Fraser,ENG,Pace,1995-02-03,W.A.C.A,Australia,1995,2,158,318,3,1,946,1817,29,788,1499,26,32.62068965517241,>30,AUS,Away,Upto 2014
ARC Fraser,ENG,Pace,1995-06-22,Lord's,England,1995,2,123,348,5,1,1000,2102,38,877,1754,33,26.31578947368421,<=30,ENG,Home,Upto 2014
ARC Fraser,ENG,Pace,1995-07-06,Birmingham,England,1995,1,93,186,2,1,511,986,26,418,800,24,19.653846153846153,<=30,ENG,Home,Upto 2014
ARC Fraser,ENG,Pace,1995-07-27,Manchester,England,1995,2,98,212,6,1,744,1375,26,646,1163,20,28.615384615384617,<=30,ENG,Home,Upto 2014
ARC Fraser,ENG,Pace,1995-08-10,Nottingham,England,1995,2,94,141,2,1,678,1465,22,584,1324,20,30.818181818181817,>30,ENG,Home,Upto 2014
ARC Fraser,ENG,Pace,1995-08-24,The Oval,England,1995,1,155,240,1,1,1059,1992,20,904,1752,19,52.95,>30,ENG,Home,Upto 2014
ARC Fraser,ENG,Pace,1995-11-30,Johannesburg,South Africa,1995,2,153,294,3,1,999,2058,30,846,1764,27,33.3,>30,SA,Away,Upto 2014
ARC Fraser,ENG,Pace,1996-01-02,Cape Town,South Africa,1996,1,34,102,1,1,418,1109,22,384,1007,21,19.0,<=30,SA,Away,Upto 2014
ARC Fraser,ENG,Pace,1998-02-05,Port of Spain,West Indies,1998,2,110,259,11,1,715,1728,33,605,1469,22,21.666666666666668,<=30,WI,Away,Upto 2014
ARC Fraser,ENG,Pace,1998-02-13,Port of Spain,West Indies,1998,2,80,277,9,1,618,1619,31,538,1342,22,19.93548387096774,<=30,WI,Away,Upto 2014
ARC Fraser,ENG,Pace,1998-02-27,Georgetown,West Indies,1998,2,101,264,3,1,412,1052,21,311,788,18,19.61904761904762,<=30,WI,Away,Upto 2014
ARC Fraser,ENG,Pace,1998-03-12,Bridgetown,West Indies,1998,2,113,198,3,1,686,1395,17,573,1197,14,40.35294117647059,>30,WI,Away,Upto 2014
ARC Fraser,ENG,Pace,1998-03-20,St John's,West Indies,1998,1,88,126,1,1,587,1147,18,499,1021,17,32.611111111111114,>30,WI,Away,Upto 2014
ARC Fraser,ENG,Pace,1998-06-04,Birmingham,England,1998,1,103,204,4,1,706,1575,23,603,1371,19,30.695652173913043,>30,ENG,Home,Upto 2014
ARC Fraser,ENG,Pace,1998-06-18,Lord's,England,1998,2,88,192,1,1,618,1463,26,530,1271,25,23.76923076923077,<=30,ENG,Home,Upto 2014
ARC Fraser,ENG,Pace,1998-07-02,Manchester,England,1998,1,87,210,1,1,671,1668,18,584,1458,17,37.27777777777778,>30,ENG,Home,Upto 2014
ARC Fraser,ENG,Pace,1998-07-23,Nottingham,England,1998,2,122,327,10,1,995,2152,32,873,1825,22,31.09375,>30,ENG,Home,Upto 2014
ARC Fraser,ENG,Pace,1998-08-06,Leeds,England,1998,2,92,288,8,1,826,2084,40,734,1796,32,20.65,<=30,ENG,Home,Upto 2014
ARC Fraser,ENG,Pace,1998-08-27,The Oval,England,1998,2,114,150,3,1,707,1308,12,593,1158,9,58.916666666666664,>30,ENG,Home,Upto 2014
ARC Fraser,ENG,Pace,1998-11-20,Brisbane,Australia,1998,2,128,258,2,1,919,1808,20,791,1550,18,45.95,>30,AUS,Away,Upto 2014
ARC Fraser,ENG,Pace,1998-12-26,Melbourne,Australia,1998,2,101,156,2,1,840,1515,33,739,1359,31,25.454545454545453,<=30,AUS,Away,Upto 2014
AS Jaggernauth,WI,Spin,2008-05-22,Kingston,West Indies,2008,2,96,138,1,1,254,420,5,158,282,4,50.8,>30,WI,Home,Upto 2014
AS Joseph,WI,Pace,2016-08-09,Gros Islet,West Indies,2016,2,92,168,3,1,570,1190,26,478,1022,23,21.923076923076923,<=30,WI,Home,After 1965
AS Joseph,WI,Pace,2016-10-30,Sharjah,UAE,2016,2,98,185,2,1,508,1019,20,410,834,18,25.4,<=30,UAE,Away,After 1965
AS Joseph,WI,Pace,2017-04-21,Kingston,West Indies,2017,2,77,204,4,1,500,1200,21,423,996,17,23.80952380952381,<=30,WI,Home,After 1965
AS Joseph,WI,Pace,2017-04-30,Bridgetown,West Indies,2017,2,90,186,2,1,469,1258,27,379,1072,25,17.37037037037037,<=30,WI,Home,After 1965
AS Joseph,WI,Pace,2017-05-10,Roseau,West Indies,2017,2,117,252,4,1,472,1494,20,355,1242,16,23.6,<=30,WI,Home,After 1965
AS Joseph,WI,Pace,2017-08-17,Birmingham,England,2017,1,109,132,0,1,610,1081,19,501,949,19,32.10526315789474,>30,ENG,Away,After 1965
AS Joseph,WI,Pace,2019-01-23,Bridgetown,West Indies,2019,2,55,98,3,1,635,1301,24,580,1203,21,26.458333333333332,<=30,WI,Home,After 1965
AS Joseph,WI,Pace,2019-01-31,North Sound,West Indies,2019,2,50,102,4,1,523,1214,27,473,1112,23,19.37037037037037,<=30,WI,Home,After 1965
AS Joseph,WI,Pace,2019-02-09,Gros Islet,West Indies,2019,2,133,198,3,1,684,1370,27,551,1172,24,25.333333333333332,<=30,WI,Home,After 1965
AS Joseph,WI,Pace,2020-07-08,Southampton,England,2020,2,98,186,2,1,825,1729,32,727,1543,30,25.78125,<=30,ENG,Away,After 1965
AS Joseph,WI,Pace,2020-07-16,Manchester,England,2020,2,84,151,1,1,747,1583,23,663,1432,22,32.47826086956522,>30,ENG,Away,After 1965
AS Joseph,WI,Pace,2020-12-03,Hamilton,New Zealand,2020,1,99,186,1,1,725,1439,25,626,1253,24,29.0,<=30,NZ,Away,After 1965
AS Joseph,WI,Pace,2020-12-11,Wellington,New Zealand,2020,1,109,132,3,1,834,1421,28,725,1289,25,29.785714285714285,<=30,NZ,Away,After 1965
AS Joseph,WI,Pace,2021-02-11,Mirpur,Bangladesh,2021,2,76,119,2,1,347,599,12,271,480,10,28.916666666666668,<=30,BAN,Away,After 1965
AS Joseph,WI,Pace,2021-03-21,North Sound,West Indies,2021,2,115,192,1,1,742,1672,25,627,1480,24,29.68,<=30,WI,Home,After 1965
AS Joseph,WI,Pace,2021-03-29,North Sound,West Indies,2021,2,97,192,3,1,742,1513,23,645,1321,20,32.26086956521739,>30,WI,Home,After 1965
AS Joseph,WI,Pace,2021-08-20,Kingston,West Indies,2021,2,99,134,2,1,688,1393,29,589,1259,27,23.724137931034484,<=30,WI,Home,After 1965
AS Joseph,WI,Pace,2022-03-08,North Sound,West Indies,2022,2,148,263,5,1,832,1769,23,684,1506,18,36.17391304347826,>30,WI,Home,After 1965
AS Joseph,WI,Pace,2022-03-16,Bridgetown,West Indies,2022,2,154,174,2,1,744,1535,17,590,1361,15,43.76470588235294,>30,WI,Home,After 1965
AS Joseph,WI,Pace,2022-03-24,St George's,West Indies,2022,2,71,204,3,1,518,1435,27,447,1231,24,19.185185185185187,<=30,WI,Home,After 1965
AS Joseph,WI,Pace,2022-06-16,North Sound,West Indies,2022,2,88,167,6,1,515,1150,28,427,983,22,18.392857142857142,<=30,WI,Home,After 1965
AS Joseph,WI,Pace,2022-06-24,Gros Islet,West Indies,2022,2,107,174,6,1,658,1090,26,551,916,20,25.307692307692307,<=30,WI,Home,After 1965
AS Joseph,WI,Pace,2022-11-30,Perth,Australia,2022,2,125,204,0,1,842,1610,13,717,1406,13,64.76923076923077,>30,AUS,Away,After 1965
AS Joseph,WI,Pace,2022-12-08,Adelaide,Australia,2022,2,140,228,5,1,712,1214,23,572,986,18,30.956521739130434,>30,AUS,Away,After 1965
AS Joseph,WI,Pace,2023-02-04,Bulawayo,Zimbabwe,2023,2,94,186,3,1,562,1122,8,468,936,5,70.25,>30,ZIM,Away,After 1965
AS Joseph,WI,Pace,2023-02-12,Bulawayo,Zimbabwe,2023,2,52,96,2,1,266,519,11,214,423,9,24.181818181818183,<=30,ZIM,Away,After 1965
AS Joseph,WI,Pace,2023-02-28,Centurion,South Africa,2023,2,111,159,7,1,738,1209,39,627,1050,32,18.923076923076923,<=30,SA,Away,After 1965
AS Joseph,WI,Pace,2023-03-08,Johannesburg,South Africa,2023,2,109,194,5,1,575,1146,28,466,952,23,20.535714285714285,<=30,SA,Away,After 1965
AS Joseph,WI,Pace,2023-07-12,Roseau,West Indies,2023,1,80,110,1,1,260,590,5,180,480,4,52.0,>30,WI,Home,After 1965
AS Joseph,WI,Pace,2023-07-20,Port of Spain,West Indies,2023,2,134,156,0,1,656,1048,14,522,892,14,46.857142857142854,>30,WI,Home,After 1965
AS Joseph,WI,Pace,2024-01-17,Adelaide,Australia,2024,2,67,126,1,1,512,947,27,445,821,26,18.962962962962962,<=30,AUS,Away,After 1965
AS Joseph,WI,Pace,2024-01-25,Brisbane,Australia,2024,2,146,186,6,1,777,1334,30,631,1148,24,25.9,<=30,AUS,Away,After 1965
AS Joseph,WI,Pace,2024-07-10,Lord's,England,2024,1,106,108,1,1,552,962,27,446,854,26,20.444444444444443,<=30,ENG,Away,After 1965
AS Joseph,WI,Pace,2024-07-18,Nottingham,England,2024,2,201,213,5,1,1038,1453,27,837,1240,22,38.44444444444444,>30,ENG,Away,After 1965
AS Joseph,WI,Pace,2024-07-26,Birmingham,England,2024,2,147,124,4,1,712,994,27,565,870,23,26.37037037037037,<=30,ENG,Away,After 1965
AS Joseph,WI,Pace,2024-11-22,North Sound,West Indies,2024,2,101,198,5,1,670,1327,30,569,1129,25,22.333333333333332,<=30,WI,Home,After 1965
AS Joseph,WI,Pace,2024-11-30,Kingston,West Indies,2024,2,106,179,4,1,598,1162,33,492,983,29,18.12121212121212,<=30,WI,Home,After 1965
AS Kennedy,ENG,Pace,1922-12-23,Johannesburg,South Africa,1922,2,169,373,8,1,634,1476,30,465,1103,22,21.133333333333333,<=30,SA,Away,Upto 2014
AS Kennedy,ENG,Pace,1923-01-01,Cape Town,South Africa,1923,2,82,320,5,1,417,1260,23,335,940,18,18.130434782608695,<=30,SA,Away,Upto 2014
AS Kennedy,ENG,Pace,1923-01-18,Durban,South Africa,1923,1,88,234,5,1,496,1373,16,408,1139,11,31.0,>30,SA,Away,Upto 2014
AS Kennedy,ENG,Pace,1923-02-09,Johannesburg,South Africa,1923,2,138,311,6,1,723,1725,22,585,1414,16,32.86363636363637,>30,SA,Away,Upto 2014
AS Kennedy,ENG,Pace,1923-02-16,Durban,South Africa,1923,2,122,445,7,1,724,2332,33,602,1887,26,21.939393939393938,<=30,SA,Away,Upto 2014
AS Wassan,IND,Pace,1990-02-02,Christchurch,New Zealand,1990,1,95,150,1,1,683,1242,22,588,1092,21,31.045454545454547,>30,NZ,Away,Upto 2014
AS Wassan,IND,Pace,1990-02-09,Napier,New Zealand,1990,1,48,90,1,1,406,996,10,358,906,9,40.6,>30,NZ,Away,Upto 2014
AS Wassan,IND,Pace,1990-02-22,Auckland,New Zealand,1990,2,188,250,5,1,1075,1694,19,887,1444,14,56.578947368421055,>30,NZ,Away,Upto 2014
AS Wassan,IND,Pace,1990-08-23,The Oval,England,1990,2,173,222,3,1,853,1642,16,680,1420,13,53.3125,>30,ENG,Away,Upto 2014
ASA Perera,SL,Pace,1998-08-27,The Oval,England,1998,2,126,306,1,1,707,1308,12,581,1002,11,58.916666666666664,>30,ENG,Away,Upto 2014
ASA Perera,SL,Pace,2001-08-14,Galle,Sri Lanka,2001,1,34,72,0,1,532,1132,18,498,1060,18,29.555555555555557,<=30,SL,Home,Upto 2014
ASA Perera,SL,Pace,2001-08-22,Kandy,Sri Lanka,2001,2,20,30,0,1,745,1357,27,725,1327,27,27.59259259259259,<=30,SL,Home,Upto 2014
ASM Oakman,ENG,Spin,1956-07-26,Manchester,England,1956,1,21,48,0,1,491,1434,26,470,1386,26,18.884615384615383,<=30,ENG,Home,Upto 2014
AU Rashid,ENG,Spin,2015-10-13,Abu Dhabi,UAE,2015,2,227,317,5,1,740,1307,14,513,990,9,52.857142857142854,>30,UAE,Away,After 1965
AU Rashid,ENG,Spin,2015-10-22,Dubai (DICS),UAE,2015,2,191,270,2,1,700,1353,17,509,1083,15,41.1764705882353,>30,UAE,Away,After 1965
AU Rashid,ENG,Spin,2015-11-01,Sharjah,UAE,2015,2,138,234,1,1,743,1504,24,605,1270,23,30.958333333333332,>30,UAE,Away,After 1965
AU Rashid,ENG,Spin,2016-10-20,Chattogram,Bangladesh,2016,2,113,198,3,1,760,1579,30,647,1381,27,25.333333333333332,<=30,BAN,Away,After 1965
AU Rashid,ENG,Spin,2016-10-28,Mirpur,Bangladesh,2016,2,96,131,4,1,691,1258,32,595,1127,28,21.59375,<=30,BAN,Away,After 1965
AU Rashid,ENG,Spin,2016-11-09,Rajkot,India,2016,2,178,273,7,1,954,1677,22,776,1404,15,43.36363636363637,>30,IND,Away,After 1965
AU Rashid,ENG,Spin,2016-11-17,Visakhapatnam,India,2016,2,192,352,6,1,632,1483,25,440,1131,19,25.28,<=30,IND,Away,After 1965
AU Rashid,ENG,Spin,2016-11-26,Mohali,India,2016,2,146,258,5,1,572,1216,17,426,958,12,33.64705882352941,>30,IND,Away,After 1965
AU Rashid,ENG,Spin,2016-12-08,Wankhede,India,2016,1,192,333,4,1,864,1639,27,672,1306,23,32.0,>30,IND,Away,After 1965
AU Rashid,ENG,Spin,2016-12-16,Chennai,India,2016,1,153,178,1,1,966,1770,17,813,1592,16,56.8235294117647,>30,IND,Away,After 1965
AU Rashid,ENG,Spin,2018-08-01,Birmingham,England,2018,2,40,72,3,1,161,354,10,121,282,7,16.1,<=30,ENG,Home,After 1965
AU Rashid,ENG,Spin,2018-08-18,Nottingham,England,2018,2,147,216,4,1,203,377,5,56,161,1,40.6,>30,ENG,Home,After 1965
AU Rashid,ENG,Spin,2018-08-30,Southampton,England,2018,2,40,84,0,1,298,647,12,258,563,12,24.833333333333332,<=30,ENG,Home,After 1965
AU Rashid,ENG,Spin,2018-09-07,The Oval,England,2018,2,82,150,3,1,513,915,16,431,765,13,32.0625,>30,ENG,Home,After 1965
AU Rashid,ENG,Spin,2018-11-06,Galle,Sri Lanka,2018,2,89,163,3,1,876,1627,28,787,1464,25,31.285714285714285,>30,SL,Away,After 1965
AU Rashid,ENG,Spin,2018-11-14,Pallekele,Sri Lanka,2018,2,127,234,4,1,1031,1760,38,904,1526,34,27.13157894736842,<=30,SL,Away,After 1965
AU Rashid,ENG,Spin,2018-11-23,Colombo (SSC),Sri Lanka,2018,2,122,197,5,1,913,1615,34,791,1418,29,26.852941176470587,<=30,SL,Away,After 1965
AU Rashid,ENG,Spin,2019-01-23,Bridgetown,West Indies,2019,2,117,156,0,1,371,593,12,254,437,12,30.916666666666668,>30,WI,Away,After 1965
AV Bedser,ENG,Pace,1946-06-22,Lord's,England,1946,2,145,368,11,1,522,1272,22,377,904,11,23.727272727272727,<=30,ENG,Home,Upto 2014
AV Bedser,ENG,Pace,1946-07-20,Manchester,England,1946,2,93,306,11,1,495,1476,27,402,1170,16,18.333333333333332,<=30,ENG,Home,Upto 2014
AV Bedser,ENG,Pace,1946-08-17,The Oval,England,1946,1,60,192,2,1,220,560,7,160,368,5,31.428571428571427,>30,ENG,Home,Upto 2014
AV Bedser,ENG,Pace,1946-11-29,Brisbane,Australia,1946,1,159,328,2,1,604,1516,23,445,1188,21,26.26086956521739,<=30,AUS,Away,Upto 2014
AV Bedser,ENG,Pace,1946-12-13,Sydney,Australia,1946,1,153,368,1,1,412,1072,9,259,704,8,45.77777777777778,>30,AUS,Away,Upto 2014
AV Bedser,ENG,Pace,1947-01-01,Melbourne,Australia,1947,2,275,523,6,1,922,1990,21,647,1467,15,43.904761904761905,>30,AUS,Away,Upto 2014
AV Bedser,ENG,Pace,1947-01-31,Adelaide,Australia,1947,2,165,360,3,1,774,1993,20,609,1633,17,38.7,>30,AUS,Away,Upto 2014
AV Bedser,ENG,Pace,1947-02-28,Sydney,Australia,1947,2,124,392,4,1,392,1131,16,268,739,12,24.5,<=30,AUS,Away,Upto 2014
AV Bedser,ENG,Pace,1947-03-21,Christchurch,New Zealand,1947,1,95,234,4,1,372,820,16,277,586,12,23.25,<=30,NZ,Away,Upto 2014
AV Bedser,ENG,Pace,1947-06-07,Nottingham,England,1947,2,137,427,4,1,512,1333,14,375,906,10,36.57142857142857,>30,ENG,Home,Upto 2014
AV Bedser,ENG,Pace,1947-06-21,Lord's,England,1947,2,96,240,0,1,440,1124,10,344,884,10,44.0,>30,ENG,Home,Upto 2014
AV Bedser,ENG,Pace,1948-06-10,Nottingham,England,1948,2,159,353,5,1,600,1427,17,441,1074,12,35.294117647058826,>30,ENG,Home,Upto 2014
AV Bedser,ENG,Pace,1948-06-24,Lord's,England,1948,2,212,462,5,1,703,1601,26,491,1139,21,27.03846153846154,<=30,ENG,Home,Upto 2014
AV Bedser,ENG,Pace,1948-07-08,Manchester,England,1948,2,108,330,4,1,513,1476,16,405,1146,12,32.0625,>30,ENG,Home,Upto 2014
AV Bedser,ENG,Pace,1948-07-22,Leeds,England,1948,2,148,314,3,1,942,2038,19,794,1724,16,49.578947368421055,>30,ENG,Home,Upto 2014
AV Bedser,ENG,Pace,1948-08-14,The Oval,England,1948,1,61,188,1,1,239,753,15,178,565,14,15.933333333333334,<=30,ENG,Home,Upto 2014
AV Bedser,ENG,Pace,1948-12-16,Durban,South Africa,1948,2,90,253,6,1,290,749,16,200,496,10,18.125,<=30,SA,Away,Upto 2014
AV Bedser,ENG,Pace,1948-12-27,Johannesburg,South Africa,1948,2,93,312,2,1,428,1173,8,335,861,6,53.5,>30,SA,Away,Upto 2014
AV Bedser,ENG,Pace,1949-01-01,Cape Town,South Africa,1949,2,132,328,0,1,484,1256,6,352,928,6,80.66666666666667,>30,SA,Away,Upto 2014
AV Bedser,ENG,Pace,1949-02-12,Johannesburg,South Africa,1949,2,135,328,3,1,558,1385,18,423,1057,15,31.0,>30,SA,Away,Upto 2014
AV Bedser,ENG,Pace,1949-03-05,Gqeberha,South Africa,1949,2,104,432,5,1,319,1001,10,215,569,5,31.9,>30,SA,Away,Upto 2014
AV Bedser,ENG,Pace,1949-06-11,Leeds,England,1949,2,82,186,0,1,597,1077,16,515,891,16,37.3125,>30,ENG,Home,Upto 2014
AV Bedser,ENG,Pace,1949-08-13,The Oval,England,1949,2,133,324,7,1,489,877,14,356,553,7,34.92857142857143,>30,ENG,Home,Upto 2014
AV Bedser,ENG,Pace,1950-06-24,Lord's,England,1950,2,140,504,4,1,279,874,5,139,370,1,55.8,>30,ENG,Home,Upto 2014
AV Bedser,ENG,Pace,1950-07-20,Nottingham,England,1950,2,162,354,5,1,535,1228,10,373,874,5,53.5,>30,ENG,Home,Upto 2014
AV Bedser,ENG,Pace,1950-08-12,The Oval,England,1950,1,75,228,2,1,259,680,4,184,452,2,64.75,>30,ENG,Home,Upto 2014
AV Bedser,ENG,Pace,1950-12-01,Brisbane,Australia,1950,2,54,186,7,1,176,538,19,122,352,12,9.263157894736842,<=30,AUS,Away,Upto 2014
AV Bedser,ENG,Pace,1950-12-22,Melbourne,Australia,1950,2,80,283,6,1,311,916,19,231,633,13,16.36842105263158,<=30,AUS,Away,Upto 2014
AV Bedser,ENG,Pace,1951-01-05,Sydney,Australia,1951,1,107,344,4,1,385,1007,10,278,663,6,38.5,>30,AUS,Away,Upto 2014
AV Bedser,ENG,Pace,1951-02-02,Adelaide,Australia,1951,2,136,408,3,1,424,1099,11,288,691,8,38.54545454545455,>30,AUS,Away,Upto 2014
AV Bedser,ENG,Pace,1951-02-23,Melbourne,Australia,1951,2,105,339,10,1,340,912,18,235,573,8,18.88888888888889,<=30,AUS,Away,Upto 2014
AV Bedser,ENG,Pace,1951-03-17,Christchurch,New Zealand,1951,1,83,246,1,1,365,1014,6,282,768,5,60.833333333333336,>30,NZ,Away,Upto 2014
AV Bedser,ENG,Pace,1951-03-24,Wellington,New Zealand,1951,2,55,258,1,1,192,572,8,137,314,7,24.0,<=30,NZ,Away,Upto 2014
AV Bedser,ENG,Pace,1951-06-07,Nottingham,England,1951,2,159,514,9,1,538,1446,18,379,932,9,29.88888888888889,<=30,ENG,Home,Upto 2014
AV Bedser,ENG,Pace,1951-06-21,Lord's,England,1951,2,60,192,2,1,253,682,13,193,490,11,19.46153846153846,<=30,ENG,Home,Upto 2014
AV Bedser,ENG,Pace,1951-07-05,Manchester,England,1951,2,112,341,12,1,355,980,20,243,639,8,17.75,<=30,ENG,Home,Upto 2014
AV Bedser,ENG,Pace,1951-07-26,Leeds,England,1951,2,118,372,2,1,354,984,3,236,612,1,118.0,>30,ENG,Home,Upto 2014
AV Bedser,ENG,Pace,1951-08-16,The Oval,England,1951,2,68,236,5,1,309,956,16,241,720,11,19.3125,<=30,ENG,Home,Upto 2014
AV Bedser,ENG,Pace,1952-06-05,Leeds,England,1952,2,70,324,4,1,376,1124,14,306,800,10,26.857142857142858,<=30,ENG,Home,Upto 2014
AV Bedser,ENG,Pace,1952-06-19,Lord's,England,1952,2,122,414,4,1,486,1206,17,364,792,13,28.58823529411765,<=30,ENG,Home,Upto 2014
AV Bedser,ENG,Pace,1952-07-17,Manchester,England,1952,2,46,156,7,1,188,520,17,142,364,10,11.058823529411764,<=30,ENG,Home,Upto 2014
AV Bedser,ENG,Pace,1952-08-14,The Oval,England,1952,1,41,89,5,1,139,287,11,98,198,6,12.636363636363637,<=30,ENG,Home,Upto 2014
AV Bedser,ENG,Pace,1953-06-11,Nottingham,England,1953,2,99,335,14,1,325,969,23,226,634,9,14.130434782608695,<=30,ENG,Home,Upto 2014
AV Bedser,ENG,Pace,1953-06-25,Lord's,England,1953,2,182,447,8,1,553,1514,19,371,1067,11,29.105263157894736,<=30,ENG,Home,Upto 2014
AV Bedser,ENG,Pace,1953-07-09,Manchester,England,1953,2,129,294,7,1,352,924,14,223,630,7,25.142857142857142,<=30,ENG,Home,Upto 2014
AV Bedser,ENG,Pace,1953-07-23,Leeds,England,1953,2,160,275,7,1,617,1986,30,457,1711,23,20.566666666666666,<=30,ENG,Home,Upto 2014
AV Bedser,ENG,Pace,1953-08-15,The Oval,England,1953,2,112,240,3,1,504,1206,15,392,966,12,33.6,>30,ENG,Home,Upto 2014
AV Bedser,ENG,Pace,1954-07-01,Nottingham,England,1954,2,113,306,4,1,686,1378,19,573,1072,15,36.10526315789474,>30,ENG,Home,Upto 2014
AV Bedser,ENG,Pace,1954-07-22,Manchester,England,1954,2,45,143,6,1,265,605,10,220,462,4,26.5,<=30,ENG,Home,Upto 2014
AV Bedser,ENG,Pace,1954-11-26,Brisbane,Australia,1954,1,131,296,1,1,750,1616,15,619,1320,14,50.0,>30,AUS,Away,Upto 2014
AV Bedser,ENG,Pace,1955-07-07,Manchester,England,1955,2,153,246,4,1,835,1929,28,682,1683,24,29.821428571428573,<=30,ENG,Home,Upto 2014
AV Mankad,IND,Pace,1969-11-04,Brabourne,India,1969,1,10,5,0,1,298,821,12,288,816,12,24.833333333333332,<=30,IND,Home,Upto 2014
AV Mankad,IND,Pace,1969-11-15,Kanpur,India,1969,1,0,6,0,1,379,992,12,379,986,12,31.583333333333332,>30,IND,Home,Upto 2014
AV Mankad,IND,Pace,1971-03-19,Georgetown,West Indies,1971,1,33,30,0,1,313,504,3,280,474,3,104.33333333333333,>30,WI,Away,Upto 2014
AW Greig,ENG,Spin,1972-06-08,Manchester,England,1972,2,74,158,5,1,177,420,8,103,262,3,22.125,<=30,ENG,Home,Upto 2014
AW Greig,ENG,Spin,1972-06-22,Lord's,England,1972,2,91,192,1,1,154,359,2,63,167,1,77.0,>30,ENG,Home,Upto 2014
AW Greig,ENG,Spin,1972-07-13,Nottingham,England,1972,2,134,304,2,1,374,904,5,240,600,3,74.8,>30,ENG,Home,Upto 2014
AW Greig,ENG,Spin,1972-07-27,Leeds,England,1972,1,25,60,0,1,321,1171,22,296,1111,22,14.590909090909092,<=30,ENG,Home,Upto 2014
AW Greig,ENG,Spin,1972-08-10,The Oval,England,1972,2,74,261,2,1,544,1256,15,470,995,13,36.266666666666666,>30,ENG,Home,Upto 2014
AW Greig,ENG,Spin,1972-12-20,Delhi,India,1972,2,48,174,2,1,561,1750,23,513,1576,21,24.391304347826086,<=30,IND,Away,Upto 2014
AW Greig,ENG,Spin,1972-12-30,Eden Gardens,India,1972,2,37,173,6,1,461,1469,28,424,1296,22,16.464285714285715,<=30,IND,Away,Upto 2014
AW Greig,ENG,Spin,1973-01-12,Chennai,India,1973,1,35,72,0,1,632,1828,31,597,1756,31,20.387096774193548,<=30,IND,Away,Upto 2014
AW Greig,ENG,Spin,1973-01-25,Kanpur,India,1973,2,46,234,2,1,638,1919,18,592,1685,16,35.44444444444444,>30,IND,Away,Upto 2014
AW Greig,ENG,Spin,1973-02-06,Brabourne,India,1973,2,81,210,1,1,967,2173,20,886,1963,19,48.35,>30,IND,Away,Upto 2014
AW Greig,ENG,Spin,1973-03-02,Lahore,Pakistan,1973,2,114,212,6,1,766,1787,23,652,1575,17,33.30434782608695,>30,PAK,Away,Upto 2014
AW Greig,ENG,Spin,1973-03-16,Hyderabad (Sind),Pakistan,1973,1,39,78,0,1,993,2402,21,954,2324,21,47.285714285714285,>30,PAK,Away,Upto 2014
AW Greig,ENG,Spin,1973-03-24,Karachi,Pakistan,1973,2,102,180,0,1,724,1728,23,622,1548,23,31.47826086956522,>30,PAK,Away,Upto 2014
AW Greig,ENG,Spin,1973-06-07,Nottingham,England,1973,2,134,335,7,1,224,617,9,90,282,2,24.88888888888889,<=30,ENG,Home,Upto 2014
AW Greig,ENG,Spin,1973-07-05,Leeds,England,1973,2,51,114,1,1,170,420,1,119,306,0,170.0,>30,ENG,Home,Upto 2014
AW Greig,ENG,Spin,1973-07-26,The Oval,England,1973,2,103,231,2,1,563,1459,15,460,1228,13,37.53333333333333,>30,ENG,Home,Upto 2014
AW Greig,ENG,Spin,1973-08-09,Birmingham,England,1973,2,119,202,2,1,511,1445,13,392,1243,11,39.30769230769231,>30,ENG,Home,Upto 2014
AW Greig,ENG,Spin,1973-08-23,Lord's,England,1973,1,180,198,3,1,503,859,9,323,661,6,55.888888888888886,>30,ENG,Home,Upto 2014
AW Greig,ENG,Spin,1974-02-02,Port of Spain,West Indies,1974,2,64,114,0,1,671,1657,22,607,1543,22,30.5,>30,WI,Away,Upto 2014
AW Greig,ENG,Spin,1974-02-16,Kingston,West Indies,1974,1,102,294,3,1,880,2436,16,778,2142,13,55.0,>30,WI,Away,Upto 2014
AW Greig,ENG,Spin,1974-03-06,Bridgetown,West Indies,1974,1,164,276,6,1,534,1195,11,370,919,5,48.54545454545455,>30,WI,Away,Upto 2014
AW Greig,ENG,Spin,1974-03-22,Georgetown,West Indies,1974,1,57,144,2,1,367,917,8,310,773,6,45.875,>30,WI,Away,Upto 2014
AW Greig,ENG,Spin,1974-03-30,Port of Spain,West Indies,1974,2,156,415,13,1,805,2406,29,649,1991,16,27.75862068965517,<=30,WI,Away,Upto 2014
AW Greig,ENG,Spin,1974-06-06,Manchester,England,1974,2,53,181,3,1,468,1159,11,415,978,8,42.54545454545455,>30,ENG,Home,Upto 2014
AW Greig,ENG,Spin,1974-06-20,Lord's,England,1974,1,63,126,1,1,526,1013,10,463,887,9,52.6,>30,ENG,Home,Upto 2014
AW Greig,ENG,Spin,1974-07-04,Birmingham,England,1974,2,60,114,2,1,474,954,5,414,840,3,94.8,>30,ENG,Home,Upto 2014
AW Greig,ENG,Spin,1974-07-25,Leeds,England,1974,2,37,120,2,1,110,348,4,73,228,2,27.5,<=30,ENG,Home,Upto 2014
AW Greig,ENG,Spin,1974-08-08,Lord's,England,1974,2,78,167,4,1,263,688,20,185,521,16,13.15,<=30,ENG,Home,Upto 2014
AW Greig,ENG,Spin,1974-08-22,The Oval,England,1974,2,107,192,2,1,476,1138,12,369,946,10,39.666666666666664,>30,ENG,Home,Upto 2014
AW Greig,ENG,Spin,1974-11-29,Brisbane,Australia,1974,2,130,232,1,1,316,776,7,186,544,6,45.142857142857146,>30,AUS,Away,Upto 2014
AW Greig,ENG,Spin,1974-12-13,W.A.C.A,Australia,1974,1,69,72,1,1,230,481,6,161,409,5,38.333333333333336,>30,AUS,Away,Upto 2014
AW Greig,ENG,Spin,1974-12-26,Melbourne,Australia,1974,2,119,336,6,1,428,1384,16,309,1048,10,26.75,<=30,AUS,Away,Upto 2014
AW Greig,ENG,Spin,1975-01-04,Sydney,Australia,1975,2,168,279,4,1,427,863,11,259,584,7,38.81818181818182,>30,AUS,Away,Upto 2014
AW Greig,ENG,Spin,1975-01-25,Adelaide,Australia,1975,2,72,96,0,1,485,1136,17,413,1040,17,28.529411764705884,<=30,AUS,Away,Upto 2014
AW Greig,ENG,Spin,1975-02-08,Melbourne,Australia,1975,2,123,326,5,1,308,798,5,185,472,0,61.6,>30,AUS,Away,Upto 2014
AW Greig,ENG,Spin,1975-02-20,Auckland,New Zealand,1975,2,149,328,10,1,416,1136,17,267,808,7,24.470588235294116,<=30,NZ,Away,Upto 2014
AW Greig,ENG,Spin,1975-02-28,Christchurch,New Zealand,1975,1,27,72,2,1,134,381,5,107,309,3,26.8,<=30,NZ,Away,Upto 2014
AW Greig,ENG,Spin,1975-07-10,Birmingham,England,1975,1,43,90,1,1,95,230,3,52,140,2,31.666666666666668,>30,ENG,Home,Upto 2014
AW Greig,ENG,Spin,1975-07-31,Lord's,England,1975,2,129,246,3,1,451,980,12,322,734,9,37.583333333333336,>30,ENG,Home,Upto 2014
AW Greig,ENG,Spin,1975-08-14,Leeds,England,1975,2,34,72,0,1,242,624,11,208,552,11,22.0,<=30,ENG,Home,Upto 2014
AW Greig,ENG,Spin,1975-08-28,The Oval,England,1975,2,116,174,4,1,533,1243,6,417,1069,2,88.83333333333333,>30,ENG,Home,Upto 2014
AW Greig,ENG,Spin,1976-06-03,Nottingham,England,1976,2,98,168,1,1,293,652,6,195,484,5,48.833333333333336,>30,ENG,Home,Upto 2014
AW Greig,ENG,Spin,1976-06-17,Lord's,England,1976,1,42,84,2,1,283,691,11,241,607,9,25.727272727272727,<=30,ENG,Home,Upto 2014
AW Greig,ENG,Spin,1976-07-08,Manchester,England,1976,2,32,60,0,1,286,618,6,254,558,6,47.666666666666664,>30,ENG,Home,Upto 2014
AW Greig,ENG,Spin,1976-07-22,Leeds,England,1976,1,57,60,0,1,146,192,0,89,132,0,inf,>30,ENG,Home,Upto 2014
AW Greig,ENG,Spin,1976-08-12,The Oval,England,1976,2,107,216,2,1,635,1217,8,528,1001,6,79.375,>30,ENG,Home,Upto 2014
AW Greig,ENG,Spin,1976-12-17,Delhi,India,1976,1,84,240,2,1,485,1319,16,401,1079,14,30.3125,>30,IND,Away,Upto 2014
AW Greig,ENG,Spin,1977-01-01,Eden Gardens,India,1977,1,27,60,2,1,396,1315,15,369,1255,13,26.4,<=30,IND,Away,Upto 2014
AW Greig,ENG,Spin,1977-01-14,Chennai,India,1977,1,4,24,0,1,366,1090,21,362,1066,21,17.428571428571427,<=30,IND,Away,Upto 2014
AW Greig,ENG,Spin,1977-01-28,Bengaluru,India,1977,2,118,246,2,1,552,1373,26,434,1127,24,21.23076923076923,<=30,IND,Away,Upto 2014
AW Greig,ENG,Spin,1977-02-11,Wankhede,India,1977,2,103,216,4,1,658,1830,25,555,1614,21,26.32,<=30,IND,Away,Upto 2014
AW Greig,ENG,Spin,1977-03-12,Melbourne,Australia,1977,1,66,112,2,1,232,574,9,166,462,7,25.77777777777778,<=30,AUS,Away,Upto 2014
AW Greig,ENG,Spin,1977-07-07,Manchester,England,1977,2,56,150,2,1,431,1095,17,375,945,15,25.352941176470587,<=30,ENG,Home,Upto 2014
AW Greig,ENG,Spin,1977-07-28,Nottingham,England,1977,2,59,144,2,1,239,584,5,180,440,3,47.8,>30,ENG,Home,Upto 2014
AW Greig,ENG,Spin,1977-08-11,Leeds,England,1977,1,64,120,2,1,146,324,4,82,204,2,36.5,>30,ENG,Home,Upto 2014
AW Greig,ENG,Spin,1977-08-25,The Oval,England,1977,1,17,48,1,1,125,294,2,108,246,1,62.5,>30,ENG,Home,Upto 2014
AW Mold,ENG,Pace,1893-07-17,Lord's,England,1893,1,44,101,3,1,548,1355,26,504,1254,23,21.076923076923077,<=30,ENG,Home,After 1965
AW Mold,ENG,Pace,1893-08-14,The Oval,England,1893,2,85,135,1,1,575,1100,17,490,965,16,33.8235294117647,>30,ENG,Home,After 1965
AW Mold,ENG,Pace,1893-08-24,Manchester,England,1893,2,105,255,3,1,557,1484,22,452,1229,19,25.318181818181817,<=30,ENG,Home,After 1965
AW Nourse,SA,Pace,1902-10-11,Johannesburg,South Africa,1902,1,15,48,0,1,545,690,15,530,642,15,36.333333333333336,>30,SA,Home,Upto 2014
AW Nourse,SA,Pace,1902-10-18,Johannesburg,South Africa,1902,1,19,18,1,1,466,648,16,447,630,15,29.125,<=30,SA,Home,Upto 2014
AW Nourse,SA,Pace,1902-11-08,Cape Town,South Africa,1902,1,13,18,0,1,317,563,15,304,545,15,21.133333333333333,<=30,SA,Home,Upto 2014
AW Nourse,SA,Pace,1906-01-02,Johannesburg,South Africa,1906,2,9,42,2,1,225,553,14,216,511,12,16.071428571428573,<=30,SA,Home,Upto 2014
AW Nourse,SA,Pace,1906-03-06,Johannesburg,South Africa,1906,2,22,54,0,1,275,764,15,253,710,15,18.333333333333332,<=30,SA,Home,Upto 2014
AW Nourse,SA,Pace,1906-03-10,Johannesburg,South Africa,1906,1,11,24,0,1,542,1143,25,531,1119,25,21.68,<=30,SA,Home,Upto 2014
AW Nourse,SA,Pace,1906-03-24,Cape Town,South Africa,1906,2,7,18,0,1,316,931,16,309,913,16,19.75,<=30,SA,Home,Upto 2014
AW Nourse,SA,Pace,1906-03-30,Cape Town,South Africa,1906,2,28,72,4,1,242,576,14,214,504,10,17.285714285714285,<=30,SA,Home,Upto 2014
AW Nourse,SA,Pace,1907-07-01,Lord's,England,1907,1,2,6,0,1,214,540,7,212,534,7,30.571428571428573,>30,ENG,Away,Upto 2014
AW Nourse,SA,Pace,1907-08-19,The Oval,England,1907,2,53,132,4,1,261,564,14,208,432,10,18.642857142857142,<=30,ENG,Away,Upto 2014
AW Nourse,SA,Pace,1910-01-01,Johannesburg,South Africa,1910,2,33,84,0,1,440,846,11,407,762,11,40.0,>30,SA,Home,Upto 2014
AW Nourse,SA,Pace,1910-01-21,Durban,South Africa,1910,2,11,42,2,1,379,1058,15,368,1016,13,25.266666666666666,<=30,SA,Home,Upto 2014
AW Nourse,SA,Pace,1910-02-26,Johannesburg,South Africa,1910,1,18,18,0,1,366,667,10,348,649,10,36.6,>30,SA,Home,Upto 2014
AW Nourse,SA,Pace,1910-03-07,Cape Town,South Africa,1910,1,13,18,0,1,321,621,18,308,603,18,17.833333333333332,<=30,SA,Home,Upto 2014
AW Nourse,SA,Pace,1910-03-11,Cape Town,South Africa,1910,1,35,48,2,1,301,570,12,266,522,10,25.083333333333332,<=30,SA,Home,Upto 2014
AW Nourse,SA,Pace,1910-12-09,Sydney,Australia,1910,1,61,72,0,1,517,899,22,456,827,22,23.5,<=30,AUS,Away,Upto 2014
AW Nourse,SA,Pace,1910-12-31,Melbourne,Australia,1910,2,42,78,0,1,540,1002,17,498,924,17,31.764705882352942,>30,AUS,Away,Upto 2014
AW Nourse,SA,Pace,1911-01-07,Adelaide,Australia,1911,2,74,102,1,1,771,1501,18,697,1399,17,42.833333333333336,>30,AUS,Away,Upto 2014
AW Nourse,SA,Pace,1911-02-17,Melbourne,Australia,1911,2,35,54,0,1,399,623,10,364,569,10,39.9,>30,AUS,Away,Upto 2014
AW Nourse,SA,Pace,1911-03-03,Sydney,Australia,1911,2,58,79,2,1,447,806,13,389,727,11,34.38461538461539,>30,AUS,Away,Upto 2014
AW Nourse,SA,Pace,1912-05-27,Manchester,England,1912,1,62,84,0,1,239,566,12,177,482,12,19.916666666666668,<=30,ENG,Away,Upto 2014
AW Nourse,SA,Pace,1912-06-10,Lord's,England,1912,1,46,96,3,1,280,781,22,234,685,19,12.727272727272727,<=30,ENG,Away,Upto 2014
AW Nourse,SA,Pace,1912-07-08,Leeds,England,1912,2,104,337,7,1,355,954,24,251,617,17,14.791666666666666,<=30,ENG,Away,Upto 2014
AW Nourse,SA,Pace,1912-07-15,Lord's,England,1912,2,82,253,3,1,300,697,11,218,444,8,27.272727272727273,<=30,ENG,Away,Upto 2014
AW Nourse,SA,Pace,1912-08-05,Nottingham,England,1912,1,12,24,0,1,106,300,3,94,276,3,35.333333333333336,>30,ENG,Away,Upto 2014
AW Nourse,SA,Pace,1912-08-12,The Oval,England,1912,1,10,15,0,1,101,319,14,91,304,14,7.214285714285714,<=30,ENG,Away,Upto 2014
AW Nourse,SA,Pace,1913-12-13,Durban,South Africa,1913,1,74,174,2,1,479,1054,20,405,880,18,23.95,<=30,SA,Home,Upto 2014
AW Nourse,SA,Pace,1913-12-26,Johannesburg,South Africa,1913,1,62,126,0,1,455,1029,24,393,903,24,18.958333333333332,<=30,SA,Home,Upto 2014
AW Nourse,SA,Pace,1914-01-01,Johannesburg,South Africa,1914,2,58,132,3,1,545,1214,22,487,1082,19,24.772727272727273,<=30,SA,Home,Upto 2014
AW Nourse,SA,Pace,1914-02-14,Durban,South Africa,1914,1,13,36,0,1,410,971,20,397,935,20,20.5,<=30,SA,Home,Upto 2014
AW Nourse,SA,Pace,1914-02-27,Gqeberha,South Africa,1914,1,31,54,0,1,418,956,19,387,902,19,22.0,<=30,SA,Home,Upto 2014
AW Nourse,SA,Pace,1921-11-05,Durban,South Africa,1921,2,68,114,0,1,645,1385,24,577,1271,24,26.875,<=30,SA,Home,Upto 2014
AW Nourse,SA,Pace,1921-11-12,Johannesburg,South Africa,1921,1,44,42,0,1,791,1453,15,747,1411,15,52.733333333333334,>30,SA,Home,Upto 2014
AW Nourse,SA,Pace,1921-11-26,Cape Town,South Africa,1921,1,89,180,1,1,368,882,11,279,702,10,33.45454545454545,>30,SA,Home,Upto 2014
AW Nourse,SA,Pace,1923-01-18,Durban,South Africa,1923,1,9,24,0,1,496,1373,16,487,1349,16,31.0,>30,SA,Home,Upto 2014
AW Nourse,SA,Pace,1923-02-09,Johannesburg,South Africa,1923,1,7,30,0,1,723,1725,22,716,1695,22,32.86363636363637,>30,SA,Home,Upto 2014
AW Nourse,SA,Pace,1923-02-16,Durban,South Africa,1923,2,33,102,1,1,724,2332,33,691,2230,32,21.939393939393938,<=30,SA,Home,Upto 2014
AW Nourse,SA,Pace,1924-06-14,Birmingham,England,1924,1,3,6,0,1,406,735,19,403,729,19,21.36842105263158,<=30,ENG,Away,Upto 2014
AW Nourse,SA,Pace,1924-06-28,Lord's,England,1924,1,57,90,0,1,434,750,7,377,660,7,62.0,>30,ENG,Away,Upto 2014
AW Nourse,SA,Pace,1924-07-12,Leeds,England,1924,1,67,144,1,1,303,630,5,236,486,4,60.6,>30,ENG,Away,Upto 2014
AW Nourse,SA,Pace,1924-08-16,The Oval,England,1924,1,63,144,2,1,298,576,2,235,432,0,149.0,>30,ENG,Away,Upto 2014
AW Powell,SA,Spin,1899-04-01,Cape Town,South Africa,1899,1,10,20,1,1,347,777,19,337,757,18,18.263157894736842,<=30,SA,Home,After 1965
AW Roberts,NZ,Pace,1937-06-26,Lord's,England,1937,2,174,345,6,1,544,1216,20,370,871,14,27.2,<=30,ENG,Away,Upto 2014
AW Roberts,NZ,Pace,1937-08-14,The Oval,England,1937,2,35,114,1,1,359,810,13,324,696,12,27.615384615384617,<=30,ENG,Away,Upto 2014
AW Seccull,SA,Pace,1896-03-21,Cape Town,South Africa,1896,1,37,60,2,1,245,540,16,208,480,14,15.3125,<=30,SA,Home,After 1965
AW Wellard,ENG,Pace,1937-07-24,Manchester,England,1937,2,111,264,4,1,359,941,19,248,677,15,18.894736842105264,<=30,ENG,Home,Upto 2014
AW Wellard,ENG,Pace,1938-06-24,Lord's,England,1938,2,126,192,3,1,661,1148,17,535,956,14,38.88235294117647,>30,ENG,Home,Upto 2014
AW White,WI,Spin,1965-03-03,Kingston,West Indies,1965,2,48,179,3,1,482,1161,15,434,982,12,32.13333333333333,>30,WI,Home,Upto 2014
AW White,WI,Spin,1965-03-26,Port of Spain,West Indies,1965,1,104,312,0,1,736,1898,17,632,1586,17,43.294117647058826,>30,WI,Home,Upto 2014
AY Patel,NZ,Spin,2018-11-16,Abu Dhabi,UAE,2018,2,123,286,7,1,468,1015,21,345,729,14,22.285714285714285,<=30,UAE,Away,After 1965
AY Patel,NZ,Spin,2018-11-24,Dubai (DICS),UAE,2018,1,120,234,1,1,473,968,16,353,734,15,29.5625,<=30,UAE,Away,After 1965
AY Patel,NZ,Spin,2018-12-03,Abu Dhabi,UAE,2018,2,142,295,5,1,612,1532,24,470,1237,19,25.5,<=30,UAE,Away,After 1965
AY Patel,NZ,Spin,2018-12-15,Wellington,New Zealand,2018,2,60,186,0,1,274,534,4,214,348,4,68.5,>30,NZ,Home,After 1965
AY Patel,NZ,Spin,2018-12-26,Christchurch,New Zealand,2018,1,21,72,0,1,228,444,2,207,372,2,114.0,>30,NZ,Home,After 1965
AY Patel,NZ,Spin,2019-08-14,Galle,Sri Lanka,2019,2,163,306,6,1,786,1622,23,623,1316,17,34.17391304347826,>30,SL,Away,After 1965
AY Patel,NZ,Spin,2019-08-22,Colombo (PSS),Sri Lanka,2019,2,79,210,3,1,428,846,11,349,636,8,38.90909090909091,>30,SL,Away,After 1965
AY Patel,NZ,Spin,2020-02-21,Wellington,New Zealand,2020,2,25,36,0,1,124,210,3,99,174,3,41.333333333333336,>30,NZ,Home,After 1965
AY Patel,NZ,Spin,2021-06-10,Birmingham,England,2021,2,59,138,4,1,120,246,5,61,108,1,24.0,<=30,ENG,Away,After 1965
AY Patel,NZ,Spin,2021-11-25,Kanpur,India,2021,2,150,277,3,1,592,1744,20,442,1467,17,29.6,<=30,IND,Away,After 1965
AY Patel,NZ,Spin,2021-12-03,Wankhede,India,2021,2,225,443,14,1,600,1113,33,375,670,19,18.181818181818183,<=30,IND,Away,After 1965
AY Patel,NZ,Spin,2022-06-02,Lord's,England,2022,1,22,12,0,1,71,111,1,49,99,1,71.0,>30,ENG,Away,After 1965
AY Patel,NZ,Spin,2022-12-26,Karachi,Pakistan,2022,2,201,360,2,1,1086,2053,24,885,1693,22,45.25,>30,PAK,Away,After 1965
AY Patel,NZ,Spin,2023-01-02,Karachi,Pakistan,2023,2,120,144,3,1,805,1350,21,685,1206,18,38.333333333333336,>30,PAK,Away,After 1965
AY Patel,NZ,Spin,2023-11-28,Sylhet,Bangladesh,2023,2,224,364,6,1,883,1678,32,659,1314,26,27.59375,<=30,BAN,Away,After 1965
AY Patel,NZ,Spin,2023-12-06,Mirpur,Bangladesh,2023,2,111,210,8,1,542,923,30,431,713,22,18.066666666666666,<=30,BAN,Away,After 1965
AY Patel,NZ,Spin,2024-09-18,Galle,Sri Lanka,2024,2,150,300,8,1,849,1559,29,699,1259,21,29.275862068965516,<=30,SL,Away,After 1965
AY Patel,NZ,Spin,2024-09-26,Galle,Sri Lanka,2024,1,135,246,0,1,824,1411,22,689,1165,22,37.45454545454545,>30,SL,Away,After 1965
AY Patel,NZ,Spin,2024-10-16,Bengaluru,India,2024,1,100,108,2,1,524,637,10,424,529,8,52.4,>30,IND,Away,After 1965
AY Patel,NZ,Spin,2024-10-24,Pune,India,2024,2,97,140,2,1,741,1336,37,644,1196,35,20.027027027027028,<=30,IND,Away,After 1965
AY Patel,NZ,Spin,2024-11-01,Wankhede,India,2024,2,160,215,11,1,671,1028,34,511,813,23,19.735294117647058,<=30,IND,Away,After 1965
Aamer Jamal,PAK,Pace,2023-12-14,Perth,Australia,2023,2,139,176,7,1,810,1410,28,671,1234,21,28.928571428571427,<=30,AUS,Away,After 1965
Aamer Jamal,PAK,Pace,2023-12-26,Melbourne,Australia,2023,2,138,210,5,1,818,1640,35,680,1430,30,23.37142857142857,<=30,AUS,Away,After 1965
Aamer Jamal,PAK,Pace,2024-01-03,Sydney,Australia,2024,2,91,153,6,1,504,897,22,413,744,16,22.90909090909091,<=30,AUS,Away,After 1965
Aamer Jamal,PAK,Pace,2024-10-07,Multan,Pakistan,2024,1,126,144,1,1,658,930,10,532,786,9,65.8,>30,PAK,Home,After 1965
Aamer Jamal,PAK,Pace,2024-10-15,Multan,Pakistan,2024,1,39,36,0,1,157,284,3,118,248,3,52.333333333333336,>30,PAK,Home,After 1965
Aamer Jamal,PAK,Pace,2024-12-26,Centurion,South Africa,2024,2,47,54,2,1,742,1206,32,695,1152,30,23.1875,<=30,SA,Away,After 1965
Aamer Jamal,PAK,Pace,2025-01-03,Cape Town,South Africa,2025,1,110,120,0,1,862,1222,17,752,1102,17,50.705882352941174,>30,SA,Away,After 1965
Aamer Malik,PAK,Pace,1987-12-07,Faisalabad,Pakistan,1987,2,39,48,0,1,157,324,5,118,276,5,31.4,>30,PAK,Home,Upto 2014
Aamer Malik,PAK,Pace,1987-12-16,Karachi,Pakistan,1987,1,7,12,0,1,422,869,15,415,857,15,28.133333333333333,<=30,PAK,Home,Upto 2014
Aamer Malik,PAK,Pace,1988-09-15,Karachi,Pakistan,1988,2,6,24,1,1,264,678,7,258,654,6,37.714285714285715,>30,PAK,Home,Upto 2014
Aamer Malik,PAK,Pace,1989-02-10,Wellington,New Zealand,1989,1,9,24,0,1,750,1984,22,741,1960,22,34.09090909090909,>30,NZ,Away,Upto 2014
Aamer Malik,PAK,Pace,1989-11-23,Faisalabad,Pakistan,1989,1,9,12,0,1,850,1756,23,841,1744,23,36.95652173913044,>30,PAK,Home,Upto 2014
Aamer Malik,PAK,Pace,1989-12-01,Lahore,Pakistan,1989,1,3,6,0,1,513,1118,6,510,1112,6,85.5,>30,PAK,Home,Upto 2014
Aamer Malik,PAK,Pace,1994-10-05,Rawalpindi,Pakistan,1994,1,16,30,0,1,838,1506,23,822,1476,23,36.43478260869565,>30,PAK,Home,Upto 2014
Aamer Nazir,PAK,Pace,1993-04-23,Bridgetown,West Indies,1993,2,90,132,2,1,783,1460,25,693,1328,23,31.32,>30,WI,Away,Upto 2014
Aamer Nazir,PAK,Pace,1994-02-24,Christchurch,New Zealand,1994,2,113,186,1,1,835,1575,27,722,1389,26,30.925925925925927,>30,NZ,Away,Upto 2014
Aamer Nazir,PAK,Pace,1995-01-19,Johannesburg,South Africa,1995,2,122,157,3,1,915,1724,33,793,1567,30,27.727272727272727,<=30,SA,Away,Upto 2014
Aamer Nazir,PAK,Pace,1995-02-07,Bulawayo,Zimbabwe,1995,2,75,174,3,1,563,1357,30,488,1183,27,18.766666666666666,<=30,ZIM,Away,Upto 2014
Aamer Nazir,PAK,Pace,1995-02-15,Harare,Zimbabwe,1995,2,96,192,8,1,795,1808,39,699,1616,31,20.384615384615383,<=30,ZIM,Away,Upto 2014
Aamer Nazir,PAK,Pace,1995-09-22,Sialkot,Pakistan,1995,2,101,216,3,1,584,1401,24,483,1185,21,24.333333333333332,<=30,PAK,Home,Upto 2014
Aamer Sohail,PAK,Spin,1992-06-04,Birmingham,England,1992,1,8,12,0,1,247,450,2,239,438,2,123.5,>30,ENG,Away,Upto 2014
Aamer Sohail,PAK,Spin,1992-07-23,Leeds,England,1992,1,0,12,0,1,87,273,5,87,261,5,17.4,<=30,ENG,Away,Upto 2014
Aamer Sohail,PAK,Spin,1992-08-06,The Oval,England,1992,1,6,6,0,1,191,493,4,185,487,4,47.75,>30,ENG,Away,Upto 2014
Aamer Sohail,PAK,Spin,1993-01-02,Hamilton,New Zealand,1993,1,12,30,0,1,217,463,6,205,433,6,36.166666666666664,>30,NZ,Away,Upto 2014
Aamer Sohail,PAK,Spin,1993-04-16,Port of Spain,West Indies,1993,1,30,30,1,1,204,311,8,174,281,7,25.5,<=30,WI,Away,Upto 2014
Aamer Sohail,PAK,Spin,1993-04-23,Bridgetown,West Indies,1993,1,14,24,1,1,162,279,5,148,255,4,32.4,>30,WI,Away,Upto 2014
Aamer Sohail,PAK,Spin,1993-12-01,Karachi,Pakistan,1993,2,17,18,0,1,291,834,6,274,816,6,48.5,>30,PAK,Home,Upto 2014
Aamer Sohail,PAK,Spin,1993-12-09,Rawalpindi,Pakistan,1993,1,8,18,0,1,59,150,0,51,132,0,inf,>30,PAK,Home,Upto 2014
Aamer Sohail,PAK,Spin,1994-02-17,Wellington,New Zealand,1994,1,1,6,0,1,228,416,2,227,410,2,114.0,>30,NZ,Away,Upto 2014
Aamer Sohail,PAK,Spin,1994-02-24,Christchurch,New Zealand,1994,1,5,12,0,1,187,378,5,182,366,5,37.4,>30,NZ,Away,Upto 2014
Aamer Sohail,PAK,Spin,1994-08-09,Colombo (PSS),Sri Lanka,1994,1,3,12,0,1,791,1520,23,788,1508,23,34.391304347826086,>30,SL,Away,Upto 2014
Aamer Sohail,PAK,Spin,1994-09-28,Karachi,Pakistan,1994,2,38,72,1,1,538,1117,15,500,1045,14,35.86666666666667,>30,PAK,Home,Upto 2014
Aamer Sohail,PAK,Spin,1994-10-05,Rawalpindi,Pakistan,1994,1,67,126,2,1,440,796,6,373,670,4,73.33333333333333,>30,PAK,Home,Upto 2014
Aamer Sohail,PAK,Spin,1995-01-19,Johannesburg,South Africa,1995,1,47,86,1,1,146,290,3,99,204,2,48.666666666666664,>30,SA,Away,Upto 2014
Aamer Sohail,PAK,Spin,1995-01-31,Harare,Zimbabwe,1995,1,27,36,0,1,301,564,1,274,528,1,301.0,>30,ZIM,Away,Upto 2014
Aamer Sohail,PAK,Spin,1995-02-07,Bulawayo,Zimbabwe,1995,1,5,13,2,1,53,103,2,48,90,0,26.5,<=30,ZIM,Away,Upto 2014
Aamer Sohail,PAK,Spin,1995-02-15,Harare,Zimbabwe,1995,1,7,12,0,1,48,90,0,41,78,0,inf,>30,ZIM,Away,Upto 2014
Aamer Sohail,PAK,Spin,1995-09-08,Peshawar,Pakistan,1995,2,55,138,4,1,297,708,12,242,570,8,24.75,<=30,PAK,Home,Upto 2014
Aamer Sohail,PAK,Spin,1995-09-15,Faisalabad,Pakistan,1995,2,115,306,1,1,624,1381,17,509,1075,16,36.705882352941174,>30,PAK,Home,Upto 2014
Aamer Sohail,PAK,Spin,1995-09-22,Sialkot,Pakistan,1995,2,100,255,2,1,336,832,11,236,577,9,30.545454545454547,>30,PAK,Home,Upto 2014
Aamer Sohail,PAK,Spin,1995-11-09,Brisbane,Australia,1995,1,43,101,2,1,256,659,16,213,558,14,16.0,<=30,AUS,Away,Upto 2014
Aamer Sohail,PAK,Spin,1995-11-17,Hobart,Australia,1995,2,18,66,0,1,263,594,9,245,528,9,29.22222222222222,<=30,AUS,Away,Upto 2014
Aamer Sohail,PAK,Spin,1995-11-30,Sydney,Australia,1995,2,19,36,0,1,467,1214,20,448,1178,20,23.35,<=30,AUS,Away,Upto 2014
Aamer Sohail,PAK,Spin,1995-12-08,Christchurch,New Zealand,1995,1,7,18,0,1,251,572,11,244,554,11,22.818181818181817,<=30,NZ,Away,Upto 2014
Aamer Sohail,PAK,Spin,1996-07-25,Lord's,England,1996,1,3,18,0,1,309,758,8,306,740,8,38.625,>30,ENG,Away,Upto 2014
Aamer Sohail,PAK,Spin,1996-08-22,The Oval,England,1996,2,21,48,0,1,418,892,11,397,844,11,38.0,>30,ENG,Away,Upto 2014
Aamer Sohail,PAK,Spin,1996-10-17,Sheikhupura,Pakistan,1996,2,34,102,0,1,616,1340,14,582,1238,14,44.0,>30,PAK,Home,Upto 2014
Aamer Sohail,PAK,Spin,1998-02-14,Johannesburg,South Africa,1998,1,12,6,0,1,141,272,5,129,266,5,28.2,<=30,SA,Away,Upto 2014
Aamer Sohail,PAK,Spin,1998-02-26,Durban,South Africa,1998,2,28,54,0,1,177,468,9,149,414,9,19.666666666666668,<=30,SA,Away,Upto 2014
Aamer Sohail,PAK,Spin,1998-03-06,Gqeberha,South Africa,1998,1,0,6,0,1,101,198,4,101,192,4,25.25,<=30,SA,Away,Upto 2014
Aamer Sohail,PAK,Spin,1998-10-01,Rawalpindi,Pakistan,1998,1,54,138,1,1,561,1319,19,507,1181,18,29.526315789473685,<=30,PAK,Home,Upto 2014
Aamer Sohail,PAK,Spin,1998-10-15,Peshawar,Pakistan,1998,2,146,312,2,1,751,1422,7,605,1110,5,107.28571428571429,>30,PAK,Home,Upto 2014
Aamer Sohail,PAK,Spin,2000-02-26,Rawalpindi,Pakistan,2000,1,55,140,1,1,401,1058,12,346,918,11,33.416666666666664,>30,PAK,Home,Upto 2014
Aamer Sohail,PAK,Spin,2000-03-05,Peshawar,Pakistan,2000,2,44,114,4,1,411,991,20,367,877,16,20.55,<=30,PAK,Home,Upto 2014
Aaqib Javed,PAK,Pace,1989-02-10,Wellington,New Zealand,1989,2,160,282,0,1,750,1984,22,590,1702,22,34.09090909090909,>30,NZ,Away,Upto 2014
Aaqib Javed,PAK,Pace,1990-01-12,Melbourne,Australia,1990,2,102,259,3,1,791,2097,34,689,1838,31,23.264705882352942,<=30,AUS,Away,Upto 2014
Aaqib Javed,PAK,Pace,1990-10-10,Karachi,Pakistan,1990,2,82,168,3,1,575,1344,23,493,1176,20,25.0,<=30,PAK,Home,Upto 2014
Aaqib Javed,PAK,Pace,1990-10-18,Lahore,Pakistan,1990,2,77,204,1,1,697,1583,26,620,1379,25,26.807692307692307,<=30,PAK,Home,Upto 2014
Aaqib Javed,PAK,Pace,1990-10-26,Faisalabad,Pakistan,1990,2,81,162,3,1,725,1761,39,644,1599,36,18.58974358974359,<=30,PAK,Home,Upto 2014
Aaqib Javed,PAK,Pace,1991-12-12,Sialkot,Pakistan,1991,2,92,180,4,1,611,1329,14,519,1149,10,43.642857142857146,>30,PAK,Home,Upto 2014
Aaqib Javed,PAK,Pace,1992-01-02,Faisalabad,Pakistan,1992,2,53,121,2,1,743,1706,36,690,1585,34,20.63888888888889,<=30,PAK,Home,Upto 2014
Aaqib Javed,PAK,Pace,1992-06-04,Birmingham,England,1992,1,86,96,1,1,641,1086,9,555,990,8,71.22222222222223,>30,ENG,Away,Upto 2014
Aaqib Javed,PAK,Pace,1992-06-18,Lord's,England,1992,2,63,156,1,1,607,1221,26,544,1065,25,23.346153846153847,<=30,ENG,Away,Upto 2014
Aaqib Javed,PAK,Pace,1992-07-02,Manchester,England,1992,1,100,130,4,1,841,1528,24,741,1398,20,35.041666666666664,>30,ENG,Away,Upto 2014
Aaqib Javed,PAK,Pace,1992-07-23,Leeds,England,1992,1,48,96,1,1,719,1557,27,671,1461,26,26.62962962962963,<=30,ENG,Away,Upto 2014
Aaqib Javed,PAK,Pace,1992-08-06,The Oval,England,1992,2,69,150,2,1,546,1176,25,477,1026,23,21.84,<=30,ENG,Away,Upto 2014
Aaqib Javed,PAK,Pace,1993-01-02,Hamilton,New Zealand,1993,2,38,90,0,1,500,1200,33,462,1110,33,15.151515151515152,<=30,NZ,Away,Upto 2014
Aaqib Javed,PAK,Pace,1994-11-01,Lahore,Pakistan,1994,1,75,186,0,1,516,907,10,441,721,10,51.6,>30,PAK,Home,Upto 2014
Aaqib Javed,PAK,Pace,1995-01-19,Johannesburg,South Africa,1995,2,184,334,5,1,915,1724,33,731,1390,28,27.727272727272727,<=30,SA,Away,Upto 2014
Aaqib Javed,PAK,Pace,1995-01-31,Harare,Zimbabwe,1995,1,73,205,2,1,693,1542,23,620,1337,21,30.130434782608695,>30,ZIM,Away,Upto 2014
Aaqib Javed,PAK,Pace,1995-02-15,Harare,Zimbabwe,1995,2,90,256,6,1,795,1808,39,705,1552,33,20.384615384615383,<=30,ZIM,Away,Upto 2014
Aaqib Javed,PAK,Pace,1995-09-08,Peshawar,Pakistan,1995,2,77,145,3,1,562,1039,16,485,894,13,35.125,>30,PAK,Home,Upto 2014
Aaqib Javed,PAK,Pace,1995-09-15,Faisalabad,Pakistan,1995,2,118,273,8,1,465,1059,21,347,786,13,22.142857142857142,<=30,PAK,Home,Upto 2014
Aaqib Javed,PAK,Pace,1995-09-22,Sialkot,Pakistan,1995,2,118,261,5,1,584,1401,24,466,1140,19,24.333333333333332,<=30,PAK,Home,Upto 2014
Aaqib Javed,PAK,Pace,1998-11-27,Peshawar,Pakistan,1998,2,88,164,0,1,700,1353,31,612,1189,31,22.580645161290324,<=30,PAK,Home,Upto 2014
Abdul Malik,1,Spin,2024-12-26,Bulawayo,Zimbabwe,2024,1,23,36,0,1,1189,1856,20,1166,1820,20,59.45,>30,ZIM,Away,After 1965
Abdul Malik,1,Spin,2025-01-02,Bulawayo,Zimbabwe,2025,2,22,18,0,1,588,1149,23,566,1131,23,25.565217391304348,<=30,ZIM,Away,After 1965
Abdul Qadir,PAK,Spin,1977-12-14,Lahore,Pakistan,1977,1,82,263,1,1,395,1311,10,313,1048,9,39.5,>30,PAK,Home,Upto 2014
Abdul Qadir,PAK,Spin,1978-01-02,Hyderabad (Sind),Pakistan,1978,2,116,408,6,1,585,1882,17,469,1474,11,34.411764705882355,>30,PAK,Home,Upto 2014
Abdul Qadir,PAK,Spin,1978-01-18,Karachi,Pakistan,1978,2,107,385,5,1,466,1665,20,359,1280,15,23.3,<=30,PAK,Home,Upto 2014
Abdul Qadir,PAK,Spin,1979-11-21,Bengaluru,India,1979,1,114,210,1,1,552,1383,11,438,1173,10,50.18181818181818,>30,IND,Away,Upto 2014
Abdul Qadir,PAK,Spin,1979-12-04,Delhi,India,1979,1,16,66,0,1,303,672,3,287,606,3,101.0,>30,IND,Away,Upto 2014
Abdul Qadir,PAK,Spin,1979-12-16,Wankhede,India,1979,2,43,84,1,1,435,1053,22,392,969,21,19.772727272727273,<=30,IND,Away,Upto 2014
Abdul Qadir,PAK,Spin,1980-11-24,Lahore,Pakistan,1980,1,131,244,4,1,274,622,12,143,378,8,22.833333333333332,<=30,PAK,Home,Upto 2014
Abdul Qadir,PAK,Spin,1980-12-08,Faisalabad,Pakistan,1980,2,93,195,4,1,460,1075,25,367,880,21,18.4,<=30,PAK,Home,Upto 2014
Abdul Qadir,PAK,Spin,1982-07-29,Birmingham,England,1982,2,170,414,3,1,280,691,9,110,277,6,31.11111111111111,>30,ENG,Away,Upto 2014
Abdul Qadir,PAK,Spin,1982-08-12,Lord's,England,1982,2,133,371,6,1,199,504,6,66,133,0,33.166666666666664,>30,ENG,Away,Upto 2014
Abdul Qadir,PAK,Spin,1982-08-26,Leeds,England,1982,2,103,180,1,1,134,222,2,31,42,1,67.0,>30,ENG,Away,Upto 2014
Abdul Qadir,PAK,Spin,1982-09-22,Karachi,Pakistan,1982,2,156,286,7,1,480,981,15,324,695,8,32.0,>30,PAK,Home,Upto 2014
Abdul Qadir,PAK,Spin,1982-09-30,Faisalabad,Pakistan,1982,2,218,557,11,1,662,1534,17,444,977,6,38.94117647058823,>30,PAK,Home,Upto 2014
Abdul Qadir,PAK,Spin,1982-10-14,Lahore,Pakistan,1982,2,188,432,4,1,305,636,6,117,204,2,50.833333333333336,>30,PAK,Home,Upto 2014
Abdul Qadir,PAK,Spin,1982-12-23,Karachi,Pakistan,1982,2,142,228,6,1,277,474,7,135,246,1,39.57142857142857,>30,PAK,Home,Upto 2014
Abdul Qadir,PAK,Spin,1983-01-03,Faisalabad,Pakistan,1983,2,81,141,1,1,324,501,2,243,360,1,162.0,>30,PAK,Home,Upto 2014
Abdul Qadir,PAK,Spin,1983-01-14,Hyderabad (Sind),Pakistan,1983,2,112,222,2,1,496,1008,6,384,786,4,82.66666666666667,>30,PAK,Home,Upto 2014
Abdul Qadir,PAK,Spin,1983-01-23,Lahore,Pakistan,1983,1,63,96,1,1,176,366,3,113,270,2,58.666666666666664,>30,PAK,Home,Upto 2014
Abdul Qadir,PAK,Spin,1983-01-30,Karachi,Pakistan,1983,2,128,222,1,1,287,546,2,159,324,1,143.5,>30,PAK,Home,Upto 2014
Abdul Qadir,PAK,Spin,1983-11-11,W.A.C.A,Australia,1983,1,121,192,3,1,212,366,4,91,174,1,53.0,>30,AUS,Away,Upto 2014
Abdul Qadir,PAK,Spin,1983-11-25,Brisbane,Australia,1983,1,112,192,1,1,302,612,4,190,420,3,75.5,>30,AUS,Away,Upto 2014
Abdul Qadir,PAK,Spin,1983-12-09,Adelaide,Australia,1983,2,228,402,3,1,433,870,5,205,468,2,86.6,>30,AUS,Away,Upto 2014
Abdul Qadir,PAK,Spin,1983-12-26,Melbourne,Australia,1983,1,166,327,5,1,391,853,9,225,526,4,43.44444444444444,>30,AUS,Away,Upto 2014
Abdul Qadir,PAK,Spin,1984-01-02,Sydney,Australia,1984,1,105,204,0,1,181,354,1,76,150,1,181.0,>30,AUS,Away,Upto 2014
Abdul Qadir,PAK,Spin,1984-03-02,Karachi,Pakistan,1984,2,133,372,8,1,352,1095,26,219,723,18,13.538461538461538,<=30,PAK,Home,Upto 2014
Abdul Qadir,PAK,Spin,1984-03-12,Faisalabad,Pakistan,1984,1,124,306,1,1,537,1272,7,413,966,6,76.71428571428571,>30,PAK,Home,Upto 2014
Abdul Qadir,PAK,Spin,1984-03-19,Lahore,Pakistan,1984,2,194,432,10,1,562,1203,13,368,771,3,43.23076923076923,>30,PAK,Home,Upto 2014
Abdul Qadir,PAK,Spin,1984-10-24,Faisalabad,Pakistan,1984,1,104,228,4,1,475,1147,7,371,919,3,67.85714285714286,>30,PAK,Home,Upto 2014
Abdul Qadir,PAK,Spin,1984-11-16,Lahore,Pakistan,1984,2,140,282,4,1,445,1036,19,305,754,15,23.42105263157895,<=30,PAK,Home,Upto 2014
Abdul Qadir,PAK,Spin,1984-11-25,Hyderabad (Sind),Pakistan,1984,2,167,351,8,1,706,1491,27,539,1140,19,26.14814814814815,<=30,PAK,Home,Upto 2014
Abdul Qadir,PAK,Spin,1985-01-18,Wellington,New Zealand,1985,2,160,354,1,1,422,1002,10,262,648,9,42.2,>30,NZ,Away,Upto 2014
Abdul Qadir,PAK,Spin,1985-01-25,Auckland,New Zealand,1985,1,52,132,1,1,99,212,2,47,80,1,49.5,>30,NZ,Away,Upto 2014
Abdul Qadir,PAK,Spin,1985-10-16,Faisalabad,Pakistan,1985,1,132,327,3,1,278,675,3,146,348,0,92.66666666666667,>30,PAK,Home,Upto 2014
Abdul Qadir,PAK,Spin,1985-10-27,Sialkot,Pakistan,1985,1,1,7,0,1,11,31,0,10,24,0,inf,>30,PAK,Home,Upto 2014
Abdul Qadir,PAK,Spin,1985-11-07,Karachi,Pakistan,1985,2,146,280,6,1,327,706,13,181,426,7,25.153846153846153,<=30,PAK,Home,Upto 2014
Abdul Qadir,PAK,Spin,1986-02-23,Kandy,Sri Lanka,1986,2,48,118,3,1,188,445,14,140,327,11,13.428571428571429,<=30,SL,Away,Upto 2014
Abdul Qadir,PAK,Spin,1986-03-22,Colombo (PSS),Sri Lanka,1986,2,126,275,2,1,135,371,2,9,96,0,67.5,>30,SL,Away,Upto 2014
Abdul Qadir,PAK,Spin,1986-10-24,Faisalabad,Pakistan,1986,2,74,147,7,1,160,446,11,86,299,4,14.545454545454545,<=30,PAK,Home,Upto 2014
Abdul Qadir,PAK,Spin,1986-11-07,Lahore,Pakistan,1986,1,96,192,4,1,133,342,6,37,150,2,22.166666666666668,<=30,PAK,Home,Upto 2014
Abdul Qadir,PAK,Spin,1986-11-20,Karachi,Pakistan,1986,2,191,455,7,1,383,1055,15,192,600,8,25.533333333333335,<=30,PAK,Home,Upto 2014
Abdul Qadir,PAK,Spin,1987-02-03,Chennai,India,1987,1,130,234,2,1,827,1860,14,697,1626,12,59.07142857142857,>30,IND,Away,Upto 2014
Abdul Qadir,PAK,Spin,1987-02-11,Eden Gardens,India,1987,2,59,96,1,1,258,750,5,199,654,4,51.6,>30,IND,Away,Upto 2014
Abdul Qadir,PAK,Spin,1987-03-04,Ahmedabad,India,1987,1,53,78,1,1,616,1851,11,563,1773,10,56.0,>30,IND,Away,Upto 2014
Abdul Qadir,PAK,Spin,1987-06-18,Lord's,England,1987,1,100,150,1,1,100,150,1,0,0,0,100.0,>30,ENG,Away,Upto 2014
Abdul Qadir,PAK,Spin,1987-07-02,Leeds,England,1987,2,74,192,0,1,133,342,1,59,150,1,133.0,>30,ENG,Away,Upto 2014
Abdul Qadir,PAK,Spin,1987-07-23,Birmingham,England,1987,1,65,126,0,1,177,477,2,112,351,2,88.5,>30,ENG,Away,Upto 2014
Abdul Qadir,PAK,Spin,1987-08-06,The Oval,England,1987,2,211,586,10,1,612,1585,13,401,999,3,47.07692307692308,>30,ENG,Away,Upto 2014
Abdul Qadir,PAK,Spin,1987-11-25,Lahore,Pakistan,1987,2,101,438,13,1,424,1316,26,323,878,13,16.307692307692307,<=30,PAK,Home,Upto 2014
Abdul Qadir,PAK,Spin,1987-12-07,Faisalabad,Pakistan,1987,2,150,342,7,1,479,1253,22,329,911,15,21.772727272727273,<=30,PAK,Home,Upto 2014
Abdul Qadir,PAK,Spin,1987-12-16,Karachi,Pakistan,1987,2,186,628,10,1,450,1486,13,264,858,3,34.61538461538461,>30,PAK,Home,Upto 2014
Abdul Qadir,PAK,Spin,1988-04-02,Georgetown,West Indies,1988,2,157,294,4,1,306,558,9,149,264,5,34.0,>30,WI,Away,Upto 2014
Abdul Qadir,PAK,Spin,1988-04-14,Port of Spain,West Indies,1988,2,231,400,8,1,344,563,11,113,163,3,31.272727272727273,>30,WI,Away,Upto 2014
Abdul Qadir,PAK,Spin,1988-04-22,Bridgetown,West Indies,1988,2,150,282,2,1,257,510,4,107,228,2,64.25,>30,WI,Away,Upto 2014
Abdul Qadir,PAK,Spin,1988-09-15,Karachi,Pakistan,1988,2,88,300,5,1,427,1461,22,339,1161,17,19.40909090909091,<=30,PAK,Home,Upto 2014
Abdul Qadir,PAK,Spin,1988-09-23,Faisalabad,Pakistan,1988,2,118,264,3,1,520,1112,15,402,848,12,34.666666666666664,>30,PAK,Home,Upto 2014
Abdul Qadir,PAK,Spin,1988-10-07,Lahore,Pakistan,1988,2,114,246,3,1,510,1394,19,396,1148,16,26.842105263157894,<=30,PAK,Home,Upto 2014
Abdul Qadir,PAK,Spin,1989-02-10,Wellington,New Zealand,1989,2,122,258,1,1,272,570,2,150,312,1,136.0,>30,NZ,Away,Upto 2014
Abdul Qadir,PAK,Spin,1989-02-24,Auckland,New Zealand,1989,2,187,445,7,1,705,1609,10,518,1164,3,70.5,>30,NZ,Away,Upto 2014
Abdul Qadir,PAK,Spin,1989-11-15,Karachi,Pakistan,1989,2,152,228,2,1,349,576,2,197,348,0,174.5,>30,PAK,Home,Upto 2014
Abdul Qadir,PAK,Spin,1989-11-23,Faisalabad,Pakistan,1989,2,97,204,1,1,216,414,1,119,210,0,216.0,>30,PAK,Home,Upto 2014
Abdul Qadir,PAK,Spin,1989-12-01,Lahore,Pakistan,1989,1,97,210,3,1,665,1174,7,568,964,4,95.0,>30,PAK,Home,Upto 2014
Abdul Qadir,PAK,Spin,1989-12-09,Sialkot,Pakistan,1989,1,0,12,0,1,4,24,0,4,12,0,inf,>30,PAK,Home,Upto 2014
Abdul Qadir,PAK,Spin,1990-10-10,Karachi,Pakistan,1990,2,64,102,1,1,202,384,2,138,282,1,101.0,>30,PAK,Home,Upto 2014
Abdul Qadir,PAK,Spin,1990-10-18,Lahore,Pakistan,1990,2,48,132,3,1,149,339,4,101,207,1,37.25,>30,PAK,Home,Upto 2014
Abdul Qadir,PAK,Spin,1990-11-15,Karachi,Pakistan,1990,2,78,168,1,1,289,648,5,211,480,4,57.8,>30,PAK,Home,Upto 2014
Abdul Qadir,PAK,Spin,1990-12-06,Lahore,Pakistan,1990,2,94,132,1,1,232,389,5,138,257,4,46.4,>30,PAK,Home,Upto 2014
Abdul Razzaq,PAK,Pace,1999-11-05,Brisbane,Australia,1999,1,66,102,0,1,895,1510,23,829,1408,23,38.91304347826087,>30,AUS,Away,Upto 2014
Abdul Razzaq,PAK,Pace,2000-02-26,Rawalpindi,Pakistan,2000,2,155,353,6,1,697,1541,24,542,1188,18,29.041666666666668,<=30,PAK,Home,Upto 2014
Abdul Razzaq,PAK,Pace,2000-03-05,Peshawar,Pakistan,2000,2,66,204,2,1,480,1060,20,414,856,18,24.0,<=30,PAK,Home,Upto 2014
Abdul Razzaq,PAK,Pace,2000-05-05,Georgetown,West Indies,2000,1,13,60,1,1,344,903,13,331,843,12,26.46153846153846,<=30,WI,Away,Upto 2014
Abdul Razzaq,PAK,Pace,2000-05-18,Bridgetown,West Indies,2000,1,50,96,1,1,788,1618,23,738,1522,22,34.26086956521739,>30,WI,Away,Upto 2014
Abdul Razzaq,PAK,Pace,2000-05-25,St John's,West Indies,2000,2,58,138,1,1,652,1622,32,594,1484,31,20.375,<=30,WI,Away,Upto 2014
Abdul Razzaq,PAK,Pace,2000-06-14,Colombo (SSC),Sri Lanka,2000,2,81,192,1,1,461,1090,17,380,898,16,27.11764705882353,<=30,SL,Away,Upto 2014
Abdul Razzaq,PAK,Pace,2000-06-21,Galle,Sri Lanka,2000,2,79,162,3,1,578,1128,20,499,966,17,28.9,<=30,SL,Away,Upto 2014
Abdul Razzaq,PAK,Pace,2000-06-28,Kandy,Sri Lanka,2000,1,65,198,2,1,200,466,2,135,268,0,100.0,>30,SL,Away,Upto 2014
Abdul Razzaq,PAK,Pace,2000-11-15,Lahore,Pakistan,2000,2,76,174,0,1,230,588,2,154,414,2,115.0,>30,PAK,Home,Upto 2014
Abdul Razzaq,PAK,Pace,2000-11-29,Faisalabad,Pakistan,2000,2,74,126,3,1,365,711,8,291,585,5,45.625,>30,PAK,Home,Upto 2014
Abdul Razzaq,PAK,Pace,2000-12-07,Karachi,Pakistan,2000,2,81,192,1,1,458,1000,15,377,808,14,30.533333333333335,>30,PAK,Home,Upto 2014
Abdul Razzaq,PAK,Pace,2001-05-17,Lord's,England,2001,1,68,126,1,1,714,1443,30,646,1317,29,23.8,<=30,ENG,Away,Upto 2014
Abdul Razzaq,PAK,Pace,2001-05-31,Manchester,England,2001,2,94,192,4,1,1134,1996,31,1040,1804,27,36.58064516129032,>30,ENG,Away,Upto 2014
Abdul Razzaq,PAK,Pace,2001-08-29,Multan,Pakistan,2001,2,61,96,0,1,512,738,9,451,642,9,56.888888888888886,>30,PAK,Home,Upto 2014
Abdul Razzaq,PAK,Pace,2002-01-09,Dhaka,Bangladesh,2002,2,71,110,4,1,377,686,15,306,576,11,25.133333333333333,<=30,BAN,Away,Upto 2014
Abdul Razzaq,PAK,Pace,2002-01-16,Chattogram,Bangladesh,2002,2,15,42,0,1,326,664,15,311,622,15,21.733333333333334,<=30,BAN,Away,Upto 2014
Abdul Razzaq,PAK,Pace,2002-01-31,Sharjah,UAE,2002,2,74,155,5,1,822,1590,24,748,1435,19,34.25,>30,UAE,Away,Upto 2014
Abdul Razzaq,PAK,Pace,2002-02-07,Sharjah,UAE,2002,2,52,114,4,1,615,1212,24,563,1098,20,25.625,<=30,UAE,Away,Upto 2014
Abdul Razzaq,PAK,Pace,2002-03-06,Lahore,Pakistan,2002,1,82,174,3,1,853,1374,23,771,1200,20,37.08695652173913,>30,PAK,Home,Upto 2014
Abdul Razzaq,PAK,Pace,2002-05-01,Lahore,Pakistan,2002,1,47,84,2,1,476,866,17,429,782,15,28.0,<=30,PAK,Home,Upto 2014
Abdul Razzaq,PAK,Pace,2002-10-03,Colombo (PSS),Sri Lanka,2002,1,78,102,1,1,672,1175,21,594,1073,20,32.0,>30,SL,Away,Upto 2014
Abdul Razzaq,PAK,Pace,2002-10-11,Sharjah,UAE,2002,1,22,61,3,1,167,426,14,145,365,11,11.928571428571429,<=30,UAE,Away,Upto 2014
Abdul Razzaq,PAK,Pace,2002-12-26,Durban,South Africa,2002,1,57,114,0,1,631,1153,23,574,1039,23,27.434782608695652,<=30,SA,Away,Upto 2014
Abdul Razzaq,PAK,Pace,2003-10-24,Faisalabad,Pakistan,2003,2,138,240,5,1,604,1451,24,466,1211,19,25.166666666666668,<=30,PAK,Home,Upto 2014
Abdul Razzaq,PAK,Pace,2003-12-19,Hamilton,New Zealand,2003,2,81,126,0,1,863,1591,23,782,1465,23,37.52173913043478,>30,NZ,Away,Upto 2014
Abdul Razzaq,PAK,Pace,2003-12-26,Wellington,New Zealand,2003,2,81,168,1,1,696,1646,29,615,1478,28,24.0,<=30,NZ,Away,Upto 2014
Abdul Razzaq,PAK,Pace,2004-03-28,Multan,Pakistan,2004,1,61,90,0,1,716,1290,10,655,1200,10,71.6,>30,PAK,Home,Upto 2014
Abdul Razzaq,PAK,Pace,2004-10-20,Faisalabad,Pakistan,2004,2,111,222,0,1,726,1252,21,615,1030,21,34.57142857142857,>30,PAK,Home,Upto 2014
Abdul Razzaq,PAK,Pace,2004-10-28,Karachi,Pakistan,2004,2,134,313,5,1,689,1333,19,555,1020,14,36.26315789473684,>30,PAK,Home,Upto 2014
Abdul Razzaq,PAK,Pace,2004-12-16,W.A.C.A,Australia,2004,2,103,147,3,1,677,1213,30,574,1066,27,22.566666666666666,<=30,AUS,Away,Upto 2014
Abdul Razzaq,PAK,Pace,2004-12-26,Melbourne,Australia,2004,1,27,42,0,1,584,1094,18,557,1052,18,32.44444444444444,>30,AUS,Away,Upto 2014
Abdul Razzaq,PAK,Pace,2005-03-08,Mohali,India,2005,1,107,156,1,1,866,1468,17,759,1312,16,50.94117647058823,>30,IND,Away,Upto 2014
Abdul Razzaq,PAK,Pace,2005-03-16,Eden Gardens,India,2005,2,142,247,6,1,678,1069,14,536,822,8,48.42857142857143,>30,IND,Away,Upto 2014
Abdul Razzaq,PAK,Pace,2005-03-24,Bengaluru,India,2005,2,111,180,0,1,604,960,8,493,780,8,75.5,>30,IND,Away,Upto 2014
Abdul Razzaq,PAK,Pace,2005-05-26,Bridgetown,West Indies,2005,2,94,192,5,1,722,1198,25,628,1006,20,28.88,<=30,WI,Away,Upto 2014
Abdul Razzaq,PAK,Pace,2005-06-03,Kingston,West Indies,2005,2,120,222,3,1,832,1351,29,712,1129,26,28.689655172413794,<=30,WI,Away,Upto 2014
Abdul Razzaq,PAK,Pace,2006-01-21,Faisalabad,Pakistan,2006,1,126,168,2,1,888,1366,17,762,1198,15,52.23529411764706,>30,PAK,Home,Upto 2014
Abdul Razzaq,PAK,Pace,2006-01-29,Karachi,Pakistan,2006,2,155,208,7,1,991,1398,31,836,1190,24,31.967741935483872,>30,PAK,Home,Upto 2014
Abdul Razzaq,PAK,Pace,2006-03-26,Colombo (SSC),Sri Lanka,2006,2,86,132,0,1,568,1044,16,482,912,16,35.5,>30,SL,Away,Upto 2014
Abdul Razzaq,PAK,Pace,2006-04-03,Kandy,Sri Lanka,2006,2,56,107,4,1,524,943,20,468,836,16,26.2,<=30,SL,Away,Upto 2014
Abdul Razzaq,PAK,Pace,2006-07-13,Lord's,England,2006,2,131,209,3,1,919,1514,18,788,1305,15,51.05555555555556,>30,ENG,Away,Upto 2014
Abdul Razzaq,PAK,Pace,2006-07-27,Manchester,England,2006,1,72,114,2,1,487,865,18,415,751,16,27.055555555555557,<=30,ENG,Away,Upto 2014
Abdul Razzaq,PAK,Pace,2006-11-11,Lahore,Pakistan,2006,2,41,84,0,1,669,1208,21,628,1124,21,31.857142857142858,>30,PAK,Home,Upto 2014
Abdul Razzaq,PAK,Pace,2006-11-19,Multan,Pakistan,2006,1,65,106,2,1,741,1564,16,676,1458,14,46.3125,>30,PAK,Home,Upto 2014
Abdul Razzaq,PAK,Pace,2006-11-27,Karachi,Pakistan,2006,2,67,168,3,1,841,1655,23,774,1487,20,36.56521739130435,>30,PAK,Home,Upto 2014
Abdul Wasi,AFG,Spin,2021-03-02,Abu Dhabi,UAE,2021,1,23,53,0,1,274,533,12,251,480,12,22.833333333333332,<=30,UAE,Away,After 1965
Abdur Rauf,PAK,Pace,2009-07-04,Galle,Sri Lanka,2009,2,108,162,3,1,560,942,21,452,780,18,26.666666666666668,<=30,SL,Away,Upto 2014
Abdur Rauf,PAK,Pace,2009-07-12,Colombo (PSS),Sri Lanka,2009,2,51,90,2,1,365,700,17,314,610,15,21.470588235294116,<=30,SL,Away,Upto 2014
Abdur Rauf,PAK,Pace,2009-12-26,Melbourne,Australia,2009,2,119,198,1,1,736,1512,23,617,1314,22,32.0,>30,AUS,Away,Upto 2014
Abdur Razzak,BAN,Spin,2006-04-16,Chattogram,Bangladesh,2006,1,99,180,0,1,796,1393,18,697,1213,18,44.22222222222222,>30,BAN,Home,Upto 2014
Abdur Razzak,BAN,Spin,2007-06-25,Colombo (SSC),Sri Lanka,2007,1,109,180,1,1,605,1005,14,496,825,13,43.214285714285715,>30,SL,Away,Upto 2014
Abdur Razzak,BAN,Spin,2008-02-29,Chattogram,Bangladesh,2008,1,129,186,1,1,550,943,13,421,757,12,42.30769230769231,>30,BAN,Home,Upto 2014
Abdur Razzak,BAN,Spin,2008-10-17,Chattogram,Bangladesh,2008,2,144,396,4,1,669,1820,29,525,1424,25,23.06896551724138,<=30,BAN,Home,Upto 2014
Abdur Razzak,BAN,Spin,2008-10-25,Mirpur,Bangladesh,2008,2,80,186,1,1,361,720,10,281,534,9,36.1,>30,BAN,Home,Upto 2014
Abdur Razzak,BAN,Spin,2010-03-12,Chattogram,Bangladesh,2010,2,210,246,4,1,894,1491,22,684,1245,18,40.63636363636363,>30,BAN,Home,Upto 2014
Abdur Razzak,BAN,Spin,2010-03-20,Mirpur,Bangladesh,2010,2,199,327,3,1,865,1792,20,666,1465,17,43.25,>30,BAN,Home,Upto 2014
Abdur Razzak,BAN,Spin,2010-06-04,Manchester,England,2010,1,109,180,2,1,455,779,14,346,599,12,32.5,>30,ENG,Away,Upto 2014
Abdur Razzak,BAN,Spin,2011-08-04,Harare,Zimbabwe,2011,2,106,252,2,1,318,704,9,212,452,7,35.333333333333336,>30,ZIM,Away,Upto 2014
Abdur Razzak,BAN,Spin,2013-10-09,Chattogram,Bangladesh,2013,2,263,522,3,1,1057,1946,22,794,1424,19,48.04545454545455,>30,BAN,Home,Upto 2014
Abdur Razzak,BAN,Spin,2013-10-21,Mirpur,Bangladesh,2013,1,96,138,2,1,460,965,12,364,827,10,38.333333333333336,>30,BAN,Home,Upto 2014
Abdur Razzak,BAN,Spin,2014-02-04,Chattogram,Bangladesh,2014,1,6,24,0,1,1153,1976,25,1147,1952,25,46.12,>30,BAN,Home,After 1965
Abdur Razzak,BAN,Spin,2018-02-08,Mirpur,Bangladesh,2018,2,123,198,5,1,561,1029,30,438,831,25,18.7,<=30,BAN,Home,After 1965
Abdur Rehman,PAK,Spin,2007-10-01,Karachi,Pakistan,2007,2,210,414,8,1,692,1416,21,482,1002,13,32.95238095238095,>30,PAK,Home,Upto 2014
Abdur Rehman,PAK,Spin,2007-10-08,Lahore,Pakistan,2007,2,142,336,3,1,512,1276,13,370,940,10,39.38461538461539,>30,PAK,Home,Upto 2014
Abdur Rehman,PAK,Spin,2010-11-12,Dubai (DICS),UAE,2010,2,206,408,4,1,753,1614,13,547,1206,9,57.92307692307692,>30,UAE,Away,Upto 2014
Abdur Rehman,PAK,Spin,2010-11-20,Abu Dhabi,UAE,2010,2,231,432,5,1,553,1225,14,322,793,9,39.5,>30,UAE,Away,Upto 2014
Abdur Rehman,PAK,Spin,2011-01-07,Hamilton,New Zealand,2011,2,75,270,6,1,193,540,7,118,270,1,27.571428571428573,<=30,NZ,Away,Upto 2014
Abdur Rehman,PAK,Spin,2011-01-15,Wellington,New Zealand,2011,2,215,505,5,1,445,1147,12,230,642,7,37.083333333333336,>30,NZ,Away,Upto 2014
Abdur Rehman,PAK,Spin,2011-05-12,Providence,West Indies,2011,2,76,240,3,1,348,989,21,272,749,18,16.571428571428573,<=30,WI,Away,Upto 2014
Abdur Rehman,PAK,Spin,2011-05-20,Basseterre,West Indies,2011,2,120,321,6,1,530,1213,20,410,892,14,26.5,<=30,WI,Away,Upto 2014
Abdur Rehman,PAK,Spin,2011-10-26,Dubai (DICS),UAE,2011,2,105,300,4,1,466,1189,19,361,889,15,24.526315789473685,<=30,UAE,Away,Upto 2014
Abdur Rehman,PAK,Spin,2011-11-03,Sharjah,UAE,2011,2,141,342,1,1,589,1524,15,448,1182,14,39.266666666666666,>30,UAE,Away,Upto 2014
Abdur Rehman,PAK,Spin,2011-12-09,Chattogram,Bangladesh,2011,2,97,218,7,1,717,1447,18,620,1229,11,39.833333333333336,>30,BAN,Away,Upto 2014
Abdur Rehman,PAK,Spin,2011-12-17,Mirpur,Bangladesh,2011,2,117,276,4,1,690,1381,17,573,1105,13,40.588235294117645,>30,BAN,Away,Upto 2014
Abdur Rehman,PAK,Spin,2012-01-17,Dubai (DICS),UAE,2012,2,89,180,4,1,302,659,19,213,479,15,15.894736842105264,<=30,UAE,Away,Upto 2014
Abdur Rehman,PAK,Spin,2012-01-25,Abu Dhabi,UAE,2012,2,92,235,8,1,558,1443,31,466,1208,23,18.0,<=30,UAE,Away,Upto 2014
Abdur Rehman,PAK,Spin,2012-02-03,Dubai (DICS),UAE,2012,2,137,375,7,1,528,1381,25,391,1006,18,21.12,<=30,UAE,Away,Upto 2014
Abdur Rehman,PAK,Spin,2012-06-22,Galle,Sri Lanka,2012,2,151,288,1,1,621,1409,23,470,1121,22,27.0,<=30,SL,Away,Upto 2014
Abdur Rehman,PAK,Spin,2012-06-30,Colombo (SSC),Sri Lanka,2012,2,97,214,5,1,609,1048,13,512,834,8,46.84615384615385,>30,SL,Away,Upto 2014
Abdur Rehman,PAK,Spin,2013-09-03,Harare,Zimbabwe,2013,2,92,192,4,1,421,874,20,329,682,16,21.05,<=30,ZIM,Away,Upto 2014
Abdur Rehman,PAK,Spin,2013-09-10,Harare,Zimbabwe,2013,2,87,287,5,1,357,809,10,270,522,5,35.7,>30,ZIM,Away,Upto 2014
Abdur Rehman,PAK,Spin,2014-01-16,Sharjah,UAE,2014,2,157,498,5,1,637,1445,16,480,947,11,39.8125,>30,UAE,Away,After 1965
Abdur Rehman,PAK,Spin,2014-08-06,Galle,Sri Lanka,2014,1,123,234,1,1,717,1430,22,594,1196,21,32.59090909090909,>30,SL,Away,After 1965
Abdur Rehman,PAK,Spin,2014-08-14,Colombo (SSC),Sri Lanka,2014,2,150,327,3,1,617,1331,23,467,1004,20,26.82608695652174,<=30,SL,Away,After 1965
Abrar Ahmed,PAK,Spin,2022-12-09,Multan,Pakistan,2022,2,234,306,11,1,774,1107,26,540,801,15,29.76923076923077,<=30,PAK,Home,After 1965
Abrar Ahmed,PAK,Spin,2022-12-17,Karachi,Pakistan,2022,2,228,280,6,1,895,1264,27,667,984,21,33.148148148148145,>30,PAK,Home,After 1965
Abrar Ahmed,PAK,Spin,2022-12-26,Karachi,Pakistan,2022,2,228,425,6,1,1086,2053,24,858,1628,18,45.25,>30,PAK,Home,After 1965
Abrar Ahmed,PAK,Spin,2023-01-02,Karachi,Pakistan,2023,2,252,420,5,1,805,1350,21,553,930,16,38.333333333333336,>30,PAK,Home,After 1965
Abrar Ahmed,PAK,Spin,2023-07-16,Galle,Sri Lanka,2023,2,136,333,6,1,731,1336,25,595,1003,19,29.24,<=30,SL,Away,After 1965
Abrar Ahmed,PAK,Spin,2023-07-24,Colombo (SSC),Sri Lanka,2023,2,103,184,4,1,535,922,13,432,738,9,41.15384615384615,>30,SL,Away,After 1965
Abrar Ahmed,PAK,Spin,2024-08-30,Rawalpindi,Pakistan,2024,2,123,270,1,1,286,641,10,163,371,9,28.6,<=30,PAK,Home,After 1965
Abrar Ahmed,PAK,Spin,2024-10-07,Multan,Pakistan,2024,1,174,210,0,1,918,1193,16,744,983,16,57.375,>30,PAK,Home,After 1965
Abrar Ahmed,PAK,Spin,2025-01-17,Multan,Pakistan,2025,2,33,77,5,1,519,896,34,486,819,29,15.264705882352942,<=30,PAK,Home,After 1965
Abrar Ahmed,PAK,Spin,2025-01-25,Multan,Pakistan,2025,2,69,126,2,1,637,1154,37,568,1028,35,17.216216216216218,<=30,PAK,Home,After 1965
Abu Jayed,BAN,Pace,2018-07-04,North Sound,West Indies,2018,1,84,159,3,1,363,699,24,279,540,21,15.125,<=30,WI,Away,After 1965
Abu Jayed,BAN,Pace,2018-07-12,Kingston,West Indies,2018,2,59,156,4,1,360,661,22,301,505,18,16.363636363636363,<=30,WI,Away,After 1965
Abu Jayed,BAN,Pace,2018-11-03,Sylhet,Bangladesh,2018,2,93,168,1,1,201,456,7,108,288,6,28.714285714285715,<=30,BAN,Home,After 1965
Abu Jayed,BAN,Pace,2019-02-28,Hamilton,New Zealand,2019,1,103,180,0,1,1009,1490,23,906,1310,23,43.869565217391305,>30,NZ,Away,After 1965
Abu Jayed,BAN,Pace,2019-03-08,Wellington,New Zealand,2019,1,94,113,3,1,692,1031,24,598,918,21,28.833333333333332,<=30,NZ,Away,After 1965
Abu Jayed,BAN,Pace,2019-11-14,Indore,India,2019,1,108,150,4,1,430,819,19,322,669,15,22.63157894736842,<=30,IND,Away,After 1965
Abu Jayed,BAN,Pace,2019-11-22,Eden Gardens,India,2019,1,77,126,2,1,491,776,27,414,650,25,18.185185185185187,<=30,IND,Away,After 1965
Abu Jayed,BAN,Pace,2020-02-07,Rawalpindi,Pakistan,2020,1,86,174,3,1,527,1060,20,441,886,17,26.35,<=30,PAK,Away,After 1965
Abu Jayed,BAN,Pace,2020-02-22,Mirpur,Bangladesh,2020,2,75,168,4,1,385,792,7,310,624,3,55.0,>30,BAN,Home,After 1965
Abu Jayed,BAN,Pace,2021-02-11,Mirpur,Bangladesh,2021,2,130,228,6,1,347,599,12,217,371,6,28.916666666666668,<=30,BAN,Home,After 1965
Abu Jayed,BAN,Pace,2021-04-21,Pallekele,Sri Lanka,2021,1,76,114,0,1,611,1140,12,535,1026,12,50.916666666666664,>30,SL,Away,After 1965
Abu Jayed,BAN,Pace,2021-04-29,Pallekele,Sri Lanka,2021,1,69,132,0,1,391,680,8,322,548,8,48.875,>30,SL,Away,After 1965
Abu Jayed,BAN,Pace,2021-11-26,Chattogram,Bangladesh,2021,2,64,96,0,1,416,874,18,352,778,18,23.11111111111111,<=30,BAN,Home,After 1965
Abul Hasan,BAN,Pace,2012-11-21,Khulna,Bangladesh,2012,1,113,144,0,1,562,872,18,449,728,18,31.22222222222222,>30,BAN,Home,Upto 2014
Abul Hasan,BAN,Pace,2013-03-08,Galle,Sri Lanka,2013,2,157,222,1,1,420,696,6,263,474,5,70.0,>30,SL,Away,Upto 2014
Abul Hasan,BAN,Pace,2013-03-16,Colombo (RPS),Sri Lanka,2013,2,101,162,2,1,510,982,14,409,820,12,36.42857142857143,>30,SL,Away,Upto 2014
Afaq Hussain,PAK,Spin,1961-10-21,Lahore,Pakistan,1961,2,61,168,1,1,702,1631,18,641,1463,17,39.0,>30,PAK,Home,Upto 2014
Afaq Hussain,PAK,Spin,1964-12-04,Melbourne,Australia,1964,1,45,72,0,1,473,1030,6,428,958,6,78.83333333333333,>30,AUS,Away,Upto 2014
Aftab Ahmed,BAN,Pace,2004-12-17,Chattogram,Bangladesh,2004,1,14,24,0,1,505,785,14,491,761,14,36.07142857142857,>30,BAN,Home,Upto 2014
Aftab Ahmed,BAN,Pace,2005-05-26,Lord's,England,2005,1,45,48,0,1,522,823,21,477,775,21,24.857142857142858,<=30,ENG,Away,Upto 2014
Aftab Ahmed,BAN,Pace,2005-06-03,Chester-le-Street,England,2005,1,56,48,1,1,697,946,22,641,898,21,31.681818181818183,>30,ENG,Away,Upto 2014
Aftab Ahmed,BAN,Pace,2005-09-20,Colombo (PSS),Sri Lanka,2005,1,33,48,1,1,387,537,17,354,489,16,22.764705882352942,<=30,SL,Away,Upto 2014
Aftab Ahmed,BAN,Pace,2006-04-16,Chattogram,Bangladesh,2006,1,28,42,1,1,238,372,5,210,330,4,47.6,>30,BAN,Home,Upto 2014
Aftab Ahmed,BAN,Pace,2008-01-12,Wellington,New Zealand,2008,1,31,74,2,1,450,866,22,419,792,20,20.454545454545453,<=30,NZ,Away,Upto 2014
Aftab Ahmed,BAN,Pace,2008-02-29,Chattogram,Bangladesh,2008,1,18,30,0,1,376,687,12,358,657,12,31.333333333333332,>30,BAN,Home,Upto 2014
Aftab Ahmed,BAN,Pace,2010-02-15,Hamilton,New Zealand,2010,1,10,24,0,1,762,1104,17,752,1080,17,44.8235294117647,>30,NZ,Away,Upto 2014
Aftab Ahmed,BAN,Pace,2010-03-12,Chattogram,Bangladesh,2010,1,2,6,0,1,497,924,10,495,918,10,49.7,>30,BAN,Home,Upto 2014
Aftab Baloch,PAK,Spin,1969-11-08,Dhaka,Bangladesh,1969,1,2,12,0,1,498,1577,22,496,1565,22,22.636363636363637,<=30,BAN,Away,Upto 2014
Aftab Baloch,PAK,Spin,1975-02-15,Lahore,Pakistan,1975,1,15,32,0,1,210,572,5,195,540,5,42.0,>30,PAK,Home,Upto 2014
Aftab Gul,PAK,Spin,1971-06-17,Lord's,England,1971,1,4,6,0,1,197,492,2,193,486,2,98.5,>30,ENG,Away,Upto 2014
Agha Salman,PAK,Spin,2022-07-16,Galle,Sri Lanka,2022,1,53,96,0,1,840,1795,26,787,1699,26,32.30769230769231,>30,SL,Away,After 1965
Agha Salman,PAK,Spin,2022-07-24,Galle,Sri Lanka,2022,2,66,108,1,1,907,1657,29,841,1549,28,31.275862068965516,>30,SL,Away,After 1965
Agha Salman,PAK,Spin,2022-12-01,Rawalpindi,Pakistan,2022,2,85,60,1,1,949,1152,16,864,1092,15,59.3125,>30,PAK,Home,After 1965
Agha Salman,PAK,Spin,2022-12-09,Multan,Pakistan,2022,1,5,6,0,1,774,1107,26,769,1101,26,29.76923076923077,<=30,PAK,Home,After 1965
Agha Salman,PAK,Spin,2022-12-17,Karachi,Pakistan,2022,1,5,6,0,1,895,1264,27,890,1258,27,33.148148148148145,>30,PAK,Home,After 1965
Agha Salman,PAK,Spin,2022-12-26,Karachi,Pakistan,2022,1,14,12,0,1,1086,2053,24,1072,2041,24,45.25,>30,PAK,Home,After 1965
Agha Salman,PAK,Spin,2023-01-02,Karachi,Pakistan,2023,2,117,240,4,1,805,1350,21,688,1110,17,38.333333333333336,>30,PAK,Home,After 1965
Agha Salman,PAK,Spin,2023-07-16,Galle,Sri Lanka,2023,2,57,84,3,1,731,1336,25,674,1252,22,29.24,<=30,SL,Away,After 1965
Agha Salman,PAK,Spin,2023-07-24,Colombo (SSC),Sri Lanka,2023,1,6,30,0,1,535,922,13,529,892,13,41.15384615384615,>30,SL,Away,After 1965
Agha Salman,PAK,Spin,2023-12-14,Perth,Australia,2023,2,122,240,0,1,206,443,6,84,203,6,34.333333333333336,>30,AUS,Away,After 1965
Agha Salman,PAK,Spin,2023-12-26,Melbourne,Australia,2023,2,38,66,1,1,195,293,5,157,227,4,39.0,>30,AUS,Away,After 1965
Agha Salman,PAK,Spin,2024-01-03,Sydney,Australia,2024,2,71,150,2,1,332,638,10,261,488,8,33.2,>30,AUS,Away,After 1965
Agha Salman,PAK,Spin,2024-08-21,Rawalpindi,Pakistan,2024,2,145,255,0,1,433,770,10,288,515,10,43.3,>30,PAK,Home,After 1965
Agha Salman,PAK,Spin,2024-08-30,Rawalpindi,Pakistan,2024,2,30,46,3,1,286,641,10,256,595,7,28.6,<=30,PAK,Home,After 1965
Agha Salman,PAK,Spin,2024-10-07,Multan,Pakistan,2024,1,118,108,1,1,918,1193,16,800,1085,15,57.375,>30,PAK,Home,After 1965
Agha Salman,PAK,Spin,2024-10-15,Multan,Pakistan,2024,1,5,6,0,1,831,1418,37,826,1412,37,22.45945945945946,<=30,PAK,Home,After 1965
Agha Salman,PAK,Spin,2024-10-24,Rawalpindi,Pakistan,2024,1,3,6,0,1,719,1161,29,716,1155,29,24.79310344827586,<=30,PAK,Home,After 1965
Agha Salman,PAK,Spin,2025-01-03,Cape Town,South Africa,2025,2,173,246,3,1,445,729,11,272,483,8,40.45454545454545,>30,SA,Away,After 1965
Agha Salman,PAK,Spin,2025-01-25,Multan,Pakistan,2025,1,10,12,0,1,637,1154,37,627,1142,37,17.216216216216218,<=30,PAK,Home,After 1965
Ahmed Shehzad,PAK,Spin,2014-08-06,Galle,Sri Lanka,2014,1,20,30,0,1,717,1430,22,697,1400,22,32.59090909090909,>30,SL,Away,After 1965
Ahmed Shehzad,PAK,Spin,2014-08-14,Colombo (SSC),Sri Lanka,2014,1,8,18,0,1,617,1331,23,609,1313,23,26.82608695652174,<=30,SL,Away,After 1965
Aizaz Cheema,PAK,Pace,2011-09-01,Bulawayo,Zimbabwe,2011,2,103,241,8,1,539,1117,15,436,876,7,35.93333333333333,>30,ZIM,Away,Upto 2014
Aizaz Cheema,PAK,Pace,2011-10-18,Abu Dhabi,UAE,2011,2,159,282,2,1,689,1303,17,530,1021,15,40.529411764705884,>30,UAE,Away,Upto 2014
Aizaz Cheema,PAK,Pace,2011-12-09,Chattogram,Bangladesh,2011,2,75,111,4,1,250,417,6,175,306,2,41.666666666666664,>30,BAN,Away,Upto 2014
Aizaz Cheema,PAK,Pace,2011-12-17,Mirpur,Bangladesh,2011,2,134,246,5,1,436,810,14,302,564,9,31.142857142857142,>30,BAN,Away,Upto 2014
Aizaz Cheema,PAK,Pace,2012-01-17,Dubai (DICS),UAE,2012,2,52,116,1,1,389,864,11,337,748,10,35.36363636363637,>30,UAE,Away,Upto 2014
Aizaz Cheema,PAK,Pace,2012-02-03,Dubai (DICS),UAE,2012,2,18,48,0,1,298,715,15,280,667,15,19.866666666666667,<=30,UAE,Away,Upto 2014
Aizaz Cheema,PAK,Pace,2012-06-30,Colombo (SSC),Sri Lanka,2012,2,97,156,0,1,504,822,6,407,666,6,84.0,>30,SL,Away,Upto 2014
Akash Deep,IND,Pace,2024-02-23,Ranchi,India,2024,1,83,114,3,1,291,444,7,208,330,4,41.57142857142857,>30,IND,Home,After 1965
Akash Deep,IND,Pace,2024-09-19,Chennai,India,2024,2,39,66,2,1,481,825,20,442,759,18,24.05,<=30,IND,Home,After 1965
Akash Deep,IND,Pace,2024-09-27,Kanpur,India,2024,2,63,138,3,1,315,492,12,252,354,9,26.25,<=30,IND,Home,After 1965
Akash Deep,IND,Pace,2024-10-24,Pune,India,2024,1,41,36,0,1,141,192,1,100,156,1,141.0,>30,IND,Home,After 1965
Akash Deep,IND,Pace,2024-11-01,Wankhede,India,2024,2,32,60,2,1,89,174,4,57,114,2,22.25,<=30,IND,Home,After 1965
Akash Deep,IND,Pace,2024-12-14,Brisbane,Australia,2024,2,123,209,3,1,550,932,24,427,723,21,22.916666666666668,<=30,AUS,Away,After 1965
Akash Deep,IND,Pace,2024-12-26,Melbourne,Australia,2024,2,147,258,2,1,849,1700,27,702,1442,25,31.444444444444443,>30,AUS,Away,After 1965
Akram Raza,PAK,Spin,1989-12-01,Lahore,Pakistan,1989,1,58,108,0,1,665,1174,7,607,1066,7,95.0,>30,PAK,Home,Upto 2014
Akram Raza,PAK,Spin,1990-11-23,Faisalabad,Pakistan,1990,2,89,158,2,1,109,218,2,20,60,0,54.5,>30,PAK,Home,Upto 2014
Akram Raza,PAK,Spin,1991-12-12,Sialkot,Pakistan,1991,2,71,210,3,1,197,606,6,126,396,3,32.833333333333336,>30,PAK,Home,Upto 2014
Akram Raza,PAK,Spin,1994-02-17,Wellington,New Zealand,1994,2,32,108,0,1,228,416,2,196,308,2,114.0,>30,NZ,Away,Upto 2014
Akram Raza,PAK,Spin,1994-02-24,Christchurch,New Zealand,1994,1,49,114,0,1,187,378,5,138,264,5,37.4,>30,NZ,Away,Upto 2014
Akram Raza,PAK,Spin,1994-08-09,Colombo (PSS),Sri Lanka,1994,2,129,210,6,1,791,1520,23,662,1310,17,34.391304347826086,>30,SL,Away,Upto 2014
Akram Raza,PAK,Spin,1994-09-28,Karachi,Pakistan,1994,2,69,144,0,1,538,1117,15,469,973,15,35.86666666666667,>30,PAK,Home,Upto 2014
Akram Raza,PAK,Spin,1994-11-01,Lahore,Pakistan,1994,1,123,270,2,1,660,1368,20,537,1098,18,33.0,>30,PAK,Home,Upto 2014
Akram Raza,PAK,Spin,1995-01-31,Harare,Zimbabwe,1995,1,112,204,0,1,301,564,1,189,360,1,301.0,>30,ZIM,Away,Upto 2014
Al-Amin Hossain,BAN,Pace,2013-10-21,Mirpur,Bangladesh,2013,1,58,96,1,1,508,858,10,450,762,9,50.8,>30,BAN,Home,Upto 2014
Al-Amin Hossain,BAN,Pace,2014-01-27,Mirpur,Bangladesh,2014,1,118,192,1,1,519,875,13,401,683,12,39.92307692307692,>30,BAN,Home,After 1965
Al-Amin Hossain,BAN,Pace,2014-02-04,Chattogram,Bangladesh,2014,2,112,192,1,1,379,646,2,267,454,1,189.5,>30,BAN,Home,After 1965
Al-Amin Hossain,BAN,Pace,2014-09-05,Kingstown,West Indies,2014,2,52,142,0,1,442,907,11,390,765,11,40.18181818181818,>30,WI,Away,After 1965
Al-Amin Hossain,BAN,Pace,2014-09-13,Gros Islet,West Indies,2014,2,98,210,3,1,563,1240,21,465,1030,18,26.80952380952381,<=30,WI,Away,After 1965
Al-Amin Hossain,BAN,Pace,2014-10-25,Mirpur,Bangladesh,2014,1,22,48,0,1,227,561,12,205,513,12,18.916666666666668,<=30,BAN,Home,After 1965
Al-Amin Hossain,BAN,Pace,2019-11-22,Eden Gardens,India,2019,1,85,136,3,1,491,776,27,406,640,24,18.185185185185187,<=30,IND,Away,After 1965
Alamgir Kabir,BAN,Pace,2002-07-21,Colombo (PSS),Sri Lanka,2002,1,82,90,0,1,532,738,12,450,648,12,44.333333333333336,>30,SL,Away,Upto 2014
Alamgir Kabir,BAN,Pace,2003-08-27,Peshawar,Pakistan,2003,2,100,123,0,1,501,1075,20,401,952,20,25.05,<=30,PAK,Away,Upto 2014
Alamgir Kabir,BAN,Pace,2004-02-26,Bulawayo,Zimbabwe,2004,1,39,48,0,1,218,510,6,179,462,6,36.333333333333336,>30,ZIM,Away,Upto 2014
Ali Hussain Rizvi,PAK,Spin,1997-10-17,Sheikhupura,Pakistan,1997,1,72,111,2,1,314,555,8,242,444,6,39.25,>30,PAK,Home,Upto 2014
Ali Naqvi,PAK,Spin,1998-03-14,Bulawayo,Zimbabwe,1998,1,11,12,0,1,364,712,5,353,700,5,72.8,>30,ZIM,Away,Upto 2014
Alimuddin,PAK,Spin,1955-01-01,Dhaka,Bangladesh,1955,1,12,30,0,1,438,1378,15,426,1348,15,29.2,<=30,BAN,Away,Upto 2014
Alimuddin,PAK,Spin,1955-01-29,Lahore,Pakistan,1955,1,12,18,0,1,591,2024,18,579,2006,18,32.833333333333336,>30,PAK,Home,Upto 2014
Alimuddin,PAK,Spin,1958-01-17,Bridgetown,West Indies,1958,1,17,12,1,1,679,1898,11,662,1886,10,61.72727272727273,>30,WI,Away,Upto 2014
Alimuddin,PAK,Spin,1958-02-26,Kingston,West Indies,1958,1,34,24,0,1,450,846,3,416,822,3,150.0,>30,WI,Away,Upto 2014
Alok Kapali,BAN,Spin,2002-07-28,Colombo (SSC),Sri Lanka,2002,2,176,240,2,1,450,838,15,274,598,13,30.0,<=30,SL,Away,Upto 2014
Alok Kapali,BAN,Spin,2002-10-18,East London,South Africa,2002,1,72,108,0,1,247,486,3,175,378,3,82.33333333333333,>30,SA,Away,Upto 2014
Alok Kapali,BAN,Spin,2002-10-25,Potchefstroom,South Africa,2002,1,75,120,0,1,189,281,2,114,161,2,94.5,>30,SA,Away,Upto 2014
Alok Kapali,BAN,Spin,2002-12-16,Chattogram,Bangladesh,2002,1,4,3,0,1,127,195,2,123,192,2,63.5,>30,BAN,Home,Upto 2014
Alok Kapali,BAN,Spin,2003-04-24,Chattogram,Bangladesh,2003,1,71,113,0,1,336,618,11,265,505,11,30.545454545454547,>30,BAN,Home,Upto 2014
Alok Kapali,BAN,Spin,2003-05-01,Dhaka,Bangladesh,2003,1,33,66,0,1,312,727,15,279,661,15,20.8,<=30,BAN,Home,Upto 2014
Alok Kapali,BAN,Spin,2003-07-18,Darwin,Australia,2003,1,65,108,1,1,161,283,8,96,175,7,20.125,<=30,AUS,Away,Upto 2014
Alok Kapali,BAN,Spin,2003-07-25,Cairns,Australia,2003,1,69,86,0,1,356,572,12,287,486,12,29.666666666666668,<=30,AUS,Away,Upto 2014
Alok Kapali,BAN,Spin,2003-08-20,Karachi,Pakistan,2003,2,60,120,0,1,435,1074,13,375,954,13,33.46153846153846,>30,PAK,Away,Upto 2014
Alok Kapali,BAN,Spin,2003-08-27,Peshawar,Pakistan,2003,2,33,49,3,1,404,889,11,371,840,8,36.72727272727273,>30,PAK,Away,Upto 2014
Alok Kapali,BAN,Spin,2003-10-21,Dhaka,Bangladesh,2003,1,4,18,0,1,443,953,10,439,935,10,44.3,>30,BAN,Home,Upto 2014
Alok Kapali,BAN,Spin,2003-10-29,Chattogram,Bangladesh,2003,1,12,24,0,1,331,702,7,319,678,7,47.285714285714285,>30,BAN,Home,Upto 2014
Alok Kapali,BAN,Spin,2004-10-19,Dhaka,Bangladesh,2004,1,6,12,0,1,383,1134,20,377,1122,20,19.15,<=30,BAN,Home,Upto 2014
Alok Kapali,BAN,Spin,2004-10-26,Chattogram,Bangladesh,2004,1,17,18,0,1,719,1390,23,702,1372,23,31.26086956521739,>30,BAN,Home,Upto 2014
Alok Kapali,BAN,Spin,2006-02-28,Chattogram,Bangladesh,2006,2,12,18,0,1,666,1170,22,654,1152,22,30.272727272727273,>30,BAN,Home,Upto 2014
Aminul Islam,BAN,Spin,2001-08-29,Multan,Pakistan,2001,1,17,24,0,1,304,445,14,287,421,14,21.714285714285715,<=30,PAK,Away,Upto 2014
Aminul Islam,BAN,Spin,2001-11-08,Dhaka,Bangladesh,2001,1,2,6,0,1,256,612,4,254,606,4,64.0,>30,BAN,Home,Upto 2014
Aminul Islam,BAN,Spin,2001-11-15,Chattogram,Bangladesh,2001,1,66,102,1,1,538,1183,18,472,1081,17,29.88888888888889,<=30,BAN,Home,Upto 2014
Aminul Islam,BAN,Spin,2001-12-26,Wellington,New Zealand,2001,1,37,42,0,1,143,312,4,106,270,4,35.75,>30,NZ,Away,Upto 2014
Aminul Islam,BAN,Spin,2002-01-16,Chattogram,Bangladesh,2002,1,27,24,0,1,412,718,14,385,694,14,29.428571428571427,<=30,BAN,Home,Upto 2014
Amir Elahi,PAK,Spin,1952-10-16,Delhi,India,1952,1,134,238,4,1,404,1143,24,270,905,20,16.833333333333332,<=30,IND,Away,Upto 2014
Amir Elahi,PAK,Spin,1952-10-23,Lucknow,India,1952,1,20,42,2,1,185,666,5,165,624,3,37.0,>30,IND,Away,Upto 2014
Amir Elahi,PAK,Spin,1952-11-13,Brabourne,India,1952,1,65,84,0,1,433,1202,15,368,1118,15,28.866666666666667,<=30,IND,Away,Upto 2014
Amir Elahi,PAK,Spin,1952-12-12,Eden Gardens,India,1952,1,29,36,1,1,455,1230,13,426,1194,12,35.0,>30,IND,Away,Upto 2014
Amir Hamza,AFG,Spin,2019-11-27,Lucknow,India,2019,2,79,185,6,1,473,932,25,394,747,19,18.92,<=30,IND,Away,After 1965
Amir Hamza,AFG,Spin,2021-03-02,Abu Dhabi,UAE,2021,2,86,162,6,1,274,533,12,188,371,6,22.833333333333332,<=30,UAE,Away,After 1965
Amir Hamza,AFG,Spin,2021-03-10,Abu Dhabi,UAE,2021,2,177,396,4,1,842,1766,20,665,1370,16,42.1,>30,UAE,Away,After 1965
Amir Hamza,AFG,Spin,2023-06-14,Mirpur,Bangladesh,2023,2,175,241,2,1,497,697,11,322,456,9,45.18181818181818,>30,BAN,Away,After 1965
Anwar Hossain Monir,BAN,Pace,2003-07-25,Cairns,Australia,2003,1,95,126,0,1,637,1169,12,542,1043,12,53.083333333333336,>30,AUS,Away,Upto 2014
Anwar Hossain Monir,BAN,Pace,2005-05-26,Lord's,England,2005,1,110,132,0,1,522,823,21,412,691,21,24.857142857142858,<=30,ENG,Away,Upto 2014
Anwar Hossain Monir,BAN,Pace,2005-06-03,Chester-le-Street,England,2005,1,102,90,0,1,697,946,22,595,856,22,31.681818181818183,>30,ENG,Away,Upto 2014
Anwar Hussain,PAK,Pace,1952-12-12,Eden Gardens,India,1952,2,29,36,1,1,409,1086,14,380,1050,13,29.214285714285715,<=30,IND,Away,Upto 2014
Anwar Khan,PAK,Pace,1979-02-02,Christchurch,New Zealand,1979,1,12,32,0,1,652,1680,19,640,1648,19,34.31578947368421,>30,NZ,Away,Upto 2014
Arif Butt,PAK,Pace,1964-12-04,Melbourne,Australia,1964,2,118,216,7,1,621,1276,24,503,1060,17,25.875,<=30,AUS,Away,Upto 2014
Arif Butt,PAK,Pace,1965-01-22,Wellington,New Zealand,1965,2,108,308,6,1,362,972,24,254,664,18,15.083333333333334,<=30,NZ,Away,Upto 2014
Arif Butt,PAK,Pace,1965-01-29,Auckland,New Zealand,1965,2,62,142,1,1,296,863,12,234,721,11,24.666666666666668,<=30,NZ,Away,Upto 2014
Ariful Haque,BAN,Pace,2018-11-03,Sylhet,Bangladesh,2018,1,7,24,0,1,201,456,7,194,432,7,28.714285714285715,<=30,BAN,Home,After 1965
Ariful Haque,BAN,Pace,2018-11-11,Mirpur,Bangladesh,2018,2,17,42,1,1,422,1002,13,405,960,12,32.46153846153846,>30,BAN,Home,After 1965
Arshad Ayub,IND,Spin,1987-11-25,Delhi,India,1987,2,86,204,5,1,217,492,5,131,288,0,43.4,>30,IND,Home,Upto 2014
Arshad Ayub,IND,Spin,1987-12-11,Wankhede,India,1987,1,54,120,0,1,252,507,7,198,387,7,36.0,>30,IND,Home,Upto 2014
Arshad Ayub,IND,Spin,1987-12-26,Eden Gardens,India,1987,2,180,360,0,1,615,1451,5,435,1091,5,123.0,>30,IND,Home,Upto 2014
Arshad Ayub,IND,Spin,1988-01-11,Chennai,India,1988,2,80,252,1,1,536,1127,23,456,875,22,23.304347826086957,<=30,IND,Home,Upto 2014
Arshad Ayub,IND,Spin,1988-11-12,Bengaluru,India,1988,2,104,502,8,1,620,1702,21,516,1200,13,29.523809523809526,<=30,IND,Home,Upto 2014
Arshad Ayub,IND,Spin,1988-11-24,Wankhede,India,1988,2,92,348,6,1,479,1162,25,387,814,19,19.16,<=30,IND,Home,Upto 2014
Arshad Ayub,IND,Spin,1988-12-02,Hyderabad (Deccan),India,1988,2,91,330,7,1,319,748,13,228,418,6,24.53846153846154,<=30,IND,Home,Upto 2014
Arshad Ayub,IND,Spin,1989-03-25,Georgetown,West Indies,1989,1,104,186,5,1,322,618,6,218,432,1,53.666666666666664,>30,WI,Away,Upto 2014
Arshad Ayub,IND,Spin,1989-04-07,Bridgetown,West Indies,1989,2,81,186,2,1,380,726,8,299,540,6,47.5,>30,WI,Away,Upto 2014
Arshad Ayub,IND,Spin,1989-04-15,Port of Spain,West Indies,1989,2,167,420,5,1,406,1089,11,239,669,6,36.90909090909091,>30,WI,Away,Upto 2014
Arshad Ayub,IND,Spin,1989-04-28,Kingston,West Indies,1989,1,99,239,2,1,262,519,4,163,280,2,65.5,>30,WI,Away,Upto 2014
Arshad Ayub,IND,Spin,1989-11-15,Karachi,Pakistan,1989,2,118,222,0,1,349,576,2,231,354,2,174.5,>30,PAK,Away,Upto 2014
Arshad Ayub,IND,Spin,1989-12-01,Lahore,Pakistan,1989,1,182,294,0,1,665,1174,7,483,880,7,95.0,>30,PAK,Away,Upto 2014
Arshad Khan,PAK,Spin,1997-11-17,Peshawar,Pakistan,1997,2,32,60,0,1,271,573,12,239,513,12,22.583333333333332,<=30,PAK,Home,Upto 2014
Arshad Khan,PAK,Spin,1998-10-22,Karachi,Pakistan,1998,2,213,582,5,1,832,1892,24,619,1310,19,34.666666666666664,>30,PAK,Home,Upto 2014
Arshad Khan,PAK,Spin,1999-03-12,Dhaka,Bangladesh,1999,2,79,192,6,1,550,1176,20,471,984,14,27.5,<=30,BAN,Away,Upto 2014
Arshad Khan,PAK,Spin,2000-03-05,Peshawar,Pakistan,2000,2,151,390,4,1,411,991,20,260,601,16,20.55,<=30,PAK,Home,Upto 2014
Arshad Khan,PAK,Spin,2000-06-14,Colombo (SSC),Sri Lanka,2000,2,92,318,7,1,317,840,16,225,522,9,19.8125,<=30,SL,Away,Upto 2014
Arshad Khan,PAK,Spin,2000-06-21,Galle,Sri Lanka,2000,2,88,204,2,1,434,852,7,346,648,5,62.0,>30,SL,Away,Upto 2014
Arshad Khan,PAK,Spin,2000-06-28,Kandy,Sri Lanka,2000,1,137,312,3,1,245,468,3,108,156,0,81.66666666666667,>30,SL,Away,Upto 2014
Arshad Khan,PAK,Spin,2000-11-29,Faisalabad,Pakistan,2000,2,60,228,3,1,641,1582,20,581,1354,17,32.05,>30,PAK,Home,Upto 2014
Arshad Khan,PAK,Spin,2005-03-24,Bengaluru,India,2005,2,108,252,2,1,834,1659,22,726,1407,20,37.90909090909091,>30,IND,Away,Upto 2014
Asad Shafiq,PAK,Spin,2015-04-28,Khulna,Bangladesh,2015,1,32,42,1,1,1092,1798,20,1060,1756,19,54.6,>30,BAN,Away,After 1965
Asad Shafiq,PAK,Spin,2015-10-13,Abu Dhabi,UAE,2015,1,19,42,0,1,740,1307,14,721,1265,14,52.857142857142854,>30,UAE,Away,After 1965
Asad Shafiq,PAK,Spin,2016-10-21,Abu Dhabi,UAE,2016,1,2,6,0,1,703,1324,15,701,1318,15,46.86666666666667,>30,UAE,Away,After 1965
Asad Shafiq,PAK,Spin,2016-11-25,Hamilton,New Zealand,2016,1,4,6,0,1,91,174,2,87,168,2,45.5,>30,NZ,Away,After 1965
Asad Shafiq,PAK,Spin,2017-01-03,Sydney,Australia,2017,1,12,12,0,1,736,1038,13,724,1026,13,56.61538461538461,>30,AUS,Away,After 1965
Asad Shafiq,PAK,Spin,2017-05-10,Roseau,West Indies,2017,1,15,12,0,1,500,993,18,485,981,18,27.77777777777778,<=30,WI,Away,After 1965
Asad Shafiq,PAK,Spin,2017-09-28,Abu Dhabi,UAE,2017,2,18,40,1,1,623,1568,26,605,1528,25,23.96153846153846,<=30,UAE,Away,After 1965
Asad Shafiq,PAK,Spin,2017-10-06,Dubai (DICS),UAE,2017,1,24,66,0,1,608,1153,24,584,1087,24,25.333333333333332,<=30,UAE,Away,After 1965
Asad Shafiq,PAK,Spin,2018-10-07,Dubai (DICS),UAE,2018,1,1,6,0,1,793,1735,21,792,1729,21,37.76190476190476,>30,UAE,Away,After 1965
Asad Shafiq,PAK,Spin,2019-01-03,Cape Town,South Africa,2019,1,16,24,0,1,103,155,0,87,131,0,inf,>30,SA,Away,After 1965
Asad Shafiq,PAK,Spin,2019-01-11,Johannesburg,South Africa,2019,1,9,12,0,1,90,145,4,81,133,4,22.5,<=30,SA,Away,After 1965
Asad Shafiq,PAK,Spin,2019-12-11,Rawalpindi,Pakistan,2019,1,8,12,0,1,170,252,0,162,240,0,inf,>30,PAK,Home,After 1965
Asad Shafiq,PAK,Spin,2020-02-07,Rawalpindi,Pakistan,2020,1,12,18,0,1,309,548,8,297,530,8,38.625,>30,PAK,Home,After 1965
Asad Shafiq,PAK,Spin,2020-08-21,Southampton,England,2020,1,24,42,1,1,389,624,7,365,582,6,55.57142857142857,>30,ENG,Away,After 1965
Asghar Afghan,AFG,Pace,2018-06-14,Bengaluru,India,2018,1,16,12,0,1,280,456,13,264,444,13,21.53846153846154,<=30,IND,Away,After 1965
Asghar Afghan,AFG,Pace,2021-03-10,Abu Dhabi,UAE,2021,1,1,6,0,1,415,797,6,414,791,6,69.16666666666667,>30,UAE,Away,After 1965
Ashfaq Ahmed,PAK,Pace,1993-12-09,Rawalpindi,Pakistan,1993,2,53,138,2,1,816,1939,40,763,1801,38,20.4,<=30,PAK,Home,Upto 2014
Asif Iqbal,PAK,Pace,1964-10-24,Karachi,Pakistan,1964,2,96,215,2,1,349,725,11,253,510,9,31.727272727272727,>30,PAK,Home,Upto 2014
Asif Iqbal,PAK,Pace,1964-12-04,Melbourne,Australia,1964,2,115,168,2,1,621,1276,24,506,1108,22,25.875,<=30,AUS,Away,Upto 2014
Asif Iqbal,PAK,Pace,1965-01-22,Wellington,New Zealand,1965,2,81,274,6,1,362,972,24,281,698,18,15.083333333333334,<=30,NZ,Away,Upto 2014
Asif Iqbal,PAK,Pace,1965-01-29,Auckland,New Zealand,1965,2,92,270,6,1,296,863,12,204,593,6,24.666666666666668,<=30,NZ,Away,Upto 2014
Asif Iqbal,PAK,Pace,1965-02-12,Christchurch,New Zealand,1965,2,75,251,6,1,416,1052,17,341,801,11,24.470588235294116,<=30,NZ,Away,Upto 2014
Asif Iqbal,PAK,Pace,1965-03-27,Rawalpindi,Pakistan,1965,2,11,48,1,1,167,432,11,156,384,10,15.181818181818182,<=30,PAK,Home,Upto 2014
Asif Iqbal,PAK,Pace,1965-04-02,Lahore,Pakistan,1965,1,85,198,1,1,328,882,6,243,684,5,54.666666666666664,>30,PAK,Home,Upto 2014
Asif Iqbal,PAK,Pace,1965-04-09,Karachi,Pakistan,1965,2,64,150,4,1,333,774,10,269,624,6,33.3,>30,PAK,Home,Upto 2014
Asif Iqbal,PAK,Pace,1967-07-27,Lord's,England,1967,2,126,294,4,1,434,1150,13,308,856,9,33.38461538461539,>30,ENG,Away,Upto 2014
Asif Iqbal,PAK,Pace,1967-08-10,Nottingham,England,1967,1,72,234,2,1,254,846,14,182,612,12,18.142857142857142,<=30,ENG,Away,Upto 2014
Asif Iqbal,PAK,Pace,1967-08-24,The Oval,England,1967,2,80,276,5,1,449,1200,19,369,924,14,23.63157894736842,<=30,ENG,Away,Upto 2014
Asif Iqbal,PAK,Pace,1969-02-21,Lahore,Pakistan,1969,1,11,24,0,1,347,758,16,336,734,16,21.6875,<=30,PAK,Home,Upto 2014
Asif Iqbal,PAK,Pace,1969-02-28,Dhaka,Bangladesh,1969,1,2,24,0,1,300,937,11,298,913,11,27.272727272727273,<=30,BAN,Away,Upto 2014
Asif Iqbal,PAK,Pace,1969-10-24,Karachi,Pakistan,1969,2,14,30,0,1,167,468,6,153,438,6,27.833333333333332,<=30,PAK,Home,Upto 2014
Asif Iqbal,PAK,Pace,1969-10-30,Lahore,Pakistan,1969,2,8,36,0,1,161,587,12,153,551,12,13.416666666666666,<=30,PAK,Home,Upto 2014
Asif Iqbal,PAK,Pace,1969-11-08,Dhaka,Bangladesh,1969,2,30,120,1,1,262,729,8,232,609,7,32.75,>30,BAN,Away,Upto 2014
Asif Iqbal,PAK,Pace,1971-06-03,Birmingham,England,1971,1,36,120,1,1,653,1403,13,617,1283,12,50.23076923076923,>30,ENG,Away,Upto 2014
Asif Iqbal,PAK,Pace,1971-06-17,Lord's,England,1971,2,35,102,0,1,276,712,9,241,610,9,30.666666666666668,>30,ENG,Away,Upto 2014
Asif Iqbal,PAK,Pace,1971-07-08,Leeds,England,1971,1,37,78,3,1,442,1309,24,405,1231,21,18.416666666666668,<=30,ENG,Away,Upto 2014
Asif Iqbal,PAK,Pace,1972-12-22,Adelaide,Australia,1972,1,76,112,0,1,517,1131,14,441,1019,14,36.92857142857143,>30,AUS,Away,Upto 2014
Asif Iqbal,PAK,Pace,1973-01-06,Sydney,Australia,1973,2,21,32,1,1,767,1875,36,746,1843,35,21.305555555555557,<=30,AUS,Away,Upto 2014
Asif Iqbal,PAK,Pace,1973-02-02,Wellington,New Zealand,1973,1,6,16,0,1,687,1320,19,681,1304,19,36.1578947368421,>30,NZ,Away,Upto 2014
Asif Iqbal,PAK,Pace,1973-03-16,Hyderabad (Sind),Pakistan,1973,2,34,72,1,1,221,462,4,187,390,3,55.25,>30,PAK,Home,Upto 2014
Asif Iqbal,PAK,Pace,1974-07-25,Leeds,England,1974,2,21,66,1,1,703,1746,31,682,1680,30,22.677419354838708,<=30,ENG,Away,Upto 2014
Asif Iqbal,PAK,Pace,1974-08-08,Lord's,England,1974,1,13,30,0,1,356,858,8,343,828,8,44.5,>30,ENG,Away,Upto 2014
Asif Iqbal,PAK,Pace,1975-02-15,Lahore,Pakistan,1975,1,16,16,0,1,757,1707,25,741,1691,25,30.28,>30,PAK,Home,Upto 2014
Asif Iqbal,PAK,Pace,1976-10-09,Lahore,Pakistan,1976,1,10,16,0,1,496,904,17,486,888,17,29.176470588235293,<=30,PAK,Home,Upto 2014
Asif Iqbal,PAK,Pace,1977-01-01,Melbourne,Australia,1977,1,52,128,3,1,882,1510,22,830,1382,19,40.09090909090909,>30,AUS,Away,Upto 2014
Asif Iqbal,PAK,Pace,1977-01-14,Sydney,Australia,1977,1,53,120,0,1,681,1364,30,628,1244,30,22.7,<=30,AUS,Away,Upto 2014
Asif Iqbal,PAK,Pace,1977-02-18,Bridgetown,West Indies,1977,1,8,6,0,1,1045,1954,34,1037,1948,34,30.735294117647058,>30,WI,Away,Upto 2014
Asif Iqbal,PAK,Pace,1977-03-18,Georgetown,West Indies,1977,1,15,24,0,1,1085,2006,25,1070,1982,25,43.4,>30,WI,Away,Upto 2014
Asif Iqbal,PAK,Pace,1977-04-15,Kingston,West Indies,1977,1,6,24,0,1,849,1372,30,843,1348,30,28.3,<=30,WI,Away,Upto 2014
Asif Iqbal,PAK,Pace,1979-02-23,Auckland,New Zealand,1979,2,29,72,1,1,754,1863,27,725,1791,26,27.925925925925927,<=30,NZ,Away,Upto 2014
Asif Iqbal,PAK,Pace,1979-12-04,Delhi,India,1979,2,49,158,2,1,647,1401,30,598,1243,28,21.566666666666666,<=30,IND,Away,Upto 2014
Asif Iqbal,PAK,Pace,1979-12-16,Wankhede,India,1979,1,1,12,0,1,330,772,18,329,760,18,18.333333333333332,<=30,IND,Away,Upto 2014
Asif Iqbal,PAK,Pace,1979-12-25,Kanpur,India,1979,1,22,48,0,1,450,1133,20,428,1085,20,22.5,<=30,IND,Away,Upto 2014
Asif Masood,PAK,Pace,1969-02-21,Lahore,Pakistan,1969,2,127,276,4,1,347,758,16,220,482,12,21.6875,<=30,PAK,Home,Upto 2014
Asif Masood,PAK,Pace,1969-03-06,Karachi,Pakistan,1969,1,94,168,2,1,172,372,2,78,204,0,86.0,>30,PAK,Home,Upto 2014
Asif Masood,PAK,Pace,1969-10-24,Karachi,Pakistan,1969,2,25,30,0,1,167,468,6,142,438,6,27.833333333333332,<=30,PAK,Home,Upto 2014
Asif Masood,PAK,Pace,1971-06-03,Birmingham,England,1971,2,160,347,9,1,653,1403,13,493,1056,4,50.23076923076923,>30,ENG,Away,Upto 2014
Asif Masood,PAK,Pace,1971-06-17,Lord's,England,1971,2,63,144,0,1,276,712,9,213,568,9,30.666666666666668,>30,ENG,Away,Upto 2014
Asif Masood,PAK,Pace,1971-07-08,Leeds,England,1971,2,121,228,4,1,442,1309,24,321,1081,20,18.416666666666668,<=30,ENG,Away,Upto 2014
Asif Masood,PAK,Pace,1972-12-22,Adelaide,Australia,1972,1,110,152,3,1,517,1131,14,407,979,11,36.92857142857143,>30,AUS,Away,Upto 2014
Asif Masood,PAK,Pace,1972-12-29,Melbourne,Australia,1972,2,197,232,2,1,925,1467,16,728,1235,14,57.8125,>30,AUS,Away,Upto 2014
Asif Masood,PAK,Pace,1973-01-06,Sydney,Australia,1973,2,96,168,0,1,767,1875,36,671,1707,36,21.305555555555557,<=30,AUS,Away,Upto 2014
Asif Masood,PAK,Pace,1973-03-24,Karachi,Pakistan,1973,2,52,150,2,1,291,630,3,239,480,1,97.0,>30,PAK,Home,Upto 2014
Asif Masood,PAK,Pace,1974-07-25,Leeds,England,1974,2,113,210,3,1,703,1746,31,590,1536,28,22.677419354838708,<=30,ENG,Away,Upto 2014
Asif Masood,PAK,Pace,1974-08-08,Lord's,England,1974,2,56,174,3,1,356,858,8,300,684,5,44.5,>30,ENG,Away,Upto 2014
Asif Masood,PAK,Pace,1974-08-22,The Oval,England,1974,1,66,240,1,1,675,1389,8,609,1149,7,84.375,>30,ENG,Away,Upto 2014
Asif Masood,PAK,Pace,1975-02-15,Lahore,Pakistan,1975,2,133,293,3,1,757,1707,25,624,1414,22,30.28,>30,PAK,Home,Upto 2014
Asif Masood,PAK,Pace,1975-03-01,Karachi,Pakistan,1975,1,76,122,2,1,655,1306,12,579,1184,10,54.583333333333336,>30,PAK,Home,Upto 2014
Asif Masood,PAK,Pace,1977-01-01,Melbourne,Australia,1977,1,79,104,0,1,882,1510,22,803,1406,22,40.09090909090909,>30,AUS,Away,Upto 2014
Asif Mujtaba,PAK,Spin,1986-11-20,Karachi,Pakistan,1986,1,2,18,0,1,383,1055,15,381,1037,15,25.533333333333335,<=30,PAK,Home,Upto 2014
Asif Mujtaba,PAK,Spin,1992-06-04,Birmingham,England,1992,1,29,48,0,1,247,450,2,218,402,2,123.5,>30,ENG,Away,Upto 2014
Asif Mujtaba,PAK,Spin,1992-06-18,Lord's,England,1992,2,1,24,1,1,212,416,11,211,392,10,19.272727272727273,<=30,ENG,Away,Upto 2014
Asif Mujtaba,PAK,Spin,1992-07-02,Manchester,England,1992,1,0,6,0,1,251,294,0,251,288,0,inf,>30,ENG,Away,Upto 2014
Asif Mujtaba,PAK,Spin,1993-04-16,Port of Spain,West Indies,1993,1,43,60,1,1,204,311,8,161,251,7,25.5,<=30,WI,Away,Upto 2014
Asif Mujtaba,PAK,Spin,1993-04-23,Bridgetown,West Indies,1993,1,30,18,0,1,162,279,5,132,261,5,32.4,>30,WI,Away,Upto 2014
Asif Mujtaba,PAK,Spin,1993-05-01,St John's,West Indies,1993,2,16,30,0,1,315,516,3,299,486,3,105.0,>30,WI,Away,Upto 2014
Asif Mujtaba,PAK,Spin,1993-12-01,Karachi,Pakistan,1993,1,1,18,0,1,291,834,6,290,816,6,48.5,>30,PAK,Home,Upto 2014
Asif Mujtaba,PAK,Spin,1995-01-31,Harare,Zimbabwe,1995,1,30,42,0,1,301,564,1,271,522,1,301.0,>30,ZIM,Away,Upto 2014
Asif Mujtaba,PAK,Spin,1996-08-08,Leeds,England,1996,1,6,42,0,1,168,414,4,162,372,4,42.0,>30,ENG,Away,Upto 2014
Asif Mujtaba,PAK,Spin,1997-04-19,Colombo (RPS),Sri Lanka,1997,2,89,234,1,1,757,2006,23,668,1772,22,32.91304347826087,>30,SL,Away,Upto 2014
Asif Mujtaba,PAK,Spin,1997-04-26,Colombo (SSC),Sri Lanka,1997,2,56,126,1,1,882,1775,14,826,1649,13,63.0,>30,SL,Away,Upto 2014
Ata-ur-Rehman,PAK,Pace,1992-06-04,Birmingham,England,1992,1,69,108,3,1,641,1086,9,572,978,6,71.22222222222223,>30,ENG,Away,Upto 2014
Ata-ur-Rehman,PAK,Pace,1993-04-16,Port of Spain,West Indies,1993,2,110,168,3,1,566,1117,30,456,949,27,18.866666666666667,<=30,WI,Away,Upto 2014
Ata-ur-Rehman,PAK,Pace,1993-04-23,Bridgetown,West Indies,1993,1,103,126,2,1,783,1460,25,680,1334,23,31.32,>30,WI,Away,Upto 2014
Ata-ur-Rehman,PAK,Pace,1993-05-01,St John's,West Indies,1993,2,90,156,1,1,577,1130,21,487,974,20,27.476190476190474,<=30,WI,Away,Upto 2014
Ata-ur-Rehman,PAK,Pace,1993-12-01,Karachi,Pakistan,1993,2,48,186,3,1,605,1326,22,557,1140,19,27.5,<=30,PAK,Home,Upto 2014
Ata-ur-Rehman,PAK,Pace,1993-12-09,Rawalpindi,Pakistan,1993,2,62,132,2,1,816,1939,40,754,1807,38,20.4,<=30,PAK,Home,Upto 2014
Ata-ur-Rehman,PAK,Pace,1993-12-16,Lahore,Pakistan,1993,1,24,78,1,1,467,1213,21,443,1135,20,22.238095238095237,<=30,PAK,Home,Upto 2014
Ata-ur-Rehman,PAK,Pace,1994-02-10,Auckland,New Zealand,1994,2,78,120,2,1,582,1070,31,504,950,29,18.774193548387096,<=30,NZ,Away,Upto 2014
Ata-ur-Rehman,PAK,Pace,1994-02-17,Wellington,New Zealand,1994,2,136,198,4,1,832,1382,22,696,1184,18,37.81818181818182,>30,NZ,Away,Upto 2014
Ata-ur-Rehman,PAK,Pace,1995-09-22,Sialkot,Pakistan,1995,2,108,252,2,1,584,1401,24,476,1149,22,24.333333333333332,<=30,PAK,Home,Upto 2014
Ata-ur-Rehman,PAK,Pace,1995-12-08,Christchurch,New Zealand,1995,2,70,157,3,1,844,1657,28,774,1500,25,30.142857142857142,>30,NZ,Away,Upto 2014
Ata-ur-Rehman,PAK,Pace,1996-07-25,Lord's,England,1996,2,83,160,4,1,850,1771,26,767,1611,22,32.69230769230769,>30,ENG,Away,Upto 2014
Ata-ur-Rehman,PAK,Pace,1996-08-08,Leeds,England,1996,1,90,132,1,1,963,1933,22,873,1801,21,43.77272727272727,>30,ENG,Away,Upto 2014
Azeem Hafeez,PAK,Pace,1983-09-14,Bengaluru,India,1983,2,122,282,2,1,497,1170,18,375,888,16,27.61111111111111,<=30,IND,Away,Upto 2014
Azeem Hafeez,PAK,Pace,1983-09-24,Jalandhar,India,1983,1,65,138,3,1,450,936,11,385,798,8,40.90909090909091,>30,IND,Away,Upto 2014
Azeem Hafeez,PAK,Pace,1983-10-05,Nagpur,India,1983,2,125,276,5,1,439,897,10,314,621,5,43.9,>30,IND,Away,Upto 2014
Azeem Hafeez,PAK,Pace,1983-11-11,W.A.C.A,Australia,1983,1,100,165,5,1,628,1218,24,528,1053,19,26.166666666666668,<=30,AUS,Away,Upto 2014
Azeem Hafeez,PAK,Pace,1983-11-25,Brisbane,Australia,1983,1,152,222,3,1,428,757,16,276,535,13,26.75,<=30,AUS,Away,Upto 2014
Azeem Hafeez,PAK,Pace,1983-12-09,Adelaide,Australia,1983,2,217,344,7,1,947,1786,20,730,1442,13,47.35,>30,AUS,Away,Upto 2014
Azeem Hafeez,PAK,Pace,1983-12-26,Melbourne,Australia,1983,1,115,210,3,1,818,1728,17,703,1518,14,48.11764705882353,>30,AUS,Away,Upto 2014
Azeem Hafeez,PAK,Pace,1984-01-02,Sydney,Australia,1984,2,149,232,1,1,768,1631,25,619,1399,24,30.72,>30,AUS,Away,Upto 2014
Azeem Hafeez,PAK,Pace,1984-03-02,Karachi,Pakistan,1984,2,35,114,0,1,284,740,10,249,626,10,28.4,<=30,PAK,Home,Upto 2014
Azeem Hafeez,PAK,Pace,1984-03-12,Faisalabad,Pakistan,1984,1,71,114,1,1,538,960,13,467,846,12,41.38461538461539,>30,PAK,Home,Upto 2014
Azeem Hafeez,PAK,Pace,1984-10-17,Lahore,Pakistan,1984,2,160,396,7,1,564,1248,16,404,852,9,35.25,>30,PAK,Home,Upto 2014
Azeem Hafeez,PAK,Pace,1984-10-24,Faisalabad,Pakistan,1984,1,137,264,4,1,679,1180,8,542,916,4,84.875,>30,PAK,Home,Upto 2014
Azeem Hafeez,PAK,Pace,1984-11-16,Lahore,Pakistan,1984,2,77,186,4,1,340,861,14,263,675,10,24.285714285714285,<=30,PAK,Home,Upto 2014
Azeem Hafeez,PAK,Pace,1984-11-25,Hyderabad (Sind),Pakistan,1984,2,63,156,2,1,178,432,6,115,276,4,29.666666666666668,<=30,PAK,Home,Upto 2014
Azeem Hafeez,PAK,Pace,1984-12-10,Karachi,Pakistan,1984,1,132,280,4,1,473,890,12,341,610,8,39.416666666666664,>30,PAK,Home,Upto 2014
Azeem Hafeez,PAK,Pace,1985-01-18,Wellington,New Zealand,1985,2,178,378,6,1,458,1096,12,280,718,6,38.166666666666664,>30,NZ,Away,Upto 2014
Azeem Hafeez,PAK,Pace,1985-01-25,Auckland,New Zealand,1985,1,157,282,3,1,673,1429,25,516,1147,22,26.92,<=30,NZ,Away,Upto 2014
Azeem Hafeez,PAK,Pace,1985-02-09,Dunedin,New Zealand,1985,2,149,312,3,1,862,2018,34,713,1706,31,25.352941176470587,<=30,NZ,Away,Upto 2014
Azhar Ali,PAK,Spin,2010-07-29,Nottingham,England,2010,1,9,6,0,1,267,351,3,258,345,3,89.0,>30,ENG,Away,Upto 2014
Azhar Ali,PAK,Spin,2011-09-01,Bulawayo,Zimbabwe,2011,1,23,36,0,1,525,1193,17,502,1157,17,30.88235294117647,>30,ZIM,Away,Upto 2014
Azhar Ali,PAK,Spin,2011-10-18,Abu Dhabi,UAE,2011,1,4,18,1,1,499,1258,7,495,1240,6,71.28571428571429,>30,UAE,Away,Upto 2014
Azhar Ali,PAK,Spin,2011-12-17,Mirpur,Bangladesh,2011,1,8,6,0,1,690,1381,17,682,1375,17,40.588235294117645,>30,BAN,Away,Upto 2014
Azhar Ali,PAK,Spin,2012-06-30,Colombo (SSC),Sri Lanka,2012,1,10,24,0,1,609,1048,13,599,1024,13,46.84615384615385,>30,SL,Away,Upto 2014
Azhar Ali,PAK,Spin,2013-02-22,Centurion,South Africa,2013,1,13,12,0,1,179,318,2,166,306,2,89.5,>30,SA,Away,Upto 2014
Azhar Ali,PAK,Spin,2013-10-23,Dubai (DICS),UAE,2013,1,22,30,0,1,497,1052,19,475,1022,19,26.157894736842106,<=30,UAE,Away,Upto 2014
Azhar Ali,PAK,Spin,2014-01-16,Sharjah,UAE,2014,1,11,18,0,1,637,1445,16,626,1427,16,39.8125,>30,UAE,Away,After 1965
Azhar Ali,PAK,Spin,2014-10-30,Abu Dhabi,UAE,2014,1,1,6,0,1,756,1259,18,755,1253,18,42.0,>30,UAE,Away,After 1965
Azhar Ali,PAK,Spin,2014-11-17,Dubai (DICS),UAE,2014,1,23,54,1,1,778,1523,22,755,1469,21,35.36363636363637,>30,UAE,Away,After 1965
Azhar Ali,PAK,Spin,2014-11-26,Sharjah,UAE,2014,1,8,12,0,1,856,1190,21,848,1178,21,40.76190476190476,>30,UAE,Away,After 1965
Azhar Ali,PAK,Spin,2015-04-28,Khulna,Bangladesh,2015,1,26,36,0,1,1092,1798,20,1066,1762,20,54.6,>30,BAN,Away,After 1965
Azhar Ali,PAK,Spin,2015-07-03,Pallekele,Sri Lanka,2015,2,49,72,2,1,413,744,13,364,672,11,31.76923076923077,>30,SL,Away,After 1965
Azhar Ali,PAK,Spin,2015-11-01,Sharjah,UAE,2015,1,7,12,0,1,743,1504,24,736,1492,24,30.958333333333332,>30,UAE,Away,After 1965
Azhar Ali,PAK,Spin,2016-07-22,Manchester,England,2016,2,73,78,0,1,470,620,7,397,542,7,67.14285714285714,>30,ENG,Away,After 1965
Azhar Ali,PAK,Spin,2016-08-03,Birmingham,England,2016,1,22,30,0,1,391,671,5,369,641,5,78.2,>30,ENG,Away,After 1965
Azhar Ali,PAK,Spin,2016-10-13,Dubai (DICS),UAE,2016,1,6,15,0,1,657,1312,22,651,1297,22,29.863636363636363,<=30,UAE,Away,After 1965
Azhar Ali,PAK,Spin,2016-10-30,Sharjah,UAE,2016,1,16,36,0,1,457,972,14,441,936,14,32.642857142857146,>30,UAE,Away,After 1965
Azhar Ali,PAK,Spin,2016-11-17,Christchurch,New Zealand,2016,1,6,18,1,1,79,123,1,73,105,0,79.0,>30,NZ,Away,After 1965
Azhar Ali,PAK,Spin,2016-11-25,Hamilton,New Zealand,2016,2,23,42,0,1,91,174,2,68,132,2,45.5,>30,NZ,Away,After 1965
Azhar Ali,PAK,Spin,2016-12-15,Brisbane,Australia,2016,2,62,72,0,1,384,649,5,322,577,5,76.8,>30,AUS,Away,After 1965
Azhar Ali,PAK,Spin,2016-12-26,Melbourne,Australia,2016,1,35,30,0,1,417,534,7,382,504,7,59.57142857142857,>30,AUS,Away,After 1965
Azhar Ali,PAK,Spin,2017-01-03,Sydney,Australia,2017,2,110,114,2,1,736,1038,13,626,924,11,56.61538461538461,>30,AUS,Away,After 1965
Azhar Ali,PAK,Spin,2017-04-30,Bridgetown,West Indies,2017,1,4,6,0,1,516,1000,13,512,994,13,39.69230769230769,>30,WI,Away,After 1965
Azhar Ali,PAK,Spin,2017-05-10,Roseau,West Indies,2017,2,18,48,1,1,500,993,18,482,945,17,27.77777777777778,<=30,WI,Away,After 1965
Azhar Ali,PAK,Spin,2018-10-07,Dubai (DICS),UAE,2018,1,3,6,0,1,793,1735,21,790,1729,21,37.76190476190476,>30,UAE,Away,After 1965
Azhar Ali,PAK,Spin,2018-12-03,Abu Dhabi,UAE,2018,1,2,6,0,1,612,1532,24,610,1526,24,25.5,<=30,UAE,Away,After 1965
Azhar Ali,PAK,Spin,2019-01-03,Cape Town,South Africa,2019,1,8,5,0,1,103,155,0,95,150,0,inf,>30,SA,Away,After 1965
Azhar Ali,PAK,Spin,2019-11-29,Adelaide,Australia,2019,1,9,6,0,1,462,654,5,453,648,5,92.4,>30,AUS,Away,After 1965
Azhar Ali,PAK,Spin,2020-08-13,Southampton,England,2020,1,0,1,0,1,30,67,1,30,66,1,30.0,<=30,ENG,Away,After 1965
Azhar Ali,PAK,Spin,2022-03-12,Karachi,Pakistan,2022,1,10,12,0,1,673,1474,11,663,1462,11,61.18181818181818,>30,PAK,Home,After 1965
Azhar Khan,PAK,Spin,1980-03-18,Lahore,Pakistan,1980,2,2,18,1,1,686,1374,15,684,1356,14,45.733333333333334,>30,PAK,Home,Upto 2014
Azhar Mahmood,PAK,Pace,1997-10-06,Rawalpindi,Pakistan,1997,1,74,162,2,1,556,1227,14,482,1065,12,39.714285714285715,>30,PAK,Home,Upto 2014
Azhar Mahmood,PAK,Pace,1997-10-17,Sheikhupura,Pakistan,1997,1,52,84,2,1,127,240,3,75,156,1,42.333333333333336,>30,PAK,Home,Upto 2014
Azhar Mahmood,PAK,Pace,1997-10-24,Faisalabad,Pakistan,1997,2,52,106,1,1,482,896,25,430,790,24,19.28,<=30,PAK,Home,Upto 2014
Azhar Mahmood,PAK,Pace,1997-11-17,Peshawar,Pakistan,1997,2,52,145,3,1,444,1004,18,392,859,15,24.666666666666668,<=30,PAK,Home,Upto 2014
Azhar Mahmood,PAK,Pace,1997-11-29,Rawalpindi,Pakistan,1997,2,57,137,4,1,728,1434,26,671,1297,22,28.0,<=30,PAK,Home,Upto 2014
Azhar Mahmood,PAK,Pace,1997-12-06,Karachi,Pakistan,1997,2,46,78,0,1,528,879,18,482,801,18,29.333333333333332,<=30,PAK,Home,Upto 2014
Azhar Mahmood,PAK,Pace,1998-02-14,Johannesburg,South Africa,1998,1,52,120,1,1,551,982,15,499,862,14,36.733333333333334,>30,SA,Away,Upto 2014
Azhar Mahmood,PAK,Pace,1998-02-26,Durban,South Africa,1998,2,40,168,0,1,733,1519,29,693,1351,29,25.275862068965516,<=30,SA,Away,Upto 2014
Azhar Mahmood,PAK,Pace,1998-03-06,Gqeberha,South Africa,1998,2,96,216,3,1,625,1400,33,529,1184,30,18.939393939393938,<=30,SA,Away,Upto 2014
Azhar Mahmood,PAK,Pace,1998-03-14,Bulawayo,Zimbabwe,1998,2,158,360,3,1,726,1690,25,568,1330,22,29.04,<=30,ZIM,Away,Upto 2014
Azhar Mahmood,PAK,Pace,1998-03-21,Harare,Zimbabwe,1998,2,95,228,5,1,727,1780,29,632,1552,24,25.06896551724138,<=30,ZIM,Away,Upto 2014
Azhar Mahmood,PAK,Pace,1998-10-01,Rawalpindi,Pakistan,1998,1,36,78,0,1,337,761,10,301,683,10,33.7,>30,PAK,Home,Upto 2014
Azhar Mahmood,PAK,Pace,1998-10-15,Peshawar,Pakistan,1998,2,100,156,1,1,690,1183,11,590,1027,10,62.72727272727273,>30,PAK,Home,Upto 2014
Azhar Mahmood,PAK,Pace,1998-11-27,Peshawar,Pakistan,1998,2,31,54,0,1,700,1353,31,669,1299,31,22.580645161290324,<=30,PAK,Home,Upto 2014
Azhar Mahmood,PAK,Pace,1999-02-16,Eden Gardens,India,1999,2,63,144,1,1,539,1227,30,476,1083,29,17.966666666666665,<=30,IND,Away,Upto 2014
Azhar Mahmood,PAK,Pace,1999-11-05,Brisbane,Australia,1999,2,65,134,1,1,895,1510,23,830,1376,22,38.91304347826087,>30,AUS,Away,Upto 2014
Azhar Mahmood,PAK,Pace,1999-11-18,Hobart,Australia,1999,2,73,144,3,1,857,1577,19,784,1433,16,45.10526315789474,>30,AUS,Away,Upto 2014
Azhar Mahmood,PAK,Pace,1999-11-26,W.A.C.A,Australia,1999,1,91,138,1,1,717,1143,27,626,1005,26,26.555555555555557,<=30,AUS,Away,Upto 2014
Azhar Mahmood,PAK,Pace,2000-06-21,Galle,Sri Lanka,2000,2,84,159,4,1,578,1128,20,494,969,16,28.9,<=30,SL,Away,Upto 2014
Azhar Mahmood,PAK,Pace,2001-05-17,Lord's,England,2001,1,50,156,4,1,714,1443,30,664,1287,26,23.8,<=30,ENG,Away,Upto 2014
Azhar Mahmood,PAK,Pace,2001-05-31,Manchester,England,2001,1,35,48,0,1,1134,1996,31,1099,1948,31,36.58064516129032,>30,ENG,Away,Upto 2014
Azmatullah Omarzai,AFG,Spin,2024-12-26,Bulawayo,Zimbabwe,2024,2,74,132,1,1,1189,1856,20,1115,1724,19,59.45,>30,ZIM,Away,After 1965
B Andrews,NZ,Pace,1973-12-29,Melbourne,Australia,1973,1,100,152,0,1,539,1189,14,439,1037,14,38.5,>30,AUS,Away,Upto 2014
B Andrews,NZ,Pace,1974-01-05,Sydney,Australia,1974,2,54,104,2,1,618,1375,28,564,1271,26,22.071428571428573,<=30,AUS,Away,Upto 2014
B Arun,IND,Pace,1986-12-17,Kanpur,India,1986,1,76,162,3,1,810,1291,13,734,1129,10,62.30769230769231,>30,IND,Home,Upto 2014
B Arun,IND,Pace,1987-01-04,Cuttack,India,1987,2,40,90,1,1,333,711,12,293,621,11,27.75,<=30,IND,Home,Upto 2014
B Casson,AUS,Spin,2008-06-12,Bridgetown,West Indies,2008,2,129,192,3,1,440,864,10,311,672,7,44.0,>30,WI,Away,Upto 2014
B Dooland,AUS,Spin,1947-01-01,Melbourne,Australia,1947,2,153,384,5,1,582,1365,14,429,981,9,41.57142857142857,>30,AUS,Home,Upto 2014
B Dooland,AUS,Spin,1947-01-31,Adelaide,Australia,1947,2,198,400,3,1,672,1532,8,474,1132,5,84.0,>30,AUS,Home,Upto 2014
B Dooland,AUS,Spin,1948-01-01,Melbourne,Australia,1948,1,68,96,1,1,660,1199,23,592,1103,22,28.695652173913043,<=30,AUS,Home,Upto 2014
B Evans,ZIM,Pace,2023-02-04,Bulawayo,Zimbabwe,2023,2,115,216,2,1,562,1122,8,447,906,6,70.25,>30,ZIM,Home,After 1965
B Kumar,IND,Pace,2013-02-22,Chennai,India,2013,1,52,78,0,1,415,813,8,363,735,8,51.875,>30,IND,Home,Upto 2014
B Kumar,IND,Pace,2013-03-02,Hyderabad,India,2013,2,60,126,3,1,327,744,7,267,618,4,46.714285714285715,>30,IND,Home,Upto 2014
B Kumar,IND,Pace,2013-03-14,Mohali,India,2013,2,75,114,3,1,473,880,15,398,766,12,31.533333333333335,>30,IND,Home,Upto 2014
B Kumar,IND,Pace,2013-03-22,Delhi,India,2013,2,52,66,0,1,259,450,5,207,384,5,51.8,>30,IND,Home,Upto 2014
B Kumar,IND,Pace,2013-11-06,Eden Gardens,India,2013,2,53,120,2,1,366,583,13,313,463,11,28.153846153846153,<=30,IND,Home,Upto 2014
B Kumar,IND,Pace,2013-11-14,Wankhede,India,2013,2,49,120,1,1,332,492,5,283,372,4,66.4,>30,IND,Home,Upto 2014
B Kumar,IND,Pace,2014-07-09,Nottingham,England,2014,1,82,185,5,1,984,1979,23,902,1794,18,42.78260869565217,>30,ENG,Away,After 1965
B Kumar,IND,Pace,2014-07-17,Lord's,England,2014,2,103,282,6,1,890,1823,32,787,1541,26,27.8125,<=30,ENG,Away,After 1965
B Kumar,IND,Pace,2014-07-27,Southampton,England,2014,2,160,282,4,1,815,1573,15,655,1291,11,54.333333333333336,>30,ENG,Away,After 1965
B Kumar,IND,Pace,2014-08-07,Manchester,England,2014,1,75,144,3,1,546,928,23,471,784,20,23.73913043478261,<=30,ENG,Away,After 1965
B Kumar,IND,Pace,2014-08-15,The Oval,England,2014,1,86,144,1,1,613,1107,25,527,963,24,24.52,<=30,ENG,Away,After 1965
B Kumar,IND,Pace,2015-01-06,Sydney,Australia,2015,2,168,252,1,1,942,1653,21,774,1401,20,44.857142857142854,>30,AUS,Away,After 1965
B Kumar,IND,Pace,2016-08-09,Gros Islet,West Indies,2016,2,46,214,6,1,570,1190,26,524,976,20,21.923076923076923,<=30,WI,Away,After 1965
B Kumar,IND,Pace,2016-08-18,Port of Spain,West Indies,2016,1,13,36,0,1,34,102,1,21,66,1,34.0,>30,WI,Away,After 1965
B Kumar,IND,Pace,2016-09-30,Eden Gardens,India,2016,2,76,162,6,1,483,1061,26,407,899,20,18.576923076923077,<=30,IND,Home,After 1965
B Kumar,IND,Pace,2016-12-08,Wankhede,India,2016,2,60,102,1,1,329,570,3,269,468,2,109.66666666666667,>30,IND,Home,After 1965
B Kumar,IND,Pace,2017-02-09,Hyderabad,India,2017,2,67,174,1,1,567,906,10,500,732,9,56.7,>30,IND,Home,After 1965
B Kumar,IND,Pace,2017-03-25,Dharamsala,India,2017,2,68,117,2,1,367,681,12,299,564,10,30.583333333333332,>30,IND,Home,After 1965
B Kumar,IND,Pace,2017-11-16,Eden Gardens,India,2017,2,96,228,8,1,743,1322,32,647,1094,24,23.21875,<=30,IND,Home,After 1965
B Kumar,IND,Pace,2018-01-05,Cape Town,South Africa,2018,2,120,180,6,1,684,1276,37,564,1096,31,18.486486486486488,<=30,SA,Away,After 1965
B Kumar,IND,Pace,2018-01-24,Johannesburg,South Africa,2018,2,83,222,4,1,749,1777,40,666,1555,36,18.725,<=30,SA,Away,After 1965
B Lee,AUS,Pace,1999-12-26,Melbourne,Australia,1999,2,78,222,7,1,715,1451,26,637,1229,19,27.5,<=30,AUS,Home,Upto 2014
B Lee,AUS,Pace,2000-01-02,Sydney,Australia,2000,2,106,192,6,1,643,1127,22,537,935,16,29.227272727272727,<=30,AUS,Home,Upto 2014
B Lee,AUS,Pace,2000-03-11,Auckland,New Zealand,2000,2,55,114,4,1,234,565,12,179,451,8,19.5,<=30,NZ,Away,Upto 2014
B Lee,AUS,Pace,2000-03-24,Wellington,New Zealand,2000,2,136,240,6,1,802,1476,20,666,1236,14,40.1,>30,NZ,Away,Upto 2014
B Lee,AUS,Pace,2000-03-31,Hamilton,New Zealand,2000,2,123,250,8,1,633,1061,24,510,811,16,26.375,<=30,NZ,Away,Upto 2014
B Lee,AUS,Pace,2000-11-23,Brisbane,Australia,2000,2,64,175,4,1,456,1175,24,392,1000,20,19.0,<=30,AUS,Home,Upto 2014
B Lee,AUS,Pace,2000-12-01,W.A.C.A,Australia,2000,2,113,180,7,1,637,1158,23,524,978,16,27.695652173913043,<=30,AUS,Home,Upto 2014
B Lee,AUS,Pace,2001-07-05,Birmingham,England,2001,2,108,114,2,1,685,933,19,577,819,17,36.05263157894737,>30,ENG,Away,Upto 2014
B Lee,AUS,Pace,2001-07-19,Lord's,England,2001,2,87,150,2,1,636,1130,28,549,980,26,22.714285714285715,<=30,ENG,Away,Upto 2014
B Lee,AUS,Pace,2001-08-02,Nottingham,England,2001,2,60,89,2,1,583,930,24,523,841,22,24.291666666666668,<=30,ENG,Away,Upto 2014
B Lee,AUS,Pace,2001-08-16,Leeds,England,2001,2,168,228,2,1,1054,1608,26,886,1380,24,40.53846153846154,>30,ENG,Away,Upto 2014
B Lee,AUS,Pace,2001-08-23,The Oval,England,2001,2,73,144,1,1,586,1029,9,513,885,8,65.11111111111111,>30,ENG,Away,Upto 2014
B Lee,AUS,Pace,2001-11-08,Brisbane,Australia,2001,2,120,198,6,1,871,1428,20,751,1230,14,43.55,>30,AUS,Home,Upto 2014
B Lee,AUS,Pace,2001-11-22,Hobart,Australia,2001,1,51,114,0,1,554,972,8,503,858,8,69.25,>30,AUS,Home,Upto 2014
B Lee,AUS,Pace,2001-11-30,W.A.C.A,Australia,2001,2,181,293,8,1,1026,1787,22,845,1494,14,46.63636363636363,>30,AUS,Home,Upto 2014
B Lee,AUS,Pace,2001-12-14,Adelaide,Australia,2001,2,110,186,2,1,773,1644,20,663,1458,18,38.65,>30,AUS,Home,Upto 2014
B Lee,AUS,Pace,2001-12-26,Melbourne,Australia,2001,2,129,294,5,1,710,1446,22,581,1152,17,32.27272727272727,>30,AUS,Home,Upto 2014
B Lee,AUS,Pace,2002-01-02,Sydney,Australia,2002,2,75,150,2,1,596,1002,11,521,852,9,54.18181818181818,>30,AUS,Home,Upto 2014
B Lee,AUS,Pace,2002-02-22,Johannesburg,South Africa,2002,2,95,120,3,1,698,1059,20,603,939,17,34.9,>30,SA,Away,Upto 2014
B Lee,AUS,Pace,2002-03-08,Cape Town,South Africa,2002,2,164,228,3,1,927,1517,20,763,1289,17,46.35,>30,SA,Away,Upto 2014
B Lee,AUS,Pace,2002-03-15,Durban,South Africa,2002,2,157,224,4,1,733,1239,21,576,1015,17,34.904761904761905,>30,SA,Away,Upto 2014
B Lee,AUS,Pace,2002-10-03,Colombo (PSS),Sri Lanka,2002,2,112,150,2,1,672,1175,21,560,1025,19,32.0,>30,SL,Away,Upto 2014
B Lee,AUS,Pace,2002-10-11,Sharjah,UAE,2002,2,31,77,3,1,167,426,14,136,349,11,11.928571428571429,<=30,UAE,Away,Upto 2014
B Lee,AUS,Pace,2002-10-19,Sharjah,UAE,2002,2,91,174,0,1,365,713,15,274,539,15,24.333333333333332,<=30,UAE,Away,Upto 2014
B Lee,AUS,Pace,2002-11-29,W.A.C.A,Australia,2002,2,150,229,5,1,590,1095,16,440,866,11,36.875,>30,AUS,Home,Upto 2014
B Lee,AUS,Pace,2002-12-26,Melbourne,Australia,2002,2,157,264,3,1,740,1406,19,583,1142,16,38.94736842105263,>30,AUS,Home,Upto 2014
B Lee,AUS,Pace,2003-01-02,Sydney,Australia,2003,2,229,375,5,1,1004,1656,32,775,1281,27,31.375,>30,AUS,Home,Upto 2014
B Lee,AUS,Pace,2003-04-10,Georgetown,West Indies,2003,2,98,147,2,1,811,1248,21,713,1101,19,38.61904761904762,>30,WI,Away,Upto 2014
B Lee,AUS,Pace,2003-04-19,Port of Spain,West Indies,2003,2,137,252,5,1,913,1617,20,776,1365,15,45.65,>30,WI,Away,Upto 2014
B Lee,AUS,Pace,2003-05-01,Bridgetown,West Indies,2003,2,121,240,3,1,652,1455,15,531,1215,12,43.46666666666667,>30,WI,Away,Upto 2014
B Lee,AUS,Pace,2003-05-09,St John's,West Indies,2003,2,135,228,7,1,870,1573,29,735,1345,22,30.0,<=30,WI,Away,Upto 2014
B Lee,AUS,Pace,2003-07-18,Darwin,Australia,2003,2,57,122,4,1,496,985,17,439,863,13,29.176470588235293,<=30,AUS,Home,Upto 2014
B Lee,AUS,Pace,2003-07-25,Cairns,Australia,2003,2,133,174,2,1,637,1169,12,504,995,10,53.083333333333336,>30,AUS,Home,Upto 2014
B Lee,AUS,Pace,2003-10-09,W.A.C.A,Australia,2003,2,144,300,4,1,658,1277,15,514,977,11,43.86666666666667,>30,AUS,Home,Upto 2014
B Lee,AUS,Pace,2003-10-17,Sydney,Australia,2003,1,78,138,2,1,646,1058,15,568,920,13,43.06666666666667,>30,AUS,Home,Upto 2014
B Lee,AUS,Pace,2003-12-26,Melbourne,Australia,2003,2,200,294,4,1,819,1520,17,619,1226,13,48.1764705882353,>30,AUS,Home,Upto 2014
B Lee,AUS,Pace,2004-01-02,Sydney,Australia,2004,2,276,311,4,1,876,1379,11,600,1068,7,79.63636363636364,>30,AUS,Home,Upto 2014
B Lee,AUS,Pace,2005-07-21,Lord's,England,2005,2,105,181,5,1,726,1256,32,621,1075,27,22.6875,<=30,ENG,Away,Upto 2014
B Lee,AUS,Pace,2005-08-04,Birmingham,England,2005,2,193,210,5,1,817,1095,24,624,885,19,34.041666666666664,>30,ENG,Away,Upto 2014
B Lee,AUS,Pace,2005-08-11,Manchester,England,2005,2,160,234,5,1,929,1432,27,769,1198,22,34.407407407407405,>30,ENG,Away,Upto 2014
B Lee,AUS,Pace,2005-08-25,Nottingham,England,2005,2,182,264,4,1,944,1543,26,762,1279,22,36.30769230769231,>30,ENG,Away,Upto 2014
B Lee,AUS,Pace,2005-09-08,The Oval,England,2005,2,182,258,1,1,707,1205,18,525,947,17,39.27777777777778,>30,ENG,Away,Upto 2014
B Lee,AUS,Pace,2005-10-14,Sydney,Australia,2005,2,96,108,2,1,422,699,17,326,591,15,24.823529411764707,<=30,AUS,Home,Upto 2014
B Lee,AUS,Pace,2005-11-03,Brisbane,Australia,2005,2,89,174,6,1,772,1215,25,683,1041,19,30.88,>30,AUS,Home,Upto 2014
B Lee,AUS,Pace,2005-11-17,Hobart,Australia,2005,2,131,243,5,1,632,1261,19,501,1018,14,33.26315789473684,>30,AUS,Home,Upto 2014
B Lee,AUS,Pace,2005-11-25,Adelaide,Australia,2005,2,157,270,7,1,853,1575,23,696,1305,16,37.08695652173913,>30,AUS,Home,Upto 2014
B Lee,AUS,Pace,2005-12-16,W.A.C.A,Australia,2005,2,176,320,6,1,1099,2050,27,923,1730,21,40.7037037037037,>30,AUS,Home,Upto 2014
B Lee,AUS,Pace,2005-12-26,Melbourne,Australia,2005,2,115,234,3,1,712,1466,23,597,1232,20,30.956521739130434,>30,AUS,Home,Upto 2014
B Lee,AUS,Pace,2006-01-02,Sydney,Australia,2006,2,130,244,4,1,752,1301,17,622,1057,13,44.23529411764706,>30,AUS,Home,Upto 2014
B Lee,AUS,Pace,2006-03-16,Cape Town,South Africa,2006,2,84,191,5,1,563,1099,28,479,908,23,20.107142857142858,<=30,SA,Away,Upto 2014
B Lee,AUS,Pace,2006-03-24,Durban,South Africa,2006,2,134,250,6,1,838,1637,23,704,1387,17,36.43478260869565,>30,SA,Away,Upto 2014
B Lee,AUS,Pace,2006-03-31,Johannesburg,South Africa,2006,2,114,255,6,1,824,1490,30,710,1235,24,27.466666666666665,<=30,SA,Away,Upto 2014
B Lee,AUS,Pace,2006-04-09,Fatullah,Bangladesh,2006,2,115,162,1,1,364,804,10,249,642,9,36.4,>30,BAN,Away,Upto 2014
B Lee,AUS,Pace,2006-04-16,Chattogram,Bangladesh,2006,2,71,120,1,1,238,372,5,167,252,4,47.6,>30,BAN,Away,Upto 2014
B Lee,AUS,Pace,2006-11-23,Brisbane,Australia,2006,2,149,222,2,1,985,1659,24,836,1437,22,41.041666666666664,>30,AUS,Home,Upto 2014
B Lee,AUS,Pace,2006-12-01,Adelaide,Australia,2006,2,174,312,3,1,876,1646,21,702,1334,18,41.714285714285715,>30,AUS,Home,Upto 2014
B Lee,AUS,Pace,2006-12-14,W.A.C.A,Australia,2006,2,144,240,3,1,846,1471,19,702,1231,16,44.526315789473685,>30,AUS,Home,Upto 2014
B Lee,AUS,Pace,2006-12-26,Melbourne,Australia,2006,2,83,191,6,1,551,1154,23,468,963,17,23.956521739130434,<=30,AUS,Home,Upto 2014
B Lee,AUS,Pace,2007-01-02,Sydney,Australia,2007,2,114,216,6,1,646,1259,24,532,1043,18,26.916666666666668,<=30,AUS,Home,Upto 2014
B Lee,AUS,Pace,2007-11-08,Brisbane,Australia,2007,2,112,269,8,1,668,1297,18,556,1028,10,37.111111111111114,>30,AUS,Home,Upto 2014
B Lee,AUS,Pace,2007-11-16,Hobart,Australia,2007,2,169,299,8,1,932,1457,19,763,1158,11,49.05263157894737,>30,AUS,Home,Upto 2014
B Lee,AUS,Pace,2007-12-26,Melbourne,Australia,2007,2,89,203,6,1,517,1047,21,428,844,15,24.61904761904762,<=30,AUS,Home,Upto 2014
B Lee,AUS,Pace,2008-01-02,Sydney,Australia,2008,2,153,272,7,1,803,1292,17,650,1020,10,47.23529411764706,>30,AUS,Home,Upto 2014
B Lee,AUS,Pace,2008-01-16,W.A.C.A,Australia,2008,2,125,268,6,1,844,1397,31,719,1129,25,27.225806451612904,<=30,AUS,Home,Upto 2014
B Lee,AUS,Pace,2008-01-24,Adelaide,Australia,2008,2,175,378,5,1,710,1457,17,535,1079,12,41.76470588235294,>30,AUS,Home,Upto 2014
B Lee,AUS,Pace,2008-05-22,Kingston,West Indies,2008,2,144,300,5,1,802,1720,34,658,1420,29,23.58823529411765,<=30,WI,Away,Upto 2014
B Lee,AUS,Pace,2008-05-30,North Sound,West Indies,2008,2,110,252,8,1,984,1871,24,874,1619,16,41.0,>30,WI,Away,Upto 2014
B Lee,AUS,Pace,2008-06-12,Bridgetown,West Indies,2008,2,173,244,5,1,809,1396,25,636,1152,20,32.36,>30,WI,Away,Upto 2014
B Lee,AUS,Pace,2008-10-09,Bengaluru,India,2008,2,90,222,2,1,560,1289,24,470,1067,22,23.333333333333332,<=30,IND,Away,Upto 2014
B Lee,AUS,Pace,2008-10-17,Mohali,India,2008,2,147,228,2,1,846,1398,17,699,1170,15,49.76470588235294,>30,IND,Away,Upto 2014
B Lee,AUS,Pace,2008-10-29,Delhi,India,2008,2,167,282,3,1,697,1278,10,530,996,7,69.7,>30,IND,Away,Upto 2014
B Lee,AUS,Pace,2008-11-06,Nagpur,India,2008,2,89,156,1,1,502,1096,12,413,940,11,41.833333333333336,>30,IND,Away,Upto 2014
B Lee,AUS,Pace,2008-11-20,Brisbane,Australia,2008,2,91,150,3,1,700,1373,36,609,1223,33,19.444444444444443,<=30,AUS,Home,Upto 2014
B Lee,AUS,Pace,2008-11-28,Adelaide,Australia,2008,2,171,303,9,1,688,1276,20,517,973,11,34.4,>30,AUS,Home,Upto 2014
B Lee,AUS,Pace,2008-12-17,W.A.C.A,Australia,2008,2,132,288,1,1,940,1782,28,808,1494,27,33.57142857142857,>30,AUS,Home,Upto 2014
B Lee,AUS,Pace,2008-12-26,Melbourne,Australia,2008,2,117,138,0,1,952,1716,26,835,1578,26,36.61538461538461,>30,AUS,Home,Upto 2014
B Mavuta,ZIM,Spin,2018-11-03,Sylhet,Bangladesh,2018,2,48,96,4,1,549,1328,32,501,1232,28,17.15625,<=30,BAN,Away,After 1965
B Mavuta,ZIM,Spin,2018-11-11,Mirpur,Bangladesh,2018,2,189,240,0,1,819,1414,17,630,1174,17,48.1764705882353,>30,BAN,Away,After 1965
B Mavuta,ZIM,Spin,2023-02-04,Bulawayo,Zimbabwe,2023,2,170,282,5,1,573,1170,18,403,888,13,31.833333333333332,>30,ZIM,Home,After 1965
B Mavuta,ZIM,Spin,2023-02-12,Bulawayo,Zimbabwe,2023,1,73,144,3,1,284,566,18,211,422,15,15.777777777777779,<=30,ZIM,Home,After 1965
B Mavuta,ZIM,Spin,2024-12-26,Bulawayo,Zimbabwe,2024,1,152,240,0,1,1189,1856,20,1037,1616,20,59.45,>30,ZIM,Home,After 1965
B Mitchell,SA,Spin,1929-06-15,Birmingham,England,1929,1,10,12,0,1,416,1126,6,406,1114,6,69.33333333333333,>30,ENG,Away,Upto 2014
B Mitchell,SA,Spin,1929-06-29,Lord's,England,1929,1,19,24,0,1,382,1002,11,363,978,11,34.72727272727273,>30,ENG,Away,Upto 2014
B Mitchell,SA,Spin,1929-07-13,Leeds,England,1929,2,51,82,1,1,624,1466,25,573,1384,24,24.96,<=30,ENG,Away,Upto 2014
B Mitchell,SA,Spin,1929-07-27,Manchester,England,1929,1,21,48,1,1,374,874,16,353,826,15,23.375,<=30,ENG,Away,Upto 2014
B Mitchell,SA,Spin,1929-08-17,The Oval,England,1929,1,17,24,0,1,557,1110,10,540,1086,10,55.7,>30,ENG,Away,Upto 2014
B Mitchell,SA,Spin,1931-01-01,Cape Town,South Africa,1931,1,20,48,0,1,731,1678,19,711,1630,19,38.473684210526315,>30,SA,Home,Upto 2014
B Mitchell,SA,Spin,1931-02-21,Durban,South Africa,1931,1,18,6,0,1,436,1147,20,418,1141,20,21.8,<=30,SA,Home,Upto 2014
B Mitchell,SA,Spin,1931-12-18,Sydney,Australia,1931,1,8,6,0,1,364,897,16,356,891,16,22.75,<=30,AUS,Away,Upto 2014
B Mitchell,SA,Spin,1932-02-27,Christchurch,New Zealand,1932,2,37,52,2,1,356,669,15,319,617,13,23.733333333333334,<=30,NZ,Away,Upto 2014
B Mitchell,SA,Spin,1932-03-04,Wellington,New Zealand,1932,1,23,29,2,1,627,1075,19,604,1046,17,33.0,>30,NZ,Away,Upto 2014
B Mitchell,SA,Spin,1935-06-15,Nottingham,England,1935,1,66,132,1,1,343,876,8,277,744,7,42.875,>30,ENG,Away,Upto 2014
B Mitchell,SA,Spin,1935-06-29,Lord's,England,1935,1,11,12,0,1,484,1320,22,473,1308,22,22.0,<=30,ENG,Away,Upto 2014
B Mitchell,SA,Spin,1935-07-13,Leeds,England,1935,1,30,36,0,1,260,741,11,230,705,11,23.636363636363637,<=30,ENG,Away,Upto 2014
B Mitchell,SA,Spin,1935-07-27,Manchester,England,1935,1,11,6,0,1,449,1029,11,438,1023,11,40.81818181818182,>30,ENG,Away,Upto 2014
B Mitchell,SA,Spin,1935-08-17,The Oval,England,1935,1,36,48,1,1,498,864,8,462,816,7,62.25,>30,ENG,Away,Upto 2014
B Mitchell,SA,Spin,1935-12-14,Durban,South Africa,1935,2,72,144,0,1,684,1775,22,612,1631,22,31.09090909090909,>30,SA,Home,Upto 2014
B Mitchell,SA,Spin,1935-12-24,Johannesburg,South Africa,1935,2,99,135,5,1,577,1226,18,478,1091,13,32.05555555555556,>30,SA,Home,Upto 2014
B Mitchell,SA,Spin,1936-01-01,Cape Town,South Africa,1936,1,19,24,0,1,468,1146,24,449,1122,24,19.5,<=30,SA,Home,Upto 2014
B Mitchell,SA,Spin,1936-02-15,Johannesburg,South Africa,1936,1,53,90,0,1,374,819,19,321,729,19,19.68421052631579,<=30,SA,Home,Upto 2014
B Mitchell,SA,Spin,1936-02-28,Durban,South Africa,1936,1,87,155,5,1,543,1530,23,456,1375,18,23.608695652173914,<=30,SA,Home,Upto 2014
B Mitchell,SA,Spin,1938-12-24,Johannesburg,South Africa,1938,2,133,264,3,1,478,1422,15,345,1158,12,31.866666666666667,>30,SA,Home,Upto 2014
B Mitchell,SA,Spin,1938-12-31,Cape Town,South Africa,1938,1,81,160,0,1,556,1422,11,475,1262,11,50.54545454545455,>30,SA,Home,Upto 2014
B Mitchell,SA,Spin,1939-01-20,Durban,South Africa,1939,1,45,64,0,1,407,989,9,362,925,9,45.22222222222222,>30,SA,Home,Upto 2014
B Mitchell,SA,Spin,1939-02-18,Johannesburg,South Africa,1939,2,79,192,2,1,359,773,7,280,581,5,51.285714285714285,>30,SA,Home,Upto 2014
B Mitchell,SA,Spin,1939-03-03,Durban,South Africa,1939,2,153,352,1,1,794,1998,16,641,1646,15,49.625,>30,SA,Home,Upto 2014
B Mitchell,SA,Spin,1947-07-26,Leeds,England,1947,1,5,12,0,1,420,1282,10,415,1270,10,42.0,>30,ENG,Away,Upto 2014
B Mitchell,SA,Spin,1948-12-27,Johannesburg,South Africa,1948,1,79,144,1,1,725,1588,13,646,1444,12,55.76923076923077,>30,SA,Home,Upto 2014
B Mitchell,SA,Spin,1949-01-01,Cape Town,South Africa,1949,2,43,104,1,1,568,1444,18,525,1340,17,31.555555555555557,>30,SA,Home,Upto 2014
B Mitchell,SA,Spin,1949-02-12,Johannesburg,South Africa,1949,2,28,80,1,1,470,1288,10,442,1208,9,47.0,>30,SA,Home,Upto 2014
B Mitchell,SA,Spin,1949-03-05,Gqeberha,South Africa,1949,1,26,40,0,1,750,1935,20,724,1895,20,37.5,>30,SA,Home,Upto 2014
B Muzarabani,ZIM,Pace,2017-12-26,Gqeberha,South Africa,2017,1,48,78,0,1,327,664,21,279,586,21,15.571428571428571,<=30,SA,Away,After 1965
B Muzarabani,ZIM,Pace,2021-03-02,Abu Dhabi,UAE,2021,2,62,120,6,1,239,474,18,177,354,12,13.277777777777779,<=30,UAE,Away,After 1965
B Muzarabani,ZIM,Pace,2021-03-10,Abu Dhabi,UAE,2021,2,87,211,2,1,415,797,6,328,586,4,69.16666666666667,>30,UAE,Away,After 1965
B Muzarabani,ZIM,Pace,2021-04-29,Harare,Zimbabwe,2021,1,73,186,4,1,469,921,23,396,735,19,20.391304347826086,<=30,ZIM,Home,After 1965
B Muzarabani,ZIM,Pace,2021-05-07,Harare,Zimbabwe,2021,1,82,174,3,1,481,1050,18,399,876,15,26.72222222222222,<=30,ZIM,Home,After 1965
B Muzarabani,ZIM,Pace,2021-07-07,Harare,Zimbabwe,2021,2,121,246,4,1,697,1302,16,576,1056,12,43.5625,>30,ZIM,Home,After 1965
B Muzarabani,ZIM,Pace,2024-07-25,Belfast,Northern Ireland,2024,2,105,180,5,1,610,1116,26,505,936,21,23.46153846153846,<=30,Northern Ireland,Away,After 1965
B Muzarabani,ZIM,Pace,2024-12-26,Bulawayo,Zimbabwe,2024,1,52,168,1,1,179,342,3,127,174,2,59.666666666666664,>30,ZIM,Home,After 1965
B Muzarabani,ZIM,Pace,2025-01-02,Bulawayo,Zimbabwe,2025,2,151,246,8,1,331,653,15,180,407,7,22.066666666666666,<=30,ZIM,Home,After 1965
B Sutcliffe,NZ,Spin,1949-06-11,Leeds,England,1949,1,17,24,1,1,545,1101,10,528,1077,9,54.5,>30,ENG,Away,Upto 2014
B Sutcliffe,NZ,Spin,1949-06-25,Lord's,England,1949,2,56,102,0,1,624,1342,19,568,1240,19,32.8421052631579,>30,ENG,Away,Upto 2014
B Sutcliffe,NZ,Spin,1949-07-23,Manchester,England,1949,1,22,30,0,1,586,1224,13,564,1194,13,45.07692307692308,>30,ENG,Away,Upto 2014
B Sutcliffe,NZ,Spin,1952-02-15,Auckland,New Zealand,1952,1,1,6,0,1,442,1192,12,441,1186,12,36.833333333333336,>30,NZ,Home,Upto 2014
B Sutcliffe,NZ,Spin,1953-03-06,Wellington,New Zealand,1953,1,4,6,0,1,540,1494,12,536,1488,12,45.0,>30,NZ,Home,Upto 2014
B Sutcliffe,NZ,Spin,1954-01-01,Cape Town,South Africa,1954,2,46,96,0,1,639,1815,13,593,1719,13,49.15384615384615,>30,SA,Away,Upto 2014
B Sutcliffe,NZ,Spin,1955-10-26,Lahore,Pakistan,1955,1,4,9,1,1,672,1787,23,668,1778,22,29.217391304347824,<=30,PAK,Away,Upto 2014
B Sutcliffe,NZ,Spin,1955-11-19,Hyderabad (Deccan),India,1955,1,36,54,0,1,665,1888,11,629,1834,11,60.45454545454545,>30,IND,Away,Upto 2014
B Sutcliffe,NZ,Spin,1955-12-02,Brabourne,India,1955,1,9,12,0,1,470,1277,17,461,1265,17,27.647058823529413,<=30,IND,Away,Upto 2014
B Sutcliffe,NZ,Spin,1955-12-16,Delhi,India,1955,1,8,18,0,1,540,1398,4,532,1380,4,135.0,>30,IND,Away,Upto 2014
B Sutcliffe,NZ,Spin,1955-12-28,Eden Gardens,India,1955,1,28,42,0,1,462,1292,19,434,1250,19,24.31578947368421,<=30,IND,Away,Upto 2014
B Sutcliffe,NZ,Spin,1956-02-18,Christchurch,New Zealand,1956,1,16,12,0,1,464,1136,24,448,1124,24,19.333333333333332,<=30,NZ,Home,Upto 2014
B Sutcliffe,NZ,Spin,1959-02-27,Christchurch,New Zealand,1959,1,9,12,0,1,315,1017,18,306,1005,18,17.5,<=30,NZ,Home,Upto 2014
B Sutcliffe,NZ,Spin,1959-03-14,Auckland,New Zealand,1959,1,2,6,0,1,206,465,5,204,459,5,41.2,>30,NZ,Home,Upto 2014
B Sutcliffe,NZ,Spin,1965-03-05,Eden Gardens,India,1965,1,14,18,0,1,632,1531,17,618,1513,17,37.1764705882353,>30,IND,Away,Upto 2014
B Sutcliffe,NZ,Spin,1965-03-12,Brabourne,India,1965,1,30,24,0,1,545,1316,11,515,1292,11,49.54545454545455,>30,IND,Away,Upto 2014
B Sutcliffe,NZ,Spin,1965-03-19,Delhi,India,1965,1,4,1,0,1,716,1840,21,712,1839,21,34.095238095238095,>30,IND,Away,Upto 2014
B Sutcliffe,NZ,Spin,1965-04-02,Lahore,Pakistan,1965,1,38,66,2,1,697,1836,15,659,1770,13,46.46666666666667,>30,PAK,Away,Upto 2014
B Warnapura,SL,Pace,1982-02-17,Colombo (PSS),Sri Lanka,1982,2,10,24,0,1,292,600,11,282,576,11,26.545454545454547,<=30,SL,Home,Upto 2014
B Warnapura,SL,Pace,1982-03-05,Karachi,Pakistan,1982,1,9,12,0,1,440,708,10,431,696,10,44.0,>30,PAK,Away,Upto 2014
B Warnapura,SL,Pace,1982-09-17,Chennai,India,1982,1,27,54,0,1,686,896,18,659,842,18,38.111111111111114,>30,IND,Away,Upto 2014
B White,IRE,Spin,2023-04-04,Mirpur,Bangladesh,2023,2,114,123,3,1,595,1200,23,481,1077,20,25.869565217391305,<=30,BAN,Away,After 1965
B White,IRE,Spin,2023-04-16,Galle,Sri Lanka,2023,1,119,132,1,1,643,1027,18,524,895,17,35.72222222222222,>30,SL,Away,After 1965
B White,IRE,Spin,2023-04-24,Galle,Sri Lanka,2023,1,203,204,0,1,963,1611,14,760,1407,14,68.78571428571429,>30,SL,Away,After 1965
B Wood,ENG,Pace,1972-12-20,Delhi,India,1972,1,13,12,0,1,207,536,11,194,524,11,18.818181818181817,<=30,IND,Away,Upto 2014
B Wood,ENG,Pace,1975-02-28,Christchurch,New Zealand,1975,1,19,32,0,1,449,1000,7,430,968,7,64.14285714285714,>30,NZ,Away,Upto 2014
B Wood,ENG,Pace,1975-07-31,Lord's,England,1975,1,6,6,0,1,808,1552,18,802,1546,18,44.888888888888886,>30,ENG,Home,Upto 2014
B Wood,ENG,Pace,1975-08-14,Leeds,England,1975,1,10,30,0,1,612,1447,21,602,1417,21,29.142857142857142,<=30,ENG,Home,Upto 2014
B Wood,ENG,Pace,1978-06-01,Birmingham,England,1978,1,2,18,0,1,618,1454,19,616,1436,19,32.526315789473685,>30,ENG,Home,Upto 2014
B Yardley,AUS,Spin,1978-01-28,Adelaide,Australia,1978,2,196,528,4,1,820,1960,16,624,1432,12,51.25,>30,AUS,Home,Upto 2014
B Yardley,AUS,Spin,1978-03-03,Port of Spain,West Indies,1978,1,64,114,3,1,269,461,9,205,347,6,29.88888888888889,<=30,WI,Away,Upto 2014
B Yardley,AUS,Spin,1978-03-17,Bridgetown,West Indies,1978,2,67,77,0,1,226,371,4,159,294,4,56.5,>30,WI,Away,Upto 2014
B Yardley,AUS,Spin,1978-03-31,Georgetown,West Indies,1978,1,96,180,3,1,414,708,7,318,528,4,59.142857142857146,>30,WI,Away,Upto 2014
B Yardley,AUS,Spin,1978-04-15,Port of Spain,West Indies,1978,2,88,290,5,1,493,1205,23,405,915,18,21.434782608695652,<=30,WI,Away,Upto 2014
B Yardley,AUS,Spin,1978-04-28,Kingston,West Indies,1978,2,62,258,4,1,606,1484,19,544,1226,15,31.894736842105264,>30,WI,Away,Upto 2014
B Yardley,AUS,Spin,1978-12-01,Brisbane,Australia,1978,2,75,160,1,1,206,680,3,131,520,2,68.66666666666667,>30,AUS,Home,Upto 2014
B Yardley,AUS,Spin,1978-12-15,W.A.C.A,Australia,1978,2,103,312,4,1,155,496,8,52,184,4,19.375,<=30,AUS,Home,Upto 2014
B Yardley,AUS,Spin,1979-01-27,Adelaide,Australia,1979,2,85,192,0,1,239,776,7,154,584,7,34.142857142857146,>30,AUS,Home,Upto 2014
B Yardley,AUS,Spin,1979-02-10,Sydney,Australia,1979,2,126,242,2,1,364,1147,19,238,905,17,19.157894736842106,<=30,AUS,Home,Upto 2014
B Yardley,AUS,Spin,1979-03-24,W.A.C.A,Australia,1979,2,94,224,1,1,123,288,2,29,64,1,61.5,>30,AUS,Home,Upto 2014
B Yardley,AUS,Spin,1979-09-19,Bengaluru,India,1979,1,107,264,4,1,418,1101,14,311,837,10,29.857142857142858,<=30,IND,Away,Upto 2014
B Yardley,AUS,Spin,1979-10-02,Kanpur,India,1979,2,136,360,2,1,449,1116,12,313,756,10,37.416666666666664,>30,IND,Away,Upto 2014
B Yardley,AUS,Spin,1979-10-26,Eden Gardens,India,1979,2,138,330,4,1,581,1386,14,443,1056,10,41.5,>30,IND,Away,Upto 2014
B Yardley,AUS,Spin,1981-01-23,Adelaide,Australia,1981,2,115,412,3,1,543,1406,16,428,994,13,33.9375,>30,AUS,Home,Upto 2014
B Yardley,AUS,Spin,1981-02-07,Melbourne,Australia,1981,2,110,264,4,1,474,1128,11,364,864,7,43.09090909090909,>30,AUS,Home,Upto 2014
B Yardley,AUS,Spin,1981-11-13,W.A.C.A,Australia,1981,1,84,155,6,1,231,461,11,147,306,5,21.0,<=30,AUS,Home,Upto 2014
B Yardley,AUS,Spin,1981-11-27,Brisbane,Australia,1981,2,128,234,5,1,312,546,7,184,312,2,44.57142857142857,>30,AUS,Home,Upto 2014
B Yardley,AUS,Spin,1981-12-11,Melbourne,Australia,1981,1,187,396,7,1,491,1248,15,304,852,8,32.733333333333334,>30,AUS,Home,Upto 2014
B Yardley,AUS,Spin,1981-12-26,Melbourne,Australia,1981,2,61,168,5,1,78,198,5,17,30,0,15.6,<=30,AUS,Home,Upto 2014
B Yardley,AUS,Spin,1982-01-02,Sydney,Australia,1982,2,185,348,10,1,278,654,13,93,306,3,21.384615384615383,<=30,AUS,Home,Upto 2014
B Yardley,AUS,Spin,1982-01-30,Adelaide,Australia,1982,2,200,341,5,1,305,605,5,105,264,0,61.0,>30,AUS,Home,Upto 2014
B Yardley,AUS,Spin,1982-02-26,Wellington,New Zealand,1982,1,49,138,3,1,49,138,3,0,0,0,16.333333333333332,<=30,NZ,Away,Upto 2014
B Yardley,AUS,Spin,1982-03-12,Auckland,New Zealand,1982,2,182,382,6,1,260,652,9,78,270,3,28.88888888888889,<=30,NZ,Away,Upto 2014
B Yardley,AUS,Spin,1982-03-19,Christchurch,New Zealand,1982,1,80,162,4,1,110,255,7,30,93,3,15.714285714285714,<=30,NZ,Away,Upto 2014
B Yardley,AUS,Spin,1982-09-22,Karachi,Pakistan,1982,2,107,156,1,1,480,981,15,373,825,14,32.0,>30,PAK,Away,Upto 2014
B Yardley,AUS,Spin,1982-10-14,Lahore,Pakistan,1982,1,102,162,1,1,305,636,6,203,474,5,50.833333333333336,>30,PAK,Away,Upto 2014
B Yardley,AUS,Spin,1982-11-12,W.A.C.A,Australia,1982,2,208,502,8,1,325,796,12,117,294,4,27.083333333333332,<=30,AUS,Home,Upto 2014
B Yardley,AUS,Spin,1982-11-26,Brisbane,Australia,1982,2,101,346,2,1,274,868,5,173,522,3,54.8,>30,AUS,Home,Upto 2014
B Yardley,AUS,Spin,1982-12-10,Adelaide,Australia,1982,2,142,348,3,1,299,810,4,157,462,1,74.75,>30,AUS,Home,Upto 2014
B Yardley,AUS,Spin,1982-12-26,Melbourne,Australia,1982,2,156,252,4,1,230,438,8,74,186,4,28.75,<=30,AUS,Home,Upto 2014
B Yardley,AUS,Spin,1983-01-02,Sydney,Australia,1983,2,186,306,5,1,585,1269,15,399,963,10,39.0,>30,AUS,Home,Upto 2014
B Yardley,AUS,Spin,1983-04-22,Kandy,Sri Lanka,1983,2,166,306,7,1,499,919,15,333,613,8,33.266666666666666,>30,SL,Away,Upto 2014
B Yograj Singh,IND,Pace,1981-02-21,Wellington,New Zealand,1981,1,63,90,1,1,725,1705,33,662,1615,32,21.96969696969697,<=30,NZ,Away,Upto 2014
BA Carse,ENG,Spin,2024-10-07,Multan,Pakistan,2024,2,140,228,4,1,918,1193,16,778,965,12,57.375,>30,PAK,Away,After 1965
BA Carse,ENG,Spin,2024-10-15,Multan,Pakistan,2024,2,79,174,5,1,831,1418,37,752,1244,32,22.45945945945946,<=30,PAK,Away,After 1965
BA Carse,ENG,Spin,2024-11-28,Christchurch,New Zealand,2024,2,106,229,10,1,459,659,17,353,430,7,27.0,<=30,NZ,Away,After 1965
BA Carse,ENG,Spin,2024-12-06,Wellington,New Zealand,2024,2,99,126,6,1,476,526,13,377,400,7,36.61538461538461,>30,NZ,Away,After 1965
BA Carse,ENG,Spin,2024-12-14,Hamilton,New Zealand,2024,2,112,180,2,1,463,592,15,351,412,13,30.866666666666667,>30,NZ,Away,After 1965
BA Edgar,NZ,Spin,1984-01-20,Wellington,New Zealand,1984,1,3,18,0,1,205,579,4,202,561,4,51.25,>30,NZ,Home,Upto 2014
BA Murphy,ZIM,Spin,2000-03-16,Port of Spain,West Indies,2000,2,55,172,4,1,105,340,7,50,168,3,15.0,<=30,WI,Away,Upto 2014
BA Murphy,ZIM,Spin,2000-03-24,Kingston,West Indies,2000,1,99,216,2,1,234,532,3,135,316,1,78.0,>30,WI,Away,Upto 2014
BA Murphy,ZIM,Spin,2000-05-18,Lord's,England,2000,1,57,150,1,1,57,150,1,0,0,0,57.0,>30,ENG,Away,Upto 2014
BA Murphy,ZIM,Spin,2000-06-01,Nottingham,England,2000,2,55,146,2,1,131,266,2,76,120,0,65.5,>30,ENG,Away,Upto 2014
BA Murphy,ZIM,Spin,2000-11-18,Delhi,India,2000,2,146,282,1,1,622,1309,9,476,1027,8,69.11111111111111,>30,IND,Away,Upto 2014
BA Murphy,ZIM,Spin,2000-11-25,Nagpur,India,2000,1,175,245,2,1,810,1427,12,635,1182,10,67.5,>30,IND,Away,Upto 2014
BA Murphy,ZIM,Spin,2000-12-26,Wellington,New Zealand,2000,2,214,384,2,1,458,942,3,244,558,1,152.66666666666666,>30,NZ,Away,Upto 2014
BA Murphy,ZIM,Spin,2001-04-19,Bulawayo,Zimbabwe,2001,2,62,126,1,1,136,274,2,74,148,1,68.0,>30,ZIM,Home,Upto 2014
BA Murphy,ZIM,Spin,2001-06-07,Bulawayo,Zimbabwe,2001,2,132,208,1,1,315,644,5,183,436,4,63.0,>30,ZIM,Home,Upto 2014
BA Murphy,ZIM,Spin,2001-06-15,Harare,Zimbabwe,2001,2,59,116,2,1,185,428,8,126,312,6,23.125,<=30,ZIM,Home,Upto 2014
BA Murphy,ZIM,Spin,2001-11-08,Dhaka,Bangladesh,2001,2,59,108,0,1,256,612,4,197,504,4,64.0,>30,BAN,Away,Upto 2014
BA Pocock,NZ,Spin,1993-11-12,W.A.C.A,Australia,1993,1,10,12,0,1,339,721,5,329,709,5,67.8,>30,AUS,Away,Upto 2014
BA Pocock,NZ,Spin,1997-02-06,Wellington,New Zealand,1997,1,10,12,0,1,215,621,7,205,609,7,30.714285714285715,>30,NZ,Home,Upto 2014
BA Reid,AUS,Pace,1985-12-13,Adelaide,Australia,1985,1,113,318,4,1,620,1368,17,507,1050,13,36.470588235294116,>30,AUS,Home,Upto 2014
BA Reid,AUS,Pace,1985-12-26,Melbourne,Australia,1985,2,123,278,6,1,429,932,13,306,654,7,33.0,>30,AUS,Home,Upto 2014
BA Reid,AUS,Pace,1986-01-02,Sydney,Australia,1986,1,89,204,1,1,382,756,4,293,552,3,95.5,>30,AUS,Home,Upto 2014
BA Reid,AUS,Pace,1986-02-21,Wellington,New Zealand,1986,1,104,186,3,1,687,1390,14,583,1204,11,49.07142857142857,>30,NZ,Away,Upto 2014
BA Reid,AUS,Pace,1986-02-28,Christchurch,New Zealand,1986,2,97,231,4,1,712,1681,22,615,1450,18,32.36363636363637,>30,NZ,Away,Upto 2014
BA Reid,AUS,Pace,1986-03-13,Auckland,New Zealand,1986,2,93,190,2,1,481,1210,15,388,1020,13,32.06666666666667,>30,NZ,Away,Upto 2014
BA Reid,AUS,Pace,1986-09-18,Chennai,India,1986,2,141,168,1,1,433,618,3,292,450,2,144.33333333333334,>30,IND,Away,Upto 2014
BA Reid,AUS,Pace,1986-10-15,Wankhede,India,1986,1,81,192,0,1,351,666,3,270,474,3,117.0,>30,IND,Away,Upto 2014
BA Reid,AUS,Pace,1986-11-14,Brisbane,Australia,1986,2,106,222,2,1,755,1483,27,649,1261,25,27.962962962962962,<=30,AUS,Home,Upto 2014
BA Reid,AUS,Pace,1986-11-28,W.A.C.A,Australia,1986,2,173,366,7,1,963,1802,22,790,1436,15,43.77272727272727,>30,AUS,Home,Upto 2014
BA Reid,AUS,Pace,1986-12-12,Adelaide,Australia,1986,1,64,172,4,1,567,1198,11,503,1026,7,51.54545454545455,>30,AUS,Home,Upto 2014
BA Reid,AUS,Pace,1986-12-26,Melbourne,Australia,1986,1,78,168,4,1,497,1065,22,419,897,18,22.59090909090909,<=30,AUS,Home,Upto 2014
BA Reid,AUS,Pace,1987-01-10,Sydney,Australia,1987,2,106,264,3,1,483,1157,14,377,893,11,34.5,>30,AUS,Home,Upto 2014
BA Reid,AUS,Pace,1987-12-04,Brisbane,Australia,1987,2,93,300,6,1,634,1568,27,541,1268,21,23.48148148148148,<=30,AUS,Home,Upto 2014
BA Reid,AUS,Pace,1987-12-11,Adelaide,Australia,1987,1,21,42,1,1,519,1199,13,498,1157,12,39.92307692307692,>30,AUS,Home,Upto 2014
BA Reid,AUS,Pace,1988-09-15,Karachi,Pakistan,1988,1,109,246,4,1,264,678,7,155,432,3,37.714285714285715,>30,PAK,Away,Upto 2014
BA Reid,AUS,Pace,1988-09-23,Faisalabad,Pakistan,1988,2,192,366,7,1,528,1164,17,336,798,10,31.058823529411764,>30,PAK,Away,Upto 2014
BA Reid,AUS,Pace,1988-10-07,Lahore,Pakistan,1988,1,53,138,3,1,344,894,11,291,756,8,31.272727272727273,>30,PAK,Away,Upto 2014
BA Reid,AUS,Pace,1990-11-23,Brisbane,Australia,1990,2,93,192,5,1,544,1327,29,451,1135,24,18.75862068965517,<=30,AUS,Home,Upto 2014
BA Reid,AUS,Pace,1990-12-26,Melbourne,Australia,1990,2,148,366,13,1,741,1809,29,593,1443,16,25.551724137931036,<=30,AUS,Home,Upto 2014
BA Reid,AUS,Pace,1991-01-04,Sydney,Australia,1991,1,79,211,3,1,621,1201,14,542,990,11,44.357142857142854,>30,AUS,Home,Upto 2014
BA Reid,AUS,Pace,1991-01-25,Adelaide,Australia,1991,2,112,312,6,1,1030,2159,28,918,1847,22,36.785714285714285,>30,AUS,Home,Upto 2014
BA Reid,AUS,Pace,1991-04-05,Port of Spain,West Indies,1991,1,79,132,1,1,449,1209,20,370,1077,19,22.45,<=30,WI,Away,Upto 2014
BA Reid,AUS,Pace,1991-04-19,Bridgetown,West Indies,1991,2,150,306,4,1,874,1849,33,724,1543,29,26.484848484848484,<=30,WI,Away,Upto 2014
BA Reid,AUS,Pace,1991-12-26,Melbourne,Australia,1991,2,126,332,12,1,732,1688,29,606,1356,17,25.24137931034483,<=30,AUS,Home,Upto 2014
BA Reid,AUS,Pace,1992-01-02,Sydney,Australia,1992,1,10,24,0,1,641,1594,19,631,1570,19,33.73684210526316,>30,AUS,Home,Upto 2014
BA Reid,AUS,Pace,1992-11-27,Brisbane,Australia,1992,2,151,318,7,1,859,1899,30,708,1581,23,28.633333333333333,<=30,AUS,Home,Upto 2014
BA Richards,SA,Spin,1970-01-22,Cape Town,South Africa,1970,1,12,36,1,1,547,1442,19,535,1406,18,28.789473684210527,<=30,SA,Home,Upto 2014
BA Richards,SA,Spin,1970-02-05,Durban,South Africa,1970,1,8,18,0,1,348,698,8,340,680,8,43.5,>30,SA,Home,Upto 2014
BA Richards,SA,Spin,1970-03-05,Gqeberha,South Africa,1970,1,6,18,0,1,276,494,3,270,476,3,92.0,>30,SA,Home,Upto 2014
BA Stokes,ENG,Pace,2013-12-05,Adelaide,Australia,2013,2,90,150,2,1,606,1290,25,516,1140,23,24.24,<=30,AUS,Away,Upto 2014
BA Stokes,ENG,Pace,2013-12-13,W.A.C.A,Australia,2013,2,145,210,3,1,995,1739,27,850,1529,24,36.851851851851855,>30,AUS,Away,Upto 2014
BA Stokes,ENG,Pace,2013-12-26,Melbourne,Australia,2013,2,96,162,2,1,653,1410,24,557,1248,22,27.208333333333332,<=30,AUS,Away,Upto 2014
BA Stokes,ENG,Pace,2014-01-03,Sydney,Australia,2014,2,161,179,8,1,663,1122,33,502,943,25,20.09090909090909,<=30,AUS,Away,After 1965
BA Stokes,ENG,Pace,2014-07-09,Nottingham,England,2014,2,141,312,2,1,984,1979,23,843,1667,21,42.78260869565217,>30,ENG,Home,After 1965
BA Stokes,ENG,Pace,2014-07-17,Lord's,England,2014,2,91,215,5,1,890,1823,32,799,1608,27,27.8125,<=30,ENG,Home,After 1965
BA Stokes,ENG,Pace,2015-04-13,North Sound,West Indies,2015,2,114,192,0,1,886,1696,22,772,1504,22,40.27272727272727,>30,WI,Away,After 1965
BA Stokes,ENG,Pace,2015-04-21,St George's,West Indies,2015,2,100,150,1,1,731,1499,18,631,1349,17,40.611111111111114,>30,WI,Away,After 1965
BA Stokes,ENG,Pace,2015-05-01,Bridgetown,West Indies,2015,2,42,42,2,1,388,896,26,346,854,24,14.923076923076923,<=30,WI,Away,After 1965
BA Stokes,ENG,Pace,2015-05-21,Lord's,England,2015,2,143,192,3,1,1185,2044,33,1042,1852,30,35.90909090909091,>30,ENG,Home,After 1965
BA Stokes,ENG,Pace,2015-05-29,Leeds,England,2015,2,131,174,1,1,1058,1587,28,927,1413,27,37.785714285714285,>30,ENG,Home,After 1965
BA Stokes,ENG,Pace,2015-07-08,Cardiff,England,2015,2,74,132,1,1,901,1488,27,827,1356,26,33.370370370370374,>30,ENG,Home,After 1965
BA Stokes,ENG,Pace,2015-07-16,Lord's,England,2015,2,97,132,0,1,791,1369,21,694,1237,21,37.666666666666664,>30,ENG,Home,After 1965
BA Stokes,ENG,Pace,2015-07-29,Birmingham,England,2015,1,28,66,1,1,619,1035,28,591,969,27,22.107142857142858,<=30,ENG,Home,After 1965
BA Stokes,ENG,Pace,2015-08-06,Nottingham,England,2015,1,36,126,6,1,542,945,29,506,819,23,18.689655172413794,<=30,ENG,Home,After 1965
BA Stokes,ENG,Pace,2015-08-20,The Oval,England,2015,1,133,174,3,1,638,1293,22,505,1119,19,29.0,<=30,ENG,Home,After 1965
BA Stokes,ENG,Pace,2015-10-13,Abu Dhabi,UAE,2015,2,66,145,4,1,582,1249,16,516,1104,12,36.375,>30,UAE,Away,After 1965
BA Stokes,ENG,Pace,2015-10-22,Dubai (DICS),UAE,2015,2,109,204,1,1,554,1207,19,445,1003,18,29.157894736842106,<=30,UAE,Away,After 1965
BA Stokes,ENG,Pace,2015-11-01,Sharjah,UAE,2015,1,23,66,0,1,278,841,14,255,775,14,19.857142857142858,<=30,UAE,Away,After 1965
BA Stokes,ENG,Pace,2015-12-26,Durban,South Africa,2015,2,51,96,1,1,593,1392,27,542,1296,26,21.962962962962962,<=30,SA,Away,After 1965
BA Stokes,ENG,Pace,2016-01-02,Cape Town,South Africa,2016,1,100,168,1,1,994,1661,14,894,1493,13,71.0,>30,SA,Away,After 1965
BA Stokes,ENG,Pace,2016-01-14,Johannesburg,South Africa,2016,2,77,157,5,1,692,1271,29,615,1114,24,23.862068965517242,<=30,SA,Away,After 1965
BA Stokes,ENG,Pace,2016-01-22,Centurion,South Africa,2016,2,122,258,5,1,827,1592,31,705,1334,26,26.677419354838708,<=30,SA,Away,After 1965
BA Stokes,ENG,Pace,2016-05-19,Leeds,England,2016,1,25,42,1,1,468,901,27,443,859,26,17.333333333333332,<=30,ENG,Home,After 1965
BA Stokes,ENG,Pace,2016-07-22,Manchester,England,2016,2,60,122,2,1,705,1279,22,645,1157,20,32.04545454545455,>30,ENG,Home,After 1965
BA Stokes,ENG,Pace,2016-10-20,Chattogram,Bangladesh,2016,2,46,153,6,1,222,543,9,176,390,3,24.666666666666668,<=30,BAN,Away,After 1965
BA Stokes,ENG,Pace,2016-10-28,Mirpur,Bangladesh,2016,2,65,138,5,1,173,288,8,108,150,3,21.625,<=30,BAN,Away,After 1965
BA Stokes,ENG,Pace,2016-11-09,Rajkot,India,2016,2,53,114,1,1,455,1020,7,402,906,6,65.0,>30,IND,Away,After 1965
BA Stokes,ENG,Pace,2016-11-17,Visakhapatnam,India,2016,2,107,162,1,1,406,876,14,299,714,13,29.0,<=30,IND,Away,After 1965
BA Stokes,ENG,Pace,2016-11-26,Mohali,India,2016,2,89,182,5,1,431,841,13,342,659,8,33.15384615384615,>30,IND,Away,After 1965
BA Stokes,ENG,Pace,2016-12-08,Wankhede,India,2016,1,32,60,0,1,329,570,3,297,510,3,109.66666666666667,>30,IND,Away,After 1965
BA Stokes,ENG,Pace,2016-12-16,Chennai,India,2016,1,76,120,1,1,437,846,9,361,726,8,48.55555555555556,>30,IND,Away,After 1965
BA Stokes,ENG,Pace,2017-07-06,Lord's,England,2017,1,53,78,0,1,720,1257,22,667,1179,22,32.72727272727273,>30,ENG,Home,After 1965
BA Stokes,ENG,Pace,2017-07-14,Nottingham,England,2017,2,111,228,4,1,739,1395,28,628,1167,24,26.392857142857142,<=30,ENG,Home,After 1965
BA Stokes,ENG,Pace,2017-07-27,The Oval,England,2017,2,77,126,3,1,850,1584,29,773,1458,26,29.310344827586206,<=30,ENG,Home,After 1965
BA Stokes,ENG,Pace,2017-08-04,Manchester,England,2017,2,60,72,0,1,698,1268,30,638,1196,30,23.266666666666666,<=30,ENG,Home,After 1965
BA Stokes,ENG,Pace,2017-08-17,Birmingham,England,2017,2,49,96,1,1,610,1081,19,561,985,18,32.10526315789474,>30,ENG,Home,After 1965
BA Stokes,ENG,Pace,2017-08-25,Leeds,England,2017,2,88,180,2,1,1027,1807,24,939,1627,22,42.791666666666664,>30,ENG,Home,After 1965
BA Stokes,ENG,Pace,2017-09-07,Lord's,England,2017,2,63,159,6,1,490,1083,30,427,924,24,16.333333333333332,<=30,ENG,Home,After 1965
BA Stokes,ENG,Pace,2018-03-30,Christchurch,New Zealand,2018,2,19,60,0,1,933,2022,34,914,1962,34,27.441176470588236,<=30,NZ,Away,After 1965
BA Stokes,ENG,Pace,2018-05-24,Lord's,England,2018,1,73,132,3,1,631,1332,28,558,1200,25,22.535714285714285,<=30,ENG,Home,After 1965
BA Stokes,ENG,Pace,2018-08-01,Birmingham,England,2018,2,113,200,6,1,700,1284,29,587,1084,23,24.137931034482758,<=30,ENG,Home,After 1965
BA Stokes,ENG,Pace,2018-08-18,Nottingham,England,2018,2,122,210,2,1,905,1711,32,783,1501,30,28.28125,<=30,ENG,Home,After 1965
BA Stokes,ENG,Pace,2018-08-30,Southampton,England,2018,2,57,114,3,1,624,1317,26,567,1203,23,24.0,<=30,ENG,Home,After 1965
BA Stokes,ENG,Pace,2018-09-07,The Oval,England,2018,2,116,174,3,1,781,1629,21,665,1455,18,37.19047619047619,>30,ENG,Home,After 1965
BA Stokes,ENG,Pace,2018-11-06,Galle,Sri Lanka,2018,2,38,72,1,1,225,432,6,187,360,5,37.5,>30,SL,Away,After 1965
BA Stokes,ENG,Pace,2018-11-14,Pallekele,Sri Lanka,2018,1,9,6,0,1,138,240,1,129,234,1,138.0,>30,SL,Away,After 1965
BA Stokes,ENG,Pace,2018-11-23,Colombo (SSC),Sri Lanka,2018,2,55,108,4,1,145,276,4,90,168,0,36.25,>30,SL,Away,After 1965
BA Stokes,ENG,Pace,2019-01-23,Bridgetown,West Indies,2019,2,140,303,6,1,635,1301,24,495,998,18,26.458333333333332,<=30,WI,Away,After 1965
BA Stokes,ENG,Pace,2019-01-31,North Sound,West Indies,2019,1,58,162,2,1,523,1214,27,465,1052,25,19.37037037037037,<=30,WI,Away,After 1965
BA Stokes,ENG,Pace,2019-02-09,Gros Islet,West Indies,2019,1,30,53,2,1,684,1370,27,654,1317,25,25.333333333333332,<=30,WI,Away,After 1965
BA Stokes,ENG,Pace,2019-08-01,Birmingham,England,2019,2,162,240,4,1,758,1453,25,596,1213,21,30.32,>30,ENG,Home,After 1965
BA Stokes,ENG,Pace,2019-08-14,Lord's,England,2019,2,33,66,0,1,589,1275,24,556,1209,24,24.541666666666668,<=30,ENG,Home,After 1965
BA Stokes,ENG,Pace,2019-08-22,Leeds,England,2019,2,101,200,4,1,629,1344,34,528,1144,30,18.5,<=30,ENG,Home,After 1965
BA Stokes,ENG,Pace,2019-09-04,Manchester,England,2019,1,66,65,0,1,783,1519,27,717,1454,27,29.0,<=30,ENG,Home,After 1965
BA Stokes,ENG,Pace,2019-11-21,Mount Maunganui,New Zealand,2019,1,74,156,2,1,805,1856,23,731,1700,21,35.0,>30,NZ,Away,After 1965
BA Stokes,ENG,Pace,2019-11-29,Hamilton,New Zealand,2019,2,94,162,0,1,881,1878,20,787,1716,20,44.05,>30,NZ,Away,After 1965
BA Stokes,ENG,Pace,2019-12-26,Centurion,South Africa,2019,1,22,48,2,1,888,1593,38,866,1545,36,23.36842105263158,<=30,SA,Away,After 1965
BA Stokes,ENG,Pace,2020-01-03,Cape Town,South Africa,2020,2,69,196,3,1,689,1635,31,620,1439,28,22.225806451612904,<=30,SA,Away,After 1965
BA Stokes,ENG,Pace,2020-01-16,Gqeberha,South Africa,2020,2,35,60,1,1,517,1029,13,482,969,12,39.76923076923077,>30,SA,Away,After 1965
BA Stokes,ENG,Pace,2020-01-24,Johannesburg,South Africa,2020,2,94,162,4,1,1022,1773,39,928,1611,35,26.205128205128204,<=30,SA,Away,After 1965
BA Stokes,ENG,Pace,2020-07-08,Southampton,England,2020,2,88,146,6,1,825,1729,32,737,1583,26,25.78125,<=30,ENG,Home,After 1965
BA Stokes,ENG,Pace,2020-07-16,Manchester,England,2020,2,59,166,3,1,747,1583,23,688,1417,20,32.47826086956522,>30,ENG,Home,After 1965
BA Stokes,ENG,Pace,2020-08-05,Manchester,England,2020,1,11,24,2,1,609,1268,24,598,1244,22,25.375,<=30,ENG,Home,After 1965
BA Stokes,ENG,Pace,2021-02-05,Chennai,India,2021,2,29,60,1,1,376,864,16,347,804,15,23.5,<=30,IND,Away,After 1965
BA Stokes,ENG,Pace,2021-02-13,Chennai,India,2021,1,16,12,0,1,192,382,7,176,370,7,27.428571428571427,<=30,IND,Away,After 1965
BA Stokes,ENG,Pace,2021-02-24,Ahmedabad,India,2021,1,19,18,0,1,124,228,2,105,210,2,62.0,>30,IND,Away,After 1965
BA Stokes,ENG,Pace,2021-03-04,Ahmedabad,India,2021,1,89,166,4,1,213,478,9,124,312,5,23.666666666666668,<=30,IND,Away,After 1965
BA Stokes,ENG,Pace,2021-12-08,Brisbane,Australia,2021,1,65,72,0,1,608,1187,25,543,1115,25,24.32,<=30,AUS,Away,After 1965
BA Stokes,ENG,Pace,2021-12-16,Adelaide,Australia,2021,2,137,162,3,1,845,1824,27,708,1662,24,31.296296296296298,>30,AUS,Away,After 1965
BA Stokes,ENG,Pace,2021-12-26,Melbourne,Australia,2021,1,47,64,1,1,423,909,26,376,845,25,16.26923076923077,<=30,AUS,Away,After 1965
BA Stokes,ENG,Pace,2022-01-05,Sydney,Australia,2022,1,37,83,0,1,798,1621,23,761,1538,23,34.69565217391305,>30,AUS,Away,After 1965
BA Stokes,ENG,Pace,2022-03-08,North Sound,West Indies,2022,2,66,246,3,1,832,1769,23,766,1523,20,36.17391304347826,>30,WI,Away,After 1965
BA Stokes,ENG,Pace,2022-03-16,Bridgetown,West Indies,2022,2,74,216,2,1,744,1535,17,670,1319,15,43.76470588235294,>30,WI,Away,After 1965
BA Stokes,ENG,Pace,2022-03-24,St George's,West Indies,2022,1,48,132,2,1,518,1435,27,470,1303,25,19.185185185185187,<=30,WI,Away,After 1965
BA Stokes,ENG,Pace,2022-06-02,Lord's,England,2022,2,48,58,1,1,722,1408,33,674,1350,32,21.87878787878788,<=30,ENG,Home,After 1965
BA Stokes,ENG,Pace,2022-06-10,Nottingham,England,2022,2,147,240,2,1,1254,1921,26,1107,1681,24,48.23076923076923,>30,ENG,Home,After 1965
BA Stokes,ENG,Pace,2022-06-23,Leeds,England,2022,1,30,24,0,1,862,1428,19,832,1404,19,45.36842105263158,>30,ENG,Home,After 1965
BA Stokes,ENG,Pace,2022-07-01,Birmingham,England,2022,2,80,149,5,1,1049,1525,30,969,1376,25,34.96666666666667,>30,ENG,Home,After 1965
BA Stokes,ENG,Pace,2022-08-17,Lord's,England,2022,1,71,108,3,1,531,875,27,460,767,24,19.666666666666668,<=30,ENG,Home,After 1965
BA Stokes,ENG,Pace,2022-08-25,Manchester,England,2022,2,47,126,4,1,514,991,25,467,865,21,20.56,<=30,ENG,Home,After 1965
BA Stokes,ENG,Pace,2022-09-08,The Oval,England,2022,1,39,78,3,1,547,897,31,508,819,28,17.64516129032258,<=30,ENG,Home,After 1965
BA Stokes,ENG,Pace,2022-12-01,Rawalpindi,Pakistan,2022,2,104,162,1,1,786,1181,21,682,1019,20,37.42857142857143,>30,PAK,Away,After 1965
BA Stokes,ENG,Pace,2022-12-17,Karachi,Pakistan,2022,1,20,48,0,1,137,318,3,117,270,3,45.666666666666664,>30,PAK,Away,After 1965
BA Stokes,ENG,Pace,2023-02-16,Mount Maunganui,New Zealand,2023,1,38,42,1,1,901,1216,34,863,1174,33,26.5,<=30,NZ,Away,After 1965
BA Stokes,ENG,Pace,2023-02-24,Wellington,New Zealand,2023,1,16,12,0,1,965,1553,25,949,1541,25,38.6,>30,NZ,Away,After 1965
BA Stokes,ENG,Pace,2023-06-16,Birmingham,England,2023,2,42,84,2,1,808,1386,24,766,1302,22,33.666666666666664,>30,ENG,Home,After 1965
BA Stokes,ENG,Pace,2023-06-28,Lord's,England,2023,2,47,90,1,1,1187,1964,35,1140,1874,34,33.91428571428571,>30,ENG,Home,After 1965
BA Stokes,ENG,Pace,2024-03-07,Dharamsala,India,2024,1,17,30,1,1,287,408,5,270,378,4,57.4,>30,IND,Away,After 1965
BA Stokes,ENG,Pace,2024-07-10,Lord's,England,2024,2,39,108,3,1,552,962,27,513,854,24,20.444444444444443,<=30,ENG,Home,After 1965
BA Stokes,ENG,Pace,2024-07-18,Nottingham,England,2024,1,61,72,1,1,1038,1453,27,977,1381,26,38.44444444444444,>30,ENG,Home,After 1965
BA Stokes,ENG,Pace,2024-07-26,Birmingham,England,2024,2,71,114,1,1,712,994,27,641,880,26,26.37037037037037,<=30,ENG,Home,After 1965
BA Stokes,ENG,Pace,2024-10-15,Multan,Pakistan,2024,2,33,60,0,1,157,284,3,124,224,3,52.333333333333336,>30,PAK,Away,After 1965
BA Stokes,ENG,Pace,2024-11-28,Christchurch,New Zealand,2024,2,89,117,0,1,709,1026,15,620,909,15,47.266666666666666,>30,NZ,Away,After 1965
BA Stokes,ENG,Pace,2024-12-06,Wellington,New Zealand,2024,2,26,62,4,1,601,832,22,575,770,18,27.318181818181817,<=30,NZ,Away,After 1965
BA Stokes,ENG,Pace,2024-12-14,Hamilton,New Zealand,2024,2,143,218,3,1,652,1099,24,509,881,21,27.166666666666668,<=30,NZ,Away,After 1965
BA Williams,AUS,Pace,2003-10-17,Sydney,Australia,2003,2,114,234,4,1,646,1058,15,532,824,11,43.06666666666667,>30,AUS,Home,Upto 2014
BA Williams,AUS,Pace,2003-12-12,Adelaide,Australia,2003,2,106,222,0,1,872,1501,19,766,1279,19,45.89473684210526,>30,AUS,Home,Upto 2014
BA Williams,AUS,Pace,2003-12-26,Melbourne,Australia,2003,2,119,252,5,1,819,1520,17,700,1268,12,48.1764705882353,>30,AUS,Home,Upto 2014
BA Williams,AUS,Pace,2004-03-24,Colombo (SSC),Sri Lanka,2004,2,67,144,0,1,527,998,13,460,854,13,40.53846153846154,>30,SL,Away,Upto 2014
BAG Murray,NZ,Spin,1968-02-29,Wellington,New Zealand,1968,1,0,6,1,1,408,1093,20,408,1087,19,20.4,<=30,NZ,Home,Upto 2014
BAW Mendis,SL,Spin,2008-07-23,Colombo (SSC),Sri Lanka,2008,2,132,275,8,1,529,1031,21,397,756,13,25.19047619047619,<=30,SL,Home,Upto 2014
BAW Mendis,SL,Spin,2008-07-31,Galle,Sri Lanka,2008,2,209,332,10,1,684,1286,30,475,954,20,22.8,<=30,SL,Home,Upto 2014
BAW Mendis,SL,Spin,2008-08-08,Colombo (PSS),Sri Lanka,2008,2,137,372,8,1,613,1402,20,476,1030,12,30.65,>30,SL,Home,Upto 2014
BAW Mendis,SL,Spin,2009-01-03,Chattogram,Bangladesh,2009,2,128,258,7,1,931,1570,27,803,1312,20,34.48148148148148,>30,BAN,Away,Upto 2014
BAW Mendis,SL,Spin,2009-02-21,Karachi,Pakistan,2009,1,157,354,1,1,883,1568,9,726,1214,8,98.11111111111111,>30,PAK,Away,Upto 2014
BAW Mendis,SL,Spin,2009-03-01,Lahore,Pakistan,2009,1,21,48,0,1,316,544,0,295,496,0,inf,>30,PAK,Away,Upto 2014
BAW Mendis,SL,Spin,2009-07-04,Galle,Sri Lanka,2009,2,116,210,2,1,354,709,16,238,499,14,22.125,<=30,SL,Home,Upto 2014
BAW Mendis,SL,Spin,2009-07-12,Colombo (PSS),Sri Lanka,2009,2,101,162,3,1,425,767,15,324,605,12,28.333333333333332,<=30,SL,Home,Upto 2014
BAW Mendis,SL,Spin,2009-08-18,Galle,Sri Lanka,2009,2,135,347,3,1,652,1329,16,517,982,13,40.75,>30,SL,Home,Upto 2014
BAW Mendis,SL,Spin,2009-11-24,Kanpur,India,2009,1,162,228,2,1,718,1197,20,556,969,18,35.9,>30,IND,Away,Upto 2014
BAW Mendis,SL,Spin,2010-07-26,Colombo (SSC),Sri Lanka,2010,1,172,378,4,1,926,1870,14,754,1492,10,66.14285714285714,>30,SL,Home,Upto 2014
BAW Mendis,SL,Spin,2010-08-03,Colombo (PSS),Sri Lanka,2010,2,174,264,2,1,813,1539,26,639,1275,24,31.26923076923077,>30,SL,Home,Upto 2014
BAW Mendis,SL,Spin,2010-11-15,Galle,Sri Lanka,2010,1,169,354,6,1,572,1048,14,403,694,8,40.857142857142854,>30,SL,Home,Upto 2014
BAW Mendis,SL,Spin,2010-11-23,Colombo (RPS),Sri Lanka,2010,2,57,117,3,1,280,519,10,223,402,7,28.0,<=30,SL,Home,Upto 2014
BAW Mendis,SL,Spin,2010-12-01,Pallekele,Sri Lanka,2010,1,78,168,2,1,152,366,6,74,198,4,25.333333333333332,<=30,SL,Home,Upto 2014
BAW Mendis,SL,Spin,2011-05-26,Cardiff,England,2011,1,66,126,1,1,338,682,10,272,556,9,33.8,>30,ENG,Away,Upto 2014
BAW Mendis,SL,Spin,2013-03-08,Galle,Sri Lanka,2013,2,175,258,2,1,1160,1920,13,985,1662,11,89.23076923076923,>30,SL,Home,Upto 2014
BAW Mendis,SL,Spin,2014-02-04,Chattogram,Bangladesh,2014,2,160,275,6,1,1153,1976,25,993,1701,19,46.12,>30,BAN,Away,After 1965
BAW Mendis,SL,Spin,2014-07-24,Colombo (SSC),Sri Lanka,2014,2,85,204,0,1,647,1745,22,562,1541,22,29.40909090909091,<=30,SL,Home,After 1965
BB Chari,ZIM,Spin,2014-11-12,Chattogram,Bangladesh,2014,1,9,12,0,1,952,1674,19,943,1662,19,50.10526315789474,>30,BAN,Away,After 1965
BB Chari,ZIM,Spin,2016-11-06,Harare,Zimbabwe,2016,1,3,6,0,1,564,968,25,561,962,25,22.56,<=30,ZIM,Home,After 1965
BB McCullum,NZ,Spin,2010-11-04,Ahmedabad,India,2010,1,18,36,0,1,781,1719,18,763,1683,18,43.388888888888886,>30,IND,Away,Upto 2014
BB McCullum,NZ,Spin,2014-11-09,Abu Dhabi,UAE,2014,2,35,67,0,1,765,1282,14,730,1215,14,54.642857142857146,>30,UAE,Away,After 1965
BB McCullum,NZ,Spin,2014-11-17,Dubai (DICS),UAE,2014,2,13,30,1,1,778,1523,22,765,1493,21,35.36363636363637,>30,UAE,Away,After 1965
BB McCullum,NZ,Spin,2014-12-26,Christchurch,New Zealand,2014,1,3,6,0,1,299,462,3,296,456,3,99.66666666666667,>30,NZ,Home,After 1965
BB McCullum,NZ,Spin,2015-11-13,W.A.C.A,Australia,2015,1,16,12,0,1,404,593,6,388,581,6,67.33333333333333,>30,AUS,Away,After 1965
BB McCullum,NZ,Spin,2016-02-20,Christchurch,New Zealand,2016,1,3,24,0,1,123,228,4,120,204,4,30.75,>30,NZ,Home,After 1965
BBM Gaskin,WI,Pace,1948-01-21,Bridgetown,West Indies,1948,2,45,126,1,1,345,968,10,300,842,9,34.5,>30,WI,Home,Upto 2014
BBM Gaskin,WI,Pace,1948-02-11,Port of Spain,West Indies,1948,2,113,348,1,1,529,1106,15,416,758,14,35.266666666666666,>30,WI,Home,Upto 2014
BC Booth,AUS,Spin,1962-12-29,Melbourne,Australia,1962,1,4,2,0,1,341,714,6,337,712,6,56.833333333333336,>30,AUS,Home,Upto 2014
BC Booth,AUS,Spin,1964-01-10,Sydney,Australia,1964,1,3,8,0,1,363,985,5,360,977,5,72.6,>30,AUS,Home,Upto 2014
BC Booth,AUS,Spin,1964-10-02,Chennai,India,1964,2,24,78,0,1,735,1918,23,711,1840,23,31.956521739130434,>30,IND,Away,Upto 2014
BC Booth,AUS,Spin,1964-10-10,Brabourne,India,1964,1,1,24,0,1,796,2173,26,795,2149,26,30.615384615384617,>30,IND,Away,Upto 2014
BC Booth,AUS,Spin,1964-10-17,Eden Gardens,India,1964,1,33,108,2,1,407,1253,16,374,1145,14,25.4375,<=30,IND,Away,Upto 2014
BC Booth,AUS,Spin,1964-10-24,Karachi,Pakistan,1964,2,33,108,1,1,840,2130,18,807,2022,17,46.666666666666664,>30,PAK,Away,Upto 2014
BC Booth,AUS,Spin,1965-03-26,Port of Spain,West Indies,1965,2,19,42,0,1,736,1898,17,717,1856,17,43.294117647058826,>30,WI,Away,Upto 2014
BC Booth,AUS,Spin,1965-05-05,Bridgetown,West Indies,1965,2,29,66,0,1,856,1946,10,827,1880,10,85.6,>30,WI,Away,Upto 2014
BC Broad,ENG,Pace,1987-12-07,Faisalabad,Pakistan,1987,1,4,6,0,1,157,324,5,153,318,5,31.4,>30,PAK,Away,Upto 2014
BC Hollioake,ENG,Pace,1997-08-07,Nottingham,England,1997,2,83,90,2,1,974,1617,31,891,1527,29,31.419354838709676,>30,ENG,Home,Upto 2014
BC Hollioake,ENG,Pace,1998-08-27,The Oval,England,1998,2,116,162,2,1,707,1308,12,591,1146,10,58.916666666666664,>30,ENG,Home,Upto 2014
BC Lara,WI,Spin,1993-01-02,Sydney,Australia,1993,1,4,12,0,1,617,1258,8,613,1246,8,77.125,>30,AUS,Away,Upto 2014
BC Lara,WI,Spin,1995-02-03,Christchurch,New Zealand,1995,1,8,24,0,1,170,372,2,162,348,2,85.0,>30,NZ,Away,Upto 2014
BC Lara,WI,Spin,1995-08-24,The Oval,England,1995,1,0,6,0,1,255,528,1,255,522,1,255.0,>30,ENG,Away,Upto 2014
BC Lara,WI,Spin,1997-03-06,Kingston,West Indies,1997,1,16,18,0,1,464,982,9,448,964,9,51.55555555555556,>30,WI,Home,Upto 2014
BC Strang,ZIM,Pace,1995-02-07,Bulawayo,Zimbabwe,1995,2,50,160,5,1,563,1357,30,513,1197,25,18.766666666666666,<=30,ZIM,Home,Upto 2014
BC Strang,ZIM,Pace,1995-02-15,Harare,Zimbabwe,1995,2,70,348,4,1,795,1808,39,725,1460,35,20.384615384615383,<=30,ZIM,Home,Upto 2014
BC Strang,ZIM,Pace,1995-10-13,Harare,Zimbabwe,1995,2,119,264,5,1,728,1549,32,609,1285,27,22.75,<=30,ZIM,Home,Upto 2014
BC Strang,ZIM,Pace,1996-01-13,Hamilton,New Zealand,1996,2,70,174,1,1,657,1344,21,587,1170,20,31.285714285714285,>30,NZ,Away,Upto 2014
BC Strang,ZIM,Pace,1996-01-20,Auckland,New Zealand,1996,2,128,351,3,1,908,2025,23,780,1674,20,39.47826086956522,>30,NZ,Away,Upto 2014
BC Strang,ZIM,Pace,1996-09-18,Colombo (SSC),Sri Lanka,1996,1,63,120,3,1,332,732,8,269,612,5,41.5,>30,SL,Away,Upto 2014
BC Strang,ZIM,Pace,1996-10-17,Sheikhupura,Pakistan,1996,1,34,60,0,1,489,1024,12,455,964,12,40.75,>30,PAK,Away,Upto 2014
BC Strang,ZIM,Pace,1996-10-24,Faisalabad,Pakistan,1996,2,73,137,3,1,475,908,25,402,771,22,19.0,<=30,PAK,Away,Upto 2014
BC Strang,ZIM,Pace,1996-12-18,Bulawayo,Zimbabwe,1996,1,54,102,0,1,665,1230,17,611,1128,17,39.11764705882353,>30,ZIM,Home,Upto 2014
BC Strang,ZIM,Pace,1997-09-18,Harare,Zimbabwe,1997,2,85,270,5,1,808,1794,25,723,1524,20,32.32,>30,ZIM,Home,Upto 2014
BC Strang,ZIM,Pace,1997-09-25,Bulawayo,Zimbabwe,1997,2,65,204,0,1,606,1326,9,541,1122,9,67.33333333333333,>30,ZIM,Home,Upto 2014
BC Strang,ZIM,Pace,1998-01-07,Kandy,Sri Lanka,1998,2,84,185,0,1,383,839,8,299,654,8,47.875,>30,SL,Away,Upto 2014
BC Strang,ZIM,Pace,1998-03-21,Harare,Zimbabwe,1998,2,85,198,3,1,727,1780,29,642,1582,26,25.06896551724138,<=30,ZIM,Home,Upto 2014
BC Strang,ZIM,Pace,1999-10-14,Harare,Zimbabwe,1999,2,101,268,2,1,535,1322,16,434,1054,14,33.4375,>30,ZIM,Home,Upto 2014
BC Strang,ZIM,Pace,1999-10-29,Bloemfontein,South Africa,1999,1,99,162,1,1,728,1549,24,629,1387,23,30.333333333333332,>30,SA,Away,Upto 2014
BC Strang,ZIM,Pace,1999-11-11,Harare,Zimbabwe,1999,1,92,228,3,1,560,1277,25,468,1049,22,22.4,<=30,ZIM,Home,Upto 2014
BC Strang,ZIM,Pace,1999-11-18,Bulawayo,Zimbabwe,1999,1,91,180,3,1,569,1220,18,478,1040,15,31.61111111111111,>30,ZIM,Home,Upto 2014
BC Strang,ZIM,Pace,1999-11-26,Harare,Zimbabwe,1999,2,72,240,2,1,681,1742,19,609,1502,17,35.8421052631579,>30,ZIM,Home,Upto 2014
BC Strang,ZIM,Pace,1999-12-04,Harare,Zimbabwe,1999,2,76,150,2,1,525,1358,25,449,1208,23,21.0,<=30,ZIM,Home,Upto 2014
BC Strang,ZIM,Pace,2000-03-24,Kingston,West Indies,2000,2,64,234,1,1,544,1582,25,480,1348,24,21.76,<=30,WI,Away,Upto 2014
BC Strang,ZIM,Pace,2000-05-18,Lord's,England,2000,1,86,162,0,1,527,1078,29,441,916,29,18.17241379310345,<=30,ENG,Away,Upto 2014
BC Strang,ZIM,Pace,2000-09-12,Bulawayo,Zimbabwe,2000,2,73,162,0,1,470,1291,13,397,1129,13,36.15384615384615,>30,ZIM,Home,Upto 2014
BC Strang,ZIM,Pace,2000-11-18,Delhi,India,2000,2,115,186,0,1,620,1261,15,505,1075,15,41.333333333333336,>30,IND,Away,Upto 2014
BC Strang,ZIM,Pace,2000-12-26,Wellington,New Zealand,2000,2,141,342,4,1,550,1397,13,409,1055,9,42.30769230769231,>30,NZ,Away,Upto 2014
BC Strang,ZIM,Pace,2001-07-19,Bulawayo,Zimbabwe,2001,1,111,270,2,1,603,1276,18,492,1006,16,33.5,>30,ZIM,Home,Upto 2014
BC Strang,ZIM,Pace,2001-07-27,Harare,Zimbabwe,2001,2,102,276,4,1,709,1347,18,607,1071,14,39.388888888888886,>30,ZIM,Home,Upto 2014
BD Julien,WI,Pace,1973-07-26,The Oval,England,1973,2,84,222,2,1,552,1154,24,468,932,22,23.0,<=30,ENG,Away,Upto 2014
BD Julien,WI,Pace,1973-08-09,Birmingham,England,1973,2,87,264,2,1,555,1416,18,468,1152,16,30.833333333333332,>30,ENG,Away,Upto 2014
BD Julien,WI,Pace,1973-08-23,Lord's,England,1973,2,95,174,3,1,497,984,19,402,810,16,26.157894736842106,<=30,ENG,Away,Upto 2014
BD Julien,WI,Pace,1974-02-02,Port of Spain,West Indies,1974,2,62,162,2,1,308,634,10,246,472,8,30.8,>30,WI,Home,Upto 2014
BD Julien,WI,Pace,1974-02-16,Kingston,West Indies,1974,2,76,186,2,1,383,780,10,307,594,8,38.3,>30,WI,Home,Upto 2014
BD Julien,WI,Pace,1974-03-06,Bridgetown,West Indies,1974,2,78,222,5,1,627,1356,14,549,1134,9,44.785714285714285,>30,WI,Home,Upto 2014
BD Julien,WI,Pace,1974-03-22,Georgetown,West Indies,1974,1,96,216,2,1,242,634,5,146,418,3,48.4,>30,WI,Home,Upto 2014
BD Julien,WI,Pace,1974-03-30,Port of Spain,West Indies,1974,2,66,258,5,1,172,537,8,106,279,3,21.5,<=30,WI,Home,Upto 2014
BD Julien,WI,Pace,1974-12-11,Delhi,India,1974,2,71,150,3,1,263,477,8,192,327,5,32.875,>30,IND,Away,Upto 2014
BD Julien,WI,Pace,1974-12-27,Eden Gardens,India,1974,2,86,174,1,1,424,954,21,338,780,20,20.19047619047619,<=30,IND,Away,Upto 2014
BD Julien,WI,Pace,1975-01-11,Chennai,India,1975,2,43,114,3,1,381,795,19,338,681,16,20.05263157894737,<=30,IND,Away,Upto 2014
BD Julien,WI,Pace,1975-01-23,Wankhede,India,1975,2,50,156,2,1,510,1022,16,460,866,14,31.875,>30,IND,Away,Upto 2014
BD Julien,WI,Pace,1975-02-15,Lahore,Pakistan,1975,2,57,136,0,1,757,1707,25,700,1571,25,30.28,>30,PAK,Away,Upto 2014
BD Julien,WI,Pace,1975-03-01,Karachi,Pakistan,1975,2,88,216,2,1,655,1306,12,567,1090,10,54.583333333333336,>30,PAK,Away,Upto 2014
BD Julien,WI,Pace,1975-12-12,W.A.C.A,Australia,1975,2,83,177,5,1,857,1286,28,774,1109,23,30.607142857142858,>30,AUS,Away,Upto 2014
BD Julien,WI,Pace,1975-12-26,Melbourne,Australia,1975,2,133,251,4,1,804,1499,27,671,1248,23,29.77777777777778,<=30,AUS,Away,Upto 2014
BD Julien,WI,Pace,1976-01-03,Sydney,Australia,1976,1,87,120,2,1,784,1539,30,697,1419,28,26.133333333333333,<=30,AUS,Away,Upto 2014
BD Julien,WI,Pace,1976-03-10,Bridgetown,West Indies,1976,2,54,114,1,1,313,600,12,259,486,11,26.083333333333332,<=30,WI,Home,Upto 2014
BD Julien,WI,Pace,1976-03-24,Port of Spain,West Indies,1976,1,63,180,0,1,260,654,5,197,474,5,52.0,>30,WI,Home,Upto 2014
BD Julien,WI,Pace,1976-04-07,Port of Spain,West Indies,1976,2,87,156,1,1,338,682,7,251,526,6,48.285714285714285,>30,WI,Home,Upto 2014
BD Julien,WI,Pace,1976-04-21,Kingston,West Indies,1976,2,66,156,0,1,382,807,9,316,651,9,42.44444444444444,>30,WI,Home,Upto 2014
BD Julien,WI,Pace,1976-06-03,Nottingham,England,1976,2,94,300,2,1,773,1761,21,679,1461,19,36.80952380952381,>30,ENG,Away,Upto 2014
BD Julien,WI,Pace,1976-06-17,Lord's,England,1976,2,74,216,0,1,584,1335,24,510,1119,24,24.333333333333332,<=30,ENG,Away,Upto 2014
BD Julien,WI,Pace,1977-03-18,Georgetown,West Indies,1977,2,88,222,1,1,1085,2006,25,997,1784,24,43.4,>30,WI,Home,Upto 2014
BD Morrison,NZ,Pace,1963-03-01,Wellington,New Zealand,1963,1,129,186,2,1,394,894,13,265,708,11,30.307692307692307,>30,NZ,Home,Upto 2014
BE Congdon,NZ,Pace,1965-03-05,Eden Gardens,India,1965,2,82,138,2,1,421,713,14,339,575,12,30.071428571428573,>30,IND,Away,Upto 2014
BE Congdon,NZ,Pace,1965-03-12,Brabourne,India,1965,2,65,156,2,1,334,847,20,269,691,18,16.7,<=30,IND,Away,Upto 2014
BE Congdon,NZ,Pace,1965-04-09,Karachi,Pakistan,1965,2,37,90,1,1,333,774,10,296,684,9,33.3,>30,PAK,Away,Upto 2014
BE Congdon,NZ,Pace,1965-05-27,Birmingham,England,1965,2,23,54,0,1,468,1202,15,445,1148,15,31.2,>30,ENG,Away,Upto 2014
BE Congdon,NZ,Pace,1965-07-08,Leeds,England,1965,1,12,24,0,1,607,1237,14,595,1213,14,43.357142857142854,>30,ENG,Away,Upto 2014
BE Congdon,NZ,Pace,1968-02-15,Dunedin,New Zealand,1968,1,6,10,0,1,426,1000,14,420,990,14,30.428571428571427,>30,NZ,Home,Upto 2014
BE Congdon,NZ,Pace,1969-09-25,Brabourne,India,1969,2,47,126,3,1,336,982,18,289,856,15,18.666666666666668,<=30,IND,Away,Upto 2014
BE Congdon,NZ,Pace,1969-10-03,Nagpur,India,1969,1,4,18,0,1,171,432,3,167,414,3,57.0,>30,IND,Away,Upto 2014
BE Congdon,NZ,Pace,1969-10-15,Hyderabad (Deccan),India,1969,2,11,50,1,1,198,715,20,187,665,19,9.9,<=30,IND,Away,Upto 2014
BE Congdon,NZ,Pace,1969-10-24,Karachi,Pakistan,1969,1,14,48,0,1,167,468,6,153,420,6,27.833333333333332,<=30,PAK,Away,Upto 2014
BE Congdon,NZ,Pace,1969-10-30,Lahore,Pakistan,1969,2,32,108,2,1,161,587,12,129,479,10,13.416666666666666,<=30,PAK,Away,Upto 2014
BE Congdon,NZ,Pace,1969-11-08,Dhaka,Bangladesh,1969,1,41,84,0,1,262,729,8,221,645,8,32.75,>30,BAN,Away,Upto 2014
BE Congdon,NZ,Pace,1971-02-25,Christchurch,New Zealand,1971,1,11,24,0,1,205,688,11,194,664,11,18.636363636363637,<=30,NZ,Home,Upto 2014
BE Congdon,NZ,Pace,1971-03-05,Auckland,New Zealand,1971,1,18,16,1,1,561,1413,20,543,1397,19,28.05,<=30,NZ,Home,Upto 2014
BE Congdon,NZ,Pace,1972-02-16,Kingston,West Indies,1972,2,100,204,3,1,643,1221,11,543,1017,8,58.45454545454545,>30,WI,Away,Upto 2014
BE Congdon,NZ,Pace,1972-03-09,Port of Spain,West Indies,1972,2,56,240,3,1,314,919,14,258,679,11,22.428571428571427,<=30,WI,Away,Upto 2014
BE Congdon,NZ,Pace,1972-03-23,Bridgetown,West Indies,1972,2,92,282,4,1,605,1337,20,513,1055,16,30.25,>30,WI,Away,Upto 2014
BE Congdon,NZ,Pace,1972-04-06,Georgetown,West Indies,1972,1,86,198,2,1,457,1170,6,371,972,4,76.16666666666667,>30,WI,Away,Upto 2014
BE Congdon,NZ,Pace,1972-04-20,Port of Spain,West Indies,1972,2,112,276,1,1,397,954,17,285,678,16,23.352941176470587,<=30,WI,Away,Upto 2014
BE Congdon,NZ,Pace,1973-02-02,Wellington,New Zealand,1973,2,56,96,0,1,687,1320,19,631,1224,19,36.1578947368421,>30,NZ,Home,Upto 2014
BE Congdon,NZ,Pace,1973-02-07,Dunedin,New Zealand,1973,1,72,136,1,1,333,648,6,261,512,5,55.5,>30,NZ,Home,Upto 2014
BE Congdon,NZ,Pace,1973-02-16,Auckland,New Zealand,1973,2,92,221,4,1,643,1420,15,551,1199,11,42.86666666666667,>30,NZ,Home,Upto 2014
BE Congdon,NZ,Pace,1973-06-07,Nottingham,England,1973,2,40,94,1,1,817,1990,27,777,1896,26,30.25925925925926,>30,ENG,Away,Upto 2014
BE Congdon,NZ,Pace,1973-06-21,Lord's,England,1973,2,29,78,0,1,777,1763,19,748,1685,19,40.89473684210526,>30,ENG,Away,Upto 2014
BE Congdon,NZ,Pace,1973-07-05,Leeds,England,1973,1,54,192,2,1,624,1466,29,570,1274,27,21.517241379310345,<=30,ENG,Away,Upto 2014
BE Congdon,NZ,Pace,1973-12-29,Melbourne,Australia,1973,1,31,69,2,1,539,1189,14,508,1120,12,38.5,>30,AUS,Away,Upto 2014
BE Congdon,NZ,Pace,1974-01-05,Sydney,Australia,1974,1,29,104,1,1,618,1375,28,589,1271,27,22.071428571428573,<=30,AUS,Away,Upto 2014
BE Congdon,NZ,Pace,1974-01-26,Adelaide,Australia,1974,1,60,120,1,1,505,1312,13,445,1192,12,38.84615384615385,>30,AUS,Away,Upto 2014
BE Congdon,NZ,Pace,1974-03-01,Wellington,New Zealand,1974,2,114,205,4,1,960,1997,18,846,1792,14,53.333333333333336,>30,NZ,Home,Upto 2014
BE Congdon,NZ,Pace,1974-03-08,Christchurch,New Zealand,1974,2,59,160,3,1,814,2050,32,755,1890,29,25.4375,<=30,NZ,Home,Upto 2014
BE Congdon,NZ,Pace,1974-03-22,Auckland,New Zealand,1974,2,112,234,5,1,628,1262,29,516,1028,24,21.655172413793103,<=30,NZ,Home,Upto 2014
BE Congdon,NZ,Pace,1975-02-20,Auckland,New Zealand,1975,1,115,240,2,1,616,1261,8,501,1021,6,77.0,>30,NZ,Home,Upto 2014
BE Congdon,NZ,Pace,1975-02-28,Christchurch,New Zealand,1975,1,27,56,0,1,449,1000,7,422,944,7,64.14285714285714,>30,NZ,Home,Upto 2014
BE Congdon,NZ,Pace,1976-01-24,Auckland,New Zealand,1976,1,65,215,5,1,264,671,8,199,456,3,33.0,>30,NZ,Home,Upto 2014
BE Congdon,NZ,Pace,1976-02-05,Christchurch,New Zealand,1976,2,41,168,1,1,616,1431,23,575,1263,22,26.782608695652176,<=30,NZ,Home,Upto 2014
BE Congdon,NZ,Pace,1976-02-13,Wellington,New Zealand,1976,1,33,72,0,1,457,1252,22,424,1180,22,20.772727272727273,<=30,NZ,Home,Upto 2014
BE Congdon,NZ,Pace,1977-02-18,Christchurch,New Zealand,1977,2,28,64,0,1,990,2047,22,962,1983,22,45.0,>30,NZ,Home,Upto 2014
BE Congdon,NZ,Pace,1977-02-25,Auckland,New Zealand,1977,1,8,40,0,1,733,1600,29,725,1560,29,25.275862068965516,<=30,NZ,Home,Upto 2014
BE Congdon,NZ,Pace,1978-02-10,Wellington,New Zealand,1978,1,14,140,2,1,523,1920,38,509,1780,36,13.763157894736842,<=30,NZ,Home,Upto 2014
BE Congdon,NZ,Pace,1978-02-24,Christchurch,New Zealand,1978,2,32,160,0,1,664,1812,24,632,1652,24,27.666666666666668,<=30,NZ,Home,Upto 2014
BE Congdon,NZ,Pace,1978-03-04,Auckland,New Zealand,1978,1,68,208,0,1,754,2126,17,686,1918,17,44.35294117647059,>30,NZ,Home,Upto 2014
BE Congdon,NZ,Pace,1978-07-27,The Oval,England,1978,2,43,132,0,1,503,1390,19,460,1258,19,26.473684210526315,<=30,ENG,Away,Upto 2014
BE Congdon,NZ,Pace,1978-08-10,Nottingham,England,1978,1,71,234,0,1,554,1523,20,483,1289,20,27.7,<=30,ENG,Away,Upto 2014
BE Congdon,NZ,Pace,1978-08-24,Lord's,England,1978,1,12,36,0,1,614,1515,29,602,1479,29,21.17241379310345,<=30,ENG,Away,Upto 2014
BE Hendricks,SA,Pace,2020-01-24,Johannesburg,South Africa,2020,2,175,231,6,1,1022,1773,39,847,1542,33,26.205128205128204,<=30,SA,Home,After 1965
BE McGain,AUS,Spin,2009-03-19,Cape Town,South Africa,2009,1,149,108,0,1,333,503,11,184,395,11,30.272727272727273,>30,SA,Away,Upto 2014
BF Butcher,WI,Spin,1959-02-06,Delhi,India,1959,1,17,36,0,1,775,1794,11,758,1758,11,70.45454545454545,>30,IND,Away,Upto 2014
BF Butcher,WI,Spin,1968-03-14,Port of Spain,West Indies,1968,2,51,112,5,1,721,1580,15,670,1468,10,48.06666666666667,>30,WI,Home,Upto 2014
BF Butcher,WI,Spin,1968-03-28,Georgetown,West Indies,1968,2,16,90,0,1,621,1884,22,605,1794,22,28.227272727272727,<=30,WI,Home,Upto 2014
BF Butcher,WI,Spin,1969-06-26,Lord's,England,1969,1,6,18,0,1,394,1024,8,388,1006,8,49.25,>30,ENG,Away,Upto 2014
BF Hastings,NZ,Spin,1973-06-21,Lord's,England,1973,1,3,6,0,1,444,1278,9,441,1272,9,49.333333333333336,>30,ENG,Away,Upto 2014
BF Hastings,NZ,Spin,1974-03-01,Wellington,New Zealand,1974,1,6,16,0,1,424,1008,5,418,992,5,84.8,>30,NZ,Home,Upto 2014
BG Rogers,ZIM,Spin,2005-01-14,Dhaka,Bangladesh,2005,1,17,18,0,1,497,1234,18,480,1216,18,27.61111111111111,<=30,BAN,Away,Upto 2014
BGK Walker,NZ,Spin,2000-11-17,Bloemfontein,South Africa,2000,2,111,201,2,1,207,537,3,96,336,1,69.0,>30,SA,Away,Upto 2014
BGK Walker,NZ,Spin,2000-11-30,Gqeberha,South Africa,2000,2,93,181,1,1,168,385,3,75,204,2,56.0,>30,SA,Away,Upto 2014
BGK Walker,NZ,Spin,2000-12-26,Wellington,New Zealand,2000,2,98,198,0,1,458,942,3,360,744,3,152.66666666666666,>30,NZ,Home,Upto 2014
BGK Walker,NZ,Spin,2002-05-01,Lahore,Pakistan,2002,1,97,89,2,1,466,722,13,369,633,11,35.84615384615385,>30,PAK,Away,Upto 2014
BH Pairaudeau,WI,Spin,1954-03-17,Port of Spain,West Indies,1954,1,3,6,0,1,1025,1930,13,1022,1924,13,78.84615384615384,>30,WI,Home,Upto 2014
BJ Arnel,NZ,Pace,2010-03-19,Wellington,New Zealand,2010,2,120,216,2,1,767,1410,18,647,1194,16,42.611111111111114,>30,NZ,Home,Upto 2014
BJ Arnel,NZ,Pace,2010-03-27,Hamilton,New Zealand,2010,2,130,228,3,1,795,1294,27,665,1066,24,29.444444444444443,<=30,NZ,Home,Upto 2014
BJ Arnel,NZ,Pace,2010-11-12,Hyderabad,India,2010,2,90,174,0,1,606,1065,12,516,891,12,50.5,>30,IND,Away,Upto 2014
BJ Arnel,NZ,Pace,2011-01-07,Hamilton,New Zealand,2011,1,95,168,4,1,564,1033,21,469,865,17,26.857142857142858,<=30,NZ,Home,Upto 2014
BJ Arnel,NZ,Pace,2011-01-15,Wellington,New Zealand,2011,2,67,150,0,1,781,1511,23,714,1361,23,33.95652173913044,>30,NZ,Home,Upto 2014
BJ Arnel,NZ,Pace,2012-03-15,Hamilton,New Zealand,2012,2,64,72,0,1,549,1079,27,485,1007,27,20.333333333333332,<=30,NZ,Home,Upto 2014
BJ Bennett,ZIM,Spin,2024-12-26,Bulawayo,Zimbabwe,2024,1,95,168,5,1,1189,1856,20,1094,1688,15,59.45,>30,ZIM,Home,After 1965
BJ Bennett,ZIM,Spin,2025-01-02,Bulawayo,Zimbabwe,2025,1,41,72,0,1,588,1149,23,547,1077,23,25.565217391304348,<=30,ZIM,Home,After 1965
BJ Bess,WI,Pace,2010-06-26,Bridgetown,West Indies,2010,2,92,78,1,1,416,803,18,324,725,17,23.11111111111111,<=30,WI,Home,Upto 2014
BJ Hodge,AUS,Spin,2005-12-16,W.A.C.A,Australia,2005,1,8,12,0,1,218,526,6,210,514,6,36.333333333333336,>30,AUS,Home,Upto 2014
BJ McCarthy,IRE,Pace,2024-02-28,Tolerance Oval,UAE,2024,2,76,174,4,1,418,850,26,342,676,22,16.076923076923077,<=30,UAE,Away,After 1965
BJ McCarthy,IRE,Pace,2024-07-25,Belfast,Northern Ireland,2024,2,75,189,4,1,610,1116,26,535,927,22,23.46153846153846,<=30,Northern Ireland,Away,After 1965
BJ Sealey,WI,Pace,1933-08-12,The Oval,England,1933,1,10,30,1,1,389,809,16,379,779,15,24.3125,<=30,ENG,Away,Upto 2014
BJ Webster,AUS,Spin,2025-01-03,Sydney,Australia,2025,2,53,102,1,1,137,216,4,84,114,3,34.25,>30,AUS,Home,After 1965
BJT Bosanquet,ENG,Spin,1903-12-11,Sydney,Australia,1903,2,152,216,3,1,839,1769,19,687,1553,16,44.1578947368421,>30,AUS,Away,Upto 2014
BJT Bosanquet,ENG,Spin,1904-01-15,Adelaide,Australia,1904,2,168,276,7,1,537,1176,17,369,900,10,31.58823529411765,>30,AUS,Away,Upto 2014
BJT Bosanquet,ENG,Spin,1904-02-26,Sydney,Australia,1904,2,56,102,6,1,399,1183,23,343,1081,17,17.347826086956523,<=30,AUS,Away,Upto 2014
BJT Bosanquet,ENG,Spin,1904-03-05,Melbourne,Australia,1904,1,27,24,0,1,273,552,23,246,528,23,11.869565217391305,<=30,AUS,Away,Upto 2014
BJT Bosanquet,ENG,Spin,1905-05-29,Nottingham,England,1905,2,136,238,8,1,379,970,12,243,732,4,31.583333333333332,>30,ENG,Home,Upto 2014
BJT Bosanquet,ENG,Spin,1905-07-03,Leeds,England,1905,2,65,114,1,1,435,1029,13,370,915,12,33.46153846153846,>30,ENG,Home,Upto 2014
BK Kunderan,IND,Pace,1967-07-13,Birmingham,England,1967,1,13,24,0,1,150,354,6,137,330,6,25.0,<=30,ENG,Away,Upto 2014
BK Shepherd,AUS,Spin,1964-01-10,Sydney,Australia,1964,1,3,8,0,1,363,985,5,360,977,5,72.6,>30,AUS,Home,Upto 2014
BK Shepherd,AUS,Spin,1965-05-05,Bridgetown,West Indies,1965,1,6,18,0,1,856,1946,10,850,1928,10,85.6,>30,WI,Away,Upto 2014
BKG Mendis,SL,Spin,2016-10-29,Harare,Zimbabwe,2016,2,18,36,1,1,573,1161,19,555,1125,18,30.157894736842106,>30,ZIM,Away,After 1965
BKG Mendis,SL,Spin,2017-07-14,Colombo (RPS),Sri Lanka,2017,1,16,24,0,1,1059,1917,28,1043,1893,28,37.82142857142857,>30,SL,Home,After 1965
BKG Mendis,SL,Spin,2017-10-06,Dubai (DICS),UAE,2017,1,7,6,0,1,608,1153,24,601,1147,24,25.333333333333332,<=30,UAE,Away,After 1965
BKG Mendis,SL,Spin,2018-01-31,Chattogram,Bangladesh,2018,1,2,6,0,1,1210,2061,19,1208,2055,19,63.68421052631579,>30,BAN,Away,After 1965
BKG Mendis,SL,Spin,2018-06-06,Port of Spain,West Indies,2018,1,12,6,0,1,353,866,12,341,860,12,29.416666666666668,<=30,WI,Away,After 1965
BKG Mendis,SL,Spin,2019-12-11,Rawalpindi,Pakistan,2019,1,14,6,0,1,170,252,0,156,246,0,inf,>30,PAK,Away,After 1965
BKG Mendis,SL,Spin,2020-12-26,Centurion,South Africa,2020,1,41,42,0,1,312,480,4,271,438,4,78.0,>30,SA,Away,After 1965
BKG Mendis,SL,Spin,2022-05-15,Chattogram,Bangladesh,2022,1,8,6,0,1,772,1873,17,764,1867,17,45.411764705882355,>30,BAN,Away,After 1965
BKV Prasad,IND,Pace,1996-06-06,Birmingham,England,1996,2,121,252,6,1,677,1326,30,556,1074,24,22.566666666666666,<=30,ENG,Away,Upto 2014
BKV Prasad,IND,Pace,1996-06-20,Lord's,England,1996,2,130,345,7,1,826,2028,26,696,1683,19,31.76923076923077,>30,ENG,Away,Upto 2014
BKV Prasad,IND,Pace,1996-07-04,Nottingham,England,1996,1,124,258,2,1,859,1781,24,735,1523,22,35.791666666666664,>30,ENG,Away,Upto 2014
BKV Prasad,IND,Pace,1996-10-10,Delhi,India,1996,2,52,153,4,1,274,681,13,222,528,9,21.076923076923077,<=30,IND,Home,Upto 2014
BKV Prasad,IND,Pace,1996-11-20,Ahmedabad,India,1996,2,42,96,0,1,335,936,19,293,840,19,17.63157894736842,<=30,IND,Home,Upto 2014
BKV Prasad,IND,Pace,1996-11-27,Eden Gardens,India,1996,2,167,300,6,1,704,1315,23,537,1015,17,30.608695652173914,>30,IND,Home,Upto 2014
BKV Prasad,IND,Pace,1996-12-08,Kanpur,India,1996,2,50,150,2,1,443,1201,16,393,1051,14,27.6875,<=30,IND,Home,Upto 2014
BKV Prasad,IND,Pace,1996-12-26,Durban,South Africa,1996,2,153,264,10,1,537,1172,37,384,908,27,14.513513513513514,<=30,SA,Away,Upto 2014
BKV Prasad,IND,Pace,1997-01-02,Cape Town,South Africa,1997,2,130,258,3,1,897,1609,22,767,1351,19,40.77272727272727,>30,SA,Away,Upto 2014
BKV Prasad,IND,Pace,1997-01-16,Johannesburg,South Africa,1997,2,142,210,4,1,895,1774,26,753,1564,22,34.42307692307692,>30,SA,Away,Upto 2014
BKV Prasad,IND,Pace,1997-03-06,Kingston,West Indies,1997,2,150,258,1,1,612,1409,17,462,1151,16,36.0,>30,WI,Away,Upto 2014
BKV Prasad,IND,Pace,1997-03-14,Port of Spain,West Indies,1997,2,92,276,1,1,527,1480,12,435,1204,11,43.916666666666664,>30,WI,Away,Upto 2014
BKV Prasad,IND,Pace,1997-03-27,Bridgetown,West Indies,1997,2,121,298,8,1,738,1569,38,617,1271,30,19.42105263157895,<=30,WI,Away,Upto 2014
BKV Prasad,IND,Pace,1997-04-04,St John's,West Indies,1997,1,65,144,1,1,268,546,4,203,402,3,67.0,>30,WI,Away,Upto 2014
BKV Prasad,IND,Pace,1997-04-17,Georgetown,West Indies,1997,1,37,42,0,1,344,855,6,307,813,6,57.333333333333336,>30,WI,Away,Upto 2014
BKV Prasad,IND,Pace,1997-08-02,Colombo (RPS),Sri Lanka,1997,1,88,144,0,1,398,549,5,310,405,5,79.6,>30,SL,Away,Upto 2014
BKV Prasad,IND,Pace,1997-08-09,Colombo (SSC),Sri Lanka,1997,2,176,252,2,1,927,1577,19,751,1325,17,48.78947368421053,>30,SL,Away,Upto 2014
BKV Prasad,IND,Pace,1997-12-03,Wankhede,India,1997,2,53,156,1,1,639,1269,12,586,1113,11,53.25,>30,IND,Home,Upto 2014
BKV Prasad,IND,Pace,1998-12-26,Wellington,New Zealand,1998,2,93,240,2,1,632,1417,22,539,1177,20,28.727272727272727,<=30,NZ,Away,Upto 2014
BKV Prasad,IND,Pace,1999-01-02,Hamilton,New Zealand,1999,2,136,396,3,1,1002,1896,23,866,1500,20,43.56521739130435,>30,NZ,Away,Upto 2014
BKV Prasad,IND,Pace,1999-01-28,Chennai,India,1999,2,87,158,6,1,432,740,16,345,582,10,27.0,<=30,IND,Home,Upto 2014
BKV Prasad,IND,Pace,1999-02-04,Delhi,India,1999,2,35,90,2,1,268,588,7,233,498,5,38.285714285714285,>30,IND,Home,Upto 2014
BKV Prasad,IND,Pace,1999-02-16,Eden Gardens,India,1999,2,88,252,3,1,539,1227,30,451,975,27,17.966666666666665,<=30,IND,Home,Upto 2014
BKV Prasad,IND,Pace,1999-02-24,Colombo (SSC),Sri Lanka,1999,1,94,186,1,1,790,1434,9,696,1248,8,87.77777777777777,>30,SL,Away,Upto 2014
BKV Prasad,IND,Pace,1999-10-10,Mohali,India,1999,2,80,210,1,1,577,1368,20,497,1158,19,28.85,<=30,IND,Home,Upto 2014
BKV Prasad,IND,Pace,1999-10-29,Ahmedabad,India,1999,2,88,234,2,1,649,1266,11,561,1032,9,59.0,>30,IND,Home,Upto 2014
BKV Prasad,IND,Pace,1999-12-10,Adelaide,Australia,1999,2,131,255,4,1,755,1459,27,624,1204,23,27.962962962962962,<=30,AUS,Away,Upto 2014
BKV Prasad,IND,Pace,1999-12-26,Melbourne,Australia,1999,2,139,216,2,1,715,1451,26,576,1235,24,27.5,<=30,AUS,Away,Upto 2014
BKV Prasad,IND,Pace,2000-01-02,Sydney,Australia,2000,1,86,168,1,1,643,1127,22,557,959,21,29.227272727272727,<=30,AUS,Away,Upto 2014
BKV Prasad,IND,Pace,2001-03-11,Eden Gardens,India,2001,2,102,198,0,1,800,1488,16,698,1290,16,50.0,>30,IND,Home,Upto 2014
BKV Prasad,IND,Pace,2001-08-14,Galle,Sri Lanka,2001,1,83,144,1,1,532,1132,18,449,988,17,29.555555555555557,<=30,SL,Away,Upto 2014
BKV Prasad,IND,Pace,2001-08-22,Kandy,Sri Lanka,2001,2,124,234,7,1,745,1357,27,621,1123,20,27.59259259259259,<=30,SL,Away,Upto 2014
BKV Prasad,IND,Pace,2001-08-29,Colombo (SSC),Sri Lanka,2001,1,101,204,3,1,542,1005,7,441,801,4,77.42857142857143,>30,SL,Away,Upto 2014
BL Cairns,NZ,Pace,1974-01-26,Adelaide,Australia,1974,1,73,168,2,1,505,1312,13,432,1144,11,38.84615384615385,>30,AUS,Away,Upto 2014
BL Cairns,NZ,Pace,1975-02-28,Christchurch,New Zealand,1975,1,44,104,0,1,449,1000,7,405,896,7,64.14285714285714,>30,NZ,Home,Upto 2014
BL Cairns,NZ,Pace,1976-02-13,Wellington,New Zealand,1976,2,66,199,2,1,457,1252,22,391,1053,20,20.772727272727273,<=30,NZ,Home,Upto 2014
BL Cairns,NZ,Pace,1976-10-23,Hyderabad (Sind),Pakistan,1976,1,102,208,1,1,398,904,11,296,696,10,36.18181818181818,>30,PAK,Away,Upto 2014
BL Cairns,NZ,Pace,1976-10-30,Karachi,Pakistan,1976,1,142,224,1,1,1003,1506,20,861,1282,19,50.15,>30,PAK,Away,Upto 2014
BL Cairns,NZ,Pace,1976-11-10,Wankhede,India,1976,1,76,204,2,1,455,894,10,379,690,8,45.5,>30,IND,Away,Upto 2014
BL Cairns,NZ,Pace,1976-11-26,Chennai,India,1976,2,104,295,5,1,298,829,13,194,534,8,22.923076923076923,<=30,IND,Away,Upto 2014
BL Cairns,NZ,Pace,1977-02-25,Auckland,New Zealand,1977,1,69,224,3,1,733,1600,29,664,1376,26,25.275862068965516,<=30,NZ,Home,Upto 2014
BL Cairns,NZ,Pace,1978-03-04,Auckland,New Zealand,1978,1,63,264,0,1,754,2126,17,691,1862,17,44.35294117647059,>30,NZ,Home,Upto 2014
BL Cairns,NZ,Pace,1978-07-27,The Oval,England,1978,2,86,282,3,1,503,1390,19,417,1108,16,26.473684210526315,<=30,ENG,Away,Upto 2014
BL Cairns,NZ,Pace,1978-08-10,Nottingham,England,1978,1,85,228,1,1,554,1523,20,469,1295,19,27.7,<=30,ENG,Away,Upto 2014
BL Cairns,NZ,Pace,1979-02-02,Christchurch,New Zealand,1979,2,142,432,3,1,652,1680,19,510,1248,16,34.31578947368421,>30,NZ,Home,Upto 2014
BL Cairns,NZ,Pace,1979-02-16,Napier,New Zealand,1979,2,109,240,3,1,699,1749,19,590,1509,16,36.78947368421053,>30,NZ,Home,Upto 2014
BL Cairns,NZ,Pace,1979-02-23,Auckland,New Zealand,1979,1,94,224,3,1,754,1863,27,660,1639,24,27.925925925925927,<=30,NZ,Home,Upto 2014
BL Cairns,NZ,Pace,1980-02-08,Dunedin,New Zealand,1980,2,95,269,3,1,533,1670,35,438,1401,32,15.228571428571428,<=30,NZ,Home,Upto 2014
BL Cairns,NZ,Pace,1980-02-22,Christchurch,New Zealand,1980,2,192,360,6,1,946,1857,20,754,1497,14,47.3,>30,NZ,Home,Upto 2014
BL Cairns,NZ,Pace,1980-02-29,Auckland,New Zealand,1980,2,132,300,3,1,786,1985,29,654,1685,26,27.103448275862068,<=30,NZ,Home,Upto 2014
BL Cairns,NZ,Pace,1980-11-28,Brisbane,Australia,1980,2,103,278,5,1,530,1227,24,427,949,19,22.083333333333332,<=30,AUS,Away,Upto 2014
BL Cairns,NZ,Pace,1980-12-12,W.A.C.A,Australia,1980,2,105,199,4,1,516,1220,27,411,1021,23,19.11111111111111,<=30,AUS,Away,Upto 2014
BL Cairns,NZ,Pace,1980-12-26,Melbourne,Australia,1980,2,148,408,4,1,683,1801,29,535,1393,25,23.551724137931036,<=30,AUS,Away,Upto 2014
BL Cairns,NZ,Pace,1981-02-21,Wellington,New Zealand,1981,2,63,232,7,1,725,1705,33,662,1473,26,21.96969696969697,<=30,NZ,Home,Upto 2014
BL Cairns,NZ,Pace,1981-03-06,Christchurch,New Zealand,1981,1,57,198,0,1,349,1020,11,292,822,11,31.727272727272727,>30,NZ,Home,Upto 2014
BL Cairns,NZ,Pace,1981-03-13,Auckland,New Zealand,1981,2,84,377,6,1,366,1193,11,282,816,5,33.27272727272727,>30,NZ,Home,Upto 2014
BL Cairns,NZ,Pace,1982-02-26,Wellington,New Zealand,1982,1,20,66,1,1,258,786,4,238,720,3,64.5,>30,NZ,Home,Upto 2014
BL Cairns,NZ,Pace,1982-03-12,Auckland,New Zealand,1982,2,123,366,4,1,673,1668,23,550,1302,19,29.26086956521739,<=30,NZ,Home,Upto 2014
BL Cairns,NZ,Pace,1982-03-19,Christchurch,New Zealand,1982,2,102,180,0,1,665,1336,24,563,1156,24,27.708333333333332,<=30,NZ,Home,Upto 2014
BL Cairns,NZ,Pace,1983-03-04,Christchurch,New Zealand,1983,2,96,210,8,1,557,1256,25,461,1046,17,22.28,<=30,NZ,Home,Upto 2014
BL Cairns,NZ,Pace,1983-03-11,Wellington,New Zealand,1983,2,61,162,1,1,592,1490,31,531,1328,30,19.096774193548388,<=30,NZ,Home,Upto 2014
BL Cairns,NZ,Pace,1983-07-14,The Oval,England,1983,2,130,282,1,1,726,1662,20,596,1380,19,36.3,>30,ENG,Away,Upto 2014
BL Cairns,NZ,Pace,1983-07-28,Leeds,England,1983,2,144,344,10,1,786,1782,32,642,1438,22,24.5625,<=30,ENG,Away,Upto 2014
BL Cairns,NZ,Pace,1983-08-11,Lord's,England,1983,2,74,156,1,1,667,1618,29,593,1462,28,23.0,<=30,ENG,Away,Upto 2014
BL Cairns,NZ,Pace,1983-08-25,Nottingham,England,1983,2,113,322,4,1,763,1600,21,650,1278,17,36.333333333333336,>30,ENG,Away,Upto 2014
BL Cairns,NZ,Pace,1984-01-20,Wellington,New Zealand,1984,1,143,270,7,1,1002,2037,24,859,1767,17,41.75,>30,NZ,Home,Upto 2014
BL Cairns,NZ,Pace,1984-02-03,Christchurch,New Zealand,1984,2,56,168,3,1,404,927,25,348,759,22,16.16,<=30,NZ,Home,Upto 2014
BL Cairns,NZ,Pace,1984-02-10,Auckland,New Zealand,1984,1,52,240,2,1,656,1758,12,604,1518,10,54.666666666666664,>30,NZ,Home,Upto 2014
BL Cairns,NZ,Pace,1984-03-09,Kandy,Sri Lanka,1984,2,77,132,1,1,359,767,20,282,635,19,17.95,<=30,SL,Away,Upto 2014
BL Cairns,NZ,Pace,1984-03-16,Colombo (SSC),Sri Lanka,1984,2,126,281,5,1,563,1643,28,437,1362,23,20.107142857142858,<=30,SL,Away,Upto 2014
BL Cairns,NZ,Pace,1985-01-18,Wellington,New Zealand,1985,1,65,166,1,1,458,1096,12,393,930,11,38.166666666666664,>30,NZ,Home,Upto 2014
BL Cairns,NZ,Pace,1985-01-25,Auckland,New Zealand,1985,2,122,292,7,1,673,1429,25,551,1137,18,26.92,<=30,NZ,Home,Upto 2014
BL Cairns,NZ,Pace,1985-02-09,Dunedin,New Zealand,1985,2,118,264,2,1,862,2018,34,744,1754,32,25.352941176470587,<=30,NZ,Home,Upto 2014
BL Cairns,NZ,Pace,1985-03-29,Port of Spain,West Indies,1985,2,163,270,2,1,784,1698,30,621,1428,28,26.133333333333333,<=30,WI,Away,Upto 2014
BL Cairns,NZ,Pace,1985-04-06,Georgetown,West Indies,1985,2,152,300,3,1,825,1600,20,673,1300,17,41.25,>30,WI,Away,Upto 2014
BL Cairns,NZ,Pace,1985-11-30,W.A.C.A,Australia,1985,2,109,240,0,1,726,2093,28,617,1853,28,25.928571428571427,<=30,AUS,Away,Upto 2014
BL D'Oliveira,ENG,Pace,1966-06-16,Lord's,England,1966,2,70,234,2,1,864,1752,24,794,1518,22,36.0,>30,ENG,Home,Upto 2014
BL D'Oliveira,ENG,Pace,1966-06-30,Nottingham,England,1966,2,128,384,4,1,760,1648,27,632,1264,23,28.14814814814815,<=30,ENG,Home,Upto 2014
BL D'Oliveira,ENG,Pace,1966-08-04,Leeds,England,1966,1,52,114,0,1,453,936,13,401,822,13,34.84615384615385,>30,ENG,Home,Upto 2014
BL D'Oliveira,ENG,Pace,1966-08-18,The Oval,England,1966,2,79,228,2,1,459,1079,13,380,851,11,35.30769230769231,>30,ENG,Home,Upto 2014
BL D'Oliveira,ENG,Pace,1967-06-08,Leeds,England,1967,2,51,120,1,1,436,1074,7,385,954,6,62.285714285714285,>30,ENG,Home,Upto 2014
BL D'Oliveira,ENG,Pace,1967-06-22,Lord's,England,1967,1,38,90,2,1,257,628,10,219,538,8,25.7,<=30,ENG,Home,Upto 2014
BL D'Oliveira,ENG,Pace,1967-07-27,Lord's,England,1967,1,17,90,0,1,434,1150,13,417,1060,13,33.38461538461539,>30,ENG,Home,Upto 2014
BL D'Oliveira,ENG,Pace,1967-08-10,Nottingham,England,1967,1,27,108,1,1,254,846,14,227,738,13,18.142857142857142,<=30,ENG,Home,Upto 2014
BL D'Oliveira,ENG,Pace,1967-08-24,The Oval,England,1967,1,41,102,0,1,449,1200,19,408,1098,19,23.63157894736842,<=30,ENG,Home,Upto 2014
BL D'Oliveira,ENG,Pace,1968-01-19,Port of Spain,West Indies,1968,2,70,192,1,1,435,1007,15,365,815,14,29.0,<=30,WI,Away,Upto 2014
BL D'Oliveira,ENG,Pace,1968-02-08,Kingston,West Indies,1968,1,51,192,2,1,570,1419,25,519,1227,23,22.8,<=30,WI,Away,Upto 2014
BL D'Oliveira,ENG,Pace,1968-02-29,Bridgetown,West Indies,1968,2,55,138,0,1,595,1213,17,540,1075,17,35.0,>30,WI,Away,Upto 2014
BL D'Oliveira,ENG,Pace,1968-03-14,Port of Spain,West Indies,1968,1,62,90,0,1,441,768,6,379,678,6,73.5,>30,WI,Away,Upto 2014
BL D'Oliveira,ENG,Pace,1968-03-28,Georgetown,West Indies,1968,2,55,96,0,1,579,1118,16,524,1022,16,36.1875,>30,WI,Away,Upto 2014
BL D'Oliveira,ENG,Pace,1968-06-06,Manchester,England,1968,2,45,180,2,1,493,1497,18,448,1317,16,27.38888888888889,<=30,ENG,Home,Upto 2014
BL D'Oliveira,ENG,Pace,1968-08-22,The Oval,England,1968,2,4,54,1,1,485,1288,15,481,1234,14,32.333333333333336,>30,ENG,Home,Upto 2014
BL D'Oliveira,ENG,Pace,1969-02-21,Lahore,Pakistan,1969,1,28,48,1,1,347,758,16,319,710,15,21.6875,<=30,PAK,Away,Upto 2014
BL D'Oliveira,ENG,Pace,1969-02-28,Dhaka,Bangladesh,1969,2,27,102,0,1,300,937,11,273,835,11,27.272727272727273,<=30,BAN,Away,Upto 2014
BL D'Oliveira,ENG,Pace,1969-06-12,Manchester,England,1969,1,29,54,1,1,490,1177,22,461,1123,21,22.272727272727273,<=30,ENG,Home,Upto 2014
BL D'Oliveira,ENG,Pace,1969-06-26,Lord's,England,1969,2,91,246,2,1,864,2111,25,773,1865,23,34.56,>30,ENG,Home,Upto 2014
BL D'Oliveira,ENG,Pace,1969-07-10,Leeds,England,1969,2,49,150,1,1,581,1581,25,532,1431,24,23.24,<=30,ENG,Home,Upto 2014
BL D'Oliveira,ENG,Pace,1969-07-24,Lord's,England,1969,1,6,48,1,1,463,1142,17,457,1094,16,27.235294117647058,<=30,ENG,Home,Upto 2014
BL D'Oliveira,ENG,Pace,1969-08-07,Nottingham,England,1969,2,48,180,1,1,534,1193,14,486,1013,13,38.142857142857146,>30,ENG,Home,Upto 2014
BL D'Oliveira,ENG,Pace,1969-08-21,The Oval,England,1969,2,23,90,0,1,397,1023,15,374,933,15,26.466666666666665,<=30,ENG,Home,Upto 2014
BL D'Oliveira,ENG,Pace,1970-11-27,Brisbane,Australia,1970,2,70,184,0,1,624,1629,19,554,1445,19,32.8421052631579,>30,AUS,Away,Upto 2014
BL D'Oliveira,ENG,Pace,1970-12-11,W.A.C.A,Australia,1970,2,46,168,1,1,852,2129,21,806,1961,20,40.57142857142857,>30,AUS,Away,Upto 2014
BL D'Oliveira,ENG,Pace,1971-01-09,Sydney,Australia,1971,2,36,128,2,1,480,1339,18,444,1211,16,26.666666666666668,<=30,AUS,Away,Upto 2014
BL D'Oliveira,ENG,Pace,1971-01-21,Melbourne,Australia,1971,1,71,176,1,1,660,1712,13,589,1536,12,50.76923076923077,>30,AUS,Away,Upto 2014
BL D'Oliveira,ENG,Pace,1971-01-29,Adelaide,Australia,1971,1,28,120,0,1,768,1851,22,740,1731,22,34.90909090909091,>30,AUS,Away,Upto 2014
BL D'Oliveira,ENG,Pace,1971-02-12,Sydney,Australia,1971,2,39,136,2,1,479,1333,21,440,1197,19,22.80952380952381,<=30,AUS,Away,Upto 2014
BL D'Oliveira,ENG,Pace,1971-02-25,Christchurch,New Zealand,1971,1,2,24,0,1,205,688,11,203,664,11,18.636363636363637,<=30,NZ,Away,Upto 2014
BL D'Oliveira,ENG,Pace,1971-06-03,Birmingham,England,1971,1,78,228,2,1,653,1403,13,575,1175,11,50.23076923076923,>30,ENG,Home,Upto 2014
BL D'Oliveira,ENG,Pace,1971-06-17,Lord's,England,1971,1,22,60,1,1,276,712,9,254,652,8,30.666666666666668,>30,ENG,Home,Upto 2014
BL D'Oliveira,ENG,Pace,1971-07-08,Leeds,England,1971,2,62,306,5,1,442,1309,24,380,1003,19,18.416666666666668,<=30,ENG,Home,Upto 2014
BL D'Oliveira,ENG,Pace,1971-07-22,Lord's,England,1971,1,20,90,0,1,287,804,9,267,714,9,31.88888888888889,>30,ENG,Home,Upto 2014
BL D'Oliveira,ENG,Pace,1971-08-05,Manchester,England,1971,2,41,162,2,1,409,1030,17,368,868,15,24.058823529411764,<=30,ENG,Home,Upto 2014
BL D'Oliveira,ENG,Pace,1971-08-19,The Oval,England,1971,2,22,96,1,1,247,588,5,225,492,4,49.4,>30,ENG,Home,Upto 2014
BL D'Oliveira,ENG,Pace,1972-06-08,Manchester,England,1972,2,36,132,2,1,656,1682,30,620,1550,28,21.866666666666667,<=30,ENG,Home,Upto 2014
BL D'Oliveira,ENG,Pace,1972-06-22,Lord's,England,1972,2,62,150,2,1,594,1418,30,532,1268,28,19.8,<=30,ENG,Home,Upto 2014
BL D'Oliveira,ENG,Pace,1972-07-13,Nottingham,England,1972,2,53,150,1,1,670,1779,23,617,1629,22,29.130434782608695,<=30,ENG,Home,Upto 2014
BL D'Oliveira,ENG,Pace,1972-07-27,Leeds,England,1972,1,8,12,0,1,173,528,9,165,516,9,19.22222222222222,<=30,ENG,Home,Upto 2014
BL D'Oliveira,ENG,Pace,1972-08-10,The Oval,England,1972,1,17,54,0,1,662,1491,19,645,1437,19,34.8421052631579,>30,ENG,Home,Upto 2014
BM Laird,AUS,Spin,1980-03-06,Faisalabad,Pakistan,1980,1,3,12,0,1,592,1272,6,589,1260,6,98.66666666666667,>30,PAK,Away,Upto 2014
BM Laird,AUS,Spin,1981-12-11,Melbourne,Australia,1981,1,9,6,0,1,491,1248,15,482,1242,15,32.733333333333334,>30,AUS,Home,Upto 2014
BM McMillan,SA,Pace,1992-11-13,Durban,South Africa,1992,1,52,222,3,1,480,1371,14,428,1149,11,34.285714285714285,>30,SA,Home,Upto 2014
BM McMillan,SA,Pace,1992-11-26,Johannesburg,South Africa,1992,2,108,300,4,1,741,2035,23,633,1735,19,32.21739130434783,>30,SA,Home,Upto 2014
BM McMillan,SA,Pace,1992-12-26,Gqeberha,South Africa,1992,2,71,192,4,1,485,1194,23,414,1002,19,21.08695652173913,<=30,SA,Home,Upto 2014
BM McMillan,SA,Pace,1993-01-02,Cape Town,South Africa,1993,1,76,216,2,1,434,1582,19,358,1366,17,22.842105263157894,<=30,SA,Home,Upto 2014
BM McMillan,SA,Pace,1993-09-06,Colombo (SSC),Sri Lanka,1993,2,49,78,2,1,464,972,21,415,894,19,22.095238095238095,<=30,SL,Away,Upto 2014
BM McMillan,SA,Pace,1993-09-14,Colombo (PSS),Sri Lanka,1993,1,64,180,0,1,422,1175,13,358,995,13,32.46153846153846,>30,SL,Away,Upto 2014
BM McMillan,SA,Pace,1994-01-28,Adelaide,Australia,1994,2,122,246,4,1,661,1638,23,539,1392,19,28.73913043478261,<=30,AUS,Away,Upto 2014
BM McMillan,SA,Pace,1994-03-04,Johannesburg,South Africa,1994,2,107,198,4,1,852,1646,28,745,1448,24,30.428571428571427,>30,SA,Home,Upto 2014
BM McMillan,SA,Pace,1994-03-17,Cape Town,South Africa,1994,2,105,204,1,1,830,1910,22,725,1706,21,37.72727272727273,>30,SA,Home,Upto 2014
BM McMillan,SA,Pace,1994-03-25,Durban,South Africa,1994,2,109,246,1,1,810,2116,20,701,1870,19,40.5,>30,SA,Home,Upto 2014
BM McMillan,SA,Pace,1994-07-21,Lord's,England,1994,2,41,101,4,1,636,1408,31,595,1307,27,20.516129032258064,<=30,ENG,Away,Upto 2014
BM McMillan,SA,Pace,1994-08-04,Leeds,England,1994,2,159,315,5,1,1145,2209,21,986,1894,16,54.523809523809526,>30,ENG,Away,Upto 2014
BM McMillan,SA,Pace,1994-08-18,The Oval,England,1994,1,67,72,0,1,962,1490,30,895,1418,30,32.06666666666667,>30,ENG,Away,Upto 2014
BM McMillan,SA,Pace,1994-11-25,Johannesburg,South Africa,1994,2,57,156,0,1,787,1709,30,730,1553,30,26.233333333333334,<=30,SA,Home,Upto 2014
BM McMillan,SA,Pace,1994-12-26,Durban,South Africa,1994,2,93,294,6,1,610,1681,28,517,1387,22,21.785714285714285,<=30,SA,Home,Upto 2014
BM McMillan,SA,Pace,1995-01-02,Cape Town,South Africa,1995,2,117,306,7,1,639,1598,22,522,1292,15,29.045454545454547,<=30,SA,Home,Upto 2014
BM McMillan,SA,Pace,1995-01-19,Johannesburg,South Africa,1995,2,79,138,4,1,915,1724,33,836,1586,29,27.727272727272727,<=30,SA,Home,Upto 2014
BM McMillan,SA,Pace,1995-10-13,Harare,Zimbabwe,1995,2,66,108,1,1,728,1549,32,662,1441,31,22.75,<=30,ZIM,Away,Upto 2014
BM McMillan,SA,Pace,1995-11-16,Centurion,South Africa,1995,1,50,150,3,1,364,846,9,314,696,6,40.44444444444444,>30,SA,Home,Upto 2014
BM McMillan,SA,Pace,1995-11-30,Johannesburg,South Africa,1995,2,92,189,3,1,999,2058,30,907,1869,27,33.3,>30,SA,Home,Upto 2014
BM McMillan,SA,Pace,1995-12-14,Durban,South Africa,1995,1,21,54,0,1,320,703,12,299,649,12,26.666666666666668,<=30,SA,Home,Upto 2014
BM McMillan,SA,Pace,1995-12-26,Gqeberha,South Africa,1995,2,46,174,1,1,681,1783,21,635,1609,20,32.42857142857143,>30,SA,Home,Upto 2014
BM McMillan,SA,Pace,1996-01-02,Cape Town,South Africa,1996,2,38,102,1,1,418,1109,22,380,1007,21,19.0,<=30,SA,Home,Upto 2014
BM McMillan,SA,Pace,1996-11-20,Ahmedabad,India,1996,2,38,120,1,1,335,936,19,297,816,18,17.63157894736842,<=30,IND,Away,Upto 2014
BM McMillan,SA,Pace,1996-11-27,Eden Gardens,India,1996,2,85,210,3,1,704,1315,23,619,1105,20,30.608695652173914,>30,IND,Away,Upto 2014
BM McMillan,SA,Pace,1996-12-08,Kanpur,India,1996,2,76,204,2,1,443,1201,16,367,997,14,27.6875,<=30,IND,Away,Upto 2014
BM McMillan,SA,Pace,1996-12-26,Durban,South Africa,1996,2,36,60,2,1,537,1172,37,501,1112,35,14.513513513513514,<=30,SA,Home,Upto 2014
BM McMillan,SA,Pace,1997-01-02,Cape Town,South Africa,1997,2,38,104,2,1,897,1609,22,859,1505,20,40.77272727272727,>30,SA,Home,Upto 2014
BM McMillan,SA,Pace,1997-01-16,Johannesburg,South Africa,1997,2,98,191,0,1,895,1774,26,797,1583,26,34.42307692307692,>30,SA,Home,Upto 2014
BM McMillan,SA,Pace,1997-03-14,Gqeberha,South Africa,1997,2,78,210,3,1,528,1387,24,450,1177,21,22.0,<=30,SA,Home,Upto 2014
BM McMillan,SA,Pace,1997-10-06,Rawalpindi,Pakistan,1997,2,60,150,0,1,556,1227,14,496,1077,14,39.714285714285715,>30,PAK,Away,Upto 2014
BM McMillan,SA,Pace,1997-10-24,Faisalabad,Pakistan,1997,1,20,42,0,1,482,896,25,462,854,25,19.28,<=30,PAK,Away,Upto 2014
BM McMillan,SA,Pace,1997-12-26,Melbourne,Australia,1997,2,25,72,1,1,627,1621,23,602,1549,22,27.26086956521739,<=30,AUS,Away,Upto 2014
BM McMillan,SA,Pace,1998-01-02,Sydney,Australia,1998,1,55,108,1,1,405,1054,13,350,946,12,31.153846153846153,>30,AUS,Away,Upto 2014
BM McMillan,SA,Pace,1998-01-30,Adelaide,Australia,1998,2,93,216,0,1,879,2002,24,786,1786,24,36.625,>30,AUS,Away,Upto 2014
BM McMillan,SA,Pace,1998-08-06,Leeds,England,1998,2,46,120,0,1,826,2084,40,780,1964,40,20.65,<=30,ENG,Away,Upto 2014
BM Tickner,NZ,Pace,2023-02-16,Mount Maunganui,New Zealand,2023,2,127,150,4,1,901,1216,34,774,1066,30,26.5,<=30,NZ,Home,After 1965
BM Tickner,NZ,Pace,2023-03-09,Christchurch,New Zealand,2023,2,203,288,4,1,1067,1960,32,864,1672,28,33.34375,>30,NZ,Home,After 1965
BM Tickner,NZ,Pace,2023-03-17,Wellington,New Zealand,2023,2,105,197,4,1,761,1427,16,656,1230,12,47.5625,>30,NZ,Home,After 1965
BN Schultz,SA,Pace,1992-11-13,Durban,South Africa,1992,1,25,89,1,1,480,1371,14,455,1282,13,34.285714285714285,>30,SA,Home,Upto 2014
BN Schultz,SA,Pace,1992-12-26,Gqeberha,South Africa,1992,2,76,221,3,1,485,1194,23,409,973,20,21.08695652173913,<=30,SA,Home,Upto 2014
BN Schultz,SA,Pace,1993-08-25,Moratuwa,Sri Lanka,1993,2,157,308,6,1,501,1154,19,344,846,13,26.36842105263158,<=30,SL,Away,Upto 2014
BN Schultz,SA,Pace,1993-09-06,Colombo (SSC),Sri Lanka,1993,2,106,216,9,1,464,972,21,358,756,12,22.095238095238095,<=30,SL,Away,Upto 2014
BN Schultz,SA,Pace,1993-09-14,Colombo (PSS),Sri Lanka,1993,1,63,221,5,1,422,1175,13,359,954,8,32.46153846153846,>30,SL,Away,Upto 2014
BN Schultz,SA,Pace,1995-10-13,Harare,Zimbabwe,1995,2,126,270,5,1,728,1549,32,602,1279,27,22.75,<=30,ZIM,Away,Upto 2014
BN Schultz,SA,Pace,1995-11-16,Centurion,South Africa,1995,1,47,96,1,1,364,846,9,317,750,8,40.44444444444444,>30,SA,Home,Upto 2014
BN Schultz,SA,Pace,1997-03-21,Centurion,South Africa,1997,2,91,222,6,1,500,1229,28,409,1007,22,17.857142857142858,<=30,SA,Home,Upto 2014
BN Schultz,SA,Pace,1997-10-06,Rawalpindi,Pakistan,1997,1,58,90,1,1,556,1227,14,498,1137,13,39.714285714285715,>30,PAK,Away,Upto 2014
BOP Fernando,SL,Spin,2019-02-13,Durban,South Africa,2019,2,16,12,0,1,237,390,9,221,378,9,26.333333333333332,<=30,SA,Away,After 1965
BOP Fernando,SL,Spin,2019-12-11,Rawalpindi,Pakistan,2019,1,3,6,0,1,170,252,0,167,246,0,inf,>30,PAK,Away,After 1965
BP Bracewell,NZ,Pace,1978-07-27,The Oval,England,1978,2,72,180,3,1,503,1390,19,431,1210,16,26.473684210526315,<=30,ENG,Away,Upto 2014
BP Bracewell,NZ,Pace,1978-08-10,Nottingham,England,1978,1,110,203,3,1,554,1523,20,444,1320,17,27.7,<=30,ENG,Away,Upto 2014
BP Bracewell,NZ,Pace,1978-08-24,Lord's,England,1978,2,100,153,3,1,614,1515,29,514,1362,26,21.17241379310345,<=30,ENG,Away,Upto 2014
BP Bracewell,NZ,Pace,1979-02-02,Christchurch,New Zealand,1979,2,103,152,1,1,652,1680,19,549,1528,18,34.31578947368421,>30,NZ,Home,Upto 2014
BP Bracewell,NZ,Pace,1980-11-28,Brisbane,Australia,1980,2,71,150,0,1,530,1227,24,459,1077,24,22.083333333333332,<=30,AUS,Away,Upto 2014
BP Bracewell,NZ,Pace,1985-02-09,Dunedin,New Zealand,1985,2,129,198,4,1,862,2018,34,733,1820,30,25.352941176470587,<=30,NZ,Home,Upto 2014
BP Gupte,IND,Spin,1961-01-13,Chennai,India,1961,2,116,210,0,1,664,1638,11,548,1428,11,60.36363636363637,>30,IND,Home,Upto 2014
BP Gupte,IND,Spin,1964-02-15,Kanpur,India,1964,1,115,240,1,1,987,2874,18,872,2634,17,54.833333333333336,>30,IND,Home,Upto 2014
BP Gupte,IND,Spin,1965-03-05,Eden Gardens,India,1965,2,118,228,2,1,632,1531,17,514,1303,15,37.1764705882353,>30,IND,Home,Upto 2014
BP Julian,AUS,Pace,1993-06-03,Manchester,England,1993,2,97,150,3,1,704,1351,14,607,1201,11,50.285714285714285,>30,ENG,Away,Upto 2014
BP Julian,AUS,Pace,1993-07-01,Nottingham,England,1993,2,194,342,2,1,786,1563,21,592,1221,19,37.42857142857143,>30,ENG,Away,Upto 2014
BP Julian,AUS,Pace,1995-03-31,Bridgetown,West Indies,1995,2,77,144,5,1,554,1046,24,477,902,19,23.083333333333332,<=30,WI,Away,Upto 2014
BP Julian,AUS,Pace,1995-04-08,St John's,West Indies,1995,2,51,90,2,1,658,1384,24,607,1294,22,27.416666666666668,<=30,WI,Away,Upto 2014
BP Julian,AUS,Pace,1995-04-21,Port of Spain,West Indies,1995,2,40,60,0,1,399,876,29,359,816,29,13.758620689655173,<=30,WI,Away,Upto 2014
BP Julian,AUS,Pace,1995-04-29,Kingston,West Indies,1995,2,68,132,2,1,658,1221,21,590,1089,19,31.333333333333332,>30,WI,Away,Upto 2014
BP Julian,AUS,Pace,1995-12-08,W.A.C.A,Australia,1995,2,72,180,1,1,613,1126,16,541,946,15,38.3125,>30,AUS,Home,Upto 2014
BP Martin,NZ,Spin,2013-03-06,Dunedin,New Zealand,2013,2,133,348,5,1,254,582,6,121,234,1,42.333333333333336,>30,NZ,Home,Upto 2014
BP Martin,NZ,Spin,2013-03-14,Wellington,New Zealand,2013,1,130,288,4,1,255,641,7,125,353,3,36.42857142857143,>30,NZ,Home,Upto 2014
BP Martin,NZ,Spin,2013-03-22,Auckland,New Zealand,2013,2,130,390,0,1,355,860,7,225,470,7,50.714285714285715,>30,NZ,Home,Upto 2014
BP Martin,NZ,Spin,2013-05-16,Lord's,England,2013,2,78,234,1,1,125,351,3,47,117,2,41.666666666666664,>30,ENG,Away,Upto 2014
BP Martin,NZ,Spin,2013-10-09,Chattogram,Bangladesh,2013,2,175,258,2,1,1057,1946,22,882,1688,20,48.04545454545455,>30,BAN,Away,Upto 2014
BP Nash,WI,Pace,2008-12-11,Dunedin,New Zealand,2008,1,2,6,0,1,619,1080,13,617,1074,13,47.61538461538461,>30,NZ,Away,Upto 2014
BP Nash,WI,Pace,2008-12-19,Napier,New Zealand,2008,1,22,36,0,1,774,1324,23,752,1288,23,33.65217391304348,>30,NZ,Away,Upto 2014
BP Nash,WI,Pace,2009-02-15,St John's,West Indies,2009,1,34,66,1,1,803,1574,19,769,1508,18,42.26315789473684,>30,WI,Home,Upto 2014
BP Nash,WI,Pace,2009-02-26,Bridgetown,West Indies,2009,1,20,54,0,1,977,1508,9,957,1454,9,108.55555555555556,>30,WI,Home,Upto 2014
BP Nash,WI,Pace,2009-03-06,Port of Spain,West Indies,2009,2,98,156,0,1,770,1390,15,672,1234,15,51.333333333333336,>30,WI,Home,Upto 2014
BP Nash,WI,Pace,2009-05-06,Lord's,England,2009,1,2,12,0,1,625,1023,22,623,1011,22,28.40909090909091,<=30,ENG,Away,Upto 2014
BP Nash,WI,Pace,2010-06-18,Basseterre,West Indies,2010,2,18,78,0,1,644,1267,9,626,1189,9,71.55555555555556,>30,WI,Home,Upto 2014
BP Nash,WI,Pace,2010-11-15,Galle,Sri Lanka,2010,1,21,30,1,1,602,992,8,581,962,7,75.25,>30,SL,Away,Upto 2014
BP Nash,WI,Pace,2011-05-12,Providence,West Indies,2011,1,2,6,0,1,310,796,18,308,790,18,17.22222222222222,<=30,WI,Home,Upto 2014
BP Nash,WI,Pace,2011-05-20,Basseterre,West Indies,2011,1,19,36,0,1,547,1106,13,528,1070,13,42.07692307692308,>30,WI,Home,Upto 2014
BP Nash,WI,Pace,2011-06-20,Kingston,West Indies,2011,2,9,12,0,1,535,1130,25,526,1118,25,21.4,<=30,WI,Home,Upto 2014
BP Patterson,WI,Pace,1986-02-21,Kingston,West Indies,1986,2,74,131,7,1,543,1027,29,469,896,22,18.724137931034484,<=30,WI,Home,Upto 2014
BP Patterson,WI,Pace,1986-03-07,Port of Spain,West Indies,1986,2,125,148,2,1,694,1180,22,569,1032,20,31.545454545454547,>30,WI,Home,Upto 2014
BP Patterson,WI,Pace,1986-03-21,Bridgetown,West Indies,1986,2,82,142,6,1,585,983,28,503,841,22,20.892857142857142,<=30,WI,Home,Upto 2014
BP Patterson,WI,Pace,1986-04-03,Port of Spain,West Indies,1986,2,67,114,3,1,614,1036,27,547,922,24,22.74074074074074,<=30,WI,Home,Upto 2014
BP Patterson,WI,Pace,1986-04-11,St John's,West Indies,1986,2,78,174,1,1,906,1622,22,828,1448,21,41.18181818181818,>30,WI,Home,Upto 2014
BP Patterson,WI,Pace,1986-10-24,Faisalabad,Pakistan,1986,2,101,186,3,1,582,1145,28,481,959,25,20.785714285714285,<=30,PAK,Away,Upto 2014
BP Patterson,WI,Pace,1987-11-25,Delhi,India,1987,2,124,227,8,1,549,1170,28,425,943,20,19.607142857142858,<=30,IND,Away,Upto 2014
BP Patterson,WI,Pace,1987-12-11,Wankhede,India,1987,2,146,198,6,1,509,808,22,363,610,16,23.136363636363637,<=30,IND,Away,Upto 2014
BP Patterson,WI,Pace,1987-12-26,Eden Gardens,India,1987,1,107,134,1,1,580,866,11,473,732,10,52.72727272727273,>30,IND,Away,Upto 2014
BP Patterson,WI,Pace,1988-01-11,Chennai,India,1988,2,79,144,2,1,358,643,15,279,499,13,23.866666666666667,<=30,IND,Away,Upto 2014
BP Patterson,WI,Pace,1988-04-02,Georgetown,West Indies,1988,2,101,156,4,1,579,1055,22,478,899,18,26.318181818181817,<=30,WI,Home,Upto 2014
BP Patterson,WI,Pace,1988-06-02,Nottingham,England,1988,2,118,240,1,1,781,1741,19,663,1501,18,41.10526315789474,>30,ENG,Away,Upto 2014
BP Patterson,WI,Pace,1988-06-16,Lord's,England,1988,2,152,209,3,1,943,1804,37,791,1595,34,25.486486486486488,<=30,ENG,Away,Upto 2014
BP Patterson,WI,Pace,1988-11-18,Brisbane,Australia,1988,1,5,19,0,1,708,1383,27,703,1364,27,26.22222222222222,<=30,AUS,Away,Upto 2014
BP Patterson,WI,Pace,1988-12-02,W.A.C.A,Australia,1988,2,153,180,2,1,1183,2020,32,1030,1840,30,36.96875,>30,AUS,Away,Upto 2014
BP Patterson,WI,Pace,1988-12-24,Melbourne,Australia,1988,2,88,211,9,1,897,2063,38,809,1852,29,23.605263157894736,<=30,AUS,Away,Upto 2014
BP Patterson,WI,Pace,1989-02-03,Adelaide,Australia,1989,2,159,233,1,1,834,1481,18,675,1248,17,46.333333333333336,>30,AUS,Away,Upto 2014
BP Patterson,WI,Pace,1990-02-24,Kingston,West Indies,1990,2,85,126,1,1,668,1460,29,583,1334,28,23.03448275862069,<=30,WI,Home,Upto 2014
BP Patterson,WI,Pace,1991-03-01,Kingston,West Indies,1991,1,83,144,5,1,694,1365,21,611,1221,16,33.04761904761905,>30,WI,Home,Upto 2014
BP Patterson,WI,Pace,1991-03-23,Georgetown,West Indies,1991,2,126,228,5,1,808,1623,19,682,1395,14,42.526315789473685,>30,WI,Home,Upto 2014
BP Patterson,WI,Pace,1991-04-05,Port of Spain,West Indies,1991,2,77,198,5,1,449,1209,20,372,1011,15,22.45,<=30,WI,Home,Upto 2014
BP Patterson,WI,Pace,1991-04-19,Bridgetown,West Indies,1991,2,78,168,1,1,874,1849,33,796,1681,32,26.484848484848484,<=30,WI,Home,Upto 2014
BP Patterson,WI,Pace,1991-04-27,St John's,West Indies,1991,2,45,78,2,1,735,1397,30,690,1319,28,24.5,<=30,WI,Home,Upto 2014
BP Patterson,WI,Pace,1991-06-06,Leeds,England,1991,2,119,248,3,1,749,1729,37,630,1481,34,20.243243243243242,<=30,ENG,Away,Upto 2014
BP Patterson,WI,Pace,1991-07-25,Birmingham,England,1991,2,120,252,6,1,722,1721,32,602,1469,26,22.5625,<=30,ENG,Away,Upto 2014
BP Patterson,WI,Pace,1991-08-08,The Oval,England,1991,2,150,205,4,1,826,1668,26,676,1463,22,31.76923076923077,>30,ENG,Away,Upto 2014
BP Patterson,WI,Pace,1992-04-18,Bridgetown,West Indies,1992,2,105,180,1,1,919,1991,34,814,1811,33,27.029411764705884,<=30,WI,Home,Upto 2014
BP Patterson,WI,Pace,1992-11-27,Brisbane,Australia,1992,2,127,156,1,1,859,1899,30,732,1743,29,28.633333333333333,<=30,AUS,Away,Upto 2014
BR Jurangpathy,SL,Spin,1985-09-14,Kandy,Sri Lanka,1985,1,24,24,0,1,249,489,4,225,465,4,62.25,>30,SL,Home,Upto 2014
BR Jurangpathy,SL,Spin,1986-12-27,Nagpur,India,1986,1,69,126,1,1,408,845,19,339,719,18,21.473684210526315,<=30,IND,Away,Upto 2014
BR Knight,ENG,Pace,1961-12-01,Kanpur,India,1961,1,80,216,2,1,383,915,5,303,699,3,76.6,>30,IND,Away,Upto 2014
BR Knight,ENG,Pace,1961-12-13,Delhi,India,1961,1,72,147,2,1,206,507,4,134,360,2,51.5,>30,IND,Away,Upto 2014
BR Knight,ENG,Pace,1961-12-30,Eden Gardens,India,1961,2,79,150,2,1,412,930,9,333,780,7,45.77777777777778,>30,IND,Away,Upto 2014
BR Knight,ENG,Pace,1962-01-10,Chennai,India,1962,2,74,108,2,1,203,330,6,129,222,4,33.833333333333336,>30,IND,Away,Upto 2014
BR Knight,ENG,Pace,1962-01-19,Dhaka,Bangladesh,1962,2,71,258,1,1,164,648,2,93,390,1,82.0,>30,BAN,Away,Upto 2014
BR Knight,ENG,Pace,1962-02-02,Karachi,Pakistan,1962,2,109,216,5,1,353,912,11,244,696,6,32.09090909090909,>30,PAK,Away,Upto 2014
BR Knight,ENG,Pace,1962-07-26,Nottingham,England,1962,2,86,228,4,1,602,1369,18,516,1141,14,33.44444444444444,>30,ENG,Home,Upto 2014
BR Knight,ENG,Pace,1962-08-16,The Oval,England,1962,2,44,120,2,1,534,1069,17,490,949,15,31.41176470588235,>30,ENG,Home,Upto 2014
BR Knight,ENG,Pace,1962-11-30,Brisbane,Australia,1962,2,128,253,3,1,871,1952,19,743,1699,16,45.8421052631579,>30,AUS,Away,Upto 2014
BR Knight,ENG,Pace,1963-02-23,Auckland,New Zealand,1963,2,36,124,2,1,301,863,11,265,739,9,27.363636363636363,<=30,NZ,Away,Upto 2014
BR Knight,ENG,Pace,1963-03-01,Wellington,New Zealand,1963,2,39,150,4,1,394,894,13,355,744,9,30.307692307692307,>30,NZ,Away,Upto 2014
BR Knight,ENG,Pace,1963-03-15,Christchurch,New Zealand,1963,2,77,198,3,1,462,1331,21,385,1133,18,22.0,<=30,NZ,Away,Upto 2014
BR Knight,ENG,Pace,1964-01-10,Chennai,India,1964,2,95,204,1,1,259,498,2,164,294,1,129.5,>30,IND,Away,Upto 2014
BR Knight,ENG,Pace,1964-01-21,Brabourne,India,1964,2,81,198,4,1,366,747,11,285,549,7,33.27272727272727,>30,IND,Away,Upto 2014
BR Knight,ENG,Pace,1964-01-29,Eden Gardens,India,1964,2,72,104,1,1,354,661,13,282,557,12,27.23076923076923,<=30,IND,Away,Upto 2014
BR Knight,ENG,Pace,1964-02-08,Delhi,India,1964,2,93,114,0,1,223,360,2,130,246,2,111.5,>30,IND,Away,Upto 2014
BR Knight,ENG,Pace,1964-02-15,Kanpur,India,1964,2,16,18,0,1,118,235,3,102,217,3,39.333333333333336,>30,IND,Away,Upto 2014
BR Knight,ENG,Pace,1965-12-30,Melbourne,Australia,1965,2,145,381,6,1,657,1479,19,512,1098,13,34.578947368421055,>30,AUS,Away,Upto 2014
BR Knight,ENG,Pace,1966-02-11,Melbourne,Australia,1966,1,105,290,2,1,701,1506,15,596,1216,13,46.733333333333334,>30,AUS,Away,Upto 2014
BR Knight,ENG,Pace,1966-03-04,Dunedin,New Zealand,1966,2,44,210,2,1,364,1194,18,320,984,16,20.22222222222222,<=30,NZ,Away,Upto 2014
BR Knight,ENG,Pace,1966-03-11,Auckland,New Zealand,1966,2,61,204,1,1,459,1620,21,398,1416,20,21.857142857142858,<=30,NZ,Away,Upto 2014
BR Knight,ENG,Pace,1966-06-16,Lord's,England,1966,2,169,306,4,1,864,1752,24,695,1446,20,36.0,>30,ENG,Home,Upto 2014
BR Knight,ENG,Pace,1968-06-20,Lord's,England,1968,2,51,160,3,1,427,1141,15,376,981,12,28.466666666666665,<=30,ENG,Home,Upto 2014
BR Knight,ENG,Pace,1968-07-11,Birmingham,England,1968,1,34,84,1,1,595,1325,15,561,1241,14,39.666666666666664,>30,ENG,Home,Upto 2014
BR Knight,ENG,Pace,1969-06-12,Manchester,England,1969,2,26,84,2,1,490,1177,22,464,1093,20,22.272727272727273,<=30,ENG,Home,Upto 2014
BR Knight,ENG,Pace,1969-06-26,Lord's,England,1969,2,143,395,3,1,864,2111,25,721,1716,22,34.56,>30,ENG,Home,Upto 2014
BR Knight,ENG,Pace,1969-07-10,Leeds,England,1969,2,110,242,6,1,581,1581,25,471,1339,19,23.24,<=30,ENG,Home,Upto 2014
BR Knight,ENG,Pace,1969-07-24,Lord's,England,1969,2,25,78,0,1,463,1142,17,438,1064,17,27.235294117647058,<=30,ENG,Home,Upto 2014
BR Knight,ENG,Pace,1969-08-07,Nottingham,England,1969,2,58,137,2,1,534,1193,14,476,1056,12,38.142857142857146,>30,ENG,Home,Upto 2014
BR Taylor,NZ,Pace,1965-03-05,Eden Gardens,India,1965,1,86,143,5,1,421,713,14,335,570,9,30.071428571428573,>30,IND,Away,Upto 2014
BR Taylor,NZ,Pace,1965-03-12,Brabourne,India,1965,2,102,219,8,1,334,847,20,232,628,12,16.7,<=30,IND,Away,Upto 2014
BR Taylor,NZ,Pace,1965-03-19,Delhi,India,1965,2,88,132,2,1,283,544,9,195,412,7,31.444444444444443,>30,IND,Away,Upto 2014
BR Taylor,NZ,Pace,1965-03-27,Rawalpindi,Pakistan,1965,1,38,90,3,1,167,432,11,129,342,8,15.181818181818182,<=30,PAK,Away,Upto 2014
BR Taylor,NZ,Pace,1965-04-02,Lahore,Pakistan,1965,2,76,210,3,1,328,882,6,252,672,3,54.666666666666664,>30,PAK,Away,Upto 2014
BR Taylor,NZ,Pace,1965-04-09,Karachi,Pakistan,1965,2,97,174,0,1,333,774,10,236,600,10,33.3,>30,PAK,Away,Upto 2014
BR Taylor,NZ,Pace,1965-06-17,Lord's,England,1965,2,119,210,2,1,637,1471,22,518,1261,20,28.954545454545453,<=30,ENG,Away,Upto 2014
BR Taylor,NZ,Pace,1965-07-08,Leeds,England,1965,1,140,240,2,1,607,1237,14,467,997,12,43.357142857142854,>30,ENG,Away,Upto 2014
BR Taylor,NZ,Pace,1966-03-11,Auckland,New Zealand,1966,2,66,198,5,1,459,1620,21,393,1422,16,21.857142857142858,<=30,NZ,Home,Upto 2014
BR Taylor,NZ,Pace,1968-02-15,Dunedin,New Zealand,1968,2,117,258,3,1,426,1000,14,309,742,11,30.428571428571427,>30,NZ,Home,Upto 2014
BR Taylor,NZ,Pace,1968-02-29,Wellington,New Zealand,1968,1,59,163,3,1,330,661,9,271,498,6,36.666666666666664,>30,NZ,Home,Upto 2014
BR Taylor,NZ,Pace,1968-03-07,Auckland,New Zealand,1968,2,109,234,2,1,377,874,14,268,640,12,26.928571428571427,<=30,NZ,Home,Upto 2014
BR Taylor,NZ,Pace,1969-02-27,Auckland,New Zealand,1969,2,102,223,3,1,544,1153,15,442,930,12,36.266666666666666,>30,NZ,Home,Upto 2014
BR Taylor,NZ,Pace,1969-03-07,Wellington,New Zealand,1969,2,103,160,0,1,575,1263,24,472,1103,24,23.958333333333332,<=30,NZ,Home,Upto 2014
BR Taylor,NZ,Pace,1969-03-13,Christchurch,New Zealand,1969,1,63,116,2,1,436,944,10,373,828,8,43.6,>30,NZ,Home,Upto 2014
BR Taylor,NZ,Pace,1969-07-24,Lord's,England,1969,2,97,233,6,1,463,1142,17,366,909,11,27.235294117647058,<=30,ENG,Away,Upto 2014
BR Taylor,NZ,Pace,1969-08-21,The Oval,England,1969,2,58,150,4,1,397,1023,15,339,873,11,26.466666666666665,<=30,ENG,Away,Upto 2014
BR Taylor,NZ,Pace,1969-09-25,Brabourne,India,1969,2,67,182,4,1,336,982,18,269,800,14,18.666666666666668,<=30,IND,Away,Upto 2014
BR Taylor,NZ,Pace,1969-10-15,Hyderabad (Deccan),India,1969,2,38,108,2,1,198,715,20,160,607,18,9.9,<=30,IND,Away,Upto 2014
BR Taylor,NZ,Pace,1969-10-30,Lahore,Pakistan,1969,2,39,173,3,1,161,587,12,122,414,9,13.416666666666666,<=30,PAK,Away,Upto 2014
BR Taylor,NZ,Pace,1972-03-09,Port of Spain,West Indies,1972,2,67,193,7,1,314,919,14,247,726,7,22.428571428571427,<=30,WI,Away,Upto 2014
BR Taylor,NZ,Pace,1972-03-23,Bridgetown,West Indies,1972,2,182,321,9,1,605,1337,20,423,1016,11,30.25,>30,WI,Away,Upto 2014
BR Taylor,NZ,Pace,1972-04-06,Georgetown,West Indies,1972,2,114,258,3,1,457,1170,6,343,912,3,76.16666666666667,>30,WI,Away,Upto 2014
BR Taylor,NZ,Pace,1972-04-20,Port of Spain,West Indies,1972,2,115,262,8,1,397,954,17,282,692,9,23.352941176470587,<=30,WI,Away,Upto 2014
BR Taylor,NZ,Pace,1973-02-02,Wellington,New Zealand,1973,2,173,284,5,1,687,1320,19,514,1036,14,36.1578947368421,>30,NZ,Home,Upto 2014
BR Taylor,NZ,Pace,1973-02-07,Dunedin,New Zealand,1973,1,91,176,2,1,333,648,6,242,472,4,55.5,>30,NZ,Home,Upto 2014
BR Taylor,NZ,Pace,1973-02-16,Auckland,New Zealand,1973,2,152,408,6,1,643,1420,15,491,1012,9,42.86666666666667,>30,NZ,Home,Upto 2014
BR Taylor,NZ,Pace,1973-06-07,Nottingham,England,1973,2,140,312,5,1,817,1990,27,677,1678,22,30.25925925925926,>30,ENG,Away,Upto 2014
BR Taylor,NZ,Pace,1973-06-21,Lord's,England,1973,2,144,318,2,1,777,1763,19,633,1445,17,40.89473684210526,>30,ENG,Away,Upto 2014
BR Taylor,NZ,Pace,1973-07-05,Leeds,England,1973,1,111,186,2,1,624,1466,29,513,1280,27,21.517241379310345,<=30,ENG,Away,Upto 2014
BRM Taylor,ZIM,Spin,2005-01-14,Dhaka,Bangladesh,2005,1,11,24,0,1,497,1234,18,486,1210,18,27.61111111111111,<=30,BAN,Away,Upto 2014
BRM Taylor,ZIM,Spin,2005-03-04,Cape Town,South Africa,2005,1,7,6,0,1,206,230,7,199,224,7,29.428571428571427,<=30,SA,Away,Upto 2014
BRM Taylor,ZIM,Spin,2005-03-11,Centurion,South Africa,2005,1,6,6,0,1,252,431,4,246,425,4,63.0,>30,SA,Away,Upto 2014
BRM Taylor,ZIM,Spin,2005-08-07,Harare,Zimbabwe,2005,1,14,6,0,1,156,237,7,142,231,7,22.285714285714285,<=30,ZIM,Home,Upto 2014
BS Bedi,IND,Spin,1966-12-31,Eden Gardens,India,1966,1,92,216,2,1,445,1335,20,353,1119,18,22.25,<=30,IND,Home,Upto 2014
BS Bedi,IND,Spin,1967-01-13,Chennai,India,1967,2,136,282,5,1,841,1944,23,705,1662,18,36.56521739130435,>30,IND,Home,Upto 2014
BS Bedi,IND,Spin,1967-06-08,Leeds,England,1967,1,32,90,0,1,861,2089,19,829,1999,19,45.31578947368421,>30,ENG,Away,Upto 2014
BS Bedi,IND,Spin,1967-06-22,Lord's,England,1967,1,68,188,3,1,346,971,18,278,783,15,19.22222222222222,<=30,ENG,Away,Upto 2014
BS Bedi,IND,Spin,1967-07-13,Birmingham,England,1967,2,136,306,4,1,686,1638,33,550,1332,29,20.78787878787879,<=30,ENG,Away,Upto 2014
BS Bedi,IND,Spin,1968-01-19,Brisbane,Australia,1968,2,115,296,1,1,711,2018,22,596,1722,21,32.31818181818182,>30,AUS,Away,Upto 2014
BS Bedi,IND,Spin,1968-01-26,Sydney,Australia,1968,2,108,336,3,1,552,1735,27,444,1399,24,20.444444444444443,<=30,AUS,Away,Upto 2014
BS Bedi,IND,Spin,1968-02-15,Dunedin,New Zealand,1968,2,134,354,2,1,642,1761,17,508,1407,15,37.76470588235294,>30,NZ,Away,Upto 2014
BS Bedi,IND,Spin,1968-02-22,Christchurch,New Zealand,1968,2,148,387,8,1,599,1533,16,451,1146,8,37.4375,>30,NZ,Away,Upto 2014
BS Bedi,IND,Spin,1968-02-29,Wellington,New Zealand,1968,2,54,108,1,1,408,1093,20,354,985,19,20.4,<=30,NZ,Away,Upto 2014
BS Bedi,IND,Spin,1968-03-07,Auckland,New Zealand,1968,2,35,208,5,1,303,1079,19,268,871,14,15.947368421052632,<=30,NZ,Away,Upto 2014
BS Bedi,IND,Spin,1969-09-25,Brabourne,India,1969,2,93,407,8,1,396,1358,19,303,951,11,20.842105263157894,<=30,IND,Home,Upto 2014
BS Bedi,IND,Spin,1969-10-03,Nagpur,India,1969,2,144,462,5,1,677,1910,37,533,1448,32,18.2972972972973,<=30,IND,Home,Upto 2014
BS Bedi,IND,Spin,1969-10-15,Hyderabad (Deccan),India,1969,2,71,258,2,1,301,978,13,230,720,11,23.153846153846153,<=30,IND,Home,Upto 2014
BS Bedi,IND,Spin,1969-11-04,Brabourne,India,1969,2,85,430,3,1,483,1714,20,398,1284,17,24.15,<=30,IND,Home,Upto 2014
BS Bedi,IND,Spin,1969-11-15,Kanpur,India,1969,2,90,312,1,1,657,2057,13,567,1745,12,50.53846153846154,>30,IND,Home,Upto 2014
BS Bedi,IND,Spin,1969-11-28,Delhi,India,1969,2,108,390,9,1,604,1737,30,496,1347,21,20.133333333333333,<=30,IND,Home,Upto 2014
BS Bedi,IND,Spin,1969-12-12,Eden Gardens,India,1969,1,98,300,7,1,380,1033,12,282,733,5,31.666666666666668,>30,IND,Home,Upto 2014
BS Bedi,IND,Spin,1969-12-24,Chennai,India,1969,2,51,210,1,1,490,1347,28,439,1137,27,17.5,<=30,IND,Home,Upto 2014
BS Bedi,IND,Spin,1971-02-18,Kingston,West Indies,1971,2,126,335,3,1,757,1901,17,631,1566,14,44.529411764705884,>30,WI,Away,Upto 2014
BS Bedi,IND,Spin,1971-03-06,Port of Spain,West Indies,1971,2,96,275,5,1,708,1890,29,612,1615,24,24.413793103448278,<=30,WI,Away,Upto 2014
BS Bedi,IND,Spin,1971-03-19,Georgetown,West Indies,1971,2,140,486,4,1,785,2232,14,645,1746,10,56.07142857142857,>30,WI,Away,Upto 2014
BS Bedi,IND,Spin,1971-04-01,Bridgetown,West Indies,1971,2,130,330,2,1,692,1614,11,562,1284,9,62.90909090909091,>30,WI,Away,Upto 2014
BS Bedi,IND,Spin,1971-04-13,Port of Spain,West Indies,1971,2,164,438,1,1,963,2470,24,799,2032,23,40.125,>30,WI,Away,Upto 2014
BS Bedi,IND,Spin,1971-07-22,Lord's,England,1971,2,111,417,6,1,610,1919,28,499,1502,22,21.785714285714285,<=30,ENG,Away,Upto 2014
BS Bedi,IND,Spin,1971-08-05,Manchester,England,1971,2,93,270,2,1,461,1050,7,368,780,5,65.85714285714286,>30,ENG,Away,Upto 2014
BS Bedi,IND,Spin,1971-08-19,The Oval,England,1971,2,121,222,3,1,621,1646,28,500,1424,25,22.178571428571427,<=30,ENG,Away,Upto 2014
BS Bedi,IND,Spin,1972-12-20,Delhi,India,1972,2,109,516,5,1,561,1750,23,452,1234,18,24.391304347826086,<=30,IND,Home,Upto 2014
BS Bedi,IND,Spin,1972-12-30,Eden Gardens,India,1972,2,122,396,7,1,461,1469,28,339,1073,21,16.464285714285715,<=30,IND,Home,Upto 2014
BS Bedi,IND,Spin,1973-01-12,Chennai,India,1973,2,104,438,6,1,632,1828,31,528,1390,25,20.387096774193548,<=30,IND,Home,Upto 2014
BS Bedi,IND,Spin,1973-01-25,Kanpur,India,1973,1,134,413,3,1,638,1919,18,504,1506,15,35.44444444444444,>30,IND,Home,Upto 2014
BS Bedi,IND,Spin,1973-02-06,Brabourne,India,1973,2,163,474,4,1,967,2173,20,804,1699,16,48.35,>30,IND,Home,Upto 2014
BS Bedi,IND,Spin,1974-06-06,Manchester,England,1974,2,145,378,3,1,468,1159,11,323,781,8,42.54545454545455,>30,ENG,Away,Upto 2014
BS Bedi,IND,Spin,1974-06-20,Lord's,England,1974,1,226,386,6,1,526,1013,10,300,627,4,52.6,>30,ENG,Away,Upto 2014
BS Bedi,IND,Spin,1974-07-04,Birmingham,England,1974,1,152,270,1,1,474,954,5,322,684,4,94.8,>30,ENG,Away,Upto 2014
BS Bedi,IND,Spin,1974-12-11,Delhi,India,1974,1,146,318,1,1,662,1469,18,516,1151,17,36.77777777777778,>30,IND,Home,Upto 2014
BS Bedi,IND,Spin,1974-12-27,Eden Gardens,India,1974,2,120,308,6,1,505,1382,15,385,1074,9,33.666666666666664,>30,IND,Home,Upto 2014
BS Bedi,IND,Spin,1975-01-11,Chennai,India,1975,2,69,228,6,1,340,944,19,271,716,13,17.894736842105264,<=30,IND,Home,Upto 2014
BS Bedi,IND,Spin,1975-01-23,Wankhede,India,1975,2,164,246,2,1,833,1734,13,669,1488,11,64.07692307692308,>30,IND,Home,Upto 2014
BS Bedi,IND,Spin,1976-02-05,Christchurch,New Zealand,1976,1,59,264,1,1,255,744,3,196,480,2,85.0,>30,NZ,Away,Upto 2014
BS Bedi,IND,Spin,1976-02-13,Wellington,New Zealand,1976,1,63,216,3,1,139,461,6,76,245,3,23.166666666666668,<=30,NZ,Away,Upto 2014
BS Bedi,IND,Spin,1976-03-10,Bridgetown,West Indies,1976,1,113,263,3,1,501,996,16,388,733,13,31.3125,>30,WI,Away,Upto 2014
BS Bedi,IND,Spin,1976-03-24,Port of Spain,West Indies,1976,2,126,420,8,1,529,1608,16,403,1188,8,33.0625,>30,WI,Away,Upto 2014
BS Bedi,IND,Spin,1976-04-07,Port of Spain,West Indies,1976,2,149,330,5,1,858,2099,21,709,1769,16,40.857142857142854,>30,WI,Away,Upto 2014
BS Bedi,IND,Spin,1976-04-21,Kingston,West Indies,1976,1,68,192,2,1,368,831,11,300,639,9,33.45454545454545,>30,WI,Away,Upto 2014
BS Bedi,IND,Spin,1976-11-10,Wankhede,India,1976,2,98,501,7,1,560,1714,23,462,1213,16,24.347826086956523,<=30,IND,Home,Upto 2014
BS Bedi,IND,Spin,1976-11-18,Kanpur,India,1976,2,122,486,6,1,806,2159,22,684,1673,16,36.63636363636363,>30,IND,Home,Upto 2014
BS Bedi,IND,Spin,1976-11-26,Chennai,India,1976,2,70,232,9,1,433,1077,20,363,845,11,21.65,<=30,IND,Home,Upto 2014
BS Bedi,IND,Spin,1976-12-17,Delhi,India,1976,1,92,354,4,1,485,1319,16,393,965,12,30.3125,>30,IND,Home,Upto 2014
BS Bedi,IND,Spin,1977-01-01,Eden Gardens,India,1977,2,116,394,5,1,396,1315,15,280,921,10,26.4,<=30,IND,Home,Upto 2014
BS Bedi,IND,Spin,1977-01-14,Chennai,India,1977,2,105,311,4,1,366,1090,21,261,779,17,17.428571428571427,<=30,IND,Home,Upto 2014
BS Bedi,IND,Spin,1977-01-28,Bengaluru,India,1977,2,100,267,7,1,552,1373,26,452,1106,19,21.23076923076923,<=30,IND,Home,Upto 2014
BS Bedi,IND,Spin,1977-02-11,Wankhede,India,1977,2,161,462,5,1,658,1830,25,497,1368,20,26.32,<=30,IND,Home,Upto 2014
BS Bedi,IND,Spin,1977-12-02,Brisbane,Australia,1977,2,126,260,5,1,389,908,12,263,648,7,32.416666666666664,>30,AUS,Away,Upto 2014
BS Bedi,IND,Spin,1977-12-16,W.A.C.A,Australia,1977,2,194,490,10,1,719,1592,15,525,1102,5,47.93333333333333,>30,AUS,Away,Upto 2014
BS Bedi,IND,Spin,1977-12-30,Melbourne,Australia,1977,2,129,249,6,1,349,802,20,220,553,14,17.45,<=30,AUS,Away,Upto 2014
BS Bedi,IND,Spin,1978-01-07,Sydney,Australia,1978,2,111,328,5,1,426,1124,16,315,796,11,26.625,<=30,AUS,Away,Upto 2014
BS Bedi,IND,Spin,1978-01-28,Adelaide,Australia,1978,2,180,432,5,1,820,1960,16,640,1528,11,51.25,>30,AUS,Away,Upto 2014
BS Bedi,IND,Spin,1978-10-16,Faisalabad,Pakistan,1978,2,164,366,3,1,700,1410,15,536,1044,12,46.666666666666664,>30,PAK,Away,Upto 2014
BS Bedi,IND,Spin,1978-10-27,Lahore,Pakistan,1978,2,153,228,2,1,591,988,6,438,760,4,98.5,>30,PAK,Away,Upto 2014
BS Bedi,IND,Spin,1978-11-14,Karachi,Pakistan,1978,2,132,234,1,1,383,654,5,251,420,4,76.6,>30,PAK,Away,Upto 2014
BS Bedi,IND,Spin,1978-12-01,Wankhede,India,1978,1,102,216,1,1,556,1295,9,454,1079,8,61.77777777777778,>30,IND,Home,Upto 2014
BS Bedi,IND,Spin,1978-12-15,Bengaluru,India,1978,2,131,288,4,1,411,996,8,280,708,4,51.375,>30,IND,Home,Upto 2014
BS Bedi,IND,Spin,1978-12-29,Eden Gardens,India,1978,2,91,276,2,1,375,1048,13,284,772,11,28.846153846153847,<=30,IND,Home,Upto 2014
BS Bedi,IND,Spin,1979-08-02,Lord's,England,1979,1,87,233,2,1,266,749,5,179,516,3,53.2,>30,ENG,Away,Upto 2014
BS Bedi,IND,Spin,1979-08-16,Leeds,England,1979,1,26,53,2,1,162,455,6,136,402,4,27.0,<=30,ENG,Away,Upto 2014
BS Bedi,IND,Spin,1979-08-30,The Oval,England,1979,2,136,335,3,1,489,1222,10,353,887,7,48.9,>30,ENG,Away,Upto 2014
BS Chandrasekhar,IND,Spin,1964-01-21,Brabourne,India,1964,2,107,372,5,1,560,2208,16,453,1836,11,35.0,>30,IND,Home,Upto 2014
BS Chandrasekhar,IND,Spin,1964-01-29,Eden Gardens,India,1964,2,56,174,1,1,555,1794,16,499,1620,15,34.6875,>30,IND,Home,Upto 2014
BS Chandrasekhar,IND,Spin,1964-02-08,Delhi,India,1964,1,79,207,3,1,1001,2631,20,922,2424,17,50.05,>30,IND,Home,Upto 2014
BS Chandrasekhar,IND,Spin,1964-02-15,Kanpur,India,1964,1,97,216,1,1,987,2874,18,890,2658,17,54.833333333333336,>30,IND,Home,Upto 2014
BS Chandrasekhar,IND,Spin,1964-10-10,Brabourne,India,1964,2,123,336,8,1,796,2173,26,673,1837,18,30.615384615384617,>30,IND,Home,Upto 2014
BS Chandrasekhar,IND,Spin,1964-10-17,Eden Gardens,India,1964,2,66,221,1,1,407,1253,16,341,1032,15,25.4375,<=30,IND,Home,Upto 2014
BS Chandrasekhar,IND,Spin,1965-03-12,Brabourne,India,1965,2,101,222,4,1,545,1316,11,444,1094,7,49.54545454545455,>30,IND,Home,Upto 2014
BS Chandrasekhar,IND,Spin,1965-03-19,Delhi,India,1965,2,191,426,4,1,716,1840,21,525,1414,17,34.095238095238095,>30,IND,Home,Upto 2014
BS Chandrasekhar,IND,Spin,1966-12-13,Brabourne,India,1966,2,235,557,11,1,1023,2319,28,788,1762,17,36.535714285714285,>30,IND,Home,Upto 2014
BS Chandrasekhar,IND,Spin,1966-12-31,Eden Gardens,India,1966,1,107,276,3,1,445,1335,20,338,1059,17,22.25,<=30,IND,Home,Upto 2014
BS Chandrasekhar,IND,Spin,1967-01-13,Chennai,India,1967,2,171,348,4,1,841,1944,23,670,1596,19,36.56521739130435,>30,IND,Home,Upto 2014
BS Chandrasekhar,IND,Spin,1967-06-08,Leeds,England,1967,2,171,384,5,1,861,2089,19,690,1705,14,45.31578947368421,>30,ENG,Away,Upto 2014
BS Chandrasekhar,IND,Spin,1967-06-22,Lord's,England,1967,1,127,318,5,1,346,971,18,219,653,13,19.22222222222222,<=30,ENG,Away,Upto 2014
BS Chandrasekhar,IND,Spin,1967-07-13,Birmingham,England,1967,2,137,317,6,1,686,1638,33,549,1321,27,20.78787878787879,<=30,ENG,Away,Upto 2014
BS Chandrasekhar,IND,Spin,1967-12-23,Adelaide,Australia,1967,2,139,321,1,1,620,1381,10,481,1060,9,62.0,>30,AUS,Away,Upto 2014
BS Chandrasekhar,IND,Spin,1967-12-30,Melbourne,Australia,1967,1,35,56,0,1,312,712,11,277,656,11,28.363636363636363,<=30,AUS,Away,Upto 2014
BS Chandrasekhar,IND,Spin,1971-07-22,Lord's,England,1971,2,170,432,5,1,610,1919,28,440,1487,23,21.785714285714285,<=30,ENG,Away,Upto 2014
BS Chandrasekhar,IND,Spin,1971-08-05,Manchester,England,1971,2,95,192,0,1,461,1050,7,366,858,7,65.85714285714286,>30,ENG,Away,Upto 2014
BS Chandrasekhar,IND,Spin,1971-08-19,The Oval,England,1971,2,114,253,8,1,621,1646,28,507,1393,20,22.178571428571427,<=30,ENG,Away,Upto 2014
BS Chandrasekhar,IND,Spin,1972-12-20,Delhi,India,1972,2,149,395,9,1,561,1750,23,412,1355,14,24.391304347826086,<=30,IND,Home,Upto 2014
BS Chandrasekhar,IND,Spin,1972-12-30,Eden Gardens,India,1972,2,107,332,9,1,461,1469,28,354,1137,19,16.464285714285715,<=30,IND,Home,Upto 2014
BS Chandrasekhar,IND,Spin,1973-01-12,Chennai,India,1973,2,159,443,7,1,632,1828,31,473,1385,24,20.387096774193548,<=30,IND,Home,Upto 2014
BS Chandrasekhar,IND,Spin,1973-01-25,Kanpur,India,1973,1,86,246,4,1,638,1919,18,552,1673,14,35.44444444444444,>30,IND,Home,Upto 2014
BS Chandrasekhar,IND,Spin,1973-02-06,Brabourne,India,1973,2,161,331,6,1,967,2173,20,806,1842,14,48.35,>30,IND,Home,Upto 2014
BS Chandrasekhar,IND,Spin,1974-06-06,Manchester,England,1974,2,93,192,2,1,468,1159,11,375,967,9,42.54545454545455,>30,ENG,Away,Upto 2014
BS Chandrasekhar,IND,Spin,1974-06-20,Lord's,England,1974,1,33,57,0,1,526,1013,10,493,956,10,52.6,>30,ENG,Away,Upto 2014
BS Chandrasekhar,IND,Spin,1974-11-22,Bengaluru,India,1974,2,214,306,6,1,592,1136,16,378,830,10,37.0,>30,IND,Home,Upto 2014
BS Chandrasekhar,IND,Spin,1974-12-27,Eden Gardens,India,1974,2,146,252,4,1,505,1382,15,359,1130,11,33.666666666666664,>30,IND,Home,Upto 2014
BS Chandrasekhar,IND,Spin,1975-01-11,Chennai,India,1975,2,84,176,3,1,340,944,19,256,768,16,17.894736842105264,<=30,IND,Home,Upto 2014
BS Chandrasekhar,IND,Spin,1975-01-23,Wankhede,India,1975,1,135,210,1,1,833,1734,13,698,1524,12,64.07692307692308,>30,IND,Home,Upto 2014
BS Chandrasekhar,IND,Spin,1976-01-24,Auckland,New Zealand,1976,2,179,418,8,1,633,1676,24,454,1258,16,26.375,<=30,NZ,Away,Upto 2014
BS Chandrasekhar,IND,Spin,1976-02-05,Christchurch,New Zealand,1976,1,60,120,0,1,255,744,3,195,624,3,85.0,>30,NZ,Away,Upto 2014
BS Chandrasekhar,IND,Spin,1976-02-13,Wellington,New Zealand,1976,1,55,181,3,1,139,461,6,84,280,3,23.166666666666668,<=30,NZ,Away,Upto 2014
BS Chandrasekhar,IND,Spin,1976-03-10,Bridgetown,West Indies,1976,1,163,234,4,1,501,996,16,338,762,12,31.3125,>30,WI,Away,Upto 2014
BS Chandrasekhar,IND,Spin,1976-03-24,Port of Spain,West Indies,1976,2,132,366,4,1,529,1608,16,397,1242,12,33.0625,>30,WI,Away,Upto 2014
BS Chandrasekhar,IND,Spin,1976-04-07,Port of Spain,West Indies,1976,2,208,356,8,1,858,2099,21,650,1743,13,40.857142857142854,>30,WI,Away,Upto 2014
BS Chandrasekhar,IND,Spin,1976-04-21,Kingston,West Indies,1976,1,153,252,5,1,368,831,11,215,579,6,33.45454545454545,>30,WI,Away,Upto 2014
BS Chandrasekhar,IND,Spin,1976-11-10,Wankhede,India,1976,2,136,380,6,1,560,1714,23,424,1334,17,24.347826086956523,<=30,IND,Home,Upto 2014
BS Chandrasekhar,IND,Spin,1976-11-18,Kanpur,India,1976,2,163,419,5,1,806,2159,22,643,1740,17,36.63636363636363,>30,IND,Home,Upto 2014
BS Chandrasekhar,IND,Spin,1976-11-26,Chennai,India,1976,2,92,216,6,1,433,1077,20,341,861,14,21.65,<=30,IND,Home,Upto 2014
BS Chandrasekhar,IND,Spin,1976-12-17,Delhi,India,1976,1,117,197,3,1,485,1319,16,368,1122,13,30.3125,>30,IND,Home,Upto 2014
BS Chandrasekhar,IND,Spin,1977-01-01,Eden Gardens,India,1977,1,66,198,0,1,396,1315,15,330,1117,15,26.4,<=30,IND,Home,Upto 2014
BS Chandrasekhar,IND,Spin,1977-01-14,Chennai,India,1977,2,113,275,5,1,366,1090,21,253,815,16,17.428571428571427,<=30,IND,Home,Upto 2014
BS Chandrasekhar,IND,Spin,1977-01-28,Bengaluru,India,1977,2,131,278,9,1,552,1373,26,421,1095,17,21.23076923076923,<=30,IND,Home,Upto 2014
BS Chandrasekhar,IND,Spin,1977-02-11,Wankhede,India,1977,2,110,216,2,1,658,1830,25,548,1614,23,26.32,<=30,IND,Home,Upto 2014
BS Chandrasekhar,IND,Spin,1977-12-02,Brisbane,Australia,1977,2,116,256,4,1,389,908,12,273,652,8,32.416666666666664,>30,AUS,Away,Upto 2014
BS Chandrasekhar,IND,Spin,1977-12-16,W.A.C.A,Australia,1977,2,181,390,1,1,719,1592,15,538,1202,14,47.93333333333333,>30,AUS,Away,Upto 2014
BS Chandrasekhar,IND,Spin,1977-12-30,Melbourne,Australia,1977,2,104,273,12,1,349,802,20,245,529,8,17.45,<=30,AUS,Away,Upto 2014
BS Chandrasekhar,IND,Spin,1978-01-07,Sydney,Australia,1978,2,115,312,6,1,426,1124,16,311,812,10,26.625,<=30,AUS,Away,Upto 2014
BS Chandrasekhar,IND,Spin,1978-01-28,Adelaide,Australia,1978,2,188,348,5,1,820,1960,16,632,1612,11,51.25,>30,AUS,Away,Upto 2014
BS Chandrasekhar,IND,Spin,1978-10-16,Faisalabad,Pakistan,1978,2,179,300,4,1,700,1410,15,521,1110,11,46.666666666666664,>30,PAK,Away,Upto 2014
BS Chandrasekhar,IND,Spin,1978-10-27,Lahore,Pakistan,1978,1,109,126,1,1,591,988,6,482,862,5,98.5,>30,PAK,Away,Upto 2014
BS Chandrasekhar,IND,Spin,1978-11-14,Karachi,Pakistan,1978,1,97,150,3,1,383,654,5,286,504,2,76.6,>30,PAK,Away,Upto 2014
BS Chandrasekhar,IND,Spin,1978-12-01,Wankhede,India,1978,1,116,258,5,1,556,1295,9,440,1037,4,61.77777777777778,>30,IND,Home,Upto 2014
BS Chandrasekhar,IND,Spin,1978-12-15,Bengaluru,India,1978,2,133,270,2,1,411,996,8,278,726,6,51.375,>30,IND,Home,Upto 2014
BS Chandrasekhar,IND,Spin,1979-01-24,Delhi,India,1979,2,65,186,4,1,226,544,8,161,358,4,28.25,<=30,IND,Home,Upto 2014
BS Chandrasekhar,IND,Spin,1979-02-02,Kanpur,India,1979,1,117,246,1,1,445,1037,7,328,791,6,63.57142857142857,>30,IND,Home,Upto 2014
BS Chandrasekhar,IND,Spin,1979-07-12,Birmingham,England,1979,1,113,174,0,1,393,774,2,280,600,2,196.5,>30,ENG,Away,Upto 2014
BS Sandhu,IND,Pace,1983-01-14,Hyderabad (Sind),Pakistan,1983,1,107,198,2,1,503,996,17,396,798,15,29.58823529411765,<=30,PAK,Away,Upto 2014
BS Sandhu,IND,Pace,1983-01-23,Lahore,Pakistan,1983,1,56,126,0,1,359,745,10,303,619,10,35.9,>30,PAK,Away,Upto 2014
BS Sandhu,IND,Pace,1983-01-30,Karachi,Pakistan,1983,1,87,170,2,1,655,1382,13,568,1212,11,50.38461538461539,>30,PAK,Away,Upto 2014
BS Sandhu,IND,Pace,1983-02-23,Kingston,West Indies,1983,2,52,84,0,1,545,1266,30,493,1182,30,18.166666666666668,<=30,WI,Away,Upto 2014
BS Sandhu,IND,Pace,1983-03-11,Port of Spain,West Indies,1983,1,69,114,2,1,669,1364,18,600,1250,16,37.166666666666664,>30,WI,Away,Upto 2014
BS Sandhu,IND,Pace,1983-03-31,Georgetown,West Indies,1983,1,87,154,3,1,361,700,8,274,546,5,45.125,>30,WI,Away,Upto 2014
BS Sandhu,IND,Pace,1983-04-15,Bridgetown,West Indies,1983,1,21,30,0,1,618,1146,24,597,1116,24,25.75,<=30,WI,Away,Upto 2014
BS Sandhu,IND,Pace,1983-11-12,Ahmedabad,India,1983,2,78,144,1,1,524,1257,33,446,1113,32,15.878787878787879,<=30,IND,Home,Upto 2014
BT Watambwa,ZIM,Pace,2001-04-19,Bulawayo,Zimbabwe,2001,2,82,180,3,1,731,1458,26,649,1278,23,28.115384615384617,<=30,ZIM,Home,Upto 2014
BT Watambwa,ZIM,Pace,2001-04-26,Harare,Zimbabwe,2001,2,112,221,6,1,669,1497,14,557,1276,8,47.785714285714285,>30,ZIM,Home,Upto 2014
BT Watambwa,ZIM,Pace,2001-06-07,Bulawayo,Zimbabwe,2001,2,148,245,3,1,658,1325,23,510,1080,20,28.608695652173914,<=30,ZIM,Home,Upto 2014
BT Watambwa,ZIM,Pace,2001-06-15,Harare,Zimbabwe,2001,1,14,22,1,1,726,1580,27,712,1558,26,26.88888888888889,<=30,ZIM,Home,Upto 2014
BT Watambwa,ZIM,Pace,2002-02-21,Nagpur,India,2002,1,87,155,1,1,439,839,7,352,684,6,62.714285714285715,>30,IND,Away,Upto 2014
BT Watambwa,ZIM,Pace,2002-02-28,Delhi,India,2002,1,47,108,0,1,446,889,10,399,781,10,44.6,>30,IND,Away,Upto 2014
BV Sears,NZ,Pace,2024-03-08,Christchurch,New Zealand,2024,2,161,198,5,1,918,1490,33,757,1292,28,27.818181818181817,<=30,NZ,Home,After 1965
BV Vitori,ZIM,Pace,2011-08-04,Harare,Zimbabwe,2011,2,122,228,5,1,850,1557,26,728,1329,21,32.69230769230769,>30,ZIM,Home,Upto 2014
BV Vitori,ZIM,Pace,2011-09-01,Bulawayo,Zimbabwe,2011,2,118,162,0,1,539,1117,15,421,955,15,35.93333333333333,>30,ZIM,Home,Upto 2014
BV Vitori,ZIM,Pace,2012-01-26,Napier,New Zealand,2012,1,94,150,1,1,497,972,21,403,822,20,23.666666666666668,<=30,NZ,Away,Upto 2014
BV Vitori,ZIM,Pace,2013-09-10,Harare,Zimbabwe,2013,2,130,293,6,1,558,1504,28,428,1211,22,19.928571428571427,<=30,ZIM,Home,Upto 2014
BW Hilfenhaus,AUS,Pace,2009-02-26,Johannesburg,South Africa,2009,2,126,336,3,1,938,1937,36,812,1601,33,26.055555555555557,<=30,SA,Away,Upto 2014
BW Hilfenhaus,AUS,Pace,2009-03-06,Durban,South Africa,2009,2,107,210,2,1,857,1739,26,750,1529,24,32.96153846153846,>30,SA,Away,Upto 2014
BW Hilfenhaus,AUS,Pace,2009-03-19,Cape Town,South Africa,2009,1,133,204,2,1,890,1587,18,757,1383,16,49.44444444444444,>30,SA,Away,Upto 2014
BW Hilfenhaus,AUS,Pace,2009-07-08,Cardiff,England,2009,2,124,252,5,1,832,1434,18,708,1182,13,46.22222222222222,>30,ENG,Away,Upto 2014
BW Hilfenhaus,AUS,Pace,2009-07-16,Lord's,England,2009,2,162,300,4,1,1009,1590,27,847,1290,23,37.370370370370374,>30,ENG,Away,Upto 2014
BW Hilfenhaus,AUS,Pace,2009-07-30,Birmingham,England,2009,1,109,180,4,1,806,1353,22,697,1173,18,36.63636363636363,>30,ENG,Away,Upto 2014
BW Hilfenhaus,AUS,Pace,2009-08-07,Leeds,England,2009,2,80,156,5,1,700,1101,30,620,945,25,23.333333333333332,<=30,ENG,Away,Upto 2014
BW Hilfenhaus,AUS,Pace,2009-08-20,The Oval,England,2009,2,129,197,4,1,842,1408,23,713,1211,19,36.608695652173914,>30,ENG,Away,Upto 2014
BW Hilfenhaus,AUS,Pace,2009-11-26,Brisbane,Australia,2009,2,70,138,5,1,697,1123,21,627,985,16,33.19047619047619,>30,AUS,Home,Upto 2014
BW Hilfenhaus,AUS,Pace,2010-07-13,Lord's,England,2010,2,74,168,3,1,698,1252,26,624,1084,23,26.846153846153847,<=30,ENG,Away,Upto 2014
BW Hilfenhaus,AUS,Pace,2010-07-21,Leeds,England,2010,2,116,203,5,1,714,1273,33,598,1070,28,21.636363636363637,<=30,ENG,Away,Upto 2014
BW Hilfenhaus,AUS,Pace,2010-10-01,Mohali,India,2010,2,157,264,4,1,619,1051,25,462,787,21,24.76,<=30,IND,Away,Upto 2014
BW Hilfenhaus,AUS,Pace,2010-10-09,Bengaluru,India,2010,2,104,228,2,1,635,1166,15,531,938,13,42.333333333333336,>30,IND,Away,Upto 2014
BW Hilfenhaus,AUS,Pace,2010-11-25,Brisbane,Australia,2010,2,142,306,1,1,947,1750,17,805,1444,16,55.705882352941174,>30,AUS,Home,Upto 2014
BW Hilfenhaus,AUS,Pace,2010-12-16,W.A.C.A,Australia,2010,2,69,186,1,1,755,1419,38,686,1233,37,19.86842105263158,<=30,AUS,Home,Upto 2014
BW Hilfenhaus,AUS,Pace,2010-12-26,Melbourne,Australia,2010,1,83,222,2,1,704,1424,26,621,1202,24,27.076923076923077,<=30,AUS,Home,Upto 2014
BW Hilfenhaus,AUS,Pace,2011-01-03,Sydney,Australia,2011,1,121,233,3,1,873,1642,26,752,1409,23,33.57692307692308,>30,AUS,Home,Upto 2014
BW Hilfenhaus,AUS,Pace,2011-12-26,Melbourne,Australia,2011,2,114,264,7,1,739,1504,35,625,1240,28,21.114285714285714,<=30,AUS,Home,Upto 2014
BW Hilfenhaus,AUS,Pace,2012-01-03,Sydney,Australia,2012,2,157,329,8,1,874,1376,22,717,1047,14,39.72727272727273,>30,AUS,Home,Upto 2014
BW Hilfenhaus,AUS,Pace,2012-01-13,W.A.C.A,Australia,2012,2,97,216,8,1,668,1156,29,571,940,21,23.03448275862069,<=30,AUS,Home,Upto 2014
BW Hilfenhaus,AUS,Pace,2012-01-24,Adelaide,Australia,2012,2,97,199,4,1,749,1369,20,652,1170,16,37.45,>30,AUS,Home,Upto 2014
BW Hilfenhaus,AUS,Pace,2012-04-07,Bridgetown,West Indies,2012,2,94,300,5,1,725,1642,25,631,1342,20,29.0,<=30,WI,Away,Upto 2014
BW Hilfenhaus,AUS,Pace,2012-04-15,Port of Spain,West Indies,2012,2,61,120,3,1,412,924,17,351,804,14,24.235294117647058,<=30,WI,Away,Upto 2014
BW Hilfenhaus,AUS,Pace,2012-04-23,Roseau,West Indies,2012,2,53,186,2,1,492,1142,12,439,956,10,41.0,>30,WI,Away,Upto 2014
BW Hilfenhaus,AUS,Pace,2012-11-09,Brisbane,Australia,2012,2,99,286,2,1,917,1756,14,818,1470,12,65.5,>30,AUS,Home,Upto 2014
BW Hilfenhaus,AUS,Pace,2012-11-22,Adelaide,Australia,2012,2,114,321,4,1,863,1649,28,749,1328,24,30.821428571428573,>30,AUS,Home,Upto 2014
BW Hilfenhaus,AUS,Pace,2012-12-14,Hobart,Australia,2012,1,30,74,1,1,927,1883,26,897,1809,25,35.65384615384615,>30,AUS,Home,Upto 2014
BW Luckhurst,ENG,Spin,1971-03-05,Auckland,New Zealand,1971,1,6,16,0,1,315,824,7,309,808,7,45.0,>30,NZ,Away,Upto 2014
BW Luckhurst,ENG,Spin,1971-08-19,The Oval,England,1971,1,9,12,1,1,621,1646,28,612,1634,27,22.178571428571427,<=30,ENG,Home,Upto 2014
BW Luckhurst,ENG,Spin,1972-06-22,Lord's,England,1972,1,5,5,0,1,154,359,2,149,354,2,77.0,>30,ENG,Home,Upto 2014
BW Luckhurst,ENG,Spin,1973-08-09,Birmingham,England,1973,1,12,24,0,1,511,1445,13,499,1421,13,39.30769230769231,>30,ENG,Home,Upto 2014
BW Sinclair,NZ,Spin,1965-04-02,Lahore,Pakistan,1965,1,32,60,2,1,697,1836,15,665,1776,13,46.46666666666667,>30,PAK,Away,Upto 2014
BW Yuile,NZ,Spin,1963-02-23,Auckland,New Zealand,1963,1,77,126,1,1,567,1236,14,490,1110,13,40.5,>30,NZ,Home,Upto 2014
BW Yuile,NZ,Spin,1963-03-01,Wellington,New Zealand,1963,1,36,60,0,1,364,1047,13,328,987,13,28.0,<=30,NZ,Home,Upto 2014
BW Yuile,NZ,Spin,1965-01-22,Wellington,New Zealand,1965,2,49,204,2,1,356,1080,8,307,876,6,44.5,>30,NZ,Home,Upto 2014
BW Yuile,NZ,Spin,1965-01-29,Auckland,New Zealand,1965,2,82,504,4,1,450,1734,24,368,1230,20,18.75,<=30,NZ,Home,Upto 2014
BW Yuile,NZ,Spin,1965-02-12,Christchurch,New Zealand,1965,2,112,186,6,1,466,1098,16,354,912,10,29.125,<=30,NZ,Home,Upto 2014
BW Yuile,NZ,Spin,1965-02-27,Chennai,India,1965,2,115,187,3,1,616,1705,17,501,1518,14,36.23529411764706,>30,IND,Away,Upto 2014
BW Yuile,NZ,Spin,1965-03-05,Eden Gardens,India,1965,1,43,84,3,1,632,1531,17,589,1447,14,37.1764705882353,>30,IND,Away,Upto 2014
BW Yuile,NZ,Spin,1965-03-12,Brabourne,India,1965,1,76,150,0,1,545,1316,11,469,1166,11,49.54545454545455,>30,IND,Away,Upto 2014
BW Yuile,NZ,Spin,1965-03-27,Rawalpindi,Pakistan,1965,1,42,96,0,1,362,890,18,320,794,18,20.11111111111111,<=30,PAK,Away,Upto 2014
BW Yuile,NZ,Spin,1965-07-08,Leeds,England,1965,1,80,102,0,1,275,702,9,195,600,9,30.555555555555557,>30,ENG,Away,Upto 2014
BW Yuile,NZ,Spin,1968-02-15,Dunedin,New Zealand,1968,2,87,198,0,1,642,1761,17,555,1563,17,37.76470588235294,>30,NZ,Home,Upto 2014
BW Yuile,NZ,Spin,1969-02-27,Auckland,New Zealand,1969,2,122,232,3,1,637,1524,17,515,1292,14,37.470588235294116,>30,NZ,Home,Upto 2014
BW Yuile,NZ,Spin,1969-03-07,Wellington,New Zealand,1969,2,52,128,4,1,243,621,7,191,493,3,34.714285714285715,>30,NZ,Home,Upto 2014
BW Yuile,NZ,Spin,1969-03-13,Christchurch,New Zealand,1969,1,70,160,2,1,515,1459,16,445,1299,14,32.1875,>30,NZ,Home,Upto 2014
BW Yuile,NZ,Spin,1969-10-03,Nagpur,India,1969,2,49,108,1,1,677,1910,37,628,1802,36,18.2972972972973,<=30,IND,Away,Upto 2014
BW Yuile,NZ,Spin,1969-10-24,Karachi,Pakistan,1969,2,105,288,4,1,665,1813,26,560,1525,22,25.576923076923077,<=30,PAK,Away,Upto 2014
BW Yuile,NZ,Spin,1969-10-30,Lahore,Pakistan,1969,1,16,84,1,1,434,1339,23,418,1255,22,18.869565217391305,<=30,PAK,Away,Upto 2014
Babar Azam,PAK,Spin,2021-12-04,Mirpur,Bangladesh,2021,2,2,18,1,1,366,844,15,364,826,14,24.4,<=30,BAN,Away,After 1965
Babar Azam,PAK,Spin,2022-03-04,Rawalpindi,Pakistan,2022,1,5,6,0,1,676,1285,9,671,1279,9,75.11111111111111,>30,PAK,Home,After 1965
Babar Azam,PAK,Spin,2022-03-12,Karachi,Pakistan,2022,1,7,24,1,1,673,1474,11,666,1450,10,61.18181818181818,>30,PAK,Home,After 1965
Babar Azam,PAK,Spin,2022-03-21,Lahore,Pakistan,2022,1,2,6,0,1,557,1146,9,555,1140,9,61.888888888888886,>30,PAK,Home,After 1965
Babar Azam,PAK,Spin,2022-07-16,Galle,Sri Lanka,2022,1,9,6,0,1,840,1795,26,831,1789,26,32.30769230769231,>30,SL,Away,After 1965
Babar Azam,PAK,Spin,2022-07-24,Galle,Sri Lanka,2022,1,6,6,0,1,907,1657,29,901,1651,29,31.275862068965516,>30,SL,Away,After 1965
Babar Azam,PAK,Spin,2022-12-26,Karachi,Pakistan,2022,1,11,24,0,1,1086,2053,24,1075,2029,24,45.25,>30,PAK,Home,After 1965
Basit Ali,PAK,Spin,1993-05-01,St John's,West Indies,1993,1,6,6,0,1,315,516,3,309,510,3,105.0,>30,WI,Away,Upto 2014
Bilal Asif,PAK,Spin,2018-10-07,Dubai (DICS),UAE,2018,2,123,351,6,1,793,1735,21,670,1384,15,37.76190476190476,>30,UAE,Away,After 1965
Bilal Asif,PAK,Spin,2018-10-16,Abu Dhabi,UAE,2018,2,35,90,3,1,566,1108,20,531,1018,17,28.3,<=30,UAE,Away,After 1965
Bilal Asif,PAK,Spin,2018-11-16,Abu Dhabi,UAE,2018,2,76,162,1,1,468,1015,21,392,853,20,22.285714285714285,<=30,UAE,Away,After 1965
Bilal Asif,PAK,Spin,2018-11-24,Dubai (DICS),UAE,2018,2,63,174,1,1,473,968,16,410,794,15,29.5625,<=30,UAE,Away,After 1965
Bilal Asif,PAK,Spin,2018-12-03,Abu Dhabi,UAE,2018,2,127,397,5,1,612,1532,24,485,1135,19,25.5,<=30,UAE,Away,After 1965
Bilawal Bhatti,PAK,Pace,2013-12-31,Abu Dhabi,UAE,2013,2,211,306,5,1,807,1581,20,596,1275,15,40.35,>30,UAE,Away,Upto 2014
Bilawal Bhatti,PAK,Pace,2014-01-08,Dubai (DICS),UAE,2014,1,80,132,1,1,719,1539,21,639,1407,20,34.23809523809524,>30,UAE,Away,After 1965
C Blythe,ENG,Spin,1901-12-13,Sydney,Australia,1901,2,56,174,7,1,360,868,16,304,694,9,22.5,<=30,AUS,Away,Upto 2014
C Blythe,ENG,Spin,1902-01-01,Melbourne,Australia,1902,2,149,282,5,1,445,1043,26,296,761,21,17.115384615384617,<=30,AUS,Away,Upto 2014
C Blythe,ENG,Spin,1902-01-17,Adelaide,Australia,1902,2,120,312,1,1,888,2292,24,768,1980,23,37.0,>30,AUS,Away,Upto 2014
C Blythe,ENG,Spin,1902-02-14,Sydney,Australia,1902,2,80,258,2,1,685,1842,29,605,1584,27,23.620689655172413,<=30,AUS,Away,Upto 2014
C Blythe,ENG,Spin,1902-02-28,Melbourne,Australia,1902,2,65,132,3,1,602,1354,31,537,1222,28,19.419354838709676,<=30,AUS,Away,Upto 2014
C Blythe,ENG,Spin,1905-07-03,Leeds,England,1905,2,77,192,4,1,435,1029,13,358,837,9,33.46153846153846,>30,ENG,Home,Upto 2014
C Blythe,ENG,Spin,1906-01-02,Johannesburg,South Africa,1906,2,83,264,4,1,455,1132,23,372,868,19,19.782608695652176,<=30,SA,Away,Upto 2014
C Blythe,ENG,Spin,1906-03-06,Johannesburg,South Africa,1906,2,73,179,1,1,287,726,15,214,547,14,19.133333333333333,<=30,SA,Away,Upto 2014
C Blythe,ENG,Spin,1906-03-10,Johannesburg,South Africa,1906,2,168,342,3,1,622,1254,10,454,912,7,62.2,>30,SA,Away,Upto 2014
C Blythe,ENG,Spin,1906-03-24,Cape Town,South Africa,1906,2,118,365,11,1,339,907,20,221,542,9,16.95,<=30,SA,Away,Upto 2014
C Blythe,ENG,Spin,1906-03-30,Cape Town,South Africa,1906,1,106,210,2,1,364,776,15,258,566,13,24.266666666666666,<=30,SA,Away,Upto 2014
C Blythe,ENG,Spin,1907-07-01,Lord's,England,1907,2,74,174,4,1,478,962,15,404,788,11,31.866666666666667,>30,ENG,Home,Upto 2014
C Blythe,ENG,Spin,1907-07-29,Leeds,England,1907,2,99,231,15,1,289,661,31,190,430,16,9.32258064516129,<=30,ENG,Home,Upto 2014
C Blythe,ENG,Spin,1907-08-19,The Oval,England,1907,2,97,198,7,1,462,1059,21,365,861,14,22.0,<=30,ENG,Home,Upto 2014
C Blythe,ENG,Spin,1907-12-13,Sydney,Australia,1907,2,88,186,1,1,592,1308,17,504,1122,16,34.8235294117647,>30,AUS,Away,Upto 2014
C Blythe,ENG,Spin,1909-05-27,Birmingham,England,1909,2,102,282,11,1,222,633,19,120,351,8,11.68421052631579,<=30,ENG,Home,Upto 2014
C Blythe,ENG,Spin,1909-07-26,Manchester,England,1909,2,140,267,7,1,297,675,13,157,408,6,22.846153846153847,<=30,ENG,Home,Upto 2014
C Blythe,ENG,Spin,1910-03-07,Cape Town,South Africa,1910,2,64,210,2,1,379,765,17,315,555,15,22.294117647058822,<=30,SA,Away,Upto 2014
C Blythe,ENG,Spin,1910-03-11,Cape Town,South Africa,1910,2,104,288,10,1,488,932,19,384,644,9,25.68421052631579,<=30,SA,Away,Upto 2014
C Bosch,SA,Spin,2024-12-26,Centurion,South Africa,2024,2,117,160,5,1,120,176,6,3,16,1,20.0,<=30,SA,Home,After 1965
C Burke,NZ,Spin,1946-03-29,Wellington,New Zealand,1946,1,30,66,2,1,63,182,11,33,116,9,5.7272727272727275,<=30,NZ,Home,Upto 2014
C Campher,IRE,Pace,2023-04-04,Mirpur,Bangladesh,2023,1,54,48,0,1,400,606,10,346,558,10,40.0,>30,BAN,Away,After 1965
C Campher,IRE,Pace,2023-04-16,Galle,Sri Lanka,2023,1,84,126,2,1,244,399,7,160,273,5,34.857142857142854,>30,SL,Away,After 1965
C Campher,IRE,Pace,2023-04-24,Galle,Sri Lanka,2023,1,101,120,1,1,403,633,9,302,513,8,44.77777777777778,>30,SL,Away,After 1965
C Campher,IRE,Pace,2023-06-01,Lord's,England,2023,1,88,78,0,1,757,1010,16,669,932,16,47.3125,>30,ENG,Away,After 1965
C Campher,IRE,Pace,2024-02-28,Tolerance Oval,UAE,2024,1,13,24,2,1,418,850,26,405,826,24,16.076923076923077,<=30,UAE,Away,After 1965
C Campher,IRE,Pace,2024-07-25,Belfast,Northern Ireland,2024,2,45,78,1,1,610,1116,26,565,1038,25,23.46153846153846,<=30,Northern Ireland,Away,After 1965
C Cook,ENG,Spin,1947-06-07,Nottingham,England,1947,2,127,180,0,1,885,2189,17,758,2009,17,52.05882352941177,>30,ENG,Home,Upto 2014
C Gladwin,ENG,Pace,1947-07-05,Manchester,England,1947,2,86,396,3,1,744,1735,22,658,1339,19,33.81818181818182,>30,ENG,Home,Upto 2014
C Gladwin,ENG,Pace,1947-08-16,The Oval,England,1947,2,72,192,0,1,526,1254,9,454,1062,9,58.44444444444444,>30,ENG,Home,Upto 2014
C Gladwin,ENG,Pace,1948-12-16,Durban,South Africa,1948,2,36,152,3,1,290,749,16,254,597,13,18.125,<=30,SA,Away,Upto 2014
C Gladwin,ENG,Pace,1948-12-27,Johannesburg,South Africa,1948,2,66,288,1,1,428,1173,8,362,885,7,53.5,>30,SA,Away,Upto 2014
C Gladwin,ENG,Pace,1949-01-01,Cape Town,South Africa,1949,2,78,320,1,1,484,1256,6,406,936,5,80.66666666666667,>30,SA,Away,Upto 2014
C Gladwin,ENG,Pace,1949-02-12,Johannesburg,South Africa,1949,2,82,320,3,1,558,1385,18,476,1065,15,31.0,>30,SA,Away,Upto 2014
C Gladwin,ENG,Pace,1949-03-05,Gqeberha,South Africa,1949,2,84,293,3,1,319,1001,10,235,708,7,31.9,>30,SA,Away,Upto 2014
C Gladwin,ENG,Pace,1949-06-25,Lord's,England,1949,1,67,168,1,1,435,853,4,368,685,3,108.75,>30,ENG,Home,Upto 2014
C Green,AUS,Pace,2020-12-17,Adelaide,Australia,2020,1,15,54,0,1,408,970,22,393,916,22,18.545454545454547,<=30,AUS,Home,After 1965
C Green,AUS,Pace,2020-12-26,Melbourne,Australia,2020,1,31,72,0,1,523,1170,20,492,1098,20,26.15,<=30,AUS,Home,After 1965
C Green,AUS,Pace,2021-01-07,Sydney,Australia,2021,2,42,72,0,1,762,1640,19,720,1568,19,40.10526315789474,>30,AUS,Home,After 1965
C Green,AUS,Pace,2021-01-15,Brisbane,Australia,2021,2,30,66,0,1,950,1738,30,920,1672,30,31.666666666666668,>30,AUS,Home,After 1965
C Green,AUS,Pace,2021-12-08,Brisbane,Australia,2021,2,29,90,3,1,608,1187,25,579,1097,22,24.32,<=30,AUS,Home,After 1965
C Green,AUS,Pace,2021-12-16,Adelaide,Australia,2021,2,33,114,2,1,845,1824,27,812,1710,25,31.296296296296298,>30,AUS,Home,After 1965
C Green,AUS,Pace,2021-12-26,Melbourne,Australia,2021,2,15,70,2,1,423,909,26,408,839,24,16.26923076923077,<=30,AUS,Home,After 1965
C Green,AUS,Pace,2022-01-05,Sydney,Australia,2022,2,62,114,2,1,798,1621,23,736,1507,21,34.69565217391305,>30,AUS,Home,After 1965
C Green,AUS,Pace,2022-01-14,Hobart,Australia,2022,2,66,96,4,1,700,1252,39,634,1156,35,17.94871794871795,<=30,AUS,Home,After 1965
C Green,AUS,Pace,2022-03-04,Rawalpindi,Pakistan,2022,2,61,114,0,1,479,990,4,418,876,4,119.75,>30,PAK,Away,After 1965
C Green,AUS,Pace,2022-03-12,Karachi,Pakistan,2022,2,55,138,2,1,534,1143,14,479,1005,12,38.142857142857146,>30,PAK,Away,After 1965
C Green,AUS,Pace,2022-03-21,Lahore,Pakistan,2022,2,55,150,1,1,523,1268,24,468,1118,23,21.791666666666668,<=30,PAK,Away,After 1965
C Green,AUS,Pace,2022-07-08,Galle,Sri Lanka,2022,1,20,36,0,1,290,570,7,270,534,7,41.42857142857143,>30,SL,Away,After 1965
C Green,AUS,Pace,2022-11-30,Perth,Australia,2022,2,80,138,1,1,842,1610,13,762,1472,12,64.76923076923077,>30,AUS,Home,After 1965
C Green,AUS,Pace,2022-12-08,Adelaide,Australia,2022,1,44,36,1,1,712,1214,23,668,1178,22,30.956521739130434,>30,AUS,Home,After 1965
C Green,AUS,Pace,2022-12-17,Brisbane,Australia,2022,1,20,18,0,1,432,770,30,412,752,30,14.4,<=30,AUS,Home,After 1965
C Green,AUS,Pace,2022-12-26,Melbourne,Australia,2022,1,27,64,5,1,684,1223,19,657,1159,14,36.0,>30,AUS,Home,After 1965
C Green,AUS,Pace,2023-03-01,Indore,India,2023,1,14,12,0,1,84,162,4,70,150,4,21.0,<=30,IND,Away,After 1965
C Green,AUS,Pace,2023-03-09,Ahmedabad,India,2023,1,90,108,0,1,466,654,3,376,546,3,155.33333333333334,>30,IND,Away,After 1965
C Green,AUS,Pace,2023-06-07,The Oval,England,2023,2,57,102,2,1,1032,1672,28,975,1570,26,36.857142857142854,>30,ENG,Away,After 1965
C Green,AUS,Pace,2023-06-16,Birmingham,England,2023,2,44,48,1,1,808,1386,24,764,1338,23,33.666666666666664,>30,ENG,Away,After 1965
C Green,AUS,Pace,2023-06-28,Lord's,England,2023,2,127,132,2,1,1187,1964,35,1060,1832,33,33.91428571428571,>30,ENG,Away,After 1965
C Green,AUS,Pace,2023-07-19,Manchester,England,2023,1,64,94,2,1,889,1350,23,825,1256,21,38.65217391304348,>30,ENG,Away,After 1965
C Green,AUS,Pace,2024-01-17,Adelaide,Australia,2024,2,21,42,1,1,512,947,27,491,905,26,18.962962962962962,<=30,AUS,Home,After 1965
C Green,AUS,Pace,2024-01-25,Brisbane,Australia,2024,2,49,102,1,1,777,1334,30,728,1232,29,25.9,<=30,AUS,Home,After 1965
C Green,AUS,Pace,2024-02-29,Wellington,New Zealand,2024,1,16,18,1,1,689,1266,22,673,1248,21,31.318181818181817,>30,NZ,Away,After 1965
C Green,AUS,Pace,2024-03-08,Christchurch,New Zealand,2024,2,69,90,2,1,918,1490,33,849,1400,31,27.818181818181817,<=30,NZ,Away,After 1965
C Gunasekara,SL,Pace,2024-02-02,Colombo (SSC),Sri Lanka,2024,1,50,54,0,1,535,897,18,485,843,18,29.72222222222222,<=30,SL,Home,After 1965
C Heseltine,ENG,Pace,1896-03-02,Johannesburg,South Africa,1896,2,67,127,5,1,539,922,24,472,795,19,22.458333333333332,<=30,SA,Away,After 1965
C Heseltine,ENG,Pace,1896-03-21,Cape Town,South Africa,1896,1,17,30,0,1,245,540,16,228,510,16,15.3125,<=30,SA,Away,After 1965
C Karunaratne,SL,Pace,2019-02-01,Canberra,Australia,2019,2,148,156,1,1,709,1113,23,561,957,22,30.82608695652174,>30,AUS,Away,After 1965
C Kelleway,AUS,Pace,1910-12-09,Sydney,Australia,1910,2,70,145,2,1,517,899,22,447,754,20,23.5,<=30,AUS,Home,Upto 2014
C Kelleway,AUS,Pace,1910-12-31,Melbourne,Australia,1910,1,67,102,1,1,540,1002,17,473,900,16,31.764705882352942,>30,AUS,Home,Upto 2014
C Kelleway,AUS,Pace,1911-01-07,Adelaide,Australia,1911,2,136,282,3,1,771,1501,18,635,1219,15,42.833333333333336,>30,AUS,Home,Upto 2014
C Kelleway,AUS,Pace,1911-02-17,Melbourne,Australia,1911,2,67,114,0,1,399,623,10,332,509,10,39.9,>30,AUS,Home,Upto 2014
C Kelleway,AUS,Pace,1911-03-03,Sydney,Australia,1911,2,50,66,1,1,447,806,13,397,740,12,34.38461538461539,>30,AUS,Home,Upto 2014
C Kelleway,AUS,Pace,1911-12-15,Sydney,Australia,1911,2,73,215,3,1,824,1814,23,751,1599,20,35.82608695652174,>30,AUS,Home,Upto 2014
C Kelleway,AUS,Pace,1911-12-30,Melbourne,Australia,1911,2,42,132,0,1,685,1483,24,643,1351,24,28.541666666666668,<=30,AUS,Home,Upto 2014
C Kelleway,AUS,Pace,1912-01-12,Adelaide,Australia,1912,2,54,180,2,1,730,1756,27,676,1576,25,27.037037037037038,<=30,AUS,Home,Upto 2014
C Kelleway,AUS,Pace,1912-02-09,Melbourne,Australia,1912,1,80,156,1,1,546,1146,23,466,990,22,23.73913043478261,<=30,AUS,Home,Upto 2014
C Kelleway,AUS,Pace,1912-05-27,Manchester,England,1912,2,60,152,5,1,239,566,12,179,414,7,19.916666666666668,<=30,ENG,Away,Upto 2014
C Kelleway,AUS,Pace,1912-06-24,Lord's,England,1912,1,66,126,2,1,300,774,7,234,648,5,42.857142857142854,>30,ENG,Away,Upto 2014
C Kelleway,AUS,Pace,1912-07-15,Lord's,England,1912,2,60,114,2,1,300,697,11,240,583,9,27.272727272727273,<=30,ENG,Away,Upto 2014
C Kelleway,AUS,Pace,1912-07-29,Manchester,England,1912,1,19,36,0,1,68,240,4,49,204,4,17.0,<=30,ENG,Away,Upto 2014
C Kelleway,AUS,Pace,1912-08-05,Nottingham,England,1912,1,18,48,1,1,106,300,3,88,252,2,35.333333333333336,>30,ENG,Away,Upto 2014
C Kelleway,AUS,Pace,1912-08-19,The Oval,England,1912,1,16,42,0,1,291,877,20,275,835,20,14.55,<=30,ENG,Away,Upto 2014
C Kelleway,AUS,Pace,1920-12-17,Sydney,Australia,1920,2,55,131,4,1,483,1134,15,428,1003,11,32.2,>30,AUS,Home,Upto 2014
C Kelleway,AUS,Pace,1920-12-31,Melbourne,Australia,1920,2,79,186,1,1,456,894,15,377,708,14,30.4,>30,AUS,Home,Upto 2014
C Kelleway,AUS,Pace,1921-01-14,Adelaide,Australia,1921,2,41,114,0,1,770,1488,14,729,1374,14,55.0,>30,AUS,Home,Upto 2014
C Kelleway,AUS,Pace,1921-02-11,Melbourne,Australia,1921,2,84,246,4,1,517,1056,6,433,810,2,86.16666666666667,>30,AUS,Home,Upto 2014
C Kelleway,AUS,Pace,1921-02-25,Sydney,Australia,1921,2,56,204,6,1,315,721,13,259,517,7,24.23076923076923,<=30,AUS,Home,Upto 2014
C Kelleway,AUS,Pace,1924-12-19,Sydney,Australia,1924,2,104,280,2,1,590,1278,15,486,998,13,39.333333333333336,>30,AUS,Home,Upto 2014
C Kelleway,AUS,Pace,1925-01-01,Melbourne,Australia,1925,2,104,384,2,1,573,1360,13,469,976,11,44.07692307692308,>30,AUS,Home,Upto 2014
C Kelleway,AUS,Pace,1925-01-16,Adelaide,Australia,1925,2,81,296,4,1,326,857,11,245,561,7,29.636363636363637,<=30,AUS,Home,Upto 2014
C Kelleway,AUS,Pace,1925-02-13,Melbourne,Australia,1925,1,70,232,3,1,305,712,6,235,480,3,50.833333333333336,>30,AUS,Home,Upto 2014
C Kelleway,AUS,Pace,1925-02-27,Sydney,Australia,1925,2,54,176,3,1,265,608,9,211,432,6,29.444444444444443,<=30,AUS,Home,Upto 2014
C Kelleway,AUS,Pace,1928-11-30,Brisbane,Australia,1928,1,77,204,0,1,486,1018,12,409,814,12,40.5,>30,AUS,Home,Upto 2014
C Munro,NZ,Pace,2013-01-11,Gqeberha,South Africa,2013,1,40,108,2,1,619,1262,23,579,1154,21,26.91304347826087,<=30,SA,Away,Upto 2014
C Newberry,SA,Spin,1913-12-26,Johannesburg,South Africa,1913,1,93,156,3,1,283,660,6,190,504,3,47.166666666666664,>30,SA,Home,Upto 2014
C Newberry,SA,Spin,1914-01-01,Johannesburg,South Africa,1914,2,101,192,4,1,388,857,18,287,665,14,21.555555555555557,<=30,SA,Home,Upto 2014
C Newberry,SA,Spin,1914-02-14,Durban,South Africa,1914,2,40,126,3,1,337,984,14,297,858,11,24.071428571428573,<=30,SA,Home,Upto 2014
C Newberry,SA,Spin,1914-02-27,Gqeberha,South Africa,1914,1,34,84,1,1,377,889,10,343,805,9,37.7,>30,SA,Home,Upto 2014
C Overton,ENG,Pace,2017-12-02,Adelaide,Australia,2017,2,116,210,4,1,779,1712,31,663,1502,27,25.129032258064516,<=30,AUS,Away,After 1965
C Overton,ENG,Pace,2017-12-14,W.A.C.A,Australia,2017,1,110,144,2,1,965,1713,24,855,1569,22,40.208333333333336,>30,AUS,Away,After 1965
C Overton,ENG,Pace,2018-03-22,Auckland,New Zealand,2018,1,70,150,1,1,669,1504,24,599,1354,23,27.875,<=30,NZ,Away,After 1965
C Overton,ENG,Pace,2019-09-04,Manchester,England,2019,2,107,203,2,1,783,1519,27,676,1316,25,29.0,<=30,ENG,Home,After 1965
C Overton,ENG,Pace,2021-08-25,Leeds,England,2021,2,61,175,6,1,610,1311,27,549,1136,21,22.59259259259259,<=30,ENG,Home,After 1965
C Overton,ENG,Pace,2021-09-02,The Oval,England,2021,2,107,200,2,1,900,1837,30,793,1637,28,30.0,<=30,ENG,Home,After 1965
C Overton,ENG,Pace,2022-03-08,North Sound,West Indies,2022,2,108,252,2,1,832,1769,23,724,1517,21,36.17391304347826,>30,WI,Away,After 1965
C Overton,ENG,Pace,2022-03-24,St George's,West Indies,2022,1,81,138,2,1,518,1435,27,437,1297,25,19.185185185185187,<=30,WI,Away,After 1965
C Pringle,NZ,Pace,1990-10-10,Karachi,Pakistan,1990,1,68,150,1,1,575,1344,23,507,1194,22,25.0,<=30,PAK,Away,Upto 2014
C Pringle,NZ,Pace,1990-10-18,Lahore,Pakistan,1990,2,122,228,1,1,697,1583,26,575,1355,25,26.807692307692307,<=30,PAK,Away,Upto 2014
C Pringle,NZ,Pace,1990-10-26,Faisalabad,Pakistan,1990,2,152,354,11,1,725,1761,39,573,1407,28,18.58974358974359,<=30,PAK,Away,Upto 2014
C Pringle,NZ,Pace,1991-01-31,Wellington,New Zealand,1991,1,116,186,0,1,940,1788,23,824,1602,23,40.869565217391305,>30,NZ,Home,Upto 2014
C Pringle,NZ,Pace,1991-02-22,Hamilton,New Zealand,1991,2,110,192,2,1,916,2000,25,806,1808,23,36.64,>30,NZ,Home,Upto 2014
C Pringle,NZ,Pace,1992-01-18,Christchurch,New Zealand,1992,1,127,216,3,1,763,1516,14,636,1300,11,54.5,>30,NZ,Home,Upto 2014
C Pringle,NZ,Pace,1992-12-06,Colombo (SSC),Sri Lanka,1992,2,90,204,1,1,402,864,12,312,660,11,33.5,>30,SL,Away,Upto 2014
C Pringle,NZ,Pace,1994-02-24,Christchurch,New Zealand,1994,2,124,300,1,1,835,1575,27,711,1275,26,30.925925925925927,>30,NZ,Home,Upto 2014
C Pringle,NZ,Pace,1994-03-19,Hamilton,New Zealand,1994,2,81,207,3,1,466,1167,15,385,960,12,31.066666666666666,>30,NZ,Home,Upto 2014
C Pringle,NZ,Pace,1994-06-16,Lord's,England,1994,2,106,234,2,1,756,1458,24,650,1224,22,31.5,>30,ENG,Away,Upto 2014
C Pringle,NZ,Pace,1994-06-30,Manchester,England,1994,1,95,234,1,1,638,1439,22,543,1205,21,29.0,<=30,ENG,Away,Upto 2014
C Pringle,NZ,Pace,1994-12-26,Durban,South Africa,1994,1,23,90,0,1,610,1681,28,587,1591,28,21.785714285714285,<=30,SA,Away,Upto 2014
C Pringle,NZ,Pace,1995-01-02,Cape Town,South Africa,1995,1,69,168,1,1,639,1598,22,570,1430,21,29.045454545454547,<=30,SA,Away,Upto 2014
C Pringle,NZ,Pace,1995-03-18,Dunedin,New Zealand,1995,2,106,222,3,1,657,1600,18,551,1378,15,36.5,>30,NZ,Home,Upto 2014
C Sharma,IND,Pace,1984-10-17,Lahore,Pakistan,1984,1,94,174,3,1,564,1248,16,470,1074,13,35.25,>30,PAK,Away,Upto 2014
C Sharma,IND,Pace,1984-10-24,Faisalabad,Pakistan,1984,1,139,192,1,1,679,1180,8,540,988,7,84.875,>30,PAK,Away,Upto 2014
C Sharma,IND,Pace,1984-11-28,Wankhede,India,1984,2,67,120,0,1,378,744,6,311,624,6,63.0,>30,IND,Home,Upto 2014
C Sharma,IND,Pace,1984-12-31,Eden Gardens,India,1984,1,38,75,4,1,288,729,8,250,654,4,36.0,>30,IND,Home,Upto 2014
C Sharma,IND,Pace,1985-01-13,Chennai,India,1985,1,95,108,0,1,557,887,19,462,779,19,29.31578947368421,<=30,IND,Home,Upto 2014
C Sharma,IND,Pace,1985-08-30,Colombo (SSC),Sri Lanka,1985,2,105,174,4,1,634,1521,27,529,1347,23,23.48148148148148,<=30,SL,Away,Upto 2014
C Sharma,IND,Pace,1985-09-06,Colombo (PSS),Sri Lanka,1985,2,173,276,6,1,740,1533,28,567,1257,22,26.428571428571427,<=30,SL,Away,Upto 2014
C Sharma,IND,Pace,1985-09-14,Kandy,Sri Lanka,1985,2,105,204,4,1,808,1515,25,703,1311,21,32.32,>30,SL,Away,Upto 2014
C Sharma,IND,Pace,1985-12-13,Adelaide,Australia,1985,2,79,126,0,1,620,1368,17,541,1242,17,36.470588235294116,>30,AUS,Away,Upto 2014
C Sharma,IND,Pace,1986-01-02,Sydney,Australia,1986,2,49,96,0,1,382,756,4,333,660,4,95.5,>30,AUS,Away,Upto 2014
C Sharma,IND,Pace,1986-06-05,Lord's,England,1986,2,112,294,6,1,690,1580,26,578,1286,20,26.53846153846154,<=30,ENG,Away,Upto 2014
C Sharma,IND,Pace,1986-07-03,Birmingham,England,1986,2,188,321,10,1,804,1599,21,616,1278,11,38.285714285714285,>30,ENG,Away,Upto 2014
C Sharma,IND,Pace,1986-09-18,Chennai,India,1986,2,89,132,1,1,433,618,3,344,486,2,144.33333333333334,>30,IND,Home,Upto 2014
C Sharma,IND,Pace,1986-09-26,Delhi,India,1986,1,34,48,1,1,158,270,3,124,222,2,52.666666666666664,>30,IND,Home,Upto 2014
C Sharma,IND,Pace,1986-12-17,Kanpur,India,1986,1,122,186,2,1,810,1291,13,688,1105,11,62.30769230769231,>30,IND,Home,Upto 2014
C Sharma,IND,Pace,1986-12-27,Nagpur,India,1986,2,40,60,1,1,372,581,7,332,521,6,53.142857142857146,>30,IND,Home,Upto 2014
C Sharma,IND,Pace,1987-11-25,Delhi,India,1987,2,99,145,5,1,549,1170,28,450,1025,23,19.607142857142858,<=30,IND,Home,Upto 2014
C Sharma,IND,Pace,1987-12-11,Wankhede,India,1987,2,65,84,4,1,509,808,22,444,724,18,23.136363636363637,<=30,IND,Home,Upto 2014
C Sharma,IND,Pace,1987-12-26,Eden Gardens,India,1987,2,104,115,1,1,580,866,11,476,751,10,52.72727272727273,>30,IND,Home,Upto 2014
C Sharma,IND,Pace,1989-03-25,Georgetown,West Indies,1989,1,68,120,1,1,194,462,4,126,342,3,48.5,>30,WI,Away,Upto 2014
C Sharma,IND,Pace,1989-04-07,Bridgetown,West Indies,1989,2,105,132,2,1,726,1450,23,621,1318,21,31.565217391304348,>30,WI,Away,Upto 2014
C Sharma,IND,Pace,1989-04-15,Port of Spain,West Indies,1989,2,77,114,3,1,469,1127,29,392,1013,26,16.17241379310345,<=30,WI,Away,Upto 2014
C Sharma,IND,Pace,1989-04-28,Kingston,West Indies,1989,2,116,174,2,1,590,1241,28,474,1067,26,21.071428571428573,<=30,WI,Away,Upto 2014
C Washbrook,ENG,Pace,1949-07-23,Manchester,England,1949,1,8,12,0,1,464,974,13,456,962,13,35.69230769230769,>30,ENG,Home,Upto 2014
C Washbrook,ENG,Pace,1951-03-17,Christchurch,New Zealand,1951,1,25,24,1,1,365,1014,6,340,990,5,60.833333333333336,>30,NZ,Away,Upto 2014
C White,ENG,Spin,1994-06-02,Nottingham,England,1994,2,38,96,1,1,324,936,7,286,840,6,46.285714285714285,>30,ENG,Home,Upto 2014
C White,ENG,Spin,1994-06-16,Lord's,England,1994,2,105,151,1,1,425,1219,7,320,1068,6,60.714285714285715,>30,ENG,Home,Upto 2014
C White,ENG,Spin,1994-06-30,Manchester,England,1994,2,54,126,4,1,174,423,5,120,297,1,34.8,>30,ENG,Home,Upto 2014
C White,ENG,Spin,1994-07-21,Lord's,England,1994,2,61,96,2,1,242,564,5,181,468,3,48.4,>30,ENG,Home,Upto 2014
C White,ENG,Spin,1995-07-27,Manchester,England,1995,2,46,66,0,1,271,569,5,225,503,5,54.2,>30,ENG,Home,Upto 2014
C White,ENG,Spin,1995-08-10,Nottingham,England,1995,1,30,30,0,1,465,1032,7,435,1002,7,66.42857142857143,>30,ENG,Home,Upto 2014
C White,ENG,Spin,1996-12-26,Harare,Zimbabwe,1996,1,41,96,1,1,217,642,8,176,546,7,27.125,<=30,ZIM,Away,Upto 2014
C White,ENG,Spin,1997-01-24,Auckland,New Zealand,1997,2,77,150,2,1,302,804,7,225,654,5,43.142857142857146,>30,NZ,Away,Upto 2014
C White,ENG,Spin,2000-06-29,Lord's,England,2000,1,30,48,0,1,40,66,0,10,18,0,inf,>30,ENG,Home,Upto 2014
C White,ENG,Spin,2000-08-03,Manchester,England,2000,2,85,216,3,1,254,606,4,169,390,1,63.5,>30,ENG,Home,Upto 2014
C White,ENG,Spin,2000-08-17,Leeds,England,2000,1,57,88,5,1,78,124,6,21,36,1,13.0,<=30,ENG,Home,Upto 2014
C White,ENG,Spin,2000-08-31,The Oval,England,2000,2,64,137,5,1,192,479,8,128,342,3,24.0,<=30,ENG,Home,Upto 2014
C White,ENG,Spin,2000-11-15,Lahore,Pakistan,2000,1,54,147,4,1,697,1762,20,643,1615,16,34.85,>30,PAK,Away,Upto 2014
C White,ENG,Spin,2000-11-29,Faisalabad,Pakistan,2000,2,126,264,2,1,641,1582,20,515,1318,18,32.05,>30,PAK,Away,Upto 2014
C White,ENG,Spin,2000-12-07,Karachi,Pakistan,2000,2,94,204,3,1,624,1582,18,530,1378,15,34.666666666666664,>30,PAK,Away,Upto 2014
C White,ENG,Spin,2001-02-22,Galle,Sri Lanka,2001,1,80,180,0,1,636,1872,18,556,1692,18,35.333333333333336,>30,SL,Away,Upto 2014
C White,ENG,Spin,2001-03-07,Kandy,Sri Lanka,2001,2,112,175,4,1,679,1658,18,567,1483,14,37.72222222222222,>30,SL,Away,Upto 2014
C White,ENG,Spin,2001-03-15,Colombo (SSC),Sri Lanka,2001,1,45,60,0,1,375,1120,19,330,1060,19,19.736842105263158,<=30,SL,Away,Upto 2014
C White,ENG,Spin,2001-07-05,Birmingham,England,2001,1,101,160,1,1,315,491,10,214,331,9,31.5,>30,ENG,Home,Upto 2014
C White,ENG,Spin,2001-07-19,Lord's,England,2001,1,80,108,0,1,166,273,3,86,165,3,55.333333333333336,>30,ENG,Home,Upto 2014
C White,ENG,Spin,2001-08-02,Nottingham,England,2001,1,8,12,0,1,88,234,9,80,222,9,9.777777777777779,<=30,ENG,Home,Upto 2014
C White,ENG,Spin,2001-12-03,Mohali,India,2001,1,56,150,1,1,507,1147,21,451,997,20,24.142857142857142,<=30,IND,Away,Upto 2014
C White,ENG,Spin,2001-12-11,Ahmedabad,India,2001,2,40,126,1,1,727,1868,25,687,1742,24,29.08,<=30,IND,Away,Upto 2014
C White,ENG,Spin,2001-12-19,Bengaluru,India,2001,1,26,48,0,1,308,742,5,282,694,5,61.6,>30,IND,Away,Upto 2014
C White,ENG,Spin,2002-07-25,Lord's,England,2002,2,107,196,4,1,509,942,14,402,746,10,36.357142857142854,>30,ENG,Home,Upto 2014
C White,ENG,Spin,2002-08-08,Nottingham,England,2002,2,71,96,1,1,350,564,6,279,468,5,58.333333333333336,>30,ENG,Home,Upto 2014
C White,ENG,Spin,2002-11-07,Brisbane,Australia,2002,2,166,228,2,1,484,801,12,318,573,10,40.333333333333336,>30,AUS,Away,Upto 2014
C White,ENG,Spin,2002-11-21,Adelaide,Australia,2002,1,106,168,4,1,378,744,13,272,576,9,29.076923076923077,<=30,AUS,Away,Upto 2014
C White,ENG,Spin,2002-11-29,W.A.C.A,Australia,2002,1,127,139,5,1,250,379,8,123,240,3,31.25,>30,AUS,Away,Upto 2014
C White,ENG,Spin,2002-12-26,Melbourne,Australia,2002,1,133,198,3,1,514,870,12,381,672,9,42.833333333333336,>30,AUS,Away,Upto 2014
C de Grandhomme,NZ,Pace,2016-11-17,Christchurch,New Zealand,2016,2,64,179,7,1,500,1232,31,436,1053,24,16.129032258064516,<=30,NZ,Home,After 1965
C de Grandhomme,NZ,Pace,2016-11-25,Hamilton,New Zealand,2016,2,46,126,2,1,921,1796,32,875,1670,30,28.78125,<=30,NZ,Home,After 1965
C de Grandhomme,NZ,Pace,2017-01-12,Wellington,New Zealand,2017,1,65,120,0,1,1047,1639,21,982,1519,21,49.857142857142854,>30,NZ,Home,After 1965
C de Grandhomme,NZ,Pace,2017-01-20,Christchurch,New Zealand,2017,2,85,150,1,1,735,1238,24,650,1088,23,30.625,>30,NZ,Home,After 1965
C de Grandhomme,NZ,Pace,2017-03-16,Wellington,New Zealand,2017,2,72,186,3,1,662,1203,19,590,1017,16,34.8421052631579,>30,NZ,Home,After 1965
C de Grandhomme,NZ,Pace,2017-03-25,Hamilton,New Zealand,2017,2,77,192,3,1,618,1215,19,541,1023,16,32.526315789473685,>30,NZ,Home,After 1965
C de Grandhomme,NZ,Pace,2017-12-01,Wellington,New Zealand,2017,2,53,138,2,1,782,1474,25,729,1336,23,31.28,>30,NZ,Home,After 1965
C de Grandhomme,NZ,Pace,2017-12-09,Hamilton,New Zealand,2017,2,60,126,2,1,876,1573,33,816,1447,31,26.545454545454547,<=30,NZ,Home,After 1965
C de Grandhomme,NZ,Pace,2018-03-22,Auckland,New Zealand,2018,1,40,144,0,1,669,1504,24,629,1360,24,27.875,<=30,NZ,Home,After 1965
C de Grandhomme,NZ,Pace,2018-03-30,Christchurch,New Zealand,2018,2,138,258,4,1,933,2022,34,795,1764,30,27.441176470588236,<=30,NZ,Home,After 1965
C de Grandhomme,NZ,Pace,2018-11-16,Abu Dhabi,UAE,2018,2,45,96,2,1,312,840,18,267,744,16,17.333333333333332,<=30,UAE,Away,After 1965
C de Grandhomme,NZ,Pace,2018-11-24,Dubai (DICS),UAE,2018,1,44,180,2,1,331,924,7,287,744,5,47.285714285714285,>30,UAE,Away,After 1965
C de Grandhomme,NZ,Pace,2018-12-03,Abu Dhabi,UAE,2018,2,39,102,1,1,467,990,12,428,888,11,38.916666666666664,>30,UAE,Away,After 1965
C de Grandhomme,NZ,Pace,2018-12-15,Wellington,New Zealand,2018,2,59,156,1,1,859,1641,18,800,1485,17,47.72222222222222,>30,NZ,Home,After 1965
C de Grandhomme,NZ,Pace,2018-12-26,Christchurch,New Zealand,2018,2,42,96,1,1,838,1658,30,796,1562,29,27.933333333333334,<=30,NZ,Home,After 1965
C de Grandhomme,NZ,Pace,2019-02-28,Hamilton,New Zealand,2019,2,72,126,1,1,1009,1490,23,937,1364,22,43.869565217391305,>30,NZ,Home,After 1965
C de Grandhomme,NZ,Pace,2019-03-08,Wellington,New Zealand,2019,2,26,72,1,1,692,1031,24,666,959,23,28.833333333333332,<=30,NZ,Home,After 1965
C de Grandhomme,NZ,Pace,2019-08-22,Colombo (PSS),Sri Lanka,2019,2,43,126,2,1,360,808,14,317,682,12,25.714285714285715,<=30,SL,Away,After 1965
C de Grandhomme,NZ,Pace,2019-11-21,Mount Maunganui,New Zealand,2019,2,56,198,3,1,805,1856,23,749,1658,20,35.0,>30,NZ,Home,After 1965
C de Grandhomme,NZ,Pace,2019-12-12,Perth,Australia,2019,2,84,234,2,1,626,1383,31,542,1149,29,20.193548387096776,<=30,AUS,Away,After 1965
C de Grandhomme,NZ,Pace,2019-12-26,Melbourne,Australia,2019,2,82,210,2,1,729,1616,26,647,1406,24,28.03846153846154,<=30,AUS,Away,After 1965
C de Grandhomme,NZ,Pace,2020-01-03,Sydney,Australia,2020,2,121,222,3,1,593,1249,16,472,1027,13,37.0625,>30,AUS,Away,After 1965
C de Grandhomme,NZ,Pace,2020-02-21,Wellington,New Zealand,2020,2,40,162,1,1,586,1297,26,546,1135,25,22.53846153846154,<=30,NZ,Home,After 1965
C de Grandhomme,NZ,Pace,2020-02-29,Christchurch,New Zealand,2020,2,34,84,1,1,623,1219,30,589,1135,29,20.766666666666666,<=30,NZ,Home,After 1965
C de Grandhomme,NZ,Pace,2021-06-02,Lord's,England,2021,2,36,132,0,1,792,1822,27,756,1690,27,29.333333333333332,<=30,ENG,Away,After 1965
C de Grandhomme,NZ,Pace,2021-06-18,Southampton,England,2021,1,32,72,0,1,643,1620,27,611,1548,27,23.814814814814813,<=30,ENG,Away,After 1965
C de Grandhomme,NZ,Pace,2022-02-17,Christchurch,New Zealand,2022,1,1,12,0,1,630,1205,28,629,1193,28,22.5,<=30,NZ,Home,After 1965
C de Grandhomme,NZ,Pace,2022-02-25,Christchurch,New Zealand,2022,2,32,84,1,1,1098,2154,35,1066,2070,34,31.37142857142857,>30,NZ,Home,After 1965
C de Grandhomme,NZ,Pace,2022-06-02,Lord's,England,2022,2,27,71,1,1,722,1408,33,695,1337,32,21.87878787878788,<=30,ENG,Away,After 1965
CA Best,WI,Spin,1990-02-24,Kingston,West Indies,1990,1,19,24,0,1,69,114,0,50,90,0,inf,>30,WI,Home,Upto 2014
CA Best,WI,Spin,1990-11-15,Karachi,Pakistan,1990,1,2,6,0,1,289,648,5,287,642,5,57.8,>30,PAK,Away,Upto 2014
CA Davis,WI,Pace,1968-12-26,Melbourne,Australia,1968,1,94,192,1,1,513,1176,14,419,984,13,36.642857142857146,>30,AUS,Away,Upto 2014
CA Davis,WI,Pace,1969-06-12,Manchester,England,1969,1,1,6,0,1,490,1177,22,489,1171,22,22.272727272727273,<=30,ENG,Away,Upto 2014
CA Davis,WI,Pace,1969-06-26,Lord's,England,1969,1,2,6,0,1,864,2111,25,862,2105,25,34.56,>30,ENG,Away,Upto 2014
CA Davis,WI,Pace,1969-07-10,Leeds,England,1969,2,29,108,1,1,581,1581,25,552,1473,24,23.24,<=30,ENG,Away,Upto 2014
CA Davis,WI,Pace,1971-03-06,Port of Spain,West Indies,1971,1,11,18,0,1,181,456,3,170,438,3,60.333333333333336,>30,WI,Home,Upto 2014
CA Davis,WI,Pace,1971-03-19,Georgetown,West Indies,1971,1,15,18,0,1,313,504,3,298,486,3,104.33333333333333,>30,WI,Home,Upto 2014
CA Davis,WI,Pace,1971-04-01,Bridgetown,West Indies,1971,2,3,30,0,1,478,1042,14,475,1012,14,34.142857142857146,>30,WI,Home,Upto 2014
CA Davis,WI,Pace,1971-04-13,Port of Spain,West Indies,1971,2,40,120,0,1,448,1056,11,408,936,11,40.72727272727273,>30,WI,Home,Upto 2014
CA Davis,WI,Pace,1972-02-16,Kingston,West Indies,1972,1,2,30,0,1,643,1221,11,641,1191,11,58.45454545454545,>30,WI,Home,Upto 2014
CA Davis,WI,Pace,1972-03-09,Port of Spain,West Indies,1972,2,14,42,0,1,314,919,14,300,877,14,22.428571428571427,<=30,WI,Home,Upto 2014
CA Davis,WI,Pace,1972-03-23,Bridgetown,West Indies,1972,1,19,60,0,1,605,1337,20,586,1277,20,30.25,>30,WI,Home,Upto 2014
CA Davis,WI,Pace,1972-04-06,Georgetown,West Indies,1972,1,42,150,0,1,457,1170,6,415,1020,6,76.16666666666667,>30,WI,Home,Upto 2014
CA Davis,WI,Pace,1973-04-06,Georgetown,West Indies,1973,2,20,54,0,1,667,1551,23,647,1497,23,29.0,<=30,WI,Home,Upto 2014
CA Davis,WI,Pace,1973-04-21,Port of Spain,West Indies,1973,2,38,60,0,1,343,870,9,305,810,9,38.111111111111114,>30,WI,Home,Upto 2014
CA McWatt,WI,Spin,1954-03-17,Port of Spain,West Indies,1954,1,16,24,1,1,1025,1930,13,1009,1906,12,78.84615384615384,>30,WI,Home,Upto 2014
CA Milton,ENG,Pace,1958-08-21,The Oval,England,1958,1,12,24,0,1,285,708,12,273,684,12,23.75,<=30,ENG,Home,Upto 2014
CA Pujara,IND,Spin,2015-12-03,Delhi,India,2015,1,2,6,0,1,551,1517,20,549,1511,20,27.55,<=30,IND,Home,After 1965
CA Pujara,IND,Spin,2023-03-09,Ahmedabad,India,2023,1,1,6,0,1,725,1892,17,724,1886,17,42.64705882352941,>30,IND,Home,After 1965
CA Roach,WI,Spin,1930-01-11,Bridgetown,West Indies,1930,1,6,30,0,1,542,1217,16,536,1187,16,33.875,>30,WI,Home,Upto 2014
CA Roach,WI,Spin,1930-02-01,Port of Spain,West Indies,1930,1,32,48,0,1,356,890,8,324,842,8,44.5,>30,WI,Home,Upto 2014
CA Roach,WI,Spin,1930-02-21,Georgetown,West Indies,1930,1,18,54,1,1,461,1269,13,443,1215,12,35.46153846153846,>30,WI,Home,Upto 2014
CA Roach,WI,Spin,1930-04-03,Kingston,West Indies,1930,2,47,90,1,1,1040,2209,18,993,2119,17,57.77777777777778,>30,WI,Home,Upto 2014
CA Smith,ENG,Pace,1889-03-12,Gqeberha,South Africa,1889,2,61,154,7,1,261,668,19,200,514,12,13.736842105263158,<=30,SA,Away,After 1965
CA Snedden,NZ,Spin,1947-03-21,Christchurch,New Zealand,1947,1,46,96,0,1,205,294,0,159,198,0,inf,>30,NZ,Home,Upto 2014
CA Walsh,WI,Pace,1984-11-09,W.A.C.A,Australia,1984,1,43,120,2,1,700,1337,30,657,1217,28,23.333333333333332,<=30,AUS,Away,Upto 2014
CA Walsh,WI,Pace,1984-11-23,Brisbane,Australia,1984,2,62,126,4,1,749,1407,30,687,1281,26,24.966666666666665,<=30,AUS,Away,Upto 2014
CA Walsh,WI,Pace,1984-12-07,Adelaide,Australia,1984,2,108,168,2,1,771,1535,30,663,1367,28,25.7,<=30,AUS,Away,Upto 2014
CA Walsh,WI,Pace,1984-12-22,Melbourne,Australia,1984,2,101,234,3,1,827,1673,26,726,1439,23,31.807692307692307,>30,AUS,Away,Upto 2014
CA Walsh,WI,Pace,1984-12-30,Sydney,Australia,1984,1,118,230,2,1,535,1040,12,417,810,10,44.583333333333336,>30,AUS,Away,Upto 2014
CA Walsh,WI,Pace,1985-05-04,Kingston,West Indies,1985,2,75,150,3,1,691,1483,26,616,1333,23,26.576923076923077,<=30,WI,Home,Upto 2014
CA Walsh,WI,Pace,1986-03-07,Port of Spain,West Indies,1986,2,103,198,5,1,694,1180,22,591,982,17,31.545454545454547,>30,WI,Home,Upto 2014
CA Walsh,WI,Pace,1986-10-24,Faisalabad,Pakistan,1986,2,71,168,3,1,582,1145,28,511,977,25,20.785714285714285,<=30,PAK,Away,Upto 2014
CA Walsh,WI,Pace,1986-11-07,Lahore,Pakistan,1986,2,77,219,7,1,247,794,22,170,575,15,11.227272727272727,<=30,PAK,Away,Upto 2014
CA Walsh,WI,Pace,1986-11-20,Karachi,Pakistan,1986,2,47,198,1,1,343,1168,21,296,970,20,16.333333333333332,<=30,PAK,Away,Upto 2014
CA Walsh,WI,Pace,1987-02-20,Wellington,New Zealand,1987,2,105,276,3,1,656,1620,18,551,1344,15,36.44444444444444,>30,NZ,Away,Upto 2014
CA Walsh,WI,Pace,1987-02-27,Auckland,New Zealand,1987,2,107,266,6,1,550,1311,24,443,1045,18,22.916666666666668,<=30,NZ,Away,Upto 2014
CA Walsh,WI,Pace,1987-03-12,Christchurch,New Zealand,1987,2,94,180,4,1,630,1188,33,536,1008,29,19.09090909090909,<=30,NZ,Away,Upto 2014
CA Walsh,WI,Pace,1987-11-25,Delhi,India,1987,2,67,201,6,1,549,1170,28,482,969,22,19.607142857142858,<=30,IND,Away,Upto 2014
CA Walsh,WI,Pace,1987-12-11,Wankhede,India,1987,2,94,190,9,1,509,808,22,415,618,13,23.136363636363637,<=30,IND,Away,Upto 2014
CA Walsh,WI,Pace,1987-12-26,Eden Gardens,India,1987,1,136,174,4,1,580,866,11,444,692,7,52.72727272727273,>30,IND,Away,Upto 2014
CA Walsh,WI,Pace,1988-01-11,Chennai,India,1988,2,140,258,7,1,358,643,15,218,385,8,23.866666666666667,<=30,IND,Away,Upto 2014
CA Walsh,WI,Pace,1988-04-02,Georgetown,West Indies,1988,1,80,162,3,1,579,1055,22,499,893,19,26.318181818181817,<=30,WI,Home,Upto 2014
CA Walsh,WI,Pace,1988-04-14,Port of Spain,West Indies,1988,2,75,222,1,1,692,1635,27,617,1413,26,25.62962962962963,<=30,WI,Home,Upto 2014
CA Walsh,WI,Pace,1988-04-22,Bridgetown,West Indies,1988,2,75,132,0,1,833,1467,30,758,1335,30,27.766666666666666,<=30,WI,Home,Upto 2014
CA Walsh,WI,Pace,1988-06-02,Nottingham,England,1988,2,123,270,0,1,781,1741,19,658,1471,19,41.10526315789474,>30,ENG,Away,Upto 2014
CA Walsh,WI,Pace,1988-06-16,Lord's,England,1988,2,111,216,3,1,943,1804,37,832,1588,34,25.486486486486488,<=30,ENG,Away,Upto 2014
CA Walsh,WI,Pace,1988-06-30,Manchester,England,1988,2,56,134,4,1,423,1051,26,367,917,22,16.26923076923077,<=30,ENG,Away,Upto 2014
CA Walsh,WI,Pace,1988-07-21,Leeds,England,1988,2,80,192,3,1,613,1328,28,533,1136,25,21.892857142857142,<=30,ENG,Away,Upto 2014
CA Walsh,WI,Pace,1988-08-04,The Oval,England,1988,2,42,132,2,1,629,1534,24,587,1402,22,26.208333333333332,<=30,ENG,Away,Upto 2014
CA Walsh,WI,Pace,1988-11-18,Brisbane,Australia,1988,2,123,225,7,1,708,1383,27,585,1158,20,26.22222222222222,<=30,AUS,Away,Upto 2014
CA Walsh,WI,Pace,1988-12-02,W.A.C.A,Australia,1988,2,104,204,2,1,1183,2020,32,1079,1816,30,36.96875,>30,AUS,Away,Upto 2014
CA Walsh,WI,Pace,1988-12-24,Melbourne,Australia,1988,2,70,201,3,1,897,2063,38,827,1862,35,23.605263157894736,<=30,AUS,Away,Upto 2014
CA Walsh,WI,Pace,1989-01-26,Sydney,Australia,1989,2,57,155,2,1,305,911,11,248,756,9,27.727272727272727,<=30,AUS,Away,Upto 2014
CA Walsh,WI,Pace,1989-02-03,Adelaide,Australia,1989,2,146,276,3,1,834,1481,18,688,1205,15,46.333333333333336,>30,AUS,Away,Upto 2014
CA Walsh,WI,Pace,1989-03-25,Georgetown,West Indies,1989,1,12,36,1,1,194,462,4,182,426,3,48.5,>30,WI,Home,Upto 2014
CA Walsh,WI,Pace,1989-04-07,Bridgetown,West Indies,1989,2,103,260,3,1,726,1450,23,623,1190,20,31.565217391304348,>30,WI,Home,Upto 2014
CA Walsh,WI,Pace,1989-04-15,Port of Spain,West Indies,1989,2,52,168,4,1,469,1127,29,417,959,25,16.17241379310345,<=30,WI,Home,Upto 2014
CA Walsh,WI,Pace,1989-04-28,Kingston,West Indies,1989,2,101,276,10,1,590,1241,28,489,965,18,21.071428571428573,<=30,WI,Home,Upto 2014
CA Walsh,WI,Pace,1990-02-24,Kingston,West Indies,1990,2,80,200,5,1,668,1460,29,588,1260,24,23.03448275862069,<=30,WI,Home,Upto 2014
CA Walsh,WI,Pace,1990-03-23,Port of Spain,West Indies,1990,2,72,174,4,1,773,1811,34,701,1637,30,22.735294117647058,<=30,WI,Home,Upto 2014
CA Walsh,WI,Pace,1990-04-12,St John's,West Indies,1990,2,91,186,3,1,830,1554,26,739,1368,23,31.923076923076923,>30,WI,Home,Upto 2014
CA Walsh,WI,Pace,1990-11-15,Karachi,Pakistan,1990,2,77,186,3,1,537,1280,27,460,1094,24,19.88888888888889,<=30,PAK,Away,Upto 2014
CA Walsh,WI,Pace,1990-11-23,Faisalabad,Pakistan,1990,2,70,114,3,1,499,862,28,429,748,25,17.821428571428573,<=30,PAK,Away,Upto 2014
CA Walsh,WI,Pace,1990-12-06,Lahore,Pakistan,1990,2,75,144,2,1,541,1248,30,466,1104,28,18.033333333333335,<=30,PAK,Away,Upto 2014
CA Walsh,WI,Pace,1991-03-01,Kingston,West Indies,1991,1,73,138,1,1,694,1365,21,621,1227,20,33.04761904761905,>30,WI,Home,Upto 2014
CA Walsh,WI,Pace,1991-03-23,Georgetown,West Indies,1991,2,136,282,2,1,808,1623,19,672,1341,17,42.526315789473685,>30,WI,Home,Upto 2014
CA Walsh,WI,Pace,1991-04-05,Port of Spain,West Indies,1991,2,56,252,2,1,449,1209,20,393,957,18,22.45,<=30,WI,Home,Upto 2014
CA Walsh,WI,Pace,1991-04-19,Bridgetown,West Indies,1991,2,51,117,6,1,874,1849,33,823,1732,27,26.484848484848484,<=30,WI,Home,Upto 2014
CA Walsh,WI,Pace,1991-04-27,St John's,West Indies,1991,2,110,288,6,1,735,1397,30,625,1109,24,24.5,<=30,WI,Home,Upto 2014
CA Walsh,WI,Pace,1991-06-06,Leeds,England,1991,2,92,264,2,1,749,1729,37,657,1465,35,20.243243243243242,<=30,ENG,Away,Upto 2014
CA Walsh,WI,Pace,1991-06-20,Lord's,England,1991,1,90,156,1,1,685,1326,19,595,1170,18,36.05263157894737,>30,ENG,Away,Upto 2014
CA Walsh,WI,Pace,1991-07-04,Nottingham,England,1991,2,139,288,5,1,833,1718,28,694,1430,23,29.75,<=30,ENG,Away,Upto 2014
CA Walsh,WI,Pace,1991-07-25,Birmingham,England,1991,2,63,168,3,1,722,1721,32,659,1553,29,22.5625,<=30,ENG,Away,Upto 2014
CA Walsh,WI,Pace,1991-08-08,The Oval,England,1991,2,109,246,4,1,826,1668,26,717,1422,22,31.76923076923077,>30,ENG,Away,Upto 2014
CA Walsh,WI,Pace,1992-04-18,Bridgetown,West Indies,1992,2,102,294,4,1,919,1991,34,817,1697,30,27.029411764705884,<=30,WI,Home,Upto 2014
CA Walsh,WI,Pace,1992-11-27,Brisbane,Australia,1992,2,66,149,2,1,859,1899,30,793,1750,28,28.633333333333333,<=30,AUS,Away,Upto 2014
CA Walsh,WI,Pace,1992-12-26,Melbourne,Australia,1992,2,133,360,6,1,743,1849,31,610,1489,25,23.967741935483872,<=30,AUS,Away,Upto 2014
CA Walsh,WI,Pace,1993-01-02,Sydney,Australia,1993,2,99,228,0,1,568,1162,8,469,934,8,71.0,>30,AUS,Away,Upto 2014
CA Walsh,WI,Pace,1993-01-23,Adelaide,Australia,1993,2,78,174,3,1,644,1295,29,566,1121,26,22.20689655172414,<=30,AUS,Away,Upto 2014
CA Walsh,WI,Pace,1993-01-30,W.A.C.A,Australia,1993,2,91,140,1,1,518,1062,27,427,922,26,19.185185185185187,<=30,AUS,Away,Upto 2014
CA Walsh,WI,Pace,1993-04-16,Port of Spain,West Indies,1993,2,42,114,4,1,566,1117,30,524,1003,26,18.866666666666667,<=30,WI,Home,Upto 2014
CA Walsh,WI,Pace,1993-04-23,Bridgetown,West Indies,1993,2,107,252,7,1,783,1460,25,676,1208,18,31.32,>30,WI,Home,Upto 2014
CA Walsh,WI,Pace,1993-05-01,St John's,West Indies,1993,1,58,114,1,1,577,1130,21,519,1016,20,27.476190476190474,<=30,WI,Home,Upto 2014
CA Walsh,WI,Pace,1993-12-08,Moratuwa,Sri Lanka,1993,2,60,181,1,1,179,537,9,119,356,8,19.88888888888889,<=30,SL,Away,Upto 2014
CA Walsh,WI,Pace,1994-02-19,Kingston,West Indies,1994,2,108,287,4,1,877,1820,28,769,1533,24,31.321428571428573,>30,WI,Home,Upto 2014
CA Walsh,WI,Pace,1994-03-17,Georgetown,West Indies,1994,2,140,306,4,1,724,1622,26,584,1316,22,27.846153846153847,<=30,WI,Home,Upto 2014
CA Walsh,WI,Pace,1994-03-25,Port of Spain,West Indies,1994,2,93,219,5,1,673,1600,36,580,1381,31,18.694444444444443,<=30,WI,Home,Upto 2014
CA Walsh,WI,Pace,1994-04-08,Bridgetown,West Indies,1994,2,182,312,6,1,996,1767,31,814,1455,25,32.12903225806452,>30,WI,Home,Upto 2014
CA Walsh,WI,Pace,1994-04-16,St John's,West Indies,1994,1,123,240,0,1,833,1731,12,710,1491,12,69.41666666666667,>30,WI,Home,Upto 2014
CA Walsh,WI,Pace,1994-11-18,Wankhede,India,1994,2,143,300,8,1,502,993,23,359,693,15,21.82608695652174,<=30,IND,Away,Upto 2014
CA Walsh,WI,Pace,1994-12-01,Nagpur,India,1994,2,95,227,4,1,503,867,8,408,640,4,62.875,>30,IND,Away,Upto 2014
CA Walsh,WI,Pace,1994-12-10,Mohali,India,1994,2,123,318,5,1,720,1337,21,597,1019,16,34.285714285714285,>30,IND,Away,Upto 2014
CA Walsh,WI,Pace,1995-02-03,Christchurch,New Zealand,1995,2,77,204,3,1,515,1143,17,438,939,14,30.294117647058822,>30,NZ,Away,Upto 2014
CA Walsh,WI,Pace,1995-02-10,Wellington,New Zealand,1995,2,55,216,13,1,598,1142,20,543,926,7,29.9,<=30,NZ,Away,Upto 2014
CA Walsh,WI,Pace,1995-03-31,Bridgetown,West Indies,1995,2,97,168,2,1,554,1046,24,457,878,22,23.083333333333332,<=30,WI,Home,Upto 2014
CA Walsh,WI,Pace,1995-04-08,St John's,West Indies,1995,2,146,345,9,1,658,1384,24,512,1039,15,27.416666666666668,<=30,WI,Home,Upto 2014
CA Walsh,WI,Pace,1995-04-21,Port of Spain,West Indies,1995,2,85,180,6,1,399,876,29,314,696,23,13.758620689655173,<=30,WI,Home,Upto 2014
CA Walsh,WI,Pace,1995-04-29,Kingston,West Indies,1995,1,103,198,3,1,658,1221,21,555,1023,18,31.333333333333332,>30,WI,Home,Upto 2014
CA Walsh,WI,Pace,1995-06-08,Leeds,England,1995,2,110,210,4,1,698,1234,27,588,1024,23,25.85185185185185,<=30,ENG,Away,Upto 2014
CA Walsh,WI,Pace,1995-06-22,Lord's,England,1995,2,141,305,6,1,1000,2102,38,859,1797,32,26.31578947368421,<=30,ENG,Away,Upto 2014
CA Walsh,WI,Pace,1995-07-06,Birmingham,England,1995,2,99,193,8,1,511,986,26,412,793,18,19.653846153846153,<=30,ENG,Away,Upto 2014
CA Walsh,WI,Pace,1995-07-27,Manchester,England,1995,2,109,258,4,1,744,1375,26,635,1117,22,28.615384615384617,<=30,ENG,Away,Upto 2014
CA Walsh,WI,Pace,1995-08-10,Nottingham,England,1995,2,163,414,2,1,678,1465,22,515,1051,20,30.818181818181817,>30,ENG,Away,Upto 2014
CA Walsh,WI,Pace,1995-08-24,The Oval,England,1995,2,164,360,2,1,1059,1992,20,895,1632,18,52.95,>30,ENG,Away,Upto 2014
CA Walsh,WI,Pace,1996-04-19,Bridgetown,West Indies,1996,2,102,234,6,1,918,1755,25,816,1521,19,36.72,>30,WI,Home,Upto 2014
CA Walsh,WI,Pace,1996-04-27,St John's,West Indies,1996,2,102,258,2,1,915,1920,26,813,1662,24,35.19230769230769,>30,WI,Home,Upto 2014
CA Walsh,WI,Pace,1996-11-22,Brisbane,Australia,1996,2,170,312,4,1,925,1944,28,755,1632,24,33.035714285714285,>30,AUS,Away,Upto 2014
CA Walsh,WI,Pace,1996-11-29,Sydney,Australia,1996,2,134,294,5,1,754,1620,23,620,1326,18,32.78260869565217,>30,AUS,Away,Upto 2014
CA Walsh,WI,Pace,1996-12-26,Melbourne,Australia,1996,2,84,150,3,1,553,1299,28,469,1149,25,19.75,<=30,AUS,Away,Upto 2014
CA Walsh,WI,Pace,1997-01-25,Adelaide,Australia,1997,1,101,225,2,1,488,1017,11,387,792,9,44.36363636363637,>30,AUS,Away,Upto 2014
CA Walsh,WI,Pace,1997-02-01,W.A.C.A,Australia,1997,2,103,174,5,1,699,1242,25,596,1068,20,27.96,<=30,AUS,Away,Upto 2014
CA Walsh,WI,Pace,1997-03-06,Kingston,West Indies,1997,2,80,240,2,1,612,1409,17,532,1169,15,36.0,>30,WI,Home,Upto 2014
CA Walsh,WI,Pace,1997-03-14,Port of Spain,West Indies,1997,1,71,216,0,1,527,1480,12,456,1264,12,43.916666666666664,>30,WI,Home,Upto 2014
CA Walsh,WI,Pace,1997-04-04,St John's,West Indies,1997,1,37,90,1,1,268,546,4,231,456,3,67.0,>30,WI,Home,Upto 2014
CA Walsh,WI,Pace,1997-04-17,Georgetown,West Indies,1997,1,62,170,1,1,344,855,6,282,685,5,57.333333333333336,>30,WI,Home,Upto 2014
CA Walsh,WI,Pace,1997-06-13,St John's,West Indies,1997,2,83,126,1,1,500,775,20,417,649,19,25.0,<=30,WI,Home,Upto 2014
CA Walsh,WI,Pace,1997-06-20,Kingstown,West Indies,1997,2,135,276,6,1,630,1024,21,495,748,15,30.0,<=30,WI,Home,Upto 2014
CA Walsh,WI,Pace,1997-11-17,Peshawar,Pakistan,1997,1,78,192,5,1,444,1004,18,366,812,13,24.666666666666668,<=30,PAK,Away,Upto 2014
CA Walsh,WI,Pace,1997-11-29,Rawalpindi,Pakistan,1997,1,143,259,5,1,728,1434,26,585,1175,21,28.0,<=30,PAK,Away,Upto 2014
CA Walsh,WI,Pace,1997-12-06,Karachi,Pakistan,1997,2,85,156,4,1,528,879,18,443,723,14,29.333333333333332,<=30,PAK,Away,Upto 2014
CA Walsh,WI,Pace,1998-01-29,Kingston,West Indies,1998,1,10,31,2,1,13,61,3,3,30,1,4.333333333333333,<=30,WI,Home,Upto 2014
CA Walsh,WI,Pace,1998-02-05,Port of Spain,West Indies,1998,2,122,336,4,1,715,1728,33,593,1392,29,21.666666666666668,<=30,WI,Home,Upto 2014
CA Walsh,WI,Pace,1998-02-13,Port of Spain,West Indies,1998,2,104,330,3,1,618,1619,31,514,1289,28,19.93548387096774,<=30,WI,Home,Upto 2014
CA Walsh,WI,Pace,1998-02-27,Georgetown,West Indies,1998,2,72,252,5,1,412,1052,21,340,800,16,19.61904761904762,<=30,WI,Home,Upto 2014
CA Walsh,WI,Pace,1998-03-12,Bridgetown,West Indies,1998,2,124,276,2,1,686,1395,17,562,1119,15,40.35294117647059,>30,WI,Home,Upto 2014
CA Walsh,WI,Pace,1998-03-20,St John's,West Indies,1998,2,132,343,6,1,587,1147,18,455,804,12,32.611111111111114,>30,WI,Home,Upto 2014
CA Walsh,WI,Pace,1998-11-26,Johannesburg,South Africa,1998,2,111,276,7,1,642,1519,31,531,1243,24,20.70967741935484,<=30,SA,Away,Upto 2014
CA Walsh,WI,Pace,1998-12-10,Gqeberha,South Africa,1998,2,145,285,7,1,639,1208,36,494,923,29,17.75,<=30,SA,Away,Upto 2014
CA Walsh,WI,Pace,1998-12-26,Durban,South Africa,1998,2,74,198,2,1,645,1347,28,571,1149,26,23.035714285714285,<=30,SA,Away,Upto 2014
CA Walsh,WI,Pace,1999-01-15,Centurion,South Africa,1999,2,86,194,6,1,776,1416,26,690,1222,20,29.846153846153847,<=30,SA,Away,Upto 2014
CA Walsh,WI,Pace,1999-03-05,Port of Spain,West Indies,1999,2,131,338,7,1,566,1392,32,435,1054,25,17.6875,<=30,WI,Home,Upto 2014
CA Walsh,WI,Pace,1999-03-13,Kingston,West Indies,1999,2,107,228,7,1,494,1032,18,387,804,11,27.444444444444443,<=30,WI,Home,Upto 2014
CA Walsh,WI,Pace,1999-03-26,Bridgetown,West Indies,1999,2,160,331,7,1,815,1748,29,655,1417,22,28.103448275862068,<=30,WI,Home,Upto 2014
CA Walsh,WI,Pace,1999-04-03,St John's,West Indies,1999,2,145,352,5,1,621,1546,25,476,1194,20,24.84,<=30,WI,Home,Upto 2014
CA Walsh,WI,Pace,1999-12-16,Hamilton,New Zealand,1999,2,114,222,3,1,615,1231,21,501,1009,18,29.285714285714285,<=30,NZ,Away,Upto 2014
CA Walsh,WI,Pace,1999-12-26,Wellington,New Zealand,1999,1,112,246,0,1,571,1324,20,459,1078,20,28.55,<=30,NZ,Away,Upto 2014
CA Walsh,WI,Pace,2000-03-16,Port of Spain,West Indies,2000,2,67,252,4,1,483,1518,30,416,1266,26,16.1,<=30,WI,Home,Upto 2014
CA Walsh,WI,Pace,2000-03-24,Kingston,West Indies,2000,2,67,231,5,1,544,1582,25,477,1351,20,21.76,<=30,WI,Home,Upto 2014
CA Walsh,WI,Pace,2000-05-05,Georgetown,West Indies,2000,1,46,168,2,1,344,903,13,298,735,11,26.46153846153846,<=30,WI,Home,Upto 2014
CA Walsh,WI,Pace,2000-05-18,Bridgetown,West Indies,2000,2,124,294,6,1,788,1618,23,664,1324,17,34.26086956521739,>30,WI,Home,Upto 2014
CA Walsh,WI,Pace,2000-05-25,St John's,West Indies,2000,2,122,276,6,1,652,1622,32,530,1346,26,20.375,<=30,WI,Home,Upto 2014
CA Walsh,WI,Pace,2000-06-15,Birmingham,England,2000,2,58,240,8,1,606,1373,25,548,1133,17,24.24,<=30,ENG,Away,Upto 2014
CA Walsh,WI,Pace,2000-06-29,Lord's,England,2000,2,117,245,10,1,573,1340,36,456,1095,26,15.916666666666666,<=30,ENG,Away,Upto 2014
CA Walsh,WI,Pace,2000-08-03,Manchester,England,2000,2,69,246,5,1,672,1537,23,603,1291,18,29.217391304347824,<=30,ENG,Away,Upto 2014
CA Walsh,WI,Pace,2000-08-17,Leeds,England,2000,1,51,149,4,1,405,817,24,354,668,20,16.875,<=30,ENG,Away,Upto 2014
CA Walsh,WI,Pace,2000-08-31,The Oval,England,2000,2,141,442,7,1,613,1636,30,472,1194,23,20.433333333333334,<=30,ENG,Away,Upto 2014
CA Walsh,WI,Pace,2000-11-23,Brisbane,Australia,2000,1,78,190,1,1,456,1175,24,378,985,23,19.0,<=30,AUS,Away,Upto 2014
CA Walsh,WI,Pace,2000-12-01,W.A.C.A,Australia,2000,1,74,186,2,1,637,1158,23,563,972,21,27.695652173913043,<=30,AUS,Away,Upto 2014
CA Walsh,WI,Pace,2000-12-15,Adelaide,Australia,2000,2,112,276,4,1,620,1329,20,508,1053,16,31.0,>30,AUS,Away,Upto 2014
CA Walsh,WI,Pace,2000-12-26,Melbourne,Australia,2000,2,108,306,2,1,686,1407,27,578,1101,25,25.40740740740741,<=30,AUS,Away,Upto 2014
CA Walsh,WI,Pace,2001-01-02,Sydney,Australia,2001,2,109,240,2,1,570,1068,13,461,828,11,43.84615384615385,>30,AUS,Away,Upto 2014
CA Walsh,WI,Pace,2001-03-09,Georgetown,West Indies,2001,2,75,228,2,1,709,1722,18,634,1494,16,39.388888888888886,>30,WI,Home,Upto 2014
CA Walsh,WI,Pace,2001-03-17,Port of Spain,West Indies,2001,2,108,346,8,1,814,1972,34,706,1626,26,23.941176470588236,<=30,WI,Home,Upto 2014
CA Walsh,WI,Pace,2001-03-29,Bridgetown,West Indies,2001,2,115,354,4,1,750,1752,22,635,1398,18,34.09090909090909,>30,WI,Home,Upto 2014
CA Walsh,WI,Pace,2001-04-06,St John's,West Indies,2001,2,101,414,5,1,374,1261,23,273,847,18,16.26086956521739,<=30,WI,Home,Upto 2014
CA Walsh,WI,Pace,2001-04-19,Kingston,West Indies,2001,2,93,240,6,1,641,1770,33,548,1530,27,19.424242424242426,<=30,WI,Home,Upto 2014
CA Young,IRE,Pace,2024-02-28,Tolerance Oval,UAE,2024,2,55,130,5,1,418,850,26,363,720,21,16.076923076923077,<=30,UAE,Away,After 1965
CA Young,IRE,Pace,2024-07-25,Belfast,Northern Ireland,2024,2,77,144,3,1,610,1116,26,533,972,23,23.46153846153846,<=30,Northern Ireland,Away,After 1965
CAK Rajitha,SL,Pace,2018-06-14,Gros Islet,West Indies,2018,2,72,210,5,1,739,1498,33,667,1288,28,22.393939393939394,<=30,WI,Away,After 1965
CAK Rajitha,SL,Pace,2018-06-23,Bridgetown,West Indies,2018,2,88,150,6,1,501,1108,32,413,958,26,15.65625,<=30,WI,Away,After 1965
CAK Rajitha,SL,Pace,2018-12-15,Wellington,New Zealand,2018,1,144,204,0,1,859,1641,18,715,1437,18,47.72222222222222,>30,NZ,Away,After 1965
CAK Rajitha,SL,Pace,2019-02-01,Canberra,Australia,2019,2,167,246,3,1,709,1113,23,542,867,20,30.82608695652174,>30,AUS,Away,After 1965
CAK Rajitha,SL,Pace,2019-02-13,Durban,South Africa,2019,2,122,166,4,1,725,1312,28,603,1146,24,25.892857142857142,<=30,SA,Away,After 1965
CAK Rajitha,SL,Pace,2019-02-21,Gqeberha,South Africa,2019,2,87,132,5,1,552,954,24,465,822,19,23.0,<=30,SA,Away,After 1965
CAK Rajitha,SL,Pace,2019-12-11,Rawalpindi,Pakistan,2019,1,5,36,1,1,376,750,8,371,714,7,47.0,>30,PAK,Away,After 1965
CAK Rajitha,SL,Pace,2020-01-19,Harare,Zimbabwe,2020,2,78,258,1,1,521,1458,17,443,1200,16,30.647058823529413,>30,ZIM,Away,After 1965
CAK Rajitha,SL,Pace,2020-12-26,Centurion,South Africa,2020,1,16,13,0,1,827,1226,23,811,1213,23,35.95652173913044,>30,SA,Away,After 1965
CAK Rajitha,SL,Pace,2022-05-15,Chattogram,Bangladesh,2022,1,60,145,4,1,332,607,7,272,462,3,47.42857142857143,>30,BAN,Away,After 1965
CAK Rajitha,SL,Pace,2022-05-23,Mirpur,Bangladesh,2022,2,104,242,7,1,494,899,21,390,657,14,23.523809523809526,<=30,BAN,Away,After 1965
CAK Rajitha,SL,Pace,2022-07-08,Galle,Sri Lanka,2022,2,86,180,2,1,290,570,7,204,390,5,41.42857142857143,>30,SL,Home,After 1965
CAK Rajitha,SL,Pace,2022-07-16,Galle,Sri Lanka,2022,2,60,120,1,1,258,511,10,198,391,9,25.8,<=30,SL,Home,After 1965
CAK Rajitha,SL,Pace,2023-03-09,Christchurch,New Zealand,2023,2,164,288,3,1,1067,1960,32,903,1672,29,33.34375,>30,NZ,Away,After 1965
CAK Rajitha,SL,Pace,2023-03-17,Wellington,New Zealand,2023,1,126,192,2,1,761,1427,16,635,1235,14,47.5625,>30,NZ,Away,After 1965
CAK Rajitha,SL,Pace,2023-07-16,Galle,Sri Lanka,2023,1,77,114,1,1,424,660,10,347,546,9,42.4,>30,SL,Home,After 1965
CAK Rajitha,SL,Pace,2024-02-02,Colombo (SSC),Sri Lanka,2024,1,59,120,2,1,535,897,18,476,777,16,29.72222222222222,<=30,SL,Home,After 1965
CAK Rajitha,SL,Pace,2024-03-22,Sylhet,Bangladesh,2024,2,112,180,8,1,733,1127,31,621,947,23,23.64516129032258,<=30,BAN,Away,After 1965
CB Clarke,WI,Spin,1939-06-24,Lord's,England,1939,1,28,48,1,1,311,784,11,283,736,10,28.272727272727273,<=30,ENG,Away,Upto 2014
CB Clarke,WI,Spin,1939-07-22,Manchester,England,1939,1,59,104,3,1,184,368,9,125,264,6,20.444444444444443,<=30,ENG,Away,Upto 2014
CB Clarke,WI,Spin,1939-08-19,The Oval,England,1939,2,174,304,2,1,434,768,4,260,464,2,108.5,>30,ENG,Away,Upto 2014
CB Fry,ENG,Pace,1899-08-14,The Oval,England,1899,1,3,10,0,1,660,1288,13,657,1278,13,50.76923076923077,>30,ENG,Home,After 1965
CB Lambert,WI,Spin,1991-08-08,The Oval,England,1991,1,4,4,1,1,257,571,9,253,567,8,28.555555555555557,<=30,ENG,Away,Upto 2014
CB Lambert,WI,Spin,1998-03-20,St John's,West Indies,1998,1,1,6,0,1,334,948,8,333,942,8,41.75,>30,WI,Home,Upto 2014
CB Llewellyn,SA,Spin,1896-03-02,Johannesburg,South Africa,1896,1,71,70,0,1,186,315,5,115,245,5,37.2,>30,SA,Home,After 1965
CB Llewellyn,SA,Spin,1899-02-14,Johannesburg,South Africa,1899,2,124,280,5,1,466,1319,30,342,1039,25,15.533333333333333,<=30,SA,Home,After 1965
CB Llewellyn,SA,Spin,1902-10-11,Johannesburg,South Africa,1902,2,216,288,9,1,619,846,16,403,558,7,38.6875,>30,SA,Home,Upto 2014
CB Llewellyn,SA,Spin,1902-10-18,Johannesburg,South Africa,1902,2,116,299,10,1,315,623,23,199,324,13,13.695652173913043,<=30,SA,Home,Upto 2014
CB Llewellyn,SA,Spin,1902-11-08,Cape Town,South Africa,1902,2,116,209,6,1,284,500,12,168,291,6,23.666666666666668,<=30,SA,Home,Upto 2014
CB Llewellyn,SA,Spin,1910-12-09,Sydney,Australia,1910,1,54,84,0,1,388,570,5,334,486,5,77.6,>30,AUS,Away,Upto 2014
CB Llewellyn,SA,Spin,1910-12-31,Melbourne,Australia,1910,2,150,156,6,1,675,1063,21,525,907,15,32.142857142857146,>30,AUS,Away,Upto 2014
CB Llewellyn,SA,Spin,1911-01-07,Adelaide,Australia,1911,2,155,258,5,1,814,1502,20,659,1244,15,40.7,>30,AUS,Away,Upto 2014
CB Llewellyn,SA,Spin,1911-02-17,Melbourne,Australia,1911,1,65,90,1,1,844,1322,23,779,1232,22,36.69565217391305,>30,AUS,Away,Upto 2014
CB Llewellyn,SA,Spin,1911-03-03,Sydney,Australia,1911,2,135,198,2,1,638,1067,19,503,869,17,33.578947368421055,>30,AUS,Away,Upto 2014
CB Llewellyn,SA,Spin,1912-06-10,Lord's,England,1912,1,60,54,0,1,275,582,7,215,528,7,39.285714285714285,>30,ENG,Away,Upto 2014
CB Llewellyn,SA,Spin,1912-07-15,Lord's,England,1912,1,71,114,2,1,501,1026,19,430,912,17,26.36842105263158,<=30,ENG,Away,Upto 2014
CB Llewellyn,SA,Spin,1912-08-05,Nottingham,England,1912,1,60,132,1,1,399,1038,15,339,906,14,26.6,<=30,ENG,Away,Upto 2014
CB Llewellyn,SA,Spin,1912-08-12,The Oval,England,1912,1,28,60,1,1,234,496,16,206,436,15,14.625,<=30,ENG,Away,Upto 2014
CB Mpofu,ZIM,Pace,2005-01-06,Chattogram,Bangladesh,2005,2,156,246,5,1,681,1423,24,525,1177,19,28.375,<=30,BAN,Away,Upto 2014
CB Mpofu,ZIM,Pace,2005-01-14,Dhaka,Bangladesh,2005,2,57,198,0,1,545,1416,17,488,1218,17,32.05882352941177,>30,BAN,Away,Upto 2014
CB Mpofu,ZIM,Pace,2005-03-04,Cape Town,South Africa,2005,1,53,72,0,1,443,710,15,390,638,15,29.533333333333335,<=30,SA,Away,Upto 2014
CB Mpofu,ZIM,Pace,2005-03-11,Centurion,South Africa,2005,1,110,126,1,1,611,1095,23,501,969,22,26.565217391304348,<=30,SA,Away,Upto 2014
CB Mpofu,ZIM,Pace,2005-08-07,Harare,Zimbabwe,2005,1,100,98,2,1,432,774,20,332,676,18,21.6,<=30,ZIM,Home,Upto 2014
CB Mpofu,ZIM,Pace,2005-08-15,Bulawayo,Zimbabwe,2005,1,80,90,0,1,584,919,19,504,829,19,30.736842105263158,>30,ZIM,Home,Upto 2014
CB Mpofu,ZIM,Pace,2011-08-04,Harare,Zimbabwe,2011,2,123,198,5,1,850,1557,26,727,1359,21,32.69230769230769,>30,ZIM,Home,Upto 2014
CB Mpofu,ZIM,Pace,2011-09-01,Bulawayo,Zimbabwe,2011,1,64,132,2,1,539,1117,15,475,985,13,35.93333333333333,>30,ZIM,Home,Upto 2014
CB Mpofu,ZIM,Pace,2011-11-01,Bulawayo,Zimbabwe,2011,2,146,288,5,1,759,1445,23,613,1157,18,33.0,>30,ZIM,Home,Upto 2014
CB Mpofu,ZIM,Pace,2016-10-29,Harare,Zimbabwe,2016,2,138,282,3,1,716,1330,16,578,1048,13,44.75,>30,ZIM,Home,After 1965
CB Mpofu,ZIM,Pace,2016-11-06,Harare,Zimbabwe,2016,2,143,264,2,1,650,1231,14,507,967,12,46.42857142857143,>30,ZIM,Home,After 1965
CB Mpofu,ZIM,Pace,2017-07-14,Colombo (RPS),Sri Lanka,2017,2,51,102,0,1,358,598,6,307,496,6,59.666666666666664,>30,SL,Away,After 1965
CB Mpofu,ZIM,Pace,2017-10-21,Bulawayo,Zimbabwe,2017,2,58,144,0,1,377,855,10,319,711,10,37.7,>30,ZIM,Home,After 1965
CB Mpofu,ZIM,Pace,2017-10-29,Bulawayo,Zimbabwe,2017,1,55,168,1,1,339,949,11,284,781,10,30.818181818181817,>30,ZIM,Home,After 1965
CB Mpofu,ZIM,Pace,2017-12-26,Gqeberha,South Africa,2017,1,58,81,3,1,327,664,21,269,583,18,15.571428571428571,<=30,SA,Away,After 1965
CB van Ryneveld,SA,Spin,1951-06-07,Nottingham,England,1951,1,10,18,0,1,552,1676,17,542,1658,17,32.470588235294116,>30,ENG,Away,Upto 2014
CB van Ryneveld,SA,Spin,1951-06-21,Lord's,England,1951,1,27,30,0,1,361,954,17,334,924,17,21.235294117647058,<=30,ENG,Away,Upto 2014
CB van Ryneveld,SA,Spin,1951-07-26,Leeds,England,1951,1,26,48,1,1,749,2072,16,723,2024,15,46.8125,>30,ENG,Away,Upto 2014
CB van Ryneveld,SA,Spin,1951-08-16,The Oval,England,1951,1,20,18,0,1,352,1033,18,332,1015,18,19.555555555555557,<=30,ENG,Away,Upto 2014
CB van Ryneveld,SA,Spin,1953-12-11,Durban,South Africa,1953,2,111,398,4,1,371,1319,16,260,921,12,23.1875,<=30,SA,Home,Upto 2014
CB van Ryneveld,SA,Spin,1954-01-01,Cape Town,South Africa,1954,1,93,184,2,1,639,1815,13,546,1631,11,49.15384615384615,>30,SA,Home,Upto 2014
CB van Ryneveld,SA,Spin,1954-01-29,Johannesburg,South Africa,1954,1,19,16,0,1,148,530,8,129,514,8,18.5,<=30,SA,Home,Upto 2014
CB van Ryneveld,SA,Spin,1954-02-05,Gqeberha,South Africa,1954,2,82,222,4,1,529,1620,15,447,1398,11,35.266666666666666,>30,SA,Home,Upto 2014
CB van Ryneveld,SA,Spin,1956-12-24,Johannesburg,South Africa,1956,1,23,64,1,1,201,734,9,178,670,8,22.333333333333332,<=30,SA,Home,Upto 2014
CB van Ryneveld,SA,Spin,1957-01-01,Cape Town,South Africa,1957,1,16,24,0,1,343,1239,21,327,1215,21,16.333333333333332,<=30,SA,Home,Upto 2014
CB van Ryneveld,SA,Spin,1957-01-25,Durban,South Africa,1957,2,87,224,3,1,361,1289,21,274,1065,18,17.19047619047619,<=30,SA,Home,Upto 2014
CB van Ryneveld,SA,Spin,1957-02-15,Johannesburg,South Africa,1957,1,40,64,0,1,404,1102,19,364,1038,19,21.263157894736842,<=30,SA,Home,Upto 2014
CB van Ryneveld,SA,Spin,1957-12-31,Cape Town,South Africa,1957,1,35,56,0,1,376,1269,21,341,1213,21,17.904761904761905,<=30,SA,Home,Upto 2014
CB van Ryneveld,SA,Spin,1958-01-24,Durban,South Africa,1958,2,54,160,2,1,339,1343,10,285,1183,8,33.9,>30,SA,Home,Upto 2014
CB van Ryneveld,SA,Spin,1958-02-07,Johannesburg,South Africa,1958,1,24,24,0,1,358,1230,15,334,1206,15,23.866666666666667,<=30,SA,Home,Upto 2014
CB van Ryneveld,SA,Spin,1958-02-28,Gqeberha,South Africa,1958,1,4,4,0,1,259,749,14,255,745,14,18.5,<=30,SA,Home,Upto 2014
CBRLS Kumara,SL,Pace,2016-10-29,Harare,Zimbabwe,2016,2,135,246,3,1,716,1330,16,581,1084,13,44.75,>30,ZIM,Away,After 1965
CBRLS Kumara,SL,Pace,2016-11-06,Harare,Zimbabwe,2016,2,102,138,1,1,650,1231,14,548,1093,13,46.42857142857143,>30,ZIM,Away,After 1965
CBRLS Kumara,SL,Pace,2017-01-02,Cape Town,South Africa,2017,2,184,222,7,1,701,1233,30,517,1011,23,23.366666666666667,<=30,SA,Away,After 1965
CBRLS Kumara,SL,Pace,2017-01-12,Johannesburg,South Africa,2017,1,107,151,4,1,621,1136,30,514,985,26,20.7,<=30,SA,Away,After 1965
CBRLS Kumara,SL,Pace,2017-03-07,Galle,Sri Lanka,2017,2,80,114,1,1,497,858,9,417,744,8,55.22222222222222,>30,SL,Home,After 1965
CBRLS Kumara,SL,Pace,2017-07-14,Colombo (RPS),Sri Lanka,2017,2,140,226,3,1,358,598,6,218,372,3,59.666666666666664,>30,SL,Home,After 1965
CBRLS Kumara,SL,Pace,2017-07-26,Galle,Sri Lanka,2017,2,190,223,4,1,627,805,16,437,582,12,39.1875,>30,SL,Home,After 1965
CBRLS Kumara,SL,Pace,2017-08-12,Pallekele,Sri Lanka,2017,1,104,138,0,1,344,606,10,240,468,10,34.4,>30,SL,Home,After 1965
CBRLS Kumara,SL,Pace,2018-01-31,Chattogram,Bangladesh,2018,2,95,126,0,1,301,515,4,206,389,4,75.25,>30,BAN,Away,After 1965
CBRLS Kumara,SL,Pace,2018-06-06,Port of Spain,West Indies,2018,2,135,240,7,1,624,1324,21,489,1084,14,29.714285714285715,<=30,WI,Away,After 1965
CBRLS Kumara,SL,Pace,2018-06-14,Gros Islet,West Indies,2018,2,114,219,4,1,739,1498,33,625,1279,29,22.393939393939394,<=30,WI,Away,After 1965
CBRLS Kumara,SL,Pace,2018-06-23,Bridgetown,West Indies,2018,2,89,191,6,1,501,1108,32,412,917,26,15.65625,<=30,WI,Away,After 1965
CBRLS Kumara,SL,Pace,2018-12-15,Wellington,New Zealand,2018,1,127,189,4,1,859,1641,18,732,1452,14,47.72222222222222,>30,NZ,Away,After 1965
CBRLS Kumara,SL,Pace,2018-12-26,Christchurch,New Zealand,2018,2,183,276,5,1,838,1658,30,655,1382,25,27.933333333333334,<=30,NZ,Away,After 1965
CBRLS Kumara,SL,Pace,2019-01-24,Brisbane,Australia,2019,1,37,90,1,1,398,892,24,361,802,23,16.583333333333332,<=30,AUS,Away,After 1965
CBRLS Kumara,SL,Pace,2019-08-14,Galle,Sri Lanka,2019,2,68,120,2,1,263,591,10,195,471,8,26.3,<=30,SL,Home,After 1965
CBRLS Kumara,SL,Pace,2019-08-22,Colombo (PSS),Sri Lanka,2019,1,115,150,1,1,360,808,14,245,658,13,25.714285714285715,<=30,SL,Home,After 1965
CBRLS Kumara,SL,Pace,2019-12-11,Rawalpindi,Pakistan,2019,1,46,84,1,1,376,750,8,330,666,7,47.0,>30,PAK,Away,After 1965
CBRLS Kumara,SL,Pace,2019-12-19,Karachi,Pakistan,2019,2,188,282,6,1,653,1162,24,465,880,18,27.208333333333332,<=30,PAK,Away,After 1965
CBRLS Kumara,SL,Pace,2020-01-19,Harare,Zimbabwe,2020,2,114,300,5,1,521,1458,17,407,1158,12,30.647058823529413,>30,ZIM,Away,After 1965
CBRLS Kumara,SL,Pace,2020-01-27,Harare,Zimbabwe,2020,2,98,180,2,1,441,1205,12,343,1025,10,36.75,>30,ZIM,Away,After 1965
CBRLS Kumara,SL,Pace,2020-12-26,Centurion,South Africa,2020,1,103,127,1,1,827,1226,23,724,1099,22,35.95652173913044,>30,SA,Away,After 1965
CBRLS Kumara,SL,Pace,2021-04-21,Pallekele,Sri Lanka,2021,1,88,168,1,1,611,1140,12,523,972,11,50.916666666666664,>30,SL,Home,After 1965
CBRLS Kumara,SL,Pace,2022-03-04,Mohali,India,2022,1,52,65,1,1,395,599,10,343,534,9,39.5,>30,IND,Away,After 1965
CBRLS Kumara,SL,Pace,2023-03-09,Christchurch,New Zealand,2023,2,137,240,4,1,1067,1960,32,930,1720,28,33.34375,>30,NZ,Away,After 1965
CBRLS Kumara,SL,Pace,2023-03-17,Wellington,New Zealand,2023,1,164,150,0,1,761,1427,16,597,1277,16,47.5625,>30,NZ,Away,After 1965
CBRLS Kumara,SL,Pace,2024-03-22,Sylhet,Bangladesh,2024,2,70,140,5,1,733,1127,31,663,987,26,23.64516129032258,<=30,BAN,Away,After 1965
CBRLS Kumara,SL,Pace,2024-03-30,Chattogram,Bangladesh,2024,2,69,156,6,1,504,886,22,435,730,16,22.90909090909091,<=30,BAN,Away,After 1965
CBRLS Kumara,SL,Pace,2024-08-29,Lord's,England,2024,2,154,213,5,1,781,1252,34,627,1039,29,22.970588235294116,<=30,ENG,Away,After 1965
CBRLS Kumara,SL,Pace,2024-09-06,The Oval,England,2024,2,118,138,6,1,809,1069,28,691,931,22,28.892857142857142,<=30,ENG,Away,After 1965
CBRLS Kumara,SL,Pace,2024-09-18,Galle,Sri Lanka,2024,2,43,84,0,1,264,533,10,221,449,10,26.4,<=30,SL,Home,After 1965
CBRLS Kumara,SL,Pace,2024-11-27,Durban,South Africa,2024,2,113,180,3,1,556,1001,29,443,821,26,19.17241379310345,<=30,SA,Away,After 1965
CBRLS Kumara,SL,Pace,2024-12-05,Gqeberha,South Africa,2024,2,150,202,5,1,793,1361,26,643,1159,21,30.5,>30,SA,Away,After 1965
CC Depeiaza,WI,Spin,1956-02-03,Dunedin,New Zealand,1956,2,15,30,0,1,439,1372,20,424,1342,20,21.95,<=30,NZ,Away,Upto 2014
CC Griffith,WI,Pace,1960-03-25,Port of Spain,West Indies,1960,2,102,144,1,1,604,1109,11,502,965,10,54.90909090909091,>30,WI,Home,Upto 2014
CC Griffith,WI,Pace,1963-06-06,Manchester,England,1963,2,48,179,1,1,370,899,6,322,720,5,61.666666666666664,>30,ENG,Away,Upto 2014
CC Griffith,WI,Pace,1963-06-20,Lord's,England,1963,2,150,336,8,1,666,1730,31,516,1394,23,21.483870967741936,<=30,ENG,Away,Upto 2014
CC Griffith,WI,Pace,1963-07-04,Birmingham,England,1963,2,103,294,5,1,467,1099,27,364,805,22,17.296296296296298,<=30,ENG,Away,Upto 2014
CC Griffith,WI,Pace,1963-07-25,Leeds,England,1963,2,81,234,9,1,551,1254,21,470,1020,12,26.238095238095237,<=30,ENG,Away,Upto 2014
CC Griffith,WI,Pace,1963-08-22,The Oval,England,1963,2,137,300,9,1,581,1365,22,444,1065,13,26.40909090909091,<=30,ENG,Away,Upto 2014
CC Griffith,WI,Pace,1965-03-03,Kingston,West Indies,1965,2,95,204,4,1,497,1218,24,402,1014,20,20.708333333333332,<=30,WI,Home,Upto 2014
CC Griffith,WI,Pace,1965-03-26,Port of Spain,West Indies,1965,1,81,198,3,1,537,1194,10,456,996,7,53.7,>30,WI,Home,Upto 2014
CC Griffith,WI,Pace,1965-04-14,Georgetown,West Indies,1965,2,70,120,2,1,434,874,16,364,754,14,27.125,<=30,WI,Home,Upto 2014
CC Griffith,WI,Pace,1965-05-05,Bridgetown,West Indies,1965,2,169,252,0,1,670,1290,13,501,1038,13,51.53846153846154,>30,WI,Home,Upto 2014
CC Griffith,WI,Pace,1965-05-14,Port of Spain,West Indies,1965,2,65,156,6,1,271,612,18,206,456,12,15.055555555555555,<=30,WI,Home,Upto 2014
CC Griffith,WI,Pace,1966-06-02,Manchester,England,1966,2,53,96,2,1,402,732,5,349,636,3,80.4,>30,ENG,Away,Upto 2014
CC Griffith,WI,Pace,1966-06-16,Lord's,England,1966,2,122,234,3,1,864,1752,24,742,1518,21,36.0,>30,ENG,Away,Upto 2014
CC Griffith,WI,Pace,1966-06-30,Nottingham,England,1966,2,96,201,6,1,760,1648,27,664,1447,21,28.14814814814815,<=30,ENG,Away,Upto 2014
CC Griffith,WI,Pace,1966-08-04,Leeds,England,1966,2,89,144,2,1,453,936,13,364,792,11,34.84615384615385,>30,ENG,Away,Upto 2014
CC Griffith,WI,Pace,1966-08-18,The Oval,England,1966,1,78,192,1,1,459,1079,13,381,887,12,35.30769230769231,>30,ENG,Away,Upto 2014
CC Griffith,WI,Pace,1966-12-13,Brabourne,India,1966,2,116,192,4,1,180,366,6,64,174,2,30.0,<=30,IND,Away,Upto 2014
CC Griffith,WI,Pace,1966-12-31,Eden Gardens,India,1966,2,18,66,0,1,232,474,6,214,408,6,38.666666666666664,>30,IND,Away,Upto 2014
CC Griffith,WI,Pace,1967-01-13,Chennai,India,1967,2,157,222,5,1,515,900,14,358,678,9,36.785714285714285,>30,IND,Away,Upto 2014
CC Griffith,WI,Pace,1968-01-19,Port of Spain,West Indies,1968,1,69,179,5,1,435,1007,15,366,828,10,29.0,<=30,WI,Home,Upto 2014
CC Griffith,WI,Pace,1968-02-08,Kingston,West Indies,1968,2,85,218,2,1,570,1419,25,485,1201,23,22.8,<=30,WI,Home,Upto 2014
CC Griffith,WI,Pace,1968-02-29,Bridgetown,West Indies,1968,1,71,144,3,1,595,1213,17,524,1069,14,35.0,>30,WI,Home,Upto 2014
CC Griffith,WI,Pace,1968-03-14,Port of Spain,West Indies,1968,1,7,18,0,1,441,768,6,434,750,6,73.5,>30,WI,Home,Upto 2014
CC Griffith,WI,Pace,1968-12-06,Brisbane,Australia,1968,1,47,96,0,1,316,792,11,269,696,11,28.727272727272727,<=30,AUS,Away,Upto 2014
CC Griffith,WI,Pace,1969-01-24,Adelaide,Australia,1969,2,167,328,4,1,674,1285,19,507,957,15,35.473684210526315,>30,AUS,Away,Upto 2014
CC Griffith,WI,Pace,1969-02-14,Sydney,Australia,1969,2,216,408,4,1,820,1525,21,604,1117,17,39.04761904761905,>30,AUS,Away,Upto 2014
CC Griffith,WI,Pace,1969-03-07,Wellington,New Zealand,1969,2,121,328,4,1,575,1263,24,454,935,20,23.958333333333332,<=30,NZ,Away,Upto 2014
CC Griffith,WI,Pace,1969-03-13,Christchurch,New Zealand,1969,2,70,148,1,1,436,944,10,366,796,9,43.6,>30,NZ,Away,Upto 2014
CC Hunte,WI,Pace,1959-02-06,Delhi,India,1959,1,4,24,0,1,501,1007,14,497,983,14,35.785714285714285,>30,IND,Away,Upto 2014
CC Hunte,WI,Pace,1960-01-06,Bridgetown,West Indies,1960,1,9,42,0,1,552,1376,10,543,1334,10,55.2,>30,WI,Home,Upto 2014
CC Hunte,WI,Pace,1960-03-25,Port of Spain,West Indies,1960,1,17,30,1,1,604,1109,11,587,1079,10,54.90909090909091,>30,WI,Home,Upto 2014
CC Hunte,WI,Pace,1965-03-26,Port of Spain,West Indies,1965,1,2,12,0,1,537,1194,10,535,1182,10,53.7,>30,WI,Home,Upto 2014
CC Hunte,WI,Pace,1965-05-05,Bridgetown,West Indies,1965,1,7,18,0,1,670,1290,13,663,1272,13,51.53846153846154,>30,WI,Home,Upto 2014
CC Hunte,WI,Pace,1966-08-18,The Oval,England,1966,1,41,78,0,1,459,1079,13,418,1001,13,35.30769230769231,>30,ENG,Away,Upto 2014
CC Hunte,WI,Pace,1966-12-31,Eden Gardens,India,1966,1,5,6,0,1,232,474,6,227,468,6,38.666666666666664,>30,IND,Away,Upto 2014
CC Hunte,WI,Pace,1967-01-13,Chennai,India,1967,1,25,60,1,1,515,900,14,490,840,13,36.785714285714285,>30,IND,Away,Upto 2014
CC Lewis,ENG,Pace,1990-07-05,Birmingham,England,1990,2,127,246,4,1,730,1539,27,603,1293,23,27.037037037037038,<=30,ENG,Home,Upto 2014
CC Lewis,ENG,Pace,1990-07-26,Lord's,England,1990,2,134,192,3,1,1076,1683,21,942,1491,18,51.23809523809524,>30,ENG,Home,Upto 2014
CC Lewis,ENG,Pace,1990-08-09,Manchester,England,1990,2,147,198,2,1,835,1242,15,688,1044,13,55.666666666666664,>30,ENG,Home,Upto 2014
CC Lewis,ENG,Pace,1990-11-23,Brisbane,Australia,1990,2,58,90,3,1,544,1327,29,486,1237,26,18.75862068965517,<=30,AUS,Away,Upto 2014
CC Lewis,ENG,Pace,1991-07-25,Birmingham,England,1991,2,156,306,6,1,722,1721,32,566,1415,26,22.5625,<=30,ENG,Home,Upto 2014
CC Lewis,ENG,Pace,1991-08-08,The Oval,England,1991,2,45,168,0,1,826,1668,26,781,1500,26,31.76923076923077,>30,ENG,Home,Upto 2014
CC Lewis,ENG,Pace,1991-08-22,Lord's,England,1991,2,60,168,2,1,770,1537,23,710,1369,21,33.47826086956522,>30,ENG,Home,Upto 2014
CC Lewis,ENG,Pace,1992-01-18,Christchurch,New Zealand,1992,2,135,312,3,1,763,1516,14,628,1204,11,54.5,>30,NZ,Away,Upto 2014
CC Lewis,ENG,Pace,1992-01-30,Auckland,New Zealand,1992,2,114,288,7,1,740,1678,33,626,1390,26,22.424242424242426,<=30,NZ,Away,Upto 2014
CC Lewis,ENG,Pace,1992-06-04,Birmingham,England,1992,1,116,198,0,1,641,1086,9,525,888,9,71.22222222222223,>30,ENG,Home,Upto 2014
CC Lewis,ENG,Pace,1992-06-18,Lord's,England,1992,2,119,270,4,1,607,1221,26,488,951,22,23.346153846153847,<=30,ENG,Home,Upto 2014
CC Lewis,ENG,Pace,1992-07-02,Manchester,England,1992,2,136,246,5,1,841,1528,24,705,1282,19,35.041666666666664,>30,ENG,Home,Upto 2014
CC Lewis,ENG,Pace,1992-07-23,Leeds,England,1992,2,103,234,2,1,719,1557,27,616,1323,25,26.62962962962963,<=30,ENG,Home,Upto 2014
CC Lewis,ENG,Pace,1992-08-06,The Oval,England,1992,1,70,180,1,1,546,1176,25,476,996,24,21.84,<=30,ENG,Home,Upto 2014
CC Lewis,ENG,Pace,1993-01-29,Eden Gardens,India,1993,2,69,156,0,1,387,856,9,318,700,9,43.0,>30,IND,Away,Upto 2014
CC Lewis,ENG,Pace,1993-02-11,Chennai,India,1993,1,40,66,1,1,257,522,5,217,456,4,51.4,>30,IND,Away,Upto 2014
CC Lewis,ENG,Pace,1993-02-19,Wankhede,India,1993,1,114,252,2,1,325,648,9,211,396,7,36.111111111111114,>30,IND,Away,Upto 2014
CC Lewis,ENG,Pace,1993-03-13,Colombo (SSC),Sri Lanka,1993,2,87,234,5,1,382,857,11,295,623,6,34.72727272727273,>30,SL,Away,Upto 2014
CC Lewis,ENG,Pace,1993-06-03,Manchester,England,1993,2,87,132,0,1,704,1351,14,617,1219,14,50.285714285714285,>30,ENG,Home,Upto 2014
CC Lewis,ENG,Pace,1993-06-17,Lord's,England,1993,1,151,216,2,1,536,1020,6,385,804,4,89.33333333333333,>30,ENG,Home,Upto 2014
CC Lewis,ENG,Pace,1994-02-19,Kingston,West Indies,1994,2,88,174,2,1,877,1820,28,789,1646,26,31.321428571428573,>30,WI,Away,Upto 2014
CC Lewis,ENG,Pace,1994-03-17,Georgetown,West Indies,1994,1,110,168,3,1,724,1622,26,614,1454,23,27.846153846153847,<=30,WI,Away,Upto 2014
CC Lewis,ENG,Pace,1994-03-25,Port of Spain,West Indies,1994,2,132,319,7,1,673,1600,36,541,1281,29,18.694444444444443,<=30,WI,Away,Upto 2014
CC Lewis,ENG,Pace,1994-04-08,Bridgetown,West Indies,1994,2,83,152,2,1,996,1767,31,913,1615,29,32.12903225806452,>30,WI,Away,Upto 2014
CC Lewis,ENG,Pace,1994-04-16,St John's,West Indies,1994,1,140,198,0,1,833,1731,12,693,1533,12,69.41666666666667,>30,WI,Away,Upto 2014
CC Lewis,ENG,Pace,1995-01-26,Adelaide,Australia,1995,2,105,186,6,1,823,1644,27,718,1458,21,30.48148148148148,>30,AUS,Away,Upto 2014
CC Lewis,ENG,Pace,1995-02-03,W.A.C.A,Australia,1995,2,144,287,5,1,946,1817,29,802,1530,24,32.62068965517241,>30,AUS,Away,Upto 2014
CC Lewis,ENG,Pace,1996-06-06,Birmingham,England,1996,2,116,244,7,1,677,1326,30,561,1082,23,22.566666666666666,<=30,ENG,Home,Upto 2014
CC Lewis,ENG,Pace,1996-06-20,Lord's,England,1996,1,101,240,3,1,826,2028,26,725,1788,23,31.76923076923077,>30,ENG,Home,Upto 2014
CC Lewis,ENG,Pace,1996-07-04,Nottingham,England,1996,2,139,306,5,1,859,1781,24,720,1475,19,35.791666666666664,>30,ENG,Home,Upto 2014
CC Lewis,ENG,Pace,1996-08-08,Leeds,England,1996,2,152,288,1,1,963,1933,22,811,1645,21,43.77272727272727,>30,ENG,Home,Upto 2014
CC Lewis,ENG,Pace,1996-08-22,The Oval,England,1996,1,112,138,0,1,690,1195,17,578,1057,17,40.588235294117645,>30,ENG,Home,Upto 2014
CC McDonald,AUS,Spin,1953-01-24,Adelaide,Australia,1953,1,3,8,0,1,857,2379,23,854,2371,23,37.26086956521739,>30,AUS,Home,Upto 2014
CC Passailaigue,WI,Spin,1930-04-03,Kingston,West Indies,1930,1,15,12,0,1,1040,2209,18,1025,2197,18,57.77777777777778,>30,WI,Home,Upto 2014
CD Collymore,WI,Pace,1999-04-03,St John's,West Indies,1999,2,109,246,1,1,621,1546,25,512,1300,24,24.84,<=30,WI,Home,Upto 2014
CD Collymore,WI,Pace,2003-06-20,Gros Islet,West Indies,2003,2,74,192,5,1,539,1047,9,465,855,4,59.888888888888886,>30,WI,Home,Upto 2014
CD Collymore,WI,Pace,2003-06-27,Kingston,West Indies,2003,2,85,186,9,1,610,1045,26,525,859,17,23.46153846153846,<=30,WI,Home,Upto 2014
CD Collymore,WI,Pace,2003-11-04,Harare,Zimbabwe,2003,2,190,264,3,1,904,1627,24,714,1363,21,37.666666666666664,>30,ZIM,Away,Upto 2014
CD Collymore,WI,Pace,2003-11-12,Bulawayo,Zimbabwe,2003,2,99,234,6,1,595,1210,25,496,976,19,23.8,<=30,ZIM,Away,Upto 2014
CD Collymore,WI,Pace,2003-12-12,Johannesburg,South Africa,2003,2,137,210,3,1,1112,2121,34,975,1911,31,32.705882352941174,>30,SA,Away,Upto 2014
CD Collymore,WI,Pace,2004-01-16,Centurion,South Africa,2004,1,91,156,1,1,1068,1800,24,977,1644,23,44.5,>30,SA,Away,Upto 2014
CD Collymore,WI,Pace,2004-03-11,Kingston,West Indies,2004,1,55,156,0,1,561,1123,25,506,967,25,22.44,<=30,WI,Home,Upto 2014
CD Collymore,WI,Pace,2004-03-19,Port of Spain,West Indies,2004,2,47,162,0,1,720,1489,29,673,1327,29,24.82758620689655,<=30,WI,Home,Upto 2014
CD Collymore,WI,Pace,2004-04-01,Bridgetown,West Indies,2004,2,50,138,3,1,550,1209,31,500,1071,28,17.741935483870968,<=30,WI,Home,Upto 2014
CD Collymore,WI,Pace,2004-04-10,St John's,West Indies,2004,2,103,222,0,1,955,1635,13,852,1413,13,73.46153846153847,>30,WI,Home,Upto 2014
CD Collymore,WI,Pace,2004-07-29,Birmingham,England,2004,2,159,234,2,1,971,1389,23,812,1155,21,42.21739130434783,>30,ENG,Away,Upto 2014
CD Collymore,WI,Pace,2004-08-12,Manchester,England,2004,2,99,252,3,1,785,1467,28,686,1215,25,28.035714285714285,<=30,ENG,Away,Upto 2014
CD Collymore,WI,Pace,2004-08-19,The Oval,England,2004,1,58,138,1,1,794,1252,26,736,1114,25,30.53846153846154,>30,ENG,Away,Upto 2014
CD Collymore,WI,Pace,2005-05-26,Bridgetown,West Indies,2005,2,100,166,4,1,722,1198,25,622,1032,21,28.88,<=30,WI,Home,Upto 2014
CD Collymore,WI,Pace,2005-06-03,Kingston,West Indies,2005,2,134,266,11,1,832,1351,29,698,1085,18,28.689655172413794,<=30,WI,Home,Upto 2014
CD Collymore,WI,Pace,2005-11-03,Brisbane,Australia,2005,2,128,222,4,1,772,1215,25,644,993,21,30.88,>30,AUS,Away,Upto 2014
CD Collymore,WI,Pace,2005-11-17,Hobart,Australia,2005,1,54,168,2,1,632,1261,19,578,1093,17,33.26315789473684,>30,AUS,Away,Upto 2014
CD Collymore,WI,Pace,2005-11-25,Adelaide,Australia,2005,2,110,258,2,1,853,1575,23,743,1317,21,37.08695652173913,>30,AUS,Away,Upto 2014
CD Collymore,WI,Pace,2006-06-02,St John's,West Indies,2006,2,77,240,4,1,716,1427,15,639,1187,11,47.733333333333334,>30,WI,Home,Upto 2014
CD Collymore,WI,Pace,2006-06-10,Gros Islet,West Indies,2006,1,92,126,0,1,597,938,8,505,812,8,74.625,>30,WI,Home,Upto 2014
CD Collymore,WI,Pace,2006-06-22,Basseterre,West Indies,2006,2,103,240,4,1,636,1116,17,533,876,13,37.411764705882355,>30,WI,Home,Upto 2014
CD Collymore,WI,Pace,2006-06-30,Kingston,West Indies,2006,2,65,259,7,1,405,1019,25,340,760,18,16.2,<=30,WI,Home,Upto 2014
CD Collymore,WI,Pace,2006-11-11,Lahore,Pakistan,2006,2,65,168,1,1,669,1208,21,604,1040,20,31.857142857142858,>30,PAK,Away,Upto 2014
CD Collymore,WI,Pace,2006-11-19,Multan,Pakistan,2006,2,133,354,2,1,741,1564,16,608,1210,14,46.3125,>30,PAK,Away,Upto 2014
CD Collymore,WI,Pace,2006-11-27,Karachi,Pakistan,2006,2,109,258,4,1,841,1655,23,732,1397,19,36.56521739130435,>30,PAK,Away,Upto 2014
CD Collymore,WI,Pace,2007-05-17,Lord's,England,2007,2,168,282,4,1,1013,1620,14,845,1338,10,72.35714285714286,>30,ENG,Away,Upto 2014
CD Collymore,WI,Pace,2007-05-25,Leeds,England,2007,1,110,174,2,1,714,1084,23,604,910,21,31.043478260869566,>30,ENG,Away,Upto 2014
CD Collymore,WI,Pace,2007-06-07,Manchester,England,2007,2,84,192,3,1,901,1654,29,817,1462,26,31.06896551724138,>30,ENG,Away,Upto 2014
CD Collymore,WI,Pace,2007-06-15,Chester-le-Street,England,2007,1,116,174,2,1,807,1380,26,691,1206,24,31.03846153846154,>30,ENG,Away,Upto 2014
CD Dixon,SA,Pace,1914-01-01,Johannesburg,South Africa,1914,2,118,240,3,1,545,1214,22,427,974,19,24.772727272727273,<=30,SA,Home,Upto 2014
CD Gopinath,IND,Pace,1951-12-14,Brabourne,India,1951,1,11,48,1,1,609,1495,17,598,1447,16,35.8235294117647,>30,IND,Home,Upto 2014
CD Matthews,AUS,Pace,1986-11-14,Brisbane,Australia,1986,2,106,234,3,1,755,1483,27,649,1249,24,27.962962962962962,<=30,AUS,Home,Upto 2014
CD Matthews,AUS,Pace,1986-11-28,W.A.C.A,Australia,1986,2,127,187,3,1,963,1802,22,836,1615,19,43.77272727272727,>30,AUS,Home,Upto 2014
CD Matthews,AUS,Pace,1988-11-18,Brisbane,Australia,1988,2,80,149,0,1,708,1383,27,628,1234,27,26.22222222222222,<=30,AUS,Home,Upto 2014
CD McMillan,NZ,Pace,1997-11-27,Hobart,Australia,1997,1,43,90,1,1,691,1411,18,648,1321,17,38.388888888888886,>30,AUS,Away,Upto 2014
CD McMillan,NZ,Pace,1998-02-19,Wellington,New Zealand,1998,1,5,30,0,1,429,1062,17,424,1032,17,25.235294117647058,<=30,NZ,Home,Upto 2014
CD McMillan,NZ,Pace,1998-02-26,Auckland,New Zealand,1998,1,15,12,0,1,557,1155,25,542,1143,25,22.28,<=30,NZ,Home,Upto 2014
CD McMillan,NZ,Pace,1998-05-27,Colombo (RPS),Sri Lanka,1998,2,43,108,2,1,355,626,8,312,518,6,44.375,>30,SL,Away,Upto 2014
CD McMillan,NZ,Pace,1998-06-03,Galle,Sri Lanka,1998,1,30,66,0,1,157,358,1,127,292,1,157.0,>30,SL,Away,Upto 2014
CD McMillan,NZ,Pace,1998-06-10,Colombo (SSC),Sri Lanka,1998,2,73,156,3,1,230,457,11,157,301,8,20.90909090909091,<=30,SL,Away,Upto 2014
CD McMillan,NZ,Pace,1998-12-26,Wellington,New Zealand,1998,2,26,70,2,1,632,1417,22,606,1347,20,28.727272727272727,<=30,NZ,Home,Upto 2014
CD McMillan,NZ,Pace,1999-01-02,Hamilton,New Zealand,1999,2,83,126,0,1,1002,1896,23,919,1770,23,43.56521739130435,>30,NZ,Home,Upto 2014
CD McMillan,NZ,Pace,1999-02-27,Auckland,New Zealand,1999,1,24,31,0,1,841,1949,13,817,1918,13,64.6923076923077,>30,NZ,Home,Upto 2014
CD McMillan,NZ,Pace,1999-07-01,Birmingham,England,1999,1,14,22,0,1,580,1146,27,566,1124,27,21.48148148148148,<=30,ENG,Away,Upto 2014
CD McMillan,NZ,Pace,1999-10-10,Mohali,India,1999,1,8,12,0,1,577,1368,20,569,1356,20,28.85,<=30,IND,Away,Upto 2014
CD McMillan,NZ,Pace,1999-12-16,Hamilton,New Zealand,1999,1,22,24,0,1,615,1231,21,593,1207,21,29.285714285714285,<=30,NZ,Home,Upto 2014
CD McMillan,NZ,Pace,2000-03-24,Wellington,New Zealand,2000,2,70,150,3,1,802,1476,20,732,1326,17,40.1,>30,NZ,Home,Upto 2014
CD McMillan,NZ,Pace,2000-03-31,Hamilton,New Zealand,2000,1,4,3,0,1,633,1061,24,629,1058,24,26.375,<=30,NZ,Home,Upto 2014
CD McMillan,NZ,Pace,2000-09-12,Bulawayo,Zimbabwe,2000,1,23,54,0,1,470,1291,13,447,1237,13,36.15384615384615,>30,ZIM,Away,Upto 2014
CD McMillan,NZ,Pace,2000-09-19,Harare,Zimbabwe,2000,2,82,197,2,1,838,2129,25,756,1932,23,33.52,>30,ZIM,Away,Upto 2014
CD McMillan,NZ,Pace,2000-11-17,Bloemfontein,South Africa,2000,1,38,78,0,1,906,1955,31,868,1877,31,29.225806451612904,<=30,SA,Away,Upto 2014
CD McMillan,NZ,Pace,2000-11-30,Gqeberha,South Africa,2000,1,31,102,1,1,698,1864,30,667,1762,29,23.266666666666666,<=30,SA,Away,Upto 2014
CD McMillan,NZ,Pace,2000-12-08,Johannesburg,South Africa,2000,1,41,102,0,1,417,1127,13,376,1025,13,32.07692307692308,>30,SA,Away,Upto 2014
CD McMillan,NZ,Pace,2000-12-26,Wellington,New Zealand,2000,1,22,54,1,1,550,1397,13,528,1343,12,42.30769230769231,>30,NZ,Home,Upto 2014
CD McMillan,NZ,Pace,2001-03-08,Auckland,New Zealand,2001,2,61,126,1,1,702,1474,24,641,1348,23,29.25,<=30,NZ,Home,Upto 2014
CD McMillan,NZ,Pace,2001-03-15,Christchurch,New Zealand,2001,1,47,186,1,1,802,1722,12,755,1536,11,66.83333333333333,>30,NZ,Home,Upto 2014
CD McMillan,NZ,Pace,2001-03-27,Hamilton,New Zealand,2001,1,2,30,1,1,506,942,23,504,912,22,22.0,<=30,NZ,Home,Upto 2014
CD McMillan,NZ,Pace,2001-11-08,Brisbane,Australia,2001,2,112,126,3,1,871,1428,20,759,1302,17,43.55,>30,AUS,Away,Upto 2014
CD McMillan,NZ,Pace,2001-11-22,Hobart,Australia,2001,1,51,48,0,1,554,972,8,503,924,8,69.25,>30,AUS,Away,Upto 2014
CD McMillan,NZ,Pace,2001-11-30,W.A.C.A,Australia,2001,1,15,30,1,1,1026,1787,22,1011,1757,21,46.63636363636363,>30,AUS,Away,Upto 2014
CD McMillan,NZ,Pace,2001-12-18,Hamilton,New Zealand,2001,1,39,48,2,1,586,928,27,547,880,25,21.703703703703702,<=30,NZ,Home,Upto 2014
CD McMillan,NZ,Pace,2002-03-13,Christchurch,New Zealand,2002,2,72,78,0,1,1052,1583,35,980,1505,35,30.057142857142857,>30,NZ,Home,Upto 2014
CD McMillan,NZ,Pace,2002-03-21,Wellington,New Zealand,2002,2,25,36,0,1,587,1212,18,562,1176,18,32.611111111111114,>30,NZ,Home,Upto 2014
CD McMillan,NZ,Pace,2002-03-30,Auckland,New Zealand,2002,1,5,6,0,1,809,1459,39,804,1453,39,20.743589743589745,<=30,NZ,Home,Upto 2014
CD McMillan,NZ,Pace,2002-05-01,Lahore,Pakistan,2002,1,48,108,3,1,476,866,17,428,758,14,28.0,<=30,PAK,Away,Upto 2014
CD McMillan,NZ,Pace,2003-10-08,Ahmedabad,India,2003,1,6,24,0,1,553,1086,9,547,1062,9,61.44444444444444,>30,IND,Away,Upto 2014
CD McMillan,NZ,Pace,2003-10-16,Mohali,India,2003,2,15,42,0,1,470,1014,9,455,972,9,52.22222222222222,>30,IND,Away,Upto 2014
CD McMillan,NZ,Pace,2003-12-26,Wellington,New Zealand,2003,1,11,24,0,1,696,1646,29,685,1622,29,24.0,<=30,NZ,Home,Upto 2014
CD McMillan,NZ,Pace,2004-03-10,Hamilton,New Zealand,2004,2,20,37,0,1,760,1661,15,740,1624,15,50.666666666666664,>30,NZ,Home,Upto 2014
CD McMillan,NZ,Pace,2004-03-18,Auckland,New Zealand,2004,1,3,24,1,1,1016,1973,29,1013,1949,28,35.03448275862069,>30,NZ,Home,Upto 2014
CD McMillan,NZ,Pace,2004-06-10,Nottingham,England,2004,1,5,12,0,1,1015,1836,30,1010,1824,30,33.833333333333336,>30,ENG,Away,Upto 2014
CD McMillan,NZ,Pace,2004-11-18,Brisbane,Australia,2004,1,23,30,0,1,723,1283,17,700,1253,17,42.529411764705884,>30,AUS,Away,Upto 2014
CD Watson,WI,Pace,1960-01-06,Bridgetown,West Indies,1960,2,140,244,3,1,552,1376,10,412,1132,7,55.2,>30,WI,Home,Upto 2014
CD Watson,WI,Pace,1960-01-28,Port of Spain,West Indies,1960,2,157,300,6,1,471,1183,24,314,883,18,19.625,<=30,WI,Home,Upto 2014
CD Watson,WI,Pace,1960-02-17,Kingston,West Indies,1960,2,136,336,5,1,593,1359,23,457,1023,18,25.782608695652176,<=30,WI,Home,Upto 2014
CD Watson,WI,Pace,1960-03-09,Georgetown,West Indies,1960,1,56,120,1,1,483,950,12,427,830,11,40.25,>30,WI,Home,Upto 2014
CD Watson,WI,Pace,1960-03-25,Port of Spain,West Indies,1960,2,104,194,1,1,604,1109,11,500,915,10,54.90909090909091,>30,WI,Home,Upto 2014
CD Watson,WI,Pace,1960-12-30,Melbourne,Australia,1960,2,105,168,2,1,364,824,18,259,656,16,20.22222222222222,<=30,AUS,Away,Upto 2014
CD Watson,WI,Pace,1962-02-16,Port of Spain,West Indies,1962,2,26,96,1,1,231,520,12,205,424,11,19.25,<=30,WI,Home,Upto 2014
CDUS Weerasinghe,SL,Spin,1985-09-06,Colombo (PSS),Sri Lanka,1985,2,36,114,0,1,268,693,4,232,579,4,67.0,>30,SL,Home,Upto 2014
CE Cuffy,WI,Pace,1994-11-18,Wankhede,India,1994,2,109,180,1,1,502,993,23,393,813,22,21.82608695652174,<=30,IND,Away,Upto 2014
CE Cuffy,WI,Pace,1994-12-10,Mohali,India,1994,2,81,134,4,1,720,1337,21,639,1203,17,34.285714285714285,>30,IND,Away,Upto 2014
CE Cuffy,WI,Pace,1997-01-25,Adelaide,Australia,1997,1,116,198,2,1,488,1017,11,372,819,9,44.36363636363637,>30,AUS,Away,Upto 2014
CE Cuffy,WI,Pace,2001-03-29,Bridgetown,West Indies,2001,2,99,240,2,1,750,1752,22,651,1512,20,34.09090909090909,>30,WI,Home,Upto 2014
CE Cuffy,WI,Pace,2001-04-19,Kingston,West Indies,2001,2,71,162,2,1,641,1770,33,570,1608,31,19.424242424242426,<=30,WI,Home,Upto 2014
CE Cuffy,WI,Pace,2002-01-31,Sharjah,UAE,2002,2,153,324,3,1,822,1590,24,669,1266,21,34.25,>30,UAE,Away,Upto 2014
CE Cuffy,WI,Pace,2002-02-07,Sharjah,UAE,2002,2,134,294,4,1,615,1212,24,481,918,20,25.625,<=30,UAE,Away,Upto 2014
CE Cuffy,WI,Pace,2002-04-11,Georgetown,West Indies,2002,1,57,162,3,1,506,1071,12,449,909,9,42.166666666666664,>30,WI,Home,Upto 2014
CE Cuffy,WI,Pace,2002-04-19,Port of Spain,West Indies,2002,2,102,300,5,1,849,1915,33,747,1615,28,25.727272727272727,<=30,WI,Home,Upto 2014
CE Cuffy,WI,Pace,2002-05-02,Bridgetown,West Indies,2002,2,43,198,2,1,655,1356,22,612,1158,20,29.772727272727273,<=30,WI,Home,Upto 2014
CE Cuffy,WI,Pace,2002-05-10,St John's,West Indies,2002,1,87,240,3,1,856,1992,11,769,1752,8,77.81818181818181,>30,WI,Home,Upto 2014
CE Cuffy,WI,Pace,2002-05-18,Kingston,West Indies,2002,2,83,240,4,1,844,1737,30,761,1497,26,28.133333333333333,<=30,WI,Home,Upto 2014
CE Cuffy,WI,Pace,2002-06-28,St George's,West Indies,2002,2,96,270,2,1,623,1356,15,527,1086,13,41.53333333333333,>30,WI,Home,Upto 2014
CE Cuffy,WI,Pace,2002-10-09,Wankhede,India,2002,1,88,172,2,1,351,798,10,263,626,8,35.1,>30,IND,Away,Upto 2014
CE Cuffy,WI,Pace,2002-10-30,Eden Gardens,India,2002,2,136,252,4,1,701,1322,15,565,1070,11,46.733333333333334,>30,IND,Away,Upto 2014
CE Eksteen,SA,Spin,1993-08-25,Moratuwa,Sri Lanka,1993,2,78,138,0,1,610,1439,14,532,1301,14,43.57142857142857,>30,SL,Away,Upto 2014
CE Eksteen,SA,Spin,1994-11-25,Johannesburg,South Africa,1994,2,81,222,2,1,233,640,10,152,418,8,23.3,<=30,SA,Home,Upto 2014
CE Eksteen,SA,Spin,1995-01-02,Cape Town,South Africa,1995,2,82,342,0,1,383,1034,9,301,692,9,42.55555555555556,>30,SA,Home,Upto 2014
CE Eksteen,SA,Spin,1995-01-19,Johannesburg,South Africa,1995,2,50,156,2,1,146,290,3,96,134,1,48.666666666666664,>30,SA,Home,Upto 2014
CE Eksteen,SA,Spin,1995-03-04,Auckland,New Zealand,1995,2,68,222,1,1,298,642,4,230,420,3,74.5,>30,NZ,Away,Upto 2014
CE Eksteen,SA,Spin,1995-11-30,Johannesburg,South Africa,1995,2,88,378,3,1,180,594,4,92,216,1,45.0,>30,SA,Home,Upto 2014
CE Eksteen,SA,Spin,2000-02-24,Wankhede,India,2000,2,47,78,0,1,274,666,12,227,588,12,22.833333333333332,<=30,IND,Away,Upto 2014
CE Finlason,SA,Pace,1889-03-12,Gqeberha,South Africa,1889,1,7,12,0,1,261,668,19,254,656,19,13.736842105263158,<=30,SA,Home,After 1965
CE Floquet,SA,Pace,1910-02-26,Johannesburg,South Africa,1910,1,24,48,0,1,366,667,10,342,619,10,36.6,>30,SA,Home,Upto 2014
CE McLeod,AUS,Pace,1894-12-14,Sydney,Australia,1894,2,92,264,2,1,993,2418,24,901,2154,22,41.375,>30,AUS,Home,After 1965
CE McLeod,AUS,Pace,1897-12-13,Sydney,Australia,1897,1,80,168,3,1,722,1597,21,642,1429,18,34.38095238095238,>30,AUS,Home,After 1965
CE McLeod,AUS,Pace,1898-01-01,Melbourne,Australia,1898,2,57,126,0,1,464,1032,7,407,906,7,66.28571428571429,>30,AUS,Home,After 1965
CE McLeod,AUS,Pace,1898-01-14,Adelaide,Australia,1898,1,65,288,5,1,674,1910,19,609,1622,14,35.473684210526315,>30,AUS,Home,After 1965
CE McLeod,AUS,Pace,1898-01-29,Melbourne,Australia,1898,1,11,50,2,1,528,1140,21,517,1090,19,25.142857142857142,<=30,AUS,Home,After 1965
CE McLeod,AUS,Pace,1898-02-26,Sydney,Australia,1898,1,23,66,0,1,648,1334,24,625,1268,24,27.0,<=30,AUS,Home,After 1965
CE McLeod,AUS,Pace,1899-08-14,The Oval,England,1899,1,131,240,1,1,660,1288,13,529,1048,12,50.76923076923077,>30,ENG,Away,After 1965
CE McLeod,AUS,Pace,1901-12-13,Sydney,Australia,1901,1,84,264,4,1,416,1027,14,332,763,10,29.714285714285715,<=30,AUS,Home,Upto 2014
CE McLeod,AUS,Pace,1902-01-17,Adelaide,Australia,1902,2,80,198,1,1,342,876,5,262,678,4,68.4,>30,AUS,Home,Upto 2014
CE McLeod,AUS,Pace,1904-01-15,Adelaide,Australia,1904,2,102,294,2,1,683,1465,19,581,1171,17,35.94736842105263,>30,AUS,Home,Upto 2014
CE McLeod,AUS,Pace,1904-02-26,Sydney,Australia,1904,2,51,168,3,1,327,845,17,276,677,14,19.235294117647058,<=30,AUS,Home,Upto 2014
CE McLeod,AUS,Pace,1904-03-05,Melbourne,Australia,1904,2,24,36,0,1,250,529,16,226,493,16,15.625,<=30,AUS,Home,Upto 2014
CE McLeod,AUS,Pace,1905-05-29,Nottingham,England,1905,2,103,216,0,1,577,1196,21,474,980,21,27.476190476190474,<=30,ENG,Away,Upto 2014
CE McLeod,AUS,Pace,1905-06-15,Lord's,England,1905,2,73,210,2,1,344,822,16,271,612,14,21.5,<=30,ENG,Away,Upto 2014
CE McLeod,AUS,Pace,1905-07-03,Leeds,England,1905,2,150,360,3,1,525,1232,17,375,872,14,30.88235294117647,>30,ENG,Away,Upto 2014
CE McLeod,AUS,Pace,1905-07-24,Manchester,England,1905,1,125,282,5,1,572,1050,20,447,768,15,28.6,<=30,ENG,Away,Upto 2014
CE McLeod,AUS,Pace,1905-08-14,The Oval,England,1905,2,74,144,0,1,775,1333,24,701,1189,24,32.291666666666664,>30,ENG,Away,Upto 2014
CE Pellew,AUS,Pace,1920-12-31,Melbourne,Australia,1920,1,3,6,0,1,456,894,15,453,888,15,30.4,>30,AUS,Home,Upto 2014
CE Pellew,AUS,Pace,1921-07-23,Manchester,England,1921,1,6,18,0,1,286,546,3,280,528,3,95.33333333333333,>30,ENG,Away,Upto 2014
CE Pellew,AUS,Pace,1921-08-13,The Oval,England,1921,1,25,54,0,1,511,912,11,486,858,11,46.45454545454545,>30,ENG,Away,Upto 2014
CEH Croft,WI,Pace,1977-02-18,Bridgetown,West Indies,1977,2,132,280,7,1,1045,1954,34,913,1674,27,30.735294117647058,>30,WI,Home,Upto 2014
CEH Croft,WI,Pace,1977-03-04,Port of Spain,West Indies,1977,2,95,263,9,1,520,1242,24,425,979,15,21.666666666666668,<=30,WI,Home,Upto 2014
CEH Croft,WI,Pace,1977-03-18,Georgetown,West Indies,1977,2,179,300,5,1,1085,2006,25,906,1706,20,43.4,>30,WI,Home,Upto 2014
CEH Croft,WI,Pace,1977-04-01,Port of Spain,West Indies,1977,2,135,263,5,1,547,1241,19,412,978,14,28.789473684210527,<=30,WI,Home,Upto 2014
CEH Croft,WI,Pace,1977-04-15,Kingston,West Indies,1977,2,135,201,7,1,849,1372,30,714,1171,23,28.3,<=30,WI,Home,Upto 2014
CEH Croft,WI,Pace,1978-03-03,Port of Spain,West Indies,1978,2,70,133,4,1,396,789,19,326,656,15,20.842105263157894,<=30,WI,Home,Upto 2014
CEH Croft,WI,Pace,1978-03-17,Bridgetown,West Indies,1978,2,100,198,5,1,577,955,26,477,757,21,22.192307692307693,<=30,WI,Home,Upto 2014
CEH Croft,WI,Pace,1979-12-01,Brisbane,Australia,1979,2,186,318,4,1,937,2006,27,751,1688,23,34.7037037037037,>30,AUS,Away,Upto 2014
CEH Croft,WI,Pace,1979-12-29,Melbourne,Australia,1979,2,88,213,6,1,659,1369,27,571,1156,21,24.40740740740741,<=30,AUS,Away,Upto 2014
CEH Croft,WI,Pace,1980-01-26,Adelaide,Australia,1980,2,104,198,6,1,844,1627,35,740,1429,29,24.114285714285714,<=30,AUS,Away,Upto 2014
CEH Croft,WI,Pace,1980-02-08,Dunedin,New Zealand,1980,2,89,216,6,1,533,1670,35,444,1454,29,15.228571428571428,<=30,NZ,Away,Upto 2014
CEH Croft,WI,Pace,1980-02-22,Christchurch,New Zealand,1980,1,78,144,1,1,946,1857,20,868,1713,19,47.3,>30,NZ,Away,Upto 2014
CEH Croft,WI,Pace,1980-02-29,Auckland,New Zealand,1980,2,98,258,3,1,786,1985,29,688,1727,26,27.103448275862068,<=30,NZ,Away,Upto 2014
CEH Croft,WI,Pace,1980-06-19,Lord's,England,1980,2,101,168,0,1,667,1407,18,566,1239,18,37.05555555555556,>30,ENG,Away,Upto 2014
CEH Croft,WI,Pace,1980-07-24,The Oval,England,1980,2,105,270,5,1,630,1595,25,525,1325,20,25.2,<=30,ENG,Away,Upto 2014
CEH Croft,WI,Pace,1980-08-07,Leeds,England,1980,2,100,186,4,1,526,1199,25,426,1013,21,21.04,<=30,ENG,Away,Upto 2014
CEH Croft,WI,Pace,1980-11-24,Lahore,Pakistan,1980,2,128,288,4,1,508,1109,13,380,821,9,39.07692307692308,>30,PAK,Away,Upto 2014
CEH Croft,WI,Pace,1980-12-08,Faisalabad,Pakistan,1980,2,64,174,5,1,265,580,15,201,406,10,17.666666666666668,<=30,PAK,Away,Upto 2014
CEH Croft,WI,Pace,1980-12-22,Karachi,Pakistan,1980,2,77,222,6,1,342,961,23,265,739,17,14.869565217391305,<=30,PAK,Away,Upto 2014
CEH Croft,WI,Pace,1980-12-30,Multan,Pakistan,1980,1,33,96,2,1,286,658,15,253,562,13,19.066666666666666,<=30,PAK,Away,Upto 2014
CEH Croft,WI,Pace,1981-02-13,Port of Spain,West Indies,1981,2,66,228,6,1,521,1338,21,455,1110,15,24.80952380952381,<=30,WI,Home,Upto 2014
CEH Croft,WI,Pace,1981-03-13,Bridgetown,West Indies,1981,2,104,197,7,1,801,1640,34,697,1443,27,23.558823529411764,<=30,WI,Home,Upto 2014
CEH Croft,WI,Pace,1981-03-27,St John's,West Indies,1981,2,113,246,8,1,702,1430,20,589,1184,12,35.1,>30,WI,Home,Upto 2014
CEH Croft,WI,Pace,1981-04-10,Kingston,West Indies,1981,2,172,276,3,1,705,1477,22,533,1201,19,32.04545454545455,>30,WI,Home,Upto 2014
CEH Croft,WI,Pace,1981-12-26,Melbourne,Australia,1981,2,100,217,3,1,642,1526,35,542,1309,32,18.34285714285714,<=30,AUS,Away,Upto 2014
CEH Croft,WI,Pace,1982-01-02,Sydney,Australia,1982,2,111,282,2,1,792,1770,20,681,1488,18,39.6,>30,AUS,Away,Upto 2014
CEH Croft,WI,Pace,1982-01-30,Adelaide,Australia,1982,2,150,330,2,1,872,1878,30,722,1548,28,29.066666666666666,<=30,AUS,Away,Upto 2014
CEJ Guest,AUS,Pace,1963-01-11,Sydney,Australia,1963,2,59,144,0,1,454,1207,16,395,1063,16,28.375,<=30,AUS,Home,Upto 2014
CEL Ambrose,WI,Pace,1988-04-02,Georgetown,West Indies,1988,2,121,177,2,1,579,1055,22,458,878,20,26.318181818181817,<=30,WI,Home,Upto 2014
CEL Ambrose,WI,Pace,1988-04-14,Port of Spain,West Indies,1988,2,106,264,2,1,692,1635,27,586,1371,25,25.62962962962963,<=30,WI,Home,Upto 2014
CEL Ambrose,WI,Pace,1988-04-22,Bridgetown,West Indies,1988,2,138,245,3,1,833,1467,30,695,1222,27,27.766666666666666,<=30,WI,Home,Upto 2014
CEL Ambrose,WI,Pace,1988-06-02,Nottingham,England,1988,2,109,294,5,1,781,1741,19,672,1447,14,41.10526315789474,>30,ENG,Away,Upto 2014
CEL Ambrose,WI,Pace,1988-06-16,Lord's,England,1988,2,86,192,2,1,943,1804,37,857,1612,35,25.486486486486488,<=30,ENG,Away,Upto 2014
CEL Ambrose,WI,Pace,1988-06-30,Manchester,England,1988,2,71,198,4,1,423,1051,26,352,853,22,16.26923076923077,<=30,ENG,Away,Upto 2014
CEL Ambrose,WI,Pace,1988-07-21,Leeds,England,1988,2,98,270,7,1,613,1328,28,515,1058,21,21.892857142857142,<=30,ENG,Away,Upto 2014
CEL Ambrose,WI,Pace,1988-08-04,The Oval,England,1988,2,81,265,4,1,629,1534,24,548,1269,20,26.208333333333332,<=30,ENG,Away,Upto 2014
CEL Ambrose,WI,Pace,1988-11-18,Brisbane,Australia,1988,2,108,258,6,1,708,1383,27,600,1125,21,26.22222222222222,<=30,AUS,Away,Upto 2014
CEL Ambrose,WI,Pace,1988-12-02,W.A.C.A,Australia,1988,2,138,243,8,1,1183,2020,32,1045,1777,24,36.96875,>30,AUS,Away,Upto 2014
CEL Ambrose,WI,Pace,1988-12-24,Melbourne,Australia,1988,2,81,240,6,1,897,2063,38,816,1823,32,23.605263157894736,<=30,AUS,Away,Upto 2014
CEL Ambrose,WI,Pace,1989-01-26,Sydney,Australia,1989,2,94,240,2,1,305,911,11,211,671,9,27.727272727272727,<=30,AUS,Away,Upto 2014
CEL Ambrose,WI,Pace,1989-02-03,Adelaide,Australia,1989,2,137,246,4,1,834,1481,18,697,1235,14,46.333333333333336,>30,AUS,Away,Upto 2014
CEL Ambrose,WI,Pace,1989-03-25,Georgetown,West Indies,1989,1,6,18,0,1,194,462,4,188,444,4,48.5,>30,WI,Home,Upto 2014
CEL Ambrose,WI,Pace,1989-04-07,Bridgetown,West Indies,1989,2,150,279,3,1,726,1450,23,576,1171,20,31.565217391304348,>30,WI,Home,Upto 2014
CEL Ambrose,WI,Pace,1989-04-15,Port of Spain,West Indies,1989,2,51,144,1,1,469,1127,29,418,983,28,16.17241379310345,<=30,WI,Home,Upto 2014
CEL Ambrose,WI,Pace,1989-04-28,Kingston,West Indies,1989,2,66,122,1,1,590,1241,28,524,1119,27,21.071428571428573,<=30,WI,Home,Upto 2014
CEL Ambrose,WI,Pace,1990-03-23,Port of Spain,West Indies,1990,2,79,254,4,1,773,1811,34,694,1557,30,22.735294117647058,<=30,WI,Home,Upto 2014
CEL Ambrose,WI,Pace,1990-04-05,Bridgetown,West Indies,1990,2,127,286,10,1,1177,2232,37,1050,1946,27,31.81081081081081,>30,WI,Home,Upto 2014
CEL Ambrose,WI,Pace,1990-04-12,St John's,West Indies,1990,2,101,252,6,1,830,1554,26,729,1302,20,31.923076923076923,>30,WI,Home,Upto 2014
CEL Ambrose,WI,Pace,1990-11-15,Karachi,Pakistan,1990,2,82,216,4,1,537,1280,27,455,1064,23,19.88888888888889,<=30,PAK,Away,Upto 2014
CEL Ambrose,WI,Pace,1990-11-23,Faisalabad,Pakistan,1990,2,79,180,4,1,499,862,28,420,682,24,17.821428571428573,<=30,PAK,Away,Upto 2014
CEL Ambrose,WI,Pace,1990-12-06,Lahore,Pakistan,1990,2,78,244,6,1,541,1248,30,463,1004,24,18.033333333333335,<=30,PAK,Away,Upto 2014
CEL Ambrose,WI,Pace,1991-03-01,Kingston,West Indies,1991,1,94,180,2,1,694,1365,21,600,1185,19,33.04761904761905,>30,WI,Home,Upto 2014
CEL Ambrose,WI,Pace,1991-03-23,Georgetown,West Indies,1991,2,109,334,4,1,808,1623,19,699,1289,15,42.526315789473685,>30,WI,Home,Upto 2014
CEL Ambrose,WI,Pace,1991-04-05,Port of Spain,West Indies,1991,2,62,234,1,1,449,1209,20,387,975,19,22.45,<=30,WI,Home,Upto 2014
CEL Ambrose,WI,Pace,1991-04-19,Bridgetown,West Indies,1991,2,72,210,5,1,874,1849,33,802,1639,28,26.484848484848484,<=30,WI,Home,Upto 2014
CEL Ambrose,WI,Pace,1991-04-27,St John's,West Indies,1991,2,156,276,6,1,735,1397,30,579,1121,24,24.5,<=30,WI,Home,Upto 2014
CEL Ambrose,WI,Pace,1991-06-06,Leeds,England,1991,2,101,324,8,1,749,1729,37,648,1405,29,20.243243243243242,<=30,ENG,Away,Upto 2014
CEL Ambrose,WI,Pace,1991-06-20,Lord's,England,1991,1,87,204,4,1,685,1326,19,598,1122,15,36.05263157894737,>30,ENG,Away,Upto 2014
CEL Ambrose,WI,Pace,1991-07-04,Nottingham,England,1991,2,135,366,8,1,833,1718,28,698,1352,20,29.75,<=30,ENG,Away,Upto 2014
CEL Ambrose,WI,Pace,1991-07-25,Birmingham,England,1991,2,106,336,5,1,722,1721,32,616,1385,27,22.5625,<=30,ENG,Away,Upto 2014
CEL Ambrose,WI,Pace,1991-08-08,The Oval,England,1991,2,131,264,3,1,826,1668,26,695,1404,23,31.76923076923077,>30,ENG,Away,Upto 2014
CEL Ambrose,WI,Pace,1992-04-18,Bridgetown,West Indies,1992,2,81,364,8,1,919,1991,34,838,1627,26,27.029411764705884,<=30,WI,Home,Upto 2014
CEL Ambrose,WI,Pace,1992-11-27,Brisbane,Australia,1992,2,119,367,7,1,859,1899,30,740,1532,23,28.633333333333333,<=30,AUS,Away,Upto 2014
CEL Ambrose,WI,Pace,1992-12-26,Melbourne,Australia,1992,2,127,390,5,1,743,1849,31,616,1459,26,23.967741935483872,<=30,AUS,Away,Upto 2014
CEL Ambrose,WI,Pace,1993-01-02,Sydney,Australia,1993,2,97,246,2,1,568,1162,8,471,916,6,71.0,>30,AUS,Away,Upto 2014
CEL Ambrose,WI,Pace,1993-01-23,Adelaide,Australia,1993,2,120,326,10,1,644,1295,29,524,969,19,22.20689655172414,<=30,AUS,Away,Upto 2014
CEL Ambrose,WI,Pace,1993-01-30,W.A.C.A,Australia,1993,2,79,234,9,1,518,1062,27,439,828,18,19.185185185185187,<=30,AUS,Away,Upto 2014
CEL Ambrose,WI,Pace,1993-04-16,Port of Spain,West Indies,1993,2,71,180,5,1,566,1117,30,495,937,25,18.866666666666667,<=30,WI,Home,Upto 2014
CEL Ambrose,WI,Pace,1993-04-23,Bridgetown,West Indies,1993,2,97,252,3,1,783,1460,25,686,1208,22,31.32,>30,WI,Home,Upto 2014
CEL Ambrose,WI,Pace,1993-05-01,St John's,West Indies,1993,1,40,138,1,1,577,1130,21,537,992,20,27.476190476190474,<=30,WI,Home,Upto 2014
CEL Ambrose,WI,Pace,1993-12-08,Moratuwa,Sri Lanka,1993,2,27,110,3,1,179,537,9,152,427,6,19.88888888888889,<=30,SL,Away,Upto 2014
CEL Ambrose,WI,Pace,1994-02-19,Kingston,West Indies,1994,2,113,276,2,1,877,1820,28,764,1544,26,31.321428571428573,>30,WI,Home,Upto 2014
CEL Ambrose,WI,Pace,1994-03-17,Georgetown,West Indies,1994,2,95,318,8,1,724,1622,26,629,1304,18,27.846153846153847,<=30,WI,Home,Upto 2014
CEL Ambrose,WI,Pace,1994-03-25,Port of Spain,West Indies,1994,2,84,234,11,1,673,1600,36,589,1366,25,18.694444444444443,<=30,WI,Home,Upto 2014
CEL Ambrose,WI,Pace,1994-04-08,Bridgetown,West Indies,1994,2,161,278,4,1,996,1767,31,835,1489,27,32.12903225806452,>30,WI,Home,Upto 2014
CEL Ambrose,WI,Pace,1994-04-16,St John's,West Indies,1994,1,66,240,1,1,833,1731,12,767,1491,11,69.41666666666667,>30,WI,Home,Upto 2014
CEL Ambrose,WI,Pace,1995-02-03,Christchurch,New Zealand,1995,2,64,205,3,1,515,1143,17,451,938,14,30.294117647058822,>30,NZ,Away,Upto 2014
CEL Ambrose,WI,Pace,1995-02-10,Wellington,New Zealand,1995,2,49,144,2,1,598,1142,20,549,998,18,29.9,<=30,NZ,Away,Upto 2014
CEL Ambrose,WI,Pace,1995-03-31,Bridgetown,West Indies,1995,1,41,120,2,1,554,1046,24,513,926,22,23.083333333333332,<=30,WI,Home,Upto 2014
CEL Ambrose,WI,Pace,1995-04-08,St John's,West Indies,1995,2,76,198,1,1,658,1384,24,582,1186,23,27.416666666666668,<=30,WI,Home,Upto 2014
CEL Ambrose,WI,Pace,1995-04-21,Port of Spain,West Indies,1995,2,65,157,9,1,399,876,29,334,719,20,13.758620689655173,<=30,WI,Home,Upto 2014
CEL Ambrose,WI,Pace,1995-04-29,Kingston,West Indies,1995,1,76,126,1,1,658,1221,21,582,1095,20,31.333333333333332,>30,WI,Home,Upto 2014
CEL Ambrose,WI,Pace,1995-06-08,Leeds,England,1995,2,100,224,4,1,698,1234,27,598,1010,23,25.85185185185185,<=30,ENG,Away,Upto 2014
CEL Ambrose,WI,Pace,1995-06-22,Lord's,England,1995,2,142,300,6,1,1000,2102,38,858,1802,32,26.31578947368421,<=30,ENG,Away,Upto 2014
CEL Ambrose,WI,Pace,1995-07-06,Birmingham,England,1995,1,26,47,2,1,511,986,26,485,939,24,19.653846153846153,<=30,ENG,Away,Upto 2014
CEL Ambrose,WI,Pace,1995-07-27,Manchester,England,1995,2,107,174,2,1,744,1375,26,637,1201,24,28.615384615384617,<=30,ENG,Away,Upto 2014
CEL Ambrose,WI,Pace,1995-08-24,The Oval,England,1995,2,131,366,7,1,1059,1992,20,928,1626,13,52.95,>30,ENG,Away,Upto 2014
CEL Ambrose,WI,Pace,1996-04-19,Bridgetown,West Indies,1996,2,74,186,1,1,918,1755,25,844,1569,24,36.72,>30,WI,Home,Upto 2014
CEL Ambrose,WI,Pace,1996-04-27,St John's,West Indies,1996,2,90,264,7,1,915,1920,26,825,1656,19,35.19230769230769,>30,WI,Home,Upto 2014
CEL Ambrose,WI,Pace,1996-11-22,Brisbane,Australia,1996,2,140,312,2,1,925,1944,28,785,1632,26,33.035714285714285,>30,AUS,Away,Upto 2014
CEL Ambrose,WI,Pace,1996-11-29,Sydney,Australia,1996,2,139,270,1,1,754,1620,23,615,1350,22,32.78260869565217,>30,AUS,Away,Upto 2014
CEL Ambrose,WI,Pace,1996-12-26,Melbourne,Australia,1996,2,72,221,9,1,553,1299,28,481,1078,19,19.75,<=30,AUS,Away,Upto 2014
CEL Ambrose,WI,Pace,1997-02-01,W.A.C.A,Australia,1997,2,93,162,7,1,699,1242,25,606,1080,18,27.96,<=30,AUS,Away,Upto 2014
CEL Ambrose,WI,Pace,1997-03-06,Kingston,West Indies,1997,2,42,186,0,1,612,1409,17,570,1223,17,36.0,>30,WI,Home,Upto 2014
CEL Ambrose,WI,Pace,1997-03-14,Port of Spain,West Indies,1997,1,87,250,5,1,527,1480,12,440,1230,7,43.916666666666664,>30,WI,Home,Upto 2014
CEL Ambrose,WI,Pace,1997-03-27,Bridgetown,West Indies,1997,2,110,264,5,1,738,1569,38,628,1305,33,19.42105263157895,<=30,WI,Home,Upto 2014
CEL Ambrose,WI,Pace,1997-04-04,St John's,West Indies,1997,1,26,54,0,1,268,546,4,242,492,4,67.0,>30,WI,Home,Upto 2014
CEL Ambrose,WI,Pace,1997-04-17,Georgetown,West Indies,1997,1,36,174,0,1,344,855,6,308,681,6,57.333333333333336,>30,WI,Home,Upto 2014
CEL Ambrose,WI,Pace,1997-06-13,St John's,West Indies,1997,2,78,133,8,1,500,775,20,422,642,12,25.0,<=30,WI,Home,Upto 2014
CEL Ambrose,WI,Pace,1997-06-20,Kingstown,West Indies,1997,2,85,144,3,1,630,1024,21,545,880,18,30.0,<=30,WI,Home,Upto 2014
CEL Ambrose,WI,Pace,1997-11-17,Peshawar,Pakistan,1997,1,76,150,0,1,444,1004,18,368,854,18,24.666666666666668,<=30,PAK,Away,Upto 2014
CEL Ambrose,WI,Pace,1997-11-29,Rawalpindi,Pakistan,1997,1,63,114,1,1,728,1434,26,665,1320,25,28.0,<=30,PAK,Away,Upto 2014
CEL Ambrose,WI,Pace,1998-01-29,Kingston,West Indies,1998,1,3,30,1,1,13,61,3,10,31,2,4.333333333333333,<=30,WI,Home,Upto 2014
CEL Ambrose,WI,Pace,1998-02-05,Port of Spain,West Indies,1998,2,75,275,8,1,715,1728,33,640,1453,25,21.666666666666668,<=30,WI,Home,Upto 2014
CEL Ambrose,WI,Pace,1998-02-13,Port of Spain,West Indies,1998,2,87,292,8,1,618,1619,31,531,1327,23,19.93548387096774,<=30,WI,Home,Upto 2014
CEL Ambrose,WI,Pace,1998-02-27,Georgetown,West Indies,1998,2,59,158,6,1,412,1052,21,353,894,15,19.61904761904762,<=30,WI,Home,Upto 2014
CEL Ambrose,WI,Pace,1998-03-12,Bridgetown,West Indies,1998,2,110,258,2,1,686,1395,17,576,1137,15,40.35294117647059,>30,WI,Home,Upto 2014
CEL Ambrose,WI,Pace,1998-03-20,St John's,West Indies,1998,2,94,222,5,1,587,1147,18,493,925,13,32.611111111111114,>30,WI,Home,Upto 2014
CEL Ambrose,WI,Pace,1998-11-26,Johannesburg,South Africa,1998,2,105,262,4,1,642,1519,31,537,1257,27,20.70967741935484,<=30,SA,Away,Upto 2014
CEL Ambrose,WI,Pace,1998-12-10,Gqeberha,South Africa,1998,2,79,216,8,1,639,1208,36,560,992,28,17.75,<=30,SA,Away,Upto 2014
CEL Ambrose,WI,Pace,1998-12-26,Durban,South Africa,1998,2,76,126,0,1,645,1347,28,569,1221,28,23.035714285714285,<=30,SA,Away,Upto 2014
CEL Ambrose,WI,Pace,1999-01-02,Cape Town,South Africa,1999,1,49,145,1,1,785,1771,27,736,1626,26,29.074074074074073,<=30,SA,Away,Upto 2014
CEL Ambrose,WI,Pace,1999-03-05,Port of Spain,West Indies,1999,2,60,270,5,1,566,1392,32,506,1122,27,17.6875,<=30,WI,Home,Upto 2014
CEL Ambrose,WI,Pace,1999-03-13,Kingston,West Indies,1999,2,61,186,2,1,494,1032,18,433,846,16,27.444444444444443,<=30,WI,Home,Upto 2014
CEL Ambrose,WI,Pace,1999-03-26,Bridgetown,West Indies,1999,2,153,309,4,1,815,1748,29,662,1439,25,28.103448275862068,<=30,WI,Home,Upto 2014
CEL Ambrose,WI,Pace,1999-04-03,St John's,West Indies,1999,2,149,341,8,1,621,1546,25,472,1205,17,24.84,<=30,WI,Home,Upto 2014
CEL Ambrose,WI,Pace,2000-03-16,Port of Spain,West Indies,2000,2,50,216,7,1,483,1518,30,433,1302,23,16.1,<=30,WI,Home,Upto 2014
CEL Ambrose,WI,Pace,2000-03-24,Kingston,West Indies,2000,2,50,246,1,1,544,1582,25,494,1336,24,21.76,<=30,WI,Home,Upto 2014
CEL Ambrose,WI,Pace,2000-05-05,Georgetown,West Indies,2000,1,43,153,4,1,344,903,13,301,750,9,26.46153846153846,<=30,WI,Home,Upto 2014
CEL Ambrose,WI,Pace,2000-05-18,Bridgetown,West Indies,2000,2,107,348,2,1,788,1618,23,681,1270,21,34.26086956521739,>30,WI,Home,Upto 2014
CEL Ambrose,WI,Pace,2000-05-25,St John's,West Indies,2000,2,69,210,5,1,652,1622,32,583,1412,27,20.375,<=30,WI,Home,Upto 2014
CEL Ambrose,WI,Pace,2000-06-15,Birmingham,England,2000,2,48,209,1,1,606,1373,25,558,1164,24,24.24,<=30,ENG,Away,Upto 2014
CEL Ambrose,WI,Pace,2000-06-29,Lord's,England,2000,2,52,218,5,1,573,1340,36,521,1122,31,15.916666666666666,<=30,ENG,Away,Upto 2014
CEL Ambrose,WI,Pace,2000-08-03,Manchester,England,2000,2,101,234,4,1,672,1537,23,571,1303,19,29.217391304347824,<=30,ENG,Away,Upto 2014
CEL Ambrose,WI,Pace,2000-08-17,Leeds,England,2000,1,42,108,4,1,405,817,24,363,709,20,16.875,<=30,ENG,Away,Upto 2014
CEL Ambrose,WI,Pace,2000-08-31,The Oval,England,2000,2,74,318,3,1,613,1636,30,539,1318,27,20.433333333333334,<=30,ENG,Away,Upto 2014
CEL Jones,WI,Spin,1930-02-21,Georgetown,West Indies,1930,1,5,60,0,1,461,1269,13,456,1209,13,35.46153846153846,>30,WI,Home,Upto 2014
CEL Jones,WI,Spin,1935-01-24,Port of Spain,West Indies,1935,1,2,12,0,1,418,1002,12,416,990,12,34.833333333333336,>30,WI,Home,Upto 2014
CEL Jones,WI,Spin,1935-02-14,Georgetown,West Indies,1935,1,4,30,0,1,339,996,16,335,966,16,21.1875,<=30,WI,Home,Upto 2014
CEL Stuart,WI,Pace,2000-12-26,Melbourne,Australia,2000,2,118,180,3,1,686,1407,27,568,1227,24,25.40740740740741,<=30,AUS,Away,Upto 2014
CEL Stuart,WI,Pace,2001-01-02,Sydney,Australia,2001,2,121,180,3,1,570,1068,13,449,888,10,43.84615384615385,>30,AUS,Away,Upto 2014
CEL Stuart,WI,Pace,2001-07-19,Bulawayo,Zimbabwe,2001,2,90,207,6,1,603,1276,18,513,1069,12,33.5,>30,ZIM,Away,Upto 2014
CEL Stuart,WI,Pace,2001-07-27,Harare,Zimbabwe,2001,2,132,270,6,1,709,1347,18,577,1077,12,39.388888888888886,>30,ZIM,Away,Upto 2014
CEL Stuart,WI,Pace,2001-11-13,Galle,Sri Lanka,2001,2,144,230,2,1,470,944,10,326,714,8,47.0,>30,SL,Away,Upto 2014
CEL Stuart,WI,Pace,2001-11-21,Kandy,Sri Lanka,2001,2,23,49,0,1,410,847,17,387,798,17,24.11764705882353,<=30,SL,Away,Upto 2014
CEW Silverwood,ENG,Pace,1996-12-18,Bulawayo,Zimbabwe,1996,2,71,150,4,1,665,1230,17,594,1080,13,39.11764705882353,>30,ZIM,Away,Upto 2014
CEW Silverwood,ENG,Pace,1999-12-09,Gqeberha,South Africa,1999,2,81,204,1,1,939,2119,25,858,1915,24,37.56,>30,SA,Away,Upto 2014
CEW Silverwood,ENG,Pace,1999-12-26,Durban,South Africa,1999,2,127,216,0,1,784,1865,22,657,1649,22,35.63636363636363,>30,SA,Away,Upto 2014
CEW Silverwood,ENG,Pace,2000-01-02,Cape Town,South Africa,2000,1,91,192,5,1,594,1440,24,503,1248,19,24.75,<=30,SA,Away,Upto 2014
CEW Silverwood,ENG,Pace,2000-01-14,Centurion,South Africa,2000,1,45,42,1,1,437,835,14,392,793,13,31.214285714285715,>30,SA,Away,Upto 2014
CEW Silverwood,ENG,Pace,2002-11-29,W.A.C.A,Australia,2002,1,29,24,0,1,590,1095,16,561,1071,16,36.875,>30,AUS,Away,Upto 2014
CF Root,ENG,Pace,1926-06-26,Lord's,England,1926,2,110,330,4,1,441,942,8,331,612,4,55.125,>30,ENG,Home,Upto 2014
CF Root,ENG,Pace,1926-07-24,Manchester,England,1926,1,84,312,4,1,147,468,4,63,156,0,36.75,>30,ENG,Home,Upto 2014
CFH Leslie,ENG,Pace,1882-12-30,Melbourne,Australia,1882,1,31,44,3,1,380,1024,17,349,980,14,22.352941176470587,<=30,AUS,Away,After 1965
CFH Leslie,ENG,Pace,1883-02-17,Sydney,Australia,1883,2,13,52,1,1,382,973,10,369,921,9,38.2,>30,AUS,Away,After 1965
CFW Allcott,NZ,Spin,1930-02-14,Auckland,New Zealand,1930,1,89,132,1,1,274,396,3,185,264,2,91.33333333333333,>30,NZ,Home,Upto 2014
CFW Allcott,NZ,Spin,1930-02-21,Auckland,New Zealand,1930,1,102,282,2,1,488,1141,10,386,859,8,48.8,>30,NZ,Home,Upto 2014
CFW Allcott,NZ,Spin,1931-06-27,Lord's,England,1931,2,60,162,1,1,753,1396,20,693,1234,19,37.65,>30,ENG,Away,Upto 2014
CFW Allcott,NZ,Spin,1931-07-29,The Oval,England,1931,1,108,264,1,1,591,1465,18,483,1201,17,32.833333333333336,>30,ENG,Away,Upto 2014
CFW Allcott,NZ,Spin,1931-08-15,Manchester,England,1931,1,75,162,0,1,146,258,2,71,96,2,73.0,>30,ENG,Away,Upto 2014
CFW Allcott,NZ,Spin,1932-03-04,Wellington,New Zealand,1932,2,107,204,1,1,627,1075,19,520,871,18,33.0,>30,NZ,Home,Upto 2014
CFW Hime,SA,Pace,1896-02-13,Gqeberha,South Africa,1896,2,31,55,1,1,376,688,29,345,633,28,12.96551724137931,<=30,SA,Home,After 1965
CG Borde,IND,Spin,1958-11-28,Brabourne,India,1958,2,60,156,0,1,512,1219,9,452,1063,9,56.888888888888886,>30,IND,Home,Upto 2014
CG Borde,IND,Spin,1958-12-12,Kanpur,India,1958,2,44,108,0,1,669,1431,13,625,1323,13,51.46153846153846,>30,IND,Home,Upto 2014
CG Borde,IND,Spin,1959-01-21,Chennai,India,1959,2,114,294,3,1,586,1441,19,472,1147,16,30.842105263157894,>30,IND,Home,Upto 2014
CG Borde,IND,Spin,1959-02-06,Delhi,India,1959,1,53,102,0,1,775,1794,11,722,1692,11,70.45454545454545,>30,IND,Home,Upto 2014
CG Borde,IND,Spin,1959-06-04,Nottingham,England,1959,1,63,120,1,1,354,956,10,291,836,9,35.4,>30,ENG,Away,Upto 2014
CG Borde,IND,Spin,1959-07-02,Leeds,England,1959,1,51,84,0,1,383,883,14,332,799,14,27.357142857142858,<=30,ENG,Away,Upto 2014
CG Borde,IND,Spin,1959-07-23,Manchester,England,1959,2,91,144,3,1,721,1722,21,630,1578,18,34.333333333333336,>30,ENG,Away,Upto 2014
CG Borde,IND,Spin,1959-12-12,Delhi,India,1959,1,49,90,0,1,348,919,18,299,829,18,19.333333333333332,<=30,IND,Home,Upto 2014
CG Borde,IND,Spin,1959-12-19,Kanpur,India,1959,1,61,90,1,1,496,1305,26,435,1215,25,19.076923076923077,<=30,IND,Home,Upto 2014
CG Borde,IND,Spin,1960-01-01,Brabourne,India,1960,1,78,78,2,1,351,876,9,273,798,7,39.0,>30,IND,Home,Upto 2014
CG Borde,IND,Spin,1960-01-13,Chennai,India,1960,1,55,96,1,1,351,1231,17,296,1135,16,20.647058823529413,<=30,IND,Home,Upto 2014
CG Borde,IND,Spin,1960-01-23,Eden Gardens,India,1960,2,68,157,3,1,425,1054,13,357,897,10,32.69230769230769,>30,IND,Home,Upto 2014
CG Borde,IND,Spin,1960-12-02,Brabourne,India,1960,2,51,132,0,1,412,1324,9,361,1192,9,45.77777777777778,>30,IND,Home,Upto 2014
CG Borde,IND,Spin,1960-12-16,Kanpur,India,1960,2,52,96,0,1,619,1984,16,567,1888,16,38.6875,>30,IND,Home,Upto 2014
CG Borde,IND,Spin,1960-12-30,Eden Gardens,India,1960,1,21,98,4,1,295,842,11,274,744,7,26.818181818181817,<=30,IND,Home,Upto 2014
CG Borde,IND,Spin,1961-01-13,Chennai,India,1961,1,105,198,1,1,664,1638,11,559,1440,10,60.36363636363637,>30,IND,Home,Upto 2014
CG Borde,IND,Spin,1961-02-08,Delhi,India,1961,2,32,72,0,1,386,1389,14,354,1317,14,27.571428571428573,<=30,IND,Home,Upto 2014
CG Borde,IND,Spin,1961-11-11,Brabourne,India,1961,2,114,222,3,1,727,1890,18,613,1668,15,40.388888888888886,>30,IND,Home,Upto 2014
CG Borde,IND,Spin,1961-12-01,Kanpur,India,1961,2,99,228,4,1,792,2016,16,693,1788,12,49.5,>30,IND,Home,Upto 2014
CG Borde,IND,Spin,1961-12-13,Delhi,India,1961,1,19,60,0,1,505,1242,8,486,1182,8,63.125,>30,IND,Home,Upto 2014
CG Borde,IND,Spin,1961-12-30,Eden Gardens,India,1961,2,111,282,4,1,632,1788,29,521,1506,25,21.79310344827586,<=30,IND,Home,Upto 2014
CG Borde,IND,Spin,1962-01-10,Chennai,India,1962,2,117,333,5,1,866,2320,33,749,1987,28,26.242424242424242,<=30,IND,Home,Upto 2014
CG Borde,IND,Spin,1962-02-16,Port of Spain,West Indies,1962,1,65,150,2,1,339,916,17,274,766,15,19.941176470588236,<=30,WI,Away,Upto 2014
CG Borde,IND,Spin,1962-03-07,Kingston,West Indies,1962,1,93,186,0,1,783,1924,16,690,1738,16,48.9375,>30,WI,Away,Upto 2014
CG Borde,IND,Spin,1962-03-23,Bridgetown,West Indies,1962,1,89,189,2,1,596,2431,22,507,2242,20,27.09090909090909,<=30,WI,Away,Upto 2014
CG Borde,IND,Spin,1962-04-04,Port of Spain,West Indies,1962,2,68,144,0,1,911,2452,24,843,2308,24,37.958333333333336,>30,WI,Away,Upto 2014
CG Borde,IND,Spin,1962-04-13,Kingston,West Indies,1962,2,98,198,2,1,527,1208,20,429,1010,18,26.35,<=30,WI,Away,Upto 2014
CG Borde,IND,Spin,1964-01-10,Chennai,India,1964,2,132,538,6,1,876,2493,27,744,1955,21,32.44444444444444,>30,IND,Home,Upto 2014
CG Borde,IND,Spin,1964-01-21,Brabourne,India,1964,2,92,426,0,1,560,2208,16,468,1782,16,35.0,>30,IND,Home,Upto 2014
CG Borde,IND,Spin,1964-01-29,Eden Gardens,India,1964,2,79,276,2,1,555,1794,16,476,1518,14,34.6875,>30,IND,Home,Upto 2014
CG Borde,IND,Spin,1964-02-08,Delhi,India,1964,1,42,72,0,1,1001,2631,20,959,2559,20,50.05,>30,IND,Home,Upto 2014
CG Borde,IND,Spin,1964-02-15,Kanpur,India,1964,1,73,138,1,1,987,2874,18,914,2736,17,54.833333333333336,>30,IND,Home,Upto 2014
CG Borde,IND,Spin,1964-10-02,Chennai,India,1964,2,23,54,0,1,735,1918,23,712,1864,23,31.956521739130434,>30,IND,Home,Upto 2014
CG Borde,IND,Spin,1964-10-10,Brabourne,India,1964,2,37,54,1,1,796,2173,26,759,2119,25,30.615384615384617,>30,IND,Home,Upto 2014
CG Borde,IND,Spin,1965-02-27,Chennai,India,1965,1,18,30,1,1,616,1705,17,598,1675,16,36.23529411764706,>30,IND,Home,Upto 2014
CG Butts,WI,Spin,1985-04-06,Georgetown,West Indies,1985,1,113,282,0,1,331,798,0,218,516,0,inf,>30,WI,Home,Upto 2014
CG Butts,WI,Spin,1986-11-20,Karachi,Pakistan,1986,2,95,360,6,1,383,1055,15,288,695,9,25.533333333333335,<=30,PAK,Away,Upto 2014
CG Butts,WI,Spin,1987-02-27,Auckland,New Zealand,1987,2,82,228,2,1,278,540,5,196,312,3,55.6,>30,NZ,Away,Upto 2014
CG Butts,WI,Spin,1987-12-11,Wankhede,India,1987,2,59,114,2,1,252,507,7,193,393,5,36.0,>30,IND,Away,Upto 2014
CG Butts,WI,Spin,1987-12-26,Eden Gardens,India,1987,1,122,300,0,1,615,1451,5,493,1151,5,123.0,>30,IND,Away,Upto 2014
CG Butts,WI,Spin,1988-01-11,Chennai,India,1988,2,124,270,0,1,536,1127,23,412,857,23,23.304347826086957,<=30,IND,Away,Upto 2014
CG Greenidge,WI,Pace,1975-12-26,Melbourne,Australia,1975,1,0,8,0,1,804,1499,27,804,1491,27,29.77777777777778,<=30,AUS,Away,Upto 2014
CG Greenidge,WI,Pace,1980-06-05,Nottingham,England,1980,1,4,18,0,1,897,2129,36,893,2111,36,24.916666666666668,<=30,ENG,Away,Upto 2014
CG Halse,SA,Pace,1964-01-10,Sydney,Australia,1964,2,94,208,2,1,926,1995,29,832,1787,27,31.93103448275862,>30,AUS,Away,Upto 2014
CG Halse,SA,Pace,1964-01-24,Adelaide,Australia,1964,2,104,211,3,1,1036,2074,26,932,1863,23,39.84615384615385,>30,AUS,Away,Upto 2014
CG Halse,SA,Pace,1964-02-07,Sydney,Australia,1964,2,62,168,1,1,694,1880,20,632,1712,19,34.7,>30,AUS,Away,Upto 2014
CG Macartney,AUS,Spin,1907-12-13,Sydney,Australia,1907,2,44,102,1,1,592,1308,17,548,1206,16,34.8235294117647,>30,AUS,Home,Upto 2014
CG Macartney,AUS,Spin,1908-01-01,Melbourne,Australia,1908,2,55,126,1,1,799,1914,21,744,1788,20,38.04761904761905,>30,AUS,Home,Upto 2014
CG Macartney,AUS,Spin,1908-01-10,Adelaide,Australia,1908,2,66,132,2,1,776,1611,17,710,1479,15,45.64705882352941,>30,AUS,Home,Upto 2014
CG Macartney,AUS,Spin,1908-02-07,Melbourne,Australia,1908,2,33,72,1,1,481,1034,24,448,962,23,20.041666666666668,<=30,AUS,Home,Upto 2014
CG Macartney,AUS,Spin,1908-02-21,Sydney,Australia,1908,2,68,181,5,1,812,1824,30,744,1643,25,27.066666666666666,<=30,AUS,Home,Upto 2014
CG Macartney,AUS,Spin,1909-05-27,Birmingham,England,1909,2,56,168,3,1,222,633,19,166,465,16,11.68421052631579,<=30,ENG,Away,Upto 2014
CG Macartney,AUS,Spin,1909-06-14,Lord's,England,1909,1,10,48,0,1,254,821,16,244,773,16,15.875,<=30,ENG,Away,Upto 2014
CG Macartney,AUS,Spin,1909-07-01,Leeds,England,1909,2,85,254,11,1,230,608,17,145,354,6,13.529411764705882,<=30,ENG,Away,Upto 2014
CG Macartney,AUS,Spin,1909-07-26,Manchester,England,1909,2,47,150,1,1,297,675,13,250,525,12,22.846153846153847,<=30,ENG,Away,Upto 2014
CG Macartney,AUS,Spin,1909-08-09,The Oval,England,1909,2,60,144,1,1,627,1104,11,567,960,10,57.0,>30,ENG,Away,Upto 2014
CG Macartney,AUS,Spin,1910-12-09,Sydney,Australia,1910,2,23,72,0,1,388,570,5,365,498,5,77.6,>30,AUS,Home,Upto 2014
CG Macartney,AUS,Spin,1910-12-31,Melbourne,Australia,1910,1,43,96,0,1,675,1063,21,632,967,21,32.142857142857146,>30,AUS,Home,Upto 2014
CG Macartney,AUS,Spin,1911-01-07,Adelaide,Australia,1911,2,77,234,1,1,814,1502,20,737,1268,19,40.7,>30,AUS,Home,Upto 2014
CG Macartney,AUS,Spin,1911-03-03,Sydney,Australia,1911,1,21,60,0,1,638,1067,19,617,1007,19,33.578947368421055,>30,AUS,Home,Upto 2014
CG Macartney,AUS,Spin,1912-02-23,Sydney,Australia,1912,2,54,114,1,1,473,1119,22,419,1005,21,21.5,<=30,AUS,Home,Upto 2014
CG Macartney,AUS,Spin,1912-06-24,Lord's,England,1912,1,13,42,0,1,243,530,6,230,488,6,40.5,>30,ENG,Away,Upto 2014
CG Macartney,AUS,Spin,1912-07-15,Lord's,England,1912,1,29,85,3,1,501,1026,19,472,941,16,26.36842105263158,<=30,ENG,Away,Upto 2014
CG Macartney,AUS,Spin,1912-08-05,Nottingham,England,1912,1,35,78,1,1,399,1038,15,364,960,14,26.6,<=30,ENG,Away,Upto 2014
CG Macartney,AUS,Spin,1912-08-19,The Oval,England,1912,2,65,246,2,1,252,792,19,187,546,17,13.263157894736842,<=30,ENG,Away,Upto 2014
CG Macartney,AUS,Spin,1920-12-17,Sydney,Australia,1920,1,7,18,0,1,783,1682,19,776,1664,19,41.21052631578947,>30,AUS,Home,Upto 2014
CG Macartney,AUS,Spin,1921-05-28,Nottingham,England,1921,1,10,30,0,1,235,583,9,225,553,9,26.11111111111111,<=30,ENG,Away,Upto 2014
CG Macartney,AUS,Spin,1921-07-23,Manchester,England,1921,1,20,48,0,1,239,952,12,219,904,12,19.916666666666668,<=30,ENG,Away,Upto 2014
CG Macartney,AUS,Spin,1921-11-05,Durban,South Africa,1921,1,13,66,1,1,340,702,10,327,636,9,34.0,>30,SA,Away,Upto 2014
CG Macartney,AUS,Spin,1921-11-26,Cape Town,South Africa,1921,2,91,291,6,1,400,850,17,309,559,11,23.529411764705884,<=30,SA,Away,Upto 2014
CG Macartney,AUS,Spin,1926-06-12,Nottingham,England,1926,1,14,50,0,1,14,56,0,0,6,0,inf,>30,ENG,Away,Upto 2014
CG Macartney,AUS,Spin,1926-06-26,Lord's,England,1926,1,90,198,1,1,556,1523,10,466,1325,9,55.6,>30,ENG,Away,Upto 2014
CG Macartney,AUS,Spin,1926-07-10,Leeds,England,1926,2,64,210,2,1,810,1836,19,746,1626,17,42.63157894736842,>30,ENG,Away,Upto 2014
CG Macartney,AUS,Spin,1926-07-24,Manchester,England,1926,1,7,48,1,1,479,1184,11,472,1136,10,43.54545454545455,>30,ENG,Away,Upto 2014
CG Macartney,AUS,Spin,1926-08-14,The Oval,England,1926,2,40,198,0,1,808,2213,28,768,2015,28,28.857142857142858,<=30,ENG,Away,Upto 2014
CG Rackemann,AUS,Pace,1982-11-26,Brisbane,Australia,1982,2,96,200,2,1,686,1313,27,590,1113,25,25.40740740740741,<=30,AUS,Home,Upto 2014
CG Rackemann,AUS,Pace,1983-11-11,W.A.C.A,Australia,1983,2,118,204,11,1,628,1218,24,510,1014,13,26.166666666666668,<=30,AUS,Home,Upto 2014
CG Rackemann,AUS,Pace,1983-11-25,Brisbane,Australia,1983,2,59,108,5,1,428,757,16,369,649,11,26.75,<=30,AUS,Home,Upto 2014
CG Rackemann,AUS,Pace,1984-04-07,St John's,West Indies,1984,1,161,256,5,1,745,1490,28,584,1234,23,26.607142857142858,<=30,WI,Away,Upto 2014
CG Rackemann,AUS,Pace,1984-11-09,W.A.C.A,Australia,1984,1,106,168,0,1,700,1337,30,594,1169,30,23.333333333333332,<=30,AUS,Home,Upto 2014
CG Rackemann,AUS,Pace,1989-11-24,W.A.C.A,Australia,1989,2,62,306,3,1,939,2255,25,877,1949,22,37.56,>30,AUS,Home,Upto 2014
CG Rackemann,AUS,Pace,1989-12-08,Brisbane,Australia,1989,1,88,183,3,1,901,1884,23,813,1701,20,39.17391304347826,>30,AUS,Home,Upto 2014
CG Rackemann,AUS,Pace,1990-01-12,Melbourne,Australia,1990,2,99,359,3,1,791,2097,34,692,1738,31,23.264705882352942,<=30,AUS,Home,Upto 2014
CG Rackemann,AUS,Pace,1990-01-19,Adelaide,Australia,1990,2,125,348,5,1,759,1677,27,634,1329,22,28.11111111111111,<=30,AUS,Home,Upto 2014
CG Rackemann,AUS,Pace,1990-02-03,Sydney,Australia,1990,1,33,132,2,1,253,749,11,220,617,9,23.0,<=30,AUS,Home,Upto 2014
CG Rackemann,AUS,Pace,1990-03-15,Wellington,New Zealand,1990,2,81,282,0,1,504,1412,21,423,1130,21,24.0,<=30,NZ,Away,Upto 2014
CG Rackemann,AUS,Pace,1991-01-04,Sydney,Australia,1991,2,109,173,0,1,621,1201,14,512,1028,14,44.357142857142854,>30,AUS,Home,Upto 2014
CH Gayle,WI,Spin,2000-03-16,Port of Spain,West Indies,2000,1,25,90,3,1,105,340,7,80,250,4,15.0,<=30,WI,Home,Upto 2014
CH Gayle,WI,Spin,2000-03-24,Kingston,West Indies,2000,2,55,96,1,1,234,532,3,179,436,2,78.0,>30,WI,Home,Upto 2014
CH Gayle,WI,Spin,2000-05-05,Georgetown,West Indies,2000,1,16,54,0,1,162,360,3,146,306,3,54.0,>30,WI,Home,Upto 2014
CH Gayle,WI,Spin,2000-06-15,Birmingham,England,2000,1,4,18,0,1,62,210,4,58,192,4,15.5,<=30,ENG,Away,Upto 2014
CH Gayle,WI,Spin,2001-03-29,Bridgetown,West Indies,2001,1,3,6,0,1,341,1000,14,338,994,14,24.357142857142858,<=30,WI,Home,Upto 2014
CH Gayle,WI,Spin,2001-11-21,Kandy,Sri Lanka,2001,1,4,3,0,1,458,1038,19,454,1035,19,24.105263157894736,<=30,SL,Away,Upto 2014
CH Gayle,WI,Spin,2001-11-29,Colombo (SSC),Sri Lanka,2001,1,28,60,0,1,542,1074,5,514,1014,5,108.4,>30,SL,Away,Upto 2014
CH Gayle,WI,Spin,2002-01-31,Sharjah,UAE,2002,1,27,47,3,1,403,857,9,376,810,6,44.77777777777778,>30,UAE,Away,Upto 2014
CH Gayle,WI,Spin,2002-02-07,Sharjah,UAE,2002,1,12,6,0,1,492,929,10,480,923,10,49.2,>30,UAE,Away,Upto 2014
CH Gayle,WI,Spin,2002-04-11,Georgetown,West Indies,2002,1,7,24,0,1,369,751,4,362,727,4,92.25,>30,WI,Home,Upto 2014
CH Gayle,WI,Spin,2002-05-02,Bridgetown,West Indies,2002,1,14,18,0,1,125,277,5,111,259,5,25.0,<=30,WI,Home,Upto 2014
CH Gayle,WI,Spin,2002-05-10,St John's,West Indies,2002,1,5,30,0,1,261,672,7,256,642,7,37.285714285714285,>30,WI,Home,Upto 2014
CH Gayle,WI,Spin,2002-05-18,Kingston,West Indies,2002,1,7,24,1,1,212,410,9,205,386,8,23.555555555555557,<=30,WI,Home,Upto 2014
CH Gayle,WI,Spin,2002-06-21,Bridgetown,West Indies,2002,1,12,60,0,1,133,433,9,121,373,9,14.777777777777779,<=30,WI,Home,Upto 2014
CH Gayle,WI,Spin,2002-06-28,St George's,West Indies,2002,2,12,54,0,1,457,1176,9,445,1122,9,50.77777777777778,>30,WI,Home,Upto 2014
CH Gayle,WI,Spin,2002-10-09,Wankhede,India,2002,1,3,12,0,1,416,1045,19,413,1033,19,21.894736842105264,<=30,IND,Away,Upto 2014
CH Gayle,WI,Spin,2002-10-30,Eden Gardens,India,2002,2,76,150,0,1,592,1269,12,516,1119,12,49.333333333333336,>30,IND,Away,Upto 2014
CH Gayle,WI,Spin,2003-05-01,Bridgetown,West Indies,2003,2,81,189,0,1,500,956,13,419,767,13,38.46153846153846,>30,WI,Home,Upto 2014
CH Gayle,WI,Spin,2003-05-09,St John's,West Indies,2003,1,30,78,1,1,401,650,6,371,572,5,66.83333333333333,>30,WI,Home,Upto 2014
CH Gayle,WI,Spin,2003-06-20,Gros Islet,West Indies,2003,1,22,56,2,1,398,848,9,376,792,7,44.22222222222222,>30,WI,Home,Upto 2014
CH Gayle,WI,Spin,2003-06-27,Kingston,West Indies,2003,1,1,24,0,1,148,370,7,147,346,7,21.142857142857142,<=30,WI,Home,Upto 2014
CH Gayle,WI,Spin,2003-11-04,Harare,Zimbabwe,2003,1,38,116,0,1,313,784,11,275,668,11,28.454545454545453,<=30,ZIM,Away,Upto 2014
CH Gayle,WI,Spin,2003-11-12,Bulawayo,Zimbabwe,2003,1,23,36,0,1,453,841,14,430,805,14,32.357142857142854,>30,ZIM,Away,Upto 2014
CH Gayle,WI,Spin,2004-01-02,Cape Town,South Africa,2004,2,73,114,0,1,458,726,4,385,612,4,114.5,>30,SA,Away,Upto 2014
CH Gayle,WI,Spin,2004-01-16,Centurion,South Africa,2004,1,39,42,0,1,187,304,2,148,262,2,93.5,>30,SA,Away,Upto 2014
CH Gayle,WI,Spin,2004-03-11,Kingston,West Indies,2004,1,6,6,0,1,110,185,4,104,179,4,27.5,<=30,WI,Home,Upto 2014
CH Gayle,WI,Spin,2004-03-19,Port of Spain,West Indies,2004,1,20,101,2,1,72,167,2,52,66,0,36.0,>30,WI,Home,Upto 2014
CH Gayle,WI,Spin,2004-04-01,Bridgetown,West Indies,2004,1,32,78,0,1,60,156,0,28,78,0,inf,>30,WI,Home,Upto 2014
CH Gayle,WI,Spin,2004-04-10,St John's,West Indies,2004,2,40,108,0,1,477,993,7,437,885,7,68.14285714285714,>30,WI,Home,Upto 2014
CH Gayle,WI,Spin,2004-05-28,Gros Islet,West Indies,2004,2,84,260,2,1,308,824,12,224,564,10,25.666666666666668,<=30,WI,Home,Upto 2014
CH Gayle,WI,Spin,2004-06-04,Kingston,West Indies,2004,1,9,12,0,1,393,750,8,384,738,8,49.125,>30,WI,Home,Upto 2014
CH Gayle,WI,Spin,2004-07-22,Lord's,England,2004,1,45,54,1,1,526,874,12,481,820,11,43.833333333333336,>30,ENG,Away,Upto 2014
CH Gayle,WI,Spin,2004-07-29,Birmingham,England,2004,1,34,91,5,1,350,688,15,316,597,10,23.333333333333332,<=30,ENG,Away,Upto 2014
CH Gayle,WI,Spin,2004-08-12,Manchester,England,2004,2,39,76,1,1,277,526,4,238,450,3,69.25,>30,ENG,Away,Upto 2014
CH Gayle,WI,Spin,2004-08-19,The Oval,England,2004,1,18,44,1,1,104,218,2,86,174,1,52.0,>30,ENG,Away,Upto 2014
CH Gayle,WI,Spin,2005-04-08,Port of Spain,West Indies,2005,2,66,293,4,1,187,617,7,121,324,3,26.714285714285715,<=30,WI,Home,Upto 2014
CH Gayle,WI,Spin,2005-04-21,Bridgetown,West Indies,2005,1,85,162,3,1,288,498,4,203,336,1,72.0,>30,WI,Home,Upto 2014
CH Gayle,WI,Spin,2005-04-29,St John's,West Indies,2005,2,68,192,1,1,410,840,3,342,648,2,136.66666666666666,>30,WI,Home,Upto 2014
CH Gayle,WI,Spin,2005-05-26,Bridgetown,West Indies,2005,1,91,111,5,1,401,552,13,310,441,8,30.846153846153847,>30,WI,Home,Upto 2014
CH Gayle,WI,Spin,2005-06-03,Kingston,West Indies,2005,2,120,210,2,1,374,708,11,254,498,9,34.0,>30,WI,Home,Upto 2014
CH Gayle,WI,Spin,2005-11-03,Brisbane,Australia,2005,2,123,282,2,1,248,570,7,125,288,5,35.42857142857143,>30,AUS,Away,Upto 2014
CH Gayle,WI,Spin,2005-11-17,Hobart,Australia,2005,2,33,78,1,1,310,697,10,277,619,9,31.0,>30,AUS,Away,Upto 2014
CH Gayle,WI,Spin,2006-03-09,Auckland,New Zealand,2006,2,81,211,6,1,180,465,11,99,254,5,16.363636363636363,<=30,NZ,Away,Upto 2014
CH Gayle,WI,Spin,2006-03-17,Wellington,New Zealand,2006,1,46,108,0,1,176,438,2,130,330,2,88.0,>30,NZ,Away,Upto 2014
CH Gayle,WI,Spin,2006-06-02,St John's,West Indies,2006,2,72,156,1,1,672,1196,20,600,1040,19,33.6,>30,WI,Home,Upto 2014
CH Gayle,WI,Spin,2006-06-10,Gros Islet,West Indies,2006,1,52,126,1,1,473,1177,17,421,1051,16,27.823529411764707,<=30,WI,Home,Upto 2014
CH Gayle,WI,Spin,2006-06-22,Basseterre,West Indies,2006,2,34,96,0,1,722,1248,13,688,1152,13,55.53846153846154,>30,WI,Home,Upto 2014
CH Gayle,WI,Spin,2006-06-30,Kingston,West Indies,2006,1,10,12,0,1,275,517,14,265,505,14,19.642857142857142,<=30,WI,Home,Upto 2014
CH Gayle,WI,Spin,2006-11-11,Lahore,Pakistan,2006,1,24,60,2,1,296,600,9,272,540,7,32.888888888888886,>30,PAK,Away,Upto 2014
CH Gayle,WI,Spin,2006-11-19,Multan,Pakistan,2006,2,137,306,1,1,610,1072,9,473,766,8,67.77777777777777,>30,PAK,Away,Upto 2014
CH Gayle,WI,Spin,2006-11-27,Karachi,Pakistan,2006,2,65,186,1,1,303,725,10,238,539,9,30.3,>30,PAK,Away,Upto 2014
CH Gayle,WI,Spin,2007-05-17,Lord's,England,2007,2,114,185,3,1,293,462,9,179,277,6,32.55555555555556,>30,ENG,Away,Upto 2014
CH Gayle,WI,Spin,2007-05-25,Leeds,England,2007,1,78,84,1,1,99,126,2,21,42,1,49.5,>30,ENG,Away,Upto 2014
CH Gayle,WI,Spin,2007-06-07,Manchester,England,2007,1,57,96,1,1,304,603,11,247,507,10,27.636363636363637,<=30,ENG,Away,Upto 2014
CH Gayle,WI,Spin,2007-06-15,Chester-le-Street,England,2007,2,36,76,1,1,166,317,7,130,241,6,23.714285714285715,<=30,ENG,Away,Upto 2014
CH Gayle,WI,Spin,2008-03-22,Providence,West Indies,2008,2,120,240,3,1,634,1374,12,514,1134,9,52.833333333333336,>30,WI,Home,Upto 2014
CH Gayle,WI,Spin,2008-04-03,Port of Spain,West Indies,2008,2,30,96,1,1,206,431,7,176,335,6,29.428571428571427,<=30,WI,Home,Upto 2014
CH Gayle,WI,Spin,2008-06-12,Bridgetown,West Indies,2008,2,51,138,0,1,440,864,10,389,726,10,44.0,>30,WI,Home,Upto 2014
CH Gayle,WI,Spin,2008-12-11,Dunedin,New Zealand,2008,1,42,126,3,1,98,276,9,56,150,6,10.88888888888889,<=30,NZ,Away,Upto 2014
CH Gayle,WI,Spin,2008-12-19,Napier,New Zealand,2008,2,56,138,0,1,472,1254,11,416,1116,11,42.90909090909091,>30,NZ,Away,Upto 2014
CH Gayle,WI,Spin,2009-02-04,Kingston,West Indies,2009,2,41,156,1,1,286,814,10,245,658,9,28.6,<=30,WI,Home,Upto 2014
CH Gayle,WI,Spin,2009-02-15,St John's,West Indies,2009,1,41,78,1,1,563,1022,15,522,944,14,37.53333333333333,>30,WI,Home,Upto 2014
CH Gayle,WI,Spin,2009-02-26,Bridgetown,West Indies,2009,2,74,192,1,1,611,1066,8,537,874,7,76.375,>30,WI,Home,Upto 2014
CH Gayle,WI,Spin,2009-03-06,Port of Spain,West Indies,2009,2,96,174,1,1,578,1262,14,482,1088,13,41.285714285714285,>30,WI,Home,Upto 2014
CH Gayle,WI,Spin,2009-05-06,Lord's,England,2009,1,11,18,0,1,150,312,8,139,294,8,18.75,<=30,ENG,Away,Upto 2014
CH Gayle,WI,Spin,2009-05-14,Chester-le-Street,England,2009,1,31,84,1,1,248,450,4,217,366,3,62.0,>30,ENG,Away,Upto 2014
CH Gayle,WI,Spin,2009-11-26,Brisbane,Australia,2009,1,36,54,0,1,179,378,7,143,324,7,25.571428571428573,<=30,AUS,Away,Upto 2014
CH Gayle,WI,Spin,2009-12-04,Adelaide,Australia,2009,2,23,72,0,1,454,1020,7,431,948,7,64.85714285714286,>30,AUS,Away,Upto 2014
CH Gayle,WI,Spin,2010-06-10,Port of Spain,West Indies,2010,1,2,6,1,1,480,983,16,478,977,15,30.0,<=30,WI,Home,Upto 2014
CH Gayle,WI,Spin,2010-06-26,Bridgetown,West Indies,2010,1,2,12,0,1,347,891,14,345,879,14,24.785714285714285,<=30,WI,Home,Upto 2014
CH Gayle,WI,Spin,2010-11-15,Galle,Sri Lanka,2010,1,3,6,0,1,572,1048,14,569,1042,14,40.857142857142854,>30,SL,Away,Upto 2014
CH Gayle,WI,Spin,2012-11-13,Mirpur,Bangladesh,2012,1,14,18,0,1,992,1679,19,978,1661,19,52.21052631578947,>30,BAN,Away,Upto 2014
CH Gayle,WI,Spin,2012-11-21,Khulna,Bangladesh,2012,1,15,24,0,1,763,1327,11,748,1303,11,69.36363636363636,>30,BAN,Away,Upto 2014
CH Gayle,WI,Spin,2014-06-08,Kingston,West Indies,2014,1,17,30,0,1,767,1332,22,750,1302,22,34.86363636363637,>30,WI,Home,After 1965
CH Gayle,WI,Spin,2014-06-16,Port of Spain,West Indies,2014,1,29,78,0,1,468,1009,10,439,931,10,46.8,>30,WI,Home,After 1965
CH Gayle,WI,Spin,2014-09-05,Kingstown,West Indies,2014,1,50,102,1,1,510,1180,16,460,1078,15,31.875,>30,WI,Home,After 1965
CH Lloyd,WI,Pace,1966-12-31,Eden Gardens,India,1966,2,27,108,2,1,232,474,6,205,366,4,38.666666666666664,>30,IND,Away,Upto 2014
CH Lloyd,WI,Pace,1967-01-13,Chennai,India,1967,2,63,150,0,1,515,900,14,452,750,14,36.785714285714285,>30,IND,Away,Upto 2014
CH Lloyd,WI,Pace,1968-01-19,Port of Spain,West Indies,1968,1,17,48,0,1,435,1007,15,418,959,15,29.0,<=30,WI,Home,Upto 2014
CH Lloyd,WI,Pace,1968-02-29,Bridgetown,West Indies,1968,1,10,18,0,1,595,1213,17,585,1195,17,35.0,>30,WI,Home,Upto 2014
CH Lloyd,WI,Pace,1968-03-14,Port of Spain,West Indies,1968,1,7,24,0,1,441,768,6,434,744,6,73.5,>30,WI,Home,Upto 2014
CH Lloyd,WI,Pace,1968-12-06,Brisbane,Australia,1968,2,24,80,2,1,316,792,11,292,712,9,28.727272727272727,<=30,AUS,Away,Upto 2014
CH Lloyd,WI,Pace,1969-01-03,Sydney,Australia,1969,1,8,16,0,1,677,1377,20,669,1361,20,33.85,>30,AUS,Away,Upto 2014
CH Lloyd,WI,Pace,1969-01-24,Adelaide,Australia,1969,1,26,48,0,1,674,1285,19,648,1237,19,35.473684210526315,>30,AUS,Away,Upto 2014
CH Lloyd,WI,Pace,1969-02-14,Sydney,Australia,1969,2,20,32,0,1,820,1525,21,800,1493,21,39.04761904761905,>30,AUS,Away,Upto 2014
CH Lloyd,WI,Pace,1971-02-18,Kingston,West Indies,1971,1,7,24,0,1,178,430,6,171,406,6,29.666666666666668,<=30,WI,Home,Upto 2014
CH Lloyd,WI,Pace,1971-03-06,Port of Spain,West Indies,1971,1,6,6,0,1,181,456,3,175,450,3,60.333333333333336,>30,WI,Home,Upto 2014
CH Lloyd,WI,Pace,1971-03-19,Georgetown,West Indies,1971,1,20,18,0,1,313,504,3,293,486,3,104.33333333333333,>30,WI,Home,Upto 2014
CH Lloyd,WI,Pace,1971-04-01,Bridgetown,West Indies,1971,1,13,24,0,1,478,1042,14,465,1018,14,34.142857142857146,>30,WI,Home,Upto 2014
CH Lloyd,WI,Pace,1972-04-06,Georgetown,West Indies,1972,1,74,216,0,1,457,1170,6,383,954,6,76.16666666666667,>30,WI,Home,Upto 2014
CH Lloyd,WI,Pace,1972-04-20,Port of Spain,West Indies,1972,1,10,18,1,1,397,954,17,387,936,16,23.352941176470587,<=30,WI,Home,Upto 2014
CH Lloyd,WI,Pace,1973-03-23,Port of Spain,West Indies,1973,2,24,60,0,1,317,912,10,293,852,10,31.7,>30,WI,Home,Upto 2014
CH Lloyd,WI,Pace,1973-04-06,Georgetown,West Indies,1973,2,30,72,0,1,667,1551,23,637,1479,23,29.0,<=30,WI,Home,Upto 2014
CH Lloyd,WI,Pace,1973-04-21,Port of Spain,West Indies,1973,2,35,90,0,1,343,870,9,308,780,9,38.111111111111114,>30,WI,Home,Upto 2014
CH Lloyd,WI,Pace,1973-08-09,Birmingham,England,1973,2,31,84,2,1,555,1416,18,524,1332,16,30.833333333333332,>30,ENG,Away,Upto 2014
CH Lloyd,WI,Pace,1974-02-02,Port of Spain,West Indies,1974,1,3,18,0,1,308,634,10,305,616,10,30.8,>30,WI,Home,Upto 2014
CH Lloyd,WI,Pace,1974-02-16,Kingston,West Indies,1974,2,7,42,0,1,383,780,10,376,738,10,38.3,>30,WI,Home,Upto 2014
CH Lloyd,WI,Pace,1974-03-06,Bridgetown,West Indies,1974,2,22,96,2,1,627,1356,14,605,1260,12,44.785714285714285,>30,WI,Home,Upto 2014
CH Lloyd,WI,Pace,1974-03-22,Georgetown,West Indies,1974,1,27,114,0,1,242,634,5,215,520,5,48.4,>30,WI,Home,Upto 2014
CH Lloyd,WI,Pace,1974-03-30,Port of Spain,West Indies,1974,2,12,66,1,1,172,537,8,160,471,7,21.5,<=30,WI,Home,Upto 2014
CH Lloyd,WI,Pace,1975-11-28,Brisbane,Australia,1975,1,22,48,0,1,663,1224,17,641,1176,17,39.0,>30,AUS,Away,Upto 2014
CH Lloyd,WI,Pace,1976-01-31,Melbourne,Australia,1976,2,34,88,0,1,775,1378,27,741,1290,27,28.703703703703702,<=30,AUS,Away,Upto 2014
CH Lloyd,WI,Pace,1976-03-24,Port of Spain,West Indies,1976,1,10,18,0,1,260,654,5,250,636,5,52.0,>30,WI,Home,Upto 2014
CH Lloyd,WI,Pace,1976-04-07,Port of Spain,West Indies,1976,2,23,42,0,1,338,682,7,315,640,7,48.285714285714285,>30,WI,Home,Upto 2014
CH Lloyd,WI,Pace,1976-06-03,Nottingham,England,1976,1,7,18,0,1,773,1761,21,766,1743,21,36.80952380952381,>30,ENG,Away,Upto 2014
CH Lloyd,WI,Pace,1976-07-22,Leeds,England,1976,1,1,12,0,1,969,1786,39,968,1774,39,24.846153846153847,<=30,ENG,Away,Upto 2014
CH Lloyd,WI,Pace,1976-08-12,The Oval,England,1976,1,1,12,0,1,768,1323,20,767,1311,20,38.4,>30,ENG,Away,Upto 2014
CH Lloyd,WI,Pace,1980-07-10,Manchester,England,1980,1,1,6,0,1,678,1412,23,677,1406,23,29.47826086956522,<=30,ENG,Away,Upto 2014
CH Mills,SA,Pace,1892-03-19,Cape Town,South Africa,1892,1,83,140,2,1,379,805,14,296,665,12,27.071428571428573,<=30,SA,Home,After 1965
CH Morris,SA,Pace,2016-01-02,Cape Town,South Africa,2016,2,174,240,2,1,994,1661,14,820,1421,12,71.0,>30,SA,Home,After 1965
CH Morris,SA,Pace,2016-01-14,Johannesburg,South Africa,2016,2,79,126,2,1,692,1271,29,613,1145,27,23.862068965517242,<=30,SA,Home,After 1965
CH Morris,SA,Pace,2017-07-14,Nottingham,England,2017,2,45,89,5,1,739,1395,28,694,1306,23,26.392857142857142,<=30,ENG,Away,After 1965
CH Morris,SA,Pace,2017-07-27,The Oval,England,2017,2,161,168,3,1,850,1584,29,689,1416,26,29.310344827586206,<=30,ENG,Away,After 1965
CH Palmer,ENG,Spin,1954-02-06,Bridgetown,West Indies,1954,1,15,30,0,1,772,2250,20,757,2220,20,38.6,>30,WI,Away,Upto 2014
CH Parkin,ENG,Spin,1920-12-17,Sydney,Australia,1920,2,160,374,4,1,783,1682,19,623,1308,15,41.21052631578947,>30,AUS,Away,Upto 2014
CH Parkin,ENG,Spin,1920-12-31,Melbourne,Australia,1920,1,116,162,2,1,436,860,13,320,698,11,33.53846153846154,>30,AUS,Away,Upto 2014
CH Parkin,ENG,Spin,1921-01-14,Adelaide,Australia,1921,2,169,360,7,1,920,1706,23,751,1346,16,40.0,>30,AUS,Away,Upto 2014
CH Parkin,ENG,Spin,1921-02-11,Melbourne,Australia,1921,2,110,204,2,1,636,1301,23,526,1097,21,27.652173913043477,<=30,AUS,Away,Upto 2014
CH Parkin,ENG,Spin,1921-02-25,Sydney,Australia,1921,2,115,168,1,1,605,1063,17,490,895,16,35.588235294117645,>30,AUS,Away,Upto 2014
CH Parkin,ENG,Spin,1921-06-11,Lord's,England,1921,2,103,174,3,1,448,876,15,345,702,12,29.866666666666667,<=30,ENG,Home,Upto 2014
CH Parkin,ENG,Spin,1921-07-02,Leeds,England,1921,2,197,241,5,1,678,1167,22,481,926,17,30.818181818181817,>30,ENG,Home,Upto 2014
CH Parkin,ENG,Spin,1921-07-23,Manchester,England,1921,1,38,178,5,1,239,952,12,201,774,7,19.916666666666668,<=30,ENG,Home,Upto 2014
CH Parkin,ENG,Spin,1921-08-13,The Oval,England,1921,1,82,138,3,1,509,810,8,427,672,5,63.625,>30,ENG,Home,Upto 2014
CH Parkin,ENG,Spin,1924-06-14,Birmingham,England,1924,1,38,96,0,1,396,946,10,358,850,10,39.6,>30,ENG,Home,Upto 2014
CH Vintcent,SA,Pace,1889-03-12,Gqeberha,South Africa,1889,2,55,81,1,1,261,668,19,206,587,18,13.736842105263158,<=30,SA,Home,After 1965
CH Vintcent,SA,Pace,1889-03-25,Cape Town,South Africa,1889,1,88,168,3,1,290,589,13,202,421,10,22.307692307692307,<=30,SA,Home,After 1965
CH Vintcent,SA,Pace,1892-03-19,Cape Town,South Africa,1892,1,50,120,0,1,379,805,14,329,685,14,27.071428571428573,<=30,SA,Home,After 1965
CIJ Smith,ENG,Pace,1935-01-08,Bridgetown,West Indies,1935,2,24,90,5,1,205,438,22,181,348,17,9.318181818181818,<=30,WI,Away,Upto 2014
CIJ Smith,ENG,Pace,1935-01-24,Port of Spain,West Indies,1935,2,173,336,6,1,486,1307,22,313,971,16,22.09090909090909,<=30,WI,Away,Upto 2014
CIJ Smith,ENG,Pace,1935-02-14,Georgetown,West Indies,1935,2,50,156,0,1,273,866,12,223,710,12,22.75,<=30,WI,Away,Upto 2014
CIJ Smith,ENG,Pace,1935-03-14,Kingston,West Indies,1935,1,83,132,0,1,412,902,15,329,770,15,27.466666666666665,<=30,WI,Away,Upto 2014
CIJ Smith,ENG,Pace,1937-07-24,Manchester,England,1937,2,63,216,4,1,359,941,19,296,725,15,18.894736842105264,<=30,ENG,Home,Upto 2014
CJ Adams,ENG,Spin,1999-12-26,Durban,South Africa,1999,1,42,78,1,1,272,696,4,230,618,3,68.0,>30,SA,Away,Upto 2014
CJ Adams,ENG,Spin,2000-01-02,Cape Town,South Africa,2000,1,17,42,0,1,194,523,5,177,481,5,38.8,>30,SA,Away,Upto 2014
CJ Anderson,NZ,Pace,2013-10-09,Chattogram,Bangladesh,2013,2,34,114,2,1,333,720,8,299,606,6,41.625,>30,BAN,Away,Upto 2014
CJ Anderson,NZ,Pace,2013-10-21,Mirpur,Bangladesh,2013,2,32,72,1,1,508,858,10,476,786,9,50.8,>30,BAN,Away,Upto 2014
CJ Anderson,NZ,Pace,2013-12-03,Dunedin,New Zealand,2013,1,29,84,1,1,879,1520,20,850,1436,19,43.95,>30,NZ,Home,Upto 2014
CJ Anderson,NZ,Pace,2013-12-11,Wellington,New Zealand,2013,2,49,108,3,1,603,1007,28,554,899,25,21.535714285714285,<=30,NZ,Home,Upto 2014
CJ Anderson,NZ,Pace,2013-12-19,Hamilton,New Zealand,2013,2,69,150,4,1,543,1073,23,474,923,19,23.608695652173914,<=30,NZ,Home,Upto 2014
CJ Anderson,NZ,Pace,2014-02-06,Auckland,New Zealand,2014,2,51,72,0,1,873,1527,37,822,1455,37,23.594594594594593,<=30,NZ,Home,After 1965
CJ Anderson,NZ,Pace,2014-02-14,Wellington,New Zealand,2014,2,72,120,0,1,1271,2109,30,1199,1989,30,42.36666666666667,>30,NZ,Home,After 1965
CJ Anderson,NZ,Pace,2014-11-09,Abu Dhabi,UAE,2014,2,79,144,2,1,447,927,10,368,783,8,44.7,>30,UAE,Away,After 1965
CJ Anderson,NZ,Pace,2014-11-17,Dubai (DICS),UAE,2014,2,30,60,0,1,426,1086,12,396,1026,12,35.5,>30,UAE,Away,After 1965
CJ Anderson,NZ,Pace,2014-11-26,Sharjah,UAE,2014,1,28,72,0,1,429,804,9,401,732,9,47.666666666666664,>30,UAE,Away,After 1965
CJ Anderson,NZ,Pace,2015-05-21,Lord's,England,2015,2,27,48,0,1,1185,2044,33,1158,1996,33,35.90909090909091,>30,ENG,Away,After 1965
CJ Anderson,NZ,Pace,2016-02-12,Wellington,New Zealand,2016,1,79,108,2,1,769,1383,21,690,1275,19,36.61904761904762,>30,NZ,Home,After 1965
CJ Anderson,NZ,Pace,2016-02-20,Christchurch,New Zealand,2016,2,80,150,1,1,1247,2076,29,1167,1926,28,43.0,>30,NZ,Home,After 1965
CJ Barnett,ENG,Pace,1933-12-15,Mumbai,India,1933,1,1,12,0,1,534,1100,19,533,1088,19,28.105263157894736,<=30,IND,Away,Upto 2014
CJ Barnett,ENG,Pace,1934-01-05,Eden Gardens,India,1934,1,7,12,0,1,492,1256,17,485,1244,17,28.941176470588236,<=30,IND,Away,Upto 2014
CJ Barnett,ENG,Pace,1934-02-10,Chennai,India,1934,1,1,6,0,1,459,1077,17,458,1071,17,27.0,<=30,IND,Away,Upto 2014
CJ Barnett,ENG,Pace,1937-01-29,Adelaide,Australia,1937,1,15,40,0,1,675,1448,20,660,1408,20,33.75,>30,AUS,Away,Upto 2014
CJ Barnett,ENG,Pace,1938-06-10,Nottingham,England,1938,1,10,6,0,1,464,954,6,454,948,6,77.33333333333333,>30,ENG,Home,Upto 2014
CJ Barnett,ENG,Pace,1947-07-05,Manchester,England,1947,2,23,78,0,1,744,1735,22,721,1657,22,33.81818181818182,>30,ENG,Home,Upto 2014
CJ Barnett,ENG,Pace,1948-06-10,Nottingham,England,1948,1,36,102,0,1,600,1427,17,564,1325,17,35.294117647058826,>30,ENG,Home,Upto 2014
CJ Chibhabha,ZIM,Pace,2016-07-28,Bulawayo,Zimbabwe,2016,1,44,90,1,1,542,1115,20,498,1025,19,27.1,<=30,ZIM,Home,After 1965
CJ Chibhabha,ZIM,Pace,2016-08-06,Bulawayo,Zimbabwe,2016,2,67,90,0,1,578,1230,11,511,1140,11,52.54545454545455,>30,ZIM,Home,After 1965
CJ Chibhabha,ZIM,Pace,2017-12-26,Gqeberha,South Africa,2017,1,51,66,0,1,327,664,21,276,598,21,15.571428571428571,<=30,SA,Away,After 1965
CJ Drum,NZ,Pace,2001-03-15,Christchurch,New Zealand,2001,1,21,48,1,1,802,1722,12,781,1674,11,66.83333333333333,>30,NZ,Home,Upto 2014
CJ Drum,NZ,Pace,2001-12-26,Wellington,New Zealand,2001,2,35,84,3,1,447,846,18,412,762,15,24.833333333333332,<=30,NZ,Home,Upto 2014
CJ Drum,NZ,Pace,2002-03-13,Christchurch,New Zealand,2002,2,166,314,5,1,1052,1583,35,886,1269,30,30.057142857142857,>30,NZ,Home,Upto 2014
CJ Drum,NZ,Pace,2002-03-21,Wellington,New Zealand,2002,2,163,240,3,1,587,1212,18,424,972,15,32.611111111111114,>30,NZ,Home,Upto 2014
CJ Drum,NZ,Pace,2002-03-30,Auckland,New Zealand,2002,2,97,120,4,1,809,1459,39,712,1339,35,20.743589743589745,<=30,NZ,Home,Upto 2014
CJ Eady,AUS,Pace,1896-06-22,Lord's,England,1896,2,69,160,4,1,652,1288,29,583,1128,25,22.482758620689655,<=30,ENG,Away,After 1965
CJ Eady,AUS,Pace,1902-02-28,Melbourne,Australia,1902,2,43,63,3,1,141,297,8,98,234,5,17.625,<=30,AUS,Home,Upto 2014
CJ Jordan,ENG,Pace,2014-06-12,Lord's,England,2014,2,136,274,5,1,1099,1996,30,963,1722,25,36.63333333333333,>30,ENG,Home,After 1965
CJ Jordan,ENG,Pace,2014-06-20,Leeds,England,2014,2,137,264,0,1,1059,2060,34,922,1796,34,31.147058823529413,>30,ENG,Home,After 1965
CJ Jordan,ENG,Pace,2014-07-27,Southampton,England,2014,2,81,132,0,1,815,1573,15,734,1441,15,54.333333333333336,>30,ENG,Home,After 1965
CJ Jordan,ENG,Pace,2014-08-07,Manchester,England,2014,2,92,126,3,1,546,928,23,454,802,20,23.73913043478261,<=30,ENG,Home,After 1965
CJ Jordan,ENG,Pace,2014-08-15,The Oval,England,2014,2,50,110,7,1,613,1107,25,563,997,18,24.52,<=30,ENG,Home,After 1965
CJ Jordan,ENG,Pace,2015-04-13,North Sound,West Indies,2015,2,94,246,2,1,886,1696,22,792,1450,20,40.27272727272727,>30,WI,Away,After 1965
CJ Jordan,ENG,Pace,2015-04-21,St George's,West Indies,2015,2,134,276,3,1,731,1499,18,597,1223,15,40.611111111111114,>30,WI,Away,After 1965
CJ Jordan,ENG,Pace,2015-05-01,Bridgetown,West Indies,2015,2,28,102,1,1,388,896,26,360,794,25,14.923076923076923,<=30,WI,Away,After 1965
CJ McDermott,AUS,Pace,1984-12-22,Melbourne,Australia,1984,2,183,288,6,1,827,1673,26,644,1385,20,31.807692307692307,>30,AUS,Home,Upto 2014
CJ McDermott,AUS,Pace,1984-12-30,Sydney,Australia,1984,2,90,126,4,1,535,1040,12,445,914,8,44.583333333333336,>30,AUS,Home,Upto 2014
CJ McDermott,AUS,Pace,1985-06-13,Leeds,England,1985,2,154,216,4,1,1140,1931,28,986,1715,24,40.714285714285715,>30,ENG,Away,Upto 2014
CJ McDermott,AUS,Pace,1985-06-27,Lord's,England,1985,2,154,296,8,1,753,1358,25,599,1062,17,30.12,>30,ENG,Away,Upto 2014
CJ McDermott,AUS,Pace,1985-07-11,Nottingham,England,1985,2,189,306,4,1,706,1344,15,517,1038,11,47.06666666666667,>30,ENG,Away,Upto 2014
CJ McDermott,AUS,Pace,1985-08-01,Manchester,England,1985,1,141,216,8,1,622,1074,12,481,858,4,51.833333333333336,>30,ENG,Away,Upto 2014
CJ McDermott,AUS,Pace,1985-08-15,Birmingham,England,1985,1,155,186,2,1,829,1344,20,674,1158,18,41.45,>30,ENG,Away,Upto 2014
CJ McDermott,AUS,Pace,1985-08-29,The Oval,England,1985,1,108,186,4,1,567,1067,25,459,881,21,22.68,<=30,ENG,Away,Upto 2014
CJ McDermott,AUS,Pace,1985-11-08,Brisbane,Australia,1985,1,119,186,1,1,699,1580,23,580,1394,22,30.391304347826086,>30,AUS,Home,Upto 2014
CJ McDermott,AUS,Pace,1985-11-30,W.A.C.A,Australia,1985,2,93,276,2,1,726,2093,28,633,1817,26,25.928571428571427,<=30,AUS,Home,Upto 2014
CJ McDermott,AUS,Pace,1985-12-13,Adelaide,Australia,1985,1,131,288,3,1,620,1368,17,489,1080,14,36.470588235294116,>30,AUS,Home,Upto 2014
CJ McDermott,AUS,Pace,1985-12-26,Melbourne,Australia,1985,2,69,126,0,1,429,932,13,360,806,13,33.0,>30,AUS,Home,Upto 2014
CJ McDermott,AUS,Pace,1986-02-21,Wellington,New Zealand,1986,1,80,153,1,1,687,1390,14,607,1237,13,49.07142857142857,>30,NZ,Away,Upto 2014
CJ McDermott,AUS,Pace,1986-03-13,Auckland,New Zealand,1986,2,76,186,2,1,481,1210,15,405,1024,13,32.06666666666667,>30,NZ,Away,Upto 2014
CJ McDermott,AUS,Pace,1986-09-18,Chennai,India,1986,2,86,114,0,1,433,618,3,347,504,3,144.33333333333334,>30,IND,Away,Upto 2014
CJ McDermott,AUS,Pace,1986-09-26,Delhi,India,1986,1,24,36,0,1,158,270,3,134,234,3,52.666666666666664,>30,IND,Away,Upto 2014
CJ McDermott,AUS,Pace,1986-12-26,Melbourne,Australia,1986,1,83,161,4,1,497,1065,22,414,904,18,22.59090909090909,<=30,AUS,Home,Upto 2014
CJ McDermott,AUS,Pace,1987-12-04,Brisbane,Australia,1987,2,122,260,7,1,634,1568,27,512,1308,20,23.48148148148148,<=30,AUS,Home,Upto 2014
CJ McDermott,AUS,Pace,1987-12-11,Adelaide,Australia,1987,2,164,335,5,1,519,1199,13,355,864,8,39.92307692307692,>30,AUS,Home,Upto 2014
CJ McDermott,AUS,Pace,1987-12-26,Melbourne,Australia,1987,2,140,270,5,1,846,1960,31,706,1690,26,27.29032258064516,<=30,AUS,Home,Upto 2014
CJ McDermott,AUS,Pace,1988-01-29,Sydney,Australia,1988,1,65,210,0,1,421,1098,12,356,888,12,35.083333333333336,>30,AUS,Home,Upto 2014
CJ McDermott,AUS,Pace,1988-02-12,W.A.C.A,Australia,1988,2,58,144,3,1,710,1536,29,652,1392,26,24.482758620689655,<=30,AUS,Home,Upto 2014
CJ McDermott,AUS,Pace,1988-11-18,Brisbane,Australia,1988,2,111,192,3,1,708,1383,27,597,1191,24,26.22222222222222,<=30,AUS,Home,Upto 2014
CJ McDermott,AUS,Pace,1988-12-24,Melbourne,Australia,1988,2,140,270,4,1,897,2063,38,757,1793,34,23.605263157894736,<=30,AUS,Home,Upto 2014
CJ McDermott,AUS,Pace,1991-01-25,Adelaide,Australia,1991,2,203,321,7,1,1030,2159,28,827,1838,21,36.785714285714285,>30,AUS,Home,Upto 2014
CJ McDermott,AUS,Pace,1991-02-01,W.A.C.A,Australia,1991,2,157,265,11,1,771,1442,29,614,1177,18,26.586206896551722,<=30,AUS,Home,Upto 2014
CJ McDermott,AUS,Pace,1991-03-01,Kingston,West Indies,1991,2,128,282,8,1,694,1365,21,566,1083,13,33.04761904761905,>30,WI,Away,Upto 2014
CJ McDermott,AUS,Pace,1991-03-23,Georgetown,West Indies,1991,2,124,240,2,1,808,1623,19,684,1383,17,42.526315789473685,>30,WI,Away,Upto 2014
CJ McDermott,AUS,Pace,1991-04-05,Port of Spain,West Indies,1991,1,36,86,3,1,449,1209,20,413,1123,17,22.45,<=30,WI,Away,Upto 2014
CJ McDermott,AUS,Pace,1991-04-19,Bridgetown,West Indies,1991,2,179,357,6,1,874,1849,33,695,1492,27,26.484848484848484,<=30,WI,Away,Upto 2014
CJ McDermott,AUS,Pace,1991-04-27,St John's,West Indies,1991,2,97,192,5,1,735,1397,30,638,1205,25,24.5,<=30,WI,Away,Upto 2014
CJ McDermott,AUS,Pace,1991-11-29,Brisbane,Australia,1991,2,101,319,9,1,581,1459,29,480,1140,20,20.03448275862069,<=30,AUS,Home,Upto 2014
CJ McDermott,AUS,Pace,1991-12-26,Melbourne,Australia,1991,2,163,354,5,1,732,1688,29,569,1334,24,25.24137931034483,<=30,AUS,Home,Upto 2014
CJ McDermott,AUS,Pace,1992-01-02,Sydney,Australia,1992,1,147,306,4,1,641,1594,19,494,1288,15,33.73684210526316,>30,AUS,Home,Upto 2014
CJ McDermott,AUS,Pace,1992-01-25,Adelaide,Australia,1992,2,168,361,10,1,796,1827,30,628,1466,20,26.533333333333335,<=30,AUS,Home,Upto 2014
CJ McDermott,AUS,Pace,1992-02-01,W.A.C.A,Australia,1992,2,91,246,3,1,946,1994,34,855,1748,31,27.823529411764707,<=30,AUS,Home,Upto 2014
CJ McDermott,AUS,Pace,1992-08-17,Colombo (SSC),Sri Lanka,1992,2,168,324,4,1,793,1548,19,625,1224,15,41.73684210526316,>30,SL,Away,Upto 2014
CJ McDermott,AUS,Pace,1992-08-28,Colombo (RPS),Sri Lanka,1992,2,85,234,6,1,531,1227,20,446,993,14,26.55,<=30,SL,Away,Upto 2014
CJ McDermott,AUS,Pace,1992-09-08,Moratuwa,Sri Lanka,1992,1,89,186,4,1,511,1044,22,422,858,18,23.227272727272727,<=30,SL,Away,Upto 2014
CJ McDermott,AUS,Pace,1992-11-27,Brisbane,Australia,1992,2,128,258,5,1,859,1899,30,731,1641,25,28.633333333333333,<=30,AUS,Home,Upto 2014
CJ McDermott,AUS,Pace,1992-12-26,Melbourne,Australia,1992,2,132,253,5,1,743,1849,31,611,1596,26,23.967741935483872,<=30,AUS,Home,Upto 2014
CJ McDermott,AUS,Pace,1993-01-02,Sydney,Australia,1993,1,119,198,1,1,568,1162,8,449,964,7,71.0,>30,AUS,Home,Upto 2014
CJ McDermott,AUS,Pace,1993-01-23,Adelaide,Australia,1993,2,151,162,4,1,644,1295,29,493,1133,25,22.20689655172414,<=30,AUS,Home,Upto 2014
CJ McDermott,AUS,Pace,1993-01-30,W.A.C.A,Australia,1993,1,85,132,3,1,518,1062,27,433,930,24,19.185185185185187,<=30,AUS,Home,Upto 2014
CJ McDermott,AUS,Pace,1993-02-25,Christchurch,New Zealand,1993,2,118,240,5,1,651,1526,21,533,1286,16,31.0,>30,NZ,Away,Upto 2014
CJ McDermott,AUS,Pace,1993-03-04,Wellington,New Zealand,1993,2,120,324,6,1,647,1552,21,527,1228,15,30.80952380952381,>30,NZ,Away,Upto 2014
CJ McDermott,AUS,Pace,1993-03-12,Auckland,New Zealand,1993,2,88,186,2,1,620,1465,22,532,1279,20,28.181818181818183,<=30,NZ,Away,Upto 2014
CJ McDermott,AUS,Pace,1993-06-03,Manchester,England,1993,2,126,288,0,1,704,1351,14,578,1063,14,50.285714285714285,>30,ENG,Away,Upto 2014
CJ McDermott,AUS,Pace,1993-11-12,W.A.C.A,Australia,1993,2,167,318,4,1,942,1817,19,775,1499,15,49.578947368421055,>30,AUS,Home,Upto 2014
CJ McDermott,AUS,Pace,1993-11-26,Hobart,Australia,1993,2,71,192,2,1,577,1014,7,506,822,5,82.42857142857143,>30,AUS,Home,Upto 2014
CJ McDermott,AUS,Pace,1993-12-03,Brisbane,Australia,1993,2,102,288,6,1,683,1440,13,581,1152,7,52.53846153846154,>30,AUS,Home,Upto 2014
CJ McDermott,AUS,Pace,1993-12-26,Melbourne,Australia,1993,1,60,138,1,1,399,858,6,339,720,5,66.5,>30,AUS,Home,Upto 2014
CJ McDermott,AUS,Pace,1994-01-02,Sydney,Australia,1994,2,104,277,6,1,459,1326,25,355,1049,19,18.36,<=30,AUS,Home,Upto 2014
CJ McDermott,AUS,Pace,1994-01-28,Adelaide,Australia,1994,2,82,276,7,1,661,1638,23,579,1362,16,28.73913043478261,<=30,AUS,Home,Upto 2014
CJ McDermott,AUS,Pace,1994-03-04,Johannesburg,South Africa,1994,2,175,302,4,1,852,1646,28,677,1344,24,30.428571428571427,>30,SA,Away,Upto 2014
CJ McDermott,AUS,Pace,1994-03-17,Cape Town,South Africa,1994,2,119,240,2,1,830,1910,22,711,1670,20,37.72727272727273,>30,SA,Away,Upto 2014
CJ McDermott,AUS,Pace,1994-03-25,Durban,South Africa,1994,1,76,228,1,1,810,2116,20,734,1888,19,40.5,>30,SA,Away,Upto 2014
CJ McDermott,AUS,Pace,1994-10-05,Rawalpindi,Pakistan,1994,2,160,330,6,1,838,1506,23,678,1176,17,36.43478260869565,>30,PAK,Away,Upto 2014
CJ McDermott,AUS,Pace,1994-11-01,Lahore,Pakistan,1994,2,168,258,1,1,516,907,10,348,649,9,51.6,>30,PAK,Away,Upto 2014
CJ McDermott,AUS,Pace,1994-11-25,Brisbane,Australia,1994,2,143,252,8,1,726,1262,21,583,1010,13,34.57142857142857,>30,AUS,Home,Upto 2014
CJ McDermott,AUS,Pace,1994-12-24,Melbourne,Australia,1994,2,114,245,8,1,587,1268,21,473,1023,13,27.952380952380953,<=30,AUS,Home,Upto 2014
CJ McDermott,AUS,Pace,1995-01-01,Sydney,Australia,1995,2,177,324,5,1,651,1345,27,474,1021,22,24.11111111111111,<=30,AUS,Home,Upto 2014
CJ McDermott,AUS,Pace,1995-01-26,Adelaide,Australia,1995,2,162,408,5,1,823,1644,27,661,1236,22,30.48148148148148,>30,AUS,Home,Upto 2014
CJ McDermott,AUS,Pace,1995-02-03,W.A.C.A,Australia,1995,2,79,168,6,1,946,1817,29,867,1649,23,32.62068965517241,>30,AUS,Home,Upto 2014
CJ McDermott,AUS,Pace,1995-11-09,Brisbane,Australia,1995,2,79,132,1,1,520,1074,13,441,942,12,40.0,>30,AUS,Home,Upto 2014
CJ McDermott,AUS,Pace,1995-11-17,Hobart,Australia,1995,2,110,204,2,1,693,1398,29,583,1194,27,23.896551724137932,<=30,AUS,Home,Upto 2014
CJ McDermott,AUS,Pace,1995-11-30,Sydney,Australia,1995,2,111,219,8,1,445,1017,19,334,798,11,23.42105263157895,<=30,AUS,Home,Upto 2014
CJ McDermott,AUS,Pace,1995-12-08,W.A.C.A,Australia,1995,2,117,232,6,1,613,1126,16,496,894,10,38.3125,>30,AUS,Home,Upto 2014
CJ McDermott,AUS,Pace,1995-12-26,Melbourne,Australia,1995,2,117,240,3,1,608,1377,17,491,1137,14,35.76470588235294,>30,AUS,Home,Upto 2014
CJ McDermott,AUS,Pace,1996-01-25,Adelaide,Australia,1996,2,101,174,1,1,886,1812,32,785,1638,31,27.6875,<=30,AUS,Home,Upto 2014
CJ McKay,AUS,Pace,2009-12-16,W.A.C.A,Australia,2009,2,101,168,1,1,927,1486,27,826,1318,26,34.333333333333336,>30,AUS,Home,Upto 2014
CJ Poole,ENG,Pace,1951-12-30,Eden Gardens,India,1951,1,9,30,0,1,283,907,5,274,877,5,56.6,>30,IND,Away,Upto 2014
CJ Sayers,AUS,Pace,2018-03-30,Johannesburg,South Africa,2018,2,146,294,2,1,666,1427,26,520,1133,24,25.615384615384617,<=30,SA,Away,After 1965
CJ Tavare,ENG,Spin,1982-01-13,Chennai,India,1982,1,11,12,0,1,285,972,8,274,960,8,35.625,>30,IND,Away,Upto 2014
CJ Tavare,ENG,Spin,1984-08-23,Lord's,England,1984,1,0,18,0,1,242,726,5,242,708,5,48.4,>30,ENG,Home,Upto 2014
CK Holder,WI,Pace,2020-12-11,Wellington,New Zealand,2020,1,110,156,2,1,834,1421,28,724,1265,26,29.785714285714285,<=30,NZ,Away,After 1965
CK Kapugedera,SL,Pace,2009-08-26,Colombo (SSC),Sri Lanka,2009,1,9,12,0,1,574,917,8,565,905,8,71.75,>30,SL,Home,Upto 2014
CK Langeveldt,SA,Pace,2005-01-02,Cape Town,South Africa,2005,2,96,198,5,1,830,1832,29,734,1634,24,28.620689655172413,<=30,SA,Home,Upto 2014
CK Langeveldt,SA,Pace,2005-03-04,Cape Town,South Africa,2005,2,36,93,2,1,443,710,15,407,617,13,29.533333333333335,<=30,SA,Home,Upto 2014
CK Langeveldt,SA,Pace,2005-03-11,Centurion,South Africa,2005,1,19,30,1,1,611,1095,23,592,1065,22,26.565217391304348,<=30,SA,Home,Upto 2014
CK Langeveldt,SA,Pace,2005-03-31,Georgetown,West Indies,2005,1,65,162,1,1,687,1530,15,622,1368,14,45.8,>30,WI,Away,Upto 2014
CK Langeveldt,SA,Pace,2005-12-16,W.A.C.A,Australia,2005,2,217,288,4,1,1099,2050,27,882,1762,23,40.7037037037037,>30,AUS,Away,Upto 2014
CK Langeveldt,SA,Pace,2006-01-02,Sydney,Australia,2006,2,160,228,3,1,752,1301,17,592,1073,14,44.23529411764706,>30,AUS,Away,Upto 2014
CK Nayudu,IND,Spin,1932-06-25,Lord's,England,1932,2,61,198,2,1,320,726,9,259,528,7,35.55555555555556,>30,ENG,Away,Upto 2014
CK Nayudu,IND,Spin,1933-12-15,Mumbai,India,1933,1,10,42,0,1,373,858,11,363,816,11,33.90909090909091,>30,IND,Home,Upto 2014
CK Nayudu,IND,Spin,1934-01-05,Eden Gardens,India,1934,1,40,138,3,1,342,922,15,302,784,12,22.8,<=30,IND,Home,Upto 2014
CK Nayudu,IND,Spin,1934-02-10,Chennai,India,1934,2,70,120,0,1,484,943,18,414,823,18,26.88888888888889,<=30,IND,Home,Upto 2014
CK Nayudu,IND,Spin,1936-06-27,Lord's,England,1936,2,39,84,1,1,182,439,11,143,355,10,16.545454545454547,<=30,ENG,Away,Upto 2014
CK Nayudu,IND,Spin,1936-07-25,Manchester,England,1936,1,84,132,2,1,479,775,14,395,643,12,34.214285714285715,>30,ENG,Away,Upto 2014
CK Nayudu,IND,Spin,1936-08-15,The Oval,England,1936,1,82,144,1,1,349,695,12,267,551,11,29.083333333333332,<=30,ENG,Away,Upto 2014
CK Singh,WI,Spin,1960-01-28,Port of Spain,West Indies,1960,2,87,186,3,1,448,1444,13,361,1258,10,34.46153846153846,>30,WI,Home,Upto 2014
CK Singh,WI,Spin,1960-03-09,Georgetown,West Indies,1960,2,79,320,2,1,501,1694,13,422,1374,11,38.53846153846154,>30,WI,Home,Upto 2014
CK Tshuma,ZIM,Pace,2020-02-22,Mirpur,Bangladesh,2020,1,85,150,1,1,385,792,7,300,642,6,55.0,>30,BAN,Away,After 1965
CKB Kulasekara,SL,Pace,2011-11-03,Sharjah,UAE,2011,2,80,168,1,1,418,917,14,338,749,13,29.857142857142858,<=30,UAE,Away,Upto 2014
CL Cairns,NZ,Pace,1989-11-24,W.A.C.A,Australia,1989,1,60,72,0,1,939,2255,25,879,2183,25,37.56,>30,AUS,Away,Upto 2014
CL Cairns,NZ,Pace,1991-03-01,Auckland,New Zealand,1991,2,211,354,9,1,890,1772,29,679,1418,20,30.689655172413794,>30,NZ,Home,Upto 2014
CL Cairns,NZ,Pace,1992-01-18,Christchurch,New Zealand,1992,1,118,180,1,1,763,1516,14,645,1336,13,54.5,>30,NZ,Home,Upto 2014
CL Cairns,NZ,Pace,1992-01-30,Auckland,New Zealand,1992,2,138,240,8,1,740,1678,33,602,1438,25,22.424242424242426,<=30,NZ,Home,Upto 2014
CL Cairns,NZ,Pace,1992-02-06,Wellington,New Zealand,1992,2,173,282,2,1,603,1369,15,430,1087,13,40.2,>30,NZ,Home,Upto 2014
CL Cairns,NZ,Pace,1993-02-25,Christchurch,New Zealand,1993,1,87,189,1,1,651,1526,21,564,1337,20,31.0,>30,NZ,Home,Upto 2014
CL Cairns,NZ,Pace,1993-03-04,Wellington,New Zealand,1993,1,77,144,0,1,647,1552,21,570,1408,21,30.80952380952381,>30,NZ,Home,Upto 2014
CL Cairns,NZ,Pace,1993-11-12,W.A.C.A,Australia,1993,2,125,174,4,1,942,1817,19,817,1643,15,49.578947368421055,>30,AUS,Away,Upto 2014
CL Cairns,NZ,Pace,1993-12-03,Brisbane,Australia,1993,1,128,216,1,1,683,1440,13,555,1224,12,52.53846153846154,>30,AUS,Away,Upto 2014
CL Cairns,NZ,Pace,1994-02-10,Auckland,New Zealand,1994,2,90,144,2,1,582,1070,31,492,926,29,18.774193548387096,<=30,NZ,Home,Upto 2014
CL Cairns,NZ,Pace,1995-10-18,Bengaluru,India,1995,2,57,142,4,1,331,688,17,274,546,13,19.470588235294116,<=30,IND,Away,Upto 2014
CL Cairns,NZ,Pace,1995-10-25,Chennai,India,1995,1,18,96,1,1,74,270,2,56,174,1,37.0,>30,IND,Away,Upto 2014
CL Cairns,NZ,Pace,1995-11-08,Cuttack,India,1995,1,95,161,3,1,240,497,7,145,336,4,34.285714285714285,>30,IND,Away,Upto 2014
CL Cairns,NZ,Pace,1995-12-08,Christchurch,New Zealand,1995,2,165,277,7,1,844,1657,28,679,1380,21,30.142857142857142,>30,NZ,Home,Upto 2014
CL Cairns,NZ,Pace,1996-01-13,Hamilton,New Zealand,1996,2,99,234,6,1,657,1344,21,558,1110,15,31.285714285714285,>30,NZ,Home,Upto 2014
CL Cairns,NZ,Pace,1996-01-20,Auckland,New Zealand,1996,2,141,324,2,1,908,2025,23,767,1701,21,39.47826086956522,>30,NZ,Home,Upto 2014
CL Cairns,NZ,Pace,1996-11-21,Lahore,Pakistan,1996,2,141,210,2,1,507,953,23,366,743,21,22.043478260869566,<=30,PAK,Away,Upto 2014
CL Cairns,NZ,Pace,1996-11-28,Rawalpindi,Pakistan,1996,1,137,184,5,1,614,1126,22,477,942,17,27.90909090909091,<=30,PAK,Away,Upto 2014
CL Cairns,NZ,Pace,1997-01-24,Auckland,New Zealand,1997,1,103,180,1,1,815,1797,20,712,1617,19,40.75,>30,NZ,Home,Upto 2014
CL Cairns,NZ,Pace,1997-02-06,Wellington,New Zealand,1997,1,8,24,0,1,457,1115,23,449,1091,23,19.869565217391305,<=30,NZ,Home,Upto 2014
CL Cairns,NZ,Pace,1997-02-14,Christchurch,New Zealand,1997,2,35,108,1,1,695,1595,19,660,1487,18,36.578947368421055,>30,NZ,Home,Upto 2014
CL Cairns,NZ,Pace,1997-09-18,Harare,Zimbabwe,1997,2,94,223,5,1,808,1794,25,714,1571,20,32.32,>30,ZIM,Away,Upto 2014
CL Cairns,NZ,Pace,1997-09-25,Bulawayo,Zimbabwe,1997,2,146,282,4,1,606,1326,9,460,1044,5,67.33333333333333,>30,ZIM,Away,Upto 2014
CL Cairns,NZ,Pace,1997-11-07,Brisbane,Australia,1997,2,144,240,7,1,809,1711,25,665,1471,18,32.36,>30,AUS,Away,Upto 2014
CL Cairns,NZ,Pace,1997-11-20,W.A.C.A,Australia,1997,1,95,168,4,1,605,1158,21,510,990,17,28.80952380952381,<=30,AUS,Away,Upto 2014
CL Cairns,NZ,Pace,1997-11-27,Hobart,Australia,1997,1,86,211,2,1,691,1411,18,605,1200,16,38.388888888888886,>30,AUS,Away,Upto 2014
CL Cairns,NZ,Pace,1998-02-19,Wellington,New Zealand,1998,2,106,243,5,1,429,1062,17,323,819,12,25.235294117647058,<=30,NZ,Home,Upto 2014
CL Cairns,NZ,Pace,1998-02-26,Auckland,New Zealand,1998,2,137,275,6,1,557,1155,25,420,880,19,22.28,<=30,NZ,Home,Upto 2014
CL Cairns,NZ,Pace,1998-05-27,Colombo (RPS),Sri Lanka,1998,2,123,204,4,1,355,626,8,232,422,4,44.375,>30,SL,Away,Upto 2014
CL Cairns,NZ,Pace,1998-06-03,Galle,Sri Lanka,1998,1,20,30,0,1,157,358,1,137,328,1,157.0,>30,SL,Away,Upto 2014
CL Cairns,NZ,Pace,1998-06-10,Colombo (SSC),Sri Lanka,1998,2,137,208,6,1,230,457,11,93,249,5,20.90909090909091,<=30,SL,Away,Upto 2014
CL Cairns,NZ,Pace,1998-12-26,Wellington,New Zealand,1998,2,137,216,0,1,632,1417,22,495,1201,22,28.727272727272727,<=30,NZ,Home,Upto 2014
CL Cairns,NZ,Pace,1999-01-02,Hamilton,New Zealand,1999,2,137,189,6,1,1002,1896,23,865,1707,17,43.56521739130435,>30,NZ,Home,Upto 2014
CL Cairns,NZ,Pace,1999-07-01,Birmingham,England,1999,2,53,82,3,1,580,1146,27,527,1064,24,21.48148148148148,<=30,ENG,Away,Upto 2014
CL Cairns,NZ,Pace,1999-07-22,Lord's,England,1999,2,144,277,8,1,642,1427,25,498,1150,17,25.68,<=30,ENG,Away,Upto 2014
CL Cairns,NZ,Pace,1999-08-05,Manchester,England,1999,2,126,270,2,1,505,1189,11,379,919,9,45.90909090909091,>30,ENG,Away,Upto 2014
CL Cairns,NZ,Pace,1999-08-19,The Oval,England,1999,2,81,205,6,1,501,1268,29,420,1063,23,17.275862068965516,<=30,ENG,Away,Upto 2014
CL Cairns,NZ,Pace,1999-10-10,Mohali,India,1999,2,99,198,2,1,577,1368,20,478,1170,18,28.85,<=30,IND,Away,Upto 2014
CL Cairns,NZ,Pace,1999-10-22,Kanpur,India,1999,2,44,114,1,1,214,642,8,170,528,7,26.75,<=30,IND,Away,Upto 2014
CL Cairns,NZ,Pace,1999-10-29,Ahmedabad,India,1999,2,111,180,2,1,649,1266,11,538,1086,9,59.0,>30,IND,Away,Upto 2014
CL Cairns,NZ,Pace,1999-12-16,Hamilton,New Zealand,1999,2,100,323,10,1,615,1231,21,515,908,11,29.285714285714285,<=30,NZ,Home,Upto 2014
CL Cairns,NZ,Pace,1999-12-26,Wellington,New Zealand,1999,2,69,187,7,1,571,1324,20,502,1137,13,28.55,<=30,NZ,Home,Upto 2014
CL Cairns,NZ,Pace,2000-03-11,Auckland,New Zealand,2000,2,84,132,3,1,234,565,12,150,433,9,19.5,<=30,NZ,Home,Upto 2014
CL Cairns,NZ,Pace,2000-03-24,Wellington,New Zealand,2000,2,155,237,4,1,802,1476,20,647,1239,16,40.1,>30,NZ,Home,Upto 2014
CL Cairns,NZ,Pace,2000-03-31,Hamilton,New Zealand,2000,2,140,192,3,1,633,1061,24,493,869,21,26.375,<=30,NZ,Home,Upto 2014
CL Cairns,NZ,Pace,2000-09-12,Bulawayo,Zimbabwe,2000,2,108,259,7,1,470,1291,13,362,1032,6,36.15384615384615,>30,ZIM,Away,Upto 2014
CL Cairns,NZ,Pace,2000-09-19,Harare,Zimbabwe,2000,2,113,301,4,1,838,2129,25,725,1828,21,33.52,>30,ZIM,Away,Upto 2014
CL Cairns,NZ,Pace,2001-11-08,Brisbane,Australia,2001,2,175,252,6,1,871,1428,20,696,1176,14,43.55,>30,AUS,Away,Upto 2014
CL Cairns,NZ,Pace,2001-11-22,Hobart,Australia,2001,1,122,168,1,1,554,972,8,432,804,7,69.25,>30,AUS,Away,Upto 2014
CL Cairns,NZ,Pace,2001-11-30,W.A.C.A,Australia,2001,2,158,228,3,1,1026,1787,22,868,1559,19,46.63636363636363,>30,AUS,Away,Upto 2014
CL Cairns,NZ,Pace,2001-12-18,Hamilton,New Zealand,2001,2,108,176,8,1,586,928,27,478,752,19,21.703703703703702,<=30,NZ,Home,Upto 2014
CL Cairns,NZ,Pace,2001-12-26,Wellington,New Zealand,2001,2,51,126,5,1,447,846,18,396,720,13,24.833333333333332,<=30,NZ,Home,Upto 2014
CL Cairns,NZ,Pace,2002-03-13,Christchurch,New Zealand,2002,2,66,114,3,1,1052,1583,35,986,1469,32,30.057142857142857,>30,NZ,Home,Upto 2014
CL Cairns,NZ,Pace,2003-12-19,Hamilton,New Zealand,2003,1,60,102,0,1,863,1591,23,803,1489,23,37.52173913043478,>30,NZ,Home,Upto 2014
CL Cairns,NZ,Pace,2004-03-10,Hamilton,New Zealand,2004,2,100,198,1,1,760,1661,15,660,1463,14,50.666666666666664,>30,NZ,Home,Upto 2014
CL Cairns,NZ,Pace,2004-03-18,Auckland,New Zealand,2004,2,117,207,4,1,1016,1973,29,899,1766,25,35.03448275862069,>30,NZ,Home,Upto 2014
CL Cairns,NZ,Pace,2004-03-26,Wellington,New Zealand,2004,2,79,161,4,1,820,1651,25,741,1490,21,32.8,>30,NZ,Home,Upto 2014
CL Cairns,NZ,Pace,2004-05-20,Lord's,England,2004,2,98,132,1,1,1118,2072,26,1020,1940,25,43.0,>30,ENG,Away,Upto 2014
CL Cairns,NZ,Pace,2004-06-03,Leeds,England,2004,1,94,162,2,1,915,1695,27,821,1533,25,33.888888888888886,>30,ENG,Away,Upto 2014
CL Cairns,NZ,Pace,2004-06-10,Nottingham,England,2004,2,187,291,9,1,1015,1836,30,828,1545,21,33.833333333333336,>30,ENG,Away,Upto 2014
CL Hooper,WI,Spin,1987-12-26,Eden Gardens,India,1987,1,40,120,0,1,615,1451,5,575,1331,5,123.0,>30,IND,Away,Upto 2014
CL Hooper,WI,Spin,1988-01-11,Chennai,India,1988,2,62,108,2,1,536,1127,23,474,1019,21,23.304347826086957,<=30,IND,Away,Upto 2014
CL Hooper,WI,Spin,1988-04-02,Georgetown,West Indies,1988,1,37,72,1,1,306,558,9,269,486,8,34.0,>30,WI,Home,Upto 2014
CL Hooper,WI,Spin,1988-04-14,Port of Spain,West Indies,1988,2,53,79,1,1,344,563,11,291,484,10,31.272727272727273,>30,WI,Home,Upto 2014
CL Hooper,WI,Spin,1988-04-22,Bridgetown,West Indies,1988,2,74,132,1,1,257,510,4,183,378,3,64.25,>30,WI,Home,Upto 2014
CL Hooper,WI,Spin,1988-06-02,Nottingham,England,1988,2,53,132,0,1,176,288,2,123,156,2,88.0,>30,ENG,Away,Upto 2014
CL Hooper,WI,Spin,1988-06-30,Manchester,England,1988,1,4,6,0,1,153,408,1,149,402,1,153.0,>30,ENG,Away,Upto 2014
CL Hooper,WI,Spin,1988-08-04,The Oval,England,1988,1,0,6,0,1,151,444,7,151,438,7,21.571428571428573,<=30,ENG,Away,Upto 2014
CL Hooper,WI,Spin,1988-11-18,Brisbane,Australia,1988,2,47,96,1,1,172,348,4,125,252,3,43.0,>30,AUS,Away,Upto 2014
CL Hooper,WI,Spin,1988-12-02,W.A.C.A,Australia,1988,2,34,60,1,1,185,288,3,151,228,2,61.666666666666664,>30,AUS,Away,Upto 2014
CL Hooper,WI,Spin,1989-01-26,Sydney,Australia,1989,2,96,285,0,1,632,1677,20,536,1392,20,31.6,>30,AUS,Away,Upto 2014
CL Hooper,WI,Spin,1989-02-03,Adelaide,Australia,1989,2,21,36,0,1,439,1030,5,418,994,5,87.8,>30,AUS,Away,Upto 2014
CL Hooper,WI,Spin,1990-02-24,Kingston,West Indies,1990,1,28,36,0,1,69,114,0,41,78,0,inf,>30,WI,Home,Upto 2014
CL Hooper,WI,Spin,1990-03-23,Port of Spain,West Indies,1990,1,26,108,0,1,26,108,0,0,0,0,inf,>30,WI,Home,Upto 2014
CL Hooper,WI,Spin,1990-11-15,Karachi,Pakistan,1990,2,95,234,0,1,289,648,5,194,414,5,57.8,>30,PAK,Away,Upto 2014
CL Hooper,WI,Spin,1990-11-23,Faisalabad,Pakistan,1990,2,14,30,0,1,109,218,2,95,188,2,54.5,>30,PAK,Away,Upto 2014
CL Hooper,WI,Spin,1990-12-06,Lahore,Pakistan,1990,1,35,90,1,1,232,389,5,197,299,4,46.4,>30,PAK,Away,Upto 2014
CL Hooper,WI,Spin,1991-03-01,Kingston,West Indies,1991,1,37,126,1,1,221,516,2,184,390,1,110.5,>30,WI,Home,Upto 2014
CL Hooper,WI,Spin,1991-03-23,Georgetown,West Indies,1991,2,72,186,0,1,331,635,8,259,449,8,41.375,>30,WI,Home,Upto 2014
CL Hooper,WI,Spin,1991-04-05,Port of Spain,West Indies,1991,2,111,228,0,1,152,384,2,41,156,2,76.0,>30,WI,Home,Upto 2014
CL Hooper,WI,Spin,1991-04-19,Bridgetown,West Indies,1991,1,28,114,2,1,121,318,6,93,204,4,20.166666666666668,<=30,WI,Home,Upto 2014
CL Hooper,WI,Spin,1991-04-27,St John's,West Indies,1991,2,143,252,2,1,399,618,7,256,366,5,57.0,>30,WI,Home,Upto 2014
CL Hooper,WI,Spin,1991-06-06,Leeds,England,1991,1,11,24,0,1,16,48,0,5,24,0,inf,>30,ENG,Away,Upto 2014
CL Hooper,WI,Spin,1991-06-20,Lord's,England,1991,1,10,30,1,1,87,138,3,77,108,2,29.0,<=30,ENG,Away,Upto 2014
CL Hooper,WI,Spin,1991-07-04,Nottingham,England,1991,1,10,36,0,1,144,282,3,134,246,3,48.0,>30,ENG,Away,Upto 2014
CL Hooper,WI,Spin,1991-07-25,Birmingham,England,1991,2,28,90,0,1,126,226,1,98,136,1,126.0,>30,ENG,Away,Upto 2014
CL Hooper,WI,Spin,1991-08-08,The Oval,England,1991,1,78,204,1,1,257,571,9,179,367,8,28.555555555555557,<=30,ENG,Away,Upto 2014
CL Hooper,WI,Spin,1992-11-27,Brisbane,Australia,1992,2,138,351,5,1,220,633,7,82,282,2,31.428571428571427,>30,AUS,Away,Upto 2014
CL Hooper,WI,Spin,1992-12-26,Melbourne,Australia,1992,2,104,232,0,1,262,558,8,158,326,8,32.75,>30,AUS,Away,Upto 2014
CL Hooper,WI,Spin,1993-01-02,Sydney,Australia,1993,2,159,334,3,1,617,1258,8,458,924,5,77.125,>30,AUS,Away,Upto 2014
CL Hooper,WI,Spin,1993-01-23,Adelaide,Australia,1993,2,37,108,2,1,119,287,11,82,179,9,10.818181818181818,<=30,AUS,Away,Upto 2014
CL Hooper,WI,Spin,1993-04-16,Port of Spain,West Indies,1993,2,65,95,5,1,204,311,8,139,216,3,25.5,<=30,WI,Home,Upto 2014
CL Hooper,WI,Spin,1993-04-23,Bridgetown,West Indies,1993,2,118,237,4,1,162,279,5,44,42,1,32.4,>30,WI,Home,Upto 2014
CL Hooper,WI,Spin,1993-05-01,St John's,West Indies,1993,1,98,168,1,1,315,516,3,217,348,2,105.0,>30,WI,Home,Upto 2014
CL Hooper,WI,Spin,1993-12-08,Moratuwa,Sri Lanka,1993,1,44,120,1,1,241,659,12,197,539,11,20.083333333333332,<=30,SL,Away,Upto 2014
CL Hooper,WI,Spin,1994-11-18,Wankhede,India,1994,2,92,198,2,1,528,1096,17,436,898,15,31.058823529411764,>30,IND,Away,Upto 2014
CL Hooper,WI,Spin,1994-12-01,Nagpur,India,1994,2,178,391,7,1,761,1735,22,583,1344,15,34.59090909090909,>30,IND,Away,Upto 2014
CL Hooper,WI,Spin,1994-12-10,Mohali,India,1994,1,50,102,0,1,470,841,10,420,739,10,47.0,>30,IND,Away,Upto 2014
CL Hooper,WI,Spin,1995-03-31,Bridgetown,West Indies,1995,2,65,78,1,1,198,315,6,133,237,5,33.0,>30,WI,Home,Upto 2014
CL Hooper,WI,Spin,1995-04-08,St John's,West Indies,1995,2,34,66,1,1,167,342,4,133,276,3,41.75,>30,WI,Home,Upto 2014
CL Hooper,WI,Spin,1995-04-29,Kingston,West Indies,1995,1,94,258,1,1,303,676,8,209,418,7,37.875,>30,WI,Home,Upto 2014
CL Hooper,WI,Spin,1995-06-22,Lord's,England,1995,2,67,138,2,1,98,234,2,31,96,0,49.0,>30,ENG,Away,Upto 2014
CL Hooper,WI,Spin,1995-08-24,The Oval,England,1995,2,82,270,1,1,255,528,1,173,258,0,255.0,>30,ENG,Away,Upto 2014
CL Hooper,WI,Spin,1996-11-22,Brisbane,Australia,1996,2,71,126,0,1,313,642,7,242,516,7,44.714285714285715,>30,AUS,Away,Upto 2014
CL Hooper,WI,Spin,1996-11-29,Sydney,Australia,1996,2,90,246,0,1,372,857,10,282,611,10,37.2,>30,AUS,Away,Upto 2014
CL Hooper,WI,Spin,1996-12-26,Melbourne,Australia,1996,1,14,30,0,1,107,223,3,93,193,3,35.666666666666664,>30,AUS,Away,Upto 2014
CL Hooper,WI,Spin,1997-01-25,Adelaide,Australia,1997,1,86,186,2,1,334,663,19,248,477,17,17.57894736842105,<=30,AUS,Away,Upto 2014
CL Hooper,WI,Spin,1997-02-01,W.A.C.A,Australia,1997,2,56,108,1,1,142,252,3,86,144,2,47.333333333333336,>30,AUS,Away,Upto 2014
CL Hooper,WI,Spin,1997-03-06,Kingston,West Indies,1997,2,67,222,0,1,464,982,9,397,760,9,51.55555555555556,>30,WI,Home,Upto 2014
CL Hooper,WI,Spin,1997-03-14,Port of Spain,West Indies,1997,1,53,168,0,1,443,1095,13,390,927,13,34.07692307692308,>30,WI,Home,Upto 2014
CL Hooper,WI,Spin,1997-03-27,Bridgetown,West Indies,1997,1,28,48,0,1,72,144,1,44,96,1,72.0,>30,WI,Home,Upto 2014
CL Hooper,WI,Spin,1997-04-04,St John's,West Indies,1997,1,40,90,0,1,268,532,5,228,442,5,53.6,>30,WI,Home,Upto 2014
CL Hooper,WI,Spin,1997-04-17,Georgetown,West Indies,1997,1,34,108,3,1,131,336,6,97,228,3,21.833333333333332,<=30,WI,Home,Upto 2014
CL Hooper,WI,Spin,1997-06-13,St John's,West Indies,1997,1,49,114,1,1,220,504,11,171,390,10,20.0,<=30,WI,Home,Upto 2014
CL Hooper,WI,Spin,1997-06-20,Kingstown,West Indies,1997,2,47,136,5,1,276,646,16,229,510,11,17.25,<=30,WI,Home,Upto 2014
CL Hooper,WI,Spin,1997-11-17,Peshawar,Pakistan,1997,1,40,120,2,1,271,573,12,231,453,10,22.583333333333332,<=30,PAK,Away,Upto 2014
CL Hooper,WI,Spin,1997-11-29,Rawalpindi,Pakistan,1997,1,71,102,0,1,146,240,1,75,138,1,146.0,>30,PAK,Away,Upto 2014
CL Hooper,WI,Spin,1997-12-06,Karachi,Pakistan,1997,1,74,192,0,1,300,618,11,226,426,11,27.272727272727273,<=30,PAK,Away,Upto 2014
CL Hooper,WI,Spin,1998-02-05,Port of Spain,West Indies,1998,2,47,168,1,1,159,524,3,112,356,2,53.0,>30,WI,Home,Upto 2014
CL Hooper,WI,Spin,1998-02-13,Port of Spain,West Indies,1998,2,54,186,3,1,83,378,4,29,192,1,20.75,<=30,WI,Home,Upto 2014
CL Hooper,WI,Spin,1998-02-27,Georgetown,West Indies,1998,2,60,198,5,1,391,1045,18,331,847,13,21.72222222222222,<=30,WI,Home,Upto 2014
CL Hooper,WI,Spin,1998-03-12,Bridgetown,West Indies,1998,2,138,353,5,1,286,824,8,148,471,3,35.75,>30,WI,Home,Upto 2014
CL Hooper,WI,Spin,1998-03-20,St John's,West Indies,1998,2,56,240,1,1,334,948,8,278,708,7,41.75,>30,WI,Home,Upto 2014
CL Hooper,WI,Spin,1998-11-26,Johannesburg,South Africa,1998,1,13,24,0,1,205,491,4,192,467,4,51.25,>30,SA,Away,Upto 2014
CL Hooper,WI,Spin,1998-12-10,Gqeberha,South Africa,1998,1,35,42,0,1,44,54,0,9,12,0,inf,>30,SA,Away,Upto 2014
CL Hooper,WI,Spin,1998-12-26,Durban,South Africa,1998,2,68,138,1,1,241,454,1,173,316,0,241.0,>30,SA,Away,Upto 2014
CL Hooper,WI,Spin,1999-01-02,Cape Town,South Africa,1999,2,112,330,3,1,319,696,6,207,366,3,53.166666666666664,>30,SA,Away,Upto 2014
CL Hooper,WI,Spin,1999-01-15,Centurion,South Africa,1999,2,144,320,4,1,279,568,9,135,248,5,31.0,>30,SA,Away,Upto 2014
CL Hooper,WI,Spin,1999-03-26,Bridgetown,West Indies,1999,1,50,94,2,1,408,819,7,358,725,5,58.285714285714285,>30,WI,Home,Upto 2014
CL Hooper,WI,Spin,1999-04-03,St John's,West Indies,1999,2,103,244,3,1,396,930,13,293,686,10,30.46153846153846,>30,WI,Home,Upto 2014
CL Hooper,WI,Spin,2001-03-09,Georgetown,West Indies,2001,2,44,132,0,1,353,904,9,309,772,9,39.22222222222222,>30,WI,Home,Upto 2014
CL Hooper,WI,Spin,2001-03-17,Port of Spain,West Indies,2001,2,48,132,0,1,234,564,4,186,432,4,58.5,>30,WI,Home,Upto 2014
CL Hooper,WI,Spin,2001-03-29,Bridgetown,West Indies,2001,2,80,312,2,1,341,1000,14,261,688,12,24.357142857142858,<=30,WI,Home,Upto 2014
CL Hooper,WI,Spin,2001-04-06,St John's,West Indies,2001,2,68,204,2,1,425,1266,13,357,1062,11,32.69230769230769,>30,WI,Home,Upto 2014
CL Hooper,WI,Spin,2001-04-19,Kingston,West Indies,2001,1,43,168,1,1,221,617,7,178,449,6,31.571428571428573,>30,WI,Home,Upto 2014
CL Hooper,WI,Spin,2001-07-19,Bulawayo,Zimbabwe,2001,2,43,132,0,1,317,696,7,274,564,7,45.285714285714285,>30,ZIM,Away,Upto 2014
CL Hooper,WI,Spin,2001-07-27,Harare,Zimbabwe,2001,1,86,168,1,1,386,944,10,300,776,9,38.6,>30,ZIM,Away,Upto 2014
CL Hooper,WI,Spin,2001-11-13,Galle,Sri Lanka,2001,1,59,144,0,1,681,1597,17,622,1453,17,40.05882352941177,>30,SL,Away,Upto 2014
CL Hooper,WI,Spin,2001-11-21,Kandy,Sri Lanka,2001,2,60,204,0,1,458,1038,19,398,834,19,24.105263157894736,<=30,SL,Away,Upto 2014
CL Hooper,WI,Spin,2001-11-29,Colombo (SSC),Sri Lanka,2001,1,112,258,2,1,542,1074,5,430,816,3,108.4,>30,SL,Away,Upto 2014
CL Hooper,WI,Spin,2002-01-31,Sharjah,UAE,2002,2,108,222,2,1,403,857,9,295,635,7,44.77777777777778,>30,UAE,Away,Upto 2014
CL Hooper,WI,Spin,2002-02-07,Sharjah,UAE,2002,1,41,42,0,1,492,929,10,451,887,10,49.2,>30,UAE,Away,Upto 2014
CL Hooper,WI,Spin,2002-04-11,Georgetown,West Indies,2002,1,16,72,0,1,369,751,4,353,679,4,92.25,>30,WI,Home,Upto 2014
CL Hooper,WI,Spin,2002-04-19,Port of Spain,West Indies,2002,2,55,168,1,1,184,491,4,129,323,3,46.0,>30,WI,Home,Upto 2014
CL Hooper,WI,Spin,2002-05-02,Bridgetown,West Indies,2002,1,11,30,0,1,125,277,5,114,247,5,25.0,<=30,WI,Home,Upto 2014
CL Hooper,WI,Spin,2002-05-10,St John's,West Indies,2002,1,29,78,0,1,261,672,7,232,594,7,37.285714285714285,>30,WI,Home,Upto 2014
CL Hooper,WI,Spin,2002-05-18,Kingston,West Indies,2002,2,20,36,0,1,212,410,9,192,374,9,23.555555555555557,<=30,WI,Home,Upto 2014
CL Hooper,WI,Spin,2002-06-21,Bridgetown,West Indies,2002,2,40,180,2,1,133,433,9,93,253,7,14.777777777777779,<=30,WI,Home,Upto 2014
CL Hooper,WI,Spin,2002-06-28,St George's,West Indies,2002,2,110,354,4,1,457,1176,9,347,822,5,50.77777777777778,>30,WI,Home,Upto 2014
CL Hooper,WI,Spin,2002-10-09,Wankhede,India,2002,1,40,71,1,1,416,1045,19,376,974,18,21.894736842105264,<=30,IND,Away,Upto 2014
CL Hooper,WI,Spin,2002-10-17,Chennai,India,2002,2,51,78,2,1,464,965,17,413,887,15,27.294117647058822,<=30,IND,Away,Upto 2014
CL Hooper,WI,Spin,2002-10-30,Eden Gardens,India,2002,2,99,210,1,1,592,1269,12,493,1059,11,49.333333333333336,>30,IND,Away,Upto 2014
CL Johnson,SA,Pace,1896-03-02,Johannesburg,South Africa,1896,1,57,140,0,1,539,922,24,482,782,24,22.458333333333332,<=30,SA,Home,After 1965
CL King,WI,Pace,1976-07-22,Leeds,England,1976,1,56,156,1,1,969,1786,39,913,1630,38,24.846153846153847,<=30,ENG,Away,Upto 2014
CL King,WI,Pace,1976-08-12,The Oval,England,1976,2,39,78,1,1,768,1323,20,729,1245,19,38.4,>30,ENG,Away,Upto 2014
CL King,WI,Pace,1977-04-15,Kingston,West Indies,1977,2,18,42,0,1,849,1372,30,831,1330,30,28.3,<=30,WI,Home,Upto 2014
CL King,WI,Pace,1979-12-01,Brisbane,Australia,1979,2,63,162,1,1,937,2006,27,874,1844,26,34.7037037037037,>30,AUS,Away,Upto 2014
CL King,WI,Pace,1980-02-08,Dunedin,New Zealand,1980,1,3,6,0,1,533,1670,35,530,1664,35,15.228571428571428,<=30,NZ,Away,Upto 2014
CL King,WI,Pace,1980-02-22,Christchurch,New Zealand,1980,1,70,54,0,1,946,1857,20,876,1803,20,47.3,>30,NZ,Away,Upto 2014
CL King,WI,Pace,1980-02-29,Auckland,New Zealand,1980,1,1,12,0,1,786,1985,29,785,1973,29,27.103448275862068,<=30,NZ,Away,Upto 2014
CL King,WI,Pace,1980-08-07,Leeds,England,1980,1,32,72,0,1,526,1199,25,494,1127,25,21.04,<=30,ENG,Away,Upto 2014
CL McCool,AUS,Spin,1946-03-29,Wellington,New Zealand,1946,1,0,2,1,1,63,182,11,63,180,10,5.7272727272727275,<=30,NZ,Away,Upto 2014
CL McCool,AUS,Spin,1946-11-29,Brisbane,Australia,1946,1,5,8,0,1,284,598,7,279,590,7,40.57142857142857,>30,AUS,Home,Upto 2014
CL McCool,AUS,Spin,1946-12-13,Sydney,Australia,1946,2,182,444,8,1,831,1933,19,649,1489,11,43.73684210526316,>30,AUS,Home,Upto 2014
CL McCool,AUS,Spin,1947-01-01,Melbourne,Australia,1947,2,94,344,3,1,582,1365,14,488,1021,11,41.57142857142857,>30,AUS,Home,Upto 2014
CL McCool,AUS,Spin,1947-01-31,Adelaide,Australia,1947,2,132,384,1,1,672,1532,8,540,1148,7,84.0,>30,AUS,Home,Upto 2014
CL McCool,AUS,Spin,1947-02-28,Sydney,Australia,1947,2,78,276,6,1,494,1134,15,416,858,9,32.93333333333333,>30,AUS,Home,Upto 2014
CL McCool,AUS,Spin,1947-12-12,Sydney,Australia,1947,1,71,144,3,1,208,752,16,137,608,13,13.0,<=30,AUS,Home,Upto 2014
CL McCool,AUS,Spin,1948-01-23,Adelaide,Australia,1948,2,128,256,1,1,689,1465,10,561,1209,9,68.9,>30,AUS,Home,Upto 2014
CL McCool,AUS,Spin,1949-12-24,Johannesburg,South Africa,1949,1,15,72,1,1,426,1143,20,411,1071,19,21.3,<=30,SA,Away,Upto 2014
CL McCool,AUS,Spin,1949-12-31,Cape Town,South Africa,1949,2,112,260,6,1,803,1732,19,691,1472,13,42.26315789473684,>30,SA,Away,Upto 2014
CL McCool,AUS,Spin,1950-01-20,Durban,South Africa,1950,1,35,104,0,1,552,1758,29,517,1654,29,19.03448275862069,<=30,SA,Away,Upto 2014
CL McCool,AUS,Spin,1950-02-10,Johannesburg,South Africa,1950,1,29,56,2,1,517,1176,4,488,1120,2,129.25,>30,SA,Away,Upto 2014
CL McCool,AUS,Spin,1950-03-03,Gqeberha,South Africa,1950,2,77,154,4,1,463,890,16,386,736,12,28.9375,<=30,SA,Away,Upto 2014
CL Smith,ENG,Spin,1983-08-25,Nottingham,England,1983,1,31,72,2,1,432,966,18,401,894,16,24.0,<=30,ENG,Home,Upto 2014
CL Smith,ENG,Spin,1984-01-20,Wellington,New Zealand,1984,1,6,18,0,1,205,579,4,199,561,4,51.25,>30,NZ,Away,Upto 2014
CL Smith,ENG,Spin,1984-03-19,Lahore,Pakistan,1984,2,2,12,1,1,562,1203,13,560,1191,12,43.23076923076923,>30,PAK,Away,Upto 2014
CL Townsend,ENG,Spin,1899-06-15,Lord's,England,1899,1,50,75,3,1,387,894,12,337,819,9,32.25,>30,ENG,Home,After 1965
CL Townsend,ENG,Spin,1899-08-14,The Oval,England,1899,2,25,65,0,1,465,899,10,440,834,10,46.5,>30,ENG,Home,After 1965
CL Vincent,SA,Spin,1927-12-24,Johannesburg,South Africa,1927,1,57,189,2,1,312,867,11,255,678,9,28.363636363636363,<=30,SA,Home,Upto 2014
CL Vincent,SA,Spin,1927-12-31,Cape Town,South Africa,1927,2,115,331,7,1,504,1376,23,389,1045,16,21.91304347826087,<=30,SA,Home,Upto 2014
CL Vincent,SA,Spin,1928-01-21,Durban,South Africa,1928,2,162,348,7,1,719,1581,22,557,1233,15,32.68181818181818,>30,SA,Home,Upto 2014
CL Vincent,SA,Spin,1928-01-28,Johannesburg,South Africa,1928,2,76,180,2,1,407,779,13,331,599,11,31.307692307692307,>30,SA,Home,Upto 2014
CL Vincent,SA,Spin,1928-02-04,Durban,South Africa,1928,2,107,288,5,1,423,969,13,316,681,8,32.53846153846154,>30,SA,Home,Upto 2014
CL Vincent,SA,Spin,1929-06-15,Birmingham,England,1929,2,92,156,0,1,416,1126,6,324,970,6,69.33333333333333,>30,ENG,Away,Upto 2014
CL Vincent,SA,Spin,1929-07-13,Leeds,England,1929,2,143,294,5,1,624,1466,25,481,1172,20,24.96,<=30,ENG,Away,Upto 2014
CL Vincent,SA,Spin,1929-07-27,Manchester,England,1929,1,93,204,2,1,374,874,16,281,670,14,23.375,<=30,ENG,Away,Upto 2014
CL Vincent,SA,Spin,1929-08-17,The Oval,England,1929,2,147,360,6,1,557,1110,10,410,750,4,55.7,>30,ENG,Away,Upto 2014
CL Vincent,SA,Spin,1930-12-24,Johannesburg,South Africa,1930,2,93,228,5,1,386,746,13,293,518,8,29.692307692307693,<=30,SA,Home,Upto 2014
CL Vincent,SA,Spin,1931-01-01,Cape Town,South Africa,1931,2,66,208,4,1,731,1678,19,665,1470,15,38.473684210526315,>30,SA,Home,Upto 2014
CL Vincent,SA,Spin,1931-01-16,Durban,South Africa,1931,1,66,150,1,1,228,660,10,162,510,9,22.8,<=30,SA,Home,Upto 2014
CL Vincent,SA,Spin,1931-02-13,Johannesburg,South Africa,1931,2,98,240,2,1,443,1089,15,345,849,13,29.533333333333335,<=30,SA,Home,Upto 2014
CL Vincent,SA,Spin,1931-02-21,Durban,South Africa,1931,1,51,188,6,1,436,1147,20,385,959,14,21.8,<=30,SA,Home,Upto 2014
CL Vincent,SA,Spin,1931-11-27,Brisbane,Australia,1931,1,100,204,3,1,332,1063,15,232,859,12,22.133333333333333,<=30,AUS,Away,Upto 2014
CL Vincent,SA,Spin,1931-12-18,Sydney,Australia,1931,1,75,144,2,1,364,897,16,289,753,14,22.75,<=30,AUS,Away,Upto 2014
CL Vincent,SA,Spin,1931-12-31,Melbourne,Australia,1931,2,186,402,4,1,678,1818,23,492,1416,19,29.47826086956522,<=30,AUS,Away,Upto 2014
CL Vincent,SA,Spin,1932-01-29,Adelaide,Australia,1932,2,141,246,1,1,610,1508,19,469,1262,18,32.10526315789474,>30,AUS,Away,Upto 2014
CL Vincent,SA,Spin,1932-02-12,Melbourne,Australia,1932,1,40,66,0,1,112,305,17,72,239,17,6.588235294117647,<=30,AUS,Away,Upto 2014
CL Vincent,SA,Spin,1932-02-27,Christchurch,New Zealand,1932,2,90,222,2,1,356,669,15,266,447,13,23.733333333333334,<=30,NZ,Away,Upto 2014
CL Vincent,SA,Spin,1932-03-04,Wellington,New Zealand,1932,1,32,36,0,1,627,1075,19,595,1039,19,33.0,>30,NZ,Away,Upto 2014
CL Vincent,SA,Spin,1935-06-15,Nottingham,England,1935,1,101,258,3,1,343,876,8,242,618,5,42.875,>30,ENG,Away,Upto 2014
CL Vincent,SA,Spin,1935-07-13,Leeds,England,1935,2,149,333,8,1,260,741,11,111,408,3,23.636363636363637,<=30,ENG,Away,Upto 2014
CL Vincent,SA,Spin,1935-07-27,Manchester,England,1935,2,163,324,5,1,449,1029,11,286,705,6,40.81818181818182,>30,ENG,Away,Upto 2014
CL Vincent,SA,Spin,1935-08-17,The Oval,England,1935,1,188,252,2,1,498,864,8,310,612,6,62.25,>30,ENG,Away,Upto 2014
CL Walcott,WI,Pace,1948-12-31,Eden Gardens,India,1948,1,12,18,0,1,577,1272,12,565,1254,12,48.083333333333336,>30,IND,Away,Upto 2014
CL Walcott,WI,Pace,1950-06-08,Manchester,England,1950,1,12,24,0,1,157,402,3,145,378,3,52.333333333333336,>30,ENG,Away,Upto 2014
CL Walcott,WI,Pace,1953-01-21,Port of Spain,West Indies,1953,1,12,96,2,1,431,1261,9,419,1165,7,47.888888888888886,>30,WI,Home,Upto 2014
CL Walcott,WI,Pace,1953-02-19,Port of Spain,West Indies,1953,1,13,42,0,1,346,1003,10,333,961,10,34.6,>30,WI,Home,Upto 2014
CL Walcott,WI,Pace,1953-03-11,Georgetown,West Indies,1953,1,8,18,0,1,150,444,4,142,426,4,37.5,>30,WI,Home,Upto 2014
CL Walcott,WI,Pace,1953-03-28,Kingston,West Indies,1953,2,15,54,0,1,439,1284,11,424,1230,11,39.90909090909091,>30,WI,Home,Upto 2014
CL Walcott,WI,Pace,1954-01-15,Kingston,West Indies,1954,1,4,12,0,1,630,1500,20,626,1488,20,31.5,>30,WI,Home,Upto 2014
CL Walcott,WI,Pace,1954-02-06,Bridgetown,West Indies,1954,1,4,12,0,1,376,820,10,372,808,10,37.6,>30,WI,Home,Upto 2014
CL Walcott,WI,Pace,1954-02-24,Georgetown,West Indies,1954,2,8,24,0,1,302,702,8,294,678,8,37.75,>30,WI,Home,Upto 2014
CL Walcott,WI,Pace,1954-03-17,Port of Spain,West Indies,1954,1,52,204,3,1,458,1100,10,406,896,7,45.8,>30,WI,Home,Upto 2014
CL Walcott,WI,Pace,1954-03-30,Kingston,West Indies,1954,1,26,66,1,1,363,910,17,337,844,16,21.352941176470587,<=30,WI,Home,Upto 2014
CL Walcott,WI,Pace,1955-03-26,Kingston,West Indies,1955,1,50,156,3,1,487,1027,18,437,871,15,27.055555555555557,<=30,WI,Home,Upto 2014
CL Walcott,WI,Pace,1955-04-11,Port of Spain,West Indies,1955,1,45,114,1,1,686,1163,14,641,1049,13,49.0,>30,WI,Home,Upto 2014
CL Walcott,WI,Pace,1955-05-14,Bridgetown,West Indies,1955,1,57,156,0,1,574,1002,10,517,846,10,57.4,>30,WI,Home,Upto 2014
CL Walcott,WI,Pace,1957-07-04,Nottingham,England,1957,1,4,6,0,1,642,1416,17,638,1410,17,37.76470588235294,>30,ENG,Away,Upto 2014
CL Walcott,WI,Pace,1958-01-17,Bridgetown,West Indies,1958,1,10,60,0,1,627,1370,15,617,1310,15,41.8,>30,WI,Home,Upto 2014
CL Walcott,WI,Pace,1958-03-26,Port of Spain,West Indies,1958,1,6,12,0,1,413,869,16,407,857,16,25.8125,<=30,WI,Home,Upto 2014
CL Walcott,WI,Pace,1960-03-09,Georgetown,West Indies,1960,1,43,54,1,1,483,950,12,440,896,11,40.25,>30,WI,Home,Upto 2014
CL Walcott,WI,Pace,1960-03-25,Port of Spain,West Indies,1960,2,27,66,0,1,604,1109,11,577,1043,11,54.90909090909091,>30,WI,Home,Upto 2014
CL White,AUS,Spin,2008-10-09,Bengaluru,India,2008,2,88,186,1,1,536,1200,6,448,1014,5,89.33333333333333,>30,IND,Away,Upto 2014
CL White,AUS,Spin,2008-10-17,Mohali,India,2008,2,119,162,3,1,362,764,15,243,602,12,24.133333333333333,<=30,IND,Away,Upto 2014
CL White,AUS,Spin,2008-10-29,Delhi,India,2008,2,96,138,1,1,668,1278,12,572,1140,11,55.666666666666664,>30,IND,Away,Upto 2014
CL White,AUS,Spin,2008-11-06,Nagpur,India,2008,2,39,72,0,1,751,1259,24,712,1187,24,31.291666666666668,>30,IND,Away,Upto 2014
CM Francois,SA,Pace,1922-12-23,Johannesburg,South Africa,1922,2,75,234,4,1,634,1476,30,559,1242,26,21.133333333333333,<=30,SA,Home,Upto 2014
CM Francois,SA,Pace,1923-01-01,Cape Town,South Africa,1923,2,17,42,0,1,417,1260,23,400,1218,23,18.130434782608695,<=30,SA,Home,Upto 2014
CM Francois,SA,Pace,1923-01-18,Durban,South Africa,1923,1,55,180,0,1,496,1373,16,441,1193,16,31.0,>30,SA,Home,Upto 2014
CM Francois,SA,Pace,1923-02-09,Johannesburg,South Africa,1923,2,30,114,0,1,723,1725,22,693,1611,22,32.86363636363637,>30,SA,Home,Upto 2014
CM Francois,SA,Pace,1923-02-16,Durban,South Africa,1923,2,48,114,2,1,724,2332,33,676,2218,31,21.939393939393938,<=30,SA,Home,Upto 2014
CM Kuggeleijn,NZ,Spin,1988-11-12,Bengaluru,India,1988,1,50,78,1,1,620,1702,21,570,1624,20,29.523809523809526,<=30,IND,Away,Upto 2014
CM Kuggeleijn,NZ,Spin,1988-12-02,Hyderabad (Deccan),India,1988,2,17,19,0,1,319,748,13,302,729,13,24.53846153846154,<=30,IND,Away,Upto 2014
CM Old,ENG,Pace,1972-12-30,Eden Gardens,India,1972,2,115,282,6,1,194,522,10,79,240,4,19.4,<=30,IND,Away,Upto 2014
CM Old,ENG,Pace,1973-01-12,Chennai,India,1973,2,70,174,2,1,119,343,5,49,169,3,23.8,<=30,IND,Away,Upto 2014
CM Old,ENG,Pace,1973-01-25,Kanpur,India,1973,2,97,210,4,1,253,624,7,156,414,3,36.142857142857146,>30,IND,Away,Upto 2014
CM Old,ENG,Pace,1973-02-06,Brabourne,India,1973,2,89,146,3,1,226,386,7,137,240,4,32.285714285714285,>30,IND,Away,Upto 2014
CM Old,ENG,Pace,1973-03-02,Lahore,Pakistan,1973,1,98,162,0,1,401,966,6,303,804,6,66.83333333333333,>30,PAK,Away,Upto 2014
CM Old,ENG,Pace,1973-06-21,Lord's,England,1973,1,113,251,5,1,777,1763,19,664,1512,14,40.89473684210526,>30,ENG,Home,Upto 2014
CM Old,ENG,Pace,1973-07-05,Leeds,England,1973,2,112,204,6,1,624,1466,29,512,1262,23,21.517241379310345,<=30,ENG,Home,Upto 2014
CM Old,ENG,Pace,1973-08-09,Birmingham,England,1973,2,151,264,4,1,555,1416,18,404,1152,14,30.833333333333332,>30,ENG,Home,Upto 2014
CM Old,ENG,Pace,1974-02-02,Port of Spain,West Indies,1974,2,107,142,3,1,308,634,10,201,492,7,30.8,>30,WI,Away,Upto 2014
CM Old,ENG,Pace,1974-02-16,Kingston,West Indies,1974,1,72,138,2,1,383,780,10,311,642,8,38.3,>30,WI,Away,Upto 2014
CM Old,ENG,Pace,1974-03-06,Bridgetown,West Indies,1974,1,102,168,0,1,627,1356,14,525,1188,14,44.785714285714285,>30,WI,Away,Upto 2014
CM Old,ENG,Pace,1974-03-22,Georgetown,West Indies,1974,1,32,78,0,1,242,634,5,210,556,5,48.4,>30,WI,Away,Upto 2014
CM Old,ENG,Pace,1974-06-06,Manchester,England,1974,2,66,192,5,1,464,1137,20,398,945,15,23.2,<=30,ENG,Home,Upto 2014
CM Old,ENG,Pace,1974-06-20,Lord's,England,1974,2,88,174,9,1,408,797,19,320,623,10,21.473684210526315,<=30,ENG,Home,Upto 2014
CM Old,ENG,Pace,1974-07-04,Birmingham,England,1974,2,95,168,4,1,333,648,16,238,480,12,20.8125,<=30,ENG,Home,Upto 2014
CM Old,ENG,Pace,1974-07-25,Leeds,England,1974,2,119,228,6,1,703,1746,31,584,1518,25,22.677419354838708,<=30,ENG,Home,Upto 2014
CM Old,ENG,Pace,1974-08-08,Lord's,England,1974,2,56,114,0,1,356,858,8,300,744,8,44.5,>30,ENG,Home,Upto 2014
CM Old,ENG,Pace,1974-08-22,The Oval,England,1974,2,149,189,1,1,675,1389,8,526,1200,7,84.375,>30,ENG,Home,Upto 2014
CM Old,ENG,Pace,1974-12-13,W.A.C.A,Australia,1974,1,85,182,3,1,728,1672,24,643,1490,21,30.333333333333332,>30,AUS,Away,Upto 2014
CM Old,ENG,Pace,1975-02-08,Melbourne,Australia,1975,2,125,232,3,1,711,1562,25,586,1330,22,28.44,<=30,AUS,Away,Upto 2014
CM Old,ENG,Pace,1975-02-20,Auckland,New Zealand,1975,1,17,56,1,1,616,1261,8,599,1205,7,77.0,>30,NZ,Away,Upto 2014
CM Old,ENG,Pace,1975-07-10,Birmingham,England,1975,1,111,198,2,1,502,1221,27,391,1023,25,18.59259259259259,<=30,ENG,Home,Upto 2014
CM Old,ENG,Pace,1975-08-14,Leeds,England,1975,2,91,168,2,1,612,1447,21,521,1279,19,29.142857142857142,<=30,ENG,Home,Upto 2014
CM Old,ENG,Pace,1975-08-28,The Oval,England,1975,2,81,180,3,1,686,1764,24,605,1584,21,28.583333333333332,<=30,ENG,Home,Upto 2014
CM Old,ENG,Pace,1976-06-03,Nottingham,England,1976,2,144,267,4,1,773,1761,21,629,1494,17,36.80952380952381,>30,ENG,Home,Upto 2014
CM Old,ENG,Pace,1976-06-17,Lord's,England,1976,2,104,144,2,1,584,1335,24,480,1191,22,24.333333333333332,<=30,ENG,Home,Upto 2014
CM Old,ENG,Pace,1976-12-17,Delhi,India,1976,2,34,101,2,1,217,567,13,183,466,11,16.692307692307693,<=30,IND,Away,Upto 2014
CM Old,ENG,Pace,1977-01-01,Eden Gardens,India,1977,2,75,192,5,1,233,654,15,158,462,10,15.533333333333333,<=30,IND,Away,Upto 2014
CM Old,ENG,Pace,1977-01-14,Chennai,India,1977,2,30,108,2,1,275,772,15,245,664,13,18.333333333333332,<=30,IND,Away,Upto 2014
CM Old,ENG,Pace,1977-01-28,Bengaluru,India,1977,2,62,132,1,1,275,606,12,213,474,11,22.916666666666668,<=30,IND,Away,Upto 2014
CM Old,ENG,Pace,1977-03-12,Melbourne,Australia,1977,2,143,318,7,1,769,1725,30,626,1407,23,25.633333333333333,<=30,AUS,Away,Upto 2014
CM Old,ENG,Pace,1977-06-16,Lord's,England,1977,2,116,294,4,1,753,1756,32,637,1462,28,23.53125,<=30,ENG,Home,Upto 2014
CM Old,ENG,Pace,1977-07-07,Manchester,England,1977,2,83,168,1,1,525,1242,14,442,1074,13,37.5,>30,ENG,Home,Upto 2014
CM Old,ENG,Pace,1977-12-14,Lahore,Pakistan,1977,2,81,200,1,1,359,1064,11,278,864,10,32.63636363636363,>30,PAK,Away,Upto 2014
CM Old,ENG,Pace,1978-02-10,Wellington,New Zealand,1978,2,86,312,7,1,523,1920,38,437,1608,31,13.763157894736842,<=30,NZ,Away,Upto 2014
CM Old,ENG,Pace,1978-02-24,Christchurch,New Zealand,1978,2,64,168,1,1,664,1812,24,600,1644,23,27.666666666666668,<=30,NZ,Away,Upto 2014
CM Old,ENG,Pace,1978-06-01,Birmingham,England,1978,2,88,286,8,1,618,1454,19,530,1168,11,32.526315789473685,>30,ENG,Home,Upto 2014
CM Old,ENG,Pace,1978-06-15,Lord's,England,1978,2,62,150,1,1,397,739,22,335,589,21,18.045454545454547,<=30,ENG,Home,Upto 2014
CM Old,ENG,Pace,1978-06-29,Leeds,England,1978,1,41,250,4,1,225,754,16,184,504,12,14.0625,<=30,ENG,Home,Upto 2014
CM Old,ENG,Pace,1978-07-27,The Oval,England,1978,2,56,150,1,1,503,1390,19,447,1240,18,26.473684210526315,<=30,ENG,Home,Upto 2014
CM Old,ENG,Pace,1978-12-01,Brisbane,Australia,1978,2,84,215,4,1,633,1750,28,549,1535,24,22.607142857142858,<=30,AUS,Away,Upto 2014
CM Old,ENG,Pace,1980-08-07,Leeds,England,1980,1,64,173,2,1,526,1199,25,462,1026,23,21.04,<=30,ENG,Home,Upto 2014
CM Old,ENG,Pace,1980-08-28,Lord's,England,1980,2,138,330,6,1,636,1262,19,498,932,13,33.473684210526315,>30,ENG,Home,Upto 2014
CM Old,ENG,Pace,1981-02-13,Port of Spain,West Indies,1981,1,49,96,1,1,521,1338,21,472,1242,20,24.80952380952381,<=30,WI,Away,Upto 2014
CM Old,ENG,Pace,1981-07-16,Leeds,England,1981,2,112,312,1,1,892,1859,38,780,1547,37,23.473684210526315,<=30,ENG,Home,Upto 2014
CM Old,ENG,Pace,1981-07-30,Birmingham,England,1981,2,63,192,4,1,525,1321,25,462,1129,21,21.0,<=30,ENG,Home,Upto 2014
CM Willoughby,SA,Pace,2003-04-24,Chattogram,Bangladesh,2003,2,79,180,1,1,514,1056,11,435,876,10,46.72727272727273,>30,BAN,Away,Upto 2014
CM Willoughby,SA,Pace,2003-07-24,Birmingham,England,2003,1,46,120,0,1,873,1408,14,827,1288,14,62.357142857142854,>30,ENG,Away,Upto 2014
CN Evans,ZIM,Pace,1996-09-11,Colombo (RPS),Sri Lanka,1996,1,27,36,0,1,295,564,9,268,528,9,32.77777777777778,>30,SL,Away,Upto 2014
CN Evans,ZIM,Pace,1998-10-07,Harare,Zimbabwe,1998,1,8,18,0,1,643,1431,26,635,1413,26,24.73076923076923,<=30,ZIM,Home,Upto 2014
CN McCarthy,SA,Pace,1948-12-16,Durban,South Africa,1948,2,63,168,6,1,290,749,16,227,581,10,18.125,<=30,SA,Home,Upto 2014
CN McCarthy,SA,Pace,1948-12-27,Johannesburg,South Africa,1948,1,102,208,3,1,428,1173,8,326,965,5,53.5,>30,SA,Home,Upto 2014
CN McCarthy,SA,Pace,1949-01-01,Cape Town,South Africa,1949,2,170,368,3,1,484,1256,6,314,888,3,80.66666666666667,>30,SA,Home,Upto 2014
CN McCarthy,SA,Pace,1949-02-12,Johannesburg,South Africa,1949,2,164,385,7,1,558,1385,18,394,1000,11,31.0,>30,SA,Home,Upto 2014
CN McCarthy,SA,Pace,1949-03-05,Gqeberha,South Africa,1949,2,62,156,2,1,319,1001,10,257,845,8,31.9,>30,SA,Home,Upto 2014
CN McCarthy,SA,Pace,1949-12-24,Johannesburg,South Africa,1949,1,90,200,2,1,273,736,9,183,536,7,30.333333333333332,>30,SA,Home,Upto 2014
CN McCarthy,SA,Pace,1949-12-31,Cape Town,South Africa,1949,2,116,224,0,1,378,860,10,262,636,10,37.8,>30,SA,Home,Upto 2014
CN McCarthy,SA,Pace,1950-01-20,Durban,South Africa,1950,2,40,144,0,1,229,704,5,189,560,5,45.8,>30,SA,Home,Upto 2014
CN McCarthy,SA,Pace,1950-02-10,Johannesburg,South Africa,1950,2,169,352,3,1,524,1232,15,355,880,12,34.93333333333333,>30,SA,Home,Upto 2014
CN McCarthy,SA,Pace,1950-03-03,Gqeberha,South Africa,1950,1,121,232,0,1,363,833,11,242,601,11,33.0,>30,SA,Home,Upto 2014
CN McCarthy,SA,Pace,1951-06-07,Nottingham,England,1951,2,112,336,5,1,538,1446,18,426,1110,13,29.88888888888889,<=30,ENG,Away,Upto 2014
CN McCarthy,SA,Pace,1951-06-21,Lord's,England,1951,1,76,138,4,1,253,682,13,177,544,9,19.46153846153846,<=30,ENG,Away,Upto 2014
CN McCarthy,SA,Pace,1951-07-05,Manchester,England,1951,2,82,198,0,1,355,980,20,273,782,20,17.75,<=30,ENG,Away,Upto 2014
CN McCarthy,SA,Pace,1951-07-26,Leeds,England,1951,1,81,246,0,1,354,984,3,273,738,3,118.0,>30,ENG,Away,Upto 2014
CN McCarthy,SA,Pace,1951-08-16,The Oval,England,1951,2,62,144,1,1,309,956,16,247,812,15,19.3125,<=30,ENG,Away,Upto 2014
COC Pearse,SA,Pace,1910-12-09,Sydney,Australia,1910,1,56,72,3,1,517,899,22,461,827,19,23.5,<=30,AUS,Away,Upto 2014
COC Pearse,SA,Pace,1911-03-03,Sydney,Australia,1911,2,50,72,0,1,447,806,13,397,734,13,34.38461538461539,>30,AUS,Away,Upto 2014
CP Buckenham,ENG,Pace,1910-01-01,Johannesburg,South Africa,1910,2,187,348,7,1,440,846,11,253,498,4,40.0,>30,SA,Away,Upto 2014
CP Buckenham,ENG,Pace,1910-01-21,Durban,South Africa,1910,2,145,348,5,1,379,1058,15,234,710,10,25.266666666666666,<=30,SA,Away,Upto 2014
CP Buckenham,ENG,Pace,1910-02-26,Johannesburg,South Africa,1910,2,188,324,5,1,366,667,10,178,343,5,36.6,>30,SA,Away,Upto 2014
CP Buckenham,ENG,Pace,1910-03-07,Cape Town,South Africa,1910,2,73,162,4,1,321,621,18,248,459,14,17.833333333333332,<=30,SA,Away,Upto 2014
CP Carter,SA,Spin,1912-06-10,Lord's,England,1912,1,15,24,0,1,275,582,7,260,558,7,39.285714285714285,>30,ENG,Away,Upto 2014
CP Carter,SA,Spin,1912-07-08,Leeds,England,1912,2,30,54,0,1,384,746,14,354,692,14,27.428571428571427,<=30,ENG,Away,Upto 2014
CP Carter,SA,Spin,1914-02-14,Durban,South Africa,1914,2,77,342,7,1,337,984,14,260,642,7,24.071428571428573,<=30,SA,Home,Upto 2014
CP Carter,SA,Spin,1914-02-27,Gqeberha,South Africa,1914,1,111,246,2,1,377,889,10,266,643,8,37.7,>30,SA,Home,Upto 2014
CP Carter,SA,Spin,1921-11-05,Durban,South Africa,1921,2,134,246,6,1,340,702,10,206,456,4,34.0,>30,SA,Home,Upto 2014
CP Carter,SA,Spin,1921-11-12,Johannesburg,South Africa,1921,1,91,179,6,1,332,785,12,241,606,6,27.666666666666668,<=30,SA,Home,Upto 2014
CP Carter,SA,Spin,1921-11-26,Cape Town,South Africa,1921,1,104,156,3,1,400,850,17,296,694,14,23.529411764705884,<=30,SA,Home,Upto 2014
CP Carter,SA,Spin,1924-07-12,Leeds,England,1924,1,47,90,1,1,557,1271,20,510,1181,19,27.85,<=30,ENG,Away,Upto 2014
CP Carter,SA,Spin,1924-08-16,The Oval,England,1924,1,85,138,3,1,425,954,15,340,816,12,28.333333333333332,<=30,ENG,Away,Upto 2014
CP Schofield,ENG,Spin,2000-06-01,Nottingham,England,2000,1,73,108,0,1,131,266,2,58,158,2,65.5,>30,ENG,Home,Upto 2014
CPH Ramanayake,SL,Pace,1988-02-12,W.A.C.A,Australia,1988,1,58,102,0,1,710,1536,29,652,1434,29,24.482758620689655,<=30,AUS,Away,Upto 2014
CPH Ramanayake,SL,Pace,1988-08-25,Lord's,England,1988,1,86,164,2,1,947,1904,31,861,1740,29,30.548387096774192,>30,ENG,Away,Upto 2014
CPH Ramanayake,SL,Pace,1989-12-08,Brisbane,Australia,1989,2,182,324,4,1,901,1884,23,719,1560,19,39.17391304347826,>30,AUS,Away,Upto 2014
CPH Ramanayake,SL,Pace,1989-12-16,Hobart,Australia,1989,2,70,84,0,1,998,1920,27,928,1836,27,36.96296296296296,>30,AUS,Away,Upto 2014
CPH Ramanayake,SL,Pace,1991-01-31,Wellington,New Zealand,1991,2,161,306,4,1,940,1788,23,779,1482,19,40.869565217391305,>30,NZ,Away,Upto 2014
CPH Ramanayake,SL,Pace,1991-02-22,Hamilton,New Zealand,1991,2,149,318,4,1,916,2000,25,767,1682,21,36.64,>30,NZ,Away,Upto 2014
CPH Ramanayake,SL,Pace,1991-03-01,Auckland,New Zealand,1991,2,158,270,3,1,890,1772,29,732,1502,26,30.689655172413794,>30,NZ,Away,Upto 2014
CPH Ramanayake,SL,Pace,1991-08-22,Lord's,England,1991,2,161,264,2,1,770,1537,23,609,1273,21,33.47826086956522,>30,ENG,Away,Upto 2014
CPH Ramanayake,SL,Pace,1991-12-12,Sialkot,Pakistan,1991,1,75,198,0,1,611,1329,14,536,1131,14,43.642857142857146,>30,PAK,Away,Upto 2014
CPH Ramanayake,SL,Pace,1991-12-20,Gujranwala,Pakistan,1991,1,16,60,0,1,97,210,2,81,150,2,48.5,>30,PAK,Away,Upto 2014
CPH Ramanayake,SL,Pace,1992-08-17,Colombo (SSC),Sri Lanka,1992,2,164,342,6,1,793,1548,19,629,1206,13,41.73684210526316,>30,SL,Home,Upto 2014
CPH Ramanayake,SL,Pace,1992-08-28,Colombo (RPS),Sri Lanka,1992,2,113,213,3,1,531,1227,20,418,1014,17,26.55,<=30,SL,Home,Upto 2014
CPH Ramanayake,SL,Pace,1992-09-08,Moratuwa,Sri Lanka,1992,2,157,319,8,1,511,1044,22,354,725,14,23.227272727272727,<=30,SL,Home,Upto 2014
CPH Ramanayake,SL,Pace,1992-11-27,Moratuwa,Sri Lanka,1992,2,84,240,3,1,602,1223,13,518,983,10,46.30769230769231,>30,SL,Home,Upto 2014
CPH Ramanayake,SL,Pace,1993-03-13,Colombo (SSC),Sri Lanka,1993,2,82,120,1,1,382,857,11,300,737,10,34.72727272727273,>30,SL,Home,Upto 2014
CPH Ramanayake,SL,Pace,1993-09-06,Colombo (SSC),Sri Lanka,1993,1,63,120,0,1,464,972,21,401,852,21,22.095238095238095,<=30,SL,Home,Upto 2014
CPH Ramanayake,SL,Pace,1993-09-14,Colombo (PSS),Sri Lanka,1993,2,101,210,4,1,422,1175,13,321,965,9,32.46153846153846,>30,SL,Home,Upto 2014
CPS Chauhan,IND,Spin,1978-10-16,Faisalabad,Pakistan,1978,1,26,30,0,1,700,1410,15,674,1380,15,46.666666666666664,>30,PAK,Away,Upto 2014
CPS Chauhan,IND,Spin,1978-11-14,Karachi,Pakistan,1978,1,3,6,0,1,383,654,5,380,648,5,76.6,>30,PAK,Away,Upto 2014
CPS Chauhan,IND,Spin,1978-12-01,Wankhede,India,1978,1,2,6,0,1,556,1295,9,554,1289,9,61.77777777777778,>30,IND,Home,Upto 2014
CPS Chauhan,IND,Spin,1979-07-12,Birmingham,England,1979,1,19,18,0,1,393,774,2,374,756,2,196.5,>30,ENG,Away,Upto 2014
CPS Chauhan,IND,Spin,1979-10-13,Delhi,India,1979,1,11,30,1,1,604,1308,12,593,1278,11,50.333333333333336,>30,IND,Home,Upto 2014
CPS Chauhan,IND,Spin,1979-10-26,Eden Gardens,India,1979,1,11,24,0,1,581,1386,14,570,1362,14,41.5,>30,IND,Home,Upto 2014
CPS Chauhan,IND,Spin,1981-01-02,Sydney,Australia,1981,1,10,6,0,1,158,276,4,148,270,4,39.5,>30,AUS,Away,Upto 2014
CPS Chauhan,IND,Spin,1981-02-07,Melbourne,Australia,1981,1,8,12,0,1,474,1128,11,466,1116,11,43.09090909090909,>30,AUS,Away,Upto 2014
CPS Chauhan,IND,Spin,1981-03-06,Christchurch,New Zealand,1981,1,12,30,0,1,157,612,3,145,582,3,52.333333333333336,>30,NZ,Away,Upto 2014
CPS Chauhan,IND,Spin,1981-03-13,Auckland,New Zealand,1981,1,4,12,1,1,519,1803,22,515,1791,21,23.59090909090909,<=30,NZ,Away,Upto 2014
CR Brathwaite,WI,Pace,2015-12-26,Melbourne,Australia,2015,2,139,216,1,1,837,1482,18,698,1266,17,46.5,>30,AUS,Away,After 1965
CR Brathwaite,WI,Pace,2016-01-03,Sydney,Australia,2016,1,23,42,0,1,234,354,3,211,312,3,78.0,>30,AUS,Away,After 1965
CR Brathwaite,WI,Pace,2016-07-21,North Sound,West Indies,2016,1,80,150,0,1,466,972,12,386,822,12,38.833333333333336,>30,WI,Home,After 1965
CR Browne,WI,Pace,1928-06-23,Lord's,England,1928,1,53,132,0,1,399,886,12,346,754,12,33.25,>30,ENG,Away,Upto 2014
CR Browne,WI,Pace,1928-07-21,Manchester,England,1928,1,72,150,2,1,337,660,7,265,510,5,48.142857142857146,>30,ENG,Away,Upto 2014
CR Browne,WI,Pace,1930-01-11,Bridgetown,West Indies,1930,2,102,300,2,1,797,1692,15,695,1392,13,53.13333333333333,>30,WI,Home,Upto 2014
CR Browne,WI,Pace,1930-02-21,Georgetown,West Indies,1930,2,61,258,2,1,688,1706,25,627,1448,23,27.52,<=30,WI,Home,Upto 2014
CR Matthews,SA,Pace,1992-11-26,Johannesburg,South Africa,1992,2,64,294,4,1,741,2035,23,677,1741,19,32.21739130434783,>30,SA,Home,Upto 2014
CR Matthews,SA,Pace,1992-12-26,Gqeberha,South Africa,1992,2,77,156,1,1,485,1194,23,408,1038,22,21.08695652173913,<=30,SA,Home,Upto 2014
CR Matthews,SA,Pace,1993-01-02,Cape Town,South Africa,1993,2,49,204,4,1,434,1582,19,385,1378,15,22.842105263157894,<=30,SA,Home,Upto 2014
CR Matthews,SA,Pace,1993-12-26,Melbourne,Australia,1993,1,68,144,3,1,399,858,6,331,714,3,66.5,>30,AUS,Away,Upto 2014
CR Matthews,SA,Pace,1994-01-02,Sydney,Australia,1994,2,53,204,0,1,459,1326,25,406,1122,25,18.36,<=30,AUS,Away,Upto 2014
CR Matthews,SA,Pace,1994-03-04,Johannesburg,South Africa,1994,2,82,210,4,1,852,1646,28,770,1436,24,30.428571428571427,>30,SA,Home,Upto 2014
CR Matthews,SA,Pace,1994-03-17,Cape Town,South Africa,1994,2,94,252,5,1,830,1910,22,736,1658,17,37.72727272727273,>30,SA,Home,Upto 2014
CR Matthews,SA,Pace,1994-03-25,Durban,South Africa,1994,2,121,342,4,1,810,2116,20,689,1774,16,40.5,>30,SA,Home,Upto 2014
CR Matthews,SA,Pace,1994-07-21,Lord's,England,1994,2,71,180,3,1,636,1408,31,565,1228,28,20.516129032258064,<=30,ENG,Away,Upto 2014
CR Matthews,SA,Pace,1994-08-04,Leeds,England,1994,2,150,378,2,1,1145,2209,21,995,1831,19,54.523809523809526,>30,ENG,Away,Upto 2014
CR Matthews,SA,Pace,1994-08-18,The Oval,England,1994,2,119,195,3,1,962,1490,30,843,1295,27,32.06666666666667,>30,ENG,Away,Upto 2014
CR Matthews,SA,Pace,1994-11-25,Johannesburg,South Africa,1994,2,140,282,8,1,787,1709,30,647,1427,22,26.233333333333334,<=30,SA,Home,Upto 2014
CR Matthews,SA,Pace,1994-12-26,Durban,South Africa,1994,2,54,186,0,1,610,1681,28,556,1495,28,21.785714285714285,<=30,SA,Home,Upto 2014
CR Matthews,SA,Pace,1995-03-04,Auckland,New Zealand,1995,2,113,269,5,1,789,1800,31,676,1531,26,25.451612903225808,<=30,NZ,Away,Upto 2014
CR Matthews,SA,Pace,1995-10-13,Harare,Zimbabwe,1995,2,82,198,2,1,728,1549,32,646,1351,30,22.75,<=30,ZIM,Away,Upto 2014
CR Matthews,SA,Pace,1995-11-16,Centurion,South Africa,1995,1,63,180,0,1,364,846,9,301,666,9,40.44444444444444,>30,SA,Home,Upto 2014
CR Matthews,SA,Pace,1995-12-14,Durban,South Africa,1995,1,31,72,3,1,320,703,12,289,631,9,26.666666666666668,<=30,SA,Home,Upto 2014
CR Matthews,SA,Pace,1995-12-26,Gqeberha,South Africa,1995,2,71,234,1,1,681,1783,21,610,1549,20,32.42857142857143,>30,SA,Home,Upto 2014
CR Miller,AUS,Spin,1998-10-01,Rawalpindi,Pakistan,1998,2,95,264,3,1,561,1319,19,466,1055,16,29.526315789473685,<=30,PAK,Away,Upto 2014
CR Miller,AUS,Spin,1998-10-15,Peshawar,Pakistan,1998,1,99,228,1,1,751,1422,7,652,1194,6,107.28571428571429,>30,PAK,Away,Upto 2014
CR Miller,AUS,Spin,1998-10-22,Karachi,Pakistan,1998,2,135,234,4,1,832,1892,24,697,1658,20,34.666666666666664,>30,PAK,Away,Upto 2014
CR Miller,AUS,Spin,1998-11-28,W.A.C.A,Australia,1998,2,15,72,1,1,27,84,2,12,12,1,13.5,<=30,AUS,Home,Upto 2014
CR Miller,AUS,Spin,1998-12-11,Adelaide,Australia,1998,2,128,282,5,1,473,1152,14,345,870,9,33.785714285714285,>30,AUS,Home,Upto 2014
CR Miller,AUS,Spin,1999-01-02,Sydney,Australia,1999,2,95,240,3,1,526,1105,23,431,865,20,22.869565217391305,<=30,AUS,Home,Upto 2014
CR Miller,AUS,Spin,1999-04-03,St John's,West Indies,1999,2,66,228,3,1,396,930,13,330,702,10,30.46153846153846,>30,WI,Away,Upto 2014
CR Miller,AUS,Spin,1999-09-09,Kandy,Sri Lanka,1999,2,110,201,7,1,373,779,20,263,578,13,18.65,<=30,SL,Away,Upto 2014
CR Miller,AUS,Spin,1999-09-22,Galle,Sri Lanka,1999,2,81,156,1,1,307,827,13,226,671,12,23.615384615384617,<=30,SL,Away,Upto 2014
CR Miller,AUS,Spin,1999-09-30,Colombo (SSC),Sri Lanka,1999,1,2,6,0,1,278,654,6,276,648,6,46.333333333333336,>30,SL,Away,Upto 2014
CR Miller,AUS,Spin,1999-10-14,Harare,Zimbabwe,1999,2,102,318,3,1,296,763,10,194,445,7,29.6,<=30,ZIM,Away,Upto 2014
CR Miller,AUS,Spin,2000-03-11,Auckland,New Zealand,2000,2,93,240,6,1,549,1142,28,456,902,22,19.607142857142858,<=30,NZ,Away,Upto 2014
CR Miller,AUS,Spin,2000-03-24,Wellington,New Zealand,2000,2,132,246,4,1,361,635,13,229,389,9,27.76923076923077,<=30,NZ,Away,Upto 2014
CR Miller,AUS,Spin,2000-03-31,Hamilton,New Zealand,2000,2,86,186,2,1,265,576,9,179,390,7,29.444444444444443,<=30,NZ,Away,Upto 2014
CR Miller,AUS,Spin,2000-12-15,Adelaide,Australia,2000,2,113,317,10,1,394,779,14,281,462,4,28.142857142857142,<=30,AUS,Home,Upto 2014
CR Miller,AUS,Spin,2000-12-26,Melbourne,Australia,2000,2,77,165,4,1,195,381,6,118,216,2,32.5,>30,AUS,Home,Upto 2014
CR Miller,AUS,Spin,2001-01-02,Sydney,Australia,2001,2,175,378,6,1,641,1329,18,466,951,12,35.611111111111114,>30,AUS,Home,Upto 2014
CR Miller,AUS,Spin,2001-03-18,Chennai,India,2001,2,201,330,6,1,924,1783,26,723,1453,20,35.53846153846154,>30,IND,Away,Upto 2014
CR Rangachari,IND,Pace,1948-01-23,Adelaide,Australia,1948,1,141,328,4,1,583,1360,19,442,1032,15,30.68421052631579,>30,AUS,Away,Upto 2014
CR Rangachari,IND,Pace,1948-02-06,Melbourne,Australia,1948,1,97,136,0,1,469,1146,14,372,1010,14,33.5,>30,AUS,Away,Upto 2014
CR Rangachari,IND,Pace,1948-11-10,Delhi,India,1948,1,107,178,5,1,457,956,11,350,778,6,41.54545454545455,>30,IND,Home,Upto 2014
CR Rangachari,IND,Pace,1948-12-09,Brabourne,India,1948,1,148,204,0,1,410,1014,5,262,810,5,82.0,>30,IND,Home,Upto 2014
CR Woakes,ENG,Pace,2013-08-21,The Oval,England,2013,1,96,144,1,1,836,1443,25,740,1299,24,33.44,>30,ENG,Home,Upto 2014
CR Woakes,ENG,Pace,2014-07-27,Southampton,England,2014,2,83,186,0,1,815,1573,15,732,1387,15,54.333333333333336,>30,ENG,Home,After 1965
CR Woakes,ENG,Pace,2014-08-07,Manchester,England,2014,2,80,114,1,1,546,928,23,466,814,22,23.73913043478261,<=30,ENG,Home,After 1965
CR Woakes,ENG,Pace,2014-08-15,The Oval,England,2014,2,54,126,4,1,613,1107,25,559,981,21,24.52,<=30,ENG,Home,After 1965
CR Woakes,ENG,Pace,2015-12-26,Durban,South Africa,2015,2,53,144,1,1,593,1392,27,540,1248,26,21.962962962962962,<=30,SA,Away,After 1965
CR Woakes,ENG,Pace,2016-01-22,Centurion,South Africa,2016,2,144,212,1,1,827,1592,31,683,1380,30,26.677419354838708,<=30,SA,Away,After 1965
CR Woakes,ENG,Pace,2016-05-27,Chester-le-Street,England,2016,2,112,206,5,1,773,1433,25,661,1227,20,30.92,>30,ENG,Home,After 1965
CR Woakes,ENG,Pace,2016-06-09,Lord's,England,2016,2,38,115,3,1,770,1481,24,732,1366,21,32.083333333333336,>30,ENG,Home,After 1965
CR Woakes,ENG,Pace,2016-07-14,Lord's,England,2016,2,102,252,11,1,760,1521,27,658,1269,16,28.14814814814815,<=30,ENG,Home,After 1965
CR Woakes,ENG,Pace,2016-07-22,Manchester,England,2016,2,108,189,7,1,705,1279,22,597,1090,15,32.04545454545455,>30,ENG,Home,After 1965
CR Woakes,ENG,Pace,2016-08-03,Birmingham,England,2016,2,132,246,5,1,912,1860,29,780,1614,24,31.448275862068964,>30,ENG,Home,After 1965
CR Woakes,ENG,Pace,2016-08-11,The Oval,England,2016,2,93,204,3,1,784,1374,21,691,1170,18,37.333333333333336,>30,ENG,Home,After 1965
CR Woakes,ENG,Pace,2016-10-20,Chattogram,Bangladesh,2016,2,25,84,0,1,222,543,9,197,459,9,24.666666666666668,<=30,BAN,Away,After 1965
CR Woakes,ENG,Pace,2016-10-28,Mirpur,Bangladesh,2016,2,44,66,3,1,173,288,8,129,222,5,21.625,<=30,BAN,Away,After 1965
CR Woakes,ENG,Pace,2016-11-09,Rajkot,India,2016,2,63,210,1,1,455,1020,7,392,810,6,65.0,>30,IND,Away,After 1965
CR Woakes,ENG,Pace,2016-11-26,Mohali,India,2016,2,102,156,1,1,431,841,13,329,685,12,33.15384615384615,>30,IND,Away,After 1965
CR Woakes,ENG,Pace,2016-12-08,Wankhede,India,2016,1,79,96,1,1,329,570,3,250,474,2,109.66666666666667,>30,IND,Away,After 1965
CR Woakes,ENG,Pace,2017-08-25,Leeds,England,2017,2,122,200,2,1,1027,1807,24,905,1607,22,42.791666666666664,>30,ENG,Home,After 1965
CR Woakes,ENG,Pace,2017-11-23,Brisbane,Australia,2017,2,113,210,1,1,713,1568,21,600,1358,20,33.95238095238095,>30,AUS,Away,After 1965
CR Woakes,ENG,Pace,2017-12-02,Adelaide,Australia,2017,2,120,258,5,1,779,1712,31,659,1454,26,25.129032258064516,<=30,AUS,Away,After 1965
CR Woakes,ENG,Pace,2017-12-14,W.A.C.A,Australia,2017,1,128,246,1,1,965,1713,24,837,1467,23,40.208333333333336,>30,AUS,Away,After 1965
CR Woakes,ENG,Pace,2017-12-26,Melbourne,Australia,2017,2,134,288,3,1,816,1807,20,682,1519,17,40.8,>30,AUS,Away,After 1965
CR Woakes,ENG,Pace,2018-03-22,Auckland,New Zealand,2018,1,107,198,0,1,669,1504,24,562,1306,24,27.875,<=30,NZ,Away,After 1965
CR Woakes,ENG,Pace,2018-06-01,Leeds,England,2018,2,73,102,4,1,552,1035,26,479,933,22,21.23076923076923,<=30,ENG,Home,After 1965
CR Woakes,ENG,Pace,2018-08-09,Lord's,England,2018,2,43,96,4,1,483,867,26,440,771,22,18.576923076923077,<=30,ENG,Home,After 1965
CR Woakes,ENG,Pace,2018-08-18,Nottingham,England,2018,2,124,252,4,1,905,1711,32,781,1459,28,28.28125,<=30,ENG,Home,After 1965
CR Woakes,ENG,Pace,2019-07-24,Lord's,England,2019,2,51,106,6,1,515,949,38,464,843,32,13.552631578947368,<=30,ENG,Home,After 1965
CR Woakes,ENG,Pace,2019-08-01,Birmingham,England,2019,2,104,204,4,1,758,1453,25,654,1249,21,30.32,>30,ENG,Home,After 1965
CR Woakes,ENG,Pace,2019-08-14,Lord's,England,2019,2,72,132,3,1,589,1275,24,517,1143,21,24.541666666666668,<=30,ENG,Home,After 1965
CR Woakes,ENG,Pace,2019-08-22,Leeds,England,2019,2,85,132,2,1,629,1344,34,544,1212,32,18.5,<=30,ENG,Home,After 1965
CR Woakes,ENG,Pace,2019-09-12,The Oval,England,2019,2,70,102,1,1,856,1530,30,786,1428,29,28.533333333333335,<=30,ENG,Home,After 1965
CR Woakes,ENG,Pace,2019-11-29,Hamilton,New Zealand,2019,2,95,252,4,1,881,1878,20,786,1626,16,44.05,>30,NZ,Away,After 1965
CR Woakes,ENG,Pace,2020-01-24,Johannesburg,South Africa,2020,2,85,186,3,1,1022,1773,39,937,1587,36,26.205128205128204,<=30,SA,Away,After 1965
CR Woakes,ENG,Pace,2020-07-16,Manchester,England,2020,2,76,222,5,1,747,1583,23,671,1361,18,32.47826086956522,>30,ENG,Home,After 1965
CR Woakes,ENG,Pace,2020-07-24,Manchester,England,2020,2,107,174,6,1,625,1206,27,518,1032,21,23.14814814814815,<=30,ENG,Home,After 1965
CR Woakes,ENG,Pace,2020-08-05,Manchester,England,2020,2,54,150,4,1,609,1268,24,555,1118,20,25.375,<=30,ENG,Home,After 1965
CR Woakes,ENG,Pace,2020-08-13,Southampton,England,2020,1,55,114,1,1,292,740,12,237,626,11,24.333333333333332,<=30,ENG,Home,After 1965
CR Woakes,ENG,Pace,2020-08-21,Southampton,England,2020,2,56,138,1,1,619,1361,14,563,1223,13,44.214285714285715,>30,ENG,Home,After 1965
CR Woakes,ENG,Pace,2021-09-02,The Oval,England,2021,2,138,282,7,1,900,1837,30,762,1555,23,30.0,<=30,ENG,Home,After 1965
CR Woakes,ENG,Pace,2021-12-08,Brisbane,Australia,2021,2,79,162,2,1,608,1187,25,529,1025,23,24.32,<=30,AUS,Away,After 1965
CR Woakes,ENG,Pace,2021-12-16,Adelaide,Australia,2021,2,149,214,1,1,845,1824,27,696,1610,26,31.296296296296298,>30,AUS,Away,After 1965
CR Woakes,ENG,Pace,2022-01-14,Hobart,Australia,2022,2,104,156,3,1,700,1252,39,596,1096,36,17.94871794871795,<=30,AUS,Away,After 1965
CR Woakes,ENG,Pace,2022-03-08,North Sound,West Indies,2022,2,110,234,1,1,832,1769,23,722,1535,22,36.17391304347826,>30,WI,Away,After 1965
CR Woakes,ENG,Pace,2022-03-16,Bridgetown,West Indies,2022,2,62,162,1,1,744,1535,17,682,1373,16,43.76470588235294,>30,WI,Away,After 1965
CR Woakes,ENG,Pace,2022-03-24,St George's,West Indies,2022,2,72,167,3,1,518,1435,27,446,1268,24,19.185185185185187,<=30,WI,Away,After 1965
CR Woakes,ENG,Pace,2023-07-06,Leeds,England,2023,2,141,210,6,1,803,1163,34,662,953,28,23.61764705882353,<=30,ENG,Home,After 1965
CR Woakes,ENG,Pace,2023-07-19,Manchester,England,2023,2,93,206,6,1,889,1350,23,796,1144,17,38.65217391304348,>30,ENG,Home,After 1965
CR Woakes,ENG,Pace,2023-07-27,The Oval,England,2023,2,111,264,7,1,971,1598,29,860,1334,22,33.48275862068966,>30,ENG,Home,After 1965
CR Woakes,ENG,Pace,2024-07-10,Lord's,England,2024,2,40,108,1,1,552,962,27,512,854,26,20.444444444444443,<=30,ENG,Home,After 1965
CR Woakes,ENG,Pace,2024-07-18,Nottingham,England,2024,2,112,216,6,1,1038,1453,27,926,1237,21,38.44444444444444,>30,ENG,Home,After 1965
CR Woakes,ENG,Pace,2024-07-26,Birmingham,England,2024,2,83,144,4,1,712,994,27,629,850,23,26.37037037037037,<=30,ENG,Home,After 1965
CR Woakes,ENG,Pace,2024-08-21,Manchester,England,2024,2,90,198,6,1,733,1160,25,643,962,19,29.32,<=30,ENG,Home,After 1965
CR Woakes,ENG,Pace,2024-08-29,Lord's,England,2024,2,67,196,4,1,781,1252,34,714,1056,30,22.970588235294116,<=30,ENG,Home,After 1965
CR Woakes,ENG,Pace,2024-09-06,The Oval,England,2024,2,94,150,3,1,809,1069,28,715,919,25,28.892857142857142,<=30,ENG,Home,After 1965
CR Woakes,ENG,Pace,2024-10-07,Multan,Pakistan,2024,2,110,210,2,1,658,930,10,548,720,8,65.8,>30,PAK,Away,After 1965
CR Woakes,ENG,Pace,2024-11-28,Christchurch,New Zealand,2024,2,129,234,3,1,709,1026,15,580,792,12,47.266666666666666,>30,NZ,Away,After 1965
CR Woakes,ENG,Pace,2024-12-06,Wellington,New Zealand,2024,2,46,108,3,1,601,832,22,555,724,19,27.318181818181817,<=30,NZ,Away,After 1965
CRD Fernando,SL,Pace,2000-06-14,Colombo (SSC),Sri Lanka,2000,2,67,113,2,1,461,1090,17,394,977,15,27.11764705882353,<=30,SL,Home,Upto 2014
CRD Fernando,SL,Pace,2000-12-26,Durban,South Africa,2000,2,146,264,6,1,618,1336,17,472,1072,11,36.35294117647059,>30,SA,Away,Upto 2014
CRD Fernando,SL,Pace,2001-01-02,Cape Town,South Africa,2001,1,105,150,1,1,537,948,18,432,798,17,29.833333333333332,<=30,SA,Away,Upto 2014
CRD Fernando,SL,Pace,2001-01-20,Centurion,South Africa,2001,1,107,96,1,1,628,1061,26,521,965,25,24.153846153846153,<=30,SA,Away,Upto 2014
CRD Fernando,SL,Pace,2001-02-22,Galle,Sri Lanka,2001,2,20,36,0,1,243,606,5,223,570,5,48.6,>30,SL,Home,Upto 2014
CRD Fernando,SL,Pace,2001-03-15,Colombo (SSC),Sri Lanka,2001,2,33,42,1,1,242,462,16,209,420,15,15.125,<=30,SL,Home,Upto 2014
CRD Fernando,SL,Pace,2001-08-14,Galle,Sri Lanka,2001,2,77,252,6,1,532,1132,18,455,880,12,29.555555555555557,<=30,SL,Home,Upto 2014
CRD Fernando,SL,Pace,2001-08-22,Kandy,Sri Lanka,2001,2,130,180,3,1,745,1357,27,615,1177,24,27.59259259259259,<=30,SL,Home,Upto 2014
CRD Fernando,SL,Pace,2001-08-29,Colombo (SSC),Sri Lanka,2001,2,97,174,0,1,542,1005,7,445,831,7,77.42857142857143,>30,SL,Home,Upto 2014
CRD Fernando,SL,Pace,2002-06-13,Manchester,England,2002,2,177,188,3,1,775,1409,20,598,1221,17,38.75,>30,ENG,Away,Upto 2014
CRD Fernando,SL,Pace,2002-07-21,Colombo (PSS),Sri Lanka,2002,2,64,126,3,1,532,738,12,468,612,9,44.333333333333336,>30,SL,Home,Upto 2014
CRD Fernando,SL,Pace,2002-11-08,Johannesburg,South Africa,2002,1,95,120,1,1,582,1139,26,487,1019,25,22.384615384615383,<=30,SA,Away,Upto 2014
CRD Fernando,SL,Pace,2002-11-15,Centurion,South Africa,2002,2,140,234,6,1,905,1840,32,765,1606,26,28.28125,<=30,SA,Away,Upto 2014
CRD Fernando,SL,Pace,2003-12-18,Colombo (SSC),Sri Lanka,2003,2,82,144,4,1,444,738,12,362,594,8,37.0,>30,SL,Home,Upto 2014
CRD Fernando,SL,Pace,2004-10-20,Faisalabad,Pakistan,2004,2,142,216,6,1,726,1252,21,584,1036,15,34.57142857142857,>30,PAK,Away,Upto 2014
CRD Fernando,SL,Pace,2004-10-28,Karachi,Pakistan,2004,2,107,151,3,1,689,1333,19,582,1182,16,36.26315789473684,>30,PAK,Away,Upto 2014
CRD Fernando,SL,Pace,2005-09-12,Colombo (RPS),Sri Lanka,2005,1,29,24,1,1,228,320,8,199,296,7,28.5,<=30,SL,Home,Upto 2014
CRD Fernando,SL,Pace,2005-09-20,Colombo (PSS),Sri Lanka,2005,2,95,126,7,1,387,537,17,292,411,10,22.764705882352942,<=30,SL,Home,Upto 2014
CRD Fernando,SL,Pace,2005-12-02,Chennai,India,2005,1,58,96,1,1,166,336,6,108,240,5,27.666666666666668,<=30,IND,Away,Upto 2014
CRD Fernando,SL,Pace,2005-12-10,Delhi,India,2005,2,118,240,1,1,417,906,10,299,666,9,41.7,>30,IND,Away,Upto 2014
CRD Fernando,SL,Pace,2006-02-28,Chattogram,Bangladesh,2006,2,60,126,2,1,293,539,9,233,413,7,32.55555555555556,>30,BAN,Away,Upto 2014
CRD Fernando,SL,Pace,2006-03-08,Bogra,Bangladesh,2006,2,75,168,5,1,292,547,11,217,379,6,26.545454545454547,<=30,BAN,Away,Upto 2014
CRD Fernando,SL,Pace,2006-03-26,Colombo (SSC),Sri Lanka,2006,2,60,108,0,1,568,1044,16,508,936,16,35.5,>30,SL,Home,Upto 2014
CRD Fernando,SL,Pace,2006-07-27,Colombo (SSC),Sri Lanka,2006,2,117,222,6,1,781,1191,14,664,969,8,55.785714285714285,>30,SL,Home,Upto 2014
CRD Fernando,SL,Pace,2007-06-25,Colombo (SSC),Sri Lanka,2007,2,61,156,3,1,288,528,11,227,372,8,26.181818181818183,<=30,SL,Home,Upto 2014
CRD Fernando,SL,Pace,2007-07-03,Colombo (PSS),Sri Lanka,2007,2,76,138,5,1,411,758,15,335,620,10,27.4,<=30,SL,Home,Upto 2014
CRD Fernando,SL,Pace,2007-11-08,Brisbane,Australia,2007,1,130,204,1,1,668,1297,18,538,1093,17,37.111111111111114,>30,AUS,Away,Upto 2014
CRD Fernando,SL,Pace,2007-11-16,Hobart,Australia,2007,2,184,228,2,1,932,1457,19,748,1229,17,49.05263157894737,>30,AUS,Away,Upto 2014
CRD Fernando,SL,Pace,2007-12-01,Kandy,Sri Lanka,2007,2,87,180,3,1,767,1367,21,680,1187,18,36.523809523809526,>30,SL,Home,Upto 2014
CRD Fernando,SL,Pace,2007-12-09,Colombo (SSC),Sri Lanka,2007,2,109,198,1,1,676,1421,13,567,1223,12,52.0,>30,SL,Home,Upto 2014
CRD Fernando,SL,Pace,2009-01-03,Chattogram,Bangladesh,2009,2,80,180,2,1,228,510,8,148,330,6,28.5,<=30,BAN,Away,Upto 2014
CRD Fernando,SL,Pace,2009-02-21,Karachi,Pakistan,2009,1,124,234,2,1,650,1043,7,526,809,5,92.85714285714286,>30,PAK,Away,Upto 2014
CRD Fernando,SL,Pace,2009-03-01,Lahore,Pakistan,2009,1,20,12,0,1,395,504,8,375,492,8,49.375,>30,PAK,Away,Upto 2014
CRD Fernando,SL,Pace,2010-07-26,Colombo (SSC),Sri Lanka,2010,1,116,188,1,1,508,710,3,392,522,2,169.33333333333334,>30,SL,Home,Upto 2014
CRD Fernando,SL,Pace,2010-12-01,Pallekele,Sri Lanka,2010,1,72,90,1,1,147,255,2,75,165,1,73.5,>30,SL,Home,Upto 2014
CRD Fernando,SL,Pace,2011-06-03,Lord's,England,2011,2,169,223,3,1,1032,1597,21,863,1374,18,49.142857142857146,>30,ENG,Away,Upto 2014
CRD Fernando,SL,Pace,2011-06-16,Southampton,England,2011,1,47,62,1,1,719,1308,21,672,1246,20,34.23809523809524,>30,ENG,Away,Upto 2014
CRD Fernando,SL,Pace,2011-12-15,Centurion,South Africa,2011,1,128,168,1,1,635,1013,25,507,845,24,25.4,<=30,SA,Away,Upto 2014
CRD Fernando,SL,Pace,2011-12-26,Durban,South Africa,2011,2,58,114,2,1,674,1304,26,616,1190,24,25.923076923076923,<=30,SA,Away,Upto 2014
CRD Fernando,SL,Pace,2012-07-08,Pallekele,Sri Lanka,2012,2,122,210,3,1,780,1418,19,658,1208,16,41.05263157894737,>30,SL,Home,Upto 2014
CS Cowdrey,ENG,Spin,1984-11-28,Wankhede,India,1984,1,30,30,1,1,629,1557,23,599,1527,22,27.347826086956523,<=30,IND,Away,Upto 2014
CS Cowdrey,ENG,Spin,1984-12-31,Eden Gardens,India,1984,2,25,36,0,1,444,1182,10,419,1146,10,44.4,>30,IND,Away,Upto 2014
CS Cowdrey,ENG,Spin,1985-01-13,Chennai,India,1985,2,91,144,2,1,779,1355,9,688,1211,7,86.55555555555556,>30,IND,Away,Upto 2014
CS Cowdrey,ENG,Spin,1985-01-31,Kanpur,India,1985,2,142,156,1,1,695,1644,9,553,1488,8,77.22222222222223,>30,IND,Away,Upto 2014
CS Cowdrey,ENG,Spin,1988-07-21,Leeds,England,1988,2,21,33,0,1,21,33,0,0,0,0,inf,>30,ENG,Home,Upto 2014
CS Dempster,NZ,Spin,1930-01-10,Christchurch,New Zealand,1930,1,10,5,0,1,139,270,9,129,265,9,15.444444444444445,<=30,NZ,Home,Upto 2014
CS Marriott,ENG,Spin,1933-08-12,The Oval,England,1933,2,96,247,11,1,194,451,12,98,204,1,16.166666666666668,<=30,ENG,Home,Upto 2014
CS Martin,NZ,Pace,2000-11-17,Bloemfontein,South Africa,2000,2,107,163,4,1,906,1955,31,799,1792,27,29.225806451612904,<=30,SA,Away,Upto 2014
CS Martin,NZ,Pace,2000-11-30,Gqeberha,South Africa,2000,2,136,246,5,1,698,1864,30,562,1618,25,23.266666666666666,<=30,SA,Away,Upto 2014
CS Martin,NZ,Pace,2000-12-08,Johannesburg,South Africa,2000,1,43,90,2,1,417,1127,13,374,1037,11,32.07692307692308,>30,SA,Away,Upto 2014
CS Martin,NZ,Pace,2000-12-26,Wellington,New Zealand,2000,2,77,227,5,1,550,1397,13,473,1170,8,42.30769230769231,>30,NZ,Home,Upto 2014
CS Martin,NZ,Pace,2001-03-08,Auckland,New Zealand,2001,2,171,204,4,1,702,1474,24,531,1270,20,29.25,<=30,NZ,Home,Upto 2014
CS Martin,NZ,Pace,2001-03-15,Christchurch,New Zealand,2001,1,153,246,2,1,802,1722,12,649,1476,10,66.83333333333333,>30,NZ,Home,Upto 2014
CS Martin,NZ,Pace,2001-03-27,Hamilton,New Zealand,2001,2,100,150,6,1,506,942,23,406,792,17,22.0,<=30,NZ,Home,Upto 2014
CS Martin,NZ,Pace,2001-11-30,W.A.C.A,Australia,2001,2,139,210,1,1,1026,1787,22,887,1577,21,46.63636363636363,>30,AUS,Away,Upto 2014
CS Martin,NZ,Pace,2001-12-18,Hamilton,New Zealand,2001,2,44,90,2,1,586,928,27,542,838,25,21.703703703703702,<=30,NZ,Home,Upto 2014
CS Martin,NZ,Pace,2002-03-21,Wellington,New Zealand,2002,2,98,144,2,1,587,1212,18,489,1068,16,32.611111111111114,>30,NZ,Home,Upto 2014
CS Martin,NZ,Pace,2002-05-01,Lahore,Pakistan,2002,1,108,186,1,1,476,866,17,368,680,16,28.0,<=30,PAK,Away,Upto 2014
CS Martin,NZ,Pace,2004-03-18,Auckland,New Zealand,2004,2,180,324,11,1,1016,1973,29,836,1649,18,35.03448275862069,>30,NZ,Home,Upto 2014
CS Martin,NZ,Pace,2004-03-26,Wellington,New Zealand,2004,2,120,230,7,1,820,1651,25,700,1421,18,32.8,>30,NZ,Home,Upto 2014
CS Martin,NZ,Pace,2004-05-20,Lord's,England,2004,2,169,270,4,1,1118,2072,26,949,1802,22,43.0,>30,ENG,Away,Upto 2014
CS Martin,NZ,Pace,2004-06-03,Leeds,England,2004,2,144,204,2,1,915,1695,27,771,1491,25,33.888888888888886,>30,ENG,Away,Upto 2014
CS Martin,NZ,Pace,2004-06-10,Nottingham,England,2004,1,1,11,0,1,1015,1836,30,1014,1825,30,33.833333333333336,>30,ENG,Away,Upto 2014
CS Martin,NZ,Pace,2004-11-18,Brisbane,Australia,2004,1,152,239,5,1,723,1283,17,571,1044,12,42.529411764705884,>30,AUS,Away,Upto 2014
CS Martin,NZ,Pace,2004-11-26,Adelaide,Australia,2004,2,129,198,0,1,602,1087,15,473,889,15,40.13333333333333,>30,AUS,Away,Upto 2014
CS Martin,NZ,Pace,2005-03-10,Christchurch,New Zealand,2005,2,131,222,1,1,768,1398,17,637,1176,16,45.1764705882353,>30,NZ,Home,Upto 2014
CS Martin,NZ,Pace,2005-03-18,Wellington,New Zealand,2005,1,123,168,0,1,569,942,15,446,774,15,37.93333333333333,>30,NZ,Home,Upto 2014
CS Martin,NZ,Pace,2005-03-26,Auckland,New Zealand,2005,2,143,174,1,1,759,1379,20,616,1205,19,37.95,>30,NZ,Home,Upto 2014
CS Martin,NZ,Pace,2005-04-04,Napier,New Zealand,2005,2,133,228,4,1,832,1538,21,699,1310,17,39.61904761904762,>30,NZ,Home,Upto 2014
CS Martin,NZ,Pace,2005-04-11,Wellington,New Zealand,2005,2,104,228,7,1,716,1428,28,612,1200,21,25.571428571428573,<=30,NZ,Home,Upto 2014
CS Martin,NZ,Pace,2005-08-07,Harare,Zimbabwe,2005,2,37,108,5,1,432,774,20,395,666,15,21.6,<=30,ZIM,Away,Upto 2014
CS Martin,NZ,Pace,2005-08-15,Bulawayo,Zimbabwe,2005,2,89,150,1,1,584,919,19,495,769,18,30.736842105263158,>30,ZIM,Away,Upto 2014
CS Martin,NZ,Pace,2006-03-09,Auckland,New Zealand,2006,2,119,198,3,1,867,1612,27,748,1414,24,32.111111111111114,>30,NZ,Home,Upto 2014
CS Martin,NZ,Pace,2006-03-17,Wellington,New Zealand,2006,2,131,246,4,1,633,1165,28,502,919,24,22.607142857142858,<=30,NZ,Home,Upto 2014
CS Martin,NZ,Pace,2006-03-25,Napier,New Zealand,2006,1,39,60,1,1,242,421,3,203,361,2,80.66666666666667,>30,NZ,Home,Upto 2014
CS Martin,NZ,Pace,2006-04-15,Centurion,South Africa,2006,2,130,280,3,1,858,1550,38,728,1270,35,22.57894736842105,<=30,SA,Away,Upto 2014
CS Martin,NZ,Pace,2006-04-27,Cape Town,South Africa,2006,1,62,120,0,1,739,1386,13,677,1266,13,56.84615384615385,>30,SA,Away,Upto 2014
CS Martin,NZ,Pace,2006-05-05,Johannesburg,South Africa,2006,2,101,192,6,1,757,1280,36,656,1088,30,21.02777777777778,<=30,SA,Away,Upto 2014
CS Martin,NZ,Pace,2006-12-07,Christchurch,New Zealand,2006,2,75,166,2,1,515,1047,25,440,881,23,20.6,<=30,NZ,Home,Upto 2014
CS Martin,NZ,Pace,2006-12-15,Wellington,New Zealand,2006,2,148,216,5,1,700,1140,20,552,924,15,35.0,>30,NZ,Home,Upto 2014
CS Martin,NZ,Pace,2007-11-08,Johannesburg,South Africa,2007,2,122,249,4,1,740,1372,29,618,1123,25,25.517241379310345,<=30,SA,Away,Upto 2014
CS Martin,NZ,Pace,2007-11-16,Centurion,South Africa,2007,1,81,132,2,1,609,994,26,528,862,24,23.423076923076923,<=30,SA,Away,Upto 2014
CS Martin,NZ,Pace,2008-01-04,Dunedin,New Zealand,2008,2,120,199,6,1,478,890,22,358,691,16,21.727272727272727,<=30,NZ,Home,Upto 2014
CS Martin,NZ,Pace,2008-01-12,Wellington,New Zealand,2008,2,100,174,7,1,450,866,22,350,692,15,20.454545454545453,<=30,NZ,Home,Upto 2014
CS Martin,NZ,Pace,2008-03-05,Hamilton,New Zealand,2008,2,93,270,5,1,672,1450,27,579,1180,22,24.88888888888889,<=30,NZ,Home,Upto 2014
CS Martin,NZ,Pace,2008-03-13,Wellington,New Zealand,2008,2,157,268,3,1,966,1899,38,809,1631,35,25.42105263157895,<=30,NZ,Home,Upto 2014
CS Martin,NZ,Pace,2008-03-22,Napier,New Zealand,2008,2,134,264,3,1,793,1402,23,659,1138,20,34.47826086956522,>30,NZ,Home,Upto 2014
CS Martin,NZ,Pace,2008-05-15,Lord's,England,2008,1,76,192,2,1,640,1330,19,564,1138,17,33.68421052631579,>30,ENG,Away,Upto 2014
CS Martin,NZ,Pace,2008-05-23,Manchester,England,2008,2,76,138,1,1,614,1172,16,538,1034,15,38.375,>30,ENG,Away,Upto 2014
CS Martin,NZ,Pace,2008-06-05,Nottingham,England,2008,1,83,132,1,1,579,1236,29,496,1104,28,19.96551724137931,<=30,ENG,Away,Upto 2014
CS Martin,NZ,Pace,2008-11-20,Brisbane,Australia,2008,2,111,234,4,1,700,1373,36,589,1139,32,19.444444444444443,<=30,AUS,Away,Upto 2014
CS Martin,NZ,Pace,2008-11-28,Adelaide,Australia,2008,1,110,162,2,1,688,1276,20,578,1114,18,34.4,>30,AUS,Away,Upto 2014
CS Martin,NZ,Pace,2009-03-18,Hamilton,New Zealand,2009,2,115,198,3,1,743,1246,14,628,1048,11,53.07142857142857,>30,NZ,Home,Upto 2014
CS Martin,NZ,Pace,2009-03-26,Napier,New Zealand,2009,2,175,324,4,1,682,1265,13,507,941,9,52.46153846153846,>30,NZ,Home,Upto 2014
CS Martin,NZ,Pace,2009-04-03,Wellington,New Zealand,2009,2,168,283,7,1,869,1366,23,701,1083,16,37.78260869565217,>30,NZ,Home,Upto 2014
CS Martin,NZ,Pace,2009-08-18,Galle,Sri Lanka,2009,2,102,168,4,1,541,798,16,439,630,12,33.8125,>30,SL,Away,Upto 2014
CS Martin,NZ,Pace,2009-08-26,Colombo (SSC),Sri Lanka,2009,2,115,198,1,1,574,917,8,459,719,7,71.75,>30,SL,Away,Upto 2014
CS Martin,NZ,Pace,2009-11-24,Dunedin,New Zealand,2009,2,108,222,5,1,862,1655,33,754,1433,28,26.12121212121212,<=30,NZ,Home,Upto 2014
CS Martin,NZ,Pace,2009-12-03,Wellington,New Zealand,2009,2,116,234,4,1,635,1257,30,519,1023,26,21.166666666666668,<=30,NZ,Home,Upto 2014
CS Martin,NZ,Pace,2009-12-11,Napier,New Zealand,2009,2,119,246,2,1,858,1683,18,739,1437,16,47.666666666666664,>30,NZ,Home,Upto 2014
CS Martin,NZ,Pace,2010-02-15,Hamilton,New Zealand,2010,2,164,222,4,1,762,1104,17,598,882,13,44.8235294117647,>30,NZ,Home,Upto 2014
CS Martin,NZ,Pace,2010-03-19,Wellington,New Zealand,2010,2,158,216,1,1,767,1410,18,609,1194,17,42.611111111111114,>30,NZ,Home,Upto 2014
CS Martin,NZ,Pace,2010-03-27,Hamilton,New Zealand,2010,2,102,156,0,1,795,1294,27,693,1138,27,29.444444444444443,<=30,NZ,Home,Upto 2014
CS Martin,NZ,Pace,2010-11-04,Ahmedabad,India,2010,2,138,306,6,1,415,862,12,277,556,6,34.583333333333336,>30,IND,Away,Upto 2014
CS Martin,NZ,Pace,2010-11-12,Hyderabad,India,2010,1,87,174,1,1,606,1065,12,519,891,11,50.5,>30,IND,Away,Upto 2014
CS Martin,NZ,Pace,2010-11-20,Nagpur,India,2010,1,82,168,2,1,407,788,13,325,620,11,31.307692307692307,>30,IND,Away,Upto 2014
CS Martin,NZ,Pace,2011-01-07,Hamilton,New Zealand,2011,2,97,163,3,1,564,1033,21,467,870,18,26.857142857142858,<=30,NZ,Home,Upto 2014
CS Martin,NZ,Pace,2011-01-15,Wellington,New Zealand,2011,2,154,336,6,1,781,1511,23,627,1175,17,33.95652173913044,>30,NZ,Home,Upto 2014
CS Martin,NZ,Pace,2011-11-01,Bulawayo,Zimbabwe,2011,2,159,287,3,1,759,1445,23,600,1158,20,33.0,>30,ZIM,Away,Upto 2014
CS Martin,NZ,Pace,2011-12-01,Brisbane,Australia,2011,2,89,174,4,1,653,1114,19,564,940,15,34.36842105263158,>30,AUS,Away,Upto 2014
CS Martin,NZ,Pace,2011-12-09,Hobart,Australia,2011,2,90,192,4,1,648,1341,37,558,1149,33,17.513513513513512,<=30,AUS,Away,Upto 2014
CS Martin,NZ,Pace,2012-01-26,Napier,New Zealand,2012,2,31,87,8,1,497,972,21,466,885,13,23.666666666666668,<=30,NZ,Home,Upto 2014
CS Martin,NZ,Pace,2012-03-07,Dunedin,New Zealand,2012,2,130,246,4,1,860,1498,21,730,1252,17,40.95238095238095,>30,NZ,Home,Upto 2014
CS Martin,NZ,Pace,2012-03-15,Hamilton,New Zealand,2012,2,56,114,2,1,549,1079,27,493,965,25,20.333333333333332,<=30,NZ,Home,Upto 2014
CS Martin,NZ,Pace,2012-03-23,Wellington,New Zealand,2012,2,139,228,2,1,873,1620,25,734,1392,23,34.92,>30,NZ,Home,Upto 2014
CS Martin,NZ,Pace,2012-07-25,North Sound,West Indies,2012,2,146,204,3,1,734,1446,19,588,1242,16,38.63157894736842,>30,WI,Away,Upto 2014
CS Martin,NZ,Pace,2012-08-23,Hyderabad,India,2012,1,76,162,1,1,403,771,7,327,609,6,57.57142857142857,>30,IND,Away,Upto 2014
CS Martin,NZ,Pace,2013-01-02,Cape Town,South Africa,2013,1,63,116,3,1,547,1103,26,484,987,23,21.03846153846154,<=30,SA,Away,Upto 2014
CS Nayudu,IND,Spin,1934-01-05,Eden Gardens,India,1934,1,26,48,0,1,342,922,15,316,874,15,22.8,<=30,IND,Home,Upto 2014
CS Nayudu,IND,Spin,1934-02-10,Chennai,India,1934,2,60,90,0,1,484,943,18,424,853,18,26.88888888888889,<=30,IND,Home,Upto 2014
CS Nayudu,IND,Spin,1936-06-27,Lord's,England,1936,1,8,18,0,1,182,439,11,174,421,11,16.545454545454547,<=30,ENG,Away,Upto 2014
CS Nayudu,IND,Spin,1936-07-25,Manchester,England,1936,1,87,102,1,1,479,775,14,392,673,13,34.214285714285715,>30,ENG,Away,Upto 2014
CS Nayudu,IND,Spin,1946-06-22,Lord's,England,1946,2,28,54,0,1,376,791,8,348,737,8,47.0,>30,ENG,Away,Upto 2014
CS Nayudu,IND,Spin,1946-08-17,The Oval,England,1946,1,19,54,1,1,184,504,4,165,450,3,46.0,>30,ENG,Away,Upto 2014
CS Nayudu,IND,Spin,1947-11-28,Brisbane,Australia,1947,1,18,24,0,1,180,496,7,162,472,7,25.714285714285715,<=30,AUS,Away,Upto 2014
CS Nayudu,IND,Spin,1948-01-01,Melbourne,Australia,1948,1,22,16,0,1,660,1199,23,638,1183,23,28.695652173913043,<=30,AUS,Away,Upto 2014
CS Nayudu,IND,Spin,1948-02-06,Melbourne,Australia,1948,1,77,104,0,1,478,1056,12,401,952,12,39.833333333333336,>30,AUS,Away,Upto 2014
CS Nayudu,IND,Spin,1952-01-12,Kanpur,India,1952,1,14,12,0,1,484,1339,31,470,1327,31,15.612903225806452,<=30,IND,Home,Upto 2014
CT Mumba,ZIM,Pace,2016-10-29,Harare,Zimbabwe,2016,2,151,215,5,1,716,1330,16,565,1115,11,44.75,>30,ZIM,Home,After 1965
CT Mumba,ZIM,Pace,2016-11-06,Harare,Zimbabwe,2016,2,147,252,3,1,650,1231,14,503,979,11,46.42857142857143,>30,ZIM,Home,After 1965
CT Mumba,ZIM,Pace,2020-01-27,Harare,Zimbabwe,2020,2,56,132,2,1,441,1205,12,385,1073,10,36.75,>30,ZIM,Home,After 1965
CT Mutombodzi,ZIM,Spin,2020-01-27,Harare,Zimbabwe,2020,2,67,114,0,1,658,1179,17,591,1065,17,38.705882352941174,>30,ZIM,Home,After 1965
CT Sarwate,IND,Spin,1946-07-20,Manchester,England,1946,1,12,42,0,1,221,522,7,209,480,7,31.571428571428573,>30,ENG,Away,Upto 2014
CT Sarwate,IND,Spin,1947-11-28,Brisbane,Australia,1947,1,16,40,1,1,180,496,7,164,456,6,25.714285714285715,<=30,AUS,Away,Upto 2014
CT Sarwate,IND,Spin,1948-01-01,Melbourne,Australia,1948,2,57,64,0,1,660,1199,23,603,1135,23,28.695652173913043,<=30,AUS,Away,Upto 2014
CT Sarwate,IND,Spin,1948-01-23,Adelaide,Australia,1948,1,121,176,0,1,689,1465,10,568,1289,10,68.9,>30,AUS,Away,Upto 2014
CT Sarwate,IND,Spin,1948-02-06,Melbourne,Australia,1948,1,82,144,1,1,478,1056,12,396,912,11,39.833333333333336,>30,AUS,Away,Upto 2014
CT Sarwate,IND,Spin,1948-11-10,Delhi,India,1948,1,52,96,1,1,804,1710,13,752,1614,12,61.84615384615385,>30,IND,Home,Upto 2014
CT Sarwate,IND,Spin,1948-12-31,Eden Gardens,India,1948,2,7,18,0,1,677,1523,19,670,1505,19,35.63157894736842,>30,IND,Home,Upto 2014
CT Sarwate,IND,Spin,1951-12-14,Brabourne,India,1951,1,27,78,0,1,561,1297,11,534,1219,11,51.0,>30,IND,Home,Upto 2014
CT Studd,ENG,Pace,1882-08-28,The Oval,England,1882,1,9,16,0,1,213,651,23,204,635,23,9.26086956521739,<=30,ENG,Home,After 1965
CT Studd,ENG,Pace,1882-12-30,Melbourne,Australia,1882,2,42,240,2,1,380,1024,17,338,784,15,22.352941176470587,<=30,AUS,Away,After 1965
CT Studd,ENG,Pace,1883-01-19,Melbourne,Australia,1883,1,22,16,0,1,335,900,10,313,884,10,33.5,>30,AUS,Away,After 1965
CT Studd,ENG,Pace,1883-01-26,Sydney,Australia,1883,1,5,56,0,1,439,1288,28,434,1232,28,15.678571428571429,<=30,AUS,Away,After 1965
CT Studd,ENG,Pace,1883-02-17,Sydney,Australia,1883,2,20,56,1,1,382,973,10,362,917,9,38.2,>30,AUS,Away,After 1965
CT Tremlett,ENG,Pace,2007-07-19,Lord's,England,2007,2,104,246,4,1,762,1573,34,658,1327,30,22.41176470588235,<=30,ENG,Home,Upto 2014
CT Tremlett,ENG,Pace,2007-07-27,Nottingham,England,2007,2,92,283,6,1,762,1633,23,670,1350,17,33.130434782608695,>30,ENG,Home,Upto 2014
CT Tremlett,ENG,Pace,2007-08-09,The Oval,England,2007,2,190,330,3,1,888,1674,23,698,1344,20,38.608695652173914,>30,ENG,Home,Upto 2014
CT Tremlett,ENG,Pace,2010-12-16,W.A.C.A,Australia,2010,2,150,282,8,1,755,1419,38,605,1137,30,19.86842105263158,<=30,AUS,Away,Upto 2014
CT Tremlett,ENG,Pace,2010-12-26,Melbourne,Australia,2010,2,97,173,5,1,704,1424,26,607,1251,21,27.076923076923077,<=30,AUS,Away,Upto 2014
CT Tremlett,ENG,Pace,2011-01-03,Sydney,Australia,2011,2,150,280,4,1,873,1642,26,723,1362,22,33.57692307692308,>30,AUS,Away,Upto 2014
CT Tremlett,ENG,Pace,2011-05-26,Cardiff,England,2011,2,121,216,5,1,591,1108,14,470,892,9,42.214285714285715,>30,ENG,Home,Upto 2014
CT Tremlett,ENG,Pace,2011-06-03,Lord's,England,2011,2,116,234,3,1,1032,1597,21,916,1363,18,49.142857142857146,>30,ENG,Home,Upto 2014
CT Tremlett,ENG,Pace,2011-06-16,Southampton,England,2011,2,114,246,7,1,719,1308,21,605,1062,14,34.23809523809524,>30,ENG,Home,Upto 2014
CT Tremlett,ENG,Pace,2011-07-21,Lord's,England,2011,2,124,270,4,1,813,1712,30,689,1442,26,27.1,<=30,ENG,Home,Upto 2014
CT Tremlett,ENG,Pace,2012-01-17,Dubai (DICS),UAE,2012,1,53,126,0,1,389,864,11,336,738,11,35.36363636363637,>30,UAE,Away,Upto 2014
CT Tremlett,ENG,Pace,2013-11-21,Brisbane,Australia,2013,2,120,216,4,1,625,1326,30,505,1110,26,20.833333333333332,<=30,AUS,Away,Upto 2014
CTB Turner,AUS,Pace,1887-01-28,Sydney,Australia,1887,2,68,250,8,1,241,1003,28,173,753,20,8.607142857142858,<=30,AUS,Home,After 1965
CTB Turner,AUS,Pace,1887-02-25,Sydney,Australia,1887,2,93,469,9,1,222,846,20,129,377,11,11.1,<=30,AUS,Home,After 1965
CTB Turner,AUS,Pace,1888-02-10,Sydney,Australia,1888,2,87,352,12,1,187,670,24,100,318,12,7.791666666666667,<=30,AUS,Home,After 1965
CTB Turner,AUS,Pace,1888-07-16,Lord's,England,1888,2,63,196,10,1,147,372,17,84,176,7,8.647058823529411,<=30,ENG,Away,After 1965
CTB Turner,AUS,Pace,1888-08-13,The Oval,England,1888,1,112,240,6,1,274,691,16,162,451,10,17.125,<=30,ENG,Away,After 1965
CTB Turner,AUS,Pace,1888-08-30,Manchester,England,1888,1,86,220,5,1,172,393,11,86,173,6,15.636363636363637,<=30,ENG,Away,After 1965
CTB Turner,AUS,Pace,1890-07-21,Lord's,England,1890,2,84,285,1,1,361,1213,17,277,928,16,21.235294117647058,<=30,ENG,Away,After 1965
CTB Turner,AUS,Pace,1890-08-11,The Oval,England,1890,2,75,235,5,1,285,909,28,210,674,23,10.178571428571429,<=30,ENG,Away,After 1965
CTB Turner,AUS,Pace,1892-01-01,Melbourne,Australia,1892,2,91,296,7,1,677,2425,30,586,2129,23,22.566666666666666,<=30,AUS,Home,After 1965
CTB Turner,AUS,Pace,1892-01-29,Sydney,Australia,1892,2,136,362,6,1,735,2292,31,599,1930,25,23.70967741935484,<=30,AUS,Home,After 1965
CTB Turner,AUS,Pace,1892-03-24,Adelaide,Australia,1892,1,111,276,3,1,529,1333,15,418,1057,12,35.266666666666666,>30,AUS,Home,After 1965
CTB Turner,AUS,Pace,1893-07-17,Lord's,England,1893,2,131,340,8,1,548,1355,26,417,1015,18,21.076923076923077,<=30,ENG,Away,After 1965
CTB Turner,AUS,Pace,1893-08-14,The Oval,England,1893,1,94,235,1,1,575,1100,17,481,865,16,33.8235294117647,>30,ENG,Away,After 1965
CTB Turner,AUS,Pace,1893-08-24,Manchester,England,1893,2,90,300,2,1,557,1484,22,467,1184,20,25.318181818181817,<=30,ENG,Away,After 1965
CTB Turner,AUS,Pace,1894-12-14,Sydney,Australia,1894,2,167,474,3,1,993,2418,24,826,1944,21,41.375,>30,AUS,Home,After 1965
CTB Turner,AUS,Pace,1894-12-29,Melbourne,Australia,1894,2,131,450,8,1,653,1784,28,522,1334,20,23.321428571428573,<=30,AUS,Home,After 1965
CTB Turner,AUS,Pace,1895-02-01,Sydney,Australia,1895,2,51,199,7,1,216,539,18,165,340,11,12.0,<=30,AUS,Home,After 1965
CV Gadkari,IND,Pace,1953-01-21,Port of Spain,West Indies,1953,2,37,84,0,1,431,1261,9,394,1177,9,47.888888888888886,>30,WI,Away,Upto 2014
CV Gadkari,IND,Pace,1953-03-11,Georgetown,West Indies,1953,1,8,18,0,1,150,444,4,142,426,4,37.5,>30,WI,Away,Upto 2014
CV Grimmett,AUS,Spin,1925-02-27,Sydney,Australia,1925,2,82,251,11,1,638,1899,28,556,1648,17,22.785714285714285,<=30,AUS,Home,Upto 2014
CV Grimmett,AUS,Spin,1926-07-10,Leeds,England,1926,2,147,408,7,1,810,1836,19,663,1428,12,42.63157894736842,>30,ENG,Away,Upto 2014
CV Grimmett,AUS,Spin,1926-07-24,Manchester,England,1926,1,85,228,1,1,479,1184,11,394,956,10,43.54545454545455,>30,ENG,Away,Upto 2014
CV Grimmett,AUS,Spin,1926-08-14,The Oval,England,1926,2,182,528,5,1,808,2213,28,626,1685,23,28.857142857142858,<=30,ENG,Away,Upto 2014
CV Grimmett,AUS,Spin,1928-11-30,Brisbane,Australia,1928,2,298,505,9,1,545,1303,22,247,798,13,24.772727272727273,<=30,AUS,Home,Upto 2014
CV Grimmett,AUS,Spin,1928-12-14,Sydney,Australia,1928,1,191,384,2,1,782,1986,12,591,1602,10,65.16666666666667,>30,AUS,Home,Upto 2014
CV Grimmett,AUS,Spin,1928-12-29,Melbourne,Australia,1928,2,210,582,4,1,717,2327,21,507,1745,17,34.142857142857146,>30,AUS,Home,Upto 2014
CV Grimmett,AUS,Spin,1929-02-01,Adelaide,Australia,1929,2,219,625,6,1,757,2268,26,538,1643,20,29.115384615384617,<=30,AUS,Home,Upto 2014
CV Grimmett,AUS,Spin,1929-03-08,Melbourne,Australia,1929,2,106,294,2,1,660,1893,8,554,1599,6,82.5,>30,AUS,Home,Upto 2014
CV Grimmett,AUS,Spin,1930-06-13,Nottingham,England,1930,2,201,372,10,1,620,1484,29,419,1112,19,21.379310344827587,<=30,ENG,Away,Upto 2014
CV Grimmett,AUS,Spin,1930-06-27,Lord's,England,1930,2,272,516,8,1,960,1932,18,688,1416,10,53.333333333333336,>30,ENG,Away,Upto 2014
CV Grimmett,AUS,Spin,1930-07-11,Leeds,England,1930,2,168,440,6,1,548,1255,15,380,815,9,36.53333333333333,>30,ENG,Away,Upto 2014
CV Grimmett,AUS,Spin,1930-07-25,Manchester,England,1930,1,59,114,0,1,355,1021,7,296,907,7,50.714285714285715,>30,ENG,Away,Upto 2014
CV Grimmett,AUS,Spin,1930-08-16,The Oval,England,1930,2,225,656,5,1,762,1847,19,537,1191,14,40.10526315789474,>30,ENG,Away,Upto 2014
CV Grimmett,AUS,Spin,1930-12-12,Adelaide,Australia,1930,2,183,516,11,1,578,1434,23,395,918,12,25.130434782608695,<=30,AUS,Home,Upto 2014
CV Grimmett,AUS,Spin,1931-01-01,Sydney,Australia,1931,2,63,136,5,1,251,536,17,188,400,12,14.764705882352942,<=30,AUS,Home,Upto 2014
CV Grimmett,AUS,Spin,1931-01-16,Brisbane,Australia,1931,2,144,336,9,1,426,888,13,282,552,4,32.76923076923077,>30,AUS,Home,Upto 2014
CV Grimmett,AUS,Spin,1931-02-13,Melbourne,Australia,1931,2,56,142,4,1,273,612,18,217,470,14,15.166666666666666,<=30,AUS,Home,Upto 2014
CV Grimmett,AUS,Spin,1931-02-27,Sydney,Australia,1931,2,147,306,4,1,469,1050,14,322,744,10,33.5,>30,AUS,Home,Upto 2014
CV Grimmett,AUS,Spin,1931-11-27,Brisbane,Australia,1931,2,94,337,3,1,332,1063,15,238,726,12,22.133333333333333,<=30,AUS,Home,Upto 2014
CV Grimmett,AUS,Spin,1931-12-18,Sydney,Australia,1931,2,72,267,8,1,364,897,16,292,630,8,22.75,<=30,AUS,Home,Upto 2014
CV Grimmett,AUS,Spin,1931-12-31,Melbourne,Australia,1931,2,192,654,8,1,678,1818,23,486,1164,15,29.47826086956522,<=30,AUS,Home,Upto 2014
CV Grimmett,AUS,Spin,1932-01-29,Adelaide,Australia,1932,2,199,578,14,1,610,1508,19,411,930,5,32.10526315789474,>30,AUS,Home,Upto 2014
CV Grimmett,AUS,Spin,1932-12-02,Sydney,Australia,1932,1,118,384,1,1,288,900,4,170,516,3,72.0,>30,AUS,Home,Upto 2014
CV Grimmett,AUS,Spin,1932-12-30,Melbourne,Australia,1932,2,40,120,1,1,223,670,15,183,550,14,14.866666666666667,<=30,AUS,Home,Upto 2014
CV Grimmett,AUS,Spin,1933-01-13,Adelaide,Australia,1933,2,168,378,3,1,546,1683,15,378,1305,12,36.4,>30,AUS,Home,Upto 2014
CV Grimmett,AUS,Spin,1934-06-08,Nottingham,England,1934,2,120,633,8,1,499,1663,22,379,1030,14,22.681818181818183,<=30,ENG,Away,Upto 2014
CV Grimmett,AUS,Spin,1934-06-22,Lord's,England,1934,1,102,321,1,1,377,1128,20,275,807,19,18.85,<=30,ENG,Away,Upto 2014
CV Grimmett,AUS,Spin,1934-07-06,Manchester,England,1934,2,150,444,1,1,477,1272,12,327,828,11,39.75,>30,ENG,Away,Upto 2014
CV Grimmett,AUS,Spin,1934-07-20,Leeds,England,1934,2,129,525,7,1,569,1652,17,440,1127,10,33.470588235294116,>30,ENG,Away,Upto 2014
CV Grimmett,AUS,Spin,1934-08-18,The Oval,England,1934,2,167,456,8,1,526,1194,12,359,738,4,43.833333333333336,>30,ENG,Away,Upto 2014
CV Grimmett,AUS,Spin,1935-12-14,Durban,South Africa,1935,2,131,480,5,1,684,1775,22,553,1295,17,31.09090909090909,>30,SA,Away,Upto 2014
CV Grimmett,AUS,Spin,1935-12-24,Johannesburg,South Africa,1935,2,140,438,6,1,577,1226,18,437,788,12,32.05555555555556,>30,SA,Away,Upto 2014
CV Grimmett,AUS,Spin,1936-01-01,Cape Town,South Africa,1936,2,88,322,10,1,468,1146,24,380,824,14,19.5,<=30,SA,Away,Upto 2014
CV Grimmett,AUS,Spin,1936-02-15,Johannesburg,South Africa,1936,2,110,279,10,1,374,819,19,264,540,9,19.68421052631579,<=30,SA,Away,Upto 2014
CV Grimmett,AUS,Spin,1936-02-28,Durban,South Africa,1936,2,173,558,13,1,543,1530,23,370,972,10,23.608695652173914,<=30,SA,Away,Upto 2014
CV Wight,WI,Spin,1930-02-21,Georgetown,West Indies,1930,1,6,30,0,1,461,1269,13,455,1239,13,35.46153846153846,>30,WI,Home,Upto 2014
CW Henderson,SA,Spin,2001-09-07,Harare,Zimbabwe,2001,2,177,474,4,1,406,782,4,229,308,0,101.5,>30,ZIM,Away,Upto 2014
CW Henderson,SA,Spin,2001-09-14,Bulawayo,Zimbabwe,2001,2,176,510,7,1,460,1130,12,284,620,5,38.333333333333336,>30,ZIM,Away,Upto 2014
CW Henderson,SA,Spin,2001-12-14,Adelaide,Australia,2001,2,246,373,7,1,425,803,15,179,430,8,28.333333333333332,<=30,AUS,Away,Upto 2014
CW Henderson,SA,Spin,2001-12-26,Melbourne,Australia,2001,1,108,174,1,1,251,480,5,143,306,4,50.2,>30,AUS,Away,Upto 2014
CW Henderson,SA,Spin,2002-01-02,Sydney,Australia,2002,2,126,174,0,1,581,1150,17,455,976,17,34.1764705882353,>30,AUS,Away,Upto 2014
CW Henderson,SA,Spin,2002-10-18,East London,South Africa,2002,2,81,222,2,1,247,486,3,166,264,1,82.33333333333333,>30,SA,Home,Upto 2014
CW Henderson,SA,Spin,2002-10-25,Potchefstroom,South Africa,2002,1,14,35,1,1,189,281,2,175,246,1,94.5,>30,SA,Home,Upto 2014
CWL Parker,ENG,Spin,1921-07-23,Manchester,England,1921,1,32,168,2,1,239,952,12,207,784,10,19.916666666666668,<=30,ENG,Home,Upto 2014
CZ Harris,NZ,Pace,1992-11-27,Moratuwa,Sri Lanka,1992,1,64,90,0,1,602,1223,13,538,1133,13,46.30769230769231,>30,SL,Away,Upto 2014
CZ Harris,NZ,Pace,1992-12-06,Colombo (SSC),Sri Lanka,1992,1,17,18,0,1,402,864,12,385,846,12,33.5,>30,SL,Away,Upto 2014
CZ Harris,NZ,Pace,1993-03-12,Auckland,New Zealand,1993,1,4,12,0,1,620,1465,22,616,1453,22,28.181818181818183,<=30,NZ,Home,Upto 2014
CZ Harris,NZ,Pace,1993-11-26,Hobart,Australia,1993,1,18,12,0,1,577,1014,7,559,1002,7,82.42857142857143,>30,AUS,Away,Upto 2014
CZ Harris,NZ,Pace,1996-04-19,Bridgetown,West Indies,1996,1,75,204,2,1,918,1755,25,843,1551,23,36.72,>30,WI,Away,Upto 2014
CZ Harris,NZ,Pace,1996-04-27,St John's,West Indies,1996,2,117,234,3,1,915,1920,26,798,1686,23,35.19230769230769,>30,WI,Away,Upto 2014
CZ Harris,NZ,Pace,1996-11-21,Lahore,Pakistan,1996,2,23,42,0,1,507,953,23,484,911,23,22.043478260869566,<=30,PAK,Away,Upto 2014
CZ Harris,NZ,Pace,1996-11-28,Rawalpindi,Pakistan,1996,1,57,144,2,1,614,1126,22,557,982,20,27.90909090909091,<=30,PAK,Away,Upto 2014
CZ Harris,NZ,Pace,1997-09-18,Harare,Zimbabwe,1997,2,38,108,0,1,808,1794,25,770,1686,25,32.32,>30,ZIM,Away,Upto 2014
CZ Harris,NZ,Pace,1997-09-25,Bulawayo,Zimbabwe,1997,2,54,186,1,1,606,1326,9,552,1140,8,67.33333333333333,>30,ZIM,Away,Upto 2014
CZ Harris,NZ,Pace,1997-11-07,Brisbane,Australia,1997,2,47,78,0,1,809,1711,25,762,1633,25,32.36,>30,AUS,Away,Upto 2014
CZ Harris,NZ,Pace,1998-05-27,Colombo (RPS),Sri Lanka,1998,2,43,66,0,1,355,626,8,312,560,8,44.375,>30,SL,Away,Upto 2014
CZ Harris,NZ,Pace,1998-06-03,Galle,Sri Lanka,1998,1,56,154,1,1,157,358,1,101,204,0,157.0,>30,SL,Away,Upto 2014
CZ Harris,NZ,Pace,1999-02-27,Auckland,New Zealand,1999,1,94,270,2,1,841,1949,13,747,1679,11,64.6923076923077,>30,NZ,Home,Upto 2014
CZ Harris,NZ,Pace,1999-03-11,Christchurch,New Zealand,1999,1,77,168,0,1,581,1404,8,504,1236,8,72.625,>30,NZ,Home,Upto 2014
CZ Harris,NZ,Pace,1999-03-18,Wellington,New Zealand,1999,1,66,132,0,1,742,1762,20,676,1630,20,37.1,>30,NZ,Home,Upto 2014
CZ Harris,NZ,Pace,1999-08-05,Manchester,England,1999,2,46,156,2,1,505,1189,11,459,1033,9,45.90909090909091,>30,ENG,Away,Upto 2014
CZ Harris,NZ,Pace,1999-10-29,Ahmedabad,India,1999,2,108,168,2,1,649,1266,11,541,1098,9,59.0,>30,IND,Away,Upto 2014
CZ Harris,NZ,Pace,2002-05-01,Lahore,Pakistan,2002,1,109,174,1,1,476,866,17,367,692,16,28.0,<=30,PAK,Away,Upto 2014
CZ Harris,NZ,Pace,2002-06-21,Bridgetown,West Indies,2002,1,17,54,0,1,787,1616,30,770,1562,30,26.233333333333334,<=30,WI,Away,Upto 2014
CZ Harris,NZ,Pace,2002-06-28,St George's,West Indies,2002,1,40,90,0,1,623,1356,15,583,1266,15,41.53333333333333,>30,WI,Away,Upto 2014
D Bishoo,WI,Spin,2011-05-12,Providence,West Indies,2011,2,124,276,4,1,348,989,21,224,713,17,16.571428571428573,<=30,WI,Home,Upto 2014
D Bishoo,WI,Spin,2011-05-20,Basseterre,West Indies,2011,2,229,425,5,1,530,1213,20,301,788,15,26.5,<=30,WI,Home,Upto 2014
D Bishoo,WI,Spin,2011-06-20,Kingston,West Indies,2011,2,140,215,7,1,367,624,15,227,409,8,24.466666666666665,<=30,WI,Home,Upto 2014
D Bishoo,WI,Spin,2011-06-28,Bridgetown,West Indies,2011,2,109,246,3,1,187,468,5,78,222,2,37.4,>30,WI,Home,Upto 2014
D Bishoo,WI,Spin,2011-07-06,Roseau,West Indies,2011,2,142,276,2,1,478,1095,12,336,819,10,39.833333333333336,>30,WI,Home,Upto 2014
D Bishoo,WI,Spin,2011-10-21,Chattogram,Bangladesh,2011,1,81,180,3,1,473,864,18,392,684,15,26.27777777777778,<=30,BAN,Away,Upto 2014
D Bishoo,WI,Spin,2011-10-29,Mirpur,Bangladesh,2011,2,152,288,8,1,846,1669,23,694,1381,15,36.78260869565217,>30,BAN,Away,Upto 2014
D Bishoo,WI,Spin,2011-11-06,Delhi,India,2011,2,111,216,3,1,434,957,21,323,741,18,20.666666666666668,<=30,IND,Away,Upto 2014
D Bishoo,WI,Spin,2011-11-14,Eden Gardens,India,2011,1,154,270,1,1,689,1188,12,535,918,11,57.416666666666664,>30,IND,Away,Upto 2014
D Bishoo,WI,Spin,2011-11-22,Wankhede,India,2011,2,171,336,3,1,794,1593,24,623,1257,21,33.083333333333336,>30,IND,Away,Upto 2014
D Bishoo,WI,Spin,2012-04-07,Bridgetown,West Indies,2012,2,169,318,1,1,422,828,8,253,510,7,52.75,>30,WI,Home,Upto 2014
D Bishoo,WI,Spin,2015-04-21,St George's,West Indies,2015,2,209,354,4,1,451,913,9,242,559,5,50.111111111111114,>30,WI,Home,After 1965
D Bishoo,WI,Spin,2015-06-03,Roseau,West Indies,2015,1,80,198,6,1,294,570,11,214,372,5,26.727272727272727,<=30,WI,Home,After 1965
D Bishoo,WI,Spin,2015-10-14,Galle,Sri Lanka,2015,1,143,243,4,1,555,1017,18,412,774,14,30.833333333333332,>30,SL,Away,After 1965
D Bishoo,WI,Spin,2015-10-22,Colombo (PSS),Sri Lanka,2015,2,79,168,1,1,448,1072,27,369,904,26,16.59259259259259,<=30,SL,Away,After 1965
D Bishoo,WI,Spin,2016-07-21,North Sound,West Indies,2016,1,163,258,3,1,560,1009,16,397,751,13,35.0,>30,WI,Home,After 1965
D Bishoo,WI,Spin,2016-07-30,Kingston,West Indies,2016,1,107,210,1,1,562,982,15,455,772,14,37.46666666666667,>30,WI,Home,After 1965
D Bishoo,WI,Spin,2016-10-13,Dubai (DICS),UAE,2016,2,174,293,10,1,657,1312,22,483,1019,12,29.863636363636363,<=30,UAE,Away,After 1965
D Bishoo,WI,Spin,2016-10-21,Abu Dhabi,UAE,2016,2,189,276,1,1,703,1324,15,514,1048,14,46.86666666666667,>30,UAE,Away,After 1965
D Bishoo,WI,Spin,2016-10-30,Sharjah,UAE,2016,2,123,240,7,1,457,972,14,334,732,7,32.642857142857146,>30,UAE,Away,After 1965
D Bishoo,WI,Spin,2017-04-21,Kingston,West Indies,2017,2,125,215,2,1,338,583,11,213,368,9,30.727272727272727,>30,WI,Home,After 1965
D Bishoo,WI,Spin,2017-04-30,Bridgetown,West Indies,2017,1,116,246,3,1,516,1000,13,400,754,10,39.69230769230769,>30,WI,Home,After 1965
D Bishoo,WI,Spin,2017-05-10,Roseau,West Indies,2017,2,115,225,4,1,500,993,18,385,768,14,27.77777777777778,<=30,WI,Home,After 1965
D Bishoo,WI,Spin,2017-08-25,Leeds,England,2017,2,94,186,2,1,415,774,7,321,588,5,59.285714285714285,>30,ENG,Away,After 1965
D Bishoo,WI,Spin,2017-09-07,Lord's,England,2017,1,35,66,1,1,84,138,1,49,72,0,84.0,>30,ENG,Away,After 1965
D Bishoo,WI,Spin,2017-10-21,Bulawayo,Zimbabwe,2017,2,184,336,9,1,674,1311,28,490,975,19,24.071428571428573,<=30,ZIM,Away,After 1965
D Bishoo,WI,Spin,2017-10-29,Bulawayo,Zimbabwe,2017,2,156,354,4,1,706,1640,15,550,1286,11,47.06666666666667,>30,ZIM,Away,After 1965
D Bishoo,WI,Spin,2018-06-06,Port of Spain,West Indies,2018,2,73,192,4,1,353,866,12,280,674,8,29.416666666666668,<=30,WI,Home,After 1965
D Bishoo,WI,Spin,2018-06-14,Gros Islet,West Indies,2018,2,73,132,0,1,246,492,2,173,360,2,123.0,>30,WI,Home,After 1965
D Bishoo,WI,Spin,2018-06-23,Bridgetown,West Indies,2018,2,5,12,0,1,34,93,2,29,81,2,17.0,<=30,WI,Home,After 1965
D Bishoo,WI,Spin,2018-07-04,North Sound,West Indies,2018,1,16,30,0,1,218,480,6,202,450,6,36.333333333333336,>30,WI,Home,After 1965
D Bishoo,WI,Spin,2018-10-04,Rajkot,India,2018,1,217,324,4,1,685,1000,22,468,676,18,31.136363636363637,>30,IND,Away,After 1965
D Bishoo,WI,Spin,2018-10-12,Hyderabad,India,2018,2,97,151,0,1,524,1095,12,427,944,12,43.666666666666664,>30,IND,Away,After 1965
D Bishoo,WI,Spin,2018-11-22,Chattogram,Bangladesh,2018,2,86,144,5,1,618,1097,34,532,953,29,18.176470588235293,<=30,BAN,Away,After 1965
D Bishoo,WI,Spin,2018-11-30,Mirpur,Bangladesh,2018,1,109,168,2,1,676,1230,27,567,1062,25,25.037037037037038,<=30,BAN,Away,After 1965
D Elgar,SA,Spin,2012-11-30,W.A.C.A,Australia,2012,1,4,6,0,1,376,409,9,372,403,9,41.77777777777778,>30,AUS,Away,Upto 2014
D Elgar,SA,Spin,2013-02-14,Cape Town,South Africa,2013,1,14,12,0,1,363,754,16,349,742,16,22.6875,<=30,SA,Home,Upto 2014
D Elgar,SA,Spin,2013-10-23,Dubai (DICS),UAE,2013,1,3,12,1,1,497,1052,19,494,1040,18,26.157894736842106,<=30,UAE,Away,Upto 2014
D Elgar,SA,Spin,2014-02-20,Gqeberha,South Africa,2014,2,25,49,1,1,316,654,11,291,605,10,28.727272727272727,<=30,SA,Home,After 1965
D Elgar,SA,Spin,2014-03-01,Cape Town,South Africa,2014,2,117,150,1,1,386,690,6,269,540,5,64.33333333333333,>30,SA,Home,After 1965
D Elgar,SA,Spin,2014-07-16,Galle,Sri Lanka,2014,2,26,48,0,1,723,1396,15,697,1348,15,48.2,>30,SL,Away,After 1965
D Elgar,SA,Spin,2014-07-24,Colombo (SSC),Sri Lanka,2014,2,14,12,0,1,647,1745,22,633,1733,22,29.40909090909091,<=30,SL,Away,After 1965
D Elgar,SA,Spin,2014-08-09,Harare,Zimbabwe,2014,1,20,18,0,1,495,865,15,475,847,15,33.0,>30,ZIM,Away,After 1965
D Elgar,SA,Spin,2014-12-17,Centurion,South Africa,2014,2,20,30,1,1,274,453,3,254,423,2,91.33333333333333,>30,SA,Home,After 1965
D Elgar,SA,Spin,2014-12-26,Gqeberha,South Africa,2014,1,5,6,0,1,215,336,4,210,330,4,53.75,>30,SA,Home,After 1965
D Elgar,SA,Spin,2015-01-02,Cape Town,South Africa,2015,1,6,12,0,1,390,806,12,384,794,12,32.5,>30,SA,Home,After 1965
D Elgar,SA,Spin,2015-07-21,Chattogram,Bangladesh,2015,1,6,18,1,1,318,607,10,312,589,9,31.8,>30,BAN,Away,After 1965
D Elgar,SA,Spin,2015-07-30,Mirpur,Bangladesh,2015,1,22,42,1,1,125,270,4,103,228,3,31.25,>30,BAN,Away,After 1965
D Elgar,SA,Spin,2015-11-05,Mohali,India,2015,2,56,90,4,1,466,1004,34,410,914,30,13.705882352941176,<=30,IND,Away,After 1965
D Elgar,SA,Spin,2015-11-25,Nagpur,India,2015,1,7,24,1,1,483,1096,33,476,1072,32,14.636363636363637,<=30,IND,Away,After 1965
D Elgar,SA,Spin,2015-12-03,Delhi,India,2015,2,73,144,0,1,551,1517,20,478,1373,20,27.55,<=30,IND,Away,After 1965
D Elgar,SA,Spin,2015-12-26,Durban,South Africa,2015,2,54,96,0,1,402,738,13,348,642,13,30.923076923076923,>30,SA,Home,After 1965
D Elgar,SA,Spin,2016-01-02,Cape Town,South Africa,2016,2,27,60,0,1,386,750,3,359,690,3,128.66666666666666,>30,SA,Home,After 1965
D Elgar,SA,Spin,2016-01-14,Johannesburg,South Africa,2016,1,10,22,2,1,60,118,3,50,96,1,20.0,<=30,SA,Home,After 1965
D Elgar,SA,Spin,2016-01-22,Centurion,South Africa,2016,2,21,36,0,1,309,534,4,288,498,4,77.25,>30,SA,Home,After 1965
D Elgar,SA,Spin,2016-11-24,Adelaide,Australia,2016,1,11,12,0,1,296,533,6,285,521,6,49.333333333333336,>30,AUS,Away,After 1965
D Elgar,SA,Spin,2017-03-25,Hamilton,New Zealand,2017,1,13,6,0,1,252,528,5,239,522,5,50.4,>30,NZ,Away,After 1965
D Elgar,SA,Spin,2017-07-27,The Oval,England,2017,1,28,18,0,1,198,330,8,170,312,8,24.75,<=30,ENG,Away,After 1965
D Elgar,SA,Spin,2018-03-01,Durban,South Africa,2018,1,10,18,1,1,376,722,13,366,704,12,28.923076923076923,<=30,SA,Home,After 1965
D Elgar,SA,Spin,2018-03-09,Gqeberha,South Africa,2018,1,6,6,0,1,252,456,5,246,450,5,50.4,>30,SA,Home,After 1965
D Elgar,SA,Spin,2018-07-12,Galle,Sri Lanka,2018,1,7,6,0,1,416,921,25,409,915,25,16.64,<=30,SL,Away,After 1965
D Elgar,SA,Spin,2018-07-20,Colombo (SSC),Sri Lanka,2018,2,12,24,0,1,722,1323,32,710,1299,32,22.5625,<=30,SL,Away,After 1965
D Elgar,SA,Spin,2019-01-11,Johannesburg,South Africa,2019,1,1,4,0,1,90,145,4,89,141,4,22.5,<=30,SA,Home,After 1965
D Elgar,SA,Spin,2019-02-13,Durban,South Africa,2019,1,5,6,0,1,237,390,9,232,384,9,26.333333333333332,<=30,SA,Home,After 1965
D Elgar,SA,Spin,2019-10-02,Visakhapatnam,India,2019,1,4,6,1,1,1062,1652,22,1058,1646,21,48.27272727272727,>30,IND,Away,After 1965
D Elgar,SA,Spin,2019-10-10,Pune,India,2019,1,26,24,0,1,587,1113,12,561,1089,12,48.916666666666664,>30,IND,Away,After 1965
D Elgar,SA,Spin,2020-01-16,Gqeberha,South Africa,2020,1,6,6,0,1,395,936,15,389,930,15,26.333333333333332,<=30,SA,Home,After 1965
D Elgar,SA,Spin,2021-02-04,Rawalpindi,Pakistan,2021,1,6,7,0,1,496,1138,13,490,1131,13,38.15384615384615,>30,PAK,Away,After 1965
D Elgar,SA,Spin,2022-03-31,Durban,South Africa,2022,1,8,6,0,1,428,1068,20,420,1062,20,21.4,<=30,SA,Home,After 1965
D Ganesh,IND,Pace,1997-01-02,Cape Town,South Africa,1997,2,131,203,1,1,897,1609,22,766,1406,21,40.77272727272727,>30,SA,Away,Upto 2014
D Ganesh,IND,Pace,1997-01-16,Johannesburg,South Africa,1997,2,34,54,0,1,895,1774,26,861,1720,26,34.42307692307692,>30,SA,Away,Upto 2014
D Ganesh,IND,Pace,1997-03-27,Bridgetown,West Indies,1997,2,98,162,4,1,738,1569,38,640,1407,34,19.42105263157895,<=30,WI,Away,Upto 2014
D Ganesh,IND,Pace,1997-04-17,Georgetown,West Indies,1997,1,24,42,0,1,344,855,6,320,813,6,57.333333333333336,>30,WI,Away,Upto 2014
D Ganga,WI,Spin,2003-04-10,Georgetown,West Indies,2003,2,10,30,0,1,403,631,9,393,601,9,44.77777777777778,>30,WI,Home,Upto 2014
D Ganga,WI,Spin,2003-11-04,Harare,Zimbabwe,2003,1,0,6,0,1,313,784,11,313,778,11,28.454545454545453,<=30,ZIM,Away,Upto 2014
D Ganga,WI,Spin,2003-12-12,Johannesburg,South Africa,2003,1,26,24,0,1,214,258,1,188,234,1,214.0,>30,SA,Away,Upto 2014
D Ganga,WI,Spin,2003-12-26,Durban,South Africa,2003,1,25,36,0,1,190,312,3,165,276,3,63.333333333333336,>30,SA,Away,Upto 2014
D Ganga,WI,Spin,2004-01-16,Centurion,South Africa,2004,1,21,60,0,1,187,304,2,166,244,2,93.5,>30,SA,Away,Upto 2014
D Ganga,WI,Spin,2005-03-31,Georgetown,West Indies,2005,1,4,6,0,1,281,750,4,277,744,4,70.25,>30,WI,Home,Upto 2014
D Ganga,WI,Spin,2006-11-27,Karachi,Pakistan,2006,1,20,24,1,1,303,725,10,283,701,9,30.3,>30,PAK,Away,Upto 2014
D Gough,ENG,Pace,1994-06-30,Manchester,England,1994,2,152,287,6,1,638,1439,22,486,1152,16,29.0,<=30,ENG,Home,Upto 2014
D Gough,ENG,Pace,1994-07-21,Lord's,England,1994,2,122,285,8,1,636,1408,31,514,1123,23,20.516129032258064,<=30,ENG,Home,Upto 2014
D Gough,ENG,Pace,1994-08-04,Leeds,England,1994,2,168,282,2,1,1145,2209,21,977,1927,19,54.523809523809526,>30,ENG,Home,Upto 2014
D Gough,ENG,Pace,1994-08-18,The Oval,England,1994,2,124,168,1,1,962,1490,30,838,1322,29,32.06666666666667,>30,ENG,Home,Upto 2014
D Gough,ENG,Pace,1994-11-25,Brisbane,Australia,1994,2,185,330,6,1,726,1262,21,541,932,15,34.57142857142857,>30,AUS,Away,Upto 2014
D Gough,ENG,Pace,1994-12-24,Melbourne,Australia,1994,2,119,306,7,1,587,1268,21,468,962,14,27.952380952380953,<=30,AUS,Away,Upto 2014
D Gough,ENG,Pace,1995-01-01,Sydney,Australia,1995,2,121,281,7,1,651,1345,27,530,1064,20,24.11111111111111,<=30,AUS,Away,Upto 2014
D Gough,ENG,Pace,1995-06-08,Leeds,England,1995,1,24,30,1,1,698,1234,27,674,1204,26,25.85185185185185,<=30,ENG,Home,Upto 2014
D Gough,ENG,Pace,1995-06-22,Lord's,England,1995,2,163,282,5,1,1000,2102,38,837,1820,33,26.31578947368421,<=30,ENG,Home,Upto 2014
D Gough,ENG,Pace,1995-07-06,Birmingham,England,1995,1,68,108,0,1,511,986,26,443,878,26,19.653846153846153,<=30,ENG,Home,Upto 2014
D Gough,ENG,Pace,1995-11-30,Johannesburg,South Africa,1995,2,112,162,0,1,999,2058,30,887,1896,30,33.3,>30,SA,Away,Upto 2014
D Gough,ENG,Pace,1996-12-18,Bulawayo,Zimbabwe,1996,2,131,228,3,1,665,1230,17,534,1002,14,39.11764705882353,>30,ZIM,Away,Upto 2014
D Gough,ENG,Pace,1996-12-26,Harare,Zimbabwe,1996,1,40,156,4,1,330,1045,15,290,889,11,22.0,<=30,ZIM,Away,Upto 2014
D Gough,ENG,Pace,1997-01-24,Auckland,New Zealand,1997,2,157,324,6,1,815,1797,20,658,1473,14,40.75,>30,NZ,Away,Upto 2014
D Gough,ENG,Pace,1997-02-06,Wellington,New Zealand,1997,2,92,234,9,1,457,1115,23,365,881,14,19.869565217391305,<=30,NZ,Away,Upto 2014
D Gough,ENG,Pace,1997-02-14,Christchurch,New Zealand,1997,2,112,207,4,1,695,1595,19,583,1388,15,36.578947368421055,>30,NZ,Away,Upto 2014
D Gough,ENG,Pace,1997-06-05,Birmingham,England,1997,2,166,270,6,1,837,1443,24,671,1173,18,34.875,>30,ENG,Home,Upto 2014
D Gough,ENG,Pace,1997-06-19,Lord's,England,1997,1,82,120,2,1,411,849,18,329,729,16,22.833333333333332,<=30,ENG,Home,Upto 2014
D Gough,ENG,Pace,1997-07-03,Manchester,England,1997,2,114,246,3,1,664,1429,26,550,1183,23,25.53846153846154,<=30,ENG,Home,Upto 2014
D Gough,ENG,Pace,1997-07-24,Leeds,England,1997,1,149,216,5,1,800,1403,28,651,1187,23,28.571428571428573,<=30,ENG,Home,Upto 2014
D Gough,ENG,Pace,1998-07-02,Manchester,England,1998,1,116,222,3,1,671,1668,18,555,1446,15,37.27777777777778,>30,ENG,Home,Upto 2014
D Gough,ENG,Pace,1998-07-23,Nottingham,England,1998,2,172,278,5,1,995,2152,32,823,1874,27,31.09375,>30,ENG,Home,Upto 2014
D Gough,ENG,Pace,1998-08-06,Leeds,England,1998,2,100,285,9,1,826,2084,40,726,1799,31,20.65,<=30,ENG,Home,Upto 2014
D Gough,ENG,Pace,1998-08-27,The Oval,England,1998,1,102,180,2,1,707,1308,12,605,1128,10,58.916666666666664,>30,ENG,Home,Upto 2014
D Gough,ENG,Pace,1998-11-20,Brisbane,Australia,1998,2,185,240,1,1,919,1808,20,734,1568,19,45.95,>30,AUS,Away,Upto 2014
D Gough,ENG,Pace,1998-11-28,W.A.C.A,Australia,1998,2,61,204,4,1,564,1246,31,503,1042,27,18.193548387096776,<=30,AUS,Away,Upto 2014
D Gough,ENG,Pace,1998-12-11,Adelaide,Australia,1998,2,179,311,5,1,622,1222,21,443,911,16,29.61904761904762,<=30,AUS,Away,Upto 2014
D Gough,ENG,Pace,1998-12-26,Melbourne,Australia,1998,2,150,262,7,1,840,1515,33,690,1253,26,25.454545454545453,<=30,AUS,Away,Upto 2014
D Gough,ENG,Pace,1999-01-02,Sydney,Australia,1999,2,112,192,4,1,361,687,17,249,495,13,21.235294117647058,<=30,AUS,Away,Upto 2014
D Gough,ENG,Pace,1999-11-25,Johannesburg,South Africa,1999,1,70,180,5,1,668,1442,28,598,1262,23,23.857142857142858,<=30,SA,Away,Upto 2014
D Gough,ENG,Pace,1999-12-09,Gqeberha,South Africa,1999,2,159,241,2,1,939,2119,25,780,1878,23,37.56,>30,SA,Away,Upto 2014
D Gough,ENG,Pace,1999-12-26,Durban,South Africa,1999,2,118,263,3,1,784,1865,22,666,1602,19,35.63636363636363,>30,SA,Away,Upto 2014
D Gough,ENG,Pace,2000-01-02,Cape Town,South Africa,2000,1,88,222,2,1,594,1440,24,506,1218,22,24.75,<=30,SA,Away,Upto 2014
D Gough,ENG,Pace,2000-01-14,Centurion,South Africa,2000,1,92,120,2,1,437,835,14,345,715,12,31.214285714285715,>30,SA,Away,Upto 2014
D Gough,ENG,Pace,2000-05-18,Lord's,England,2000,2,93,165,6,1,527,1078,29,434,913,23,18.17241379310345,<=30,ENG,Home,Upto 2014
D Gough,ENG,Pace,2000-06-01,Nottingham,England,2000,2,81,132,3,1,655,1521,23,574,1389,20,28.47826086956522,<=30,ENG,Home,Upto 2014
D Gough,ENG,Pace,2000-06-15,Birmingham,England,2000,1,109,221,5,1,606,1373,25,497,1152,20,24.24,<=30,ENG,Home,Upto 2014
D Gough,ENG,Pace,2000-06-29,Lord's,England,2000,2,89,174,6,1,573,1340,36,484,1166,30,15.916666666666666,<=30,ENG,Home,Upto 2014
D Gough,ENG,Pace,2000-08-03,Manchester,England,2000,2,154,288,3,1,672,1537,23,518,1249,20,29.217391304347824,<=30,ENG,Home,Upto 2014
D Gough,ENG,Pace,2000-08-17,Leeds,England,2000,2,89,162,7,1,405,817,24,316,655,17,16.875,<=30,ENG,Home,Upto 2014
D Gough,ENG,Pace,2000-08-31,The Oval,England,2000,2,89,198,4,1,613,1636,30,524,1438,26,20.433333333333334,<=30,ENG,Home,Upto 2014
D Gough,ENG,Pace,2000-11-15,Lahore,Pakistan,2000,1,45,102,0,1,230,588,2,185,486,2,115.0,>30,PAK,Away,Upto 2014
D Gough,ENG,Pace,2000-11-29,Faisalabad,Pakistan,2000,2,111,201,4,1,365,711,8,254,510,4,45.625,>30,PAK,Away,Upto 2014
D Gough,ENG,Pace,2000-12-07,Karachi,Pakistan,2000,2,112,244,6,1,458,1000,15,346,756,9,30.533333333333335,>30,PAK,Away,Upto 2014
D Gough,ENG,Pace,2001-02-22,Galle,Sri Lanka,2001,1,95,156,1,1,243,606,5,148,450,4,48.6,>30,SL,Away,Upto 2014
D Gough,ENG,Pace,2001-03-07,Kandy,Sri Lanka,2001,2,123,216,8,1,362,762,19,239,546,11,19.05263157894737,<=30,SL,Away,Upto 2014
D Gough,ENG,Pace,2001-03-15,Colombo (SSC),Sri Lanka,2001,2,56,120,5,1,242,462,16,186,342,11,15.125,<=30,SL,Away,Upto 2014
D Gough,ENG,Pace,2001-05-17,Lord's,England,2001,2,101,192,8,1,714,1443,30,613,1251,22,23.8,<=30,ENG,Home,Upto 2014
D Gough,ENG,Pace,2001-05-31,Manchester,England,2001,2,179,279,6,1,1134,1996,31,955,1717,25,36.58064516129032,>30,ENG,Home,Upto 2014
D Gough,ENG,Pace,2001-07-05,Birmingham,England,2001,1,152,198,3,1,685,933,19,533,735,16,36.05263157894737,>30,ENG,Home,Upto 2014
D Gough,ENG,Pace,2001-07-19,Lord's,England,2001,2,120,162,4,1,636,1130,28,516,968,24,22.714285714285715,<=30,ENG,Home,Upto 2014
D Gough,ENG,Pace,2001-08-02,Nottingham,England,2001,2,101,144,2,1,583,930,24,482,786,22,24.291666666666668,<=30,ENG,Home,Upto 2014
D Gough,ENG,Pace,2001-08-16,Leeds,England,2001,2,171,253,7,1,1054,1608,26,883,1355,19,40.53846153846154,>30,ENG,Home,Upto 2014
D Gough,ENG,Pace,2001-08-23,The Oval,England,2001,1,113,174,1,1,586,1029,9,473,855,8,65.11111111111111,>30,ENG,Home,Upto 2014
D Gough,ENG,Pace,2003-07-24,Birmingham,England,2003,1,88,150,1,1,873,1408,14,785,1258,13,62.357142857142854,>30,ENG,Home,Upto 2014
D Gough,ENG,Pace,2003-07-31,Lord's,England,2003,1,127,168,0,1,967,1600,24,840,1432,24,40.291666666666664,>30,ENG,Home,Upto 2014
D Hettiarachchi,SL,Spin,2001-03-15,Colombo (SSC),Sri Lanka,2001,2,41,162,2,1,375,1120,19,334,958,17,19.736842105263158,<=30,SL,Home,Upto 2014
D Lloyd,ENG,Spin,1974-06-20,Lord's,England,1974,1,4,12,0,1,526,1013,10,522,1001,10,52.6,>30,ENG,Home,Upto 2014
D Lloyd,ENG,Spin,1974-08-22,The Oval,England,1974,1,13,12,0,1,476,1138,12,463,1126,12,39.666666666666664,>30,ENG,Home,Upto 2014
D Madushanka,SL,Pace,2023-07-24,Colombo (SSC),Sri Lanka,2023,1,77,102,0,1,369,580,10,292,478,10,36.9,>30,SL,Home,After 1965
D Mohammed,WI,Spin,2004-01-02,Cape Town,South Africa,2004,2,142,234,3,1,458,726,4,316,492,1,114.5,>30,SA,Away,Upto 2014
D Mohammed,WI,Spin,2004-08-12,Manchester,England,2004,2,102,192,0,1,277,526,4,175,334,4,69.25,>30,ENG,Away,Upto 2014
D Mohammed,WI,Spin,2006-06-02,St John's,West Indies,2006,2,186,221,4,1,672,1196,20,486,975,16,33.6,>30,WI,Home,Upto 2014
D Mohammed,WI,Spin,2006-11-11,Lahore,Pakistan,2006,1,98,186,3,1,296,600,9,198,414,6,32.888888888888886,>30,PAK,Away,Upto 2014
D Mohammed,WI,Spin,2006-11-19,Multan,Pakistan,2006,2,140,232,3,1,610,1072,9,470,840,6,67.77777777777777,>30,PAK,Away,Upto 2014
D Myers,ZIM,Pace,2021-07-07,Harare,Zimbabwe,2021,1,13,18,0,1,697,1302,16,684,1284,16,43.5625,>30,ZIM,Home,After 1965
D Olivier,SA,Pace,2017-01-12,Johannesburg,South Africa,2017,2,57,108,5,1,621,1136,30,564,1028,25,20.7,<=30,SA,Home,After 1965
D Olivier,SA,Pace,2017-07-14,Nottingham,England,2017,2,64,62,2,1,739,1395,28,675,1333,26,26.392857142857142,<=30,ENG,Away,After 1965
D Olivier,SA,Pace,2017-08-04,Manchester,England,2017,2,129,198,5,1,698,1268,30,569,1070,25,23.266666666666666,<=30,ENG,Away,After 1965
D Olivier,SA,Pace,2017-09-28,Potchefstroom,South Africa,2017,2,64,100,1,1,634,1140,16,570,1040,15,39.625,>30,SA,Home,After 1965
D Olivier,SA,Pace,2017-10-06,Bloemfontein,South Africa,2017,2,79,138,4,1,638,933,23,559,795,19,27.73913043478261,<=30,SA,Home,After 1965
D Olivier,SA,Pace,2018-12-26,Centurion,South Africa,2018,2,96,174,11,1,620,1128,33,524,954,22,18.78787878787879,<=30,SA,Home,After 1965
D Olivier,SA,Pace,2019-01-03,Cape Town,South Africa,2019,2,132,186,5,1,809,1380,31,677,1194,26,26.096774193548388,<=30,SA,Home,After 1965
D Olivier,SA,Pace,2019-01-11,Johannesburg,South Africa,2019,2,125,168,8,1,906,1496,35,781,1328,27,25.885714285714286,<=30,SA,Home,After 1965
D Olivier,SA,Pace,2019-02-13,Durban,South Africa,2019,2,71,174,3,1,725,1312,28,654,1138,25,25.892857142857142,<=30,SA,Home,After 1965
D Olivier,SA,Pace,2019-02-21,Gqeberha,South Africa,2019,2,107,132,4,1,552,954,24,445,822,20,23.0,<=30,SA,Home,After 1965
D Olivier,SA,Pace,2022-01-03,Johannesburg,South Africa,2022,2,115,174,4,1,818,1482,32,703,1308,28,25.5625,<=30,SA,Home,After 1965
D Olivier,SA,Pace,2022-01-11,Cape Town,South Africa,2022,2,80,168,1,1,686,1515,32,606,1347,31,21.4375,<=30,SA,Home,After 1965
D Olivier,SA,Pace,2022-02-17,Christchurch,New Zealand,2022,1,100,126,3,1,630,1205,28,530,1079,25,22.5,<=30,NZ,Away,After 1965
D Olivier,SA,Pace,2022-03-31,Durban,South Africa,2022,1,36,90,1,1,457,911,16,421,821,15,28.5625,<=30,SA,Home,After 1965
D Olivier,SA,Pace,2022-04-08,Gqeberha,South Africa,2022,1,39,90,2,1,403,672,9,364,582,7,44.77777777777778,>30,SA,Home,After 1965
D Olivier,SA,Pace,2024-02-04,Mount Maunganui,New Zealand,2024,2,138,204,0,1,753,1368,17,615,1164,17,44.294117647058826,>30,NZ,Away,After 1965
D Paterson,SA,Pace,2020-01-16,Gqeberha,South Africa,2020,1,62,144,1,1,517,1029,13,455,885,12,39.76923076923077,>30,SA,Home,After 1965
D Paterson,SA,Pace,2020-01-24,Johannesburg,South Africa,2020,2,104,203,3,1,1022,1773,39,918,1570,36,26.205128205128204,<=30,SA,Home,After 1965
D Paterson,SA,Pace,2024-02-04,Mount Maunganui,New Zealand,2024,2,136,252,2,1,753,1368,17,617,1116,15,44.294117647058826,>30,NZ,Away,After 1965
D Paterson,SA,Pace,2024-02-13,Hamilton,New Zealand,2024,2,97,234,3,1,507,1179,18,410,945,15,28.166666666666668,<=30,NZ,Away,After 1965
D Paterson,SA,Pace,2024-10-29,Chattogram,Bangladesh,2024,2,37,78,3,1,267,480,9,230,402,6,29.666666666666668,<=30,BAN,Away,After 1965
D Paterson,SA,Pace,2024-12-05,Gqeberha,South Africa,2024,2,104,204,7,1,793,1361,26,689,1157,19,30.5,>30,SA,Home,After 1965
D Paterson,SA,Pace,2024-12-26,Centurion,South Africa,2024,2,116,204,6,1,742,1206,32,626,1002,26,23.1875,<=30,SA,Home,After 1965
D Pretorius,SA,Pace,2002-03-08,Cape Town,South Africa,2002,2,132,150,1,1,927,1517,20,795,1367,19,46.35,>30,SA,Home,Upto 2014
D Pretorius,SA,Pace,2003-07-24,Birmingham,England,2003,2,135,210,4,1,873,1408,14,738,1198,10,62.357142857142854,>30,ENG,Away,Upto 2014
D Pretorius,SA,Pace,2003-07-31,Lord's,England,2003,2,36,42,0,1,967,1600,24,931,1558,24,40.291666666666664,>30,ENG,Away,Upto 2014
D Pretorius,SA,Pace,2003-08-21,Leeds,England,2003,2,127,168,1,1,1130,2145,39,1003,1977,38,28.974358974358974,<=30,ENG,Away,Upto 2014
D Pretorius,SA,Pace,2019-12-26,Centurion,South Africa,2019,2,49,144,2,1,888,1593,38,839,1449,36,23.36842105263158,<=30,SA,Home,After 1965
D Pretorius,SA,Pace,2020-01-03,Cape Town,South Africa,2020,2,82,162,3,1,689,1635,31,607,1473,28,22.225806451612904,<=30,SA,Home,After 1965
D Pretorius,SA,Pace,2020-01-24,Johannesburg,South Africa,2020,2,121,174,2,1,1022,1773,39,901,1599,37,26.205128205128204,<=30,SA,Home,After 1965
D Ramnarine,WI,Spin,1998-02-27,Georgetown,West Indies,1998,2,49,168,3,1,391,1045,18,342,877,15,21.72222222222222,<=30,WI,Home,Upto 2014
D Ramnarine,WI,Spin,1998-03-20,St John's,West Indies,1998,2,99,378,6,1,334,948,8,235,570,2,41.75,>30,WI,Home,Upto 2014
D Ramnarine,WI,Spin,1999-12-16,Hamilton,New Zealand,1999,2,86,222,3,1,276,775,8,190,553,5,34.5,>30,NZ,Away,Upto 2014
D Ramnarine,WI,Spin,2001-03-09,Georgetown,West Indies,2001,2,151,411,4,1,353,904,9,202,493,5,39.22222222222222,>30,WI,Home,Upto 2014
D Ramnarine,WI,Spin,2001-03-17,Port of Spain,West Indies,2001,2,121,318,4,1,234,564,4,113,246,0,58.5,>30,WI,Home,Upto 2014
D Ramnarine,WI,Spin,2001-03-29,Bridgetown,West Indies,2001,2,164,390,6,1,341,1000,14,177,610,8,24.357142857142858,<=30,WI,Home,Upto 2014
D Ramnarine,WI,Spin,2001-04-06,St John's,West Indies,2001,2,100,372,2,1,425,1266,13,325,894,11,32.69230769230769,>30,WI,Home,Upto 2014
D Ramnarine,WI,Spin,2001-04-19,Kingston,West Indies,2001,2,81,252,4,1,221,617,7,140,365,3,31.571428571428573,>30,WI,Home,Upto 2014
D Ramnarine,WI,Spin,2001-11-13,Galle,Sri Lanka,2001,1,158,348,3,1,681,1597,17,523,1249,14,40.05882352941177,>30,SL,Away,Upto 2014
D Ramnarine,WI,Spin,2001-11-21,Kandy,Sri Lanka,2001,2,147,246,7,1,458,1038,19,311,792,12,24.105263157894736,<=30,SL,Away,Upto 2014
D Ramnarine,WI,Spin,2001-11-29,Colombo (SSC),Sri Lanka,2001,1,51,102,0,1,542,1074,5,491,972,5,108.4,>30,SL,Away,Upto 2014
D Ramnarine,WI,Spin,2002-02-07,Sharjah,UAE,2002,2,176,288,3,1,492,929,10,316,641,7,49.2,>30,UAE,Away,Upto 2014
D Shackleton,ENG,Pace,1950-07-20,Nottingham,England,1950,2,135,294,1,1,535,1228,10,400,934,9,53.5,>30,ENG,Home,Upto 2014
D Shackleton,ENG,Pace,1951-08-16,The Oval,England,1951,2,39,150,1,1,309,956,16,270,806,15,19.3125,<=30,ENG,Home,Upto 2014
D Shackleton,ENG,Pace,1951-11-02,Delhi,India,1951,1,76,174,1,1,354,1056,2,278,882,1,177.0,>30,IND,Away,Upto 2014
D Shackleton,ENG,Pace,1963-06-20,Lord's,England,1963,2,165,506,7,1,666,1730,31,501,1224,24,21.483870967741936,<=30,ENG,Home,Upto 2014
D Shackleton,ENG,Pace,1963-07-04,Birmingham,England,1963,2,97,228,3,1,467,1099,27,370,871,24,17.296296296296298,<=30,ENG,Home,Upto 2014
D Shackleton,ENG,Pace,1963-07-25,Leeds,England,1963,2,151,408,4,1,551,1254,21,400,846,17,26.238095238095237,<=30,ENG,Home,Upto 2014
D Shackleton,ENG,Pace,1963-08-22,The Oval,England,1963,2,105,318,1,1,581,1365,22,476,1047,21,26.40909090909091,<=30,ENG,Home,Upto 2014
D Wilson,ENG,Spin,1964-01-10,Chennai,India,1964,2,69,168,2,1,876,2493,27,807,2325,25,32.44444444444444,>30,IND,Away,Upto 2014
D Wilson,ENG,Spin,1964-01-21,Brabourne,India,1964,2,69,228,1,1,560,2208,16,491,1980,15,35.0,>30,IND,Away,Upto 2014
D Wilson,ENG,Spin,1964-01-29,Eden Gardens,India,1964,2,72,222,3,1,555,1794,16,483,1572,13,34.6875,>30,IND,Away,Upto 2014
D Wilson,ENG,Spin,1964-02-08,Delhi,India,1964,2,115,378,3,1,1001,2631,20,886,2253,17,50.05,>30,IND,Away,Upto 2014
D Wilson,ENG,Spin,1964-02-15,Kanpur,India,1964,2,73,276,0,1,987,2874,18,914,2598,18,54.833333333333336,>30,IND,Away,Upto 2014
D Wilson,ENG,Spin,1971-02-25,Christchurch,New Zealand,1971,2,68,200,2,1,395,1134,21,327,934,19,18.80952380952381,<=30,NZ,Away,Upto 2014
DA Allen,ENG,Spin,1960-01-06,Bridgetown,West Indies,1960,1,82,258,0,1,518,1446,6,436,1188,6,86.33333333333333,>30,WI,Away,Upto 2014
DA Allen,ENG,Spin,1960-01-28,Port of Spain,West Indies,1960,2,66,216,3,1,448,1444,13,382,1228,10,34.46153846153846,>30,WI,Away,Upto 2014
DA Allen,ENG,Spin,1960-02-17,Kingston,West Indies,1960,2,76,222,1,1,443,1323,11,367,1101,10,40.27272727272727,>30,WI,Away,Upto 2014
DA Allen,ENG,Spin,1960-03-09,Georgetown,West Indies,1960,1,75,252,3,1,501,1694,13,426,1442,10,38.53846153846154,>30,WI,Away,Upto 2014
DA Allen,ENG,Spin,1960-03-25,Port of Spain,West Indies,1960,2,118,234,2,1,649,1404,16,531,1170,14,40.5625,>30,WI,Away,Upto 2014
DA Allen,ENG,Spin,1960-07-21,Manchester,England,1960,2,63,161,4,1,183,377,4,120,216,0,45.75,>30,ENG,Home,Upto 2014
DA Allen,ENG,Spin,1960-08-18,The Oval,England,1960,2,38,180,0,1,312,852,6,274,672,6,52.0,>30,ENG,Home,Upto 2014
DA Allen,ENG,Spin,1961-06-08,Birmingham,England,1961,1,88,144,2,1,367,819,8,279,675,6,45.875,>30,ENG,Home,Upto 2014
DA Allen,ENG,Spin,1961-07-06,Leeds,England,1961,2,75,252,3,1,330,840,7,255,588,4,47.142857142857146,>30,ENG,Home,Upto 2014
DA Allen,ENG,Spin,1961-07-27,Manchester,England,1961,1,58,228,4,1,285,796,15,227,568,11,19.0,<=30,ENG,Home,Upto 2014
DA Allen,ENG,Spin,1961-08-17,The Oval,England,1961,1,133,180,4,1,415,906,9,282,726,5,46.111111111111114,>30,ENG,Home,Upto 2014
DA Allen,ENG,Spin,1961-10-21,Lahore,Pakistan,1961,2,118,330,5,1,702,1631,18,584,1301,13,39.0,>30,PAK,Away,Upto 2014
DA Allen,ENG,Spin,1961-11-11,Brabourne,India,1961,2,66,300,3,1,727,1890,18,661,1590,15,40.388888888888886,>30,IND,Away,Upto 2014
DA Allen,ENG,Spin,1961-12-01,Kanpur,India,1961,1,88,258,1,1,792,2016,16,704,1758,15,49.5,>30,IND,Away,Upto 2014
DA Allen,ENG,Spin,1961-12-13,Delhi,India,1961,1,87,282,4,1,505,1242,8,418,960,4,63.125,>30,IND,Away,Upto 2014
DA Allen,ENG,Spin,1961-12-30,Eden Gardens,India,1961,2,162,464,9,1,632,1788,29,470,1324,20,21.79310344827586,<=30,IND,Away,Upto 2014
DA Allen,ENG,Spin,1962-01-10,Chennai,India,1962,2,180,507,4,1,866,2320,33,686,1813,29,26.242424242424242,<=30,IND,Away,Upto 2014
DA Allen,ENG,Spin,1962-01-19,Dhaka,Bangladesh,1962,2,124,382,7,1,862,2494,25,738,2112,18,34.48,>30,BAN,Away,Upto 2014
DA Allen,ENG,Spin,1962-02-02,Karachi,Pakistan,1962,2,93,372,1,1,769,2063,17,676,1691,16,45.23529411764706,>30,PAK,Away,Upto 2014
DA Allen,ENG,Spin,1962-05-31,Birmingham,England,1962,2,135,408,5,1,664,1386,13,529,978,8,51.07692307692308,>30,ENG,Home,Upto 2014
DA Allen,ENG,Spin,1962-06-21,Lord's,England,1962,1,41,90,1,1,359,496,6,318,406,5,59.833333333333336,>30,ENG,Home,Upto 2014
DA Allen,ENG,Spin,1962-07-05,Leeds,England,1962,2,61,198,3,1,208,474,7,147,276,4,29.714285714285715,<=30,ENG,Home,Upto 2014
DA Allen,ENG,Spin,1962-08-16,The Oval,England,1962,2,85,294,2,1,452,1071,6,367,777,4,75.33333333333333,>30,ENG,Home,Upto 2014
DA Allen,ENG,Spin,1963-02-15,Sydney,Australia,1963,2,113,496,5,1,588,2042,17,475,1546,12,34.588235294117645,>30,AUS,Away,Upto 2014
DA Allen,ENG,Spin,1963-06-06,Manchester,England,1963,2,123,343,2,1,595,1480,19,472,1137,17,31.31578947368421,>30,ENG,Home,Upto 2014
DA Allen,ENG,Spin,1963-06-20,Lord's,England,1963,2,85,186,2,1,329,816,7,244,630,5,47.0,>30,ENG,Home,Upto 2014
DA Allen,ENG,Spin,1964-06-04,Nottingham,England,1964,1,22,96,1,1,92,264,7,70,168,6,13.142857142857142,<=30,ENG,Home,Upto 2014
DA Allen,ENG,Spin,1964-12-04,Durban,South Africa,1964,2,140,401,7,1,464,1264,16,324,863,9,29.0,<=30,SA,Away,Upto 2014
DA Allen,ENG,Spin,1964-12-23,Johannesburg,South Africa,1964,2,132,528,5,1,545,1457,14,413,929,9,38.92857142857143,>30,SA,Away,Upto 2014
DA Allen,ENG,Spin,1965-01-01,Cape Town,South Africa,1965,2,106,342,2,1,605,1499,14,499,1157,12,43.214285714285715,>30,SA,Away,Upto 2014
DA Allen,ENG,Spin,1965-02-12,Gqeberha,South Africa,1965,1,80,264,3,1,437,1309,10,357,1045,7,43.7,>30,SA,Away,Upto 2014
DA Allen,ENG,Spin,1965-12-10,Brisbane,Australia,1965,1,108,312,0,1,514,1281,8,406,969,8,64.25,>30,AUS,Away,Upto 2014
DA Allen,ENG,Spin,1965-12-30,Melbourne,Australia,1965,2,103,304,3,1,661,1476,9,558,1172,6,73.44444444444444,>30,AUS,Away,Upto 2014
DA Allen,ENG,Spin,1966-01-07,Sydney,Australia,1966,2,89,312,6,1,404,1124,13,315,812,7,31.076923076923077,>30,AUS,Away,Upto 2014
DA Allen,ENG,Spin,1966-01-28,Adelaide,Australia,1966,1,103,168,0,1,423,991,7,320,823,7,60.42857142857143,>30,AUS,Away,Upto 2014
DA Allen,ENG,Spin,1966-02-25,Christchurch,New Zealand,1966,2,88,354,1,1,245,648,5,157,294,4,49.0,>30,NZ,Away,Upto 2014
DA Allen,ENG,Spin,1966-03-04,Dunedin,New Zealand,1966,2,114,364,6,1,185,556,9,71,192,3,20.555555555555557,<=30,NZ,Away,Upto 2014
DA Allen,ENG,Spin,1966-03-11,Auckland,New Zealand,1966,2,157,428,6,1,300,776,10,143,348,4,30.0,<=30,NZ,Away,Upto 2014
DA Allen,ENG,Spin,1966-06-02,Manchester,England,1966,1,104,187,2,1,479,1280,24,375,1093,22,19.958333333333332,<=30,ENG,Home,Upto 2014
DA Marillier,ZIM,Spin,2001-11-08,Dhaka,Bangladesh,2001,1,16,42,1,1,256,612,4,240,570,3,64.0,>30,BAN,Away,Upto 2014
DA Marillier,ZIM,Spin,2001-11-15,Chattogram,Bangladesh,2001,2,96,204,6,1,538,1183,18,442,979,12,29.88888888888889,<=30,BAN,Away,Upto 2014
DA Marillier,ZIM,Spin,2002-01-04,Kandy,Sri Lanka,2002,1,75,126,0,1,367,934,16,292,808,16,22.9375,<=30,SL,Away,Upto 2014
DA Marillier,ZIM,Spin,2002-01-12,Galle,Sri Lanka,2002,2,135,244,4,1,515,1423,24,380,1179,20,21.458333333333332,<=30,SL,Away,Upto 2014
DA Reeve,ENG,Pace,1992-01-18,Christchurch,New Zealand,1992,2,24,60,1,1,763,1516,14,739,1456,13,54.5,>30,NZ,Away,Upto 2014
DA Reeve,ENG,Pace,1992-01-30,Auckland,New Zealand,1992,1,21,42,0,1,740,1678,33,719,1636,33,22.424242424242426,<=30,NZ,Away,Upto 2014
DA Reeve,ENG,Pace,1992-02-06,Wellington,New Zealand,1992,2,15,47,1,1,603,1369,15,588,1322,14,40.2,>30,NZ,Away,Upto 2014
DA Renneberg,AUS,Pace,1966-12-23,Johannesburg,South Africa,1966,2,150,288,3,1,809,1914,26,659,1626,23,31.115384615384617,>30,SA,Away,Upto 2014
DA Renneberg,AUS,Pace,1966-12-31,Cape Town,South Africa,1966,2,114,252,2,1,762,1783,22,648,1531,20,34.63636363636363,>30,SA,Away,Upto 2014
DA Renneberg,AUS,Pace,1967-01-20,Durban,South Africa,1967,2,85,192,1,1,725,1921,25,640,1729,24,29.0,<=30,SA,Away,Upto 2014
DA Renneberg,AUS,Pace,1967-02-03,Johannesburg,South Africa,1967,1,97,150,5,1,518,1312,23,421,1162,18,22.52173913043478,<=30,SA,Away,Upto 2014
DA Renneberg,AUS,Pace,1967-02-24,Gqeberha,South Africa,1967,2,82,186,0,1,655,1640,26,573,1454,26,25.192307692307693,<=30,SA,Away,Upto 2014
DA Renneberg,AUS,Pace,1967-12-23,Adelaide,Australia,1967,2,84,162,6,1,596,1119,26,512,957,20,22.923076923076923,<=30,AUS,Home,Upto 2014
DA Renneberg,AUS,Pace,1967-12-30,Melbourne,Australia,1967,2,135,232,4,1,704,1270,18,569,1038,14,39.111111111111114,>30,AUS,Home,Upto 2014
DA Renneberg,AUS,Pace,1968-01-19,Brisbane,Australia,1968,2,83,136,2,1,552,1226,17,469,1090,15,32.470588235294116,>30,AUS,Home,Upto 2014
DA Stirling,NZ,Pace,1984-11-16,Lahore,Pakistan,1984,2,131,253,3,1,340,861,14,209,608,11,24.285714285714285,<=30,PAK,Away,Upto 2014
DA Stirling,NZ,Pace,1984-11-25,Hyderabad (Sind),Pakistan,1984,2,37,42,0,1,178,432,6,141,390,6,29.666666666666668,<=30,PAK,Away,Upto 2014
DA Stirling,NZ,Pace,1984-12-10,Karachi,Pakistan,1984,2,170,258,5,1,473,890,12,303,632,7,39.416666666666664,>30,PAK,Away,Upto 2014
DA Stirling,NZ,Pace,1985-04-26,Bridgetown,West Indies,1985,1,82,85,2,1,558,1140,29,476,1055,27,19.24137931034483,<=30,WI,Away,Upto 2014
DA Stirling,NZ,Pace,1986-08-07,Nottingham,England,1986,2,110,210,3,1,656,1476,21,546,1266,18,31.238095238095237,>30,ENG,Away,Upto 2014
DA Stirling,NZ,Pace,1986-08-21,The Oval,England,1986,1,71,54,0,1,479,811,12,408,757,12,39.916666666666664,>30,ENG,Away,Upto 2014
DA Warner,AUS,Spin,2011-12-01,Brisbane,Australia,2011,1,5,6,0,1,207,471,10,202,465,10,20.7,<=30,AUS,Home,Upto 2014
DA Warner,AUS,Spin,2011-12-26,Melbourne,Australia,2011,1,8,12,0,1,247,467,5,239,455,5,49.4,>30,AUS,Home,Upto 2014
DA Warner,AUS,Spin,2012-04-07,Bridgetown,West Indies,2012,1,45,60,2,1,422,828,8,377,768,6,52.75,>30,WI,Away,Upto 2014
DA Warner,AUS,Spin,2012-04-15,Port of Spain,West Indies,2012,1,9,18,0,1,339,951,13,330,933,13,26.076923076923077,<=30,WI,Away,Upto 2014
DA Warner,AUS,Spin,2012-04-23,Roseau,West Indies,2012,2,27,36,1,1,565,1160,26,538,1124,25,21.73076923076923,<=30,WI,Away,Upto 2014
DA Warner,AUS,Spin,2012-11-22,Adelaide,Australia,2012,2,56,66,1,1,554,1050,7,498,984,6,79.14285714285714,>30,AUS,Home,Upto 2014
DA Warner,AUS,Spin,2012-11-30,W.A.C.A,Australia,2012,1,14,18,0,1,376,409,9,362,391,9,41.77777777777778,>30,AUS,Home,Upto 2014
DA Warner,AUS,Spin,2012-12-14,Hobart,Australia,2012,1,8,24,0,1,352,719,7,344,695,7,50.285714285714285,>30,AUS,Home,Upto 2014
DA Warner,AUS,Spin,2013-02-22,Chennai,India,2013,1,19,18,0,1,771,1539,24,752,1521,24,32.125,>30,IND,Away,Upto 2014
DA Warner,AUS,Spin,2013-03-02,Hyderabad,India,2013,1,14,6,0,1,504,1093,21,490,1087,21,24.0,<=30,IND,Away,Upto 2014
DA Warner,AUS,Spin,2014-02-12,Centurion,South Africa,2014,1,3,12,0,1,266,474,6,263,462,6,44.333333333333336,>30,SA,Away,After 1965
DA Warner,AUS,Spin,2014-02-20,Gqeberha,South Africa,2014,1,10,18,0,1,316,654,11,306,636,11,28.727272727272727,<=30,SA,Away,After 1965
DA Warner,AUS,Spin,2014-12-17,Brisbane,Australia,2014,1,9,6,0,1,289,440,7,280,434,7,41.285714285714285,>30,AUS,Home,After 1965
DA Warner,AUS,Spin,2015-07-08,Cardiff,England,2015,1,9,12,0,1,311,478,13,302,466,13,23.923076923076923,<=30,ENG,Away,After 1965
DA Warner,AUS,Spin,2015-08-06,Nottingham,England,2015,1,18,18,0,1,99,114,0,81,96,0,inf,>30,ENG,Away,After 1965
DA Warner,AUS,Spin,2016-07-26,Pallekele,Sri Lanka,2016,1,10,6,0,1,503,1219,26,493,1213,26,19.346153846153847,<=30,SL,Away,After 1965
DA Warner,AUS,Spin,2016-11-24,Adelaide,Australia,2016,1,5,6,0,1,296,533,6,291,527,6,49.333333333333336,>30,AUS,Home,After 1965
DAJ Bracewell,NZ,Pace,2011-11-01,Bulawayo,Zimbabwe,2011,2,136,288,6,1,759,1445,23,623,1157,17,33.0,>30,ZIM,Away,Upto 2014
DAJ Bracewell,NZ,Pace,2011-12-01,Brisbane,Australia,2011,2,112,158,1,1,653,1114,19,541,956,18,34.36842105263158,>30,AUS,Away,Upto 2014
DAJ Bracewell,NZ,Pace,2011-12-09,Hobart,Australia,2011,2,60,160,9,1,648,1341,37,588,1181,28,17.513513513513512,<=30,AUS,Away,Upto 2014
DAJ Bracewell,NZ,Pace,2012-01-26,Napier,New Zealand,2012,2,38,96,5,1,497,972,21,459,876,16,23.666666666666668,<=30,NZ,Home,Upto 2014
DAJ Bracewell,NZ,Pace,2012-03-07,Dunedin,New Zealand,2012,2,122,248,5,1,860,1498,21,738,1250,16,40.95238095238095,>30,NZ,Home,Upto 2014
DAJ Bracewell,NZ,Pace,2012-03-15,Hamilton,New Zealand,2012,2,64,138,2,1,549,1079,27,485,941,25,20.333333333333332,<=30,NZ,Home,Upto 2014
DAJ Bracewell,NZ,Pace,2012-03-23,Wellington,New Zealand,2012,2,153,220,2,1,873,1620,25,720,1400,23,34.92,>30,NZ,Home,Upto 2014
DAJ Bracewell,NZ,Pace,2012-07-25,North Sound,West Indies,2012,2,121,213,3,1,734,1446,19,613,1233,16,38.63157894736842,>30,WI,Away,Upto 2014
DAJ Bracewell,NZ,Pace,2012-08-02,Kingston,West Indies,2012,2,84,171,4,1,597,1132,23,513,961,19,25.956521739130434,<=30,WI,Away,Upto 2014
DAJ Bracewell,NZ,Pace,2012-08-23,Hyderabad,India,2012,1,88,115,1,1,403,771,7,315,656,6,57.57142857142857,>30,IND,Away,Upto 2014
DAJ Bracewell,NZ,Pace,2012-08-31,Bengaluru,India,2012,2,143,204,2,1,733,1159,18,590,955,16,40.72222222222222,>30,IND,Away,Upto 2014
DAJ Bracewell,NZ,Pace,2012-11-17,Galle,Sri Lanka,2012,2,102,129,0,1,371,706,14,269,577,14,26.5,<=30,SL,Away,Upto 2014
DAJ Bracewell,NZ,Pace,2012-11-25,Colombo (PSS),Sri Lanka,2012,2,57,156,2,1,530,1109,22,473,953,20,24.09090909090909,<=30,SL,Away,Upto 2014
DAJ Bracewell,NZ,Pace,2013-01-02,Cape Town,South Africa,2013,1,93,144,1,1,547,1103,26,454,959,25,21.03846153846154,<=30,SA,Away,Upto 2014
DAJ Bracewell,NZ,Pace,2013-01-11,Gqeberha,South Africa,2013,1,94,204,3,1,619,1262,23,525,1058,20,26.91304347826087,<=30,SA,Away,Upto 2014
DAJ Bracewell,NZ,Pace,2013-05-24,Leeds,England,2013,2,132,192,1,1,701,1279,21,569,1087,20,33.38095238095238,>30,ENG,Away,Upto 2014
DAJ Bracewell,NZ,Pace,2013-10-09,Chattogram,Bangladesh,2013,2,110,180,3,1,333,720,8,223,540,5,41.625,>30,BAN,Away,Upto 2014
DAJ Bracewell,NZ,Pace,2013-10-21,Mirpur,Bangladesh,2013,2,104,168,0,1,508,858,10,404,690,10,50.8,>30,BAN,Away,Upto 2014
DAJ Bracewell,NZ,Pace,2015-01-03,Wellington,New Zealand,2015,2,118,222,5,1,987,1835,28,869,1613,23,35.25,>30,NZ,Home,After 1965
DAJ Bracewell,NZ,Pace,2015-11-05,Brisbane,Australia,2015,2,170,228,0,1,1023,1505,20,853,1277,20,51.15,>30,AUS,Away,After 1965
DAJ Bracewell,NZ,Pace,2015-11-13,W.A.C.A,Australia,2015,2,143,270,3,1,1234,1914,22,1091,1644,19,56.09090909090909,>30,AUS,Away,After 1965
DAJ Bracewell,NZ,Pace,2015-11-27,Adelaide,Australia,2015,2,55,139,4,1,584,1142,29,529,1003,25,20.137931034482758,<=30,AUS,Away,After 1965
DAJ Bracewell,NZ,Pace,2015-12-10,Dunedin,New Zealand,2015,2,88,242,1,1,942,1677,26,854,1435,25,36.23076923076923,>30,NZ,Home,After 1965
DAJ Bracewell,NZ,Pace,2015-12-18,Hamilton,New Zealand,2015,2,112,181,4,1,667,1250,30,555,1069,26,22.233333333333334,<=30,NZ,Home,After 1965
DAJ Bracewell,NZ,Pace,2016-02-12,Wellington,New Zealand,2016,1,127,198,2,1,769,1383,21,642,1185,19,36.61904761904762,>30,NZ,Home,After 1965
DAJ Bracewell,NZ,Pace,2016-08-19,Durban,South Africa,2016,1,53,96,1,1,247,526,10,194,430,9,24.7,<=30,SA,Away,After 1965
DAJ Bracewell,NZ,Pace,2016-08-27,Centurion,South Africa,2016,2,117,224,2,1,829,1709,31,712,1485,29,26.741935483870968,<=30,SA,Away,After 1965
DAJ Bracewell,NZ,Pace,2023-03-17,Wellington,New Zealand,2023,2,77,180,2,1,761,1427,16,684,1247,14,47.5625,>30,NZ,Home,After 1965
DAJ Holford,WI,Spin,1966-06-02,Manchester,England,1966,2,83,174,4,1,479,1280,24,396,1106,20,19.958333333333332,<=30,ENG,Away,Upto 2014
DAJ Holford,WI,Spin,1966-06-16,Lord's,England,1966,1,35,54,0,1,279,801,4,244,747,4,69.75,>30,ENG,Away,Upto 2014
DAJ Holford,WI,Spin,1966-06-30,Nottingham,England,1966,1,23,48,0,1,501,1422,8,478,1374,8,62.625,>30,ENG,Away,Upto 2014
DAJ Holford,WI,Spin,1966-08-04,Leeds,England,1966,2,82,114,0,1,445,946,16,363,832,16,27.8125,<=30,ENG,Away,Upto 2014
DAJ Holford,WI,Spin,1966-08-18,The Oval,England,1966,1,79,155,1,1,515,1218,14,436,1063,13,36.785714285714285,>30,ENG,Away,Upto 2014
DAJ Holford,WI,Spin,1966-12-13,Brabourne,India,1966,2,162,352,5,1,1023,2319,28,861,1967,23,36.535714285714285,>30,IND,Away,Upto 2014
DAJ Holford,WI,Spin,1968-01-19,Port of Spain,West Indies,1968,1,121,258,1,1,688,1548,12,567,1290,11,57.333333333333336,>30,WI,Home,Upto 2014
DAJ Holford,WI,Spin,1968-02-08,Kingston,West Indies,1968,1,71,198,3,1,308,929,12,237,731,9,25.666666666666668,<=30,WI,Home,Upto 2014
DAJ Holford,WI,Spin,1968-02-29,Bridgetown,West Indies,1968,1,52,192,0,1,405,1049,8,353,857,8,50.625,>30,WI,Home,Upto 2014
DAJ Holford,WI,Spin,1968-03-28,Georgetown,West Indies,1968,2,91,288,2,1,621,1884,22,530,1596,20,28.227272727272727,<=30,WI,Home,Upto 2014
DAJ Holford,WI,Spin,1968-12-06,Brisbane,Australia,1968,2,119,312,2,1,799,2162,28,680,1850,26,28.535714285714285,<=30,AUS,Away,Upto 2014
DAJ Holford,WI,Spin,1969-01-24,Adelaide,Australia,1969,2,171,269,2,1,1020,2021,15,849,1752,13,68.0,>30,AUS,Away,Upto 2014
DAJ Holford,WI,Spin,1969-02-27,Auckland,New Zealand,1969,2,94,160,4,1,637,1524,17,543,1364,13,37.470588235294116,>30,NZ,Away,Upto 2014
DAJ Holford,WI,Spin,1969-03-13,Christchurch,New Zealand,1969,2,148,360,5,1,515,1459,16,367,1099,11,32.1875,>30,NZ,Away,Upto 2014
DAJ Holford,WI,Spin,1971-04-13,Port of Spain,West Indies,1971,2,131,333,3,1,963,2470,24,832,2137,21,40.125,>30,WI,Home,Upto 2014
DAJ Holford,WI,Spin,1972-02-16,Kingston,West Indies,1972,2,119,462,6,1,653,1794,11,534,1332,5,59.36363636363637,>30,WI,Home,Upto 2014
DAJ Holford,WI,Spin,1972-03-09,Port of Spain,West Indies,1972,2,95,234,1,1,722,2183,14,627,1949,13,51.57142857142857,>30,WI,Home,Upto 2014
DAJ Holford,WI,Spin,1972-03-23,Bridgetown,West Indies,1972,1,20,54,0,1,454,1224,7,434,1170,7,64.85714285714286,>30,WI,Home,Upto 2014
DAJ Holford,WI,Spin,1972-04-06,Georgetown,West Indies,1972,1,78,324,1,1,489,1488,3,411,1164,2,163.0,>30,WI,Home,Upto 2014
DAJ Holford,WI,Spin,1976-03-10,Bridgetown,West Indies,1976,2,75,151,6,1,501,996,16,426,845,10,31.3125,>30,WI,Home,Upto 2014
DAJ Holford,WI,Spin,1976-03-24,Port of Spain,West Indies,1976,1,51,120,0,1,529,1608,16,478,1488,16,33.0625,>30,WI,Home,Upto 2014
DAJ Holford,WI,Spin,1977-04-15,Kingston,West Indies,1977,2,109,204,5,1,227,438,8,118,234,3,28.375,<=30,WI,Home,Upto 2014
DAN McRae,NZ,Pace,1946-03-29,Wellington,New Zealand,1946,1,44,84,0,1,212,690,16,168,606,16,13.25,<=30,NZ,Home,Upto 2014
DAR Moloney,NZ,Spin,1937-06-26,Lord's,England,1937,1,9,12,0,1,512,1098,11,503,1086,11,46.54545454545455,>30,ENG,Away,Upto 2014
DAS Gunaratne,SL,Pace,2016-10-29,Harare,Zimbabwe,2016,1,23,18,0,1,716,1330,16,693,1312,16,44.75,>30,ZIM,Away,After 1965
DAS Gunaratne,SL,Pace,2016-11-06,Harare,Zimbabwe,2016,1,5,12,0,1,650,1231,14,645,1219,14,46.42857142857143,>30,ZIM,Away,After 1965
DAS Gunaratne,SL,Pace,2017-03-07,Galle,Sri Lanka,2017,1,16,36,1,1,497,858,9,481,822,8,55.22222222222222,>30,SL,Home,After 1965
DAS Gunaratne,SL,Pace,2017-03-15,Colombo (PSS),Sri Lanka,2017,2,42,48,0,1,356,675,9,314,627,9,39.55555555555556,>30,SL,Home,After 1965
DAS Gunaratne,SL,Pace,2017-07-14,Colombo (RPS),Sri Lanka,2017,1,28,42,2,1,358,598,6,330,556,4,59.666666666666664,>30,SL,Home,After 1965
DB Carr,ENG,Spin,1951-11-02,Delhi,India,1951,1,56,96,0,1,589,1935,18,533,1839,18,32.72222222222222,>30,IND,Away,Upto 2014
DB Carr,ENG,Spin,1952-02-06,Chennai,India,1952,1,84,114,2,1,648,1564,25,564,1450,23,25.92,<=30,IND,Away,Upto 2014
DB Close,ENG,Spin,1949-07-23,Manchester,England,1949,2,85,252,1,1,586,1224,13,501,972,12,45.07692307692308,>30,ENG,Home,Upto 2014
DB Close,ENG,Spin,1950-12-22,Melbourne,Australia,1950,2,28,56,1,1,357,991,20,329,935,19,17.85,<=30,AUS,Away,Upto 2014
DB Close,ENG,Spin,1957-05-30,Birmingham,England,1957,1,8,12,0,1,809,2558,20,801,2546,20,40.45,>30,ENG,Home,Upto 2014
DB Close,ENG,Spin,1959-07-02,Leeds,England,1959,2,53,96,5,1,383,883,14,330,787,9,27.357142857142858,<=30,ENG,Home,Upto 2014
DB Close,ENG,Spin,1961-07-27,Manchester,England,1961,1,33,48,0,1,285,796,15,252,748,15,19.0,<=30,ENG,Home,Upto 2014
DB Close,ENG,Spin,1963-06-06,Manchester,England,1963,1,31,60,0,1,595,1480,19,564,1420,19,31.31578947368421,>30,ENG,Home,Upto 2014
DB Close,ENG,Spin,1963-06-20,Lord's,England,1963,1,21,54,0,1,329,816,7,308,762,7,47.0,>30,ENG,Home,Upto 2014
DB Close,ENG,Spin,1963-08-22,The Oval,England,1963,1,36,36,0,1,379,930,8,343,894,8,47.375,>30,ENG,Home,Upto 2014
DB Close,ENG,Spin,1966-08-18,The Oval,England,1966,2,28,72,1,1,515,1218,14,487,1146,13,36.785714285714285,>30,ENG,Home,Upto 2014
DB Close,ENG,Spin,1967-06-08,Leeds,England,1967,2,48,144,2,1,861,2089,19,813,1945,17,45.31578947368421,>30,ENG,Home,Upto 2014
DB Close,ENG,Spin,1967-06-22,Lord's,England,1967,1,28,90,2,1,346,971,18,318,881,16,19.22222222222222,<=30,ENG,Home,Upto 2014
DB Close,ENG,Spin,1967-07-13,Birmingham,England,1967,1,68,130,4,1,686,1638,33,618,1508,29,20.78787878787879,<=30,ENG,Home,Upto 2014
DB Close,ENG,Spin,1967-07-27,Lord's,England,1967,2,23,84,0,1,583,1689,19,560,1605,19,30.68421052631579,>30,ENG,Home,Upto 2014
DB Close,ENG,Spin,1967-08-10,Nottingham,England,1967,2,23,42,1,1,240,772,12,217,730,11,20.0,<=30,ENG,Home,Upto 2014
DB Close,ENG,Spin,1967-08-24,The Oval,England,1967,2,19,36,1,1,475,1075,13,456,1039,12,36.53846153846154,>30,ENG,Home,Upto 2014
DB Pithey,SA,Spin,1963-12-06,Brisbane,Australia,1963,2,115,224,0,1,346,1069,8,231,845,8,43.25,>30,AUS,Away,Upto 2014
DB Pithey,SA,Spin,1964-01-01,Melbourne,Australia,1964,2,38,88,0,1,262,721,5,224,633,5,52.4,>30,AUS,Away,Upto 2014
DB Pithey,SA,Spin,1964-01-10,Sydney,Australia,1964,1,86,128,0,1,363,985,5,277,857,5,72.6,>30,AUS,Away,Upto 2014
DB Pithey,SA,Spin,1964-02-21,Wellington,New Zealand,1964,2,87,228,2,1,335,893,10,248,665,8,33.5,>30,NZ,Away,Upto 2014
DB Pithey,SA,Spin,1964-02-28,Dunedin,New Zealand,1964,2,64,234,7,1,207,662,16,143,428,9,12.9375,<=30,NZ,Away,Upto 2014
DB Pithey,SA,Spin,1964-03-13,Auckland,New Zealand,1964,2,73,222,3,1,351,809,9,278,587,6,39.0,>30,NZ,Away,Upto 2014
DB Pithey,SA,Spin,1966-12-31,Cape Town,South Africa,1966,1,59,132,0,1,643,1501,10,584,1369,10,64.3,>30,SA,Home,Upto 2014
DB Pithey,SA,Spin,1967-01-20,Durban,South Africa,1967,1,55,168,0,1,209,570,4,154,402,4,52.25,>30,SA,Home,Upto 2014
DB Vengsarkar,IND,Pace,1976-04-21,Kingston,West Indies,1976,1,7,5,0,1,382,807,9,375,802,9,42.44444444444444,>30,WI,Away,Upto 2014
DB Vengsarkar,IND,Pace,1979-01-24,Delhi,India,1979,1,3,6,0,1,605,998,12,602,992,12,50.416666666666664,>30,IND,Home,Upto 2014
DB Vengsarkar,IND,Pace,1981-03-06,Christchurch,New Zealand,1981,1,3,12,0,1,349,1020,11,346,1008,11,31.727272727272727,>30,NZ,Away,Upto 2014
DB Vengsarkar,IND,Pace,1983-01-03,Faisalabad,Pakistan,1983,1,4,6,0,1,934,1450,28,930,1444,28,33.357142857142854,>30,PAK,Away,Upto 2014
DB Vengsarkar,IND,Pace,1983-10-05,Nagpur,India,1983,1,15,12,0,1,439,897,10,424,885,10,43.9,>30,IND,Home,Upto 2014
DB Vengsarkar,IND,Pace,1983-12-24,Chennai,India,1983,1,4,6,0,1,443,882,12,439,876,12,36.916666666666664,>30,IND,Home,Upto 2014
DBL Powell,WI,Pace,2002-06-21,Bridgetown,West Indies,2002,2,102,246,3,1,787,1616,30,685,1370,27,26.233333333333334,<=30,WI,Home,Upto 2014
DBL Powell,WI,Pace,2002-10-30,Eden Gardens,India,2002,2,115,248,3,1,701,1322,15,586,1074,12,46.733333333333334,>30,IND,Away,Upto 2014
DBL Powell,WI,Pace,2002-12-08,Dhaka,Bangladesh,2002,2,50,102,0,1,465,906,25,415,804,25,18.6,<=30,BAN,Away,Upto 2014
DBL Powell,WI,Pace,2002-12-16,Chattogram,Bangladesh,2002,2,87,174,6,1,655,1306,30,568,1132,24,21.833333333333332,<=30,BAN,Away,Upto 2014
DBL Powell,WI,Pace,2005-03-31,Georgetown,West Indies,2005,2,107,276,3,1,687,1530,15,580,1254,12,45.8,>30,WI,Home,Upto 2014
DBL Powell,WI,Pace,2005-04-08,Port of Spain,West Indies,2005,2,113,192,1,1,854,1820,25,741,1628,24,34.16,>30,WI,Home,Upto 2014
DBL Powell,WI,Pace,2005-04-21,Bridgetown,West Indies,2005,1,103,186,3,1,712,1449,24,609,1263,21,29.666666666666668,<=30,WI,Home,Upto 2014
DBL Powell,WI,Pace,2005-04-29,St John's,West Indies,2005,2,152,228,2,1,1036,1736,12,884,1508,10,86.33333333333333,>30,WI,Home,Upto 2014
DBL Powell,WI,Pace,2005-05-26,Bridgetown,West Indies,2005,2,83,126,2,1,722,1198,25,639,1072,23,28.88,<=30,WI,Home,Upto 2014
DBL Powell,WI,Pace,2005-06-03,Kingston,West Indies,2005,2,169,258,2,1,832,1351,29,663,1093,27,28.689655172413794,<=30,WI,Home,Upto 2014
DBL Powell,WI,Pace,2005-07-13,Colombo (SSC),Sri Lanka,2005,2,75,126,2,1,469,856,25,394,730,23,18.76,<=30,SL,Away,Upto 2014
DBL Powell,WI,Pace,2005-07-22,Kandy,Sri Lanka,2005,2,114,247,7,1,490,931,20,376,684,13,24.5,<=30,SL,Away,Upto 2014
DBL Powell,WI,Pace,2005-11-03,Brisbane,Australia,2005,2,124,150,3,1,772,1215,25,648,1065,22,30.88,>30,AUS,Away,Upto 2014
DBL Powell,WI,Pace,2005-11-17,Hobart,Australia,2005,2,138,186,1,1,632,1261,19,494,1075,18,33.26315789473684,>30,AUS,Away,Upto 2014
DBL Powell,WI,Pace,2005-11-25,Adelaide,Australia,2005,2,120,228,1,1,853,1575,23,733,1347,22,37.08695652173913,>30,AUS,Away,Upto 2014
DBL Powell,WI,Pace,2006-03-17,Wellington,New Zealand,2006,2,104,169,4,1,633,1165,28,529,996,24,22.607142857142858,<=30,NZ,Away,Upto 2014
DBL Powell,WI,Pace,2006-11-19,Multan,Pakistan,2006,2,97,204,1,1,741,1564,16,644,1360,15,46.3125,>30,PAK,Away,Upto 2014
DBL Powell,WI,Pace,2006-11-27,Karachi,Pakistan,2006,2,153,287,3,1,841,1655,23,688,1368,20,36.56521739130435,>30,PAK,Away,Upto 2014
DBL Powell,WI,Pace,2007-05-17,Lord's,England,2007,2,157,276,2,1,1013,1620,14,856,1344,12,72.35714285714286,>30,ENG,Away,Upto 2014
DBL Powell,WI,Pace,2007-05-25,Leeds,England,2007,1,153,198,2,1,714,1084,23,561,886,21,31.043478260869566,>30,ENG,Away,Upto 2014
DBL Powell,WI,Pace,2007-06-15,Chester-le-Street,England,2007,2,127,234,5,1,807,1380,26,680,1146,21,31.03846153846154,>30,ENG,Away,Upto 2014
DBL Powell,WI,Pace,2007-12-26,Gqeberha,South Africa,2007,2,105,186,4,1,900,1655,32,795,1469,28,28.125,<=30,SA,Away,Upto 2014
DBL Powell,WI,Pace,2008-01-02,Cape Town,South Africa,2008,2,180,276,2,1,787,1720,28,607,1444,26,28.107142857142858,<=30,SA,Away,Upto 2014
DBL Powell,WI,Pace,2008-01-10,Durban,South Africa,2008,1,128,156,1,1,883,1304,22,755,1148,21,40.13636363636363,>30,SA,Away,Upto 2014
DBL Powell,WI,Pace,2008-03-22,Providence,West Indies,2008,2,122,228,1,1,635,1249,22,513,1021,21,28.863636363636363,<=30,WI,Home,Upto 2014
DBL Powell,WI,Pace,2008-04-03,Port of Spain,West Indies,2008,2,108,180,3,1,851,1278,24,743,1098,21,35.458333333333336,>30,WI,Home,Upto 2014
DBL Powell,WI,Pace,2008-05-22,Kingston,West Indies,2008,2,135,264,4,1,802,1720,34,667,1456,30,23.58823529411765,<=30,WI,Home,Upto 2014
DBL Powell,WI,Pace,2008-05-30,North Sound,West Indies,2008,2,148,252,1,1,984,1871,24,836,1619,23,41.0,>30,WI,Home,Upto 2014
DBL Powell,WI,Pace,2008-06-12,Bridgetown,West Indies,2008,2,83,162,1,1,809,1396,25,726,1234,24,32.36,>30,WI,Home,Upto 2014
DBL Powell,WI,Pace,2008-12-11,Dunedin,New Zealand,2008,2,85,174,5,1,619,1080,13,534,906,8,47.61538461538461,>30,NZ,Away,Upto 2014
DBL Powell,WI,Pace,2008-12-19,Napier,New Zealand,2008,2,115,186,1,1,774,1324,23,659,1138,22,33.65217391304348,>30,NZ,Away,Upto 2014
DBL Powell,WI,Pace,2009-02-04,Kingston,West Indies,2009,2,59,162,2,1,444,1066,20,385,904,18,22.2,<=30,WI,Home,Upto 2014
DBL Powell,WI,Pace,2009-02-15,St John's,West Indies,2009,2,136,198,2,1,803,1574,19,667,1376,17,42.26315789473684,>30,WI,Home,Upto 2014
DBL Powell,WI,Pace,2009-02-26,Bridgetown,West Indies,2009,2,142,216,1,1,977,1508,9,835,1292,8,108.55555555555556,>30,WI,Home,Upto 2014
DBL Powell,WI,Pace,2009-03-06,Port of Spain,West Indies,2009,1,79,96,1,1,770,1390,15,691,1294,14,51.333333333333336,>30,WI,Home,Upto 2014
DC Boon,AUS,Spin,1986-09-26,Delhi,India,1986,1,5,12,0,1,149,340,2,144,328,2,74.5,>30,IND,Away,Upto 2014
DC Boon,AUS,Spin,1993-03-04,Wellington,New Zealand,1993,1,0,6,0,1,142,558,5,142,552,5,28.4,<=30,NZ,Away,Upto 2014
DC Boon,AUS,Spin,1994-10-05,Rawalpindi,Pakistan,1994,1,9,18,0,1,440,796,6,431,778,6,73.33333333333333,>30,PAK,Away,Upto 2014
DC Cleverley,NZ,Pace,1932-02-27,Christchurch,New Zealand,1932,1,79,132,0,1,481,1211,11,402,1079,11,43.72727272727273,>30,NZ,Home,Upto 2014
DC Cleverley,NZ,Pace,1946-03-29,Wellington,New Zealand,1946,1,51,90,0,1,212,690,16,161,600,16,13.25,<=30,NZ,Home,Upto 2014
DC Parkin,SA,Pace,1892-03-19,Cape Town,South Africa,1892,1,82,130,3,1,379,805,14,297,675,11,27.071428571428573,<=30,SA,Home,After 1965
DC Thomas,WI,Pace,2022-12-08,Adelaide,Australia,2022,2,66,96,2,1,712,1214,23,646,1118,21,30.956521739130434,>30,AUS,Away,After 1965
DCH Townsend,ENG,Pace,1935-02-14,Georgetown,West Indies,1935,1,9,6,0,1,273,866,12,264,860,12,22.75,<=30,WI,Away,Upto 2014
DCS Compton,ENG,Spin,1937-08-14,The Oval,England,1937,1,34,36,2,1,331,715,12,297,679,10,27.583333333333332,<=30,ENG,Home,Upto 2014
DCS Compton,ENG,Spin,1939-06-24,Lord's,England,1939,1,8,24,0,1,311,784,11,303,760,11,28.272727272727273,<=30,ENG,Home,Upto 2014
DCS Compton,ENG,Spin,1939-08-19,The Oval,England,1939,1,20,40,0,1,434,768,4,414,728,4,108.5,>30,ENG,Home,Upto 2014
DCS Compton,ENG,Spin,1946-07-20,Manchester,England,1946,2,23,42,0,1,221,522,7,198,480,7,31.571428571428573,>30,ENG,Home,Upto 2014
DCS Compton,ENG,Spin,1946-08-17,The Oval,England,1946,1,15,30,0,1,184,504,4,169,474,4,46.0,>30,ENG,Home,Upto 2014
DCS Compton,ENG,Spin,1946-11-29,Brisbane,Australia,1946,1,20,48,0,1,284,598,7,264,550,7,40.57142857142857,>30,AUS,Away,Upto 2014
DCS Compton,ENG,Spin,1946-12-13,Sydney,Australia,1946,1,38,48,0,1,831,1933,19,793,1885,19,43.73684210526316,>30,AUS,Away,Upto 2014
DCS Compton,ENG,Spin,1947-01-31,Adelaide,Australia,1947,1,12,24,0,1,672,1532,8,660,1508,8,84.0,>30,AUS,Away,Upto 2014
DCS Compton,ENG,Spin,1947-02-28,Sydney,Australia,1947,1,8,10,0,1,494,1134,15,486,1124,15,32.93333333333333,>30,AUS,Away,Upto 2014
DCS Compton,ENG,Spin,1947-06-07,Nottingham,England,1947,2,20,36,0,1,885,2189,17,865,2153,17,52.05882352941177,>30,ENG,Home,Upto 2014
DCS Compton,ENG,Spin,1947-06-21,Lord's,England,1947,2,78,312,4,1,699,1857,18,621,1545,14,38.833333333333336,>30,ENG,Home,Upto 2014
DCS Compton,ENG,Spin,1947-07-05,Manchester,England,1947,2,85,144,1,1,418,900,10,333,756,9,41.8,>30,ENG,Home,Upto 2014
DCS Compton,ENG,Spin,1947-07-26,Leeds,England,1947,2,19,36,0,1,420,1282,10,401,1246,10,42.0,>30,ENG,Home,Upto 2014
DCS Compton,ENG,Spin,1947-08-16,The Oval,England,1947,2,61,90,0,1,893,1980,23,832,1890,23,38.82608695652174,>30,ENG,Home,Upto 2014
DCS Compton,ENG,Spin,1948-06-10,Nottingham,England,1948,1,24,30,0,1,552,1614,15,528,1584,15,36.8,>30,ENG,Home,Upto 2014
DCS Compton,ENG,Spin,1948-06-24,Lord's,England,1948,1,11,18,0,1,442,1043,11,431,1025,11,40.18181818181818,>30,ENG,Home,Upto 2014
DCS Compton,ENG,Spin,1948-07-08,Manchester,England,1948,1,18,54,0,1,279,893,5,261,839,5,55.8,>30,ENG,Home,Upto 2014
DCS Compton,ENG,Spin,1948-07-22,Leeds,England,1948,2,97,108,1,1,708,1260,12,611,1152,11,59.0,>30,ENG,Home,Upto 2014
DCS Compton,ENG,Spin,1948-08-14,The Oval,England,1948,1,6,12,0,1,359,1083,14,353,1071,14,25.642857142857142,<=30,ENG,Home,Upto 2014
DCS Compton,ENG,Spin,1948-12-16,Durban,South Africa,1948,2,16,144,1,1,426,1415,21,410,1271,20,20.285714285714285,<=30,SA,Away,Upto 2014
DCS Compton,ENG,Spin,1948-12-27,Johannesburg,South Africa,1948,2,65,184,1,1,725,1588,13,660,1404,12,55.76923076923077,>30,SA,Away,Upto 2014
DCS Compton,ENG,Spin,1949-01-01,Cape Town,South Africa,1949,2,77,226,5,1,568,1444,18,491,1218,13,31.555555555555557,>30,SA,Away,Upto 2014
DCS Compton,ENG,Spin,1949-02-12,Johannesburg,South Africa,1949,2,54,104,0,1,470,1288,10,416,1184,10,47.0,>30,SA,Away,Upto 2014
DCS Compton,ENG,Spin,1949-03-05,Gqeberha,South Africa,1949,2,96,128,0,1,750,1935,20,654,1807,20,37.5,>30,SA,Away,Upto 2014
DCS Compton,ENG,Spin,1949-06-11,Leeds,England,1949,2,28,54,1,1,545,1101,10,517,1047,9,54.5,>30,ENG,Home,Upto 2014
DCS Compton,ENG,Spin,1949-06-25,Lord's,England,1949,1,33,42,1,1,624,1342,19,591,1300,18,32.8421052631579,>30,ENG,Home,Upto 2014
DCS Compton,ENG,Spin,1949-07-23,Manchester,England,1949,2,56,84,2,1,586,1224,13,530,1140,11,45.07692307692308,>30,ENG,Home,Upto 2014
DCS Compton,ENG,Spin,1949-08-13,The Oval,England,1949,2,9,18,1,1,597,1082,15,588,1064,14,39.8,>30,ENG,Home,Upto 2014
DCS Compton,ENG,Spin,1950-08-12,The Oval,England,1950,1,21,42,0,1,654,1981,25,633,1939,25,26.16,<=30,ENG,Home,Upto 2014
DCS Compton,ENG,Spin,1951-01-05,Sydney,Australia,1951,1,14,48,0,1,426,1236,15,412,1188,15,28.4,<=30,AUS,Away,Upto 2014
DCS Compton,ENG,Spin,1951-02-02,Adelaide,Australia,1951,2,29,46,1,1,793,1857,24,764,1811,23,33.041666666666664,>30,AUS,Away,Upto 2014
DCS Compton,ENG,Spin,1951-03-17,Christchurch,New Zealand,1951,2,31,36,0,1,586,1337,15,555,1301,15,39.06666666666667,>30,NZ,Away,Upto 2014
DCS Compton,ENG,Spin,1951-06-07,Nottingham,England,1951,1,7,12,0,1,552,1676,17,545,1664,17,32.470588235294116,>30,ENG,Home,Upto 2014
DCS Compton,ENG,Spin,1951-06-21,Lord's,England,1951,1,13,12,0,1,361,954,17,348,942,17,21.235294117647058,<=30,ENG,Home,Upto 2014
DCS Compton,ENG,Spin,1951-07-26,Leeds,England,1951,2,20,48,0,1,749,2072,16,729,2024,16,46.8125,>30,ENG,Home,Upto 2014
DCS Compton,ENG,Spin,1951-08-16,The Oval,England,1951,1,5,6,0,1,352,1033,18,347,1027,18,19.555555555555557,<=30,ENG,Home,Upto 2014
DCS Compton,ENG,Spin,1952-06-05,Leeds,England,1952,1,20,42,0,1,495,1359,19,475,1317,19,26.05263157894737,<=30,ENG,Home,Upto 2014
DCS Compton,ENG,Spin,1952-06-19,Lord's,England,1952,1,10,12,0,1,669,1629,14,659,1617,14,47.785714285714285,>30,ENG,Home,Upto 2014
DCS Compton,ENG,Spin,1953-06-25,Lord's,England,1953,1,21,18,1,1,753,1644,18,732,1626,17,41.833333333333336,>30,ENG,Home,Upto 2014
DCS Compton,ENG,Spin,1954-01-15,Kingston,West Indies,1954,1,5,12,0,1,426,1149,15,421,1137,15,28.4,<=30,WI,Away,Upto 2014
DCS Compton,ENG,Spin,1954-02-06,Bridgetown,West Indies,1954,2,42,36,0,1,772,2250,20,730,2214,20,38.6,>30,WI,Away,Upto 2014
DCS Compton,ENG,Spin,1954-02-24,Georgetown,West Indies,1954,1,6,18,0,1,666,2079,21,660,2061,21,31.714285714285715,>30,WI,Away,Upto 2014
DCS Compton,ENG,Spin,1954-03-17,Port of Spain,West Indies,1954,2,91,94,2,1,1025,1930,13,934,1836,11,78.84615384615384,>30,WI,Away,Upto 2014
DCS Compton,ENG,Spin,1954-06-10,Lord's,England,1954,1,36,78,1,1,153,655,8,117,577,7,19.125,<=30,ENG,Home,Upto 2014
DCS Compton,ENG,Spin,1957-01-01,Cape Town,South Africa,1957,1,3,16,0,1,343,1239,21,340,1223,21,16.333333333333332,<=30,SA,Away,Upto 2014
DCS Compton,ENG,Spin,1957-01-25,Durban,South Africa,1957,1,5,8,0,1,361,1289,21,356,1281,21,17.19047619047619,<=30,SA,Away,Upto 2014
DD Beard,NZ,Pace,1952-02-08,Christchurch,New Zealand,1952,2,67,204,2,1,219,588,9,152,384,7,24.333333333333332,<=30,NZ,Home,Upto 2014
DD Beard,NZ,Pace,1952-02-15,Auckland,New Zealand,1952,1,96,240,2,1,254,466,5,158,226,3,50.8,>30,NZ,Home,Upto 2014
DD Beard,NZ,Pace,1956-03-03,Wellington,New Zealand,1956,2,97,218,1,1,372,822,9,275,604,8,41.333333333333336,>30,NZ,Home,Upto 2014
DD Beard,NZ,Pace,1956-03-09,Auckland,New Zealand,1956,2,42,144,4,1,188,741,21,146,597,17,8.952380952380953,<=30,NZ,Home,Upto 2014
DD Blackie,AUS,Spin,1928-12-14,Sydney,Australia,1928,1,148,354,4,1,782,1986,12,634,1632,8,65.16666666666667,>30,AUS,Home,Upto 2014
DD Blackie,AUS,Spin,1928-12-29,Melbourne,Australia,1928,2,169,498,7,1,717,2327,21,548,1829,14,34.142857142857146,>30,AUS,Home,Upto 2014
DD Blackie,AUS,Spin,1929-02-01,Adelaide,Australia,1929,2,127,408,3,1,757,2268,26,630,1860,23,29.115384615384617,<=30,AUS,Home,Upto 2014
DD Parsana,IND,Spin,1979-01-12,Chennai,India,1979,2,39,84,1,1,234,496,9,195,412,8,26.0,<=30,IND,Home,Upto 2014
DD Parsana,IND,Spin,1979-01-24,Delhi,India,1979,1,11,36,0,1,226,544,8,215,508,8,28.25,<=30,IND,Home,Upto 2014
DE Bernard,WI,Pace,2003-04-19,Port of Spain,West Indies,2003,1,61,66,0,1,913,1617,20,852,1551,20,45.65,>30,WI,Home,Upto 2014
DE Bernard,WI,Pace,2009-07-09,Kingstown,West Indies,2009,2,62,90,3,1,537,1048,20,475,958,17,26.85,<=30,WI,Home,Upto 2014
DE Bernard,WI,Pace,2009-07-17,St George's,West Indies,2009,2,62,102,1,1,424,759,14,362,657,13,30.285714285714285,>30,WI,Home,Upto 2014
DE Bollinger,AUS,Pace,2009-01-03,Sydney,Australia,2009,2,131,264,2,1,952,2011,26,821,1747,24,36.61538461538461,>30,AUS,Home,Upto 2014
DE Bollinger,AUS,Pace,2009-12-04,Adelaide,Australia,2009,2,117,257,5,1,930,1567,26,813,1310,21,35.76923076923077,>30,AUS,Home,Upto 2014
DE Bollinger,AUS,Pace,2009-12-16,W.A.C.A,Australia,2009,2,141,243,8,1,927,1486,27,786,1243,19,34.333333333333336,>30,AUS,Home,Upto 2014
DE Bollinger,AUS,Pace,2009-12-26,Melbourne,Australia,2009,2,92,210,5,1,736,1512,23,644,1302,18,32.0,>30,AUS,Home,Upto 2014
DE Bollinger,AUS,Pace,2010-01-03,Sydney,Australia,2010,2,104,203,6,1,640,1344,29,536,1141,23,22.06896551724138,<=30,AUS,Home,Upto 2014
DE Bollinger,AUS,Pace,2010-01-14,Hobart,Australia,2010,2,66,168,1,1,758,1508,15,692,1340,14,50.53333333333333,>30,AUS,Home,Upto 2014
DE Bollinger,AUS,Pace,2010-03-19,Wellington,New Zealand,2010,2,108,240,7,1,767,1410,18,659,1170,11,42.611111111111114,>30,NZ,Away,Upto 2014
DE Bollinger,AUS,Pace,2010-03-27,Hamilton,New Zealand,2010,2,144,180,5,1,795,1294,27,651,1114,22,29.444444444444443,<=30,NZ,Away,Upto 2014
DE Bollinger,AUS,Pace,2010-07-13,Lord's,England,2010,2,81,138,2,1,698,1252,26,617,1114,24,26.846153846153847,<=30,ENG,Away,Upto 2014
DE Bollinger,AUS,Pace,2010-07-21,Leeds,England,2010,2,101,180,3,1,714,1273,33,613,1093,30,21.636363636363637,<=30,ENG,Away,Upto 2014
DE Bollinger,AUS,Pace,2010-10-01,Mohali,India,2010,2,81,144,5,1,619,1051,25,538,907,20,24.76,<=30,IND,Away,Upto 2014
DE Bollinger,AUS,Pace,2010-12-03,Adelaide,Australia,2010,1,130,174,1,1,745,1313,14,615,1139,13,53.214285714285715,>30,AUS,Home,Upto 2014
DE Hoare,AUS,Spin,1961-01-27,Adelaide,Australia,1961,2,156,232,2,1,1001,2526,24,845,2294,22,41.708333333333336,>30,AUS,Home,Upto 2014
DE Malcolm,ENG,Pace,1989-08-10,Nottingham,England,1989,1,166,264,1,1,695,1373,18,529,1109,17,38.611111111111114,>30,ENG,Home,Upto 2014
DE Malcolm,ENG,Pace,1990-02-24,Kingston,West Indies,1990,2,126,225,5,1,668,1460,29,542,1235,24,23.03448275862069,<=30,WI,Away,Upto 2014
DE Malcolm,ENG,Pace,1990-03-23,Port of Spain,West Indies,1990,2,137,278,10,1,773,1811,34,636,1533,24,22.735294117647058,<=30,WI,Away,Upto 2014
DE Malcolm,ENG,Pace,1990-04-05,Bridgetown,West Indies,1990,2,188,258,0,1,1177,2232,37,989,1974,37,31.81081081081081,>30,WI,Away,Upto 2014
DE Malcolm,ENG,Pace,1990-04-12,St John's,West Indies,1990,1,126,209,4,1,830,1554,26,704,1345,22,31.923076923076923,>30,WI,Away,Upto 2014
DE Malcolm,ENG,Pace,1990-06-07,Nottingham,England,1990,2,70,156,2,1,425,1056,17,355,900,15,25.0,<=30,ENG,Home,Upto 2014
DE Malcolm,ENG,Pace,1990-06-21,Lord's,England,1990,1,94,258,5,1,748,1364,15,654,1106,10,49.86666666666667,>30,ENG,Home,Upto 2014
DE Malcolm,ENG,Pace,1990-07-05,Birmingham,England,1990,2,105,298,8,1,730,1539,27,625,1241,19,27.037037037037038,<=30,ENG,Home,Upto 2014
DE Malcolm,ENG,Pace,1990-07-26,Lord's,England,1990,2,171,210,3,1,1076,1683,21,905,1473,18,51.23809523809524,>30,ENG,Home,Upto 2014
DE Malcolm,ENG,Pace,1990-08-09,Manchester,England,1990,2,155,240,2,1,835,1242,15,680,1002,13,55.666666666666664,>30,ENG,Home,Upto 2014
DE Malcolm,ENG,Pace,1990-08-23,The Oval,England,1990,1,110,210,2,1,853,1642,16,743,1432,14,53.3125,>30,ENG,Home,Upto 2014
DE Malcolm,ENG,Pace,1990-11-23,Brisbane,Australia,1990,2,67,156,1,1,544,1327,29,477,1171,28,18.75862068965517,<=30,AUS,Away,Upto 2014
DE Malcolm,ENG,Pace,1990-12-26,Melbourne,Australia,1990,2,126,293,3,1,741,1809,29,615,1516,26,25.551724137931036,<=30,AUS,Away,Upto 2014
DE Malcolm,ENG,Pace,1991-01-04,Sydney,Australia,1991,2,147,306,6,1,621,1201,14,474,895,8,44.357142857142854,>30,AUS,Away,Upto 2014
DE Malcolm,ENG,Pace,1991-01-25,Adelaide,Australia,1991,2,191,354,3,1,1030,2159,28,839,1805,25,36.785714285714285,>30,AUS,Away,Upto 2014
DE Malcolm,ENG,Pace,1991-02-01,W.A.C.A,Australia,1991,2,134,234,3,1,771,1442,29,637,1208,26,26.586206896551722,<=30,AUS,Away,Upto 2014
DE Malcolm,ENG,Pace,1991-06-06,Leeds,England,1991,2,95,124,1,1,749,1729,37,654,1605,36,20.243243243243242,<=30,ENG,Home,Upto 2014
DE Malcolm,ENG,Pace,1991-06-20,Lord's,England,1991,2,85,131,2,1,685,1326,19,600,1195,17,36.05263157894737,>30,ENG,Home,Upto 2014
DE Malcolm,ENG,Pace,1992-06-18,Lord's,England,1992,2,112,185,5,1,607,1221,26,495,1036,21,23.346153846153847,<=30,ENG,Home,Upto 2014
DE Malcolm,ENG,Pace,1992-07-02,Manchester,England,1992,2,174,258,3,1,841,1528,24,667,1270,21,35.041666666666664,>30,ENG,Home,Upto 2014
DE Malcolm,ENG,Pace,1992-08-06,The Oval,England,1992,1,94,174,5,1,546,1176,25,452,1002,20,21.84,<=30,ENG,Home,Upto 2014
DE Malcolm,ENG,Pace,1993-01-29,Eden Gardens,India,1993,2,83,180,3,1,387,856,9,304,676,6,43.0,>30,IND,Away,Upto 2014
DE Malcolm,ENG,Pace,1993-02-11,Chennai,India,1993,1,87,162,0,1,257,522,5,170,360,5,51.4,>30,IND,Away,Upto 2014
DE Malcolm,ENG,Pace,1993-03-13,Colombo (SSC),Sri Lanka,1993,2,71,168,0,1,382,857,11,311,689,11,34.72727272727273,>30,SL,Away,Upto 2014
DE Malcolm,ENG,Pace,1993-08-19,The Oval,England,1993,2,170,276,6,1,872,1626,33,702,1350,27,26.424242424242426,<=30,ENG,Home,Upto 2014
DE Malcolm,ENG,Pace,1994-02-19,Kingston,West Indies,1994,2,132,168,3,1,877,1820,28,745,1652,25,31.321428571428573,>30,WI,Away,Upto 2014
DE Malcolm,ENG,Pace,1994-06-02,Nottingham,England,1994,2,84,166,2,1,704,1313,20,620,1147,18,35.2,>30,ENG,Home,Upto 2014
DE Malcolm,ENG,Pace,1994-08-18,The Oval,England,1994,2,138,249,10,1,962,1490,30,824,1241,20,32.06666666666667,>30,ENG,Home,Upto 2014
DE Malcolm,ENG,Pace,1994-12-24,Melbourne,Australia,1994,2,164,303,1,1,587,1268,21,423,965,20,27.952380952380953,<=30,AUS,Away,Upto 2014
DE Malcolm,ENG,Pace,1995-01-01,Sydney,Australia,1995,2,109,204,3,1,651,1345,27,542,1141,24,24.11111111111111,<=30,AUS,Away,Upto 2014
DE Malcolm,ENG,Pace,1995-01-26,Adelaide,Australia,1995,2,117,253,7,1,823,1644,27,706,1391,20,30.48148148148148,>30,AUS,Away,Upto 2014
DE Malcolm,ENG,Pace,1995-02-03,W.A.C.A,Australia,1995,2,198,327,2,1,946,1817,29,748,1490,27,32.62068965517241,>30,AUS,Away,Upto 2014
DE Malcolm,ENG,Pace,1995-06-08,Leeds,England,1995,2,60,69,2,1,698,1234,27,638,1165,25,25.85185185185185,<=30,ENG,Home,Upto 2014
DE Malcolm,ENG,Pace,1995-08-24,The Oval,England,1995,1,160,234,3,1,1059,1992,20,899,1758,17,52.95,>30,ENG,Home,Upto 2014
DE Malcolm,ENG,Pace,1995-11-30,Johannesburg,South Africa,1995,2,127,210,6,1,999,2058,30,872,1848,24,33.3,>30,SA,Away,Upto 2014
DE Malcolm,ENG,Pace,1996-01-02,Cape Town,South Africa,1996,2,68,132,0,1,418,1109,22,350,977,22,19.0,<=30,SA,Away,Upto 2014
DE Malcolm,ENG,Pace,1997-06-05,Birmingham,England,1997,2,77,186,2,1,837,1443,24,760,1257,22,34.875,>30,ENG,Home,Upto 2014
DE Malcolm,ENG,Pace,1997-06-19,Lord's,England,1997,1,26,42,0,1,411,849,18,385,807,18,22.833333333333332,<=30,ENG,Home,Upto 2014
DE Malcolm,ENG,Pace,1997-08-07,Nottingham,England,1997,2,152,246,3,1,974,1617,31,822,1371,28,31.419354838709676,>30,ENG,Home,Upto 2014
DE Malcolm,ENG,Pace,1997-08-21,The Oval,England,1997,2,52,84,1,1,435,825,24,383,741,23,18.125,<=30,ENG,Home,Upto 2014
DEJ Ironside,SA,Pace,1953-12-24,Johannesburg,South Africa,1953,2,88,317,8,1,463,1350,29,375,1033,21,15.96551724137931,<=30,SA,Home,Upto 2014
DEJ Ironside,SA,Pace,1954-01-01,Cape Town,South Africa,1954,1,117,371,4,1,315,963,9,198,592,5,35.0,>30,SA,Home,Upto 2014
DEJ Ironside,SA,Pace,1954-01-29,Johannesburg,South Africa,1954,2,70,298,3,1,358,1413,20,288,1115,17,17.9,<=30,SA,Home,Upto 2014
DEV Padgett,ENG,Pace,1960-07-21,Manchester,England,1960,1,8,12,0,1,475,1326,23,467,1314,23,20.652173913043477,<=30,ENG,Home,Upto 2014
DF Whatmore,AUS,Spin,1979-11-03,Wankhede,India,1979,1,11,30,0,1,457,1061,17,446,1031,17,26.88235294117647,<=30,IND,Away,Upto 2014
DG Bradman,AUS,Spin,1930-06-27,Lord's,England,1930,1,1,6,0,1,960,1932,18,959,1926,18,53.333333333333336,>30,ENG,Away,Upto 2014
DG Bradman,AUS,Spin,1930-12-12,Adelaide,Australia,1930,2,15,54,1,1,578,1434,23,563,1380,22,25.130434782608695,<=30,AUS,Home,Upto 2014
DG Bradman,AUS,Spin,1931-12-31,Melbourne,Australia,1931,1,2,6,0,1,678,1818,23,676,1812,23,29.47826086956522,<=30,AUS,Home,Upto 2014
DG Bradman,AUS,Spin,1933-01-13,Adelaide,Australia,1933,1,23,24,1,1,546,1683,15,523,1659,14,36.4,>30,AUS,Home,Upto 2014
DG Bradman,AUS,Spin,1933-02-10,Brisbane,Australia,1933,1,17,42,0,1,466,1558,15,449,1516,15,31.066666666666666,>30,AUS,Home,Upto 2014
DG Bradman,AUS,Spin,1933-02-23,Sydney,Australia,1933,1,4,6,0,1,492,1240,17,488,1234,17,28.941176470588236,<=30,AUS,Home,Upto 2014
DG Bradman,AUS,Spin,1938-08-20,The Oval,England,1938,1,6,14,0,1,776,1827,9,770,1813,9,86.22222222222223,>30,ENG,Away,Upto 2014
DG Bradman,AUS,Spin,1948-01-23,Adelaide,Australia,1948,1,4,8,0,1,689,1465,10,685,1457,10,68.9,>30,AUS,Home,Upto 2014
DG Brownlie,NZ,Pace,2011-11-01,Bulawayo,Zimbabwe,2011,2,15,30,1,1,759,1445,23,744,1415,22,33.0,>30,ZIM,Away,Upto 2014
DG Brownlie,NZ,Pace,2011-12-01,Brisbane,Australia,2011,1,11,18,0,1,653,1114,19,642,1096,19,34.36842105263158,>30,AUS,Away,Upto 2014
DG Brownlie,NZ,Pace,2012-03-23,Wellington,New Zealand,2012,1,20,12,0,1,873,1620,25,853,1608,25,34.92,>30,NZ,Home,Upto 2014
DG Brownlie,NZ,Pace,2012-08-02,Kingston,West Indies,2012,1,6,6,0,1,597,1132,23,591,1126,23,25.956521739130434,<=30,WI,Away,Upto 2014
DG Cork,ENG,Pace,1995-06-22,Lord's,England,1995,2,115,249,8,1,1000,2102,38,885,1853,30,26.31578947368421,<=30,ENG,Home,Upto 2014
DG Cork,ENG,Pace,1995-07-06,Birmingham,England,1995,1,69,132,4,1,511,986,26,442,854,22,19.653846153846153,<=30,ENG,Home,Upto 2014
DG Cork,ENG,Pace,1995-07-27,Manchester,England,1995,2,197,263,8,1,744,1375,26,547,1112,18,28.615384615384617,<=30,ENG,Home,Upto 2014
DG Cork,ENG,Pace,1995-08-10,Nottingham,England,1995,2,135,246,3,1,678,1465,22,543,1219,19,30.818181818181817,>30,ENG,Home,Upto 2014
DG Cork,ENG,Pace,1995-08-24,The Oval,England,1995,1,145,216,3,1,1059,1992,20,914,1776,17,52.95,>30,ENG,Home,Upto 2014
DG Cork,ENG,Pace,1995-11-30,Johannesburg,South Africa,1995,2,162,381,9,1,999,2058,30,837,1677,21,33.3,>30,SA,Away,Upto 2014
DG Cork,ENG,Pace,1995-12-14,Durban,South Africa,1995,1,64,162,0,1,320,703,12,256,541,12,26.666666666666668,<=30,SA,Away,Upto 2014
DG Cork,ENG,Pace,1995-12-26,Gqeberha,South Africa,1995,2,176,419,7,1,681,1783,21,505,1364,14,32.42857142857143,>30,SA,Away,Upto 2014
DG Cork,ENG,Pace,1996-01-02,Cape Town,South Africa,1996,2,83,174,3,1,418,1109,22,335,935,19,19.0,<=30,SA,Away,Upto 2014
DG Cork,ENG,Pace,1996-06-06,Birmingham,England,1996,2,101,235,6,1,677,1326,30,576,1091,24,22.566666666666666,<=30,ENG,Home,Upto 2014
DG Cork,ENG,Pace,1996-06-20,Lord's,England,1996,1,112,255,2,1,826,2028,26,714,1773,24,31.76923076923077,>30,ENG,Home,Upto 2014
DG Cork,ENG,Pace,1996-07-04,Nottingham,England,1996,2,156,234,2,1,859,1781,24,703,1547,22,35.791666666666664,>30,ENG,Home,Upto 2014
DG Cork,ENG,Pace,1996-07-25,Lord's,England,1996,2,186,312,5,1,850,1771,26,664,1459,21,32.69230769230769,>30,ENG,Home,Upto 2014
DG Cork,ENG,Pace,1996-08-08,Leeds,England,1996,2,162,318,6,1,963,1933,22,801,1615,16,43.77272727272727,>30,ENG,Home,Upto 2014
DG Cork,ENG,Pace,1996-08-22,The Oval,England,1996,2,86,156,1,1,690,1195,17,604,1039,16,40.588235294117645,>30,ENG,Home,Upto 2014
DG Cork,ENG,Pace,1997-01-24,Auckland,New Zealand,1997,2,141,293,4,1,815,1797,20,674,1504,16,40.75,>30,NZ,Away,Upto 2014
DG Cork,ENG,Pace,1997-02-06,Wellington,New Zealand,1997,2,76,144,1,1,457,1115,23,381,971,22,19.869565217391305,<=30,NZ,Away,Upto 2014
DG Cork,ENG,Pace,1997-02-14,Christchurch,New Zealand,1997,2,83,156,2,1,695,1595,19,612,1439,17,36.578947368421055,>30,NZ,Away,Upto 2014
DG Cork,ENG,Pace,1998-06-04,Birmingham,England,1998,1,93,195,5,1,706,1575,23,613,1380,18,30.695652173913043,>30,ENG,Home,Upto 2014
DG Cork,ENG,Pace,1998-06-18,Lord's,England,1998,2,124,188,6,1,618,1463,26,494,1275,20,23.76923076923077,<=30,ENG,Home,Upto 2014
DG Cork,ENG,Pace,1998-07-02,Manchester,England,1998,1,109,215,0,1,671,1668,18,562,1453,18,37.27777777777778,>30,ENG,Home,Upto 2014
DG Cork,ENG,Pace,1998-07-23,Nottingham,England,1998,2,125,222,4,1,995,2152,32,870,1930,28,31.09375,>30,ENG,Home,Upto 2014
DG Cork,ENG,Pace,1998-08-06,Leeds,England,1998,2,122,228,3,1,826,2084,40,704,1856,37,20.65,<=30,ENG,Home,Upto 2014
DG Cork,ENG,Pace,1998-08-27,The Oval,England,1998,2,131,228,2,1,707,1308,12,576,1080,10,58.916666666666664,>30,ENG,Home,Upto 2014
DG Cork,ENG,Pace,1998-11-20,Brisbane,Australia,1998,2,116,216,3,1,919,1808,20,803,1592,17,45.95,>30,AUS,Away,Upto 2014
DG Cork,ENG,Pace,1998-11-28,W.A.C.A,Australia,1998,1,49,126,1,1,564,1246,31,515,1120,30,18.193548387096776,<=30,AUS,Away,Upto 2014
DG Cork,ENG,Pace,2000-06-29,Lord's,England,2000,2,52,178,7,1,573,1340,36,521,1162,29,15.916666666666666,<=30,ENG,Home,Upto 2014
DG Cork,ENG,Pace,2000-08-03,Manchester,England,2000,2,87,271,5,1,672,1537,23,585,1266,18,29.217391304347824,<=30,ENG,Home,Upto 2014
DG Cork,ENG,Pace,2000-08-17,Leeds,England,2000,2,33,72,3,1,405,817,24,372,745,21,16.875,<=30,ENG,Home,Upto 2014
DG Cork,ENG,Pace,2000-08-31,The Oval,England,2000,2,73,138,5,1,613,1636,30,540,1498,25,20.433333333333334,<=30,ENG,Home,Upto 2014
DG Cork,ENG,Pace,2001-05-17,Lord's,England,2001,2,83,159,4,1,714,1443,30,631,1284,26,23.8,<=30,ENG,Home,Upto 2014
DG Cork,ENG,Pace,2001-05-31,Manchester,England,2001,2,117,276,1,1,1134,1996,31,1017,1720,30,36.58064516129032,>30,ENG,Home,Upto 2014
DG Cork,ENG,Pace,2001-07-19,Lord's,England,2001,1,84,138,1,1,636,1130,28,552,992,27,22.714285714285715,<=30,ENG,Home,Upto 2014
DG Cork,ENG,Pace,2002-05-16,Lord's,England,2002,1,93,213,3,1,1188,2251,20,1095,2038,17,59.4,>30,ENG,Home,Upto 2014
DG Cork,ENG,Pace,2002-08-08,Nottingham,England,2002,2,99,138,3,1,996,1602,22,897,1464,19,45.27272727272727,>30,ENG,Home,Upto 2014
DG Cork,ENG,Pace,2002-09-05,The Oval,England,2002,1,67,132,1,1,664,1200,10,597,1068,9,66.4,>30,ENG,Home,Upto 2014
DG Phadkar,IND,Spin,1947-12-12,Sydney,Australia,1947,1,14,80,3,1,208,752,16,194,672,13,13.0,<=30,AUS,Away,Upto 2014
DG Phadkar,IND,Spin,1948-01-01,Melbourne,Australia,1948,2,108,200,2,1,660,1199,23,552,999,21,28.695652173913043,<=30,AUS,Away,Upto 2014
DG Phadkar,IND,Spin,1948-01-23,Adelaide,Australia,1948,1,74,120,2,1,689,1465,10,615,1345,8,68.9,>30,AUS,Away,Upto 2014
DG Phadkar,IND,Spin,1948-02-06,Melbourne,Australia,1948,1,58,72,1,1,478,1056,12,420,984,11,39.833333333333336,>30,AUS,Away,Upto 2014
DG Phadkar,IND,Spin,1948-11-10,Delhi,India,1948,1,61,108,0,1,804,1710,13,743,1602,13,61.84615384615385,>30,IND,Home,Upto 2014
DG Phadkar,IND,Spin,1948-12-09,Brabourne,India,1948,1,35,96,1,1,780,1868,11,745,1772,10,70.9090909090909,>30,IND,Home,Upto 2014
DG Phadkar,IND,Spin,1949-01-27,Chennai,India,1949,1,159,273,7,1,495,939,11,336,666,4,45.0,>30,IND,Home,Upto 2014
DG Phadkar,IND,Spin,1949-02-04,Brabourne,India,1949,2,156,362,6,1,580,1268,18,424,906,12,32.22222222222222,>30,IND,Home,Upto 2014
DG Phadkar,IND,Spin,1951-11-02,Delhi,India,1951,2,54,150,1,1,589,1935,18,535,1785,17,32.72222222222222,>30,IND,Home,Upto 2014
DG Phadkar,IND,Spin,1951-12-30,Eden Gardens,India,1951,2,116,348,4,1,698,1841,19,582,1493,15,36.73684210526316,>30,IND,Home,Upto 2014
DG Phadkar,IND,Spin,1952-01-12,Kanpur,India,1952,2,11,24,0,1,484,1339,31,473,1315,31,15.612903225806452,<=30,IND,Home,Upto 2014
DG Phadkar,IND,Spin,1952-02-06,Chennai,India,1952,2,66,150,2,1,648,1564,25,582,1414,23,25.92,<=30,IND,Home,Upto 2014
DG Phadkar,IND,Spin,1952-06-05,Leeds,England,1952,2,75,210,2,1,495,1359,19,420,1149,17,26.05263157894737,<=30,ENG,Away,Upto 2014
DG Phadkar,IND,Spin,1952-06-19,Lord's,England,1952,1,44,162,0,1,669,1629,14,625,1467,14,47.785714285714285,>30,ENG,Away,Upto 2014
DG Phadkar,IND,Spin,1952-07-17,Manchester,England,1952,1,30,132,0,1,285,693,12,255,561,12,23.75,<=30,ENG,Away,Upto 2014
DG Phadkar,IND,Spin,1952-08-14,The Oval,England,1952,1,61,192,1,1,267,870,5,206,678,4,53.4,>30,ENG,Away,Upto 2014
DG Phadkar,IND,Spin,1952-11-28,Chennai,India,1952,1,61,114,2,1,261,594,8,200,480,6,32.625,>30,IND,Home,Upto 2014
DG Phadkar,IND,Spin,1952-12-12,Eden Gardens,India,1952,2,102,318,5,1,455,1230,13,353,912,8,35.0,>30,IND,Home,Upto 2014
DG Phadkar,IND,Spin,1953-01-21,Port of Spain,West Indies,1953,2,50,132,0,1,842,2177,19,792,2045,19,44.31578947368421,>30,WI,Away,Upto 2014
DG Phadkar,IND,Spin,1953-02-07,Bridgetown,West Indies,1953,2,88,247,7,1,692,2028,31,604,1781,24,22.322580645161292,<=30,WI,Away,Upto 2014
DG Phadkar,IND,Spin,1953-02-19,Port of Spain,West Indies,1953,2,92,300,2,1,777,2186,14,685,1886,12,55.5,>30,WI,Away,Upto 2014
DG Phadkar,IND,Spin,1955-01-01,Dhaka,Bangladesh,1955,2,81,278,3,1,438,1378,15,357,1100,12,29.2,<=30,BAN,Away,Upto 2014
DG Phadkar,IND,Spin,1955-02-12,Peshawar,Pakistan,1955,2,61,252,4,1,400,1761,19,339,1509,15,21.05263157894737,<=30,PAK,Away,Upto 2014
DG Phadkar,IND,Spin,1955-02-26,Karachi,Pakistan,1955,2,102,264,1,1,327,894,7,225,630,6,46.714285714285715,>30,PAK,Away,Upto 2014
DG Phadkar,IND,Spin,1955-11-19,Hyderabad (Deccan),India,1955,2,58,222,0,1,665,1888,11,607,1666,11,60.45454545454545,>30,IND,Home,Upto 2014
DG Phadkar,IND,Spin,1955-12-02,Brabourne,India,1955,2,58,204,3,1,470,1277,17,412,1073,14,27.647058823529413,<=30,IND,Home,Upto 2014
DG Phadkar,IND,Spin,1955-12-28,Eden Gardens,India,1955,2,87,234,2,1,462,1292,19,375,1058,17,24.31578947368421,<=30,IND,Home,Upto 2014
DG Phadkar,IND,Spin,1956-01-06,Chennai,India,1956,2,58,258,1,1,610,1887,20,552,1629,19,30.5,>30,IND,Home,Upto 2014
DG Phadkar,IND,Spin,1956-10-26,Brabourne,India,1956,1,92,234,0,1,685,1650,12,593,1416,12,57.083333333333336,>30,IND,Home,Upto 2014
DG Phadkar,IND,Spin,1958-12-31,Eden Gardens,India,1958,1,173,258,0,1,513,906,7,340,648,7,73.28571428571429,>30,IND,Home,Upto 2014
DG Sewell,NZ,Pace,1997-09-25,Bulawayo,Zimbabwe,1997,2,90,138,0,1,606,1326,9,516,1188,9,67.33333333333333,>30,ZIM,Away,Upto 2014
DH Brain,ZIM,Pace,1992-11-07,Harare,Zimbabwe,1992,2,101,204,4,1,623,1378,20,522,1174,16,31.15,>30,ZIM,Home,Upto 2014
DH Brain,ZIM,Pace,1993-03-13,Delhi,India,1993,1,146,204,2,1,351,630,4,205,426,2,87.75,>30,IND,Away,Upto 2014
DH Brain,ZIM,Pace,1993-12-09,Rawalpindi,Pakistan,1993,2,114,396,6,1,816,1939,40,702,1543,34,20.4,<=30,PAK,Away,Upto 2014
DH Brain,ZIM,Pace,1993-12-16,Lahore,Pakistan,1993,2,70,174,6,1,467,1213,21,397,1039,15,22.238095238095237,<=30,PAK,Away,Upto 2014
DH Brain,ZIM,Pace,1994-10-11,Harare,Zimbabwe,1994,1,9,30,0,1,445,1241,16,436,1211,16,27.8125,<=30,ZIM,Home,Upto 2014
DH Brain,ZIM,Pace,1994-10-26,Harare,Zimbabwe,1994,2,138,270,4,1,659,1576,19,521,1306,15,34.68421052631579,>30,ZIM,Home,Upto 2014
DH Brain,ZIM,Pace,1995-01-31,Harare,Zimbabwe,1995,2,144,258,4,1,693,1542,23,549,1284,19,30.130434782608695,>30,ZIM,Home,Upto 2014
DH Brain,ZIM,Pace,1995-02-07,Bulawayo,Zimbabwe,1995,2,84,102,1,1,563,1357,30,479,1255,29,18.766666666666666,<=30,ZIM,Home,Upto 2014
DH Brain,ZIM,Pace,1995-02-15,Harare,Zimbabwe,1995,2,109,172,3,1,795,1808,39,686,1636,36,20.384615384615383,<=30,ZIM,Home,Upto 2014
DI Gower,ENG,Spin,1982-01-13,Chennai,India,1982,1,1,6,0,1,285,972,8,284,966,8,35.625,>30,IND,Away,Upto 2014
DI Gower,ENG,Spin,1982-01-30,Kanpur,India,1982,1,1,6,1,1,274,704,7,273,698,6,39.142857142857146,>30,IND,Away,Upto 2014
DI Gower,ENG,Spin,1984-12-31,Eden Gardens,India,1984,1,13,18,0,1,444,1182,10,431,1164,10,44.4,>30,IND,Away,Upto 2014
DI Gower,ENG,Spin,1986-07-24,Lord's,England,1986,1,1,6,0,1,350,940,10,349,934,10,35.0,>30,ENG,Home,Upto 2014
DJ Bravo,WI,Pace,2004-07-22,Lord's,England,2004,2,102,190,3,1,966,1493,22,864,1303,19,43.90909090909091,>30,ENG,Away,Upto 2014
DJ Bravo,WI,Pace,2004-07-29,Birmingham,England,2004,2,104,180,4,1,971,1389,23,867,1209,19,42.21739130434783,>30,ENG,Away,Upto 2014
DJ Bravo,WI,Pace,2004-08-12,Manchester,England,2004,2,96,228,6,1,785,1467,28,689,1239,22,28.035714285714285,<=30,ENG,Away,Upto 2014
DJ Bravo,WI,Pace,2004-08-19,The Oval,England,2004,1,117,174,3,1,794,1252,26,677,1078,23,30.53846153846154,>30,ENG,Away,Upto 2014
DJ Bravo,WI,Pace,2005-04-08,Port of Spain,West Indies,2005,2,125,258,3,1,854,1820,25,729,1562,22,34.16,>30,WI,Home,Upto 2014
DJ Bravo,WI,Pace,2005-04-21,Bridgetown,West Indies,2005,1,73,174,0,1,712,1449,24,639,1275,24,29.666666666666668,<=30,WI,Home,Upto 2014
DJ Bravo,WI,Pace,2005-04-29,St John's,West Indies,2005,2,121,192,1,1,1036,1736,12,915,1544,11,86.33333333333333,>30,WI,Home,Upto 2014
DJ Bravo,WI,Pace,2005-11-17,Hobart,Australia,2005,2,117,180,2,1,632,1261,19,515,1081,17,33.26315789473684,>30,AUS,Away,Upto 2014
DJ Bravo,WI,Pace,2005-11-25,Adelaide,Australia,2005,1,84,162,6,1,853,1575,23,769,1413,17,37.08695652173913,>30,AUS,Away,Upto 2014
DJ Bravo,WI,Pace,2006-06-02,St John's,West Indies,2006,2,138,290,4,1,716,1427,15,578,1137,11,47.733333333333334,>30,WI,Home,Upto 2014
DJ Bravo,WI,Pace,2006-06-10,Gros Islet,West Indies,2006,1,66,60,0,1,597,938,8,531,878,8,74.625,>30,WI,Home,Upto 2014
DJ Bravo,WI,Pace,2006-06-22,Basseterre,West Indies,2006,2,74,147,2,1,636,1116,17,562,969,15,37.411764705882355,>30,WI,Home,Upto 2014
DJ Bravo,WI,Pace,2006-06-30,Kingston,West Indies,2006,2,78,168,2,1,405,1019,25,327,851,23,16.2,<=30,WI,Home,Upto 2014
DJ Bravo,WI,Pace,2006-11-11,Lahore,Pakistan,2006,1,63,120,0,1,669,1208,21,606,1088,21,31.857142857142858,>30,PAK,Away,Upto 2014
DJ Bravo,WI,Pace,2006-11-19,Multan,Pakistan,2006,2,81,192,1,1,741,1564,16,660,1372,15,46.3125,>30,PAK,Away,Upto 2014
DJ Bravo,WI,Pace,2006-11-27,Karachi,Pakistan,2006,2,101,198,2,1,841,1655,23,740,1457,21,36.56521739130435,>30,PAK,Away,Upto 2014
DJ Bravo,WI,Pace,2007-05-17,Lord's,England,2007,2,197,300,3,1,1013,1620,14,816,1320,11,72.35714285714286,>30,ENG,Away,Upto 2014
DJ Bravo,WI,Pace,2007-05-25,Leeds,England,2007,1,97,147,1,1,714,1084,23,617,937,22,31.043478260869566,>30,ENG,Away,Upto 2014
DJ Bravo,WI,Pace,2007-06-07,Manchester,England,2007,2,108,186,2,1,901,1654,29,793,1468,27,31.06896551724138,>30,ENG,Away,Upto 2014
DJ Bravo,WI,Pace,2007-06-15,Chester-le-Street,England,2007,1,10,12,0,1,807,1380,26,797,1368,26,31.03846153846154,>30,ENG,Away,Upto 2014
DJ Bravo,WI,Pace,2007-12-26,Gqeberha,South Africa,2007,2,87,175,5,1,900,1655,32,813,1480,27,28.125,<=30,SA,Away,Upto 2014
DJ Bravo,WI,Pace,2008-01-02,Cape Town,South Africa,2008,2,116,264,5,1,787,1720,28,671,1456,23,28.107142857142858,<=30,SA,Away,Upto 2014
DJ Bravo,WI,Pace,2008-03-22,Providence,West Indies,2008,2,128,264,3,1,635,1249,22,507,985,19,28.863636363636363,<=30,WI,Home,Upto 2014
DJ Bravo,WI,Pace,2008-04-03,Port of Spain,West Indies,2008,2,117,177,2,1,851,1278,24,734,1101,22,35.458333333333336,>30,WI,Home,Upto 2014
DJ Bravo,WI,Pace,2008-05-22,Kingston,West Indies,2008,2,108,245,5,1,802,1720,34,694,1475,29,23.58823529411765,<=30,WI,Home,Upto 2014
DJ Bravo,WI,Pace,2008-05-30,North Sound,West Indies,2008,2,139,228,2,1,984,1871,24,845,1643,22,41.0,>30,WI,Home,Upto 2014
DJ Bravo,WI,Pace,2008-06-12,Bridgetown,West Indies,2008,2,124,228,3,1,809,1396,25,685,1168,22,32.36,>30,WI,Home,Upto 2014
DJ Bravo,WI,Pace,2009-11-26,Brisbane,Australia,2009,1,118,192,3,1,697,1123,21,579,931,18,33.19047619047619,>30,AUS,Away,Upto 2014
DJ Bravo,WI,Pace,2009-12-04,Adelaide,Australia,2009,2,80,162,3,1,930,1567,26,850,1405,23,35.76923076923077,>30,AUS,Away,Upto 2014
DJ Bravo,WI,Pace,2009-12-16,W.A.C.A,Australia,2009,2,121,211,5,1,927,1486,27,806,1275,22,34.333333333333336,>30,AUS,Away,Upto 2014
DJ Bravo,WI,Pace,2010-06-10,Port of Spain,West Indies,2010,2,42,124,1,1,433,932,18,391,808,17,24.055555555555557,<=30,WI,Home,Upto 2014
DJ Bravo,WI,Pace,2010-06-18,Basseterre,West Indies,2010,2,95,174,1,1,644,1267,9,549,1093,8,71.55555555555556,>30,WI,Home,Upto 2014
DJ Bravo,WI,Pace,2010-06-26,Bridgetown,West Indies,2010,1,43,162,0,1,416,803,18,373,641,18,23.11111111111111,<=30,WI,Home,Upto 2014
DJ Bravo,WI,Pace,2010-11-15,Galle,Sri Lanka,2010,2,87,170,1,1,602,992,8,515,822,7,75.25,>30,SL,Away,Upto 2014
DJ Bravo,WI,Pace,2010-11-23,Colombo (RPS),Sri Lanka,2010,2,69,132,2,1,389,758,12,320,626,10,32.416666666666664,>30,SL,Away,Upto 2014
DJ Brown,ENG,Pace,1965-07-22,Lord's,England,1965,2,74,270,6,1,689,1908,25,615,1638,19,27.56,<=30,ENG,Home,Upto 2014
DJ Brown,ENG,Pace,1965-08-26,The Oval,England,1965,2,126,270,2,1,786,1848,27,660,1578,25,29.11111111111111,<=30,ENG,Home,Upto 2014
DJ Brown,ENG,Pace,1965-12-10,Brisbane,Australia,1965,1,71,168,3,1,379,960,11,308,792,8,34.45454545454545,>30,AUS,Away,Upto 2014
DJ Brown,ENG,Pace,1966-01-07,Sydney,Australia,1966,2,95,224,6,1,445,1015,16,350,791,10,27.8125,<=30,AUS,Away,Upto 2014
DJ Brown,ENG,Pace,1966-01-28,Adelaide,Australia,1966,1,109,224,1,1,581,1367,21,472,1143,20,27.666666666666668,<=30,AUS,Away,Upto 2014
DJ Brown,ENG,Pace,1966-02-11,Melbourne,Australia,1966,1,134,248,1,1,701,1506,15,567,1258,14,46.733333333333334,>30,AUS,Away,Upto 2014
DJ Brown,ENG,Pace,1966-02-25,Christchurch,New Zealand,1966,2,86,204,4,1,629,1668,27,543,1464,23,23.296296296296298,<=30,NZ,Away,Upto 2014
DJ Brown,ENG,Pace,1966-03-11,Auckland,New Zealand,1966,2,40,157,2,1,459,1620,21,419,1463,19,21.857142857142858,<=30,NZ,Away,Upto 2014
DJ Brown,ENG,Pace,1966-06-02,Manchester,England,1966,1,84,168,0,1,402,732,5,318,564,5,80.4,>30,ENG,Home,Upto 2014
DJ Brown,ENG,Pace,1967-06-22,Lord's,England,1967,2,71,138,3,1,257,628,10,186,490,7,25.7,<=30,ENG,Home,Upto 2014
DJ Brown,ENG,Pace,1967-07-13,Birmingham,England,1967,2,18,78,3,1,150,354,6,132,276,3,25.0,<=30,ENG,Home,Upto 2014
DJ Brown,ENG,Pace,1968-01-19,Port of Spain,West Indies,1968,2,92,216,5,1,435,1007,15,343,791,10,29.0,<=30,WI,Away,Upto 2014
DJ Brown,ENG,Pace,1968-02-08,Kingston,West Indies,1968,2,99,276,3,1,570,1419,25,471,1143,22,22.8,<=30,WI,Away,Upto 2014
DJ Brown,ENG,Pace,1968-02-29,Bridgetown,West Indies,1968,2,127,258,3,1,595,1213,17,468,955,14,35.0,>30,WI,Away,Upto 2014
DJ Brown,ENG,Pace,1968-03-14,Port of Spain,West Indies,1968,2,140,222,3,1,441,768,6,301,546,3,73.5,>30,WI,Away,Upto 2014
DJ Brown,ENG,Pace,1968-06-20,Lord's,England,1968,2,82,198,5,1,427,1141,15,345,943,10,28.466666666666665,<=30,ENG,Home,Upto 2014
DJ Brown,ENG,Pace,1968-07-11,Birmingham,England,1968,2,59,114,1,1,595,1325,15,536,1211,14,39.666666666666664,>30,ENG,Home,Upto 2014
DJ Brown,ENG,Pace,1968-07-25,Leeds,England,1968,2,178,372,2,1,706,1746,18,528,1374,16,39.22222222222222,>30,ENG,Home,Upto 2014
DJ Brown,ENG,Pace,1968-08-22,The Oval,England,1968,2,82,180,4,1,485,1288,15,403,1108,11,32.333333333333336,>30,ENG,Home,Upto 2014
DJ Brown,ENG,Pace,1969-02-21,Lahore,Pakistan,1969,2,90,174,5,1,347,758,16,257,584,11,21.6875,<=30,PAK,Away,Upto 2014
DJ Brown,ENG,Pace,1969-02-28,Dhaka,Bangladesh,1969,2,69,174,3,1,300,937,11,231,763,8,27.272727272727273,<=30,BAN,Away,Upto 2014
DJ Brown,ENG,Pace,1969-06-12,Manchester,England,1969,2,98,210,7,1,490,1177,22,392,967,15,22.272727272727273,<=30,ENG,Home,Upto 2014
DJ Brown,ENG,Pace,1969-06-26,Lord's,England,1969,2,124,282,3,1,864,2111,25,740,1829,22,34.56,>30,ENG,Home,Upto 2014
DJ Brown,ENG,Pace,1969-07-10,Leeds,England,1969,2,66,171,4,1,581,1581,25,515,1410,21,23.24,<=30,ENG,Home,Upto 2014
DJ Brown,ENG,Pace,1969-07-24,Lord's,England,1969,2,23,102,0,1,463,1142,17,440,1040,17,27.235294117647058,<=30,ENG,Home,Upto 2014
DJ Capel,ENG,Pace,1987-07-02,Leeds,England,1987,1,64,108,0,1,511,1279,29,447,1171,29,17.620689655172413,<=30,ENG,Home,Upto 2014
DJ Capel,ENG,Pace,1987-11-25,Lahore,Pakistan,1987,1,28,18,0,1,221,462,3,193,444,3,73.66666666666667,>30,PAK,Away,Upto 2014
DJ Capel,ENG,Pace,1987-12-07,Faisalabad,Pakistan,1987,1,23,42,0,1,157,324,5,134,282,5,31.4,>30,PAK,Away,Upto 2014
DJ Capel,ENG,Pace,1987-12-16,Karachi,Pakistan,1987,1,8,18,1,1,422,869,15,414,851,14,28.133333333333333,<=30,PAK,Away,Upto 2014
DJ Capel,ENG,Pace,1988-01-29,Sydney,Australia,1988,2,51,138,3,1,421,1098,12,370,960,9,35.083333333333336,>30,AUS,Away,Upto 2014
DJ Capel,ENG,Pace,1988-02-12,Christchurch,New Zealand,1988,2,48,138,0,1,693,1999,33,645,1861,33,21.0,<=30,NZ,Away,Upto 2014
DJ Capel,ENG,Pace,1988-02-25,Auckland,New Zealand,1988,2,97,284,3,1,724,1989,22,627,1705,19,32.90909090909091,>30,NZ,Away,Upto 2014
DJ Capel,ENG,Pace,1988-03-03,Wellington,New Zealand,1988,1,129,234,2,1,376,817,5,247,583,3,75.2,>30,NZ,Away,Upto 2014
DJ Capel,ENG,Pace,1988-06-30,Manchester,England,1988,1,38,72,1,1,423,1051,26,385,979,25,16.26923076923077,<=30,ENG,Home,Upto 2014
DJ Capel,ENG,Pace,1988-08-04,The Oval,England,1988,2,41,60,0,1,629,1534,24,588,1474,24,26.208333333333332,<=30,ENG,Home,Upto 2014
DJ Capel,ENG,Pace,1989-08-24,The Oval,England,1989,2,101,144,2,1,921,1691,26,820,1547,24,35.42307692307692,>30,ENG,Home,Upto 2014
DJ Capel,ENG,Pace,1990-02-24,Kingston,West Indies,1990,2,81,168,2,1,668,1460,29,587,1292,27,23.03448275862069,<=30,WI,Away,Upto 2014
DJ Capel,ENG,Pace,1990-03-23,Port of Spain,West Indies,1990,2,83,168,1,1,773,1811,34,690,1643,33,22.735294117647058,<=30,WI,Away,Upto 2014
DJ Capel,ENG,Pace,1990-04-05,Bridgetown,West Indies,1990,2,154,240,4,1,1177,2232,37,1023,1992,33,31.81081081081081,>30,WI,Away,Upto 2014
DJ Capel,ENG,Pace,1990-04-12,St John's,West Indies,1990,1,118,168,2,1,830,1554,26,712,1386,24,31.923076923076923,>30,WI,Away,Upto 2014
DJ Colley,AUS,Pace,1972-06-08,Manchester,England,1972,2,151,336,4,1,656,1682,30,505,1346,26,21.866666666666667,<=30,ENG,Away,Upto 2014
DJ Colley,AUS,Pace,1972-06-22,Lord's,England,1972,2,50,138,0,1,594,1418,30,544,1280,30,19.8,<=30,ENG,Away,Upto 2014
DJ Colley,AUS,Pace,1972-07-13,Nottingham,England,1972,2,111,255,2,1,670,1779,23,559,1524,21,29.130434782608695,<=30,ENG,Away,Upto 2014
DJ Cullen,AUS,Spin,2006-04-16,Chattogram,Bangladesh,2006,2,54,84,1,1,796,1393,18,742,1309,17,44.22222222222222,>30,BAN,Away,Upto 2014
DJ Cullinan,SA,Spin,1997-10-06,Rawalpindi,Pakistan,1997,1,2,6,0,1,443,1103,12,441,1097,12,36.916666666666664,>30,PAK,Away,Upto 2014
DJ Cullinan,SA,Spin,1998-07-02,Manchester,England,1998,1,1,6,0,1,380,1050,6,379,1044,6,63.333333333333336,>30,ENG,Away,Upto 2014
DJ Cullinan,SA,Spin,1998-08-06,Leeds,England,1998,1,1,6,0,1,41,72,0,40,66,0,inf,>30,ENG,Away,Upto 2014
DJ Cullinan,SA,Spin,1999-01-02,Cape Town,South Africa,1999,1,10,24,0,1,319,696,6,309,672,6,53.166666666666664,>30,SA,Home,Upto 2014
DJ Cullinan,SA,Spin,1999-01-15,Centurion,South Africa,1999,1,32,42,1,1,279,568,9,247,526,8,31.0,>30,SA,Home,Upto 2014
DJ Cullinan,SA,Spin,1999-02-27,Auckland,New Zealand,1999,1,8,12,0,1,327,720,5,319,708,5,65.4,>30,NZ,Away,Upto 2014
DJ Cullinan,SA,Spin,2000-07-20,Galle,Sri Lanka,2000,1,10,12,1,1,705,1392,24,695,1380,23,29.375,<=30,SL,Away,Upto 2014
DJ Cullinan,SA,Spin,2000-07-30,Kandy,Sri Lanka,2000,1,7,12,0,1,551,1139,19,544,1127,19,29.0,<=30,SL,Away,Upto 2014
DJ Johnson,IND,Pace,1996-10-10,Delhi,India,1996,2,52,96,1,1,274,681,13,222,585,12,21.076923076923077,<=30,IND,Home,Upto 2014
DJ Johnson,IND,Pace,1996-12-26,Durban,South Africa,1996,2,91,144,2,1,537,1172,37,446,1028,35,14.513513513513514,<=30,SA,Away,Upto 2014
DJ Malan,ENG,Spin,2017-08-04,Manchester,England,2017,1,7,6,0,1,291,609,10,284,603,10,29.1,<=30,ENG,Home,After 1965
DJ Malan,ENG,Spin,2017-12-14,W.A.C.A,Australia,2017,1,13,36,0,1,269,492,4,256,456,4,67.25,>30,AUS,Away,After 1965
DJ Malan,ENG,Spin,2017-12-26,Melbourne,Australia,2017,2,41,90,0,1,251,518,4,210,428,4,62.75,>30,AUS,Away,After 1965
DJ Malan,ENG,Spin,2018-03-30,Christchurch,New Zealand,2018,1,9,24,0,1,236,508,3,227,484,3,78.66666666666667,>30,NZ,Away,After 1965
DJ Malan,ENG,Spin,2021-12-16,Adelaide,Australia,2021,1,33,36,2,1,255,630,10,222,594,8,25.5,<=30,AUS,Away,After 1965
DJ Malan,ENG,Spin,2022-01-05,Sydney,Australia,2022,2,28,30,0,1,414,683,10,386,653,10,41.4,>30,AUS,Away,After 1965
DJ McGlew,SA,Spin,1953-01-24,Adelaide,Australia,1953,2,16,24,0,1,857,2379,23,841,2355,23,37.26086956521739,>30,AUS,Away,Upto 2014
DJ McGlew,SA,Spin,1957-12-23,Johannesburg,South Africa,1957,1,7,8,0,1,467,1272,8,460,1264,8,58.375,>30,SA,Home,Upto 2014
DJ Meintjes,SA,Pace,1923-02-09,Johannesburg,South Africa,1923,2,69,114,4,1,723,1725,22,654,1611,18,32.86363636363637,>30,SA,Home,Upto 2014
DJ Meintjes,SA,Pace,1923-02-16,Durban,South Africa,1923,2,46,132,2,1,724,2332,33,678,2200,31,21.939393939393938,<=30,SA,Home,Upto 2014
DJ Mitchell,NZ,Pace,2019-11-29,Hamilton,New Zealand,2019,1,69,132,0,1,881,1878,20,812,1746,20,44.05,>30,NZ,Home,After 1965
DJ Mitchell,NZ,Pace,2020-12-03,Hamilton,New Zealand,2020,1,7,18,1,1,725,1439,25,718,1421,24,29.0,<=30,NZ,Home,After 1965
DJ Mitchell,NZ,Pace,2020-12-11,Wellington,New Zealand,2020,1,20,24,0,1,834,1421,28,814,1397,28,29.785714285714285,<=30,NZ,Home,After 1965
DJ Mitchell,NZ,Pace,2021-01-03,Christchurch,New Zealand,2021,2,14,42,0,1,918,1730,25,904,1688,25,36.72,>30,NZ,Home,After 1965
DJ Mitchell,NZ,Pace,2021-06-10,Birmingham,England,2021,1,23,66,0,1,672,1387,27,649,1321,27,24.88888888888889,<=30,ENG,Away,After 1965
DJ Mitchell,NZ,Pace,2021-12-03,Wankhede,India,2021,1,9,30,0,1,192,474,3,183,444,3,64.0,>30,IND,Away,After 1965
DJ Mitchell,NZ,Pace,2022-01-09,Christchurch,New Zealand,2022,1,18,36,1,1,738,1267,23,720,1231,22,32.08695652173913,>30,NZ,Home,After 1965
DJ Mitchell,NZ,Pace,2022-06-02,Lord's,England,2022,1,0,1,0,1,722,1408,33,722,1407,33,21.87878787878788,<=30,ENG,Away,After 1965
DJ Mitchell,NZ,Pace,2022-06-10,Nottingham,England,2022,1,8,12,0,1,1254,1921,26,1246,1909,26,48.23076923076923,>30,ENG,Away,After 1965
DJ Mitchell,NZ,Pace,2022-06-23,Leeds,England,2022,1,16,18,0,1,862,1428,19,846,1410,19,45.36842105263158,>30,ENG,Away,After 1965
DJ Mitchell,NZ,Pace,2022-12-26,Karachi,Pakistan,2022,1,19,18,0,1,287,569,4,268,551,4,71.75,>30,PAK,Away,After 1965
DJ Mitchell,NZ,Pace,2023-01-02,Karachi,Pakistan,2023,2,16,84,1,1,583,1266,12,567,1182,11,48.583333333333336,>30,PAK,Away,After 1965
DJ Mitchell,NZ,Pace,2023-02-24,Wellington,New Zealand,2023,1,61,54,0,1,965,1553,25,904,1499,25,38.6,>30,NZ,Home,After 1965
DJ Mitchell,NZ,Pace,2023-03-09,Christchurch,New Zealand,2023,2,48,114,0,1,1067,1960,32,1019,1846,32,33.34375,>30,NZ,Home,After 1965
DJ Mitchell,NZ,Pace,2023-03-17,Wellington,New Zealand,2023,1,3,6,0,1,761,1427,16,758,1421,16,47.5625,>30,NZ,Home,After 1965
DJ Mitchell,NZ,Pace,2023-11-28,Sylhet,Bangladesh,2023,1,2,6,0,1,222,475,6,220,469,6,37.0,>30,BAN,Away,After 1965
DJ Mitchell,NZ,Pace,2024-02-29,Wellington,New Zealand,2024,1,17,24,0,1,689,1266,22,672,1242,22,31.318181818181817,>30,NZ,Home,After 1965
DJ Mitchell,NZ,Pace,2024-09-26,Galle,Sri Lanka,2024,1,25,18,0,1,205,300,2,180,282,2,102.5,>30,SL,Away,After 1965
DJ Nash,NZ,Pace,1992-11-07,Harare,Zimbabwe,1992,2,78,216,2,1,623,1378,20,545,1162,18,31.15,>30,ZIM,Away,Upto 2014
DJ Nash,NZ,Pace,1992-11-27,Moratuwa,Sri Lanka,1992,1,62,108,1,1,602,1223,13,540,1115,12,46.30769230769231,>30,SL,Away,Upto 2014
DJ Nash,NZ,Pace,1994-03-19,Hamilton,New Zealand,1994,2,82,198,1,1,466,1167,15,384,969,14,31.066666666666666,>30,NZ,Home,Upto 2014
DJ Nash,NZ,Pace,1994-06-02,Nottingham,England,1994,1,153,216,2,1,704,1313,20,551,1097,18,35.2,>30,ENG,Away,Upto 2014
DJ Nash,NZ,Pace,1994-06-16,Lord's,England,1994,2,169,324,11,1,756,1458,24,587,1134,13,31.5,>30,ENG,Away,Upto 2014
DJ Nash,NZ,Pace,1994-06-30,Manchester,England,1994,1,107,234,4,1,638,1439,22,531,1205,18,29.0,<=30,ENG,Away,Upto 2014
DJ Nash,NZ,Pace,1994-11-25,Johannesburg,South Africa,1994,2,98,192,3,1,787,1709,30,689,1517,27,26.233333333333334,<=30,SA,Away,Upto 2014
DJ Nash,NZ,Pace,1995-02-03,Christchurch,New Zealand,1995,1,11,30,0,1,515,1143,17,504,1113,17,30.294117647058822,>30,NZ,Home,Upto 2014
DJ Nash,NZ,Pace,1995-03-04,Auckland,New Zealand,1995,2,139,294,5,1,789,1800,31,650,1506,26,25.451612903225808,<=30,NZ,Home,Upto 2014
DJ Nash,NZ,Pace,1995-03-11,Napier,New Zealand,1995,2,115,312,3,1,717,1794,34,602,1482,31,21.08823529411765,<=30,NZ,Home,Upto 2014
DJ Nash,NZ,Pace,1995-10-18,Bengaluru,India,1995,2,76,138,3,1,331,688,17,255,550,14,19.470588235294116,<=30,IND,Away,Upto 2014
DJ Nash,NZ,Pace,1995-10-25,Chennai,India,1995,1,22,90,1,1,74,270,2,52,180,1,37.0,>30,IND,Away,Upto 2014
DJ Nash,NZ,Pace,1995-11-08,Cuttack,India,1995,1,62,174,4,1,240,497,7,178,323,3,34.285714285714285,>30,IND,Away,Upto 2014
DJ Nash,NZ,Pace,1995-12-08,Christchurch,New Zealand,1995,2,134,246,4,1,844,1657,28,710,1411,24,30.142857142857142,>30,NZ,Home,Upto 2014
DJ Nash,NZ,Pace,1998-02-19,Wellington,New Zealand,1998,2,21,138,2,1,429,1062,17,408,924,15,25.235294117647058,<=30,NZ,Home,Upto 2014
DJ Nash,NZ,Pace,1998-02-26,Auckland,New Zealand,1998,2,54,168,5,1,557,1155,25,503,987,20,22.28,<=30,NZ,Home,Upto 2014
DJ Nash,NZ,Pace,1998-12-26,Wellington,New Zealand,1998,2,66,174,4,1,632,1417,22,566,1243,18,28.727272727272727,<=30,NZ,Home,Upto 2014
DJ Nash,NZ,Pace,1999-01-02,Hamilton,New Zealand,1999,1,98,222,2,1,1002,1896,23,904,1674,21,43.56521739130435,>30,NZ,Home,Upto 2014
DJ Nash,NZ,Pace,1999-02-27,Auckland,New Zealand,1999,1,97,168,0,1,841,1949,13,744,1781,13,64.6923076923077,>30,NZ,Home,Upto 2014
DJ Nash,NZ,Pace,1999-03-11,Christchurch,New Zealand,1999,1,46,132,0,1,581,1404,8,535,1272,8,72.625,>30,NZ,Home,Upto 2014
DJ Nash,NZ,Pace,1999-03-18,Wellington,New Zealand,1999,1,76,150,2,1,742,1762,20,666,1612,18,37.1,>30,NZ,Home,Upto 2014
DJ Nash,NZ,Pace,1999-07-01,Birmingham,England,1999,2,46,108,4,1,580,1146,27,534,1038,23,21.48148148148148,<=30,ENG,Away,Upto 2014
DJ Nash,NZ,Pace,1999-07-22,Lord's,England,1999,2,100,288,4,1,642,1427,25,542,1139,21,25.68,<=30,ENG,Away,Upto 2014
DJ Nash,NZ,Pace,1999-08-05,Manchester,England,1999,2,72,247,4,1,505,1189,11,433,942,7,45.90909090909091,>30,ENG,Away,Upto 2014
DJ Nash,NZ,Pace,1999-08-19,The Oval,England,1999,2,79,168,5,1,501,1268,29,422,1100,24,17.275862068965516,<=30,ENG,Away,Upto 2014
DJ Nash,NZ,Pace,1999-10-10,Mohali,India,1999,2,106,288,6,1,577,1368,20,471,1080,14,28.85,<=30,IND,Away,Upto 2014
DJ Nash,NZ,Pace,1999-10-22,Kanpur,India,1999,2,52,156,1,1,214,642,8,162,486,7,26.75,<=30,IND,Away,Upto 2014
DJ Nash,NZ,Pace,1999-10-29,Ahmedabad,India,1999,2,121,216,1,1,649,1266,11,528,1050,10,59.0,>30,IND,Away,Upto 2014
DJ Nash,NZ,Pace,1999-12-16,Hamilton,New Zealand,1999,2,100,210,3,1,615,1231,21,515,1021,18,29.285714285714285,<=30,NZ,Home,Upto 2014
DJ Nash,NZ,Pace,1999-12-26,Wellington,New Zealand,1999,2,61,204,5,1,571,1324,20,510,1120,15,28.55,<=30,NZ,Home,Upto 2014
DJ Nash,NZ,Pace,2000-09-19,Harare,Zimbabwe,2000,2,53,207,1,1,838,2129,25,785,1922,24,33.52,>30,ZIM,Away,Upto 2014
DJ Nash,NZ,Pace,2001-11-08,Brisbane,Australia,2001,1,93,180,0,1,871,1428,20,778,1248,20,43.55,>30,AUS,Away,Upto 2014
DJ Pattinson,ENG,Pace,2008-07-18,Leeds,England,2008,2,96,181,2,1,905,1732,27,809,1551,25,33.51851851851852,>30,ENG,Home,Upto 2014
DJ Sincock,AUS,Spin,1964-12-04,Melbourne,Australia,1964,2,169,366,4,1,473,1030,6,304,664,2,78.83333333333333,>30,AUS,Home,Upto 2014
DJ Sincock,AUS,Spin,1965-05-14,Port of Spain,West Indies,1965,2,143,198,4,1,396,885,11,253,687,7,36.0,>30,WI,Away,Upto 2014
DJ Sincock,AUS,Spin,1966-01-07,Sydney,Australia,1966,1,98,160,0,1,404,1124,13,306,964,13,31.076923076923077,>30,AUS,Home,Upto 2014
DJ Terbrugge,SA,Pace,1998-11-26,Johannesburg,South Africa,1998,2,55,180,2,1,642,1519,31,587,1339,29,20.70967741935484,<=30,SA,Home,Upto 2014
DJ Terbrugge,SA,Pace,1998-12-10,Gqeberha,South Africa,1998,2,54,84,3,1,639,1208,36,585,1124,33,17.75,<=30,SA,Home,Upto 2014
DJ Terbrugge,SA,Pace,1998-12-26,Durban,South Africa,1998,2,67,150,3,1,645,1347,28,578,1197,25,23.035714285714285,<=30,SA,Home,Upto 2014
DJ Terbrugge,SA,Pace,1999-01-02,Cape Town,South Africa,1999,2,77,186,1,1,785,1771,27,708,1585,26,29.074074074074073,<=30,SA,Home,Upto 2014
DJ Terbrugge,SA,Pace,2002-03-15,Durban,South Africa,2002,2,82,120,4,1,733,1239,21,651,1119,17,34.904761904761905,>30,SA,Home,Upto 2014
DJ Terbrugge,SA,Pace,2002-10-18,East London,South Africa,2002,2,89,160,7,1,686,1167,21,597,1007,14,32.666666666666664,>30,SA,Home,Upto 2014
DJ Terbrugge,SA,Pace,2004-03-18,Auckland,New Zealand,2004,1,93,132,0,1,1016,1973,29,923,1841,29,35.03448275862069,>30,NZ,Away,Upto 2014
DJ White,NZ,Spin,1990-10-18,Lahore,Pakistan,1990,1,5,3,0,1,149,339,4,144,336,4,37.25,>30,PAK,Away,Upto 2014
DJG Sammy,WI,Pace,2007-06-07,Manchester,England,2007,2,98,231,8,1,901,1654,29,803,1423,21,31.06896551724138,>30,ENG,Away,Upto 2014
DJG Sammy,WI,Pace,2007-12-26,Gqeberha,South Africa,2007,2,35,66,1,1,900,1655,32,865,1589,31,28.125,<=30,SA,Away,Upto 2014
DJG Sammy,WI,Pace,2008-01-10,Durban,South Africa,2008,1,104,150,1,1,883,1304,22,779,1154,21,40.13636363636363,>30,SA,Away,Upto 2014
DJG Sammy,WI,Pace,2008-05-22,Kingston,West Indies,2008,2,88,198,2,1,802,1720,34,714,1522,32,23.58823529411765,<=30,WI,Home,Upto 2014
DJG Sammy,WI,Pace,2008-05-30,North Sound,West Indies,2008,2,116,198,1,1,984,1871,24,868,1673,23,41.0,>30,WI,Home,Upto 2014
DJG Sammy,WI,Pace,2009-07-09,Kingstown,West Indies,2009,2,108,295,6,1,537,1048,20,429,753,14,26.85,<=30,WI,Home,Upto 2014
DJG Sammy,WI,Pace,2009-07-17,St George's,West Indies,2009,2,100,186,6,1,424,759,14,324,573,8,30.285714285714285,>30,WI,Home,Upto 2014
DJG Sammy,WI,Pace,2009-12-04,Adelaide,Australia,2009,2,100,138,2,1,930,1567,26,830,1429,24,35.76923076923077,>30,AUS,Away,Upto 2014
DJG Sammy,WI,Pace,2010-11-15,Galle,Sri Lanka,2010,2,55,120,0,1,602,992,8,547,872,8,75.25,>30,SL,Away,Upto 2014
DJG Sammy,WI,Pace,2010-11-23,Colombo (RPS),Sri Lanka,2010,2,96,234,2,1,389,758,12,293,524,10,32.416666666666664,>30,SL,Away,Upto 2014
DJG Sammy,WI,Pace,2011-05-12,Providence,West Indies,2011,2,45,174,7,1,310,796,18,265,622,11,17.22222222222222,<=30,WI,Home,Upto 2014
DJG Sammy,WI,Pace,2011-05-20,Basseterre,West Indies,2011,2,134,306,3,1,547,1106,13,413,800,10,42.07692307692308,>30,WI,Home,Upto 2014
DJG Sammy,WI,Pace,2011-06-20,Kingston,West Indies,2011,2,94,240,4,1,535,1130,25,441,890,21,21.4,<=30,WI,Home,Upto 2014
DJG Sammy,WI,Pace,2011-06-28,Bridgetown,West Indies,2011,2,97,258,1,1,639,1424,28,542,1166,27,22.821428571428573,<=30,WI,Home,Upto 2014
DJG Sammy,WI,Pace,2011-07-06,Roseau,West Indies,2011,2,77,198,2,1,449,995,20,372,797,18,22.45,<=30,WI,Home,Upto 2014
DJG Sammy,WI,Pace,2011-10-21,Chattogram,Bangladesh,2011,2,62,192,2,1,310,664,6,248,472,4,51.666666666666664,>30,BAN,Away,Upto 2014
DJG Sammy,WI,Pace,2011-10-29,Mirpur,Bangladesh,2011,2,51,138,2,1,378,650,10,327,512,8,37.8,>30,BAN,Away,Upto 2014
DJG Sammy,WI,Pace,2011-11-06,Delhi,India,2011,2,91,144,5,1,494,839,13,403,695,8,38.0,>30,IND,Away,Upto 2014
DJG Sammy,WI,Pace,2011-11-14,Eden Gardens,India,2011,1,132,150,2,1,531,767,14,399,617,12,37.92857142857143,>30,IND,Away,Upto 2014
DJG Sammy,WI,Pace,2011-11-22,Wankhede,India,2011,1,90,156,2,1,622,1054,14,532,898,12,44.42857142857143,>30,IND,Away,Upto 2014
DJG Sammy,WI,Pace,2012-04-07,Bridgetown,West Indies,2012,2,92,186,3,1,725,1642,25,633,1456,22,29.0,<=30,WI,Home,Upto 2014
DJG Sammy,WI,Pace,2012-04-15,Port of Spain,West Indies,2012,2,44,144,1,1,412,924,17,368,780,16,24.235294117647058,<=30,WI,Home,Upto 2014
DJG Sammy,WI,Pace,2012-04-23,Roseau,West Indies,2012,2,68,186,1,1,492,1142,12,424,956,11,41.0,>30,WI,Home,Upto 2014
DJG Sammy,WI,Pace,2012-05-17,Lord's,England,2012,2,117,228,3,1,939,1916,29,822,1688,26,32.37931034482759,>30,ENG,Away,Upto 2014
DJG Sammy,WI,Pace,2012-05-25,Nottingham,England,2012,2,152,240,2,1,765,1507,24,613,1267,22,31.875,>30,ENG,Away,Upto 2014
DJG Sammy,WI,Pace,2012-06-07,Birmingham,England,2012,1,22,48,1,1,443,825,14,421,777,13,31.642857142857142,>30,ENG,Away,Upto 2014
DJG Sammy,WI,Pace,2012-07-25,North Sound,West Indies,2012,2,101,252,1,1,734,1446,19,633,1194,18,38.63157894736842,>30,WI,Home,Upto 2014
DJG Sammy,WI,Pace,2012-08-02,Kingston,West Indies,2012,2,50,96,0,1,597,1132,23,547,1036,23,25.956521739130434,<=30,WI,Home,Upto 2014
DJG Sammy,WI,Pace,2012-11-13,Mirpur,Bangladesh,2012,2,96,156,2,1,489,849,15,393,693,13,32.6,>30,BAN,Away,Upto 2014
DJG Sammy,WI,Pace,2012-11-21,Khulna,Bangladesh,2012,2,93,186,3,1,562,872,18,469,686,15,31.22222222222222,>30,BAN,Away,Upto 2014
DJG Sammy,WI,Pace,2013-03-12,Bridgetown,West Indies,2013,1,17,54,0,1,330,750,17,313,696,17,19.41176470588235,<=30,WI,Home,Upto 2014
DJG Sammy,WI,Pace,2013-03-20,Roseau,West Indies,2013,2,28,60,1,1,341,648,7,313,588,6,48.714285714285715,>30,WI,Home,Upto 2014
DJG Sammy,WI,Pace,2013-11-06,Eden Gardens,India,2013,1,52,72,0,1,366,583,13,314,511,13,28.153846153846153,<=30,IND,Away,Upto 2014
DJG Sammy,WI,Pace,2013-11-14,Wankhede,India,2013,1,41,54,0,1,332,492,5,291,438,5,66.4,>30,IND,Away,Upto 2014
DJG Sammy,WI,Pace,2013-12-03,Dunedin,New Zealand,2013,1,79,139,2,1,879,1520,20,800,1381,18,43.95,>30,NZ,Away,Upto 2014
DJG Sammy,WI,Pace,2013-12-11,Wellington,New Zealand,2013,1,92,150,2,1,603,1007,28,511,857,26,21.535714285714285,<=30,NZ,Away,Upto 2014
DJG Sammy,WI,Pace,2013-12-19,Hamilton,New Zealand,2013,2,90,192,3,1,543,1073,23,453,881,20,23.608695652173914,<=30,NZ,Away,Upto 2014
DK Gaekwad,IND,Spin,1953-01-21,Port of Spain,West Indies,1953,1,4,6,0,1,842,2177,19,838,2171,19,44.31578947368421,>30,WI,Away,Upto 2014
DK Gaekwad,IND,Spin,1959-02-06,Delhi,India,1959,1,8,6,0,1,775,1794,11,767,1788,11,70.45454545454545,>30,IND,Home,Upto 2014
DK Lillee,AUS,Pace,1971-01-29,Adelaide,Australia,1971,2,124,283,5,1,768,1851,22,644,1568,17,34.90909090909091,>30,AUS,Home,Upto 2014
DK Lillee,AUS,Pace,1971-02-12,Sydney,Australia,1971,2,75,216,3,1,479,1333,21,404,1117,18,22.80952380952381,<=30,AUS,Home,Upto 2014
DK Lillee,AUS,Pace,1972-06-08,Manchester,England,1972,2,106,354,8,1,656,1682,30,550,1328,22,21.866666666666667,<=30,ENG,Away,Upto 2014
DK Lillee,AUS,Pace,1972-06-22,Lord's,England,1972,2,140,294,4,1,594,1418,30,454,1124,26,19.8,<=30,ENG,Away,Upto 2014
DK Lillee,AUS,Pace,1972-07-13,Nottingham,England,1972,2,75,324,6,1,670,1779,23,595,1455,17,29.130434782608695,<=30,ENG,Away,Upto 2014
DK Lillee,AUS,Pace,1972-07-27,Leeds,England,1972,2,46,187,3,1,173,528,9,127,341,6,19.22222222222222,<=30,ENG,Away,Upto 2014
DK Lillee,AUS,Pace,1972-08-10,The Oval,England,1972,2,181,340,10,1,662,1491,19,481,1151,9,34.8421052631579,>30,ENG,Away,Upto 2014
DK Lillee,AUS,Pace,1972-12-22,Adelaide,Australia,1972,2,102,283,5,1,517,1131,14,415,848,9,36.92857142857143,>30,AUS,Home,Upto 2014
DK Lillee,AUS,Pace,1972-12-29,Melbourne,Australia,1972,2,149,222,3,1,925,1467,16,776,1245,13,57.8125,>30,AUS,Home,Upto 2014
DK Lillee,AUS,Pace,1973-01-06,Sydney,Australia,1973,2,102,264,4,1,767,1875,36,665,1611,32,21.305555555555557,<=30,AUS,Home,Upto 2014
DK Lillee,AUS,Pace,1973-02-16,Kingston,West Indies,1973,2,132,192,0,1,629,1295,15,497,1103,15,41.93333333333333,>30,WI,Away,Upto 2014
DK Lillee,AUS,Pace,1974-11-29,Brisbane,Australia,1974,2,98,280,4,1,649,1743,27,551,1463,23,24.037037037037038,<=30,AUS,Home,Upto 2014
DK Lillee,AUS,Pace,1974-12-13,W.A.C.A,Australia,1974,2,107,304,4,1,728,1672,24,621,1368,20,30.333333333333332,>30,AUS,Home,Upto 2014
DK Lillee,AUS,Pace,1974-12-26,Melbourne,Australia,1974,2,125,296,4,1,489,1257,19,364,961,15,25.736842105263158,<=30,AUS,Home,Upto 2014
DK Lillee,AUS,Pace,1975-01-04,Sydney,Australia,1975,2,131,321,4,1,724,1665,23,593,1344,19,31.47826086956522,>30,AUS,Home,Upto 2014
DK Lillee,AUS,Pace,1975-01-25,Adelaide,Australia,1975,2,118,213,8,1,469,911,17,351,698,9,27.58823529411765,<=30,AUS,Home,Upto 2014
DK Lillee,AUS,Pace,1975-02-08,Melbourne,Australia,1975,1,17,48,1,1,711,1562,25,694,1514,24,28.44,<=30,AUS,Home,Upto 2014
DK Lillee,AUS,Pace,1975-07-10,Birmingham,England,1975,2,60,210,7,1,502,1221,27,442,1011,20,18.59259259259259,<=30,ENG,Away,Upto 2014
DK Lillee,AUS,Pace,1975-07-31,Lord's,England,1975,2,164,318,5,1,808,1552,18,644,1234,13,44.888888888888886,>30,ENG,Away,Upto 2014
DK Lillee,AUS,Pace,1975-08-14,Leeds,England,1975,2,101,288,3,1,612,1447,21,511,1159,18,29.142857142857142,<=30,ENG,Away,Upto 2014
DK Lillee,AUS,Pace,1975-08-28,The Oval,England,1975,2,135,426,6,1,686,1764,24,551,1338,18,28.583333333333332,<=30,ENG,Away,Upto 2014
DK Lillee,AUS,Pace,1975-11-28,Brisbane,Australia,1975,2,156,216,6,1,663,1224,17,507,1008,11,39.0,>30,AUS,Home,Upto 2014
DK Lillee,AUS,Pace,1975-12-12,W.A.C.A,Australia,1975,1,123,160,2,1,857,1286,28,734,1126,26,30.607142857142858,>30,AUS,Home,Upto 2014
DK Lillee,AUS,Pace,1975-12-26,Melbourne,Australia,1975,2,126,232,7,1,804,1499,27,678,1267,20,29.77777777777778,<=30,AUS,Home,Upto 2014
DK Lillee,AUS,Pace,1976-01-23,Adelaide,Australia,1976,2,132,192,4,1,939,1486,26,807,1294,22,36.11538461538461,>30,AUS,Home,Upto 2014
DK Lillee,AUS,Pace,1976-01-31,Melbourne,Australia,1976,2,175,235,8,1,775,1378,27,600,1143,19,28.703703703703702,<=30,AUS,Home,Upto 2014
DK Lillee,AUS,Pace,1976-12-24,Adelaide,Australia,1976,2,267,535,6,1,783,1646,15,516,1111,9,52.2,>30,AUS,Home,Upto 2014
DK Lillee,AUS,Pace,1977-01-01,Melbourne,Australia,1977,2,135,296,10,1,882,1510,22,747,1214,12,40.09090909090909,>30,AUS,Home,Upto 2014
DK Lillee,AUS,Pace,1977-01-14,Sydney,Australia,1977,2,138,211,5,1,681,1364,30,543,1153,25,22.7,<=30,AUS,Home,Upto 2014
DK Lillee,AUS,Pace,1977-02-18,Christchurch,New Zealand,1977,2,189,394,4,1,990,2047,22,801,1653,18,45.0,>30,NZ,Away,Upto 2014
DK Lillee,AUS,Pace,1977-02-25,Auckland,New Zealand,1977,2,123,266,11,1,733,1600,29,610,1334,18,25.275862068965516,<=30,NZ,Away,Upto 2014
DK Lillee,AUS,Pace,1977-03-12,Melbourne,Australia,1977,2,165,383,11,1,769,1725,30,604,1342,19,25.633333333333333,<=30,AUS,Home,Upto 2014
DK Lillee,AUS,Pace,1979-12-01,Brisbane,Australia,1979,2,107,187,4,1,937,2006,27,830,1819,23,34.7037037037037,>30,AUS,Home,Upto 2014
DK Lillee,AUS,Pace,1979-12-14,W.A.C.A,Australia,1979,2,147,306,6,1,716,1874,34,569,1568,28,21.058823529411764,<=30,AUS,Home,Upto 2014
DK Lillee,AUS,Pace,1979-12-29,Melbourne,Australia,1979,2,105,234,3,1,659,1369,27,554,1135,24,24.40740740740741,<=30,AUS,Home,Upto 2014
DK Lillee,AUS,Pace,1980-01-04,Sydney,Australia,1980,2,103,228,6,1,548,1437,28,445,1209,22,19.571428571428573,<=30,AUS,Home,Upto 2014
DK Lillee,AUS,Pace,1980-01-26,Adelaide,Australia,1980,2,153,300,5,1,844,1627,35,691,1327,30,24.114285714285714,<=30,AUS,Home,Upto 2014
DK Lillee,AUS,Pace,1980-02-01,Melbourne,Australia,1980,2,138,397,11,1,694,1833,26,556,1436,15,26.692307692307693,<=30,AUS,Home,Upto 2014
DK Lillee,AUS,Pace,1980-02-27,Karachi,Pakistan,1980,2,98,234,0,1,240,648,5,142,414,5,48.0,>30,PAK,Away,Upto 2014
DK Lillee,AUS,Pace,1980-03-06,Faisalabad,Pakistan,1980,1,91,126,0,1,357,750,4,266,624,4,89.25,>30,PAK,Away,Upto 2014
DK Lillee,AUS,Pace,1980-03-18,Lahore,Pakistan,1980,1,114,252,3,1,489,1014,8,375,762,5,61.125,>30,PAK,Away,Upto 2014
DK Lillee,AUS,Pace,1980-08-28,Lord's,England,1980,2,96,204,5,1,636,1262,19,540,1058,14,33.473684210526315,>30,ENG,Away,Upto 2014
DK Lillee,AUS,Pace,1980-11-28,Brisbane,Australia,1980,2,89,198,8,1,530,1227,24,441,1029,16,22.083333333333332,<=30,AUS,Home,Upto 2014
DK Lillee,AUS,Pace,1980-12-12,W.A.C.A,Australia,1980,2,77,234,7,1,516,1220,27,439,986,20,19.11111111111111,<=30,AUS,Home,Upto 2014
DK Lillee,AUS,Pace,1980-12-26,Melbourne,Australia,1980,2,79,204,1,1,683,1801,29,604,1597,28,23.551724137931036,<=30,AUS,Home,Upto 2014
DK Lillee,AUS,Pace,1981-01-02,Sydney,Australia,1981,2,165,230,7,1,622,1071,25,457,841,18,24.88,<=30,AUS,Home,Upto 2014
DK Lillee,AUS,Pace,1981-01-23,Adelaide,Australia,1981,2,118,318,6,1,673,1308,18,555,990,12,37.388888888888886,>30,AUS,Home,Upto 2014
DK Lillee,AUS,Pace,1981-02-07,Melbourne,Australia,1981,2,169,343,8,1,509,1262,25,340,919,17,20.36,<=30,AUS,Home,Upto 2014
DK Lillee,AUS,Pace,1981-06-18,Nottingham,England,1981,2,80,178,8,1,571,1418,36,491,1240,28,15.86111111111111,<=30,ENG,Away,Upto 2014
DK Lillee,AUS,Pace,1981-07-02,Lord's,England,1981,2,184,374,3,1,755,1760,25,571,1386,22,30.2,>30,ENG,Away,Upto 2014
DK Lillee,AUS,Pace,1981-07-16,Leeds,England,1981,2,143,263,7,1,892,1859,38,749,1596,31,23.473684210526315,<=30,ENG,Away,Upto 2014
DK Lillee,AUS,Pace,1981-07-30,Birmingham,England,1981,2,112,264,4,1,525,1321,25,413,1057,21,21.0,<=30,ENG,Away,Upto 2014
DK Lillee,AUS,Pace,1981-08-13,Manchester,England,1981,2,192,421,6,1,887,1850,35,695,1429,29,25.34285714285714,<=30,ENG,Away,Upto 2014
DK Lillee,AUS,Pace,1981-08-27,The Oval,England,1981,2,159,370,11,1,972,2088,35,813,1718,24,27.771428571428572,<=30,ENG,Away,Upto 2014
DK Lillee,AUS,Pace,1981-11-13,W.A.C.A,Australia,1981,2,96,174,6,1,628,1440,27,532,1266,21,23.25925925925926,<=30,AUS,Home,Upto 2014
DK Lillee,AUS,Pace,1981-11-27,Brisbane,Australia,1981,2,132,234,9,1,651,1292,22,519,1058,13,29.59090909090909,<=30,AUS,Home,Upto 2014
DK Lillee,AUS,Pace,1981-12-11,Melbourne,Australia,1981,1,104,219,0,1,395,1019,11,291,800,11,35.90909090909091,>30,AUS,Home,Upto 2014
DK Lillee,AUS,Pace,1981-12-26,Melbourne,Australia,1981,2,127,322,10,1,642,1526,35,515,1204,25,18.34285714285714,<=30,AUS,Home,Upto 2014
DK Lillee,AUS,Pace,1982-01-02,Sydney,Australia,1982,2,169,354,6,1,792,1770,20,623,1416,14,39.6,>30,AUS,Home,Upto 2014
DK Lillee,AUS,Pace,1982-01-30,Adelaide,Australia,1982,2,21,53,0,1,872,1878,30,851,1825,30,29.066666666666666,<=30,AUS,Home,Upto 2014
DK Lillee,AUS,Pace,1982-02-26,Wellington,New Zealand,1982,1,32,90,0,1,258,786,4,226,696,4,64.5,>30,NZ,Away,Upto 2014
DK Lillee,AUS,Pace,1982-03-12,Auckland,New Zealand,1982,2,138,312,4,1,673,1668,23,535,1356,19,29.26086956521739,<=30,NZ,Away,Upto 2014
DK Lillee,AUS,Pace,1982-03-19,Christchurch,New Zealand,1982,1,13,72,3,1,665,1336,24,652,1264,21,27.708333333333332,<=30,NZ,Away,Upto 2014
DK Lillee,AUS,Pace,1982-11-12,W.A.C.A,Australia,1982,2,185,426,4,1,850,1760,19,665,1334,15,44.73684210526316,>30,AUS,Home,Upto 2014
DK Lillee,AUS,Pace,1983-04-22,Kandy,Sri Lanka,1983,2,107,180,3,1,440,696,7,333,516,4,62.857142857142854,>30,SL,Away,Upto 2014
DK Lillee,AUS,Pace,1983-11-11,W.A.C.A,Australia,1983,2,82,252,1,1,628,1218,24,546,966,23,26.166666666666668,<=30,AUS,Home,Upto 2014
DK Lillee,AUS,Pace,1983-11-25,Brisbane,Australia,1983,2,43,60,0,1,428,757,16,385,697,16,26.75,<=30,AUS,Home,Upto 2014
DK Lillee,AUS,Pace,1983-12-09,Adelaide,Australia,1983,1,171,302,6,1,947,1786,20,776,1484,14,47.35,>30,AUS,Home,Upto 2014
DK Lillee,AUS,Pace,1983-12-26,Melbourne,Australia,1983,2,184,402,5,1,818,1728,17,634,1326,12,48.11764705882353,>30,AUS,Home,Upto 2014
DK Lillee,AUS,Pace,1984-01-02,Sydney,Australia,1984,2,153,367,8,1,768,1631,25,615,1264,17,30.72,>30,AUS,Home,Upto 2014
DK Liyanage,SL,Pace,1992-08-28,Colombo (RPS),Sri Lanka,1992,2,113,258,3,1,531,1227,20,418,969,17,26.55,<=30,SL,Home,Upto 2014
DK Liyanage,SL,Pace,1992-09-08,Moratuwa,Sri Lanka,1992,2,110,198,5,1,511,1044,22,401,846,17,23.227272727272727,<=30,SL,Home,Upto 2014
DK Liyanage,SL,Pace,1992-11-27,Moratuwa,Sri Lanka,1992,2,130,263,4,1,602,1223,13,472,960,9,46.30769230769231,>30,SL,Home,Upto 2014
DK Liyanage,SL,Pace,1992-12-06,Colombo (SSC),Sri Lanka,1992,2,44,126,3,1,402,864,12,358,738,9,33.5,>30,SL,Home,Upto 2014
DK Liyanage,SL,Pace,1993-07-27,Colombo (SSC),Sri Lanka,1993,2,95,174,0,1,627,1409,18,532,1235,18,34.833333333333336,>30,SL,Home,Upto 2014
DK Liyanage,SL,Pace,1993-09-14,Colombo (PSS),Sri Lanka,1993,2,75,150,1,1,422,1175,13,347,1025,12,32.46153846153846,>30,SL,Home,Upto 2014
DK Liyanage,SL,Pace,1994-01-18,Lucknow,India,1994,1,55,102,1,1,249,514,6,194,412,5,41.5,>30,IND,Away,Upto 2014
DK Liyanage,SL,Pace,2001-08-29,Colombo (SSC),Sri Lanka,2001,2,44,84,0,1,542,1005,7,498,921,7,77.42857142857143,>30,SL,Home,Upto 2014
DK Morrison,NZ,Pace,1987-12-04,Brisbane,Australia,1987,2,118,216,4,1,634,1568,27,516,1352,23,23.48148148148148,<=30,AUS,Away,Upto 2014
DK Morrison,NZ,Pace,1987-12-11,Adelaide,Australia,1987,1,89,132,1,1,519,1199,13,430,1067,12,39.92307692307692,>30,AUS,Away,Upto 2014
DK Morrison,NZ,Pace,1987-12-26,Melbourne,Australia,1987,2,147,262,3,1,846,1960,31,699,1698,28,27.29032258064516,<=30,AUS,Away,Upto 2014
DK Morrison,NZ,Pace,1988-02-12,Christchurch,New Zealand,1988,2,133,254,6,1,693,1999,33,560,1745,27,21.0,<=30,NZ,Home,Upto 2014
DK Morrison,NZ,Pace,1988-02-25,Auckland,New Zealand,1988,1,95,192,2,1,724,1989,22,629,1797,20,32.90909090909091,>30,NZ,Home,Upto 2014
DK Morrison,NZ,Pace,1988-03-03,Wellington,New Zealand,1988,1,41,36,0,1,376,817,5,335,781,5,75.2,>30,NZ,Home,Upto 2014
DK Morrison,NZ,Pace,1988-11-24,Wankhede,India,1988,2,85,132,0,1,384,842,15,299,710,15,25.6,<=30,IND,Away,Upto 2014
DK Morrison,NZ,Pace,1989-02-10,Wellington,New Zealand,1989,1,96,216,1,1,750,1984,22,654,1768,21,34.09090909090909,>30,NZ,Home,Upto 2014
DK Morrison,NZ,Pace,1989-11-24,W.A.C.A,Australia,1989,1,145,235,4,1,939,2255,25,794,2020,21,37.56,>30,AUS,Away,Upto 2014
DK Morrison,NZ,Pace,1990-02-02,Christchurch,New Zealand,1990,2,169,210,6,1,683,1242,22,514,1032,16,31.045454545454547,>30,NZ,Home,Upto 2014
DK Morrison,NZ,Pace,1990-02-09,Napier,New Zealand,1990,1,98,228,5,1,406,996,10,308,768,5,40.6,>30,NZ,Home,Upto 2014
DK Morrison,NZ,Pace,1990-02-22,Auckland,New Zealand,1990,2,179,222,5,1,1075,1694,19,896,1472,14,56.578947368421055,>30,NZ,Home,Upto 2014
DK Morrison,NZ,Pace,1990-03-15,Wellington,New Zealand,1990,2,80,204,5,1,504,1412,21,424,1208,16,24.0,<=30,NZ,Home,Upto 2014
DK Morrison,NZ,Pace,1990-06-07,Nottingham,England,1990,1,96,132,1,1,425,1056,17,329,924,16,25.0,<=30,ENG,Away,Upto 2014
DK Morrison,NZ,Pace,1990-06-21,Lord's,England,1990,2,145,208,4,1,748,1364,15,603,1156,11,49.86666666666667,>30,ENG,Away,Upto 2014
DK Morrison,NZ,Pace,1990-07-05,Birmingham,England,1990,2,110,174,2,1,730,1539,27,620,1365,25,27.037037037037038,<=30,ENG,Away,Upto 2014
DK Morrison,NZ,Pace,1990-10-10,Karachi,Pakistan,1990,1,86,171,2,1,575,1344,23,489,1173,21,25.0,<=30,PAK,Away,Upto 2014
DK Morrison,NZ,Pace,1990-10-18,Lahore,Pakistan,1990,2,139,222,2,1,697,1583,26,558,1361,24,26.807692307692307,<=30,PAK,Away,Upto 2014
DK Morrison,NZ,Pace,1990-10-26,Faisalabad,Pakistan,1990,2,123,233,4,1,725,1761,39,602,1528,35,18.58974358974359,<=30,PAK,Away,Upto 2014
DK Morrison,NZ,Pace,1991-01-31,Wellington,New Zealand,1991,1,153,264,5,1,940,1788,23,787,1524,18,40.869565217391305,>30,NZ,Home,Upto 2014
DK Morrison,NZ,Pace,1991-02-22,Hamilton,New Zealand,1991,2,162,306,4,1,916,2000,25,754,1694,21,36.64,>30,NZ,Home,Upto 2014
DK Morrison,NZ,Pace,1991-03-01,Auckland,New Zealand,1991,2,161,246,4,1,890,1772,29,729,1526,25,30.689655172413794,>30,NZ,Home,Upto 2014
DK Morrison,NZ,Pace,1992-01-18,Christchurch,New Zealand,1992,1,133,198,2,1,763,1516,14,630,1318,12,54.5,>30,NZ,Home,Upto 2014
DK Morrison,NZ,Pace,1992-01-30,Auckland,New Zealand,1992,2,121,232,3,1,740,1678,33,619,1446,30,22.424242424242426,<=30,NZ,Home,Upto 2014
DK Morrison,NZ,Pace,1992-02-06,Wellington,New Zealand,1992,2,107,271,3,1,603,1369,15,496,1098,12,40.2,>30,NZ,Home,Upto 2014
DK Morrison,NZ,Pace,1993-01-02,Hamilton,New Zealand,1993,2,83,207,8,1,500,1200,33,417,993,25,15.151515151515152,<=30,NZ,Home,Upto 2014
DK Morrison,NZ,Pace,1993-02-25,Christchurch,New Zealand,1993,1,81,216,3,1,651,1526,21,570,1310,18,31.0,>30,NZ,Home,Upto 2014
DK Morrison,NZ,Pace,1993-03-04,Wellington,New Zealand,1993,1,89,160,7,1,647,1552,21,558,1392,14,30.80952380952381,>30,NZ,Home,Upto 2014
DK Morrison,NZ,Pace,1993-03-12,Auckland,New Zealand,1993,2,118,310,7,1,620,1465,22,502,1155,15,28.181818181818183,<=30,NZ,Home,Upto 2014
DK Morrison,NZ,Pace,1993-11-12,W.A.C.A,Australia,1993,2,193,360,2,1,942,1817,19,749,1457,17,49.578947368421055,>30,AUS,Away,Upto 2014
DK Morrison,NZ,Pace,1993-11-26,Hobart,Australia,1993,1,125,198,1,1,577,1014,7,452,816,6,82.42857142857143,>30,AUS,Away,Upto 2014
DK Morrison,NZ,Pace,1993-12-03,Brisbane,Australia,1993,1,104,198,0,1,683,1440,13,579,1242,13,52.53846153846154,>30,AUS,Away,Upto 2014
DK Morrison,NZ,Pace,1994-02-17,Wellington,New Zealand,1994,1,139,186,2,1,832,1382,22,693,1196,20,37.81818181818182,>30,NZ,Home,Upto 2014
DK Morrison,NZ,Pace,1994-02-24,Christchurch,New Zealand,1994,2,171,273,8,1,835,1575,27,664,1302,19,30.925925925925927,>30,NZ,Home,Upto 2014
DK Morrison,NZ,Pace,1994-03-19,Hamilton,New Zealand,1994,2,67,228,4,1,466,1167,15,399,939,11,31.066666666666666,>30,NZ,Home,Upto 2014
DK Morrison,NZ,Pace,1994-12-26,Durban,South Africa,1994,2,126,240,4,1,610,1681,28,484,1441,24,21.785714285714285,<=30,SA,Away,Upto 2014
DK Morrison,NZ,Pace,1995-01-02,Cape Town,South Africa,1995,2,105,228,1,1,639,1598,22,534,1370,21,29.045454545454547,<=30,SA,Away,Upto 2014
DK Morrison,NZ,Pace,1995-02-03,Christchurch,New Zealand,1995,1,69,158,6,1,515,1143,17,446,985,11,30.294117647058822,>30,NZ,Home,Upto 2014
DK Morrison,NZ,Pace,1995-02-10,Wellington,New Zealand,1995,1,82,174,2,1,598,1142,20,516,968,18,29.9,<=30,NZ,Home,Upto 2014
DK Morrison,NZ,Pace,1995-03-04,Auckland,New Zealand,1995,2,131,294,3,1,789,1800,31,658,1506,28,25.451612903225808,<=30,NZ,Home,Upto 2014
DK Morrison,NZ,Pace,1995-03-11,Napier,New Zealand,1995,2,101,267,7,1,717,1794,34,616,1527,27,21.08823529411765,<=30,NZ,Home,Upto 2014
DK Morrison,NZ,Pace,1995-10-18,Bengaluru,India,1995,2,95,150,3,1,331,688,17,236,538,14,19.470588235294116,<=30,IND,Away,Upto 2014
DK Morrison,NZ,Pace,1995-10-25,Chennai,India,1995,1,34,84,0,1,74,270,2,40,186,2,37.0,>30,IND,Away,Upto 2014
DK Morrison,NZ,Pace,1995-11-08,Cuttack,India,1995,1,52,78,0,1,240,497,7,188,419,7,34.285714285714285,>30,IND,Away,Upto 2014
DK Morrison,NZ,Pace,1995-12-08,Christchurch,New Zealand,1995,2,156,246,4,1,844,1657,28,688,1411,24,30.142857142857142,>30,NZ,Home,Upto 2014
DK Morrison,NZ,Pace,1996-04-19,Bridgetown,West Indies,1996,2,128,189,2,1,918,1755,25,790,1566,23,36.72,>30,WI,Away,Upto 2014
DK Morrison,NZ,Pace,1996-04-27,St John's,West Indies,1996,2,185,276,5,1,915,1920,26,730,1644,21,35.19230769230769,>30,WI,Away,Upto 2014
DK Morrison,NZ,Pace,1997-01-24,Auckland,New Zealand,1997,1,104,148,3,1,815,1797,20,711,1649,17,40.75,>30,NZ,Home,Upto 2014
DL Freeman,NZ,Spin,1933-03-24,Christchurch,New Zealand,1933,1,78,120,0,1,316,759,7,238,639,7,45.142857142857146,>30,NZ,Home,Upto 2014
DL Freeman,NZ,Spin,1933-03-31,Auckland,New Zealand,1933,1,91,120,1,1,345,534,4,254,414,3,86.25,>30,NZ,Home,Upto 2014
DL Haynes,WI,Spin,1980-07-10,Manchester,England,1980,1,2,6,0,1,55,171,3,53,165,3,18.333333333333332,<=30,ENG,Away,Upto 2014
DL Haynes,WI,Spin,1980-11-24,Lahore,Pakistan,1980,1,2,6,1,1,274,622,12,272,616,11,22.833333333333332,<=30,PAK,Away,Upto 2014
DL Haynes,WI,Spin,1981-04-10,Kingston,West Indies,1981,1,4,6,0,1,271,768,4,267,762,4,67.75,>30,WI,Home,Upto 2014
DL Houghton,ZIM,Spin,1992-11-01,Bulawayo,Zimbabwe,1992,1,0,5,0,1,469,976,10,469,971,10,46.9,>30,ZIM,Home,Upto 2014
DL Maddy,ENG,Pace,1999-12-26,Durban,South Africa,1999,1,40,84,0,1,784,1865,22,744,1781,22,35.63636363636363,>30,SA,Away,Upto 2014
DL Piedt,SA,Spin,2014-08-09,Harare,Zimbabwe,2014,2,152,294,8,1,495,865,15,343,571,7,33.0,>30,ZIM,Away,After 1965
DL Piedt,SA,Spin,2015-12-03,Delhi,India,2015,2,170,336,4,1,551,1517,20,381,1181,16,27.55,<=30,IND,Away,After 1965
DL Piedt,SA,Spin,2015-12-26,Durban,South Africa,2015,2,216,312,6,1,402,738,13,186,426,7,30.923076923076923,>30,SA,Home,After 1965
DL Piedt,SA,Spin,2016-01-02,Cape Town,South Africa,2016,2,150,258,3,1,386,750,3,236,492,0,128.66666666666666,>30,SA,Home,After 1965
DL Piedt,SA,Spin,2016-01-22,Centurion,South Africa,2016,2,89,186,1,1,309,534,4,220,348,3,77.25,>30,SA,Home,After 1965
DL Piedt,SA,Spin,2016-08-27,Centurion,South Africa,2016,2,88,114,2,1,150,198,3,62,84,1,50.0,>30,SA,Home,After 1965
DL Piedt,SA,Spin,2019-10-02,Visakhapatnam,India,2019,2,209,216,1,1,1062,1652,22,853,1436,21,48.27272727272727,>30,IND,Away,After 1965
DL Piedt,SA,Spin,2019-10-19,Ranchi,India,2019,1,101,108,1,1,405,692,13,304,584,12,31.153846153846153,>30,IND,Away,After 1965
DL Piedt,SA,Spin,2024-02-13,Hamilton,New Zealand,2024,2,182,387,8,1,415,855,14,233,468,6,29.642857142857142,<=30,NZ,Away,After 1965
DL Piedt,SA,Spin,2024-08-15,Providence,West Indies,2024,1,50,72,2,1,233,450,12,183,378,10,19.416666666666668,<=30,WI,Away,After 1965
DL Piedt,SA,Spin,2024-10-21,Mirpur,Bangladesh,2024,2,114,144,1,1,586,1001,17,472,857,16,34.470588235294116,>30,BAN,Away,After 1965
DL Underwood,ENG,Spin,1966-06-30,Nottingham,England,1966,2,91,270,0,1,501,1422,8,410,1152,8,62.625,>30,ENG,Home,Upto 2014
DL Underwood,ENG,Spin,1966-08-04,Leeds,England,1966,1,81,144,1,1,445,946,16,364,802,15,27.8125,<=30,ENG,Home,Upto 2014
DL Underwood,ENG,Spin,1967-08-10,Nottingham,England,1967,2,69,186,6,1,240,772,12,171,586,6,20.0,<=30,ENG,Home,Upto 2014
DL Underwood,ENG,Spin,1967-08-24,The Oval,England,1967,2,60,210,2,1,475,1075,13,415,865,11,36.53846153846154,>30,ENG,Home,Upto 2014
DL Underwood,ENG,Spin,1968-06-20,Lord's,England,1968,1,8,108,2,1,103,330,4,95,222,2,25.75,<=30,ENG,Home,Upto 2014
DL Underwood,ENG,Spin,1968-07-11,Birmingham,England,1968,2,62,198,3,1,212,680,8,150,482,5,26.5,<=30,ENG,Home,Upto 2014
DL Underwood,ENG,Spin,1968-07-25,Leeds,England,1968,2,93,437,6,1,396,1367,16,303,930,10,24.75,<=30,ENG,Home,Upto 2014
DL Underwood,ENG,Spin,1968-08-22,The Oval,England,1968,2,139,516,9,1,604,1754,22,465,1238,13,27.454545454545453,<=30,ENG,Home,Upto 2014
DL Underwood,ENG,Spin,1969-02-21,Lahore,Pakistan,1969,2,65,210,2,1,546,1362,17,481,1152,15,32.11764705882353,>30,PAK,Away,Upto 2014
DL Underwood,ENG,Spin,1969-02-28,Dhaka,Bangladesh,1969,2,139,426,6,1,397,1246,15,258,820,9,26.466666666666665,<=30,BAN,Away,Upto 2014
DL Underwood,ENG,Spin,1969-06-12,Manchester,England,1969,2,46,186,2,1,322,1014,6,276,828,4,53.666666666666664,>30,ENG,Home,Upto 2014
DL Underwood,ENG,Spin,1969-07-10,Leeds,England,1969,1,55,132,4,1,278,822,14,223,690,10,19.857142857142858,<=30,ENG,Home,Upto 2014
DL Underwood,ENG,Spin,1969-07-24,Lord's,England,1969,2,70,363,11,1,319,1131,22,249,768,11,14.5,<=30,ENG,Home,Upto 2014
DL Underwood,ENG,Spin,1969-08-07,Nottingham,England,1969,2,49,150,1,1,236,642,5,187,492,4,47.2,>30,ENG,Home,Upto 2014
DL Underwood,ENG,Spin,1969-08-21,The Oval,England,1969,2,101,387,12,1,310,1074,17,209,687,5,18.235294117647058,<=30,ENG,Home,Upto 2014
DL Underwood,ENG,Spin,1970-11-27,Brisbane,Australia,1970,2,124,384,4,1,461,1342,10,337,958,6,46.1,>30,AUS,Away,Upto 2014
DL Underwood,ENG,Spin,1971-01-09,Sydney,Australia,1971,2,83,240,4,1,467,1239,15,384,999,11,31.133333333333333,>30,AUS,Away,Upto 2014
DL Underwood,ENG,Spin,1971-01-21,Melbourne,Australia,1971,2,116,248,2,1,448,1245,9,332,997,7,49.77777777777778,>30,AUS,Away,Upto 2014
DL Underwood,ENG,Spin,1971-01-29,Adelaide,Australia,1971,2,130,448,2,1,449,1176,4,319,728,2,112.25,>30,AUS,Away,Upto 2014
DL Underwood,ENG,Spin,1971-02-12,Sydney,Australia,1971,2,67,238,4,1,385,1254,19,318,1016,15,20.263157894736842,<=30,AUS,Away,Upto 2014
DL Underwood,ENG,Spin,1971-02-25,Christchurch,New Zealand,1971,2,97,353,12,1,395,1134,21,298,781,9,18.80952380952381,<=30,NZ,Away,Upto 2014
DL Underwood,ENG,Spin,1971-03-05,Auckland,New Zealand,1971,2,108,320,5,1,315,824,7,207,504,2,45.0,>30,NZ,Away,Upto 2014
DL Underwood,ENG,Spin,1971-06-03,Birmingham,England,1971,1,102,246,0,1,451,1037,8,349,791,8,56.375,>30,ENG,Home,Upto 2014
DL Underwood,ENG,Spin,1971-08-19,The Oval,England,1971,2,121,378,4,1,621,1646,28,500,1268,24,22.178571428571427,<=30,ENG,Home,Upto 2014
DL Underwood,ENG,Spin,1972-07-27,Leeds,England,1972,2,82,312,10,1,321,1171,22,239,859,12,14.590909090909092,<=30,ENG,Home,Upto 2014
DL Underwood,ENG,Spin,1972-08-10,The Oval,England,1972,2,184,438,6,1,544,1256,15,360,818,9,36.266666666666666,>30,ENG,Home,Upto 2014
DL Underwood,ENG,Spin,1972-12-20,Delhi,India,1972,2,72,234,4,1,561,1750,23,489,1516,19,24.391304347826086,<=30,IND,Away,Upto 2014
DL Underwood,ENG,Spin,1972-12-30,Eden Gardens,India,1972,2,79,208,3,1,461,1469,28,382,1261,25,16.464285714285715,<=30,IND,Away,Upto 2014
DL Underwood,ENG,Spin,1973-01-25,Kanpur,India,1973,2,136,462,5,1,638,1919,18,502,1457,13,35.44444444444444,>30,IND,Away,Upto 2014
DL Underwood,ENG,Spin,1973-02-06,Brabourne,India,1973,2,170,384,3,1,967,2173,20,797,1789,17,48.35,>30,IND,Away,Upto 2014
DL Underwood,ENG,Spin,1973-03-02,Lahore,Pakistan,1973,2,96,288,3,1,766,1787,23,670,1499,20,33.30434782608695,>30,PAK,Away,Upto 2014
DL Underwood,ENG,Spin,1973-03-16,Hyderabad (Sind),Pakistan,1973,1,119,288,0,1,993,2402,21,874,2114,21,47.285714285714285,>30,PAK,Away,Upto 2014
DL Underwood,ENG,Spin,1973-07-05,Leeds,England,1973,2,41,108,0,1,170,420,1,129,312,1,170.0,>30,ENG,Home,Upto 2014
DL Underwood,ENG,Spin,1973-07-26,The Oval,England,1973,2,119,255,3,1,563,1459,15,444,1204,12,37.53333333333333,>30,ENG,Home,Upto 2014
DL Underwood,ENG,Spin,1973-08-09,Birmingham,England,1973,2,106,339,5,1,511,1445,13,405,1106,8,39.30769230769231,>30,ENG,Home,Upto 2014
DL Underwood,ENG,Spin,1973-08-23,Lord's,England,1973,1,105,204,0,1,503,859,9,398,655,9,55.888888888888886,>30,ENG,Home,Upto 2014
DL Underwood,ENG,Spin,1974-02-02,Port of Spain,West Indies,1974,2,104,210,3,1,671,1657,22,567,1447,19,30.5,>30,WI,Away,Upto 2014
DL Underwood,ENG,Spin,1974-02-16,Kingston,West Indies,1974,1,98,216,0,1,880,2436,16,782,2220,16,55.0,>30,WI,Away,Upto 2014
DL Underwood,ENG,Spin,1974-03-22,Georgetown,West Indies,1974,1,36,107,1,1,367,917,8,331,810,7,45.875,>30,WI,Away,Upto 2014
DL Underwood,ENG,Spin,1974-03-30,Port of Spain,West Indies,1974,2,76,294,1,1,805,2406,29,729,2112,28,27.75862068965517,<=30,WI,Away,Upto 2014
DL Underwood,ENG,Spin,1974-06-06,Manchester,England,1974,2,95,204,2,1,468,1159,11,373,955,9,42.54545454545455,>30,ENG,Home,Upto 2014
DL Underwood,ENG,Spin,1974-06-20,Lord's,England,1974,1,18,90,1,1,526,1013,10,508,923,9,52.6,>30,ENG,Home,Upto 2014
DL Underwood,ENG,Spin,1974-07-04,Birmingham,England,1974,2,33,108,1,1,474,954,5,441,846,4,94.8,>30,ENG,Home,Upto 2014
DL Underwood,ENG,Spin,1974-07-25,Leeds,England,1974,2,26,78,1,1,110,348,4,84,270,3,27.5,<=30,ENG,Home,Upto 2014
DL Underwood,ENG,Spin,1974-08-08,Lord's,England,1974,2,71,293,13,1,263,688,20,192,395,7,13.15,<=30,ENG,Home,Upto 2014
DL Underwood,ENG,Spin,1974-08-22,The Oval,England,1974,2,121,312,3,1,476,1138,12,355,826,9,39.666666666666664,>30,ENG,Home,Upto 2014
DL Underwood,ENG,Spin,1974-11-29,Brisbane,Australia,1974,2,117,368,4,1,316,776,7,199,408,3,45.142857142857146,>30,AUS,Away,Upto 2014
DL Underwood,ENG,Spin,1974-12-26,Melbourne,Australia,1974,2,105,328,0,1,428,1384,16,323,1056,16,26.75,<=30,AUS,Away,Upto 2014
DL Underwood,ENG,Spin,1975-01-04,Sydney,Australia,1975,2,119,200,2,1,427,863,11,308,663,9,38.81818181818182,>30,AUS,Away,Upto 2014
DL Underwood,ENG,Spin,1975-01-25,Adelaide,Australia,1975,2,215,440,11,1,485,1136,17,270,696,6,28.529411764705884,<=30,AUS,Away,Upto 2014
DL Underwood,ENG,Spin,1975-02-08,Melbourne,Australia,1975,1,39,144,0,1,308,798,5,269,654,5,61.6,>30,AUS,Away,Upto 2014
DL Underwood,ENG,Spin,1975-02-20,Auckland,New Zealand,1975,2,85,328,5,1,416,1136,17,331,808,12,24.470588235294116,<=30,NZ,Away,Upto 2014
DL Underwood,ENG,Spin,1975-02-28,Christchurch,New Zealand,1975,1,35,109,2,1,134,381,5,99,272,3,26.8,<=30,NZ,Away,Upto 2014
DL Underwood,ENG,Spin,1975-07-10,Birmingham,England,1975,1,10,42,1,1,95,230,3,85,188,2,31.666666666666668,>30,ENG,Home,Upto 2014
DL Underwood,ENG,Spin,1975-07-31,Lord's,England,1975,2,93,264,1,1,451,980,12,358,716,11,37.583333333333336,>30,ENG,Home,Upto 2014
DL Underwood,ENG,Spin,1975-08-14,Leeds,England,1975,2,62,204,2,1,242,624,11,180,420,9,22.0,<=30,ENG,Home,Upto 2014
DL Underwood,ENG,Spin,1975-08-28,The Oval,England,1975,2,101,276,2,1,533,1243,6,432,967,4,88.83333333333333,>30,ENG,Home,Upto 2014
DL Underwood,ENG,Spin,1976-06-03,Nottingham,England,1976,2,91,204,4,1,293,652,6,202,448,2,48.833333333333336,>30,ENG,Home,Upto 2014
DL Underwood,ENG,Spin,1976-06-17,Lord's,England,1976,2,112,259,7,1,283,691,11,171,432,4,25.727272727272727,<=30,ENG,Home,Upto 2014
DL Underwood,ENG,Spin,1976-07-08,Manchester,England,1976,2,145,354,3,1,286,618,6,141,264,3,47.666666666666664,>30,ENG,Home,Upto 2014
DL Underwood,ENG,Spin,1976-07-22,Leeds,England,1976,1,80,108,0,1,146,192,0,66,84,0,inf,>30,ENG,Home,Upto 2014
DL Underwood,ENG,Spin,1976-08-12,The Oval,England,1976,2,203,419,3,1,635,1217,8,432,798,5,79.375,>30,ENG,Home,Upto 2014
DL Underwood,ENG,Spin,1976-12-17,Delhi,India,1976,2,97,318,5,1,485,1319,16,388,1001,11,30.3125,>30,IND,Away,Upto 2014
DL Underwood,ENG,Spin,1977-01-01,Eden Gardens,India,1977,2,74,275,4,1,396,1315,15,322,1040,11,26.4,<=30,IND,Away,Upto 2014
DL Underwood,ENG,Spin,1977-01-14,Chennai,India,1977,2,44,186,6,1,366,1090,21,322,904,15,17.428571428571427,<=30,IND,Away,Upto 2014
DL Underwood,ENG,Spin,1977-01-28,Bengaluru,India,1977,2,121,312,5,1,552,1373,26,431,1061,21,21.23076923076923,<=30,IND,Away,Upto 2014
DL Underwood,ENG,Spin,1977-02-11,Wankhede,India,1977,2,173,426,9,1,658,1830,25,485,1404,16,26.32,<=30,IND,Away,Upto 2014
DL Underwood,ENG,Spin,1977-03-12,Melbourne,Australia,1977,2,54,190,4,1,232,574,9,178,384,5,25.77777777777778,<=30,AUS,Away,Upto 2014
DL Underwood,ENG,Spin,1977-06-16,Lord's,England,1977,2,58,210,2,1,116,360,3,58,150,1,38.666666666666664,>30,ENG,Home,Upto 2014
DL Underwood,ENG,Spin,1977-07-07,Manchester,England,1977,2,119,319,7,1,431,1095,17,312,776,10,25.352941176470587,<=30,ENG,Home,Upto 2014
DL Underwood,ENG,Spin,1977-07-28,Nottingham,England,1977,2,67,228,3,1,239,584,5,172,356,2,47.8,>30,ENG,Home,Upto 2014
DL Underwood,ENG,Spin,1977-08-11,Leeds,England,1977,1,16,48,0,1,146,324,4,130,276,4,36.5,>30,ENG,Home,Upto 2014
DL Underwood,ENG,Spin,1977-08-25,The Oval,England,1977,1,102,210,1,1,125,294,2,23,84,1,62.5,>30,ENG,Home,Upto 2014
DL Underwood,ENG,Spin,1979-12-14,W.A.C.A,Australia,1979,2,115,324,4,1,247,666,5,132,342,1,49.4,>30,AUS,Away,Upto 2014
DL Underwood,ENG,Spin,1980-01-04,Sydney,Australia,1980,2,110,236,5,1,132,272,5,22,36,0,26.4,<=30,AUS,Away,Upto 2014
DL Underwood,ENG,Spin,1980-02-01,Melbourne,Australia,1980,2,180,402,4,1,381,798,5,201,396,1,76.2,>30,AUS,Away,Upto 2014
DL Underwood,ENG,Spin,1980-02-15,Wankhede,India,1980,2,28,42,0,1,158,297,1,130,255,1,158.0,>30,IND,Away,Upto 2014
DL Underwood,ENG,Spin,1980-06-19,Lord's,England,1980,1,108,176,1,1,206,362,3,98,186,2,68.66666666666667,>30,ENG,Home,Upto 2014
DL Underwood,ENG,Spin,1981-11-27,Wankhede,India,1981,2,26,90,1,1,162,553,10,136,463,9,16.2,<=30,IND,Away,Upto 2014
DL Underwood,ENG,Spin,1981-12-09,Bengaluru,India,1981,1,88,258,3,1,405,1140,11,317,882,8,36.81818181818182,>30,IND,Away,Upto 2014
DL Underwood,ENG,Spin,1981-12-23,Delhi,India,1981,1,97,288,2,1,331,798,4,234,510,2,82.75,>30,IND,Away,Upto 2014
DL Underwood,ENG,Spin,1982-01-01,Eden Gardens,India,1982,2,83,360,3,1,396,1328,13,313,968,10,30.46153846153846,>30,IND,Away,Upto 2014
DL Underwood,ENG,Spin,1982-01-13,Chennai,India,1982,2,89,222,1,1,285,972,8,196,750,7,35.625,>30,IND,Away,Upto 2014
DL Underwood,ENG,Spin,1982-01-30,Kanpur,India,1982,1,55,150,0,1,274,704,7,219,554,7,39.142857142857146,>30,IND,Away,Upto 2014
DL Underwood,ENG,Spin,1982-02-17,Colombo (PSS),Sri Lanka,1982,2,95,335,8,1,442,1264,21,347,929,13,21.047619047619047,<=30,SL,Away,Upto 2014
DL Vettori,ICC,Spin,2005-10-14,Sydney,Australia,2005,2,111,162,1,1,421,817,21,310,655,20,20.047619047619047,<=30,AUS,Away,Upto 2014
DL Vettori,NZ,Spin,1997-02-06,Wellington,New Zealand,1997,1,98,207,2,1,215,621,7,117,414,5,30.714285714285715,>30,NZ,Home,Upto 2014
DL Vettori,NZ,Spin,1997-02-14,Christchurch,New Zealand,1997,2,110,414,5,1,333,1099,15,223,685,10,22.2,<=30,NZ,Home,Upto 2014
DL Vettori,NZ,Spin,1997-03-07,Dunedin,New Zealand,1997,2,91,174,2,1,364,612,5,273,438,3,72.8,>30,NZ,Home,Upto 2014
DL Vettori,NZ,Spin,1997-03-14,Hamilton,New Zealand,1997,2,130,320,9,1,413,1010,18,283,690,9,22.944444444444443,<=30,NZ,Home,Upto 2014
DL Vettori,NZ,Spin,1997-09-18,Harare,Zimbabwe,1997,2,54,102,0,1,277,714,8,223,612,8,34.625,>30,ZIM,Away,Upto 2014
DL Vettori,NZ,Spin,1997-09-25,Bulawayo,Zimbabwe,1997,2,234,456,6,1,722,1402,21,488,946,15,34.38095238095238,>30,ZIM,Away,Upto 2014
DL Vettori,NZ,Spin,1997-11-07,Brisbane,Australia,1997,2,133,342,3,1,311,786,10,178,444,7,31.1,>30,AUS,Away,Upto 2014
DL Vettori,NZ,Spin,1997-11-20,W.A.C.A,Australia,1997,1,84,174,1,1,231,466,7,147,292,6,33.0,>30,AUS,Away,Upto 2014
DL Vettori,NZ,Spin,1997-11-27,Hobart,Australia,1997,2,93,156,2,1,298,570,8,205,414,6,37.25,>30,AUS,Away,Upto 2014
DL Vettori,NZ,Spin,1998-02-19,Wellington,New Zealand,1998,2,112,366,4,1,396,984,10,284,618,6,39.6,>30,NZ,Home,Upto 2014
DL Vettori,NZ,Spin,1998-02-26,Auckland,New Zealand,1998,2,75,132,1,1,314,511,5,239,379,4,62.8,>30,NZ,Home,Upto 2014
DL Vettori,NZ,Spin,1998-05-27,Colombo (RPS),Sri Lanka,1998,2,157,450,6,1,939,2077,27,782,1627,21,34.77777777777778,>30,SL,Away,Upto 2014
DL Vettori,NZ,Spin,1998-06-03,Galle,Sri Lanka,1998,1,88,156,4,1,443,1219,25,355,1063,21,17.72,<=30,SL,Away,Upto 2014
DL Vettori,NZ,Spin,1998-06-10,Colombo (SSC),Sri Lanka,1998,2,116,348,7,1,526,1430,27,410,1082,20,19.48148148148148,<=30,SL,Away,Upto 2014
DL Vettori,NZ,Spin,1998-12-26,Wellington,New Zealand,1998,2,112,162,2,1,442,922,12,330,760,10,36.833333333333336,>30,NZ,Home,Upto 2014
DL Vettori,NZ,Spin,1999-01-02,Hamilton,New Zealand,1999,1,71,96,0,1,438,743,6,367,647,6,73.0,>30,NZ,Home,Upto 2014
DL Vettori,NZ,Spin,1999-02-27,Auckland,New Zealand,1999,1,120,252,1,1,327,720,5,207,468,4,65.4,>30,NZ,Home,Upto 2014
DL Vettori,NZ,Spin,1999-03-11,Christchurch,New Zealand,1999,1,73,144,1,1,135,274,3,62,130,2,45.0,>30,NZ,Home,Upto 2014
DL Vettori,NZ,Spin,1999-03-18,Wellington,New Zealand,1999,2,160,348,5,1,235,525,9,75,177,4,26.11111111111111,<=30,NZ,Home,Upto 2014
DL Vettori,NZ,Spin,1999-07-01,Birmingham,England,1999,1,22,36,0,1,51,151,5,29,115,5,10.2,<=30,ENG,Away,Upto 2014
DL Vettori,NZ,Spin,1999-07-22,Lord's,England,1999,1,62,186,2,1,143,403,4,81,217,2,35.75,>30,ENG,Away,Upto 2014
DL Vettori,NZ,Spin,1999-08-05,Manchester,England,1999,2,83,306,3,1,316,834,9,233,528,6,35.111111111111114,>30,ENG,Away,Upto 2014
DL Vettori,NZ,Spin,1999-08-19,The Oval,England,1999,2,82,294,5,1,179,486,10,97,192,5,17.9,<=30,ENG,Away,Upto 2014
DL Vettori,NZ,Spin,1999-10-10,Mohali,India,1999,1,171,426,2,1,393,1249,10,222,823,8,39.3,>30,IND,Away,Upto 2014
DL Vettori,NZ,Spin,1999-10-22,Kanpur,India,1999,2,149,369,6,1,568,1375,24,419,1006,18,23.666666666666668,<=30,IND,Away,Upto 2014
DL Vettori,NZ,Spin,1999-10-29,Ahmedabad,India,1999,2,223,354,4,1,599,1348,12,376,994,8,49.916666666666664,>30,IND,Away,Upto 2014
DL Vettori,NZ,Spin,1999-12-16,Hamilton,New Zealand,1999,2,103,337,5,1,276,775,8,173,438,3,34.5,>30,NZ,Home,Upto 2014
DL Vettori,NZ,Spin,1999-12-26,Wellington,New Zealand,1999,2,155,378,3,1,335,762,4,180,384,1,83.75,>30,NZ,Home,Upto 2014
DL Vettori,NZ,Spin,2000-03-11,Auckland,New Zealand,2000,2,149,360,12,1,549,1142,28,400,782,16,19.607142857142858,<=30,NZ,Home,Upto 2014
DL Vettori,NZ,Spin,2000-03-24,Wellington,New Zealand,2000,2,69,138,2,1,361,635,13,292,497,11,27.76923076923077,<=30,NZ,Home,Upto 2014
DL Vettori,NZ,Spin,2000-09-12,Bulawayo,Zimbabwe,2000,1,79,312,1,1,456,1365,20,377,1053,19,22.8,<=30,ZIM,Away,Upto 2014
DL Vettori,NZ,Spin,2001-11-08,Brisbane,Australia,2001,2,73,94,0,1,231,316,3,158,222,3,77.0,>30,AUS,Away,Upto 2014
DL Vettori,NZ,Spin,2001-11-22,Hobart,Australia,2001,1,138,216,5,1,238,404,7,100,188,2,34.0,>30,AUS,Away,Upto 2014
DL Vettori,NZ,Spin,2001-11-30,W.A.C.A,Australia,2001,2,229,478,8,1,465,898,10,236,420,2,46.5,>30,AUS,Away,Upto 2014
DL Vettori,NZ,Spin,2001-12-18,Hamilton,New Zealand,2001,2,42,144,2,1,67,162,2,25,18,0,33.5,>30,NZ,Home,Upto 2014
DL Vettori,NZ,Spin,2001-12-26,Wellington,New Zealand,2001,2,95,252,4,1,143,312,4,48,60,0,35.75,>30,NZ,Home,Upto 2014
DL Vettori,NZ,Spin,2002-03-13,Christchurch,New Zealand,2002,2,123,186,0,1,196,354,1,73,168,1,196.0,>30,NZ,Home,Upto 2014
DL Vettori,NZ,Spin,2002-03-21,Wellington,New Zealand,2002,2,152,294,5,1,323,744,10,171,450,5,32.3,>30,NZ,Home,Upto 2014
DL Vettori,NZ,Spin,2002-03-30,Auckland,New Zealand,2002,1,5,12,0,1,12,24,0,7,12,0,inf,>30,NZ,Home,Upto 2014
DL Vettori,NZ,Spin,2002-05-01,Lahore,Pakistan,2002,1,178,240,1,1,466,722,13,288,482,12,35.84615384615385,>30,PAK,Away,Upto 2014
DL Vettori,NZ,Spin,2002-06-21,Bridgetown,West Indies,2002,2,80,187,7,1,133,433,9,53,246,2,14.777777777777779,<=30,WI,Away,Upto 2014
DL Vettori,NZ,Spin,2002-06-28,St George's,West Indies,2002,1,134,246,1,1,457,1176,9,323,930,8,50.77777777777778,>30,WI,Away,Upto 2014
DL Vettori,NZ,Spin,2003-04-25,Colombo (PSS),Sri Lanka,2003,1,94,198,3,1,714,1571,15,620,1373,12,47.6,>30,SL,Away,Upto 2014
DL Vettori,NZ,Spin,2003-05-03,Kandy,Sri Lanka,2003,1,11,36,0,1,468,1155,15,457,1119,15,31.2,>30,SL,Away,Upto 2014
DL Vettori,NZ,Spin,2003-10-08,Ahmedabad,India,2003,2,209,360,3,1,719,1566,18,510,1206,15,39.94444444444444,>30,IND,Away,Upto 2014
DL Vettori,NZ,Spin,2003-10-16,Mohali,India,2003,2,124,474,2,1,664,1623,9,540,1149,7,73.77777777777777,>30,IND,Away,Upto 2014
DL Vettori,NZ,Spin,2003-12-19,Hamilton,New Zealand,2003,1,117,216,1,1,235,432,3,118,216,2,78.33333333333333,>30,NZ,Home,Upto 2014
DL Vettori,NZ,Spin,2003-12-26,Wellington,New Zealand,2003,2,106,270,2,1,210,516,3,104,246,1,70.0,>30,NZ,Home,Upto 2014
DL Vettori,NZ,Spin,2004-03-10,Hamilton,New Zealand,2004,2,237,440,4,1,513,956,8,276,516,4,64.125,>30,NZ,Home,Upto 2014
DL Vettori,NZ,Spin,2004-03-18,Auckland,New Zealand,2004,2,88,174,0,1,247,374,2,159,200,2,123.5,>30,NZ,Home,Upto 2014
DL Vettori,NZ,Spin,2004-03-26,Wellington,New Zealand,2004,2,129,264,0,1,263,584,8,134,320,8,32.875,>30,NZ,Home,Upto 2014
DL Vettori,NZ,Spin,2004-05-20,Lord's,England,2004,2,122,276,2,1,241,540,5,119,264,3,48.2,>30,ENG,Away,Upto 2014
DL Vettori,NZ,Spin,2004-06-03,Leeds,England,2004,1,83,138,2,1,153,264,2,70,126,0,76.5,>30,ENG,Away,Upto 2014
DL Vettori,NZ,Spin,2004-10-19,Dhaka,Bangladesh,2004,2,54,306,8,1,383,1134,20,329,828,12,19.15,<=30,BAN,Away,Upto 2014
DL Vettori,NZ,Spin,2004-10-26,Chattogram,Bangladesh,2004,2,170,364,12,1,719,1390,23,549,1026,11,31.26086956521739,>30,BAN,Away,Upto 2014
DL Vettori,NZ,Spin,2004-11-18,Brisbane,Australia,2004,1,154,300,4,1,278,563,12,124,263,8,23.166666666666668,<=30,AUS,Away,Upto 2014
DL Vettori,NZ,Spin,2004-11-26,Adelaide,Australia,2004,2,187,440,6,1,578,1205,15,391,765,9,38.53333333333333,>30,AUS,Away,Upto 2014
DL Vettori,NZ,Spin,2005-03-10,Christchurch,New Zealand,2005,2,161,323,6,1,328,677,14,167,354,8,23.428571428571427,<=30,NZ,Home,Upto 2014
DL Vettori,NZ,Spin,2005-03-18,Wellington,New Zealand,2005,1,170,282,2,1,261,489,6,91,207,4,43.5,>30,NZ,Home,Upto 2014
DL Vettori,NZ,Spin,2005-03-26,Auckland,New Zealand,2005,2,66,138,0,1,283,621,8,217,483,8,35.375,>30,NZ,Home,Upto 2014
DL Vettori,NZ,Spin,2005-08-07,Harare,Zimbabwe,2005,2,29,99,6,1,156,237,7,127,138,1,22.285714285714285,<=30,ZIM,Away,Upto 2014
DL Vettori,NZ,Spin,2005-08-15,Bulawayo,Zimbabwe,2005,2,122,295,5,1,320,589,7,198,294,2,45.714285714285715,>30,ZIM,Away,Upto 2014
DL Vettori,NZ,Spin,2006-03-09,Auckland,New Zealand,2006,2,99,254,5,1,180,465,11,81,211,6,16.363636363636363,<=30,NZ,Home,Upto 2014
DL Vettori,NZ,Spin,2006-03-17,Wellington,New Zealand,2006,2,53,150,2,1,176,438,2,123,288,0,88.0,>30,NZ,Home,Upto 2014
DL Vettori,NZ,Spin,2006-03-25,Napier,New Zealand,2006,1,11,48,0,1,11,48,0,0,0,0,inf,>30,NZ,Home,Upto 2014
DL Vettori,NZ,Spin,2006-04-15,Centurion,South Africa,2006,2,86,199,2,1,126,259,2,40,60,0,63.0,>30,SA,Away,Upto 2014
DL Vettori,NZ,Spin,2006-04-27,Cape Town,South Africa,2006,1,147,378,2,1,434,954,6,287,576,4,72.33333333333333,>30,SA,Away,Upto 2014
DL Vettori,NZ,Spin,2006-05-05,Johannesburg,South Africa,2006,1,11,6,0,1,11,6,0,0,0,0,inf,>30,SA,Away,Upto 2014
DL Vettori,NZ,Spin,2006-12-07,Christchurch,New Zealand,2006,1,10,12,0,1,109,300,7,99,288,7,15.571428571428571,<=30,NZ,Home,Upto 2014
DL Vettori,NZ,Spin,2006-12-15,Wellington,New Zealand,2006,2,183,339,10,1,311,653,20,128,314,10,15.55,<=30,NZ,Home,Upto 2014
DL Vettori,NZ,Spin,2007-11-08,Johannesburg,South Africa,2007,2,142,330,2,1,163,386,3,21,56,1,54.333333333333336,>30,SA,Away,Upto 2014
DL Vettori,NZ,Spin,2007-11-16,Centurion,South Africa,2007,1,61,120,1,1,76,138,1,15,18,0,76.0,>30,SA,Away,Upto 2014
DL Vettori,NZ,Spin,2008-01-04,Dunedin,New Zealand,2008,2,78,180,5,1,288,481,9,210,301,4,32.0,>30,NZ,Home,Upto 2014
DL Vettori,NZ,Spin,2008-01-12,Wellington,New Zealand,2008,2,13,21,1,1,156,309,6,143,288,5,26.0,<=30,NZ,Home,Upto 2014
DL Vettori,NZ,Spin,2008-03-05,Hamilton,New Zealand,2008,2,104,420,3,1,412,1080,12,308,660,9,34.333333333333336,>30,NZ,Home,Upto 2014
DL Vettori,NZ,Spin,2008-03-13,Wellington,New Zealand,2008,2,70,138,0,1,128,279,1,58,141,1,128.0,>30,NZ,Home,Upto 2014
DL Vettori,NZ,Spin,2008-03-22,Napier,New Zealand,2008,2,209,384,4,1,490,971,14,281,587,10,35.0,>30,NZ,Home,Upto 2014
DL Vettori,NZ,Spin,2008-05-15,Lord's,England,2008,1,69,135,5,1,176,375,7,107,240,2,25.142857142857142,<=30,ENG,Away,Upto 2014
DL Vettori,NZ,Spin,2008-05-23,Manchester,England,2008,2,177,396,6,1,323,648,13,146,252,7,24.846153846153847,<=30,ENG,Away,Upto 2014
DL Vettori,NZ,Spin,2008-06-05,Nottingham,England,2008,1,77,173,1,1,98,239,1,21,66,0,98.0,>30,ENG,Away,Upto 2014
DL Vettori,NZ,Spin,2008-10-17,Chattogram,Bangladesh,2008,2,133,468,9,1,669,1820,29,536,1352,20,23.06896551724138,<=30,BAN,Away,Upto 2014
DL Vettori,NZ,Spin,2008-10-25,Mirpur,Bangladesh,2008,1,66,114,5,1,361,720,10,295,606,5,36.1,>30,BAN,Away,Upto 2014
DL Vettori,NZ,Spin,2008-11-20,Brisbane,Australia,2008,2,73,162,3,1,95,204,3,22,42,0,31.666666666666668,>30,AUS,Away,Upto 2014
DL Vettori,NZ,Spin,2008-11-28,Adelaide,Australia,2008,1,124,358,2,1,283,706,9,159,348,7,31.444444444444443,>30,AUS,Away,Upto 2014
DL Vettori,NZ,Spin,2008-12-11,Dunedin,New Zealand,2008,1,56,150,6,1,98,276,9,42,126,3,10.88888888888889,<=30,NZ,Home,Upto 2014
DL Vettori,NZ,Spin,2008-12-19,Napier,New Zealand,2008,2,162,444,4,1,472,1254,11,310,810,7,42.90909090909091,>30,NZ,Home,Upto 2014
DL Vettori,NZ,Spin,2009-03-18,Hamilton,New Zealand,2009,1,90,214,2,1,359,787,15,269,573,13,23.933333333333334,<=30,NZ,Home,Upto 2014
DL Vettori,NZ,Spin,2009-03-26,Napier,New Zealand,2009,2,121,342,3,1,685,1306,9,564,964,6,76.11111111111111,>30,NZ,Home,Upto 2014
DL Vettori,NZ,Spin,2009-04-03,Wellington,New Zealand,2009,2,155,264,2,1,383,840,12,228,576,10,31.916666666666668,>30,NZ,Home,Upto 2014
DL Vettori,NZ,Spin,2009-08-18,Galle,Sri Lanka,2009,2,159,340,5,1,652,1329,16,493,989,11,40.75,>30,SL,Away,Upto 2014
DL Vettori,NZ,Spin,2009-08-26,Colombo (SSC),Sri Lanka,2009,2,166,387,5,1,760,1587,27,594,1200,22,28.14814814814815,<=30,SL,Away,Upto 2014
DL Vettori,NZ,Spin,2009-11-24,Dunedin,New Zealand,2009,2,115,246,4,1,232,575,6,117,329,2,38.666666666666664,>30,NZ,Home,Upto 2014
DL Vettori,NZ,Spin,2009-12-03,Wellington,New Zealand,2009,2,121,282,4,1,206,510,10,85,228,6,20.6,<=30,NZ,Home,Upto 2014
DL Vettori,NZ,Spin,2009-12-11,Napier,New Zealand,2009,2,128,384,2,1,354,812,12,226,428,10,29.5,<=30,NZ,Home,Upto 2014
DL Vettori,NZ,Spin,2010-02-15,Hamilton,New Zealand,2010,2,168,315,5,1,711,1173,10,543,858,5,71.1,>30,NZ,Home,Upto 2014
DL Vettori,NZ,Spin,2010-03-19,Wellington,New Zealand,2010,2,143,240,1,1,326,678,4,183,438,3,81.5,>30,NZ,Home,Upto 2014
DL Vettori,NZ,Spin,2010-03-27,Hamilton,New Zealand,2010,2,176,405,6,1,478,999,10,302,594,4,47.8,>30,NZ,Home,Upto 2014
DL Vettori,NZ,Spin,2010-11-04,Ahmedabad,India,2010,2,199,557,6,1,781,1719,18,582,1162,12,43.388888888888886,>30,IND,Away,Upto 2014
DL Vettori,NZ,Spin,2010-11-12,Hyderabad,India,2010,1,135,298,5,1,691,1414,15,556,1116,10,46.06666666666667,>30,IND,Away,Upto 2014
DL Vettori,NZ,Spin,2010-11-20,Nagpur,India,2010,1,178,348,3,1,493,909,15,315,561,12,32.86666666666667,>30,IND,Away,Upto 2014
DL Vettori,NZ,Spin,2011-01-07,Hamilton,New Zealand,2011,1,48,174,1,1,193,540,7,145,366,6,27.571428571428573,<=30,NZ,Home,Upto 2014
DL Vettori,NZ,Spin,2011-01-15,Wellington,New Zealand,2011,2,157,486,5,1,445,1147,12,288,661,7,37.083333333333336,>30,NZ,Home,Upto 2014
DL Vettori,NZ,Spin,2011-11-01,Bulawayo,Zimbabwe,2011,2,141,487,8,1,535,1222,13,394,735,5,41.15384615384615,>30,ZIM,Away,Upto 2014
DL Vettori,NZ,Spin,2011-12-01,Brisbane,Australia,2011,1,88,222,2,1,207,471,10,119,249,8,20.7,<=30,AUS,Away,Upto 2014
DL Vettori,NZ,Spin,2012-01-26,Napier,New Zealand,2012,2,27,84,1,1,163,234,4,136,150,3,40.75,>30,NZ,Home,Upto 2014
DL Vettori,NZ,Spin,2012-03-07,Dunedin,New Zealand,2012,2,96,282,1,1,209,528,4,113,246,3,52.25,>30,NZ,Home,Upto 2014
DL Vettori,NZ,Spin,2012-03-15,Hamilton,New Zealand,2012,2,51,126,1,1,143,280,4,92,154,3,35.75,>30,NZ,Home,Upto 2014
DL Vettori,NZ,Spin,2012-03-23,Wellington,New Zealand,2012,2,138,294,1,1,247,510,1,109,216,0,247.0,>30,NZ,Home,Upto 2014
DL Vettori,NZ,Spin,2012-07-25,North Sound,West Indies,2012,2,127,315,1,1,474,1059,11,347,744,10,43.09090909090909,>30,WI,Away,Upto 2014
DL Vettori,NZ,Spin,2014-11-26,Sharjah,UAE,2014,2,49,144,2,1,856,1190,21,807,1046,19,40.76190476190476,>30,UAE,Away,After 1965
DM Bess,ENG,Spin,2018-05-24,Lord's,England,2018,2,88,124,0,1,185,274,2,97,150,2,92.5,>30,ENG,Home,After 1965
DM Bess,ENG,Spin,2018-06-01,Leeds,England,2018,1,33,66,3,1,83,168,4,50,102,1,20.75,<=30,ENG,Home,After 1965
DM Bess,ENG,Spin,2020-01-03,Cape Town,South Africa,2020,2,119,360,2,1,404,942,7,285,582,5,57.714285714285715,>30,SA,Away,After 1965
DM Bess,ENG,Spin,2020-01-16,Gqeberha,South Africa,2020,2,87,318,6,1,395,936,15,308,618,9,26.333333333333332,<=30,SA,Away,After 1965
DM Bess,ENG,Spin,2020-07-08,Southampton,England,2020,2,82,174,2,1,162,342,4,80,168,2,40.5,>30,ENG,Home,After 1965
DM Bess,ENG,Spin,2020-07-16,Manchester,England,2020,2,126,217,3,1,307,518,8,181,301,5,38.375,>30,ENG,Home,After 1965
DM Bess,ENG,Spin,2020-08-05,Manchester,England,2020,2,114,192,2,1,351,585,12,237,393,10,29.25,<=30,ENG,Home,After 1965
DM Bess,ENG,Spin,2020-08-21,Southampton,England,2020,2,122,234,1,1,389,624,7,267,390,6,55.57142857142857,>30,ENG,Home,After 1965
DM Bess,ENG,Spin,2021-01-14,Galle,Sri Lanka,2021,2,130,259,8,1,751,1413,23,621,1154,15,32.65217391304348,>30,SL,Away,After 1965
DM Bess,ENG,Spin,2021-01-22,Galle,Sri Lanka,2021,2,125,252,4,1,734,1377,23,609,1125,19,31.91304347826087,>30,SL,Away,After 1965
DM Bess,ENG,Spin,2021-02-05,Chennai,India,2021,2,126,204,5,1,867,1480,24,741,1276,19,36.125,>30,IND,Away,After 1965
DM Bess,ENG,Spin,2021-03-04,Ahmedabad,India,2021,1,71,102,0,1,456,994,20,385,892,20,22.8,<=30,IND,Away,After 1965
DM Bravo,WI,Pace,2014-06-08,Kingston,West Indies,2014,1,2,6,0,1,334,854,13,332,848,13,25.692307692307693,<=30,WI,Home,After 1965
DM Jones,AUS,Spin,1986-09-26,Delhi,India,1986,1,0,6,0,1,149,340,2,149,334,2,74.5,>30,IND,Away,Upto 2014
DM Jones,AUS,Spin,1987-12-11,Adelaide,Australia,1987,2,6,36,1,1,613,1530,11,607,1494,10,55.72727272727273,>30,AUS,Home,Upto 2014
DM Jones,AUS,Spin,1987-12-26,Melbourne,Australia,1987,1,23,48,0,1,311,684,6,288,636,6,51.833333333333336,>30,AUS,Home,Upto 2014
DM Jones,AUS,Spin,1989-11-24,W.A.C.A,Australia,1989,1,6,18,0,1,104,222,1,98,204,1,104.0,>30,AUS,Home,Upto 2014
DM Jones,AUS,Spin,1989-12-08,Brisbane,Australia,1989,1,1,6,0,1,218,426,2,217,420,2,109.0,>30,AUS,Home,Upto 2014
DM Jones,AUS,Spin,1989-12-16,Hobart,Australia,1989,1,5,24,0,1,264,618,8,259,594,8,33.0,>30,AUS,Home,Upto 2014
DM Jones,AUS,Spin,1990-03-15,Wellington,New Zealand,1990,1,14,36,0,1,227,624,10,213,588,10,22.7,<=30,NZ,Away,Upto 2014
DM Jones,AUS,Spin,1991-04-05,Port of Spain,West Indies,1991,1,4,6,0,1,152,384,2,148,378,2,76.0,>30,WI,Away,Upto 2014
DM Jones,AUS,Spin,1991-04-19,Bridgetown,West Indies,1991,1,5,18,0,1,121,318,6,116,300,6,20.166666666666668,<=30,WI,Away,Upto 2014
DM Washington,WI,Pace,2005-04-29,St John's,West Indies,2005,2,93,174,0,1,1036,1736,12,943,1562,12,86.33333333333333,>30,WI,Home,Upto 2014
DM de Silva,SL,Spin,2016-07-26,Pallekele,Sri Lanka,2016,1,12,66,1,1,503,1219,26,491,1153,25,19.346153846153847,<=30,SL,Home,After 1965
DM de Silva,SL,Spin,2016-08-04,Galle,Sri Lanka,2016,2,9,24,0,1,555,873,24,546,849,24,23.125,<=30,SL,Home,After 1965
DM de Silva,SL,Spin,2016-08-13,Colombo (SSC),Sri Lanka,2016,2,42,66,1,1,860,1808,28,818,1742,27,30.714285714285715,>30,SL,Home,After 1965
DM de Silva,SL,Spin,2016-10-29,Harare,Zimbabwe,2016,1,10,12,0,1,573,1161,19,563,1149,19,30.157894736842106,>30,ZIM,Away,After 1965
DM de Silva,SL,Spin,2016-11-06,Harare,Zimbabwe,2016,2,14,24,1,1,564,968,25,550,944,24,22.56,<=30,ZIM,Away,After 1965
DM de Silva,SL,Spin,2016-12-26,Gqeberha,South Africa,2016,2,103,108,2,1,359,638,9,256,530,7,39.888888888888886,>30,SA,Away,After 1965
DM de Silva,SL,Spin,2017-01-02,Cape Town,South Africa,2017,2,45,66,0,1,230,404,6,185,338,6,38.333333333333336,>30,SA,Away,After 1965
DM de Silva,SL,Spin,2017-01-12,Johannesburg,South Africa,2017,1,22,48,0,1,90,138,0,68,90,0,inf,>30,SA,Away,After 1965
DM de Silva,SL,Spin,2017-03-15,Colombo (PSS),Sri Lanka,2017,2,12,24,0,1,916,1838,26,904,1814,26,35.23076923076923,>30,SL,Home,After 1965
DM de Silva,SL,Spin,2017-08-03,Colombo (SSC),Sri Lanka,2017,1,59,72,0,1,953,1487,21,894,1415,21,45.38095238095238,>30,SL,Home,After 1965
DM de Silva,SL,Spin,2017-12-02,Delhi,India,2017,2,79,126,1,1,881,1566,17,802,1440,16,51.8235294117647,>30,IND,Away,After 1965
DM de Silva,SL,Spin,2018-01-31,Chattogram,Bangladesh,2018,2,53,102,1,1,1210,2061,19,1157,1959,18,63.68421052631579,>30,BAN,Away,After 1965
DM de Silva,SL,Spin,2018-06-14,Gros Islet,West Indies,2018,2,15,24,0,1,246,492,2,231,468,2,123.0,>30,WI,Away,After 1965
DM de Silva,SL,Spin,2018-07-20,Colombo (SSC),Sri Lanka,2018,1,5,12,0,1,722,1323,32,717,1311,32,22.5625,<=30,SL,Home,After 1965
DM de Silva,SL,Spin,2018-11-06,Galle,Sri Lanka,2018,2,59,91,0,1,876,1627,28,817,1536,28,31.285714285714285,>30,SL,Home,After 1965
DM de Silva,SL,Spin,2018-11-14,Pallekele,Sri Lanka,2018,2,11,36,0,1,1031,1760,38,1020,1724,38,27.13157894736842,<=30,SL,Home,After 1965
DM de Silva,SL,Spin,2018-11-23,Colombo (SSC),Sri Lanka,2018,2,40,84,0,1,913,1615,34,873,1531,34,26.852941176470587,<=30,SL,Home,After 1965
DM de Silva,SL,Spin,2018-12-15,Wellington,New Zealand,2018,1,54,90,2,1,274,534,4,220,444,2,68.5,>30,NZ,Away,After 1965
DM de Silva,SL,Spin,2019-01-24,Brisbane,Australia,2019,1,22,48,1,1,161,391,5,139,343,4,32.2,>30,AUS,Away,After 1965
DM de Silva,SL,Spin,2019-02-01,Canberra,Australia,2019,2,79,144,0,1,375,678,4,296,534,4,93.75,>30,AUS,Away,After 1965
DM de Silva,SL,Spin,2019-02-13,Durban,South Africa,2019,1,8,12,0,1,237,390,9,229,378,9,26.333333333333332,<=30,SA,Away,After 1965
DM de Silva,SL,Spin,2019-02-21,Gqeberha,South Africa,2019,2,51,96,5,1,131,181,6,80,85,1,21.833333333333332,<=30,SA,Away,After 1965
DM de Silva,SL,Spin,2019-08-14,Galle,Sri Lanka,2019,2,45,108,3,1,786,1622,23,741,1514,20,34.17391304347826,>30,SL,Home,After 1965
DM de Silva,SL,Spin,2019-08-22,Colombo (PSS),Sri Lanka,2019,1,10,30,0,1,428,846,11,418,816,11,38.90909090909091,>30,SL,Home,After 1965
DM de Silva,SL,Spin,2019-12-11,Rawalpindi,Pakistan,2019,1,48,66,0,1,170,252,0,122,186,0,inf,>30,PAK,Away,After 1965
DM de Silva,SL,Spin,2019-12-19,Karachi,Pakistan,2019,1,19,42,0,1,548,873,9,529,831,9,60.888888888888886,>30,PAK,Away,After 1965
DM de Silva,SL,Spin,2020-01-19,Harare,Zimbabwe,2020,2,62,192,0,1,523,1058,12,461,866,12,43.583333333333336,>30,ZIM,Away,After 1965
DM de Silva,SL,Spin,2020-01-27,Harare,Zimbabwe,2020,2,103,144,3,1,658,1179,17,555,1035,14,38.705882352941174,>30,ZIM,Away,After 1965
DM de Silva,SL,Spin,2021-03-21,North Sound,West Indies,2021,2,42,126,0,1,363,863,7,321,737,7,51.857142857142854,>30,WI,Away,After 1965
DM de Silva,SL,Spin,2021-03-29,North Sound,West Indies,2021,2,107,228,1,1,313,706,3,206,478,2,104.33333333333333,>30,WI,Away,After 1965
DM de Silva,SL,Spin,2021-04-21,Pallekele,Sri Lanka,2021,2,176,246,1,1,649,1170,4,473,924,3,162.25,>30,SL,Home,After 1965
DM de Silva,SL,Spin,2021-04-29,Pallekele,Sri Lanka,2021,2,25,48,1,1,753,1454,28,728,1406,27,26.892857142857142,<=30,SL,Home,After 1965
DM de Silva,SL,Spin,2021-11-21,Galle,Sri Lanka,2021,2,16,24,1,1,748,1629,31,732,1605,30,24.129032258064516,<=30,SL,Home,After 1965
DM de Silva,SL,Spin,2021-11-29,Galle,Sri Lanka,2021,1,8,6,0,1,790,1806,36,782,1800,36,21.944444444444443,<=30,SL,Home,After 1965
DM de Silva,SL,Spin,2022-03-04,Mohali,India,2022,1,79,110,1,1,500,927,18,421,817,17,27.77777777777778,<=30,IND,Away,After 1965
DM de Silva,SL,Spin,2022-03-12,Bengaluru,India,2022,2,79,96,3,1,625,968,26,546,872,23,24.03846153846154,<=30,IND,Away,After 1965
DM de Silva,SL,Spin,2022-05-15,Chattogram,Bangladesh,2022,1,48,114,1,1,772,1873,17,724,1759,16,45.411764705882355,>30,BAN,Away,After 1965
DM de Silva,SL,Spin,2022-05-23,Mirpur,Bangladesh,2022,2,37,48,0,1,553,1141,6,516,1093,6,92.16666666666667,>30,BAN,Away,After 1965
DM de Silva,SL,Spin,2022-06-29,Galle,Sri Lanka,2022,1,8,30,1,1,491,729,25,483,699,24,19.64,<=30,SL,Home,After 1965
DM de Silva,SL,Spin,2022-07-16,Galle,Sri Lanka,2022,2,35,102,1,1,840,1795,26,805,1693,25,32.30769230769231,>30,SL,Home,After 1965
DM de Silva,SL,Spin,2022-07-24,Galle,Sri Lanka,2022,2,19,36,1,1,907,1657,29,888,1621,28,31.275862068965516,>30,SL,Home,After 1965
DM de Silva,SL,Spin,2023-03-09,Christchurch,New Zealand,2023,1,34,54,0,1,216,294,4,182,240,4,54.0,>30,NZ,Away,After 1965
DM de Silva,SL,Spin,2023-03-17,Wellington,New Zealand,2023,1,75,114,1,1,311,564,7,236,450,6,44.42857142857143,>30,NZ,Away,After 1965
DM de Silva,SL,Spin,2023-04-16,Galle,Sri Lanka,2023,2,14,24,0,1,643,1027,18,629,1003,18,35.72222222222222,>30,SL,Home,After 1965
DM de Silva,SL,Spin,2023-04-24,Galle,Sri Lanka,2023,2,23,90,0,1,963,1611,14,940,1521,14,68.78571428571429,>30,SL,Home,After 1965
DM de Silva,SL,Spin,2023-07-16,Galle,Sri Lanka,2023,2,19,54,0,1,731,1336,25,712,1282,25,29.24,<=30,SL,Home,After 1965
DM de Silva,SL,Spin,2023-07-24,Colombo (SSC),Sri Lanka,2023,1,13,18,0,1,535,922,13,522,904,13,41.15384615384615,>30,SL,Home,After 1965
DM de Silva,SL,Spin,2024-02-02,Colombo (SSC),Sri Lanka,2024,2,29,72,0,1,432,854,10,403,782,10,43.2,>30,SL,Home,After 1965
DM de Silva,SL,Spin,2024-03-22,Sylhet,Bangladesh,2024,1,4,6,0,1,284,550,7,280,544,7,40.57142857142857,>30,BAN,Away,After 1965
DM de Silva,SL,Spin,2024-03-30,Chattogram,Bangladesh,2024,2,39,90,0,1,649,1230,12,610,1140,12,54.083333333333336,>30,BAN,Away,After 1965
DM de Silva,SL,Spin,2024-08-21,Manchester,England,2024,1,14,12,0,1,370,678,9,356,666,9,41.111111111111114,>30,ENG,Away,After 1965
DM de Silva,SL,Spin,2024-09-06,The Oval,England,2024,1,18,24,2,1,123,161,3,105,137,1,41.0,>30,ENG,Away,After 1965
DM de Silva,SL,Spin,2024-09-18,Galle,Sri Lanka,2024,2,63,114,3,1,849,1559,29,786,1445,26,29.275862068965516,<=30,SL,Home,After 1965
DM de Silva,SL,Spin,2024-09-26,Galle,Sri Lanka,2024,1,28,42,1,1,824,1411,22,796,1369,21,37.45454545454545,>30,SL,Home,After 1965
DM de Silva,SL,Spin,2024-11-27,Durban,South Africa,2024,2,42,42,0,1,277,462,6,235,420,6,46.166666666666664,>30,SA,Away,After 1965
DM de Silva,SL,Spin,2024-12-05,Gqeberha,South Africa,2024,2,36,72,0,1,411,788,13,375,716,13,31.615384615384617,>30,SA,Away,After 1965
DN Patel,NZ,Spin,1987-02-20,Wellington,New Zealand,1987,1,13,18,0,1,313,876,9,300,858,9,34.77777777777778,>30,NZ,Home,Upto 2014
DN Patel,NZ,Spin,1987-02-27,Auckland,New Zealand,1987,1,38,36,0,1,278,540,5,240,504,5,55.6,>30,NZ,Home,Upto 2014
DN Patel,NZ,Spin,1987-12-04,Brisbane,Australia,1987,1,18,19,0,1,142,366,3,124,347,3,47.333333333333336,>30,AUS,Away,Upto 2014
DN Patel,NZ,Spin,1987-12-11,Adelaide,Australia,1987,1,11,42,0,1,613,1530,11,602,1488,11,55.72727272727273,>30,AUS,Away,Upto 2014
DN Patel,NZ,Spin,1987-12-26,Melbourne,Australia,1987,1,23,72,0,1,311,684,6,288,612,6,51.833333333333336,>30,AUS,Away,Upto 2014
DN Patel,NZ,Spin,1989-02-10,Wellington,New Zealand,1989,1,27,72,0,1,272,570,2,245,498,2,136.0,>30,NZ,Home,Upto 2014
DN Patel,NZ,Spin,1989-11-24,W.A.C.A,Australia,1989,1,80,168,1,1,104,222,1,24,54,0,104.0,>30,AUS,Away,Upto 2014
DN Patel,NZ,Spin,1990-10-10,Karachi,Pakistan,1990,1,62,144,0,1,202,384,2,140,240,2,101.0,>30,PAK,Away,Upto 2014
DN Patel,NZ,Spin,1990-10-18,Lahore,Pakistan,1990,2,56,114,0,1,149,339,4,93,225,4,37.25,>30,PAK,Away,Upto 2014
DN Patel,NZ,Spin,1990-10-26,Faisalabad,Pakistan,1990,1,21,36,0,1,81,132,1,60,96,1,81.0,>30,PAK,Away,Upto 2014
DN Patel,NZ,Spin,1991-02-22,Hamilton,New Zealand,1991,2,123,324,3,1,304,672,6,181,348,3,50.666666666666664,>30,NZ,Home,Upto 2014
DN Patel,NZ,Spin,1991-03-01,Auckland,New Zealand,1991,2,115,186,1,1,346,733,6,231,547,5,57.666666666666664,>30,NZ,Home,Upto 2014
DN Patel,NZ,Spin,1992-01-18,Christchurch,New Zealand,1992,1,132,276,2,1,362,1021,13,230,745,11,27.846153846153847,<=30,NZ,Home,Upto 2014
DN Patel,NZ,Spin,1992-01-30,Auckland,New Zealand,1992,1,43,132,1,1,104,264,4,61,132,3,26.0,<=30,NZ,Home,Upto 2014
DN Patel,NZ,Spin,1992-02-06,Wellington,New Zealand,1992,2,199,453,7,1,491,1353,13,292,900,6,37.76923076923077,>30,NZ,Home,Upto 2014
DN Patel,NZ,Spin,1992-11-01,Bulawayo,Zimbabwe,1992,2,173,412,7,1,469,976,10,296,564,3,46.9,>30,ZIM,Away,Upto 2014
DN Patel,NZ,Spin,1992-11-07,Harare,Zimbabwe,1992,2,131,303,8,1,372,723,13,241,420,5,28.615384615384617,<=30,ZIM,Away,Upto 2014
DN Patel,NZ,Spin,1993-01-02,Hamilton,New Zealand,1993,2,118,205,3,1,217,463,6,99,258,3,36.166666666666664,>30,NZ,Home,Upto 2014
DN Patel,NZ,Spin,1993-02-25,Christchurch,New Zealand,1993,1,145,186,2,1,243,504,9,98,318,7,27.0,<=30,NZ,Home,Upto 2014
DN Patel,NZ,Spin,1993-03-04,Wellington,New Zealand,1993,1,4,6,0,1,142,558,5,138,552,5,28.4,<=30,NZ,Home,Upto 2014
DN Patel,NZ,Spin,1993-03-12,Auckland,New Zealand,1993,2,114,228,6,1,187,516,12,73,288,6,15.583333333333334,<=30,NZ,Home,Upto 2014
DN Patel,NZ,Spin,1993-11-12,W.A.C.A,Australia,1993,2,181,282,2,1,339,721,5,158,439,3,67.8,>30,AUS,Away,Upto 2014
DN Patel,NZ,Spin,1993-11-26,Hobart,Australia,1993,1,78,138,1,1,270,782,19,192,644,18,14.210526315789474,<=30,AUS,Away,Upto 2014
DN Patel,NZ,Spin,1993-12-03,Brisbane,Australia,1993,1,125,198,1,1,392,909,12,267,711,11,32.666666666666664,>30,AUS,Away,Upto 2014
DN Patel,NZ,Spin,1995-03-04,Auckland,New Zealand,1995,2,135,282,2,1,298,642,4,163,360,2,74.5,>30,NZ,Home,Upto 2014
DN Patel,NZ,Spin,1995-03-18,Dunedin,New Zealand,1995,2,158,468,7,1,246,774,9,88,306,2,27.333333333333332,<=30,NZ,Home,Upto 2014
DN Patel,NZ,Spin,1995-12-08,Christchurch,New Zealand,1995,2,73,162,1,1,251,572,11,178,410,10,22.818181818181817,<=30,NZ,Home,Upto 2014
DN Patel,NZ,Spin,1996-01-13,Hamilton,New Zealand,1996,2,101,227,4,1,166,401,6,65,174,2,27.666666666666668,<=30,NZ,Home,Upto 2014
DN Patel,NZ,Spin,1996-01-20,Auckland,New Zealand,1996,2,120,234,4,1,314,606,5,194,372,1,62.8,>30,NZ,Home,Upto 2014
DN Patel,NZ,Spin,1996-04-27,St John's,West Indies,1996,1,131,228,2,1,371,702,4,240,474,2,92.75,>30,WI,Away,Upto 2014
DN Patel,NZ,Spin,1996-11-21,Lahore,Pakistan,1996,2,60,133,4,1,322,664,17,262,531,13,18.941176470588236,<=30,PAK,Away,Upto 2014
DN Patel,NZ,Spin,1996-11-28,Rawalpindi,Pakistan,1996,1,33,90,0,1,194,426,8,161,336,8,24.25,<=30,PAK,Away,Upto 2014
DN Patel,NZ,Spin,1997-01-24,Auckland,New Zealand,1997,1,92,264,2,1,302,804,7,210,540,5,43.142857142857146,>30,NZ,Home,Upto 2014
DN Patel,NZ,Spin,1997-02-06,Wellington,New Zealand,1997,1,59,144,1,1,215,621,7,156,477,6,30.714285714285715,>30,NZ,Home,Upto 2014
DN Patel,NZ,Spin,1997-03-07,Dunedin,New Zealand,1997,2,103,192,3,1,364,612,5,261,420,2,72.8,>30,NZ,Home,Upto 2014
DN Patel,NZ,Spin,1997-03-14,Hamilton,New Zealand,1997,2,59,120,0,1,413,1010,18,354,890,18,22.944444444444443,<=30,NZ,Home,Upto 2014
DN Sardesai,IND,Spin,1961-12-01,Kanpur,India,1961,1,3,6,0,1,792,2016,16,789,2010,16,49.5,>30,IND,Home,Upto 2014
DN Sardesai,IND,Spin,1964-01-10,Chennai,India,1964,1,14,6,0,1,876,2493,27,862,2487,27,32.44444444444444,>30,IND,Home,Upto 2014
DN Sardesai,IND,Spin,1964-01-21,Brabourne,India,1964,1,6,18,0,1,560,2208,16,554,2190,16,35.0,>30,IND,Home,Upto 2014
DN Sardesai,IND,Spin,1964-01-29,Eden Gardens,India,1964,1,10,18,0,1,555,1794,16,545,1776,16,34.6875,>30,IND,Home,Upto 2014
DN Sardesai,IND,Spin,1972-12-20,Delhi,India,1972,1,12,11,0,1,561,1750,23,549,1739,23,24.391304347826086,<=30,IND,Home,Upto 2014
DN Wellalage,SL,Spin,2022-07-24,Galle,Sri Lanka,2022,2,35,78,0,1,907,1657,29,872,1579,29,31.275862068965516,>30,SL,Home,After 1965
DNT Zoysa,SL,Pace,1997-03-07,Dunedin,New Zealand,1997,1,112,240,1,1,739,1295,21,627,1055,20,35.19047619047619,>30,NZ,Away,Upto 2014
DNT Zoysa,SL,Pace,1997-03-14,Hamilton,New Zealand,1997,2,100,244,6,1,399,988,18,299,744,12,22.166666666666668,<=30,NZ,Away,Upto 2014
DNT Zoysa,SL,Pace,1997-04-19,Colombo (RPS),Sri Lanka,1997,1,55,60,0,1,337,618,3,282,558,3,112.33333333333333,>30,SL,Home,Upto 2014
DNT Zoysa,SL,Pace,1998-03-27,Centurion,South Africa,1998,2,40,84,1,1,463,1134,19,423,1050,18,24.36842105263158,<=30,SA,Away,Upto 2014
DNT Zoysa,SL,Pace,1999-09-09,Kandy,Sri Lanka,1999,2,66,138,3,1,252,546,11,186,408,8,22.90909090909091,<=30,SL,Home,Upto 2014
DNT Zoysa,SL,Pace,1999-09-22,Galle,Sri Lanka,1999,1,9,36,0,1,252,497,5,243,461,5,50.4,>30,SL,Home,Upto 2014
DNT Zoysa,SL,Pace,1999-09-30,Colombo (SSC),Sri Lanka,1999,1,23,60,0,1,116,297,8,93,237,8,14.5,<=30,SL,Home,Upto 2014
DNT Zoysa,SL,Pace,1999-11-26,Harare,Zimbabwe,1999,2,46,144,4,1,681,1742,19,635,1598,15,35.8421052631579,>30,ZIM,Away,Upto 2014
DNT Zoysa,SL,Pace,2000-02-26,Rawalpindi,Pakistan,2000,2,101,234,3,1,697,1541,24,596,1307,21,29.041666666666668,<=30,PAK,Away,Upto 2014
DNT Zoysa,SL,Pace,2000-06-14,Colombo (SSC),Sri Lanka,2000,2,68,192,4,1,461,1090,17,393,898,13,27.11764705882353,<=30,SL,Home,Upto 2014
DNT Zoysa,SL,Pace,2000-07-20,Galle,Sri Lanka,2000,2,23,54,0,1,282,658,5,259,604,5,56.4,>30,SL,Home,Upto 2014
DNT Zoysa,SL,Pace,2000-07-30,Kandy,Sri Lanka,2000,2,33,66,2,1,362,832,17,329,766,15,21.294117647058822,<=30,SL,Home,Upto 2014
DNT Zoysa,SL,Pace,2000-12-26,Durban,South Africa,2000,2,83,150,0,1,618,1336,17,535,1186,17,36.35294117647059,>30,SA,Away,Upto 2014
DNT Zoysa,SL,Pace,2001-01-02,Cape Town,South Africa,2001,1,80,156,0,1,537,948,18,457,792,18,29.833333333333332,<=30,SA,Away,Upto 2014
DNT Zoysa,SL,Pace,2001-01-20,Centurion,South Africa,2001,1,76,132,4,1,628,1061,26,552,929,22,24.153846153846153,<=30,SA,Away,Upto 2014
DNT Zoysa,SL,Pace,2001-03-07,Kandy,Sri Lanka,2001,2,51,72,0,1,362,762,19,311,690,19,19.05263157894737,<=30,SL,Home,Upto 2014
DNT Zoysa,SL,Pace,2001-11-21,Kandy,Sri Lanka,2001,2,47,126,2,1,410,847,17,363,721,15,24.11764705882353,<=30,SL,Home,Upto 2014
DNT Zoysa,SL,Pace,2001-11-29,Colombo (SSC),Sri Lanka,2001,2,100,186,2,1,728,1313,22,628,1127,20,33.09090909090909,>30,SL,Home,Upto 2014
DNT Zoysa,SL,Pace,2001-12-27,Colombo (SSC),Sri Lanka,2001,2,58,174,4,1,677,1297,14,619,1123,10,48.357142857142854,>30,SL,Home,Upto 2014
DNT Zoysa,SL,Pace,2002-01-04,Kandy,Sri Lanka,2002,2,74,150,0,1,529,977,13,455,827,13,40.69230769230769,>30,SL,Home,Upto 2014
DNT Zoysa,SL,Pace,2002-03-06,Lahore,Pakistan,2002,2,83,180,2,1,853,1374,23,770,1194,21,37.08695652173913,>30,PAK,Away,Upto 2014
DNT Zoysa,SL,Pace,2002-05-16,Lord's,England,2002,2,166,318,3,1,1188,2251,20,1022,1933,17,59.4,>30,ENG,Away,Upto 2014
DNT Zoysa,SL,Pace,2002-05-30,Birmingham,England,2002,1,93,144,3,1,687,1192,22,594,1048,19,31.227272727272727,>30,ENG,Away,Upto 2014
DNT Zoysa,SL,Pace,2004-03-16,Kandy,Sri Lanka,2004,2,156,294,6,1,512,998,21,356,704,15,24.38095238095238,<=30,SL,Home,Upto 2014
DNT Zoysa,SL,Pace,2004-03-24,Colombo (SSC),Sri Lanka,2004,2,77,93,0,1,527,998,13,450,905,13,40.53846153846154,>30,SL,Home,Upto 2014
DNT Zoysa,SL,Pace,2004-05-06,Harare,Zimbabwe,2004,2,73,161,8,1,612,996,20,539,835,12,30.6,>30,ZIM,Away,Upto 2014
DNT Zoysa,SL,Pace,2004-05-14,Bulawayo,Zimbabwe,2004,2,77,162,3,1,856,1362,13,779,1200,10,65.84615384615384,>30,ZIM,Away,Upto 2014
DNT Zoysa,SL,Pace,2004-07-01,Darwin,Australia,2004,2,81,174,1,1,425,1034,30,344,860,29,14.166666666666666,<=30,AUS,Away,Upto 2014
DNT Zoysa,SL,Pace,2004-07-09,Cairns,Australia,2004,2,106,198,2,1,844,1536,15,738,1338,13,56.266666666666666,>30,AUS,Away,Upto 2014
DP Conyngham,SA,Pace,1923-02-16,Durban,South Africa,1923,2,103,366,2,1,724,2332,33,621,1966,31,21.939393939393938,<=30,SA,Home,Upto 2014
DP Sibley,ENG,Spin,2020-08-21,Southampton,England,2020,1,7,6,0,1,389,624,7,382,618,7,55.57142857142857,>30,ENG,Home,After 1965
DP Viljoen,ZIM,Spin,1998-03-14,Bulawayo,Zimbabwe,1998,1,14,21,1,1,364,712,5,350,691,4,72.8,>30,ZIM,Home,Upto 2014
DP Viljoen,ZIM,Spin,2000-11-25,Nagpur,India,2000,1,51,84,0,1,810,1427,12,759,1343,12,67.5,>30,IND,Away,Upto 2014
DPB Morkel,SA,Pace,1927-12-24,Johannesburg,South Africa,1927,1,38,84,1,1,371,971,19,333,887,18,19.526315789473685,<=30,SA,Home,Upto 2014
DPB Morkel,SA,Pace,1927-12-31,Cape Town,South Africa,1927,2,80,180,1,1,474,1145,15,394,965,14,31.6,>30,SA,Home,Upto 2014
DPB Morkel,SA,Pace,1928-01-21,Durban,South Africa,1928,2,43,66,0,1,482,1079,8,439,1013,8,60.25,>30,SA,Home,Upto 2014
DPB Morkel,SA,Pace,1928-02-04,Durban,South Africa,1928,1,3,12,0,1,338,797,16,335,785,16,21.125,<=30,SA,Home,Upto 2014
DPB Morkel,SA,Pace,1929-06-15,Birmingham,England,1929,2,94,252,4,1,506,1355,18,412,1103,14,28.11111111111111,<=30,ENG,Away,Upto 2014
DPB Morkel,SA,Pace,1929-06-29,Lord's,England,1929,2,156,330,7,1,601,1182,21,445,852,14,28.61904761904762,<=30,ENG,Away,Upto 2014
DPB Morkel,SA,Pace,1929-07-13,Leeds,England,1929,2,84,198,2,1,359,767,10,275,569,8,35.9,>30,ENG,Away,Upto 2014
DPB Morkel,SA,Pace,1929-07-27,Manchester,England,1929,1,61,108,1,1,396,1059,11,335,951,10,36.0,>30,ENG,Away,Upto 2014
DPB Morkel,SA,Pace,1929-08-17,The Oval,England,1929,2,63,150,0,1,426,1011,9,363,861,9,47.333333333333336,>30,ENG,Away,Upto 2014
DPB Morkel,SA,Pace,1931-11-27,Brisbane,Australia,1931,1,57,78,1,1,377,952,14,320,874,13,26.928571428571427,<=30,AUS,Away,Upto 2014
DPB Morkel,SA,Pace,1931-12-18,Sydney,Australia,1931,1,33,72,1,1,383,911,14,350,839,13,27.357142857142858,<=30,AUS,Away,Upto 2014
DPB Morkel,SA,Pace,1931-12-31,Melbourne,Australia,1931,2,27,42,0,1,596,1454,16,569,1412,16,37.25,>30,AUS,Away,Upto 2014
DPB Morkel,SA,Pace,1932-01-29,Adelaide,Australia,1932,2,76,120,0,1,508,1020,9,432,900,9,56.44444444444444,>30,AUS,Away,Upto 2014
DPB Morkel,SA,Pace,1932-02-27,Christchurch,New Zealand,1932,1,6,12,0,1,481,1211,11,475,1199,11,43.72727272727273,>30,NZ,Away,Upto 2014
DPMD Jayawardene,SL,Pace,1997-08-02,Colombo (RPS),Sri Lanka,1997,1,6,12,0,1,398,549,5,392,537,5,79.6,>30,SL,Home,Upto 2014
DPMD Jayawardene,SL,Pace,1997-08-09,Colombo (SSC),Sri Lanka,1997,2,29,54,0,1,927,1577,19,898,1523,19,48.78947368421053,>30,SL,Home,Upto 2014
DPMD Jayawardene,SL,Pace,1998-05-27,Colombo (RPS),Sri Lanka,1998,1,10,18,0,1,355,626,8,345,608,8,44.375,>30,SL,Home,Upto 2014
DPMD Jayawardene,SL,Pace,1998-08-27,The Oval,England,1998,1,5,12,0,1,707,1308,12,702,1296,12,58.916666666666664,>30,ENG,Away,Upto 2014
DPMD Jayawardene,SL,Pace,1999-02-24,Colombo (SSC),Sri Lanka,1999,2,65,150,1,1,790,1434,9,725,1284,8,87.77777777777777,>30,SL,Home,Upto 2014
DPMD Jayawardene,SL,Pace,1999-03-12,Dhaka,Bangladesh,1999,1,35,60,0,1,404,794,8,369,734,8,50.5,>30,BAN,Away,Upto 2014
DPMD Jayawardene,SL,Pace,1999-11-26,Harare,Zimbabwe,1999,1,7,24,0,1,681,1742,19,674,1718,19,35.8421052631579,>30,ZIM,Away,Upto 2014
DPMD Jayawardene,SL,Pace,1999-12-04,Harare,Zimbabwe,1999,1,12,12,0,1,525,1358,25,513,1346,25,21.0,<=30,ZIM,Away,Upto 2014
DPMD Jayawardene,SL,Pace,2000-03-05,Peshawar,Pakistan,2000,1,7,30,1,1,480,1060,20,473,1030,19,24.0,<=30,PAK,Away,Upto 2014
DPMD Jayawardene,SL,Pace,2000-06-14,Colombo (SSC),Sri Lanka,2000,1,2,12,0,1,461,1090,17,459,1078,17,27.11764705882353,<=30,SL,Home,Upto 2014
DPMD Jayawardene,SL,Pace,2000-06-21,Galle,Sri Lanka,2000,1,32,20,2,1,578,1128,20,546,1108,18,28.9,<=30,SL,Home,Upto 2014
DPMD Jayawardene,SL,Pace,2001-01-02,Cape Town,South Africa,2001,1,2,6,0,1,537,948,18,535,942,18,29.833333333333332,<=30,SA,Away,Upto 2014
DPMD Jayawardene,SL,Pace,2002-11-15,Centurion,South Africa,2002,1,2,12,0,1,905,1840,32,903,1828,32,28.28125,<=30,SA,Away,Upto 2014
DPMD Jayawardene,SL,Pace,2005-04-11,Wellington,New Zealand,2005,1,14,36,0,1,716,1428,28,702,1392,28,25.571428571428573,<=30,NZ,Away,Upto 2014
DPMD Jayawardene,SL,Pace,2007-12-09,Colombo (SSC),Sri Lanka,2007,1,4,12,0,1,676,1421,13,672,1409,13,52.0,>30,SL,Home,Upto 2014
DPMD Jayawardene,SL,Pace,2009-02-21,Karachi,Pakistan,2009,1,41,41,1,1,650,1043,7,609,1002,6,92.85714285714286,>30,PAK,Away,Upto 2014
DPMD Jayawardene,SL,Pace,2009-07-20,Colombo (SSC),Sri Lanka,2009,1,9,12,0,1,669,1180,14,660,1168,14,47.785714285714285,>30,SL,Home,Upto 2014
DPMD Jayawardene,SL,Pace,2009-08-18,Galle,Sri Lanka,2009,1,10,24,1,1,541,798,16,531,774,15,33.8125,>30,SL,Home,Upto 2014
DPMD Jayawardene,SL,Pace,2011-06-16,Southampton,England,2011,1,5,6,0,1,719,1308,21,714,1302,21,34.23809523809524,>30,ENG,Away,Upto 2014
DPMD Jayawardene,SL,Pace,2014-06-20,Leeds,England,2014,1,13,36,0,1,1059,2060,34,1046,2024,34,31.147058823529413,>30,ENG,Away,After 1965
DR Doshi,IND,Spin,1979-09-11,Chennai,India,1979,2,167,510,8,1,518,1389,19,351,879,11,27.263157894736842,<=30,IND,Home,Upto 2014
DR Doshi,IND,Spin,1979-09-19,Bengaluru,India,1979,2,74,216,1,1,418,1101,14,344,885,13,29.857142857142858,<=30,IND,Home,Upto 2014
DR Doshi,IND,Spin,1979-10-02,Kanpur,India,1979,2,46,168,2,1,449,1116,12,403,948,10,37.416666666666664,>30,IND,Home,Upto 2014
DR Doshi,IND,Spin,1979-10-13,Delhi,India,1979,2,98,285,2,1,604,1308,12,506,1023,10,50.333333333333336,>30,IND,Home,Upto 2014
DR Doshi,IND,Spin,1979-10-26,Eden Gardens,India,1979,2,142,390,6,1,581,1386,14,439,996,8,41.5,>30,IND,Home,Upto 2014
DR Doshi,IND,Spin,1979-11-03,Wankhede,India,1979,2,103,269,8,1,457,1061,17,354,792,9,26.88235294117647,<=30,IND,Home,Upto 2014
DR Doshi,IND,Spin,1979-11-21,Bengaluru,India,1979,2,128,387,4,1,552,1383,11,424,996,7,50.18181818181818,>30,IND,Home,Upto 2014
DR Doshi,IND,Spin,1979-12-04,Delhi,India,1979,2,82,216,2,1,303,672,3,221,456,1,101.0,>30,IND,Home,Upto 2014
DR Doshi,IND,Spin,1979-12-16,Wankhede,India,1979,2,94,276,6,1,435,1053,22,341,777,16,19.772727272727273,<=30,IND,Home,Upto 2014
DR Doshi,IND,Spin,1979-12-25,Kanpur,India,1979,1,26,102,1,1,100,282,2,74,180,1,50.0,>30,IND,Home,Upto 2014
DR Doshi,IND,Spin,1980-01-15,Chennai,India,1980,2,90,252,3,1,236,570,6,146,318,3,39.333333333333336,>30,IND,Home,Upto 2014
DR Doshi,IND,Spin,1980-01-29,Eden Gardens,India,1980,2,84,270,2,1,248,600,5,164,330,3,49.6,>30,IND,Home,Upto 2014
DR Doshi,IND,Spin,1980-02-15,Wankhede,India,1980,2,69,174,1,1,158,297,1,89,123,0,158.0,>30,IND,Home,Upto 2014
DR Doshi,IND,Spin,1981-01-02,Sydney,Australia,1981,1,103,162,0,1,158,276,4,55,114,4,39.5,>30,AUS,Away,Upto 2014
DR Doshi,IND,Spin,1981-01-23,Adelaide,Australia,1981,2,195,486,6,1,543,1406,16,348,920,10,33.9375,>30,AUS,Away,Upto 2014
DR Doshi,IND,Spin,1981-02-07,Melbourne,Australia,1981,2,142,444,5,1,474,1128,11,332,684,6,43.09090909090909,>30,AUS,Away,Upto 2014
DR Doshi,IND,Spin,1981-03-06,Christchurch,New Zealand,1981,1,67,294,1,1,157,612,3,90,318,2,52.333333333333336,>30,NZ,Away,Upto 2014
DR Doshi,IND,Spin,1981-03-13,Auckland,New Zealand,1981,2,97,528,4,1,519,1803,22,422,1275,18,23.59090909090909,<=30,NZ,Away,Upto 2014
DR Doshi,IND,Spin,1981-11-27,Wankhede,India,1981,2,39,181,5,1,162,553,10,123,372,5,16.2,<=30,IND,Home,Upto 2014
DR Doshi,IND,Spin,1981-12-09,Bengaluru,India,1981,2,120,360,3,1,405,1140,11,285,780,8,36.81818181818182,>30,IND,Home,Upto 2014
DR Doshi,IND,Spin,1981-12-23,Delhi,India,1981,1,68,240,2,1,331,798,4,263,558,2,82.75,>30,IND,Home,Upto 2014
DR Doshi,IND,Spin,1982-01-01,Eden Gardens,India,1982,2,91,278,4,1,396,1328,13,305,1050,9,30.46153846153846,>30,IND,Home,Upto 2014
DR Doshi,IND,Spin,1982-01-13,Chennai,India,1982,1,69,342,4,1,285,972,8,216,630,4,35.625,>30,IND,Home,Upto 2014
DR Doshi,IND,Spin,1982-01-30,Kanpur,India,1982,1,81,206,4,1,274,704,7,193,498,3,39.142857142857146,>30,IND,Home,Upto 2014
DR Doshi,IND,Spin,1982-06-10,Lord's,England,1982,2,131,270,2,1,261,594,2,130,324,0,130.5,>30,ENG,Away,Upto 2014
DR Doshi,IND,Spin,1982-06-24,Manchester,England,1982,1,102,283,6,1,341,811,11,239,528,5,31.0,>30,ENG,Away,Upto 2014
DR Doshi,IND,Spin,1982-07-08,The Oval,England,1982,2,222,390,5,1,576,1184,12,354,794,7,48.0,>30,ENG,Away,Upto 2014
DR Doshi,IND,Spin,1982-09-17,Chennai,India,1982,2,232,408,8,1,682,1194,13,450,786,5,52.46153846153846,>30,IND,Home,Upto 2014
DR Doshi,IND,Spin,1982-12-10,Lahore,Pakistan,1982,2,147,287,6,1,261,509,6,114,222,0,43.5,>30,PAK,Away,Upto 2014
DR Doshi,IND,Spin,1982-12-23,Karachi,Pakistan,1982,1,68,108,1,1,277,474,7,209,366,6,39.57142857142857,>30,PAK,Away,Upto 2014
DR Doshi,IND,Spin,1983-01-03,Faisalabad,Pakistan,1983,1,130,174,0,1,324,501,2,194,327,2,162.0,>30,PAK,Away,Upto 2014
DR Doshi,IND,Spin,1983-01-14,Hyderabad (Sind),Pakistan,1983,1,143,246,1,1,496,1008,6,353,762,5,82.66666666666667,>30,PAK,Away,Upto 2014
DR Doshi,IND,Spin,1983-09-14,Bengaluru,India,1983,1,52,120,1,1,224,589,2,172,469,1,112.0,>30,IND,Home,Upto 2014
DR Flynn,NZ,Spin,2012-11-25,Colombo (PSS),Sri Lanka,2012,1,0,6,0,1,489,1212,15,489,1206,15,32.6,>30,SL,Away,Upto 2014
DR Gilbert,AUS,Pace,1985-08-29,The Oval,England,1985,1,96,126,1,1,567,1067,25,471,941,24,22.68,<=30,ENG,Away,Upto 2014
DR Gilbert,AUS,Pace,1985-11-08,Brisbane,Australia,1985,1,102,234,2,1,699,1580,23,597,1346,21,30.391304347826086,>30,AUS,Home,Upto 2014
DR Gilbert,AUS,Pace,1985-11-22,Sydney,Australia,1985,2,63,177,2,1,241,652,9,178,475,7,26.77777777777778,<=30,AUS,Home,Upto 2014
DR Gilbert,AUS,Pace,1985-11-30,W.A.C.A,Australia,1985,2,123,324,4,1,726,2093,28,603,1769,24,25.928571428571427,<=30,AUS,Home,Upto 2014
DR Gilbert,AUS,Pace,1985-12-26,Melbourne,Australia,1985,2,90,156,2,1,429,932,13,339,776,11,33.0,>30,AUS,Home,Upto 2014
DR Gilbert,AUS,Pace,1986-01-02,Sydney,Australia,1986,1,135,222,2,1,382,756,4,247,534,2,95.5,>30,AUS,Home,Upto 2014
DR Gilbert,AUS,Pace,1986-02-28,Christchurch,New Zealand,1986,2,115,198,2,1,712,1681,22,597,1483,20,32.36363636363637,>30,NZ,Away,Upto 2014
DR Gilbert,AUS,Pace,1986-09-26,Delhi,India,1986,1,44,66,1,1,158,270,3,114,204,2,52.666666666666664,>30,IND,Away,Upto 2014
DR Gilbert,AUS,Pace,1986-10-15,Wankhede,India,1986,1,75,144,0,1,351,666,3,276,522,3,117.0,>30,IND,Away,Upto 2014
DR Hadlee,NZ,Pace,1969-07-24,Lord's,England,1969,2,91,180,2,1,463,1142,17,372,962,15,27.235294117647058,<=30,ENG,Away,Upto 2014
DR Hadlee,NZ,Pace,1969-08-07,Nottingham,England,1969,1,88,150,4,1,534,1193,14,446,1043,10,38.142857142857146,>30,ENG,Away,Upto 2014
DR Hadlee,NZ,Pace,1969-09-25,Brabourne,India,1969,2,74,218,6,1,336,982,18,262,764,12,18.666666666666668,<=30,IND,Away,Upto 2014
DR Hadlee,NZ,Pace,1969-10-03,Nagpur,India,1969,2,46,102,0,1,171,432,3,125,330,3,57.0,>30,IND,Away,Upto 2014
DR Hadlee,NZ,Pace,1969-10-15,Hyderabad (Deccan),India,1969,2,61,166,7,1,198,715,20,137,549,13,9.9,<=30,IND,Away,Upto 2014
DR Hadlee,NZ,Pace,1969-10-24,Karachi,Pakistan,1969,2,58,200,4,1,167,468,6,109,268,2,27.833333333333332,<=30,PAK,Away,Upto 2014
DR Hadlee,NZ,Pace,1969-10-30,Lahore,Pakistan,1969,2,37,144,4,1,161,587,12,124,443,8,13.416666666666666,<=30,PAK,Away,Upto 2014
DR Hadlee,NZ,Pace,1969-11-08,Dhaka,Bangladesh,1969,2,58,144,0,1,262,729,8,204,585,8,32.75,>30,BAN,Away,Upto 2014
DR Hadlee,NZ,Pace,1973-02-07,Dunedin,New Zealand,1973,1,100,192,2,1,333,648,6,233,456,4,55.5,>30,NZ,Home,Upto 2014
DR Hadlee,NZ,Pace,1973-02-16,Auckland,New Zealand,1973,2,135,191,1,1,643,1420,15,508,1229,14,42.86666666666667,>30,NZ,Home,Upto 2014
DR Hadlee,NZ,Pace,1973-06-07,Nottingham,England,1973,2,93,192,5,1,817,1990,27,724,1798,22,30.25925925925926,>30,ENG,Away,Upto 2014
DR Hadlee,NZ,Pace,1973-06-21,Lord's,England,1973,2,149,306,4,1,777,1763,19,628,1457,15,40.89473684210526,>30,ENG,Away,Upto 2014
DR Hadlee,NZ,Pace,1973-07-05,Leeds,England,1973,1,98,139,1,1,624,1466,29,526,1327,28,21.517241379310345,<=30,ENG,Away,Upto 2014
DR Hadlee,NZ,Pace,1973-12-29,Melbourne,Australia,1973,1,102,160,4,1,539,1189,14,437,1029,10,38.5,>30,AUS,Away,Upto 2014
DR Hadlee,NZ,Pace,1974-01-05,Sydney,Australia,1974,1,52,104,3,1,618,1375,28,566,1271,25,22.071428571428573,<=30,AUS,Away,Upto 2014
DR Hadlee,NZ,Pace,1974-01-26,Adelaide,Australia,1974,1,76,168,1,1,505,1312,13,429,1144,12,38.84615384615385,>30,AUS,Away,Upto 2014
DR Hadlee,NZ,Pace,1974-03-01,Wellington,New Zealand,1974,2,213,384,3,1,960,1997,18,747,1613,15,53.333333333333336,>30,NZ,Home,Upto 2014
DR Hadlee,NZ,Pace,1974-03-08,Christchurch,New Zealand,1974,2,117,258,5,1,814,2050,32,697,1792,27,25.4375,<=30,NZ,Home,Upto 2014
DR Hadlee,NZ,Pace,1974-03-22,Auckland,New Zealand,1974,2,89,128,0,1,628,1262,29,539,1134,29,21.655172413793103,<=30,NZ,Home,Upto 2014
DR Hadlee,NZ,Pace,1975-02-20,Auckland,New Zealand,1975,1,102,160,2,1,616,1261,8,514,1101,6,77.0,>30,NZ,Home,Upto 2014
DR Hadlee,NZ,Pace,1975-02-28,Christchurch,New Zealand,1975,1,61,152,1,1,449,1000,7,388,848,6,64.14285714285714,>30,NZ,Home,Upto 2014
DR Hadlee,NZ,Pace,1976-01-24,Auckland,New Zealand,1976,2,86,168,2,1,264,671,8,178,503,6,33.0,>30,NZ,Home,Upto 2014
DR Hadlee,NZ,Pace,1976-02-05,Christchurch,New Zealand,1976,2,128,224,4,1,616,1431,23,488,1207,19,26.782608695652176,<=30,NZ,Home,Upto 2014
DR Hadlee,NZ,Pace,1976-02-13,Wellington,New Zealand,1976,2,70,216,3,1,457,1252,22,387,1036,19,20.772727272727273,<=30,NZ,Home,Upto 2014
DR Hadlee,NZ,Pace,1977-02-18,Christchurch,New Zealand,1977,2,158,261,3,1,990,2047,22,832,1786,19,45.0,>30,NZ,Home,Upto 2014
DR Hadlee,NZ,Pace,1978-02-10,Wellington,New Zealand,1978,2,47,176,0,1,523,1920,38,476,1744,38,13.763157894736842,<=30,NZ,Home,Upto 2014
DR Jardine,ENG,Spin,1928-12-29,Melbourne,Australia,1928,1,10,6,0,1,717,2327,21,707,2321,21,34.142857142857146,>30,AUS,Away,Upto 2014
DR Martyn,AUS,Pace,1993-03-12,Auckland,New Zealand,1993,1,0,6,0,1,620,1465,22,620,1459,22,28.181818181818183,<=30,NZ,Away,Upto 2014
DR Martyn,AUS,Pace,2000-03-31,Hamilton,New Zealand,2000,1,12,42,0,1,633,1061,24,621,1019,24,26.375,<=30,NZ,Away,Upto 2014
DR Martyn,AUS,Pace,2001-11-30,W.A.C.A,Australia,2001,1,44,60,0,1,1026,1787,22,982,1727,22,46.63636363636363,>30,AUS,Home,Upto 2014
DR Martyn,AUS,Pace,2001-12-14,Adelaide,Australia,2001,2,4,30,1,1,773,1644,20,769,1614,19,38.65,>30,AUS,Home,Upto 2014
DR Martyn,AUS,Pace,2002-03-08,Cape Town,South Africa,2002,1,15,24,0,1,927,1517,20,912,1493,20,46.35,>30,SA,Away,Upto 2014
DR Martyn,AUS,Pace,2002-11-29,W.A.C.A,Australia,2002,2,9,18,1,1,590,1095,16,581,1077,15,36.875,>30,AUS,Home,Upto 2014
DR Martyn,AUS,Pace,2003-01-02,Sydney,Australia,2003,1,14,18,0,1,1004,1656,32,990,1638,32,31.375,>30,AUS,Home,Upto 2014
DR Martyn,AUS,Pace,2003-10-09,W.A.C.A,Australia,2003,1,34,78,0,1,658,1277,15,624,1199,15,43.86666666666667,>30,AUS,Home,Upto 2014
DR Martyn,AUS,Pace,2003-10-17,Sydney,Australia,2003,1,9,18,0,1,646,1058,15,637,1040,15,43.06666666666667,>30,AUS,Home,Upto 2014
DR Martyn,AUS,Pace,2004-01-02,Sydney,Australia,2004,1,27,54,0,1,876,1379,11,849,1325,11,79.63636363636364,>30,AUS,Home,Upto 2014
DR O'Sullivan,NZ,Spin,1973-02-07,Dunedin,New Zealand,1973,1,81,144,0,1,480,1145,19,399,1001,19,25.263157894736842,<=30,NZ,Home,Upto 2014
DR O'Sullivan,NZ,Spin,1973-12-29,Melbourne,Australia,1973,1,80,176,0,1,322,917,12,242,741,12,26.833333333333332,<=30,AUS,Away,Upto 2014
DR O'Sullivan,NZ,Spin,1974-01-26,Adelaide,Australia,1974,1,148,285,5,1,351,1069,16,203,784,11,21.9375,<=30,AUS,Away,Upto 2014
DR O'Sullivan,NZ,Spin,1976-01-24,Auckland,New Zealand,1976,2,111,264,0,1,633,1676,24,522,1412,24,26.375,<=30,NZ,Home,Upto 2014
DR O'Sullivan,NZ,Spin,1976-10-09,Lahore,Pakistan,1976,1,86,205,1,1,495,1028,17,409,823,16,29.11764705882353,<=30,PAK,Away,Upto 2014
DR O'Sullivan,NZ,Spin,1976-10-23,Hyderabad (Sind),Pakistan,1976,1,95,312,2,1,481,1360,16,386,1048,14,30.0625,>30,PAK,Away,Upto 2014
DR O'Sullivan,NZ,Spin,1976-10-30,Karachi,Pakistan,1976,2,227,416,4,1,499,1183,10,272,767,6,49.9,>30,PAK,Away,Upto 2014
DR O'Sullivan,NZ,Spin,1976-11-10,Wankhede,India,1976,2,83,222,1,1,560,1714,23,477,1492,22,24.347826086956523,<=30,IND,Away,Upto 2014
DR O'Sullivan,NZ,Spin,1976-11-18,Kanpur,India,1976,2,174,396,3,1,806,2159,22,632,1763,19,36.63636363636363,>30,IND,Away,Upto 2014
DR O'Sullivan,NZ,Spin,1976-11-26,Chennai,India,1976,2,139,324,2,1,433,1077,20,294,753,18,21.65,<=30,IND,Away,Upto 2014
DR Parry,WI,Spin,1978-03-03,Port of Spain,West Indies,1978,1,49,102,2,1,269,461,9,220,359,7,29.88888888888889,<=30,WI,Home,Upto 2014
DR Parry,WI,Spin,1978-03-17,Bridgetown,West Indies,1978,1,44,72,1,1,226,371,4,182,299,3,56.5,>30,WI,Home,Upto 2014
DR Parry,WI,Spin,1978-03-31,Georgetown,West Indies,1978,2,100,192,2,1,414,708,7,314,516,5,59.142857142857146,>30,WI,Home,Upto 2014
DR Parry,WI,Spin,1978-04-15,Port of Spain,West Indies,1978,2,92,244,6,1,493,1205,23,401,961,17,21.434782608695652,<=30,WI,Home,Upto 2014
DR Parry,WI,Spin,1978-04-28,Kingston,West Indies,1978,2,75,138,1,1,606,1484,19,531,1346,18,31.894736842105264,>30,WI,Home,Upto 2014
DR Parry,WI,Spin,1978-12-01,Wankhede,India,1978,2,177,330,2,1,556,1295,9,379,965,7,61.77777777777778,>30,IND,Away,Upto 2014
DR Parry,WI,Spin,1978-12-15,Bengaluru,India,1978,1,22,72,1,1,411,996,8,389,924,7,51.375,>30,IND,Away,Upto 2014
DR Parry,WI,Spin,1978-12-29,Eden Gardens,India,1978,2,101,201,3,1,375,1048,13,274,847,10,28.846153846153847,<=30,IND,Away,Upto 2014
DR Parry,WI,Spin,1979-01-12,Chennai,India,1979,1,43,90,1,1,234,496,9,191,406,8,26.0,<=30,IND,Away,Upto 2014
DR Parry,WI,Spin,1979-01-24,Delhi,India,1979,1,43,102,0,1,226,544,8,183,442,8,28.25,<=30,IND,Away,Upto 2014
DR Parry,WI,Spin,1979-02-02,Kanpur,India,1979,1,127,234,2,1,445,1037,7,318,803,5,63.57142857142857,>30,IND,Away,Upto 2014
DR Parry,WI,Spin,1980-02-08,Dunedin,New Zealand,1980,1,63,132,2,1,109,276,3,46,144,1,36.333333333333336,>30,NZ,Away,Upto 2014
DR Pringle,ENG,Pace,1982-06-10,Lord's,England,1982,2,74,168,4,1,701,1384,31,627,1216,27,22.612903225806452,<=30,ENG,Home,Upto 2014
DR Pringle,ENG,Pace,1982-06-24,Manchester,England,1982,1,33,90,1,1,426,732,7,393,642,6,60.857142857142854,>30,ENG,Home,Upto 2014
DR Pringle,ENG,Pace,1982-07-08,The Oval,England,1982,2,112,234,2,1,668,1272,12,556,1038,10,55.666666666666664,>30,ENG,Home,Upto 2014
DR Pringle,ENG,Pace,1982-08-12,Lord's,England,1982,1,62,156,0,1,700,1644,21,638,1488,21,33.333333333333336,>30,ENG,Home,Upto 2014
DR Pringle,ENG,Pace,1982-11-12,W.A.C.A,Australia,1982,2,40,72,0,1,850,1760,19,810,1688,19,44.73684210526316,>30,AUS,Away,Upto 2014
DR Pringle,ENG,Pace,1982-12-10,Adelaide,Australia,1982,2,108,209,2,1,666,1305,27,558,1096,25,24.666666666666668,<=30,AUS,Away,Upto 2014
DR Pringle,ENG,Pace,1982-12-26,Melbourne,Australia,1982,2,66,162,2,1,837,1586,32,771,1424,30,26.15625,<=30,AUS,Away,Upto 2014
DR Pringle,ENG,Pace,1984-06-14,Birmingham,England,1984,1,108,186,5,1,672,1256,23,564,1070,18,29.217391304347824,<=30,ENG,Home,Upto 2014
DR Pringle,ENG,Pace,1984-06-28,Lord's,England,1984,2,98,114,0,1,986,1843,27,888,1729,27,36.51851851851852,>30,ENG,Home,Upto 2014
DR Pringle,ENG,Pace,1984-07-12,Leeds,England,1984,2,51,129,0,1,659,1294,24,608,1165,24,27.458333333333332,<=30,ENG,Home,Upto 2014
DR Pringle,ENG,Pace,1986-06-05,Lord's,England,1986,2,88,240,4,1,690,1580,26,602,1340,22,26.53846153846154,<=30,ENG,Home,Upto 2014
DR Pringle,ENG,Pace,1986-06-19,Leeds,England,1986,2,120,297,7,1,608,1416,31,488,1119,24,19.612903225806452,<=30,ENG,Home,Upto 2014
DR Pringle,ENG,Pace,1986-07-03,Birmingham,England,1986,2,94,222,2,1,804,1599,21,710,1377,19,38.285714285714285,>30,ENG,Home,Upto 2014
DR Pringle,ENG,Pace,1986-08-07,Nottingham,England,1986,2,74,132,0,1,656,1476,21,582,1344,21,31.238095238095237,>30,ENG,Home,Upto 2014
DR Pringle,ENG,Pace,1988-06-02,Nottingham,England,1988,1,82,204,1,1,781,1741,19,699,1537,18,41.10526315789474,>30,ENG,Home,Upto 2014
DR Pringle,ENG,Pace,1988-06-16,Lord's,England,1988,2,80,168,2,1,943,1804,37,863,1636,35,25.486486486486488,<=30,ENG,Home,Upto 2014
DR Pringle,ENG,Pace,1988-07-21,Leeds,England,1988,1,95,162,5,1,613,1328,28,518,1166,23,21.892857142857142,<=30,ENG,Home,Upto 2014
DR Pringle,ENG,Pace,1988-08-04,The Oval,England,1988,2,69,180,3,1,629,1534,24,560,1354,21,26.208333333333332,<=30,ENG,Home,Upto 2014
DR Pringle,ENG,Pace,1988-08-25,Lord's,England,1988,2,47,107,3,1,947,1904,31,900,1797,28,30.548387096774192,>30,ENG,Home,Upto 2014
DR Pringle,ENG,Pace,1989-06-08,Leeds,England,1989,2,183,275,1,1,1372,2385,30,1189,2110,29,45.733333333333334,>30,ENG,Home,Upto 2014
DR Pringle,ENG,Pace,1989-08-24,The Oval,England,1989,2,123,243,4,1,921,1691,26,798,1448,22,35.42307692307692,>30,ENG,Home,Upto 2014
DR Pringle,ENG,Pace,1991-06-06,Leeds,England,1991,2,52,186,4,1,749,1729,37,697,1543,33,20.243243243243242,<=30,ENG,Home,Upto 2014
DR Pringle,ENG,Pace,1991-06-20,Lord's,England,1991,1,100,211,5,1,685,1326,19,585,1115,14,36.05263157894737,>30,ENG,Home,Upto 2014
DR Pringle,ENG,Pace,1991-07-04,Nottingham,England,1991,2,91,192,2,1,833,1718,28,742,1526,26,29.75,<=30,ENG,Home,Upto 2014
DR Pringle,ENG,Pace,1991-07-25,Birmingham,England,1991,2,79,180,1,1,722,1721,32,643,1541,31,22.5625,<=30,ENG,Home,Upto 2014
DR Pringle,ENG,Pace,1992-01-18,Christchurch,New Zealand,1992,2,118,216,2,1,763,1516,14,645,1300,12,54.5,>30,NZ,Away,Upto 2014
DR Pringle,ENG,Pace,1992-01-30,Auckland,New Zealand,1992,2,44,132,3,1,740,1678,33,696,1546,30,22.424242424242426,<=30,NZ,Away,Upto 2014
DR Pringle,ENG,Pace,1992-06-04,Birmingham,England,1992,1,92,168,0,1,641,1086,9,549,918,9,71.22222222222223,>30,ENG,Home,Upto 2014
DR Pringle,ENG,Pace,1992-07-23,Leeds,England,1992,2,107,216,5,1,719,1557,27,612,1341,22,26.62962962962963,<=30,ENG,Home,Upto 2014
DR Pringle,ENG,Pace,1992-08-06,The Oval,England,1992,1,28,36,0,1,546,1176,25,518,1140,25,21.84,<=30,ENG,Home,Upto 2014
DR Smith,ENG,Pace,1961-11-11,Brabourne,India,1961,2,72,228,2,1,444,942,9,372,714,7,49.333333333333336,>30,IND,Away,Upto 2014
DR Smith,ENG,Pace,1961-12-01,Kanpur,India,1961,1,111,264,0,1,383,915,5,272,651,5,76.6,>30,IND,Away,Upto 2014
DR Smith,ENG,Pace,1961-12-13,Delhi,India,1961,1,66,180,1,1,206,507,4,140,327,3,51.5,>30,IND,Away,Upto 2014
DR Smith,ENG,Pace,1961-12-30,Eden Gardens,India,1961,2,75,204,2,1,412,930,9,337,726,7,45.77777777777778,>30,IND,Away,Upto 2014
DR Smith,ENG,Pace,1962-01-10,Chennai,India,1962,2,35,96,1,1,203,330,6,168,234,5,33.833333333333336,>30,IND,Away,Upto 2014
DR Smith,WI,Pace,2004-01-02,Cape Town,South Africa,2004,1,4,12,0,1,1140,1873,23,1136,1861,23,49.56521739130435,>30,SA,Away,Upto 2014
DR Smith,WI,Pace,2004-01-16,Centurion,South Africa,2004,1,42,78,1,1,1068,1800,24,1026,1722,23,44.5,>30,SA,Away,Upto 2014
DR Smith,WI,Pace,2004-03-19,Port of Spain,West Indies,2004,1,30,54,1,1,720,1489,29,690,1435,28,24.82758620689655,<=30,WI,Home,Upto 2014
DR Smith,WI,Pace,2004-05-28,Gros Islet,West Indies,2004,1,5,24,0,1,821,1459,16,816,1435,16,51.3125,>30,WI,Home,Upto 2014
DR Smith,WI,Pace,2004-06-04,Kingston,West Indies,2004,2,22,48,0,1,592,1032,15,570,984,15,39.46666666666667,>30,WI,Home,Upto 2014
DR Smith,WI,Pace,2004-08-19,The Oval,England,2004,1,50,84,0,1,794,1252,26,744,1168,26,30.53846153846154,>30,ENG,Away,Upto 2014
DR Smith,WI,Pace,2005-07-13,Colombo (SSC),Sri Lanka,2005,2,16,30,1,1,469,856,25,453,826,24,18.76,<=30,SL,Away,Upto 2014
DR Smith,WI,Pace,2005-11-25,Adelaide,Australia,2005,2,60,111,1,1,853,1575,23,793,1464,22,37.08695652173913,>30,AUS,Away,Upto 2014
DR Smith,WI,Pace,2006-03-09,Auckland,New Zealand,2006,2,115,210,3,1,867,1612,27,752,1402,24,32.111111111111114,>30,NZ,Away,Upto 2014
DR Tuffey,NZ,Pace,2000-03-31,Hamilton,New Zealand,2000,2,127,120,0,1,633,1061,24,506,941,24,26.375,<=30,NZ,Home,Upto 2014
DR Tuffey,NZ,Pace,2000-11-17,Bloemfontein,South Africa,2000,2,134,204,3,1,906,1955,31,772,1751,28,29.225806451612904,<=30,SA,Away,Upto 2014
DR Tuffey,NZ,Pace,2000-12-08,Johannesburg,South Africa,2000,1,60,114,0,1,417,1127,13,357,1013,13,32.07692307692308,>30,SA,Away,Upto 2014
DR Tuffey,NZ,Pace,2001-03-08,Auckland,New Zealand,2001,2,139,306,7,1,702,1474,24,563,1168,17,29.25,<=30,NZ,Home,Upto 2014
DR Tuffey,NZ,Pace,2001-03-15,Christchurch,New Zealand,2001,1,152,294,2,1,802,1722,12,650,1428,10,66.83333333333333,>30,NZ,Home,Upto 2014
DR Tuffey,NZ,Pace,2001-03-27,Hamilton,New Zealand,2001,2,77,179,7,1,506,942,23,429,763,16,22.0,<=30,NZ,Home,Upto 2014
DR Tuffey,NZ,Pace,2001-11-22,Hobart,Australia,2001,1,74,90,0,1,554,972,8,480,882,8,69.25,>30,AUS,Away,Upto 2014
DR Tuffey,NZ,Pace,2002-03-30,Auckland,New Zealand,2002,2,116,210,9,1,809,1459,39,693,1249,30,20.743589743589745,<=30,NZ,Home,Upto 2014
DR Tuffey,NZ,Pace,2002-05-01,Lahore,Pakistan,2002,1,94,150,2,1,476,866,17,382,716,15,28.0,<=30,PAK,Away,Upto 2014
DR Tuffey,NZ,Pace,2002-06-21,Bridgetown,West Indies,2002,2,59,132,2,1,787,1616,30,728,1484,28,26.233333333333334,<=30,WI,Away,Upto 2014
DR Tuffey,NZ,Pace,2002-12-12,Wellington,New Zealand,2002,2,60,150,5,1,505,1071,28,445,921,23,18.035714285714285,<=30,NZ,Home,Upto 2014
DR Tuffey,NZ,Pace,2002-12-19,Hamilton,New Zealand,2002,2,53,150,8,1,426,959,32,373,809,24,13.3125,<=30,NZ,Home,Upto 2014
DR Tuffey,NZ,Pace,2003-04-25,Colombo (PSS),Sri Lanka,2003,1,54,102,1,1,412,858,7,358,756,6,58.857142857142854,>30,SL,Away,Upto 2014
DR Tuffey,NZ,Pace,2003-05-03,Kandy,Sri Lanka,2003,2,63,174,1,1,352,866,14,289,692,13,25.142857142857142,<=30,SL,Away,Upto 2014
DR Tuffey,NZ,Pace,2003-10-08,Ahmedabad,India,2003,2,121,240,1,1,553,1086,9,432,846,8,61.44444444444444,>30,IND,Away,Upto 2014
DR Tuffey,NZ,Pace,2003-10-16,Mohali,India,2003,2,110,258,7,1,470,1014,9,360,756,2,52.22222222222222,>30,IND,Away,Upto 2014
DR Tuffey,NZ,Pace,2003-12-19,Hamilton,New Zealand,2003,1,87,198,5,1,863,1591,23,776,1393,18,37.52173913043478,>30,NZ,Home,Upto 2014
DR Tuffey,NZ,Pace,2003-12-26,Wellington,New Zealand,2003,2,87,228,1,1,696,1646,29,609,1418,28,24.0,<=30,NZ,Home,Upto 2014
DR Tuffey,NZ,Pace,2004-03-10,Hamilton,New Zealand,2004,2,90,246,1,1,760,1661,15,670,1415,14,50.666666666666664,>30,NZ,Home,Upto 2014
DR Tuffey,NZ,Pace,2004-03-18,Auckland,New Zealand,2004,2,54,168,1,1,1016,1973,29,962,1805,28,35.03448275862069,>30,NZ,Home,Upto 2014
DR Tuffey,NZ,Pace,2004-05-20,Lord's,England,2004,2,130,216,1,1,1118,2072,26,988,1856,25,43.0,>30,ENG,Away,Upto 2014
DR Tuffey,NZ,Pace,2004-06-03,Leeds,England,2004,2,116,181,2,1,915,1695,27,799,1514,25,33.888888888888886,>30,ENG,Away,Upto 2014
DR Tuffey,NZ,Pace,2009-12-03,Wellington,New Zealand,2009,2,109,236,4,1,635,1257,30,526,1021,26,21.166666666666668,<=30,NZ,Home,Upto 2014
DR Tuffey,NZ,Pace,2009-12-11,Napier,New Zealand,2009,2,113,219,4,1,858,1683,18,745,1464,14,47.666666666666664,>30,NZ,Home,Upto 2014
DR Tuffey,NZ,Pace,2010-02-15,Hamilton,New Zealand,2010,2,117,180,3,1,762,1104,17,645,924,14,44.8235294117647,>30,NZ,Home,Upto 2014
DR Tuffey,NZ,Pace,2010-03-19,Wellington,New Zealand,2010,1,49,132,0,1,767,1410,18,718,1278,18,42.611111111111114,>30,NZ,Home,Upto 2014
DRA Gehrs,AUS,Spin,1911-01-07,Adelaide,Australia,1911,1,4,6,0,1,814,1502,20,810,1496,20,40.7,>30,AUS,Home,Upto 2014
DS Atkinson,WI,Spin,1948-11-10,Delhi,India,1948,2,38,108,0,1,804,1710,13,766,1602,13,61.84615384615385,>30,IND,Away,Upto 2014
DS Atkinson,WI,Spin,1948-12-09,Brabourne,India,1948,2,47,162,1,1,780,1868,11,733,1706,10,70.9090909090909,>30,IND,Away,Upto 2014
DS Atkinson,WI,Spin,1948-12-31,Eden Gardens,India,1948,2,69,138,1,1,677,1523,19,608,1385,18,35.63157894736842,>30,IND,Away,Upto 2014
DS Atkinson,WI,Spin,1949-02-04,Brabourne,India,1949,2,70,156,3,1,580,1268,18,510,1112,15,32.22222222222222,>30,IND,Away,Upto 2014
DS Atkinson,WI,Spin,1952-01-25,Sydney,Australia,1952,2,43,112,0,1,474,1237,15,431,1125,15,31.6,>30,AUS,Away,Upto 2014
DS Atkinson,WI,Spin,1952-02-15,Auckland,New Zealand,1952,2,46,156,2,1,442,1192,12,396,1036,10,36.833333333333336,>30,NZ,Away,Upto 2014
DS Atkinson,WI,Spin,1954-02-06,Bridgetown,West Indies,1954,2,40,192,3,1,772,2250,20,732,2058,17,38.6,>30,WI,Home,Upto 2014
DS Atkinson,WI,Spin,1954-02-24,Georgetown,West Indies,1954,2,112,390,4,1,666,2079,21,554,1689,17,31.714285714285715,>30,WI,Home,Upto 2014
DS Atkinson,WI,Spin,1954-03-17,Port of Spain,West Indies,1954,2,72,216,0,1,1025,1930,13,953,1714,13,78.84615384615384,>30,WI,Home,Upto 2014
DS Atkinson,WI,Spin,1954-03-30,Kingston,West Indies,1954,2,90,264,1,1,581,1630,14,491,1366,13,41.5,>30,WI,Home,Upto 2014
DS Atkinson,WI,Spin,1955-03-26,Kingston,West Indies,1955,1,46,138,1,1,550,1394,11,504,1256,10,50.0,>30,WI,Home,Upto 2014
DS Atkinson,WI,Spin,1955-04-26,Georgetown,West Indies,1955,2,117,317,4,1,484,1365,24,367,1048,20,20.166666666666668,<=30,WI,Home,Upto 2014
DS Atkinson,WI,Spin,1955-05-14,Bridgetown,West Indies,1955,2,164,506,7,1,1042,2444,22,878,1938,15,47.36363636363637,>30,WI,Home,Upto 2014
DS Atkinson,WI,Spin,1955-06-11,Kingston,West Indies,1955,1,132,330,1,1,758,1737,11,626,1407,10,68.9090909090909,>30,WI,Home,Upto 2014
DS Atkinson,WI,Spin,1956-02-03,Dunedin,New Zealand,1956,2,27,120,2,1,439,1372,20,412,1252,18,21.95,<=30,NZ,Away,Upto 2014
DS Atkinson,WI,Spin,1956-02-18,Christchurch,New Zealand,1956,2,22,78,0,1,464,1136,24,442,1058,24,19.333333333333332,<=30,NZ,Away,Upto 2014
DS Atkinson,WI,Spin,1956-03-03,Wellington,New Zealand,1956,2,86,260,7,1,421,1506,19,335,1246,12,22.157894736842106,<=30,NZ,Away,Upto 2014
DS Atkinson,WI,Spin,1956-03-09,Auckland,New Zealand,1956,2,98,432,7,1,420,1482,16,322,1050,9,26.25,<=30,NZ,Away,Upto 2014
DS Atkinson,WI,Spin,1957-05-30,Birmingham,England,1957,2,167,508,1,1,809,2558,20,642,2050,19,40.45,>30,ENG,Away,Upto 2014
DS Atkinson,WI,Spin,1957-07-04,Nottingham,England,1957,2,100,246,1,1,731,1812,9,631,1566,8,81.22222222222223,>30,ENG,Away,Upto 2014
DS Atkinson,WI,Spin,1958-01-17,Bridgetown,West Indies,1958,1,61,372,1,1,679,1898,11,618,1526,10,61.72727272727273,>30,WI,Home,Upto 2014
DS Lehmann,AUS,Spin,1998-03-25,Bengaluru,India,1998,1,27,42,1,1,817,1511,22,790,1469,21,37.13636363636363,>30,IND,Away,Upto 2014
DS Lehmann,AUS,Spin,1998-10-01,Rawalpindi,Pakistan,1998,2,6,42,0,1,561,1319,19,555,1277,19,29.526315789473685,<=30,PAK,Away,Upto 2014
DS Lehmann,AUS,Spin,1998-10-22,Karachi,Pakistan,1998,2,12,18,1,1,832,1892,24,820,1874,23,34.666666666666664,>30,PAK,Away,Upto 2014
DS Lehmann,AUS,Spin,2002-11-07,Brisbane,Australia,2002,1,11,30,0,1,484,801,12,473,771,12,40.333333333333336,>30,AUS,Home,Upto 2014
DS Lehmann,AUS,Spin,2003-04-10,Georgetown,West Indies,2003,1,6,24,1,1,403,631,9,397,607,8,44.77777777777778,>30,WI,Away,Upto 2014
DS Lehmann,AUS,Spin,2003-04-19,Port of Spain,West Indies,2003,1,20,42,0,1,510,828,7,490,786,7,72.85714285714286,>30,WI,Away,Upto 2014
DS Lehmann,AUS,Spin,2003-05-01,Bridgetown,West Indies,2003,2,30,60,1,1,500,956,13,470,896,12,38.46153846153846,>30,WI,Away,Upto 2014
DS Lehmann,AUS,Spin,2003-07-25,Cairns,Australia,2003,1,4,18,0,1,356,572,12,352,554,12,29.666666666666668,<=30,AUS,Home,Upto 2014
DS Lehmann,AUS,Spin,2003-10-09,W.A.C.A,Australia,2003,2,64,200,3,1,603,903,11,539,703,8,54.81818181818182,>30,AUS,Home,Upto 2014
DS Lehmann,AUS,Spin,2004-03-08,Galle,Sri Lanka,2004,1,9,12,0,1,953,1791,32,944,1779,32,29.78125,<=30,SL,Away,Upto 2014
DS Lehmann,AUS,Spin,2004-03-24,Colombo (SSC),Sri Lanka,2004,2,92,216,6,1,844,1656,26,752,1440,20,32.46153846153846,>30,SL,Away,Upto 2014
DS Lehmann,AUS,Spin,2004-07-09,Cairns,Australia,2004,2,6,36,0,1,552,988,20,546,952,20,27.6,<=30,AUS,Home,Upto 2014
DS Lehmann,AUS,Spin,2004-10-06,Bengaluru,India,2004,1,14,36,0,1,685,1243,20,671,1207,20,34.25,>30,IND,Away,Upto 2014
DS Lehmann,AUS,Spin,2004-10-14,Chennai,India,2004,1,26,30,0,1,557,1169,24,531,1139,24,23.208333333333332,<=30,IND,Away,Upto 2014
DS Lehmann,AUS,Spin,2004-11-18,Brisbane,Australia,2004,1,12,24,0,1,278,563,12,266,539,12,23.166666666666668,<=30,AUS,Home,Upto 2014
DS Lehmann,AUS,Spin,2004-11-26,Adelaide,Australia,2004,2,55,108,2,1,578,1205,15,523,1097,13,38.53333333333333,>30,AUS,Home,Upto 2014
DS Lehmann,AUS,Spin,2004-12-16,W.A.C.A,Australia,2004,1,5,24,0,1,275,498,5,270,474,5,55.0,>30,AUS,Home,Upto 2014
DS Lehmann,AUS,Spin,2004-12-26,Melbourne,Australia,2004,1,13,12,0,1,412,701,11,399,689,11,37.45454545454545,>30,AUS,Home,Upto 2014
DS Mohanty,IND,Pace,1997-08-09,Colombo (SSC),Sri Lanka,1997,2,150,220,4,1,927,1577,19,777,1357,15,48.78947368421053,>30,SL,Away,Upto 2014
DS Mohanty,IND,Pace,1997-11-19,Mohali,India,1997,2,89,210,0,1,565,1196,16,476,986,16,35.3125,>30,IND,Home,Upto 2014
DS Smith,WI,Spin,2009-03-06,Port of Spain,West Indies,2009,1,3,6,0,1,578,1262,14,575,1256,14,41.285714285714285,>30,WI,Home,Upto 2014
DS Steele,ENG,Spin,1975-07-31,Lord's,England,1975,2,20,58,2,1,451,980,12,431,922,10,37.583333333333336,>30,ENG,Home,Upto 2014
DS Steele,ENG,Spin,1975-08-28,The Oval,England,1975,1,1,12,0,1,533,1243,6,532,1231,6,88.83333333333333,>30,ENG,Home,Upto 2014
DS Steele,ENG,Spin,1976-08-12,The Oval,England,1976,1,18,18,0,1,635,1217,8,617,1199,8,79.375,>30,ENG,Home,Upto 2014
DS Tomlinson,SA,Spin,1935-06-15,Nottingham,England,1935,1,38,60,0,1,343,876,8,305,816,8,42.875,>30,ENG,Away,Upto 2014
DS de Silva,SL,Spin,1982-02-17,Colombo (PSS),Sri Lanka,1982,2,92,257,3,1,442,1264,21,350,1007,18,21.047619047619047,<=30,SL,Home,Upto 2014
DS de Silva,SL,Spin,1982-03-05,Karachi,Pakistan,1982,2,201,384,7,1,669,1411,22,468,1027,15,30.40909090909091,>30,PAK,Away,Upto 2014
DS de Silva,SL,Spin,1982-03-14,Faisalabad,Pakistan,1982,2,162,300,9,1,699,1740,27,537,1440,18,25.88888888888889,<=30,PAK,Away,Upto 2014
DS de Silva,SL,Spin,1982-03-22,Lahore,Pakistan,1982,1,129,234,1,1,386,750,7,257,516,6,55.142857142857146,>30,PAK,Away,Upto 2014
DS de Silva,SL,Spin,1982-09-17,Chennai,India,1982,2,191,342,3,1,682,1194,13,491,852,10,52.46153846153846,>30,IND,Away,Upto 2014
DS de Silva,SL,Spin,1983-03-04,Christchurch,New Zealand,1983,1,41,137,1,1,53,167,1,12,30,0,53.0,>30,NZ,Away,Upto 2014
DS de Silva,SL,Spin,1983-03-11,Wellington,New Zealand,1983,2,31,90,2,1,31,90,2,0,0,0,15.5,<=30,NZ,Away,Upto 2014
DS de Silva,SL,Spin,1983-04-22,Kandy,Sri Lanka,1983,1,122,264,1,1,499,919,15,377,655,14,33.266666666666666,>30,SL,Home,Upto 2014
DS de Silva,SL,Spin,1984-03-09,Kandy,Sri Lanka,1984,2,128,300,4,1,410,807,17,282,507,13,24.11764705882353,<=30,SL,Home,Upto 2014
DS de Silva,SL,Spin,1984-03-16,Colombo (SSC),Sri Lanka,1984,2,70,201,2,1,166,567,3,96,366,1,55.333333333333336,>30,SL,Home,Upto 2014
DS de Silva,SL,Spin,1984-03-24,Colombo (CCC),Sri Lanka,1984,1,95,252,2,1,342,828,8,247,576,6,42.75,>30,SL,Home,Upto 2014
DS de Silva,SL,Spin,1984-08-23,Lord's,England,1984,1,85,270,2,1,242,726,5,157,456,3,48.4,>30,ENG,Away,Upto 2014
DT Dewdney,WI,Pace,1955-05-14,Bridgetown,West Indies,1955,2,148,258,4,1,574,1002,10,426,744,6,57.4,>30,WI,Home,Upto 2014
DT Dewdney,WI,Pace,1955-06-11,Kingston,West Indies,1955,1,115,144,1,1,633,1010,16,518,866,15,39.5625,>30,WI,Home,Upto 2014
DT Dewdney,WI,Pace,1956-02-18,Christchurch,New Zealand,1956,2,51,144,1,1,198,504,4,147,360,3,49.5,>30,NZ,Away,Upto 2014
DT Dewdney,WI,Pace,1956-03-03,Wellington,New Zealand,1956,2,80,168,2,1,372,822,9,292,654,7,41.333333333333336,>30,NZ,Away,Upto 2014
DT Dewdney,WI,Pace,1956-03-09,Auckland,New Zealand,1956,2,43,191,5,1,188,741,21,145,550,16,8.952380952380953,<=30,NZ,Away,Upto 2014
DT Dewdney,WI,Pace,1957-08-22,The Oval,England,1957,1,43,90,1,1,85,210,3,42,120,2,28.333333333333332,<=30,ENG,Away,Upto 2014
DT Dewdney,WI,Pace,1958-02-05,Port of Spain,West Indies,1958,2,79,210,2,1,632,1494,19,553,1284,17,33.26315789473684,>30,WI,Home,Upto 2014
DT Dewdney,WI,Pace,1958-02-26,Kingston,West Indies,1958,2,139,273,4,1,916,1594,17,777,1321,13,53.88235294117647,>30,WI,Home,Upto 2014
DT Dewdney,WI,Pace,1958-03-13,Georgetown,West Indies,1958,2,109,163,1,1,363,620,8,254,457,7,45.375,>30,WI,Home,Upto 2014
DT Hondo,ZIM,Pace,2001-09-07,Harare,Zimbabwe,2001,2,87,114,1,1,919,1718,19,832,1604,18,48.36842105263158,>30,ZIM,Home,Upto 2014
DT Hondo,ZIM,Pace,2003-05-22,Lord's,England,2003,1,45,84,0,1,641,1236,26,596,1152,26,24.653846153846153,<=30,ENG,Away,Upto 2014
DT Hondo,ZIM,Pace,2003-06-05,Chester-le-Street,England,2003,1,98,132,3,1,554,1098,27,456,966,24,20.51851851851852,<=30,ENG,Away,Upto 2014
DT Hondo,ZIM,Pace,2004-02-19,Harare,Zimbabwe,2004,2,73,190,5,1,617,1260,23,544,1070,18,26.82608695652174,<=30,ZIM,Home,Upto 2014
DT Hondo,ZIM,Pace,2004-02-26,Bulawayo,Zimbabwe,2004,1,25,108,2,1,218,510,6,193,402,4,36.333333333333336,>30,ZIM,Home,Upto 2014
DT Hondo,ZIM,Pace,2004-05-06,Harare,Zimbabwe,2004,1,103,162,1,1,612,996,20,509,834,19,30.6,>30,ZIM,Home,Upto 2014
DT Hondo,ZIM,Pace,2004-05-14,Bulawayo,Zimbabwe,2004,1,116,174,0,1,856,1362,13,740,1188,13,65.84615384615384,>30,ZIM,Home,Upto 2014
DT Hondo,ZIM,Pace,2005-01-06,Chattogram,Bangladesh,2005,2,131,264,3,1,681,1423,24,550,1159,21,28.375,<=30,BAN,Away,Upto 2014
DT Hondo,ZIM,Pace,2005-01-14,Dhaka,Bangladesh,2005,2,96,258,6,1,545,1416,17,449,1158,11,32.05882352941177,>30,BAN,Away,Upto 2014
DT Mutendera,ZIM,Pace,2000-09-12,Bulawayo,Zimbabwe,2000,1,29,84,0,1,470,1291,13,441,1207,13,36.15384615384615,>30,ZIM,Home,Upto 2014
DT Ring,AUS,Spin,1948-02-06,Melbourne,Australia,1948,2,120,328,6,1,478,1056,12,358,728,6,39.833333333333336,>30,AUS,Home,Upto 2014
DT Ring,AUS,Spin,1948-08-14,The Oval,England,1948,1,44,168,1,1,359,1083,14,315,915,13,25.642857142857142,<=30,ENG,Away,Upto 2014
DT Ring,AUS,Spin,1951-11-09,Brisbane,Australia,1951,2,132,240,8,1,714,1815,27,582,1575,19,26.444444444444443,<=30,AUS,Home,Upto 2014
DT Ring,AUS,Spin,1951-11-30,Sydney,Australia,1951,2,92,192,1,1,842,1964,19,750,1772,18,44.31578947368421,>30,AUS,Home,Upto 2014
DT Ring,AUS,Spin,1951-12-22,Adelaide,Australia,1951,1,62,133,3,1,501,1145,26,439,1012,23,19.26923076923077,<=30,AUS,Home,Upto 2014
DT Ring,AUS,Spin,1951-12-31,Melbourne,Australia,1951,2,60,128,0,1,557,1523,18,497,1395,18,30.944444444444443,>30,AUS,Home,Upto 2014
DT Ring,AUS,Spin,1952-01-25,Sydney,Australia,1952,1,44,104,1,1,474,1237,15,430,1133,14,31.6,>30,AUS,Home,Upto 2014
DT Ring,AUS,Spin,1952-12-05,Brisbane,Australia,1952,2,130,304,6,1,592,1609,17,462,1305,11,34.8235294117647,>30,AUS,Home,Upto 2014
DT Ring,AUS,Spin,1952-12-24,Melbourne,Australia,1952,2,187,392,3,1,730,1899,24,543,1507,21,30.416666666666668,>30,AUS,Home,Upto 2014
DT Ring,AUS,Spin,1953-01-09,Sydney,Australia,1953,2,77,192,1,1,515,1280,12,438,1088,11,42.916666666666664,>30,AUS,Home,Upto 2014
DT Ring,AUS,Spin,1953-01-24,Adelaide,Australia,1953,2,113,328,1,1,857,2379,23,744,2051,22,37.26086956521739,>30,AUS,Home,Upto 2014
DT Ring,AUS,Spin,1953-02-06,Melbourne,Australia,1953,2,117,257,2,1,952,2221,20,835,1964,18,47.6,>30,AUS,Home,Upto 2014
DT Ring,AUS,Spin,1953-06-25,Lord's,England,1953,2,127,258,2,1,753,1644,18,626,1386,16,41.833333333333336,>30,ENG,Away,Upto 2014
DT Tiripano,ZIM,Pace,2014-08-09,Harare,Zimbabwe,2014,1,65,156,2,1,362,1164,16,297,1008,14,22.625,<=30,ZIM,Home,After 1965
DT Tiripano,ZIM,Pace,2016-07-28,Bulawayo,Zimbabwe,2016,1,82,168,1,1,542,1115,20,460,947,19,27.1,<=30,ZIM,Home,After 1965
DT Tiripano,ZIM,Pace,2016-08-06,Bulawayo,Zimbabwe,2016,2,116,186,2,1,578,1230,11,462,1044,9,52.54545454545455,>30,ZIM,Home,After 1965
DT Tiripano,ZIM,Pace,2016-10-29,Harare,Zimbabwe,2016,2,104,204,0,1,716,1330,16,612,1126,16,44.75,>30,ZIM,Home,After 1965
DT Tiripano,ZIM,Pace,2016-11-06,Harare,Zimbabwe,2016,2,105,258,4,1,650,1231,14,545,973,10,46.42857142857143,>30,ZIM,Home,After 1965
DT Tiripano,ZIM,Pace,2017-07-14,Colombo (RPS),Sri Lanka,2017,1,38,60,1,1,358,598,6,320,538,5,59.666666666666664,>30,SL,Away,After 1965
DT Tiripano,ZIM,Pace,2018-11-11,Mirpur,Bangladesh,2018,2,96,214,3,1,422,1002,13,326,788,10,32.46153846153846,>30,BAN,Away,After 1965
DT Tiripano,ZIM,Pace,2020-01-19,Harare,Zimbabwe,2020,2,90,198,1,1,521,1458,17,431,1260,16,30.647058823529413,>30,ZIM,Home,After 1965
DT Tiripano,ZIM,Pace,2020-01-27,Harare,Zimbabwe,2020,2,45,240,1,1,441,1205,12,396,965,11,36.75,>30,ZIM,Home,After 1965
DT Tiripano,ZIM,Pace,2020-02-22,Mirpur,Bangladesh,2020,1,96,180,1,1,385,792,7,289,612,6,55.0,>30,BAN,Away,After 1965
DT Tiripano,ZIM,Pace,2021-03-02,Abu Dhabi,UAE,2021,2,47,129,4,1,239,474,18,192,345,14,13.277777777777779,<=30,UAE,Away,After 1965
DT Tiripano,ZIM,Pace,2021-03-10,Abu Dhabi,UAE,2021,2,100,148,0,1,415,797,6,315,649,6,69.16666666666667,>30,UAE,Away,After 1965
DT Tiripano,ZIM,Pace,2021-04-29,Harare,Zimbabwe,2021,1,89,138,3,1,469,921,23,380,783,20,20.391304347826086,<=30,ZIM,Home,After 1965
DT Tiripano,ZIM,Pace,2021-05-07,Harare,Zimbabwe,2021,1,83,132,1,1,481,1050,18,398,918,17,26.72222222222222,<=30,ZIM,Home,After 1965
DT Tiripano,ZIM,Pace,2021-07-07,Harare,Zimbabwe,2021,2,91,204,2,1,697,1302,16,606,1098,14,43.5625,>30,ZIM,Home,After 1965
DT Tiripano,ZIM,Pace,2023-02-12,Bulawayo,Zimbabwe,2023,1,26,78,0,1,266,519,11,240,441,11,24.181818181818183,<=30,ZIM,Home,After 1965
DV Lawrence,ENG,Pace,1988-08-25,Lord's,England,1988,2,111,216,3,1,947,1904,31,836,1688,28,30.548387096774192,>30,ENG,Home,Upto 2014
DV Lawrence,ENG,Pace,1991-07-04,Nottingham,England,1991,2,177,218,3,1,833,1718,28,656,1500,25,29.75,<=30,ENG,Home,Upto 2014
DV Lawrence,ENG,Pace,1991-08-08,The Oval,England,1991,2,173,251,7,1,826,1668,26,653,1417,19,31.76923076923077,>30,ENG,Home,Upto 2014
DV Lawrence,ENG,Pace,1991-08-22,Lord's,England,1991,2,144,229,4,1,770,1537,23,626,1308,19,33.47826086956522,>30,ENG,Home,Upto 2014
DV Lawrence,ENG,Pace,1992-02-06,Wellington,New Zealand,1992,2,71,175,1,1,603,1369,15,532,1194,14,40.2,>30,NZ,Away,Upto 2014
DV Smith,ENG,Pace,1957-07-04,Nottingham,England,1957,2,61,144,0,1,642,1416,17,581,1272,17,37.76470588235294,>30,ENG,Home,Upto 2014
DV Smith,ENG,Pace,1957-07-25,Leeds,England,1957,2,36,126,1,1,268,663,16,232,537,15,16.75,<=30,ENG,Home,Upto 2014
DVP Wright,ENG,Spin,1938-06-10,Nottingham,England,1938,2,238,456,5,1,958,2061,18,720,1605,13,53.22222222222222,>30,ENG,Home,Upto 2014
DVP Wright,ENG,Spin,1938-06-24,Lord's,England,1938,2,124,144,2,1,622,1129,16,498,985,14,38.875,>30,ENG,Home,Upto 2014
DVP Wright,ENG,Spin,1938-07-22,Leeds,England,1938,2,64,120,5,1,387,966,24,323,846,19,16.125,<=30,ENG,Home,Upto 2014
DVP Wright,ENG,Spin,1938-12-31,Cape Town,South Africa,1938,2,145,304,2,1,556,1422,11,411,1118,9,50.54545454545455,>30,SA,Away,Upto 2014
DVP Wright,ENG,Spin,1939-01-20,Durban,South Africa,1939,2,93,216,2,1,407,989,9,314,773,7,45.22222222222222,>30,SA,Away,Upto 2014
DVP Wright,ENG,Spin,1939-03-03,Durban,South Africa,1939,2,288,552,5,1,794,1998,16,506,1446,11,49.625,>30,SA,Away,Upto 2014
DVP Wright,ENG,Spin,1939-06-24,Lord's,England,1939,2,132,240,5,1,311,784,11,179,544,6,28.272727272727273,<=30,ENG,Home,Upto 2014
DVP Wright,ENG,Spin,1939-07-22,Manchester,England,1939,2,29,64,1,1,184,368,9,155,304,8,20.444444444444443,<=30,ENG,Home,Upto 2014
DVP Wright,ENG,Spin,1939-08-19,The Oval,England,1939,1,53,104,0,1,434,768,4,381,664,4,108.5,>30,ENG,Home,Upto 2014
DVP Wright,ENG,Spin,1946-06-22,Lord's,England,1946,2,121,222,4,1,376,791,8,255,569,4,47.0,>30,ENG,Home,Upto 2014
DVP Wright,ENG,Spin,1946-07-20,Manchester,England,1946,2,29,24,0,1,221,522,7,192,498,7,31.571428571428573,>30,ENG,Home,Upto 2014
DVP Wright,ENG,Spin,1946-11-29,Brisbane,Australia,1946,1,167,350,5,1,284,598,7,117,248,2,40.57142857142857,>30,AUS,Away,Upto 2014
DVP Wright,ENG,Spin,1946-12-13,Sydney,Australia,1946,1,169,368,1,1,831,1933,19,662,1565,18,43.73684210526316,>30,AUS,Away,Upto 2014
DVP Wright,ENG,Spin,1947-01-01,Melbourne,Australia,1947,2,255,464,5,1,582,1365,14,327,901,9,41.57142857142857,>30,AUS,Away,Upto 2014
DVP Wright,ENG,Spin,1947-01-31,Adelaide,Australia,1947,2,201,332,3,1,672,1532,8,471,1200,5,84.0,>30,AUS,Away,Upto 2014
DVP Wright,ENG,Spin,1947-02-28,Sydney,Australia,1947,2,198,408,9,1,494,1134,15,296,726,6,32.93333333333333,>30,AUS,Away,Upto 2014
DVP Wright,ENG,Spin,1947-03-21,Christchurch,New Zealand,1947,1,61,78,0,1,205,294,0,144,216,0,inf,>30,NZ,Away,Upto 2014
DVP Wright,ENG,Spin,1947-06-21,Lord's,England,1947,2,175,428,10,1,699,1857,18,524,1429,8,38.833333333333336,>30,ENG,Home,Upto 2014
DVP Wright,ENG,Spin,1947-07-05,Manchester,England,1947,2,62,114,3,1,418,900,10,356,786,7,41.8,>30,ENG,Home,Upto 2014
DVP Wright,ENG,Spin,1947-07-26,Leeds,England,1947,2,55,204,2,1,420,1282,10,365,1078,8,42.0,>30,ENG,Home,Upto 2014
DVP Wright,ENG,Spin,1947-08-16,The Oval,England,1947,2,192,354,4,1,893,1980,23,701,1626,19,38.82608695652174,>30,ENG,Home,Upto 2014
DVP Wright,ENG,Spin,1948-06-24,Lord's,England,1948,2,123,243,2,1,442,1043,11,319,800,9,40.18181818181818,>30,ENG,Home,Upto 2014
DVP Wright,ENG,Spin,1948-12-16,Durban,South Africa,1948,2,101,280,5,1,426,1415,21,325,1135,16,20.285714285714285,<=30,SA,Away,Upto 2014
DVP Wright,ENG,Spin,1948-12-27,Johannesburg,South Africa,1948,2,139,320,4,1,725,1588,13,586,1268,9,55.76923076923077,>30,SA,Away,Upto 2014
DVP Wright,ENG,Spin,1949-01-01,Cape Town,South Africa,1949,2,76,88,0,1,568,1444,18,492,1356,18,31.555555555555557,>30,SA,Away,Upto 2014
DVP Wright,ENG,Spin,1949-08-13,The Oval,England,1949,2,114,168,1,1,597,1082,15,483,914,14,39.8,>30,ENG,Home,Upto 2014
DVP Wright,ENG,Spin,1950-08-12,The Oval,England,1950,1,141,318,5,1,654,1981,25,513,1663,20,26.16,<=30,ENG,Home,Upto 2014
DVP Wright,ENG,Spin,1950-12-01,Brisbane,Australia,1950,1,81,128,1,1,252,496,14,171,368,13,18.0,<=30,AUS,Away,Upto 2014
DVP Wright,ENG,Spin,1950-12-22,Melbourne,Australia,1950,2,105,136,1,1,357,991,20,252,855,19,17.85,<=30,AUS,Away,Upto 2014
DVP Wright,ENG,Spin,1951-02-02,Adelaide,Australia,1951,2,208,368,6,1,793,1857,24,585,1489,18,33.041666666666664,>30,AUS,Away,Upto 2014
DVP Wright,ENG,Spin,1951-02-23,Melbourne,Australia,1951,2,106,192,3,1,462,1120,13,356,928,10,35.53846153846154,>30,AUS,Away,Upto 2014
DVP Wright,ENG,Spin,1951-03-17,Christchurch,New Zealand,1951,1,99,162,2,1,586,1337,15,487,1175,13,39.06666666666667,>30,NZ,Away,Upto 2014
DVP Wright,ENG,Spin,1951-03-24,Wellington,New Zealand,1951,2,80,186,5,1,366,1136,25,286,950,20,14.64,<=30,NZ,Away,Upto 2014
DW Begbie,SA,Spin,1948-12-27,Johannesburg,South Africa,1948,1,38,48,0,1,725,1588,13,687,1540,13,55.76923076923077,>30,SA,Home,Upto 2014
DW Begbie,SA,Spin,1950-02-10,Johannesburg,South Africa,1950,2,54,80,0,1,517,1176,4,463,1096,4,129.25,>30,SA,Home,Upto 2014
DW Begbie,SA,Spin,1950-03-03,Gqeberha,South Africa,1950,1,38,32,1,1,463,890,16,425,858,15,28.9375,<=30,SA,Home,Upto 2014
DW Carr,ENG,Spin,1909-08-09,The Oval,England,1909,2,282,414,7,1,627,1104,11,345,690,4,57.0,>30,ENG,Home,Upto 2014
DW Fleming,AUS,Pace,1994-10-05,Rawalpindi,Pakistan,1994,2,161,288,7,1,838,1506,23,677,1218,16,36.43478260869565,>30,PAK,Away,Upto 2014
DW Fleming,AUS,Pace,1994-12-24,Melbourne,Australia,1994,2,54,120,2,1,587,1268,21,533,1148,19,27.952380952380953,<=30,AUS,Home,Upto 2014
DW Fleming,AUS,Pace,1995-01-01,Sydney,Australia,1995,2,118,278,5,1,651,1345,27,533,1067,22,24.11111111111111,<=30,AUS,Home,Upto 2014
DW Fleming,AUS,Pace,1995-01-26,Adelaide,Australia,1995,2,102,216,3,1,823,1644,27,721,1428,24,30.48148148148148,>30,AUS,Home,Upto 2014
DW Fleming,AUS,Pace,1998-10-01,Rawalpindi,Pakistan,1998,2,77,210,3,1,337,761,10,260,551,7,33.7,>30,PAK,Away,Upto 2014
DW Fleming,AUS,Pace,1998-10-15,Peshawar,Pakistan,1998,1,103,211,1,1,690,1183,11,587,972,10,62.72727272727273,>30,PAK,Away,Upto 2014
DW Fleming,AUS,Pace,1998-11-20,Brisbane,Australia,1998,2,95,204,0,1,919,1808,20,824,1604,20,45.95,>30,AUS,Home,Upto 2014
DW Fleming,AUS,Pace,1998-11-28,W.A.C.A,Australia,1998,2,91,198,9,1,564,1246,31,473,1048,22,18.193548387096776,<=30,AUS,Home,Upto 2014
DW Fleming,AUS,Pace,1998-12-11,Adelaide,Australia,1998,2,90,191,5,1,622,1222,21,532,1031,16,29.61904761904762,<=30,AUS,Home,Upto 2014
DW Fleming,AUS,Pace,1998-12-26,Melbourne,Australia,1998,2,116,216,2,1,840,1515,33,724,1299,31,25.454545454545453,<=30,AUS,Home,Upto 2014
DW Fleming,AUS,Pace,1999-09-22,Galle,Sri Lanka,1999,2,89,162,2,1,252,497,5,163,335,3,50.4,>30,SL,Away,Upto 2014
DW Fleming,AUS,Pace,1999-09-30,Colombo (SSC),Sri Lanka,1999,1,14,35,3,1,116,297,8,102,262,5,14.5,<=30,SL,Away,Upto 2014
DW Fleming,AUS,Pace,1999-10-14,Harare,Zimbabwe,1999,2,53,216,2,1,535,1322,16,482,1106,14,33.4375,>30,ZIM,Away,Upto 2014
DW Fleming,AUS,Pace,1999-11-05,Brisbane,Australia,1999,2,124,271,9,1,895,1510,23,771,1239,14,38.91304347826087,>30,AUS,Home,Upto 2014
DW Fleming,AUS,Pace,1999-11-18,Hobart,Australia,1999,2,143,323,4,1,857,1577,19,714,1254,15,45.10526315789474,>30,AUS,Home,Upto 2014
DW Fleming,AUS,Pace,1999-11-26,W.A.C.A,Australia,1999,2,134,232,5,1,717,1143,27,583,911,22,26.555555555555557,<=30,AUS,Home,Upto 2014
DW Fleming,AUS,Pace,1999-12-10,Adelaide,Australia,1999,2,100,203,8,1,755,1459,27,655,1256,19,27.962962962962962,<=30,AUS,Home,Upto 2014
DW Fleming,AUS,Pace,1999-12-26,Melbourne,Australia,1999,2,108,219,3,1,715,1451,26,607,1232,23,27.5,<=30,AUS,Home,Upto 2014
DW Fleming,AUS,Pace,2000-01-02,Sydney,Australia,2000,2,71,156,1,1,643,1127,22,572,971,21,29.227272727272727,<=30,AUS,Home,Upto 2014
DW Fleming,AUS,Pace,2001-02-27,Wankhede,India,2001,2,99,180,1,1,373,790,15,274,610,14,24.866666666666667,<=30,IND,Away,Upto 2014
DW Gregory,AUS,Spin,1877-03-15,Melbourne,Australia,1877,1,9,20,0,1,437,1296,31,428,1276,31,14.096774193548388,<=30,AUS,Home,After 1965
DW Headley,ENG,Pace,1997-07-03,Manchester,England,1997,2,176,339,8,1,664,1429,26,488,1090,18,25.53846153846154,<=30,ENG,Home,Upto 2014
DW Headley,ENG,Pace,1997-07-24,Leeds,England,1997,1,125,150,2,1,800,1403,28,675,1253,26,28.571428571428573,<=30,ENG,Home,Upto 2014
DW Headley,ENG,Pace,1997-08-07,Nottingham,England,1997,2,143,299,6,1,974,1617,31,831,1318,25,31.419354838709676,>30,ENG,Home,Upto 2014
DW Headley,ENG,Pace,1998-02-05,Port of Spain,West Indies,1998,2,115,228,4,1,715,1728,33,600,1500,29,21.666666666666668,<=30,WI,Away,Upto 2014
DW Headley,ENG,Pace,1998-02-13,Port of Spain,West Indies,1998,2,117,240,4,1,618,1619,31,501,1379,27,19.93548387096774,<=30,WI,Away,Upto 2014
DW Headley,ENG,Pace,1998-02-27,Georgetown,West Indies,1998,2,127,264,6,1,412,1052,21,285,788,15,19.61904761904762,<=30,WI,Away,Upto 2014
DW Headley,ENG,Pace,1998-03-12,Bridgetown,West Indies,1998,2,78,117,3,1,686,1395,17,608,1278,14,40.35294117647059,>30,WI,Away,Upto 2014
DW Headley,ENG,Pace,1998-03-20,St John's,West Indies,1998,1,109,180,2,1,587,1147,18,478,967,16,32.611111111111114,>30,WI,Away,Upto 2014
DW Headley,ENG,Pace,1998-06-18,Lord's,England,1998,1,69,132,2,1,618,1463,26,549,1331,24,23.76923076923077,<=30,ENG,Home,Upto 2014
DW Headley,ENG,Pace,1998-12-11,Adelaide,Australia,1998,2,175,246,5,1,622,1222,21,447,976,16,29.61904761904762,<=30,AUS,Away,Upto 2014
DW Headley,ENG,Pace,1998-12-26,Melbourne,Australia,1998,2,146,252,6,1,840,1515,33,694,1263,27,25.454545454545453,<=30,AUS,Away,Upto 2014
DW Headley,ENG,Pace,1999-01-02,Sydney,Australia,1999,2,102,231,8,1,361,687,17,259,456,9,21.235294117647058,<=30,AUS,Away,Upto 2014
DW Headley,ENG,Pace,1999-07-22,Lord's,England,1999,1,74,162,3,1,642,1427,25,568,1265,22,25.68,<=30,ENG,Home,Upto 2014
DW Headley,ENG,Pace,1999-08-05,Manchester,England,1999,1,115,186,1,1,505,1189,11,390,1003,10,45.90909090909091,>30,ENG,Home,Upto 2014
DW Hookes,AUS,Spin,1979-12-01,Brisbane,Australia,1979,1,15,30,0,1,171,384,1,156,354,1,171.0,>30,AUS,Home,Upto 2014
DW Hookes,AUS,Spin,1982-11-12,W.A.C.A,Australia,1982,1,2,6,0,1,325,796,12,323,790,12,27.083333333333332,<=30,AUS,Home,Upto 2014
DW Hookes,AUS,Spin,1982-11-26,Brisbane,Australia,1982,1,4,12,0,1,274,868,5,270,856,5,54.8,>30,AUS,Home,Upto 2014
DW Hookes,AUS,Spin,1982-12-10,Adelaide,Australia,1982,1,9,18,0,1,299,810,4,290,792,4,74.75,>30,AUS,Home,Upto 2014
DW Hookes,AUS,Spin,1983-01-02,Sydney,Australia,1983,1,5,12,0,1,585,1269,15,580,1257,15,39.0,>30,AUS,Home,Upto 2014
DW Hookes,AUS,Spin,1985-11-30,W.A.C.A,Australia,1985,1,2,6,0,1,164,587,6,162,581,6,27.333333333333332,<=30,AUS,Home,Upto 2014
DW Hookes,AUS,Spin,1985-12-13,Adelaide,Australia,1985,1,4,12,1,1,282,786,3,278,774,2,94.0,>30,AUS,Home,Upto 2014
DW Lawrence,ENG,Spin,2021-01-14,Galle,Sri Lanka,2021,1,10,12,0,1,751,1413,23,741,1401,23,32.65217391304348,>30,SL,Away,After 1965
DW Lawrence,ENG,Spin,2021-02-13,Chennai,India,2021,1,7,6,0,1,686,1393,32,679,1387,32,21.4375,<=30,IND,Away,After 1965
DW Lawrence,ENG,Spin,2021-06-10,Birmingham,England,2021,1,16,18,1,1,120,246,5,104,228,4,24.0,<=30,ENG,Home,After 1965
DW Lawrence,ENG,Spin,2022-03-08,North Sound,West Indies,2022,2,7,48,1,1,307,730,6,300,682,5,51.166666666666664,>30,WI,Away,After 1965
DW Lawrence,ENG,Spin,2022-03-16,Bridgetown,West Indies,2022,2,57,126,1,1,465,1126,13,408,1000,12,35.76923076923077,>30,WI,Away,After 1965
DW Lawrence,ENG,Spin,2024-08-21,Manchester,England,2024,1,5,6,0,1,370,678,9,365,672,9,41.111111111111114,>30,ENG,Home,After 1965
DW Lawrence,ENG,Spin,2024-08-29,Lord's,England,2024,1,2,6,0,1,342,540,5,340,534,5,68.4,>30,ENG,Home,After 1965
DW Lawrence,ENG,Spin,2024-09-06,The Oval,England,2024,1,29,36,0,1,123,161,3,94,125,3,41.0,>30,ENG,Home,After 1965
DW Randall,ENG,Pace,1977-12-14,Lahore,Pakistan,1977,1,2,8,0,1,359,1064,11,357,1056,11,32.63636363636363,>30,PAK,Away,Upto 2014
DW Randall,ENG,Pace,1978-03-04,Auckland,New Zealand,1978,1,1,8,0,1,754,2126,17,753,2118,17,44.35294117647059,>30,NZ,Away,Upto 2014
DW Steyn,SA,Pace,2004-12-17,Gqeberha,South Africa,2004,2,146,191,3,1,915,1720,27,769,1529,24,33.888888888888886,>30,SA,Home,Upto 2014
DW Steyn,SA,Pace,2004-12-26,Durban,South Africa,2004,2,148,231,3,1,968,1978,29,820,1747,26,33.37931034482759,>30,SA,Home,Upto 2014
DW Steyn,SA,Pace,2005-01-13,Johannesburg,South Africa,2005,2,122,180,2,1,1212,2062,34,1090,1882,32,35.64705882352941,>30,SA,Home,Upto 2014
DW Steyn,SA,Pace,2006-04-15,Centurion,South Africa,2006,2,142,214,7,1,858,1550,38,716,1336,31,22.57894736842105,<=30,SA,Home,Upto 2014
DW Steyn,SA,Pace,2006-04-27,Cape Town,South Africa,2006,2,140,240,2,1,739,1386,13,599,1146,11,56.84615384615385,>30,SA,Home,Upto 2014
DW Steyn,SA,Pace,2006-05-05,Johannesburg,South Africa,2006,2,134,204,7,1,757,1280,36,623,1076,29,21.02777777777778,<=30,SA,Home,Upto 2014
DW Steyn,SA,Pace,2006-07-27,Colombo (SSC),Sri Lanka,2006,1,129,156,3,1,781,1191,14,652,1035,11,55.785714285714285,>30,SL,Away,Upto 2014
DW Steyn,SA,Pace,2006-08-04,Colombo (PSS),Sri Lanka,2006,2,163,215,5,1,843,1453,20,680,1238,15,42.15,>30,SL,Away,Upto 2014
DW Steyn,SA,Pace,2006-12-15,Johannesburg,South Africa,2006,1,26,61,0,1,728,1389,33,702,1328,33,22.060606060606062,<=30,SA,Home,Upto 2014
DW Steyn,SA,Pace,2007-01-02,Cape Town,South Africa,2007,2,88,204,6,1,634,1285,20,546,1081,14,31.7,>30,SA,Home,Upto 2014
DW Steyn,SA,Pace,2007-01-26,Cape Town,South Africa,2007,2,87,144,4,1,527,865,27,440,721,23,19.51851851851852,<=30,SA,Home,Upto 2014
DW Steyn,SA,Pace,2007-10-01,Karachi,Pakistan,2007,2,106,171,7,1,523,1031,16,417,860,9,32.6875,>30,PAK,Away,Upto 2014
DW Steyn,SA,Pace,2007-10-08,Lahore,Pakistan,2007,2,116,162,2,1,635,1158,14,519,996,12,45.357142857142854,>30,PAK,Away,Upto 2014
DW Steyn,SA,Pace,2007-11-08,Johannesburg,South Africa,2007,2,93,189,10,1,740,1372,29,647,1183,19,25.517241379310345,<=30,SA,Home,Upto 2014
DW Steyn,SA,Pace,2007-11-16,Centurion,South Africa,2007,2,91,147,10,1,609,994,26,518,847,16,23.423076923076923,<=30,SA,Home,Upto 2014
DW Steyn,SA,Pace,2007-12-26,Gqeberha,South Africa,2007,2,188,288,5,1,900,1655,32,712,1367,27,28.125,<=30,SA,Home,Upto 2014
DW Steyn,SA,Pace,2008-01-02,Cape Town,South Africa,2008,2,104,239,8,1,787,1720,28,683,1481,20,28.107142857142858,<=30,SA,Home,Upto 2014
DW Steyn,SA,Pace,2008-01-10,Durban,South Africa,2008,2,90,179,7,1,883,1304,22,793,1125,15,40.13636363636363,>30,SA,Home,Upto 2014
DW Steyn,SA,Pace,2008-02-22,Mirpur,Bangladesh,2008,2,75,178,7,1,379,784,18,304,606,11,21.055555555555557,<=30,BAN,Away,Upto 2014
DW Steyn,SA,Pace,2008-02-29,Chattogram,Bangladesh,2008,2,101,198,7,1,376,687,12,275,489,5,31.333333333333332,>30,BAN,Away,Upto 2014
DW Steyn,SA,Pace,2008-03-26,Chennai,India,2008,1,103,192,4,1,691,1044,8,588,852,4,86.375,>30,IND,Away,Upto 2014
DW Steyn,SA,Pace,2008-04-03,Ahmedabad,India,2008,2,114,186,8,1,574,946,21,460,760,13,27.333333333333332,<=30,IND,Away,Upto 2014
DW Steyn,SA,Pace,2008-04-11,Kanpur,India,2008,2,86,132,3,1,346,693,14,260,561,11,24.714285714285715,<=30,IND,Away,Upto 2014
DW Steyn,SA,Pace,2008-07-10,Lord's,England,2008,1,117,210,1,1,845,1704,13,728,1494,12,65.0,>30,ENG,Away,Upto 2014
DW Steyn,SA,Pace,2008-07-18,Leeds,England,2008,2,173,279,7,1,905,1732,27,732,1453,20,33.51851851851852,>30,ENG,Away,Upto 2014
DW Steyn,SA,Pace,2008-11-19,Bloemfontein,South Africa,2008,2,99,162,7,1,387,770,21,288,608,14,18.428571428571427,<=30,SA,Home,Upto 2014
DW Steyn,SA,Pace,2008-11-26,Centurion,South Africa,2008,2,103,150,1,1,529,990,19,426,840,18,27.842105263157894,<=30,SA,Home,Upto 2014
DW Steyn,SA,Pace,2008-12-17,W.A.C.A,Australia,2008,2,162,252,4,1,940,1782,28,778,1530,24,33.57142857142857,>30,AUS,Away,Upto 2014
DW Steyn,SA,Pace,2008-12-26,Melbourne,Australia,2008,2,154,296,10,1,952,1716,26,798,1420,16,36.61538461538461,>30,AUS,Away,Upto 2014
DW Steyn,SA,Pace,2009-01-03,Sydney,Australia,2009,2,155,240,4,1,952,2011,26,797,1771,22,36.61538461538461,>30,AUS,Away,Upto 2014
DW Steyn,SA,Pace,2009-02-26,Johannesburg,South Africa,2009,2,164,280,5,1,938,1937,36,774,1657,31,26.055555555555557,<=30,SA,Home,Upto 2014
DW Steyn,SA,Pace,2009-03-06,Durban,South Africa,2009,2,158,248,4,1,857,1739,26,699,1491,22,32.96153846153846,>30,SA,Home,Upto 2014
DW Steyn,SA,Pace,2009-03-19,Cape Town,South Africa,2009,2,152,258,7,1,890,1587,18,738,1329,11,49.44444444444444,>30,SA,Home,Upto 2014
DW Steyn,SA,Pace,2009-12-26,Durban,South Africa,2009,1,94,204,2,1,616,1251,15,522,1047,13,41.06666666666667,>30,SA,Home,Upto 2014
DW Steyn,SA,Pace,2010-01-03,Cape Town,South Africa,2010,2,148,342,6,1,868,1767,26,720,1425,20,33.38461538461539,>30,SA,Home,Upto 2014
DW Steyn,SA,Pace,2010-01-14,Johannesburg,South Africa,2010,2,115,167,7,1,644,1109,23,529,942,16,28.0,<=30,SA,Home,Upto 2014
DW Steyn,SA,Pace,2010-02-06,Nagpur,India,2010,2,108,209,10,1,534,1007,19,426,798,9,28.105263157894736,<=30,IND,Away,Upto 2014
DW Steyn,SA,Pace,2010-02-14,Eden Gardens,India,2010,1,115,180,1,1,646,954,10,531,774,9,64.6,>30,IND,Away,Upto 2014
DW Steyn,SA,Pace,2010-06-10,Port of Spain,West Indies,2010,2,94,177,8,1,433,932,18,339,755,10,24.055555555555557,<=30,WI,Away,Upto 2014
DW Steyn,SA,Pace,2010-06-18,Basseterre,West Indies,2010,1,105,174,1,1,644,1267,9,539,1093,8,71.55555555555556,>30,WI,Away,Upto 2014
DW Steyn,SA,Pace,2010-06-26,Bridgetown,West Indies,2010,2,73,144,6,1,416,803,18,343,659,12,23.11111111111111,<=30,WI,Away,Upto 2014
DW Steyn,SA,Pace,2010-11-12,Dubai (DICS),UAE,2010,2,140,240,2,1,500,966,12,360,726,10,41.666666666666664,>30,UAE,Away,Upto 2014
DW Steyn,SA,Pace,2010-11-20,Abu Dhabi,UAE,2010,2,138,258,4,1,798,1290,13,660,1032,9,61.38461538461539,>30,UAE,Away,Upto 2014
DW Steyn,SA,Pace,2010-12-16,Centurion,South Africa,2010,2,139,241,7,1,795,1278,19,656,1037,12,41.8421052631579,>30,SA,Home,Upto 2014
DW Steyn,SA,Pace,2010-12-26,Durban,South Africa,2010,2,110,209,8,1,613,1119,31,503,910,23,19.774193548387096,<=30,SA,Home,Upto 2014
DW Steyn,SA,Pace,2011-01-02,Cape Town,South Africa,2011,2,118,294,6,1,846,1680,22,728,1386,16,38.45454545454545,>30,SA,Home,Upto 2014
DW Steyn,SA,Pace,2011-11-09,Cape Town,South Africa,2011,2,78,150,6,1,597,929,31,519,779,25,19.258064516129032,<=30,SA,Home,Upto 2014
DW Steyn,SA,Pace,2011-11-17,Johannesburg,South Africa,2011,2,162,246,5,1,938,1680,27,776,1434,22,34.74074074074074,>30,SA,Home,Upto 2014
DW Steyn,SA,Pace,2011-12-15,Centurion,South Africa,2011,2,54,124,6,1,635,1013,25,581,889,19,25.4,<=30,SA,Home,Upto 2014
DW Steyn,SA,Pace,2011-12-26,Durban,South Africa,2011,2,136,258,5,1,674,1304,26,538,1046,21,25.923076923076923,<=30,SA,Home,Upto 2014
DW Steyn,SA,Pace,2012-01-03,Cape Town,South Africa,2012,2,112,240,3,1,828,1318,18,716,1078,15,46.0,>30,SA,Home,Upto 2014
DW Steyn,SA,Pace,2012-03-07,Dunedin,New Zealand,2012,2,104,170,2,1,860,1498,21,756,1328,19,40.95238095238095,>30,NZ,Away,Upto 2014
DW Steyn,SA,Pace,2012-03-15,Hamilton,New Zealand,2012,2,80,204,5,1,549,1079,27,469,875,22,20.333333333333332,<=30,NZ,Away,Upto 2014
DW Steyn,SA,Pace,2012-03-23,Wellington,New Zealand,2012,2,55,228,2,1,873,1620,25,818,1392,23,34.92,>30,NZ,Away,Upto 2014
DW Steyn,SA,Pace,2012-07-19,The Oval,England,2012,2,155,306,7,1,900,1787,18,745,1481,11,50.0,>30,ENG,Away,Upto 2014
DW Steyn,SA,Pace,2012-08-02,Leeds,England,2012,2,128,210,3,1,982,1920,23,854,1710,20,42.69565217391305,>30,ENG,Away,Upto 2014
DW Steyn,SA,Pace,2012-08-16,Lord's,England,2012,2,155,270,5,1,927,1840,33,772,1570,28,28.09090909090909,<=30,ENG,Away,Upto 2014
DW Steyn,SA,Pace,2012-11-09,Brisbane,Australia,2012,1,129,180,1,1,917,1756,14,788,1576,13,65.5,>30,AUS,Away,Upto 2014
DW Steyn,SA,Pace,2012-11-22,Adelaide,Australia,2012,2,129,244,4,1,863,1649,28,734,1405,24,30.821428571428573,>30,AUS,Away,Upto 2014
DW Steyn,SA,Pace,2012-11-30,W.A.C.A,Australia,2012,2,112,233,7,1,885,1522,30,773,1289,23,29.5,<=30,AUS,Away,Upto 2014
DW Steyn,SA,Pace,2013-01-02,Cape Town,South Africa,2013,2,85,224,5,1,547,1103,26,462,879,21,21.03846153846154,<=30,SA,Home,Upto 2014
DW Steyn,SA,Pace,2013-01-11,Gqeberha,South Africa,2013,2,65,172,8,1,619,1262,23,554,1090,15,26.91304347826087,<=30,SA,Home,Upto 2014
DW Steyn,SA,Pace,2013-02-01,Johannesburg,South Africa,2013,2,60,221,11,1,592,1253,26,532,1032,15,22.76923076923077,<=30,SA,Home,Upto 2014
DW Steyn,SA,Pace,2013-02-14,Cape Town,South Africa,2013,2,93,261,4,1,620,1269,20,527,1008,16,31.0,>30,SA,Home,Upto 2014
DW Steyn,SA,Pace,2013-02-22,Centurion,South Africa,2013,2,105,210,5,1,578,1050,26,473,840,21,22.23076923076923,<=30,SA,Home,Upto 2014
DW Steyn,SA,Pace,2013-10-14,Abu Dhabi,UAE,2013,2,95,202,4,1,476,1024,18,381,822,14,26.444444444444443,<=30,UAE,Away,Upto 2014
DW Steyn,SA,Pace,2013-10-23,Dubai (DICS),UAE,2013,2,86,214,4,1,404,958,9,318,744,5,44.888888888888886,>30,UAE,Away,Upto 2014
DW Steyn,SA,Pace,2013-12-18,Johannesburg,South Africa,2013,2,165,336,1,1,1012,2037,30,847,1701,29,33.733333333333334,>30,SA,Home,Upto 2014
DW Steyn,SA,Pace,2013-12-26,Durban,South Africa,2013,2,147,306,9,1,714,1389,18,567,1083,9,39.666666666666664,>30,SA,Home,Upto 2014
DW Steyn,SA,Pace,2014-02-12,Centurion,South Africa,2014,2,139,260,6,1,767,1417,27,628,1157,21,28.40740740740741,<=30,SA,Home,After 1965
DW Steyn,SA,Pace,2014-02-20,Gqeberha,South Africa,2014,2,110,198,5,1,800,1419,22,690,1221,17,36.36363636363637,>30,SA,Home,After 1965
DW Steyn,SA,Pace,2014-03-01,Cape Town,South Africa,2014,2,68,79,1,1,924,1728,25,856,1649,24,36.96,>30,SA,Home,After 1965
DW Steyn,SA,Pace,2014-07-16,Galle,Sri Lanka,2014,2,99,240,9,1,420,962,20,321,722,11,21.0,<=30,SL,Away,After 1965
DW Steyn,SA,Pace,2014-07-24,Colombo (SSC),Sri Lanka,2014,2,128,210,4,1,394,782,12,266,572,8,32.833333333333336,>30,SL,Away,After 1965
DW Steyn,SA,Pace,2014-08-09,Harare,Zimbabwe,2014,2,84,264,8,1,362,1164,16,278,900,8,22.625,<=30,ZIM,Away,After 1965
DW Steyn,SA,Pace,2014-12-17,Centurion,South Africa,2014,2,87,134,6,1,587,1007,20,500,873,14,29.35,<=30,SA,Home,After 1965
DW Steyn,SA,Pace,2014-12-26,Gqeberha,South Africa,2014,1,48,84,0,1,464,870,12,416,786,12,38.666666666666664,>30,SA,Home,After 1965
DW Steyn,SA,Pace,2015-01-02,Cape Town,South Africa,2015,2,153,293,7,1,670,1234,16,517,941,9,41.875,>30,SA,Home,After 1965
DW Steyn,SA,Pace,2015-07-21,Chattogram,Bangladesh,2015,1,78,133,3,1,297,719,10,219,586,7,29.7,<=30,BAN,Away,After 1965
DW Steyn,SA,Pace,2015-07-30,Mirpur,Bangladesh,2015,1,30,97,3,1,105,259,4,75,162,1,26.25,<=30,BAN,Away,After 1965
DW Steyn,SA,Pace,2015-11-05,Mohali,India,2015,1,30,66,0,1,185,504,6,155,438,6,30.833333333333332,>30,IND,Away,After 1965
DW Steyn,SA,Pace,2015-12-26,Durban,South Africa,2015,2,80,174,4,1,593,1392,27,513,1218,23,21.962962962962962,<=30,SA,Home,After 1965
DW Steyn,SA,Pace,2016-08-19,Durban,South Africa,2016,1,3,36,2,1,247,526,10,244,490,8,24.7,<=30,SA,Home,After 1965
DW Steyn,SA,Pace,2016-08-27,Centurion,South Africa,2016,2,99,218,8,1,829,1709,31,730,1491,23,26.741935483870968,<=30,SA,Home,After 1965
DW Steyn,SA,Pace,2016-11-03,W.A.C.A,Australia,2016,1,51,76,1,1,937,1726,29,886,1650,28,32.310344827586206,>30,AUS,Away,After 1965
DW Steyn,SA,Pace,2018-01-05,Cape Town,South Africa,2018,1,51,105,2,1,684,1276,37,633,1171,35,18.486486486486488,<=30,SA,Home,After 1965
DW Steyn,SA,Pace,2018-07-12,Galle,Sri Lanka,2018,2,89,148,2,1,242,397,13,153,249,11,18.615384615384617,<=30,SL,Away,After 1965
DW Steyn,SA,Pace,2018-07-20,Colombo (SSC),Sri Lanka,2018,2,90,168,0,1,278,518,2,188,350,2,139.0,>30,SL,Away,After 1965
DW Steyn,SA,Pace,2018-12-26,Centurion,South Africa,2018,2,100,168,3,1,620,1128,33,520,960,30,18.78787878787879,<=30,SA,Home,After 1965
DW Steyn,SA,Pace,2019-01-03,Cape Town,South Africa,2019,2,133,205,7,1,809,1380,31,676,1175,24,26.096774193548388,<=30,SA,Home,After 1965
DW Steyn,SA,Pace,2019-01-11,Johannesburg,South Africa,2019,2,115,192,2,1,906,1496,35,791,1304,33,25.885714285714286,<=30,SA,Home,After 1965
DW Steyn,SA,Pace,2019-02-13,Durban,South Africa,2019,2,119,228,6,1,725,1312,28,606,1084,22,25.892857142857142,<=30,SA,Home,After 1965
DW Steyn,SA,Pace,2019-02-21,Gqeberha,South Africa,2019,2,77,108,0,1,552,954,24,475,846,24,23.0,<=30,SA,Home,After 1965
DW White,ENG,Pace,1961-10-21,Lahore,Pakistan,1961,2,107,204,3,1,400,1080,13,293,876,10,30.76923076923077,>30,PAK,Away,Upto 2014
DW White,ENG,Pace,1962-02-02,Karachi,Pakistan,1962,1,12,16,1,1,353,912,11,341,896,10,32.09090909090909,>30,PAK,Away,Upto 2014
Danish Kaneria,PAK,Spin,2000-11-29,Faisalabad,Pakistan,2000,2,119,246,2,1,641,1582,20,522,1336,18,32.05,>30,PAK,Home,Upto 2014
Danish Kaneria,PAK,Spin,2000-12-07,Karachi,Pakistan,2000,2,98,300,2,1,624,1582,18,526,1282,16,34.666666666666664,>30,PAK,Home,Upto 2014
Danish Kaneria,PAK,Spin,2001-08-29,Multan,Pakistan,2001,2,94,168,12,1,304,445,14,210,277,2,21.714285714285715,<=30,PAK,Home,Upto 2014
Danish Kaneria,PAK,Spin,2002-01-09,Dhaka,Bangladesh,2002,2,113,232,9,1,399,740,13,286,508,4,30.692307692307693,>30,BAN,Away,Upto 2014
Danish Kaneria,PAK,Spin,2002-01-16,Chattogram,Bangladesh,2002,2,71,168,4,1,412,718,14,341,550,10,29.428571428571427,<=30,BAN,Away,Upto 2014
Danish Kaneria,PAK,Spin,2002-01-31,Sharjah,UAE,2002,2,130,270,2,1,403,857,9,273,587,7,44.77777777777778,>30,UAE,Away,Upto 2014
Danish Kaneria,PAK,Spin,2002-02-07,Sharjah,UAE,2002,2,59,144,1,1,492,929,10,433,785,9,49.2,>30,UAE,Away,Upto 2014
Danish Kaneria,PAK,Spin,2002-05-01,Lahore,Pakistan,2002,2,129,228,6,1,466,722,13,337,494,7,35.84615384615385,>30,PAK,Home,Upto 2014
Danish Kaneria,PAK,Spin,2002-10-11,Sharjah,UAE,2002,1,116,156,1,1,223,467,13,107,311,12,17.153846153846153,<=30,UAE,Away,Upto 2014
Danish Kaneria,PAK,Spin,2002-10-19,Sharjah,UAE,2002,1,128,216,3,1,467,889,13,339,673,10,35.92307692307692,>30,UAE,Away,Upto 2014
Danish Kaneria,PAK,Spin,2003-08-20,Karachi,Pakistan,2003,2,143,354,6,1,435,1074,13,292,720,7,33.46153846153846,>30,PAK,Home,Upto 2014
Danish Kaneria,PAK,Spin,2003-08-27,Peshawar,Pakistan,2003,2,137,306,3,1,404,889,11,267,583,8,36.72727272727273,>30,PAK,Home,Upto 2014
Danish Kaneria,PAK,Spin,2003-10-17,Lahore,Pakistan,2003,2,111,297,7,1,515,1054,21,404,757,14,24.523809523809526,<=30,PAK,Home,Upto 2014
Danish Kaneria,PAK,Spin,2003-10-24,Faisalabad,Pakistan,2003,2,168,421,4,1,613,1195,9,445,774,5,68.11111111111111,>30,PAK,Home,Upto 2014
Danish Kaneria,PAK,Spin,2003-12-19,Hamilton,New Zealand,2003,2,118,216,2,1,235,432,3,117,216,1,78.33333333333333,>30,NZ,Away,Upto 2014
Danish Kaneria,PAK,Spin,2003-12-26,Wellington,New Zealand,2003,2,104,246,1,1,210,516,3,106,270,2,70.0,>30,NZ,Away,Upto 2014
Danish Kaneria,PAK,Spin,2004-04-05,Lahore,Pakistan,2004,2,70,119,5,1,269,480,8,199,361,3,33.625,>30,PAK,Home,Upto 2014
Danish Kaneria,PAK,Spin,2004-04-13,Rawalpindi,Pakistan,2004,1,178,372,2,1,324,559,10,146,187,8,32.4,>30,PAK,Home,Upto 2014
Danish Kaneria,PAK,Spin,2004-10-20,Faisalabad,Pakistan,2004,2,170,338,5,1,395,875,14,225,537,9,28.214285714285715,<=30,PAK,Home,Upto 2014
Danish Kaneria,PAK,Spin,2004-10-28,Karachi,Pakistan,2004,2,190,498,10,1,509,1056,15,319,558,5,33.93333333333333,>30,PAK,Home,Upto 2014
Danish Kaneria,PAK,Spin,2004-12-16,W.A.C.A,Australia,2004,2,179,282,2,1,275,498,5,96,216,3,55.0,>30,AUS,Away,Upto 2014
Danish Kaneria,PAK,Spin,2004-12-26,Melbourne,Australia,2004,2,177,302,5,1,412,701,11,235,399,6,37.45454545454545,>30,AUS,Away,Upto 2014
Danish Kaneria,PAK,Spin,2005-01-02,Sydney,Australia,2005,2,204,312,8,1,684,1068,21,480,756,13,32.57142857142857,>30,AUS,Away,Upto 2014
Danish Kaneria,PAK,Spin,2005-03-08,Mohali,India,2005,2,167,358,6,1,471,904,13,304,546,7,36.23076923076923,>30,IND,Away,Upto 2014
Danish Kaneria,PAK,Spin,2005-03-16,Eden Gardens,India,2005,2,259,414,6,1,693,1450,23,434,1036,17,30.130434782608695,>30,IND,Away,Upto 2014
Danish Kaneria,PAK,Spin,2005-03-24,Bengaluru,India,2005,2,173,384,7,1,834,1659,22,661,1275,15,37.90909090909091,>30,IND,Away,Upto 2014
Danish Kaneria,PAK,Spin,2005-05-26,Bridgetown,West Indies,2005,2,229,303,5,1,401,552,13,172,249,8,30.846153846153847,>30,WI,Away,Upto 2014
Danish Kaneria,PAK,Spin,2005-06-03,Kingston,West Indies,2005,2,140,293,6,1,374,708,11,234,415,5,34.0,>30,WI,Away,Upto 2014
Danish Kaneria,PAK,Spin,2005-11-12,Multan,Pakistan,2005,2,168,282,5,1,438,798,8,270,516,3,54.75,>30,PAK,Home,Upto 2014
Danish Kaneria,PAK,Spin,2005-11-20,Faisalabad,Pakistan,2005,2,129,264,0,1,496,897,7,367,633,7,70.85714285714286,>30,PAK,Home,Upto 2014
Danish Kaneria,PAK,Spin,2005-11-29,Lahore,Pakistan,2005,2,99,253,6,1,258,469,10,159,216,4,25.8,<=30,PAK,Home,Upto 2014
Danish Kaneria,PAK,Spin,2006-01-13,Lahore,Pakistan,2006,1,69,60,0,1,588,687,2,519,627,2,294.0,>30,PAK,Home,Upto 2014
Danish Kaneria,PAK,Spin,2006-01-21,Faisalabad,Pakistan,2006,1,165,324,3,1,770,1194,9,605,870,6,85.55555555555556,>30,PAK,Home,Upto 2014
Danish Kaneria,PAK,Spin,2006-01-29,Karachi,Pakistan,2006,1,75,108,2,1,322,481,6,247,373,4,53.666666666666664,>30,PAK,Home,Upto 2014
Danish Kaneria,PAK,Spin,2006-03-26,Colombo (SSC),Sri Lanka,2006,2,182,323,4,1,538,1125,13,356,802,9,41.38461538461539,>30,SL,Away,Upto 2014
Danish Kaneria,PAK,Spin,2006-04-03,Kandy,Sri Lanka,2006,1,53,140,4,1,153,330,9,100,190,5,17.0,<=30,SL,Away,Upto 2014
Danish Kaneria,PAK,Spin,2006-07-13,Lord's,England,2006,2,196,492,6,1,515,1101,11,319,609,5,46.81818181818182,>30,ENG,Away,Upto 2014
Danish Kaneria,PAK,Spin,2006-07-27,Manchester,England,2006,1,106,222,1,1,286,568,10,180,346,9,28.6,<=30,ENG,Away,Upto 2014
Danish Kaneria,PAK,Spin,2006-08-04,Leeds,England,2006,2,237,402,4,1,443,837,10,206,435,6,44.3,>30,ENG,Away,Upto 2014
Danish Kaneria,PAK,Spin,2006-08-17,The Oval,England,2006,2,112,222,2,1,237,438,3,125,216,1,79.0,>30,ENG,Away,Upto 2014
Danish Kaneria,PAK,Spin,2006-11-11,Lahore,Pakistan,2006,2,136,282,3,1,296,600,9,160,318,6,32.888888888888886,>30,PAK,Home,Upto 2014
Danish Kaneria,PAK,Spin,2006-11-19,Multan,Pakistan,2006,1,181,276,5,1,610,1072,9,429,796,4,67.77777777777777,>30,PAK,Home,Upto 2014
Danish Kaneria,PAK,Spin,2006-11-27,Karachi,Pakistan,2006,2,131,366,6,1,303,725,10,172,359,4,30.3,>30,PAK,Home,Upto 2014
Danish Kaneria,PAK,Spin,2007-01-11,Centurion,South Africa,2007,2,158,395,3,1,295,739,8,137,344,5,36.875,>30,SA,Away,Upto 2014
Danish Kaneria,PAK,Spin,2007-01-19,Gqeberha,South Africa,2007,2,141,392,7,1,226,545,7,85,153,0,32.285714285714285,>30,SA,Away,Upto 2014
Danish Kaneria,PAK,Spin,2007-01-26,Cape Town,South Africa,2007,2,96,288,5,1,134,404,7,38,116,2,19.142857142857142,<=30,SA,Away,Upto 2014
Danish Kaneria,PAK,Spin,2007-10-01,Karachi,Pakistan,2007,2,209,384,5,1,692,1416,21,483,1032,16,32.95238095238095,>30,PAK,Home,Upto 2014
Danish Kaneria,PAK,Spin,2007-10-08,Lahore,Pakistan,2007,2,213,526,5,1,512,1276,13,299,750,8,39.38461538461539,>30,PAK,Home,Upto 2014
Danish Kaneria,PAK,Spin,2007-11-22,Delhi,India,2007,2,109,226,4,1,425,937,15,316,711,11,28.333333333333332,<=30,IND,Away,Upto 2014
Danish Kaneria,PAK,Spin,2007-11-30,Eden Gardens,India,2007,2,255,390,4,1,851,1606,18,596,1216,14,47.27777777777778,>30,IND,Away,Upto 2014
Danish Kaneria,PAK,Spin,2007-12-08,Bengaluru,India,2007,2,264,434,4,1,712,1214,14,448,780,10,50.857142857142854,>30,IND,Away,Upto 2014
Danish Kaneria,PAK,Spin,2009-02-21,Karachi,Pakistan,2009,2,205,332,5,1,883,1568,9,678,1236,4,98.11111111111111,>30,PAK,Home,Upto 2014
Danish Kaneria,PAK,Spin,2009-03-01,Lahore,Pakistan,2009,1,183,282,0,1,316,544,0,133,262,0,inf,>30,PAK,Home,Upto 2014
Danish Kaneria,PAK,Spin,2009-07-20,Colombo (SSC),Sri Lanka,2009,2,176,339,7,1,647,1311,18,471,972,11,35.94444444444444,>30,SL,Away,Upto 2014
Danish Kaneria,PAK,Spin,2009-12-03,Wellington,New Zealand,2009,2,80,222,6,1,206,510,10,126,288,4,20.6,<=30,NZ,Away,Upto 2014
Danish Kaneria,PAK,Spin,2009-12-11,Napier,New Zealand,2009,2,189,348,7,1,354,812,12,165,464,5,29.5,<=30,NZ,Away,Upto 2014
Danish Kaneria,PAK,Spin,2010-01-03,Sydney,Australia,2010,2,169,299,5,1,308,485,11,139,186,6,28.0,<=30,AUS,Away,Upto 2014
Danish Kaneria,PAK,Spin,2010-01-14,Hobart,Australia,2010,2,245,341,4,1,458,793,15,213,452,11,30.533333333333335,>30,AUS,Away,Upto 2014
Danish Kaneria,PAK,Spin,2010-07-13,Lord's,England,2010,2,123,210,4,1,298,547,14,175,337,10,21.285714285714285,<=30,ENG,Away,Upto 2014
Danish Kaneria,PAK,Spin,2010-07-21,Leeds,England,2010,2,83,132,2,1,114,192,2,31,60,0,57.0,>30,ENG,Away,Upto 2014
Danish Kaneria,PAK,Spin,2010-07-29,Nottingham,England,2010,2,171,198,1,1,267,351,3,96,153,2,89.0,>30,ENG,Away,Upto 2014
E Chigumbura,ZIM,Pace,2004-05-06,Harare,Zimbabwe,2004,1,44,72,1,1,612,996,20,568,924,19,30.6,>30,ZIM,Home,Upto 2014
E Chigumbura,ZIM,Pace,2004-05-14,Bulawayo,Zimbabwe,2004,1,108,126,1,1,856,1362,13,748,1236,12,65.84615384615384,>30,ZIM,Home,Upto 2014
E Chigumbura,ZIM,Pace,2005-01-06,Chattogram,Bangladesh,2005,2,133,265,6,1,681,1423,24,548,1158,18,28.375,<=30,BAN,Away,Upto 2014
E Chigumbura,ZIM,Pace,2005-01-14,Dhaka,Bangladesh,2005,2,63,168,0,1,545,1416,17,482,1248,17,32.05882352941177,>30,BAN,Away,Upto 2014
E Chigumbura,ZIM,Pace,2005-03-04,Cape Town,South Africa,2005,1,53,48,0,1,443,710,15,390,662,15,29.533333333333335,<=30,SA,Away,Upto 2014
E Chigumbura,ZIM,Pace,2005-03-11,Centurion,South Africa,2005,1,97,150,1,1,611,1095,23,514,945,22,26.565217391304348,<=30,SA,Away,Upto 2014
E Chigumbura,ZIM,Pace,2011-08-04,Harare,Zimbabwe,2011,2,97,204,3,1,850,1557,26,753,1353,23,32.69230769230769,>30,ZIM,Home,Upto 2014
E Chigumbura,ZIM,Pace,2013-04-17,Harare,Zimbabwe,2013,2,34,48,1,1,550,1165,26,516,1117,25,21.153846153846153,<=30,ZIM,Home,Upto 2014
E Chigumbura,ZIM,Pace,2013-04-25,Harare,Zimbabwe,2013,2,129,230,3,1,755,1568,25,626,1338,22,30.2,>30,ZIM,Home,Upto 2014
E Chigumbura,ZIM,Pace,2013-09-03,Harare,Zimbabwe,2013,1,15,12,0,1,657,1465,18,642,1453,18,36.5,>30,ZIM,Home,Upto 2014
E Chigumbura,ZIM,Pace,2013-09-10,Harare,Zimbabwe,2013,1,6,30,0,1,558,1504,28,552,1474,28,19.928571428571427,<=30,ZIM,Home,Upto 2014
E Chigumbura,ZIM,Pace,2014-10-25,Mirpur,Bangladesh,2014,2,55,147,4,1,227,561,12,172,414,8,18.916666666666668,<=30,BAN,Away,After 1965
E Chigumbura,ZIM,Pace,2014-11-03,Khulna,Bangladesh,2014,2,73,168,1,1,338,810,9,265,642,8,37.55555555555556,>30,BAN,Away,After 1965
E Chigumbura,ZIM,Pace,2014-11-12,Chattogram,Bangladesh,2014,2,59,138,0,1,456,862,15,397,724,15,30.4,>30,BAN,Away,After 1965
E Evans,AUS,Spin,1881-12-31,Melbourne,Australia,1881,2,144,576,3,1,812,2321,24,668,1745,21,33.833333333333336,>30,AUS,Home,After 1965
E Evans,AUS,Spin,1882-02-17,Sydney,Australia,1882,2,113,389,4,1,520,1846,24,407,1457,20,21.666666666666668,<=30,AUS,Home,After 1965
E Evans,AUS,Spin,1883-02-17,Sydney,Australia,1883,1,15,44,0,1,484,1391,24,469,1347,24,20.166666666666668,<=30,AUS,Home,After 1965
E Evans,AUS,Spin,1885-02-20,Sydney,Australia,1885,2,17,32,0,1,276,897,19,259,865,19,14.526315789473685,<=30,AUS,Home,After 1965
E Evans,AUS,Spin,1886-07-19,Lord's,England,1886,1,37,144,0,1,231,789,16,194,645,16,14.4375,<=30,ENG,Away,After 1965
E Evans,AUS,Spin,1886-08-12,The Oval,England,1886,1,6,52,0,1,247,704,10,241,652,10,24.7,<=30,ENG,Away,After 1965
E Jones,AUS,Pace,1894-12-14,Sydney,Australia,1894,2,101,228,2,1,993,2418,24,892,2190,22,41.375,>30,AUS,Home,After 1965
E Jones,AUS,Pace,1896-06-22,Lord's,England,1896,2,106,245,3,1,652,1288,29,546,1043,26,22.482758620689655,<=30,ENG,Away,After 1965
E Jones,AUS,Pace,1896-07-16,Manchester,England,1896,2,89,110,2,1,587,1233,20,498,1123,18,29.35,<=30,ENG,Away,After 1965
E Jones,AUS,Pace,1896-08-10,The Oval,England,1896,1,13,15,1,1,180,416,13,167,401,12,13.846153846153847,<=30,ENG,Away,After 1965
E Jones,AUS,Pace,1897-12-13,Sydney,Australia,1897,2,158,354,3,1,722,1597,21,564,1243,18,34.38095238095238,>30,AUS,Home,After 1965
E Jones,AUS,Pace,1898-01-01,Melbourne,Australia,1898,1,54,132,2,1,464,1032,7,410,900,5,66.28571428571429,>30,AUS,Home,After 1965
E Jones,AUS,Pace,1898-01-14,Adelaide,Australia,1898,2,72,168,2,1,674,1910,19,602,1742,17,35.473684210526315,>30,AUS,Home,After 1965
E Jones,AUS,Pace,1898-01-29,Melbourne,Australia,1898,2,126,222,6,1,528,1140,21,402,918,15,25.142857142857142,<=30,AUS,Home,After 1965
E Jones,AUS,Pace,1898-02-26,Sydney,Australia,1898,2,143,314,9,1,648,1334,24,505,1020,15,27.0,<=30,AUS,Home,After 1965
E Jones,AUS,Pace,1899-06-01,Nottingham,England,1899,2,119,275,7,1,533,1449,20,414,1174,13,26.65,<=30,ENG,Away,After 1965
E Jones,AUS,Pace,1899-06-15,Lord's,England,1899,2,164,361,10,1,490,1002,18,326,641,8,27.22222222222222,<=30,ENG,Away,After 1965
E Jones,AUS,Pace,1899-06-29,Leeds,England,1899,2,41,125,1,1,374,834,15,333,709,14,24.933333333333334,<=30,ENG,Away,After 1965
E Jones,AUS,Pace,1899-07-17,Manchester,England,1899,2,169,250,4,1,742,1679,23,573,1429,19,32.26086956521739,>30,ENG,Away,After 1965
E Jones,AUS,Pace,1899-08-14,The Oval,England,1899,1,164,265,4,1,660,1288,13,496,1023,9,50.76923076923077,>30,ENG,Away,After 1965
E Jones,AUS,Pace,1901-12-13,Sydney,Australia,1901,1,98,216,1,1,416,1027,14,318,811,13,29.714285714285715,<=30,AUS,Home,Upto 2014
E Jones,AUS,Pace,1902-01-01,Melbourne,Australia,1902,1,33,72,0,1,229,661,13,196,589,13,17.615384615384617,<=30,AUS,Home,Upto 2014
E Jones,AUS,Pace,1902-05-29,Birmingham,England,1902,1,76,168,3,1,229,582,9,153,414,6,25.444444444444443,<=30,ENG,Away,Upto 2014
E Jones,AUS,Pace,1902-06-12,Lord's,England,1902,1,31,66,0,1,82,168,2,51,102,2,41.0,>30,ENG,Away,Upto 2014
E Jones,AUS,Pace,1902-10-11,Johannesburg,South Africa,1902,2,100,168,4,1,545,690,15,445,522,11,36.333333333333336,>30,SA,Away,Upto 2014
E Leadbeater,ENG,Spin,1951-12-14,Brabourne,India,1951,2,100,151,1,1,561,1297,11,461,1146,10,51.0,>30,IND,Away,Upto 2014
E Leadbeater,ENG,Spin,1951-12-30,Eden Gardens,India,1951,2,118,138,1,1,698,1841,19,580,1703,18,36.73684210526316,>30,IND,Away,Upto 2014
E Peate,ENG,Spin,1881-12-31,Melbourne,Australia,1881,2,86,280,1,1,812,2321,24,726,2041,23,33.833333333333336,>30,AUS,Away,After 1965
E Peate,ENG,Spin,1882-02-17,Sydney,Australia,1882,2,75,288,1,1,520,1846,24,445,1558,23,21.666666666666668,<=30,AUS,Away,After 1965
E Peate,ENG,Spin,1882-03-03,Sydney,Australia,1882,2,58,280,8,1,374,1277,25,316,997,17,14.96,<=30,AUS,Away,After 1965
E Peate,ENG,Spin,1882-03-10,Melbourne,Australia,1882,1,38,80,1,1,397,773,12,359,693,11,33.083333333333336,>30,AUS,Away,After 1965
E Peate,ENG,Spin,1882-08-28,The Oval,England,1882,2,71,236,8,1,130,428,15,59,192,7,8.666666666666666,<=30,ENG,Home,After 1965
E Peate,ENG,Spin,1884-07-10,Manchester,England,1884,1,62,196,3,1,222,640,17,160,444,14,13.058823529411764,<=30,ENG,Home,After 1965
E Peate,ENG,Spin,1884-07-21,Lord's,England,1884,2,119,224,6,1,320,694,15,201,470,9,21.333333333333332,<=30,ENG,Home,After 1965
E Peate,ENG,Spin,1884-08-11,The Oval,England,1884,1,99,252,2,1,469,1036,14,370,784,12,33.5,>30,ENG,Home,After 1965
E Peate,ENG,Spin,1886-07-05,Manchester,England,1886,2,75,260,1,1,205,538,9,130,278,8,22.77777777777778,<=30,ENG,Home,After 1965
E Wainwright,ENG,Spin,1893-07-17,Lord's,England,1893,1,41,55,0,1,216,425,2,175,370,2,108.0,>30,ENG,Home,After 1965
E Wainwright,ENG,Spin,1898-01-29,Melbourne,Australia,1898,2,32,72,0,1,328,761,11,296,689,11,29.818181818181817,<=30,AUS,Away,After 1965
EA Brandes,ZIM,Pace,1992-10-18,Harare,Zimbabwe,1992,1,3,12,0,1,480,1630,15,477,1618,15,32.0,>30,ZIM,Home,Upto 2014
EA Brandes,ZIM,Pace,1992-11-07,Harare,Zimbabwe,1992,2,108,250,4,1,623,1378,20,515,1128,16,31.15,>30,ZIM,Home,Upto 2014
EA Brandes,ZIM,Pace,1993-03-13,Delhi,India,1993,1,93,156,0,1,351,630,4,258,474,4,87.75,>30,IND,Away,Upto 2014
EA Brandes,ZIM,Pace,1993-12-01,Karachi,Pakistan,1993,2,165,288,4,1,605,1326,22,440,1038,18,27.5,<=30,PAK,Away,Upto 2014
EA Brandes,ZIM,Pace,1993-12-09,Rawalpindi,Pakistan,1993,2,153,378,6,1,816,1939,40,663,1561,34,20.4,<=30,PAK,Away,Upto 2014
EA Brandes,ZIM,Pace,1993-12-16,Lahore,Pakistan,1993,2,76,180,3,1,467,1213,21,391,1033,18,22.238095238095237,<=30,PAK,Away,Upto 2014
EA Brandes,ZIM,Pace,1996-01-13,Hamilton,New Zealand,1996,2,98,198,2,1,657,1344,21,559,1146,19,31.285714285714285,>30,NZ,Away,Upto 2014
EA Brandes,ZIM,Pace,1996-01-20,Auckland,New Zealand,1996,2,110,186,3,1,908,2025,23,798,1839,20,39.47826086956522,>30,NZ,Away,Upto 2014
EA Brandes,ZIM,Pace,1996-12-26,Harare,Zimbabwe,1996,2,80,222,0,1,330,1045,15,250,823,15,22.0,<=30,ZIM,Home,Upto 2014
EA Brandes,ZIM,Pace,1999-12-04,Harare,Zimbabwe,1999,2,65,126,4,1,525,1358,25,460,1232,21,21.0,<=30,ZIM,Home,Upto 2014
EA Martindale,WI,Pace,1933-06-24,Lord's,England,1933,1,85,144,4,1,246,540,10,161,396,6,24.6,<=30,ENG,Away,Upto 2014
EA Martindale,WI,Pace,1933-07-22,Manchester,England,1933,1,73,142,5,1,416,958,13,343,816,8,32.0,>30,ENG,Away,Upto 2014
EA Martindale,WI,Pace,1933-08-12,The Oval,England,1933,1,93,149,5,1,389,809,16,296,660,11,24.3125,<=30,ENG,Away,Upto 2014
EA Martindale,WI,Pace,1935-01-08,Bridgetown,West Indies,1935,2,61,105,8,1,205,438,22,144,333,14,9.318181818181818,<=30,WI,Home,Upto 2014
EA Martindale,WI,Pace,1935-01-24,Port of Spain,West Indies,1935,2,31,132,1,1,486,1307,22,455,1175,21,22.09090909090909,<=30,WI,Home,Upto 2014
EA Martindale,WI,Pace,1935-02-14,Georgetown,West Indies,1935,2,63,168,3,1,273,866,12,210,698,9,22.75,<=30,WI,Home,Upto 2014
EA Martindale,WI,Pace,1935-03-14,Kingston,West Indies,1935,2,84,198,7,1,412,902,15,328,704,8,27.466666666666665,<=30,WI,Home,Upto 2014
EA Martindale,WI,Pace,1939-06-24,Lord's,England,1939,2,137,223,1,1,652,1327,16,515,1104,15,40.75,>30,ENG,Away,Upto 2014
EA Martindale,WI,Pace,1939-07-22,Manchester,England,1939,2,44,160,2,1,257,788,18,213,628,16,14.277777777777779,<=30,ENG,Away,Upto 2014
EA Martindale,WI,Pace,1939-08-19,The Oval,England,1939,2,133,184,1,1,751,1240,17,618,1056,16,44.1764705882353,>30,ENG,Away,Upto 2014
EA McDonald,AUS,Pace,1921-01-14,Adelaide,Australia,1921,2,173,288,3,1,770,1488,14,597,1200,11,55.0,>30,AUS,Home,Upto 2014
EA McDonald,AUS,Pace,1921-02-11,Melbourne,Australia,1921,2,123,252,1,1,517,1056,6,394,804,5,86.16666666666667,>30,AUS,Home,Upto 2014
EA McDonald,AUS,Pace,1921-02-25,Sydney,Australia,1921,2,96,216,2,1,315,721,13,219,505,11,24.23076923076923,<=30,AUS,Home,Upto 2014
EA McDonald,AUS,Pace,1921-05-28,Nottingham,England,1921,2,74,226,8,1,251,658,20,177,432,12,12.55,<=30,ENG,Away,Upto 2014
EA McDonald,AUS,Pace,1921-06-11,Lord's,England,1921,2,147,258,8,1,453,764,17,306,506,9,26.647058823529413,<=30,ENG,Away,Upto 2014
EA McDonald,AUS,Pace,1921-07-02,Leeds,England,1921,2,172,247,6,1,408,703,13,236,456,7,31.384615384615383,>30,ENG,Away,Upto 2014
EA McDonald,AUS,Pace,1921-07-23,Manchester,England,1921,1,112,186,0,1,286,546,3,174,360,3,95.33333333333333,>30,ENG,Away,Upto 2014
EA McDonald,AUS,Pace,1921-08-13,The Oval,England,1921,2,163,318,5,1,511,912,11,348,594,6,46.45454545454545,>30,ENG,Away,Upto 2014
EA McDonald,AUS,Pace,1921-11-05,Durban,South Africa,1921,2,119,324,4,1,645,1385,24,526,1061,20,26.875,<=30,SA,Away,Upto 2014
EA McDonald,AUS,Pace,1921-11-12,Johannesburg,South Africa,1921,2,164,378,2,1,791,1453,15,627,1075,13,52.733333333333334,>30,SA,Away,Upto 2014
EA McDonald,AUS,Pace,1921-11-26,Cape Town,South Africa,1921,2,88,192,4,1,368,882,11,280,690,7,33.45454545454545,>30,SA,Away,Upto 2014
EA Moseley,WI,Pace,1990-03-23,Port of Spain,West Indies,1990,2,103,240,3,1,773,1811,34,670,1571,31,22.735294117647058,<=30,WI,Home,Upto 2014
EA Moseley,WI,Pace,1990-04-05,Bridgetown,West Indies,1990,2,158,282,3,1,1177,2232,37,1019,1950,34,31.81081081081081,>30,WI,Home,Upto 2014
EAB Rowan,SA,Spin,1950-02-10,Johannesburg,South Africa,1950,1,0,8,0,1,517,1176,4,517,1168,4,129.25,>30,SA,Home,Upto 2014
EAB Rowan,SA,Spin,1951-06-21,Lord's,England,1951,1,7,11,0,1,361,954,17,354,943,17,21.235294117647058,<=30,ENG,Away,Upto 2014
EAE Baptiste,WI,Pace,1983-10-21,Kanpur,India,1983,2,66,102,1,1,584,1065,26,518,963,25,22.46153846153846,<=30,IND,Away,Upto 2014
EAE Baptiste,WI,Pace,1984-03-30,Bridgetown,West Indies,1984,2,48,120,1,1,810,1566,27,762,1446,26,30.0,<=30,WI,Home,Upto 2014
EAE Baptiste,WI,Pace,1984-04-07,St John's,West Indies,1984,2,56,150,4,1,745,1490,28,689,1340,24,26.607142857142858,<=30,WI,Home,Upto 2014
EAE Baptiste,WI,Pace,1984-04-28,Kingston,West Indies,1984,2,51,102,1,1,537,1132,24,486,1030,23,22.375,<=30,WI,Home,Upto 2014
EAE Baptiste,WI,Pace,1984-06-14,Birmingham,England,1984,2,46,96,1,1,672,1256,23,626,1160,22,29.217391304347824,<=30,ENG,Away,Upto 2014
EAE Baptiste,WI,Pace,1984-06-28,Lord's,England,1984,2,84,276,2,1,986,1843,27,902,1567,25,36.51851851851852,>30,ENG,Away,Upto 2014
EAE Baptiste,WI,Pace,1984-07-12,Leeds,England,1984,1,45,78,1,1,659,1294,24,614,1216,23,27.458333333333332,<=30,ENG,Away,Upto 2014
EAE Baptiste,WI,Pace,1984-07-26,Manchester,England,1984,2,60,180,3,1,536,1172,18,476,992,15,29.77777777777778,<=30,ENG,Away,Upto 2014
EAE Baptiste,WI,Pace,1984-08-09,The Oval,England,1984,2,30,120,1,1,809,1686,40,779,1566,39,20.225,<=30,ENG,Away,Upto 2014
EAE Baptiste,WI,Pace,1990-04-12,St John's,West Indies,1990,2,77,138,1,1,830,1554,26,753,1416,25,31.923076923076923,>30,WI,Home,Upto 2014
EAR de Silva,SL,Spin,1985-08-30,Colombo (SSC),Sri Lanka,1985,2,38,162,0,1,225,696,4,187,534,4,56.25,>30,SL,Home,Upto 2014
EAR de Silva,SL,Spin,1986-02-23,Kandy,Sri Lanka,1986,1,37,108,1,1,188,445,14,151,337,13,13.428571428571429,<=30,SL,Home,Upto 2014
EAR de Silva,SL,Spin,1986-12-17,Kanpur,India,1986,1,133,240,0,1,263,540,3,130,300,3,87.66666666666667,>30,IND,Away,Upto 2014
EAR de Silva,SL,Spin,1986-12-27,Nagpur,India,1986,1,91,228,1,1,408,845,19,317,617,18,21.473684210526315,<=30,IND,Away,Upto 2014
EAR de Silva,SL,Spin,1987-01-04,Cuttack,India,1987,1,114,240,0,1,354,865,18,240,625,18,19.666666666666668,<=30,IND,Away,Upto 2014
EAR de Silva,SL,Spin,1989-12-08,Brisbane,Australia,1989,2,133,282,1,1,218,426,2,85,144,1,109.0,>30,AUS,Away,Upto 2014
EAR de Silva,SL,Spin,1989-12-16,Hobart,Australia,1989,2,93,180,1,1,264,618,8,171,438,7,33.0,>30,AUS,Away,Upto 2014
EAR de Silva,SL,Spin,1991-01-31,Wellington,New Zealand,1991,1,141,336,0,1,378,792,0,237,456,0,inf,>30,NZ,Away,Upto 2014
EAR de Silva,SL,Spin,1991-02-22,Hamilton,New Zealand,1991,2,124,228,2,1,304,672,6,180,444,4,50.666666666666664,>30,NZ,Away,Upto 2014
EAR de Silva,SL,Spin,1991-03-01,Auckland,New Zealand,1991,2,128,324,2,1,346,733,6,218,409,4,57.666666666666664,>30,NZ,Away,Upto 2014
EAS Prasanna,IND,Spin,1962-01-10,Chennai,India,1962,2,39,120,1,1,866,2320,33,827,2200,32,26.242424242424242,<=30,IND,Home,Upto 2014
EAS Prasanna,IND,Spin,1962-03-07,Kingston,West Indies,1962,1,122,300,3,1,783,1924,16,661,1624,13,48.9375,>30,WI,Away,Upto 2014
EAS Prasanna,IND,Spin,1967-01-13,Chennai,India,1967,2,224,468,5,1,841,1944,23,617,1476,18,36.56521739130435,>30,IND,Home,Upto 2014
EAS Prasanna,IND,Spin,1967-06-08,Leeds,England,1967,2,241,483,1,1,861,2089,19,620,1606,18,45.31578947368421,>30,ENG,Away,Upto 2014
EAS Prasanna,IND,Spin,1967-06-22,Lord's,England,1967,1,78,192,1,1,346,971,18,268,779,17,19.22222222222222,<=30,ENG,Away,Upto 2014
EAS Prasanna,IND,Spin,1967-07-13,Birmingham,England,1967,2,111,264,7,1,686,1638,33,575,1374,26,20.78787878787879,<=30,ENG,Away,Upto 2014
EAS Prasanna,IND,Spin,1967-12-23,Adelaide,Australia,1967,2,169,336,4,1,620,1381,10,451,1045,6,62.0,>30,AUS,Away,Upto 2014
EAS Prasanna,IND,Spin,1967-12-30,Melbourne,Australia,1967,1,141,272,6,1,312,712,11,171,440,5,28.363636363636363,<=30,AUS,Away,Upto 2014
EAS Prasanna,IND,Spin,1968-01-19,Brisbane,Australia,1968,2,218,572,8,1,711,2018,22,493,1446,14,32.31818181818182,>30,AUS,Away,Upto 2014
EAS Prasanna,IND,Spin,1968-01-26,Sydney,Australia,1968,2,158,401,7,1,552,1735,27,394,1334,20,20.444444444444443,<=30,AUS,Away,Upto 2014
EAS Prasanna,IND,Spin,1968-02-15,Dunedin,New Zealand,1968,2,178,462,6,1,642,1761,17,464,1299,11,37.76470588235294,>30,NZ,Away,Upto 2014
EAS Prasanna,IND,Spin,1968-02-22,Christchurch,New Zealand,1968,2,101,162,2,1,599,1533,16,498,1371,14,37.4375,>30,NZ,Away,Upto 2014
EAS Prasanna,IND,Spin,1968-02-29,Wellington,New Zealand,1968,2,88,232,8,1,408,1093,20,320,861,12,20.4,<=30,NZ,Away,Upto 2014
EAS Prasanna,IND,Spin,1968-03-07,Auckland,New Zealand,1968,2,84,331,8,1,303,1079,19,219,748,11,15.947368421052632,<=30,NZ,Away,Upto 2014
EAS Prasanna,IND,Spin,1969-09-25,Brabourne,India,1969,2,171,477,8,1,396,1358,19,225,881,11,20.842105263157894,<=30,IND,Home,Upto 2014
EAS Prasanna,IND,Spin,1969-10-03,Nagpur,India,1969,2,153,384,4,1,677,1910,37,524,1526,33,18.2972972972973,<=30,IND,Home,Upto 2014
EAS Prasanna,IND,Spin,1969-10-15,Hyderabad (Deccan),India,1969,2,109,330,8,1,301,978,13,192,648,5,23.153846153846153,<=30,IND,Home,Upto 2014
EAS Prasanna,IND,Spin,1969-11-04,Brabourne,India,1969,2,141,348,5,1,483,1714,20,342,1366,15,24.15,<=30,IND,Home,Upto 2014
EAS Prasanna,IND,Spin,1969-11-15,Kanpur,India,1969,2,88,324,2,1,657,2057,13,569,1733,11,50.53846153846154,>30,IND,Home,Upto 2014
EAS Prasanna,IND,Spin,1969-11-28,Delhi,India,1969,2,153,378,9,1,604,1737,30,451,1359,21,20.133333333333333,<=30,IND,Home,Upto 2014
EAS Prasanna,IND,Spin,1969-12-12,Eden Gardens,India,1969,1,116,294,0,1,380,1033,12,264,739,12,31.666666666666668,>30,IND,Home,Upto 2014
EAS Prasanna,IND,Spin,1969-12-24,Chennai,India,1969,2,174,426,10,1,490,1347,28,316,921,18,17.5,<=30,IND,Home,Upto 2014
EAS Prasanna,IND,Spin,1971-02-18,Kingston,West Indies,1971,2,137,324,4,1,757,1901,17,620,1577,13,44.529411764705884,>30,WI,Away,Upto 2014
EAS Prasanna,IND,Spin,1971-03-06,Port of Spain,West Indies,1971,2,101,215,4,1,708,1890,29,607,1675,25,24.413793103448278,<=30,WI,Away,Upto 2014
EAS Prasanna,IND,Spin,1971-04-13,Port of Spain,West Indies,1971,2,169,420,3,1,963,2470,24,794,2050,21,40.125,>30,WI,Away,Upto 2014
EAS Prasanna,IND,Spin,1972-12-30,Eden Gardens,India,1972,2,52,150,3,1,461,1469,28,409,1319,25,16.464285714285715,<=30,IND,Home,Upto 2014
EAS Prasanna,IND,Spin,1973-01-12,Chennai,India,1973,2,63,150,6,1,632,1828,31,569,1678,25,20.387096774193548,<=30,IND,Home,Upto 2014
EAS Prasanna,IND,Spin,1973-01-25,Kanpur,India,1973,1,87,204,1,1,638,1919,18,551,1715,17,35.44444444444444,>30,IND,Home,Upto 2014
EAS Prasanna,IND,Spin,1974-06-20,Lord's,England,1974,1,166,306,2,1,526,1013,10,360,707,8,52.6,>30,ENG,Away,Upto 2014
EAS Prasanna,IND,Spin,1974-07-04,Birmingham,England,1974,1,101,210,1,1,474,954,5,373,744,4,94.8,>30,ENG,Away,Upto 2014
EAS Prasanna,IND,Spin,1974-11-22,Bengaluru,India,1974,2,103,242,2,1,592,1136,16,489,894,14,37.0,>30,IND,Home,Upto 2014
EAS Prasanna,IND,Spin,1974-12-11,Delhi,India,1974,1,147,204,4,1,662,1469,18,515,1265,14,36.77777777777778,>30,IND,Home,Upto 2014
EAS Prasanna,IND,Spin,1974-12-27,Eden Gardens,India,1974,2,63,216,0,1,505,1382,15,442,1166,15,33.666666666666664,>30,IND,Home,Upto 2014
EAS Prasanna,IND,Spin,1975-01-11,Chennai,India,1975,2,111,282,9,1,340,944,19,229,662,10,17.894736842105264,<=30,IND,Home,Upto 2014
EAS Prasanna,IND,Spin,1975-01-23,Wankhede,India,1975,2,177,300,0,1,833,1734,13,656,1434,13,64.07692307692308,>30,IND,Home,Upto 2014
EAS Prasanna,IND,Spin,1976-01-24,Auckland,New Zealand,1976,2,140,376,11,1,633,1676,24,493,1300,13,26.375,<=30,NZ,Away,Upto 2014
EAS Prasanna,IND,Spin,1976-02-05,Christchurch,New Zealand,1976,1,62,128,0,1,255,744,3,193,616,3,85.0,>30,NZ,Away,Upto 2014
EAS Prasanna,IND,Spin,1976-02-13,Wellington,New Zealand,1976,1,21,64,0,1,139,461,6,118,397,6,23.166666666666668,<=30,NZ,Away,Upto 2014
EAS Prasanna,IND,Spin,1976-03-10,Bridgetown,West Indies,1976,1,66,144,0,1,501,996,16,435,852,16,31.3125,>30,WI,Away,Upto 2014
EAS Prasanna,IND,Spin,1977-01-01,Eden Gardens,India,1977,2,98,352,4,1,396,1315,15,298,963,11,26.4,<=30,IND,Home,Upto 2014
EAS Prasanna,IND,Spin,1977-01-14,Chennai,India,1977,2,100,294,6,1,366,1090,21,266,796,15,17.428571428571427,<=30,IND,Home,Upto 2014
EAS Prasanna,IND,Spin,1977-01-28,Bengaluru,India,1977,2,82,258,3,1,552,1373,26,470,1115,23,21.23076923076923,<=30,IND,Home,Upto 2014
EAS Prasanna,IND,Spin,1977-02-11,Wankhede,India,1977,2,109,492,5,1,658,1830,25,549,1338,20,26.32,<=30,IND,Home,Upto 2014
EAS Prasanna,IND,Spin,1977-12-02,Brisbane,Australia,1977,2,61,192,0,1,389,908,12,328,716,12,32.416666666666664,>30,AUS,Away,Upto 2014
EAS Prasanna,IND,Spin,1977-12-30,Melbourne,Australia,1977,2,37,144,0,1,349,802,20,312,658,20,17.45,<=30,AUS,Away,Upto 2014
EAS Prasanna,IND,Spin,1978-01-07,Sydney,Australia,1978,2,65,292,5,1,426,1124,16,361,832,11,26.625,<=30,AUS,Away,Upto 2014
EAS Prasanna,IND,Spin,1978-01-28,Adelaide,Australia,1978,2,116,352,1,1,820,1960,16,704,1608,15,51.25,>30,AUS,Away,Upto 2014
EAS Prasanna,IND,Spin,1978-10-16,Faisalabad,Pakistan,1978,2,157,336,2,1,700,1410,15,543,1074,13,46.666666666666664,>30,PAK,Away,Upto 2014
EAS Prasanna,IND,Spin,1978-10-27,Lahore,Pakistan,1978,1,94,150,0,1,591,988,6,497,838,6,98.5,>30,PAK,Away,Upto 2014
EAV Williams,WI,Pace,1939-07-22,Manchester,England,1939,1,23,72,0,1,257,788,18,234,716,18,14.277777777777779,<=30,ENG,Away,Upto 2014
EAV Williams,WI,Pace,1948-01-21,Bridgetown,West Indies,1948,2,68,252,3,1,345,968,10,277,716,7,34.5,>30,WI,Home,Upto 2014
EAV Williams,WI,Pace,1948-02-11,Port of Spain,West Indies,1948,2,95,288,4,1,529,1106,15,434,818,11,35.266666666666666,>30,WI,Home,Upto 2014
EAV Williams,WI,Pace,1948-03-03,Georgetown,West Indies,1948,2,55,184,2,1,265,632,11,210,448,9,24.09090909090909,<=30,WI,Home,Upto 2014
EB Lundie,SA,Pace,1914-02-27,Gqeberha,South Africa,1914,2,107,286,4,1,418,956,19,311,670,15,22.0,<=30,SA,Home,Upto 2014
ED Solkar,IND,Spin,1969-10-15,Hyderabad (Deccan),India,1969,1,8,18,0,1,301,978,13,293,960,13,23.153846153846153,<=30,IND,Home,Upto 2014
ED Solkar,IND,Spin,1969-11-15,Kanpur,India,1969,2,81,186,1,1,657,2057,13,576,1871,12,50.53846153846154,>30,IND,Home,Upto 2014
ED Solkar,IND,Spin,1969-11-28,Delhi,India,1969,2,43,72,0,1,604,1737,30,561,1665,30,20.133333333333333,<=30,IND,Home,Upto 2014
ED Solkar,IND,Spin,1969-12-12,Eden Gardens,India,1969,1,28,55,1,1,380,1033,12,352,978,11,31.666666666666668,>30,IND,Home,Upto 2014
ED Solkar,IND,Spin,1969-12-24,Chennai,India,1969,2,10,74,1,1,490,1347,28,480,1273,27,17.5,<=30,IND,Home,Upto 2014
ED Solkar,IND,Spin,1971-02-18,Kingston,West Indies,1971,2,65,144,2,1,757,1901,17,692,1757,15,44.529411764705884,>30,WI,Away,Upto 2014
ED Solkar,IND,Spin,1971-03-06,Port of Spain,West Indies,1971,2,31,60,0,1,708,1890,29,677,1830,29,24.413793103448278,<=30,WI,Away,Upto 2014
ED Solkar,IND,Spin,1971-03-19,Georgetown,West Indies,1971,2,77,198,2,1,785,2232,14,708,2034,12,56.07142857142857,>30,WI,Away,Upto 2014
ED Solkar,IND,Spin,1971-04-01,Bridgetown,West Indies,1971,2,113,198,1,1,692,1614,11,579,1416,10,62.90909090909091,>30,WI,Away,Upto 2014
ED Solkar,IND,Spin,1971-04-13,Port of Spain,West Indies,1971,2,75,144,1,1,963,2470,24,888,2326,23,40.125,>30,WI,Away,Upto 2014
ED Solkar,IND,Spin,1971-07-22,Lord's,England,1971,2,30,84,1,1,610,1919,28,580,1835,27,21.785714285714285,<=30,ENG,Away,Upto 2014
ED Solkar,IND,Spin,1971-08-05,Manchester,England,1971,2,69,156,2,1,461,1050,7,392,894,5,65.85714285714286,>30,ENG,Away,Upto 2014
ED Solkar,IND,Spin,1971-08-19,The Oval,England,1971,2,38,108,3,1,621,1646,28,583,1538,25,22.178571428571427,<=30,ENG,Away,Upto 2014
ED Solkar,IND,Spin,1972-12-20,Delhi,India,1972,2,21,36,0,1,561,1750,23,540,1714,23,24.391304347826086,<=30,IND,Home,Upto 2014
ED Solkar,IND,Spin,1972-12-30,Eden Gardens,India,1972,2,5,24,0,1,461,1469,28,456,1445,28,16.464285714285715,<=30,IND,Home,Upto 2014
ED Solkar,IND,Spin,1973-01-12,Chennai,India,1973,2,13,24,0,1,632,1828,31,619,1804,31,20.387096774193548,<=30,IND,Home,Upto 2014
ED Solkar,IND,Spin,1973-01-25,Kanpur,India,1973,1,14,30,0,1,638,1919,18,624,1889,18,35.44444444444444,>30,IND,Home,Upto 2014
ED Solkar,IND,Spin,1973-02-06,Brabourne,India,1973,2,20,36,0,1,967,2173,20,947,2137,20,48.35,>30,IND,Home,Upto 2014
ED Solkar,IND,Spin,1974-06-06,Manchester,England,1974,2,57,120,1,1,468,1159,11,411,1039,10,42.54545454545455,>30,ENG,Away,Upto 2014
ED Solkar,IND,Spin,1974-06-20,Lord's,England,1974,1,16,36,0,1,526,1013,10,510,977,10,52.6,>30,ENG,Away,Upto 2014
ED Solkar,IND,Spin,1974-07-04,Birmingham,England,1974,1,52,108,0,1,474,954,5,422,846,5,94.8,>30,ENG,Away,Upto 2014
ED Solkar,IND,Spin,1974-11-22,Bengaluru,India,1974,2,35,54,0,1,592,1136,16,557,1082,16,37.0,>30,IND,Home,Upto 2014
ED Solkar,IND,Spin,1974-12-11,Delhi,India,1974,1,43,78,2,1,662,1469,18,619,1391,16,36.77777777777778,>30,IND,Home,Upto 2014
ED Solkar,IND,Spin,1975-01-23,Wankhede,India,1975,2,71,132,0,1,833,1734,13,762,1602,13,64.07692307692308,>30,IND,Home,Upto 2014
ED Solkar,IND,Spin,1976-04-07,Port of Spain,West Indies,1976,1,40,54,0,1,858,2099,21,818,2045,21,40.857142857142854,>30,WI,Away,Upto 2014
ED Solkar,IND,Spin,1977-01-01,Eden Gardens,India,1977,1,15,36,0,1,396,1315,15,381,1279,15,26.4,<=30,IND,Home,Upto 2014
ED Weekes,WI,Spin,1948-11-10,Delhi,India,1948,1,2,6,0,1,804,1710,13,802,1704,13,61.84615384615385,>30,IND,Away,Upto 2014
ED Weekes,WI,Spin,1948-12-31,Eden Gardens,India,1948,1,3,6,0,1,677,1523,19,674,1517,19,35.63157894736842,>30,IND,Away,Upto 2014
ED Weekes,WI,Spin,1953-01-21,Port of Spain,West Indies,1953,1,10,12,0,1,842,2177,19,832,2165,19,44.31578947368421,>30,WI,Home,Upto 2014
ED Weekes,WI,Spin,1953-02-19,Port of Spain,West Indies,1953,1,1,6,0,1,777,2186,14,776,2180,14,55.5,>30,WI,Home,Upto 2014
ED Weekes,WI,Spin,1954-02-24,Georgetown,West Indies,1954,1,8,7,0,1,666,2079,21,658,2072,21,31.714285714285715,>30,WI,Home,Upto 2014
ED Weekes,WI,Spin,1954-03-17,Port of Spain,West Indies,1954,1,28,30,0,1,1025,1930,13,997,1900,13,78.84615384615384,>30,WI,Home,Upto 2014
ED Weekes,WI,Spin,1954-03-30,Kingston,West Indies,1954,1,3,5,0,1,581,1630,14,578,1625,14,41.5,>30,WI,Home,Upto 2014
ED Weekes,WI,Spin,1955-03-26,Kingston,West Indies,1955,1,8,14,1,1,550,1394,11,542,1380,10,50.0,>30,WI,Home,Upto 2014
ED Weekes,WI,Spin,1958-02-26,Kingston,West Indies,1958,1,10,18,0,1,450,846,3,440,828,3,150.0,>30,WI,Home,Upto 2014
ED Weekes,WI,Spin,1958-03-26,Port of Spain,West Indies,1958,1,4,18,0,1,527,1152,14,523,1134,14,37.642857142857146,>30,WI,Home,Upto 2014
EE Achong,WI,Spin,1930-02-01,Port of Spain,West Indies,1930,2,76,144,2,1,356,890,8,280,746,6,44.5,>30,WI,Home,Upto 2014
EE Achong,WI,Spin,1933-06-24,Lord's,England,1933,1,88,210,2,1,304,786,19,216,576,17,16.0,<=30,ENG,Away,Upto 2014
EE Achong,WI,Spin,1933-07-22,Manchester,England,1933,1,90,222,2,1,521,1061,15,431,839,13,34.733333333333334,>30,ENG,Away,Upto 2014
EE Achong,WI,Spin,1933-08-12,The Oval,England,1933,1,59,138,1,1,194,451,12,135,313,11,16.166666666666668,<=30,ENG,Away,Upto 2014
EE Achong,WI,Spin,1935-01-08,Bridgetown,West Indies,1935,1,14,36,0,1,82,234,6,68,198,6,13.666666666666666,<=30,WI,Home,Upto 2014
EE Achong,WI,Spin,1935-01-24,Port of Spain,West Indies,1935,2,51,168,1,1,418,1002,12,367,834,11,34.833333333333336,>30,WI,Home,Upto 2014
EE Hemmings,ENG,Spin,1982-07-29,Birmingham,England,1982,2,83,204,3,1,280,691,9,197,487,6,31.11111111111111,>30,ENG,Home,Upto 2014
EE Hemmings,ENG,Spin,1982-08-12,Lord's,England,1982,2,66,133,0,1,199,504,6,133,371,6,33.166666666666664,>30,ENG,Home,Upto 2014
EE Hemmings,ENG,Spin,1982-11-26,Brisbane,Australia,1982,2,124,375,2,1,274,868,5,150,493,3,54.8,>30,AUS,Away,Upto 2014
EE Hemmings,ENG,Spin,1982-12-10,Adelaide,Australia,1982,2,101,312,1,1,299,810,4,198,498,3,74.75,>30,AUS,Away,Upto 2014
EE Hemmings,ENG,Spin,1983-01-02,Sydney,Australia,1983,2,184,444,6,1,585,1269,15,401,825,9,39.0,>30,AUS,Away,Upto 2014
EE Hemmings,ENG,Spin,1987-12-07,Faisalabad,Pakistan,1987,2,51,150,1,1,479,1253,22,428,1103,21,21.772727272727273,<=30,PAK,Away,Upto 2014
EE Hemmings,ENG,Spin,1988-01-29,Sydney,Australia,1988,2,160,444,3,1,513,1326,10,353,882,7,51.3,>30,AUS,Away,Upto 2014
EE Hemmings,ENG,Spin,1988-03-03,Wellington,New Zealand,1988,1,107,270,0,1,303,839,2,196,569,2,151.5,>30,NZ,Away,Upto 2014
EE Hemmings,ENG,Spin,1989-08-10,Nottingham,England,1989,1,81,198,0,1,273,660,7,192,462,7,39.0,>30,ENG,Home,Upto 2014
EE Hemmings,ENG,Spin,1990-06-07,Nottingham,England,1990,2,47,126,1,1,148,408,4,101,282,3,37.0,>30,ENG,Home,Upto 2014
EE Hemmings,ENG,Spin,1990-06-21,Lord's,England,1990,1,67,180,2,1,264,588,7,197,408,5,37.714285714285715,>30,ENG,Home,Upto 2014
EE Hemmings,ENG,Spin,1990-07-05,Birmingham,England,1990,2,101,339,7,1,288,747,13,187,408,6,22.153846153846153,<=30,ENG,Home,Upto 2014
EE Hemmings,ENG,Spin,1990-07-26,Lord's,England,1990,2,188,246,4,1,488,672,6,300,426,2,81.33333333333333,>30,ENG,Home,Upto 2014
EE Hemmings,ENG,Spin,1990-08-09,Manchester,England,1990,2,149,362,5,1,724,1465,14,575,1103,9,51.714285714285715,>30,ENG,Home,Upto 2014
EE Hemmings,ENG,Spin,1990-08-23,The Oval,England,1990,1,117,216,2,1,500,1062,6,383,846,4,83.33333333333333,>30,ENG,Home,Upto 2014
EE Hemmings,ENG,Spin,1991-01-04,Sydney,Australia,1991,2,199,438,6,1,645,1458,16,446,1020,10,40.3125,>30,AUS,Away,Upto 2014
EG Arnold,ENG,Pace,1903-12-11,Sydney,Australia,1903,2,169,360,6,1,649,1476,14,480,1116,8,46.357142857142854,>30,AUS,Away,Upto 2014
EG Arnold,ENG,Pace,1904-01-15,Adelaide,Australia,1904,2,167,276,3,1,683,1465,19,516,1189,16,35.94736842105263,>30,AUS,Away,Upto 2014
EG Arnold,ENG,Pace,1904-02-26,Sydney,Australia,1904,2,70,159,6,1,327,845,17,257,686,11,19.235294117647058,<=30,AUS,Away,Upto 2014
EG Arnold,ENG,Pace,1904-03-05,Melbourne,Australia,1904,2,69,156,3,1,250,529,16,181,373,13,15.625,<=30,AUS,Away,Upto 2014
EG Arnold,ENG,Pace,1905-05-29,Nottingham,England,1905,2,46,90,1,1,577,1196,21,531,1106,20,27.476190476190474,<=30,ENG,Home,Upto 2014
EG Arnold,ENG,Pace,1905-06-15,Lord's,England,1905,1,13,42,1,1,344,822,16,331,780,15,21.5,<=30,ENG,Home,Upto 2014
EG Arnold,ENG,Pace,1905-07-24,Manchester,England,1905,2,88,174,4,1,572,1050,20,484,876,16,28.6,<=30,ENG,Home,Upto 2014
EG Arnold,ENG,Pace,1905-08-14,The Oval,England,1905,2,67,108,1,1,775,1333,24,708,1225,23,32.291666666666664,>30,ENG,Home,Upto 2014
EG Arnold,ENG,Pace,1907-07-01,Lord's,England,1907,2,78,210,5,1,214,540,7,136,330,2,30.571428571428573,>30,ENG,Home,Upto 2014
EG Arnold,ENG,Pace,1907-07-29,Leeds,England,1907,2,21,102,1,1,113,315,7,92,213,6,16.142857142857142,<=30,ENG,Home,Upto 2014
EG Bock,SA,Pace,1935-12-24,Johannesburg,South Africa,1935,2,91,138,0,1,547,996,13,456,858,13,42.07692307692308,>30,SA,Home,Upto 2014
EG Hayes,ENG,Spin,1906-01-02,Johannesburg,South Africa,1906,1,28,54,1,1,455,1132,23,427,1078,22,19.782608695652176,<=30,SA,Away,Upto 2014
EG Hayes,ENG,Spin,1909-08-09,The Oval,England,1909,2,24,36,0,1,627,1104,11,603,1068,11,57.0,>30,ENG,Home,Upto 2014
EG McLeod,NZ,Spin,1930-01-24,Wellington,New Zealand,1930,1,5,12,0,1,379,753,13,374,741,13,29.153846153846153,<=30,NZ,Home,Upto 2014
EG Wynyard,ENG,Spin,1906-01-02,Johannesburg,South Africa,1906,1,15,18,0,1,455,1132,23,440,1114,23,19.782608695652176,<=30,SA,Away,Upto 2014
EG Wynyard,ENG,Spin,1906-03-06,Johannesburg,South Africa,1906,1,2,6,0,1,287,726,15,285,720,15,19.133333333333333,<=30,SA,Away,Upto 2014
EH Bowley,ENG,Spin,1929-07-13,Leeds,England,1929,1,7,24,0,1,624,1466,25,617,1442,25,24.96,<=30,ENG,Home,Upto 2014
EH Bowley,ENG,Spin,1930-01-24,Wellington,New Zealand,1930,2,51,60,0,1,379,753,13,328,693,13,29.153846153846153,<=30,NZ,Away,Upto 2014
EH Bowley,ENG,Spin,1930-02-21,Auckland,New Zealand,1930,1,58,168,0,1,488,1141,10,430,973,10,48.8,>30,NZ,Away,Upto 2014
EH Bromley,AUS,Spin,1933-02-10,Brisbane,Australia,1933,1,19,60,0,1,466,1558,15,447,1498,15,31.066666666666666,>30,AUS,Home,Upto 2014
EH Hendren,ENG,Spin,1925-01-16,Adelaide,Australia,1925,1,27,41,1,1,1079,2740,29,1052,2699,28,37.206896551724135,>30,AUS,Away,Upto 2014
EH Hendren,ENG,Spin,1934-07-06,Manchester,England,1934,1,4,6,0,1,477,1272,12,473,1266,12,39.75,>30,ENG,Home,Upto 2014
EH Mattis,WI,Spin,1981-03-27,St John's,West Indies,1981,1,4,6,0,1,220,600,1,216,594,1,220.0,>30,WI,Home,Upto 2014
EH Mattis,WI,Spin,1981-04-10,Kingston,West Indies,1981,1,10,30,0,1,271,768,4,261,738,4,67.75,>30,WI,Home,Upto 2014
EJ Barlow,SA,Pace,1961-12-08,Durban,South Africa,1961,1,17,48,0,1,481,1242,23,464,1194,23,20.91304347826087,<=30,SA,Home,Upto 2014
EJ Barlow,SA,Pace,1961-12-26,Johannesburg,South Africa,1961,2,20,36,0,1,549,1269,21,529,1233,21,26.142857142857142,<=30,SA,Home,Upto 2014
EJ Barlow,SA,Pace,1962-01-01,Cape Town,South Africa,1962,2,93,174,0,1,494,1176,15,401,1002,15,32.93333333333333,>30,SA,Home,Upto 2014
EJ Barlow,SA,Pace,1963-12-06,Brisbane,Australia,1963,1,71,72,1,1,562,1265,13,491,1193,12,43.23076923076923,>30,AUS,Away,Upto 2014
EJ Barlow,SA,Pace,1964-01-01,Melbourne,Australia,1964,2,100,150,3,1,870,1955,24,770,1805,21,36.25,>30,AUS,Away,Upto 2014
EJ Barlow,SA,Pace,1964-01-10,Sydney,Australia,1964,2,14,24,0,1,926,1995,29,912,1971,29,31.93103448275862,>30,AUS,Away,Upto 2014
EJ Barlow,SA,Pace,1964-01-24,Adelaide,Australia,1964,1,6,40,3,1,1036,2074,26,1030,2034,23,39.84615384615385,>30,AUS,Away,Upto 2014
EJ Barlow,SA,Pace,1964-02-07,Sydney,Australia,1964,2,39,80,0,1,694,1880,20,655,1800,20,34.7,>30,AUS,Away,Upto 2014
EJ Barlow,SA,Pace,1964-02-21,Wellington,New Zealand,1964,2,51,78,0,1,514,1667,18,463,1589,18,28.555555555555557,<=30,NZ,Away,Upto 2014
EJ Barlow,SA,Pace,1964-02-28,Dunedin,New Zealand,1964,1,11,18,0,1,306,1085,13,295,1067,13,23.53846153846154,<=30,NZ,Away,Upto 2014
EJ Barlow,SA,Pace,1964-03-13,Auckland,New Zealand,1964,2,39,168,2,1,606,1729,24,567,1561,22,25.25,<=30,NZ,Away,Upto 2014
EJ Barlow,SA,Pace,1964-12-04,Durban,South Africa,1964,1,36,120,0,1,364,1062,8,328,942,8,45.5,>30,SA,Home,Upto 2014
EJ Barlow,SA,Pace,1964-12-23,Johannesburg,South Africa,1964,1,33,48,0,1,619,1341,11,586,1293,11,56.27272727272727,>30,SA,Home,Upto 2014
EJ Barlow,SA,Pace,1965-01-01,Cape Town,South Africa,1965,1,37,72,1,1,647,1572,12,610,1500,11,53.916666666666664,>30,SA,Home,Upto 2014
EJ Barlow,SA,Pace,1965-01-22,Johannesburg,South Africa,1965,1,34,108,1,1,754,1664,13,720,1556,12,58.0,>30,SA,Home,Upto 2014
EJ Barlow,SA,Pace,1965-02-12,Gqeberha,South Africa,1965,1,55,132,3,1,624,1549,12,569,1417,9,52.0,>30,SA,Home,Upto 2014
EJ Barlow,SA,Pace,1965-07-22,Lord's,England,1965,2,56,168,0,1,689,1908,25,633,1740,25,27.56,<=30,ENG,Away,Upto 2014
EJ Barlow,SA,Pace,1965-08-05,Nottingham,England,1965,1,20,42,0,1,718,1736,30,698,1694,30,23.933333333333334,<=30,ENG,Away,Upto 2014
EJ Barlow,SA,Pace,1965-08-26,The Oval,England,1965,2,49,102,0,1,786,1848,27,737,1746,27,29.11111111111111,<=30,ENG,Away,Upto 2014
EJ Barlow,SA,Pace,1966-12-23,Johannesburg,South Africa,1966,2,86,192,4,1,809,1914,26,723,1722,22,31.115384615384617,>30,SA,Home,Upto 2014
EJ Barlow,SA,Pace,1966-12-31,Cape Town,South Africa,1966,2,86,213,5,1,762,1783,22,676,1570,17,34.63636363636363,>30,SA,Home,Upto 2014
EJ Barlow,SA,Pace,1967-01-20,Durban,South Africa,1967,2,46,150,3,1,725,1921,25,679,1771,22,29.0,<=30,SA,Home,Upto 2014
EJ Barlow,SA,Pace,1967-02-03,Johannesburg,South Africa,1967,2,45,108,1,1,518,1312,23,473,1204,22,22.52173913043478,<=30,SA,Home,Upto 2014
EJ Barlow,SA,Pace,1967-02-24,Gqeberha,South Africa,1967,2,61,114,2,1,655,1640,26,594,1526,24,25.192307692307693,<=30,SA,Home,Upto 2014
EJ Barlow,SA,Pace,1970-01-22,Cape Town,South Africa,1970,2,29,42,0,1,471,1312,21,442,1270,21,22.428571428571427,<=30,SA,Home,Upto 2014
EJ Barlow,SA,Pace,1970-02-05,Durban,South Africa,1970,2,87,246,6,1,686,1387,21,599,1141,15,32.666666666666664,>30,SA,Home,Upto 2014
EJ Barlow,SA,Pace,1970-02-19,Johannesburg,South Africa,1970,2,48,114,2,1,766,1822,28,718,1708,26,27.357142857142858,<=30,SA,Home,Upto 2014
EJ Barlow,SA,Pace,1970-03-05,Gqeberha,South Africa,1970,2,93,162,3,1,887,1974,33,794,1812,30,26.87878787878788,<=30,SA,Home,Upto 2014
EJ Chatfield,NZ,Pace,1975-02-20,Auckland,New Zealand,1975,1,95,152,0,1,616,1261,8,521,1109,8,77.0,>30,NZ,Home,Upto 2014
EJ Chatfield,NZ,Pace,1977-02-18,Christchurch,New Zealand,1977,2,159,336,3,1,990,2047,22,831,1711,19,45.0,>30,NZ,Home,Upto 2014
EJ Chatfield,NZ,Pace,1977-02-25,Auckland,New Zealand,1977,2,115,230,4,1,733,1600,29,618,1370,25,25.275862068965516,<=30,NZ,Home,Upto 2014
EJ Chatfield,NZ,Pace,1978-02-24,Christchurch,New Zealand,1978,2,116,336,1,1,664,1812,24,548,1476,23,27.666666666666668,<=30,NZ,Home,Upto 2014
EJ Chatfield,NZ,Pace,1982-02-26,Wellington,New Zealand,1982,1,7,48,0,1,258,786,4,251,738,4,64.5,>30,NZ,Home,Upto 2014
EJ Chatfield,NZ,Pace,1983-03-04,Christchurch,New Zealand,1983,2,60,191,3,1,557,1256,25,497,1065,22,22.28,<=30,NZ,Home,Upto 2014
EJ Chatfield,NZ,Pace,1983-03-11,Wellington,New Zealand,1983,2,81,233,7,1,592,1490,31,511,1257,24,19.096774193548388,<=30,NZ,Home,Upto 2014
EJ Chatfield,NZ,Pace,1983-07-14,The Oval,England,1983,2,133,312,0,1,726,1662,20,593,1350,20,36.3,>30,ENG,Away,Upto 2014
EJ Chatfield,NZ,Pace,1983-07-28,Leeds,England,1983,2,162,306,6,1,786,1782,32,624,1476,26,24.5625,<=30,ENG,Away,Upto 2014
EJ Chatfield,NZ,Pace,1983-08-11,Lord's,England,1983,2,145,300,5,1,667,1618,29,522,1318,24,23.0,<=30,ENG,Away,Upto 2014
EJ Chatfield,NZ,Pace,1984-01-20,Wellington,New Zealand,1984,2,92,198,0,1,1002,2037,24,910,1839,24,41.75,>30,NZ,Home,Upto 2014
EJ Chatfield,NZ,Pace,1984-02-03,Christchurch,New Zealand,1984,2,24,116,4,1,404,927,25,380,811,21,16.16,<=30,NZ,Home,Upto 2014
EJ Chatfield,NZ,Pace,1984-02-10,Auckland,New Zealand,1984,1,72,276,2,1,656,1758,12,584,1482,10,54.666666666666664,>30,NZ,Home,Upto 2014
EJ Chatfield,NZ,Pace,1984-03-16,Colombo (SSC),Sri Lanka,1984,2,113,294,5,1,563,1643,28,450,1349,23,20.107142857142858,<=30,SL,Away,Upto 2014
EJ Chatfield,NZ,Pace,1984-03-24,Colombo (CCC),Sri Lanka,1984,2,90,186,5,1,479,1056,21,389,870,16,22.80952380952381,<=30,SL,Away,Upto 2014
EJ Chatfield,NZ,Pace,1984-11-16,Lahore,Pakistan,1984,2,69,242,3,1,340,861,14,271,619,11,24.285714285714285,<=30,PAK,Away,Upto 2014
EJ Chatfield,NZ,Pace,1985-01-18,Wellington,New Zealand,1985,1,52,150,1,1,458,1096,12,406,946,11,38.166666666666664,>30,NZ,Home,Upto 2014
EJ Chatfield,NZ,Pace,1985-01-25,Auckland,New Zealand,1985,2,71,198,5,1,673,1429,25,602,1231,20,26.92,<=30,NZ,Home,Upto 2014
EJ Chatfield,NZ,Pace,1985-02-09,Dunedin,New Zealand,1985,2,111,300,3,1,862,2018,34,751,1718,31,25.352941176470587,<=30,NZ,Home,Upto 2014
EJ Chatfield,NZ,Pace,1985-03-29,Port of Spain,West Indies,1985,2,124,300,10,1,784,1698,30,660,1398,20,26.133333333333333,<=30,WI,Away,Upto 2014
EJ Chatfield,NZ,Pace,1985-04-06,Georgetown,West Indies,1985,2,165,276,1,1,825,1600,20,660,1324,19,41.25,>30,WI,Away,Upto 2014
EJ Chatfield,NZ,Pace,1985-04-26,Bridgetown,West Indies,1985,1,57,168,2,1,558,1140,29,501,972,27,19.24137931034483,<=30,WI,Away,Upto 2014
EJ Chatfield,NZ,Pace,1985-05-04,Kingston,West Indies,1985,2,95,168,0,1,691,1483,26,596,1315,26,26.576923076923077,<=30,WI,Away,Upto 2014
EJ Chatfield,NZ,Pace,1985-11-08,Brisbane,Australia,1985,2,104,300,3,1,699,1580,23,595,1280,20,30.391304347826086,>30,AUS,Away,Upto 2014
EJ Chatfield,NZ,Pace,1985-11-30,W.A.C.A,Australia,1985,2,80,276,4,1,726,2093,28,646,1817,24,25.928571428571427,<=30,AUS,Away,Upto 2014
EJ Chatfield,NZ,Pace,1986-02-21,Wellington,New Zealand,1986,1,96,216,1,1,687,1390,14,591,1174,13,49.07142857142857,>30,NZ,Home,Upto 2014
EJ Chatfield,NZ,Pace,1986-02-28,Christchurch,New Zealand,1986,2,85,318,2,1,712,1681,22,627,1363,20,32.36363636363637,>30,NZ,Home,Upto 2014
EJ Chatfield,NZ,Pace,1986-03-13,Auckland,New Zealand,1986,2,73,282,5,1,481,1210,15,408,928,10,32.06666666666667,>30,NZ,Home,Upto 2014
EJ Chatfield,NZ,Pace,1986-08-21,The Oval,England,1986,1,73,126,3,1,479,811,12,406,685,9,39.916666666666664,>30,ENG,Away,Upto 2014
EJ Chatfield,NZ,Pace,1987-02-20,Wellington,New Zealand,1987,2,115,258,4,1,656,1620,18,541,1362,14,36.44444444444444,>30,NZ,Home,Upto 2014
EJ Chatfield,NZ,Pace,1987-02-27,Auckland,New Zealand,1987,2,95,225,1,1,550,1311,24,455,1086,23,22.916666666666668,<=30,NZ,Home,Upto 2014
EJ Chatfield,NZ,Pace,1987-03-12,Christchurch,New Zealand,1987,2,72,204,5,1,630,1188,33,558,984,28,19.09090909090909,<=30,NZ,Home,Upto 2014
EJ Chatfield,NZ,Pace,1987-04-16,Colombo (CCC),Sri Lanka,1987,1,104,228,2,1,574,1325,10,470,1097,8,57.4,>30,SL,Away,Upto 2014
EJ Chatfield,NZ,Pace,1987-12-04,Brisbane,Australia,1987,1,58,204,0,1,634,1568,27,576,1364,27,23.48148148148148,<=30,AUS,Away,Upto 2014
EJ Chatfield,NZ,Pace,1987-12-26,Melbourne,Australia,1987,2,96,306,2,1,846,1960,31,750,1654,29,27.29032258064516,<=30,AUS,Away,Upto 2014
EJ Chatfield,NZ,Pace,1988-02-12,Christchurch,New Zealand,1988,2,123,432,8,1,693,1999,33,570,1567,25,21.0,<=30,NZ,Home,Upto 2014
EJ Chatfield,NZ,Pace,1988-02-25,Auckland,New Zealand,1988,1,37,187,4,1,724,1989,22,687,1802,18,32.90909090909091,>30,NZ,Home,Upto 2014
EJ Chatfield,NZ,Pace,1988-03-03,Wellington,New Zealand,1988,1,38,138,1,1,376,817,5,338,679,4,75.2,>30,NZ,Home,Upto 2014
EJ Chatfield,NZ,Pace,1988-11-12,Bengaluru,India,1988,2,114,264,1,1,219,525,9,105,261,8,24.333333333333332,<=30,IND,Away,Upto 2014
EJ Chatfield,NZ,Pace,1988-11-24,Wankhede,India,1988,2,60,168,2,1,384,842,15,324,674,13,25.6,<=30,IND,Away,Upto 2014
EJ Chatfield,NZ,Pace,1988-12-02,Hyderabad (Deccan),India,1988,2,87,204,3,1,410,867,17,323,663,14,24.11764705882353,<=30,IND,Away,Upto 2014
EJ Chatfield,NZ,Pace,1989-02-10,Wellington,New Zealand,1989,1,82,318,1,1,750,1984,22,668,1666,21,34.09090909090909,>30,NZ,Home,Upto 2014
EJ Chatfield,NZ,Pace,1989-02-24,Auckland,New Zealand,1989,1,158,390,1,1,397,1018,6,239,628,5,66.16666666666667,>30,NZ,Home,Upto 2014
EJ Gray,NZ,Spin,1983-08-11,Lord's,England,1983,1,73,180,3,1,227,566,11,154,386,8,20.636363636363637,<=30,ENG,Away,Upto 2014
EJ Gray,NZ,Spin,1983-08-25,Nottingham,England,1983,2,55,108,1,1,432,966,18,377,858,17,24.0,<=30,ENG,Away,Upto 2014
EJ Gray,NZ,Spin,1984-11-16,Lahore,Pakistan,1984,2,64,156,4,1,445,1036,19,381,880,15,23.42105263157895,<=30,PAK,Away,Upto 2014
EJ Gray,NZ,Spin,1984-11-25,Hyderabad (Sind),Pakistan,1984,2,119,198,0,1,706,1491,27,587,1293,27,26.14814814814815,<=30,PAK,Away,Upto 2014
EJ Gray,NZ,Spin,1986-07-24,Lord's,England,1986,2,112,354,3,1,350,940,10,238,586,7,35.0,>30,ENG,Away,Upto 2014
EJ Gray,NZ,Spin,1986-08-07,Nottingham,England,1986,2,85,222,2,1,295,797,10,210,575,8,29.5,<=30,ENG,Away,Upto 2014
EJ Gray,NZ,Spin,1986-08-21,The Oval,England,1986,1,74,126,0,1,193,510,3,119,384,3,64.33333333333333,>30,ENG,Away,Upto 2014
EJ Gray,NZ,Spin,1987-04-16,Colombo (CCC),Sri Lanka,1987,1,35,162,1,1,223,696,4,188,534,3,55.75,>30,SL,Away,Upto 2014
EJ Gray,NZ,Spin,1987-12-11,Adelaide,Australia,1987,1,102,264,0,1,613,1530,11,511,1266,11,55.72727272727273,>30,AUS,Away,Upto 2014
EJ Gray,NZ,Spin,1988-11-12,Bengaluru,India,1988,2,167,306,3,1,620,1702,21,453,1396,18,29.523809523809526,<=30,IND,Away,Upto 2014
EJ Tyler,ENG,Spin,1896-03-21,Cape Town,South Africa,1896,2,65,145,4,1,223,529,14,158,384,10,15.928571428571429,<=30,SA,Away,After 1965
EL Dalton,SA,Spin,1935-06-29,Lord's,England,1935,1,33,78,2,1,484,1320,22,451,1242,20,22.0,<=30,ENG,Away,Upto 2014
EL Dalton,SA,Spin,1935-07-27,Manchester,England,1935,1,23,24,0,1,449,1029,11,426,1005,11,40.81818181818182,>30,ENG,Away,Upto 2014
EL Dalton,SA,Spin,1935-08-17,The Oval,England,1935,1,50,96,0,1,498,864,8,448,768,8,62.25,>30,ENG,Away,Upto 2014
EL Dalton,SA,Spin,1935-12-14,Durban,South Africa,1935,2,37,45,1,1,684,1775,22,647,1730,21,31.09090909090909,>30,SA,Home,Upto 2014
EL Dalton,SA,Spin,1938-12-24,Johannesburg,South Africa,1938,2,71,133,3,1,478,1422,15,407,1289,12,31.866666666666667,>30,SA,Home,Upto 2014
EL Dalton,SA,Spin,1939-01-20,Durban,South Africa,1939,1,74,104,0,1,407,989,9,333,885,9,45.22222222222222,>30,SA,Home,Upto 2014
EL Dalton,SA,Spin,1939-02-18,Johannesburg,South Africa,1939,2,43,64,0,1,359,773,7,316,709,7,51.285714285714285,>30,SA,Home,Upto 2014
EL Dalton,SA,Spin,1939-03-03,Durban,South Africa,1939,2,159,320,6,1,794,1998,16,635,1678,10,49.625,>30,SA,Home,Upto 2014
EL McCormick,AUS,Pace,1935-12-14,Durban,South Africa,1935,2,76,126,1,1,348,794,8,272,668,7,43.5,>30,SA,Away,Upto 2014
EL McCormick,AUS,Pace,1935-12-24,Johannesburg,South Africa,1935,2,165,252,6,1,547,996,13,382,744,7,42.07692307692308,>30,SA,Away,Upto 2014
EL McCormick,AUS,Pace,1936-01-01,Cape Town,South Africa,1936,2,11,24,0,1,144,300,3,133,276,3,48.0,>30,SA,Away,Upto 2014
EL McCormick,AUS,Pace,1936-02-15,Johannesburg,South Africa,1936,2,65,138,5,1,303,592,11,238,454,6,27.545454545454547,<=30,SA,Away,Upto 2014
EL McCormick,AUS,Pace,1936-02-28,Durban,South Africa,1936,2,101,211,3,1,320,685,7,219,474,4,45.714285714285715,>30,SA,Away,Upto 2014
EL McCormick,AUS,Pace,1936-12-04,Brisbane,Australia,1936,1,26,64,3,1,297,839,25,271,775,22,11.88,<=30,AUS,Home,Upto 2014
EL McCormick,AUS,Pace,1936-12-18,Sydney,Australia,1936,1,79,160,2,1,331,936,17,252,776,15,19.470588235294116,<=30,AUS,Home,Upto 2014
EL McCormick,AUS,Pace,1937-01-29,Adelaide,Australia,1937,2,124,272,4,1,675,1448,20,551,1176,16,33.75,>30,AUS,Home,Upto 2014
EL McCormick,AUS,Pace,1937-02-26,Melbourne,Australia,1937,2,87,176,2,1,632,1154,16,545,978,14,39.5,>30,AUS,Home,Upto 2014
EL McCormick,AUS,Pace,1938-06-10,Nottingham,England,1938,1,108,192,1,1,464,954,6,356,762,5,77.33333333333333,>30,ENG,Away,Upto 2014
EL McCormick,AUS,Pace,1938-06-24,Lord's,England,1938,2,173,306,7,1,661,1148,17,488,842,10,38.88235294117647,>30,ENG,Away,Upto 2014
EL McCormick,AUS,Pace,1938-07-22,Leeds,England,1938,2,64,186,2,1,285,715,10,221,529,8,28.5,<=30,ENG,Away,Upto 2014
EL St Hill,WI,Pace,1930-01-11,Bridgetown,West Indies,1930,2,134,276,2,1,797,1692,15,663,1416,13,53.13333333333333,>30,WI,Home,Upto 2014
EL St Hill,WI,Pace,1930-02-21,Georgetown,West Indies,1930,2,87,282,1,1,688,1706,25,601,1424,24,27.52,<=30,WI,Home,Upto 2014
EL a'Beckett,AUS,Pace,1928-12-29,Melbourne,Australia,1928,2,131,354,1,1,730,1882,14,599,1528,13,52.142857142857146,>30,AUS,Home,Upto 2014
EL a'Beckett,AUS,Pace,1929-02-01,Adelaide,Australia,1929,2,85,348,1,1,620,1906,12,535,1558,11,51.666666666666664,>30,AUS,Home,Upto 2014
EL a'Beckett,AUS,Pace,1930-07-11,Leeds,England,1930,2,66,234,1,1,460,1116,6,394,882,5,76.66666666666667,>30,ENG,Away,Upto 2014
EL a'Beckett,AUS,Pace,1931-12-31,Melbourne,Australia,1931,2,35,126,0,1,596,1454,16,561,1328,16,37.25,>30,AUS,Home,Upto 2014
EP Nupen,SA,Pace,1921-11-05,Durban,South Africa,1921,2,101,186,2,1,645,1385,24,544,1199,22,26.875,<=30,SA,Home,Upto 2014
EP Nupen,SA,Pace,1921-11-12,Johannesburg,South Africa,1921,2,89,100,0,1,791,1453,15,702,1353,15,52.733333333333334,>30,SA,Home,Upto 2014
EP Nupen,SA,Pace,1922-12-23,Johannesburg,South Africa,1922,2,111,282,6,1,634,1476,30,523,1194,24,21.133333333333333,<=30,SA,Home,Upto 2014
EP Nupen,SA,Pace,1923-01-01,Cape Town,South Africa,1923,2,89,234,1,1,417,1260,23,328,1026,22,18.130434782608695,<=30,SA,Home,Upto 2014
EP Nupen,SA,Pace,1923-01-18,Durban,South Africa,1923,1,86,246,2,1,496,1373,16,410,1127,14,31.0,>30,SA,Home,Upto 2014
EP Nupen,SA,Pace,1923-02-09,Johannesburg,South Africa,1923,2,138,264,2,1,723,1725,22,585,1461,20,32.86363636363637,>30,SA,Home,Upto 2014
EP Nupen,SA,Pace,1924-06-14,Birmingham,England,1924,1,66,108,0,1,406,735,19,340,627,19,21.36842105263158,<=30,ENG,Away,Upto 2014
EP Nupen,SA,Pace,1924-07-12,Leeds,England,1924,2,91,186,1,1,303,630,5,212,444,4,60.6,>30,ENG,Away,Upto 2014
EP Nupen,SA,Pace,1927-12-24,Johannesburg,South Africa,1927,2,140,360,1,1,371,971,19,231,611,18,19.526315789473685,<=30,SA,Home,Upto 2014
EP Nupen,SA,Pace,1927-12-31,Cape Town,South Africa,1927,2,100,234,1,1,474,1145,15,374,911,14,31.6,>30,SA,Home,Upto 2014
EP Nupen,SA,Pace,1928-01-21,Durban,South Africa,1928,2,123,329,5,1,482,1079,8,359,750,3,60.25,>30,SA,Home,Upto 2014
EP Nupen,SA,Pace,1928-01-28,Johannesburg,South Africa,1928,2,91,342,1,1,503,1258,23,412,916,22,21.869565217391305,<=30,SA,Home,Upto 2014
EP Nupen,SA,Pace,1928-02-04,Durban,South Africa,1928,2,97,257,6,1,338,797,16,241,540,10,21.125,<=30,SA,Home,Upto 2014
EP Nupen,SA,Pace,1930-12-24,Johannesburg,South Africa,1930,2,150,310,11,1,390,954,25,240,644,14,15.6,<=30,SA,Home,Upto 2014
EP Nupen,SA,Pace,1931-01-01,Cape Town,South Africa,1931,2,69,234,1,1,323,942,8,254,708,7,40.375,>30,SA,Home,Upto 2014
EP Nupen,SA,Pace,1931-02-13,Johannesburg,South Africa,1931,2,194,403,9,1,670,1471,21,476,1068,12,31.904761904761905,>30,SA,Home,Upto 2014
EP Nupen,SA,Pace,1936-02-15,Johannesburg,South Africa,1936,1,53,84,1,1,303,592,11,250,508,10,27.545454545454547,<=30,SA,Home,Upto 2014
EQ Davies,SA,Pace,1936-02-15,Johannesburg,South Africa,1936,1,75,148,4,1,303,592,11,228,444,7,27.545454545454547,<=30,SA,Home,Upto 2014
EQ Davies,SA,Pace,1936-02-28,Durban,South Africa,1936,1,54,108,0,1,320,685,7,266,577,7,45.714285714285715,>30,SA,Home,Upto 2014
EQ Davies,SA,Pace,1938-12-24,Johannesburg,South Africa,1938,2,169,264,1,1,680,1468,10,511,1204,9,68.0,>30,SA,Home,Upto 2014
EQ Davies,SA,Pace,1938-12-31,Cape Town,South Africa,1938,1,77,128,1,1,456,999,10,379,871,9,45.6,>30,SA,Home,Upto 2014
EQ Davies,SA,Pace,1939-01-20,Durban,South Africa,1939,1,106,120,1,1,487,999,14,381,879,13,34.785714285714285,>30,SA,Home,Upto 2014
ER Dexter,ENG,Pace,1958-07-24,Manchester,England,1958,1,23,30,0,1,389,953,12,366,923,12,32.416666666666664,>30,ENG,Home,Upto 2014
ER Dexter,ENG,Pace,1959-02-27,Christchurch,New Zealand,1959,1,3,6,0,1,293,707,12,290,701,12,24.416666666666668,<=30,NZ,Away,Upto 2014
ER Dexter,ENG,Pace,1959-03-14,Auckland,New Zealand,1959,1,23,114,3,1,267,780,10,244,666,7,26.7,<=30,NZ,Away,Upto 2014
ER Dexter,ENG,Pace,1959-07-23,Manchester,England,1959,2,36,90,1,1,572,1208,15,536,1118,14,38.13333333333333,>30,ENG,Home,Upto 2014
ER Dexter,ENG,Pace,1959-08-20,The Oval,England,1959,2,35,138,2,1,341,1038,21,306,900,19,16.238095238095237,<=30,ENG,Home,Upto 2014
ER Dexter,ENG,Pace,1960-01-06,Bridgetown,West Indies,1960,1,85,226,2,1,552,1376,10,467,1150,8,55.2,>30,WI,Away,Upto 2014
ER Dexter,ENG,Pace,1960-01-28,Port of Spain,West Indies,1960,1,7,36,2,1,471,1183,24,464,1147,22,19.625,<=30,WI,Away,Upto 2014
ER Dexter,ENG,Pace,1960-02-17,Kingston,West Indies,1960,1,38,72,0,1,593,1359,23,555,1287,23,25.782608695652176,<=30,WI,Away,Upto 2014
ER Dexter,ENG,Pace,1960-03-09,Georgetown,West Indies,1960,1,20,30,0,1,483,950,12,463,920,12,40.25,>30,WI,Away,Upto 2014
ER Dexter,ENG,Pace,1960-03-25,Port of Spain,West Indies,1960,1,20,24,1,1,604,1109,11,584,1085,10,54.90909090909091,>30,WI,Away,Upto 2014
ER Dexter,ENG,Pace,1960-06-09,Birmingham,England,1960,2,8,42,0,1,549,1558,25,541,1516,25,21.96,<=30,ENG,Home,Upto 2014
ER Dexter,ENG,Pace,1960-06-23,Lord's,England,1960,1,17,24,2,1,549,1209,28,532,1185,26,19.607142857142858,<=30,ENG,Home,Upto 2014
ER Dexter,ENG,Pace,1960-07-07,Nottingham,England,1960,1,12,36,0,1,545,1319,26,533,1283,26,20.96153846153846,<=30,ENG,Home,Upto 2014
ER Dexter,ENG,Pace,1960-07-21,Manchester,England,1960,1,41,102,0,1,475,1326,23,434,1224,23,20.652173913043477,<=30,ENG,Home,Upto 2014
ER Dexter,ENG,Pace,1960-08-18,The Oval,England,1960,2,79,182,3,1,792,1752,24,713,1570,21,33.0,>30,ENG,Home,Upto 2014
ER Dexter,ENG,Pace,1961-06-08,Birmingham,England,1961,1,22,30,0,1,708,1529,14,686,1499,14,50.57142857142857,>30,ENG,Home,Upto 2014
ER Dexter,ENG,Pace,1961-06-22,Lord's,England,1961,1,56,144,3,1,687,1676,33,631,1532,30,20.818181818181817,<=30,ENG,Home,Upto 2014
ER Dexter,ENG,Pace,1961-07-27,Manchester,England,1961,2,77,160,6,1,869,2028,25,792,1868,19,34.76,>30,ENG,Home,Upto 2014
ER Dexter,ENG,Pace,1961-08-17,The Oval,England,1961,1,68,144,0,1,680,1860,19,612,1716,19,35.78947368421053,>30,ENG,Home,Upto 2014
ER Dexter,ENG,Pace,1961-10-21,Lahore,Pakistan,1961,2,36,84,1,1,400,1080,13,364,996,12,30.76923076923077,>30,PAK,Away,Upto 2014
ER Dexter,ENG,Pace,1961-11-11,Brabourne,India,1961,2,40,96,1,1,444,942,9,404,846,8,49.333333333333336,>30,IND,Away,Upto 2014
ER Dexter,ENG,Pace,1961-12-01,Kanpur,India,1961,1,84,186,2,1,383,915,5,299,729,3,76.6,>30,IND,Away,Upto 2014
ER Dexter,ENG,Pace,1961-12-13,Delhi,India,1961,1,11,12,0,1,206,507,4,195,495,4,51.5,>30,IND,Away,Upto 2014
ER Dexter,ENG,Pace,1961-12-30,Eden Gardens,India,1961,1,83,174,0,1,412,930,9,329,756,9,45.77777777777778,>30,IND,Away,Upto 2014
ER Dexter,ENG,Pace,1962-01-10,Chennai,India,1962,1,22,30,1,1,203,330,6,181,300,5,33.833333333333336,>30,IND,Away,Upto 2014
ER Dexter,ENG,Pace,1962-01-19,Dhaka,Bangladesh,1962,2,35,198,0,1,164,648,2,129,450,2,82.0,>30,BAN,Away,Upto 2014
ER Dexter,ENG,Pace,1962-02-02,Karachi,Pakistan,1962,2,134,302,5,1,353,912,11,219,610,6,32.09090909090909,>30,PAK,Away,Upto 2014
ER Dexter,ENG,Pace,1962-05-31,Birmingham,England,1962,2,39,114,0,1,384,834,12,345,720,12,32.0,>30,ENG,Home,Upto 2014
ER Dexter,ENG,Pace,1962-06-21,Lord's,England,1962,2,85,162,1,1,524,1195,25,439,1033,24,20.96,<=30,ENG,Home,Upto 2014
ER Dexter,ENG,Pace,1962-07-05,Leeds,England,1962,2,34,103,5,1,501,1157,23,467,1054,18,21.782608695652176,<=30,ENG,Home,Upto 2014
ER Dexter,ENG,Pace,1962-07-26,Nottingham,England,1962,1,25,42,1,1,602,1369,18,577,1327,17,33.44444444444444,>30,ENG,Home,Upto 2014
ER Dexter,ENG,Pace,1962-08-16,The Oval,England,1962,1,16,36,0,1,534,1069,17,518,1033,17,31.41176470588235,>30,ENG,Home,Upto 2014
ER Dexter,ENG,Pace,1962-11-30,Brisbane,Australia,1962,2,124,208,3,1,871,1952,19,747,1744,16,45.8421052631579,>30,AUS,Away,Upto 2014
ER Dexter,ENG,Pace,1962-12-29,Melbourne,Australia,1962,2,28,120,1,1,758,2009,23,730,1889,22,32.95652173913044,>30,AUS,Away,Upto 2014
ER Dexter,ENG,Pace,1963-01-11,Sydney,Australia,1963,1,27,26,0,1,454,1207,16,427,1181,16,28.375,<=30,AUS,Away,Upto 2014
ER Dexter,ENG,Pace,1963-01-25,Adelaide,Australia,1963,2,159,320,6,1,686,1693,27,527,1373,21,25.40740740740741,<=30,AUS,Away,Upto 2014
ER Dexter,ENG,Pace,1963-02-15,Sydney,Australia,1963,2,35,88,1,1,466,1318,15,431,1230,14,31.066666666666666,>30,AUS,Away,Upto 2014
ER Dexter,ENG,Pace,1963-02-23,Auckland,New Zealand,1963,1,20,54,0,1,301,863,11,281,809,11,27.363636363636363,<=30,NZ,Away,Upto 2014
ER Dexter,ENG,Pace,1963-03-01,Wellington,New Zealand,1963,1,2,6,0,1,394,894,13,392,888,13,30.307692307692307,>30,NZ,Away,Upto 2014
ER Dexter,ENG,Pace,1963-03-15,Christchurch,New Zealand,1963,2,26,114,0,1,462,1331,21,436,1217,21,22.0,<=30,NZ,Away,Upto 2014
ER Dexter,ENG,Pace,1963-06-06,Manchester,England,1963,1,16,72,0,1,370,899,6,354,827,6,61.666666666666664,>30,ENG,Home,Upto 2014
ER Dexter,ENG,Pace,1963-06-20,Lord's,England,1963,1,41,120,0,1,666,1730,31,625,1610,31,21.483870967741936,<=30,ENG,Home,Upto 2014
ER Dexter,ENG,Pace,1963-07-04,Birmingham,England,1963,2,45,138,5,1,467,1099,27,422,961,22,17.296296296296298,<=30,ENG,Home,Upto 2014
ER Dexter,ENG,Pace,1963-07-25,Leeds,England,1963,2,83,150,1,1,551,1254,21,468,1104,20,26.238095238095237,<=30,ENG,Home,Upto 2014
ER Dexter,ENG,Pace,1963-08-22,The Oval,England,1963,2,42,90,1,1,581,1365,22,539,1275,21,26.40909090909091,<=30,ENG,Home,Upto 2014
ER Dexter,ENG,Pace,1964-06-18,Lord's,England,1964,2,21,60,2,1,401,987,19,380,927,17,21.105263157894736,<=30,ENG,Home,Upto 2014
ER Dexter,ENG,Pace,1964-07-02,Leeds,England,1964,2,49,132,0,1,604,1337,21,555,1205,21,28.761904761904763,<=30,ENG,Home,Upto 2014
ER Dexter,ENG,Pace,1964-07-23,Manchester,England,1964,1,12,24,0,1,759,1991,14,747,1967,14,54.214285714285715,>30,ENG,Home,Upto 2014
ER Dexter,ENG,Pace,1964-08-13,The Oval,England,1964,1,36,78,1,1,732,1783,22,696,1705,21,33.27272727272727,>30,ENG,Home,Upto 2014
ER Dexter,ENG,Pace,1964-12-23,Johannesburg,South Africa,1964,2,49,72,1,1,619,1341,11,570,1269,10,56.27272727272727,>30,SA,Away,Upto 2014
ER Dexter,ENG,Pace,1965-01-01,Cape Town,South Africa,1965,2,74,114,1,1,647,1572,12,573,1458,11,53.916666666666664,>30,SA,Away,Upto 2014
ER Dexter,ENG,Pace,1965-01-22,Johannesburg,South Africa,1965,1,30,36,0,1,754,1664,13,724,1628,13,58.0,>30,SA,Away,Upto 2014
ER Dexter,ENG,Pace,1965-05-27,Birmingham,England,1965,1,18,30,1,1,468,1202,15,450,1172,14,31.2,>30,ENG,Home,Upto 2014
ER Dexter,ENG,Pace,1965-06-17,Lord's,England,1965,1,27,48,0,1,637,1471,22,610,1423,22,28.954545454545453,<=30,ENG,Home,Upto 2014
ER Dexter,ENG,Pace,1968-07-25,Leeds,England,1968,2,28,48,0,1,706,1746,18,678,1698,18,39.22222222222222,>30,ENG,Home,Upto 2014
ER Mayne,AUS,Spin,1921-11-12,Johannesburg,South Africa,1921,1,1,6,0,1,332,785,12,331,779,12,27.666666666666668,<=30,SA,Away,Upto 2014
ER Wilson,ENG,Spin,1921-02-25,Sydney,Australia,1921,2,36,123,3,1,605,1063,17,569,940,14,35.588235294117645,>30,AUS,Away,Upto 2014
ERH Fuller,SA,Pace,1953-01-24,Adelaide,Australia,1953,2,131,224,2,1,427,785,5,296,561,3,85.4,>30,AUS,Away,Upto 2014
ERH Fuller,SA,Pace,1953-02-06,Melbourne,Australia,1953,2,140,394,8,1,486,1431,11,346,1037,3,44.18181818181818,>30,AUS,Away,Upto 2014
ERH Fuller,SA,Pace,1953-03-06,Wellington,New Zealand,1953,2,72,280,4,1,299,1005,14,227,725,10,21.357142857142858,<=30,NZ,Away,Upto 2014
ERH Fuller,SA,Pace,1953-03-13,Auckland,New Zealand,1953,2,74,270,0,1,316,1056,6,242,786,6,52.666666666666664,>30,NZ,Away,Upto 2014
ERH Fuller,SA,Pace,1955-06-09,Nottingham,England,1955,1,59,174,3,1,443,1507,20,384,1333,17,22.15,<=30,ENG,Away,Upto 2014
ERH Fuller,SA,Pace,1955-08-13,The Oval,England,1955,2,67,282,3,1,283,1030,15,216,748,12,18.866666666666667,<=30,ENG,Away,Upto 2014
ERH Fuller,SA,Pace,1957-12-31,Cape Town,South Africa,1957,1,125,274,2,1,357,1102,8,232,828,6,44.625,>30,SA,Home,Upto 2014
ERH Toshack,AUS,Pace,1946-03-29,Wellington,New Zealand,1946,2,18,174,6,1,212,690,16,194,516,10,13.25,<=30,NZ,Away,Upto 2014
ERH Toshack,AUS,Pace,1946-11-29,Brisbane,Australia,1946,2,99,300,9,1,604,1516,23,505,1216,14,26.26086956521739,<=30,AUS,Home,Upto 2014
ERH Toshack,AUS,Pace,1946-12-13,Sydney,Australia,1946,2,22,104,0,1,412,1072,9,390,968,9,45.77777777777778,>30,AUS,Home,Upto 2014
ERH Toshack,AUS,Pace,1947-01-01,Melbourne,Australia,1947,2,127,336,2,1,922,1990,21,795,1654,19,43.904761904761905,>30,AUS,Home,Upto 2014
ERH Toshack,AUS,Pace,1947-01-31,Adelaide,Australia,1947,2,135,528,5,1,774,1993,20,639,1465,15,38.7,>30,AUS,Home,Upto 2014
ERH Toshack,AUS,Pace,1947-02-28,Sydney,Australia,1947,2,54,160,1,1,392,1131,16,338,971,15,24.5,<=30,AUS,Home,Upto 2014
ERH Toshack,AUS,Pace,1947-11-28,Brisbane,Australia,1947,2,31,155,11,1,345,994,21,314,839,10,16.428571428571427,<=30,AUS,Home,Upto 2014
ERH Toshack,AUS,Pace,1948-01-23,Adelaide,Australia,1948,2,139,344,2,1,583,1360,19,444,1016,17,30.68421052631579,>30,AUS,Home,Upto 2014
ERH Toshack,AUS,Pace,1948-06-10,Nottingham,England,1948,2,88,282,2,1,600,1427,17,512,1145,15,35.294117647058826,>30,ENG,Away,Upto 2014
ERH Toshack,AUS,Pace,1948-06-24,Lord's,England,1948,2,63,229,5,1,703,1601,26,640,1372,21,27.03846153846154,<=30,ENG,Away,Upto 2014
ERH Toshack,AUS,Pace,1948-07-08,Manchester,England,1948,2,101,318,3,1,513,1476,16,412,1158,13,32.0625,>30,ENG,Away,Upto 2014
ERH Toshack,AUS,Pace,1948-07-22,Leeds,England,1948,1,112,210,1,1,942,2038,19,830,1828,18,49.578947368421055,>30,ENG,Away,Upto 2014
ERT Holmes,ENG,Spin,1935-01-24,Port of Spain,West Indies,1935,1,10,18,1,1,418,1002,12,408,984,11,34.833333333333336,>30,WI,Away,Upto 2014
ERT Holmes,ENG,Spin,1935-02-14,Georgetown,West Indies,1935,1,16,18,1,1,339,996,16,323,978,15,21.1875,<=30,WI,Away,Upto 2014
ERT Holmes,ENG,Spin,1935-03-14,Kingston,West Indies,1935,1,40,48,0,1,453,1026,10,413,978,10,45.3,>30,WI,Away,Upto 2014
ERT Holmes,ENG,Spin,1935-06-29,Lord's,England,1935,1,10,24,0,1,484,1320,22,474,1296,22,22.0,<=30,ENG,Home,Upto 2014
ES Atkinson,WI,Pace,1958-01-17,Bridgetown,West Indies,1958,2,163,342,3,1,627,1370,15,464,1028,12,41.8,>30,WI,Home,Upto 2014
ES Atkinson,WI,Pace,1958-02-26,Kingston,West Indies,1958,2,78,234,8,1,916,1594,17,838,1360,9,53.88235294117647,>30,WI,Home,Upto 2014
ES Atkinson,WI,Pace,1958-03-26,Port of Spain,West Indies,1958,1,66,186,1,1,413,869,16,347,683,15,25.8125,<=30,WI,Home,Upto 2014
ES Atkinson,WI,Pace,1958-11-28,Brabourne,India,1958,2,77,288,3,1,439,1262,18,362,974,15,24.38888888888889,<=30,IND,Away,Upto 2014
ES Atkinson,WI,Pace,1959-01-21,Chennai,India,1959,2,38,144,1,1,372,990,12,334,846,11,31.0,>30,IND,Away,Upto 2014
ES Atkinson,WI,Pace,1959-02-06,Delhi,India,1959,2,48,90,0,1,501,1007,14,453,917,14,35.785714285714285,>30,IND,Away,Upto 2014
ES Atkinson,WI,Pace,1959-03-06,Dhaka,Bangladesh,1959,2,64,192,5,1,310,823,30,246,631,25,10.333333333333334,<=30,BAN,Away,Upto 2014
ES Atkinson,WI,Pace,1959-03-26,Lahore,Pakistan,1959,2,55,158,4,1,381,764,12,326,606,8,31.75,>30,PAK,Away,Upto 2014
ES Newson,SA,Pace,1930-12-24,Johannesburg,South Africa,1930,2,41,132,0,1,390,954,25,349,822,25,15.6,<=30,SA,Home,Upto 2014
ES Newson,SA,Pace,1939-02-18,Johannesburg,South Africa,1939,2,75,192,2,1,381,1034,15,306,842,13,25.4,<=30,SA,Home,Upto 2014
ES Newson,SA,Pace,1939-03-03,Durban,South Africa,1939,2,149,550,2,1,1100,3449,18,951,2899,16,61.111111111111114,>30,SA,Home,Upto 2014
ESH Giddins,ENG,Pace,1999-08-19,The Oval,England,1999,2,79,156,4,1,501,1268,29,422,1112,25,17.275862068965516,<=30,ENG,Home,Upto 2014
ESH Giddins,ENG,Pace,2000-05-18,Lord's,England,2000,2,42,84,7,1,527,1078,29,485,994,22,18.17241379310345,<=30,ENG,Home,Upto 2014
ESH Giddins,ENG,Pace,2000-06-01,Nottingham,England,2000,1,46,96,1,1,655,1521,23,609,1425,22,28.47826086956522,<=30,ENG,Home,Upto 2014
ESH Giddins,ENG,Pace,2000-06-15,Birmingham,England,2000,1,73,108,0,1,606,1373,25,533,1265,25,24.24,<=30,ENG,Home,Upto 2014
ESM Kentish,WI,Pace,1948-03-27,Kingston,West Indies,1948,2,106,282,3,1,401,1001,16,295,719,13,25.0625,<=30,WI,Home,Upto 2014
ESM Kentish,WI,Pace,1954-01-15,Kingston,West Indies,1954,2,72,258,5,1,630,1500,20,558,1242,15,31.5,>30,WI,Home,Upto 2014
ET Willett,WI,Spin,1973-03-09,Bridgetown,West Indies,1973,2,124,390,2,1,470,1314,10,346,924,8,47.0,>30,WI,Home,Upto 2014
ET Willett,WI,Spin,1973-03-23,Port of Spain,West Indies,1973,2,95,282,3,1,758,1913,26,663,1631,23,29.153846153846153,<=30,WI,Home,Upto 2014
ET Willett,WI,Spin,1973-04-06,Georgetown,West Indies,1973,2,108,198,2,1,241,564,5,133,366,3,48.2,>30,WI,Home,Upto 2014
ET Willett,WI,Spin,1974-12-11,Delhi,India,1974,2,91,234,2,1,662,1469,18,571,1235,16,36.77777777777778,>30,IND,Away,Upto 2014
ET Willett,WI,Spin,1974-12-27,Eden Gardens,India,1974,2,64,222,2,1,505,1382,15,441,1160,13,33.666666666666664,>30,IND,Away,Upto 2014
EW Clark,ENG,Pace,1929-08-17,The Oval,England,1929,1,79,216,3,1,426,1011,9,347,795,6,47.333333333333336,>30,ENG,Home,Upto 2014
EW Clark,ENG,Pace,1933-07-22,Manchester,England,1933,2,163,330,6,1,416,958,13,253,628,7,32.0,>30,ENG,Home,Upto 2014
EW Clark,ENG,Pace,1933-08-12,The Oval,England,1933,2,70,174,5,1,389,809,16,319,635,11,24.3125,<=30,ENG,Home,Upto 2014
EW Clark,ENG,Pace,1933-12-15,Mumbai,India,1933,2,110,192,4,1,534,1100,19,424,908,15,28.105263157894736,<=30,IND,Away,Upto 2014
EW Clark,ENG,Pace,1934-01-05,Eden Gardens,India,1934,2,89,273,6,1,492,1256,17,403,983,11,28.941176470588236,<=30,IND,Away,Upto 2014
EW Clark,ENG,Pace,1934-02-10,Chennai,India,1934,2,64,138,0,1,459,1077,17,395,939,17,27.0,<=30,IND,Away,Upto 2014
EW Clark,ENG,Pace,1934-07-06,Manchester,England,1934,2,116,264,1,1,754,1551,6,638,1287,5,125.66666666666667,>30,ENG,Home,Upto 2014
EW Clark,ENG,Pace,1934-08-18,The Oval,England,1934,2,208,344,7,1,874,1331,25,666,987,18,34.96,>30,ENG,Home,Upto 2014
EW Dempster,NZ,Spin,1953-03-13,Auckland,New Zealand,1953,2,113,312,1,1,495,1529,18,382,1217,17,27.5,<=30,NZ,Home,Upto 2014
EW Dempster,NZ,Spin,1953-12-11,Durban,South Africa,1953,1,36,80,0,1,371,1319,16,335,1239,16,23.1875,<=30,SA,Away,Upto 2014
EW Dempster,NZ,Spin,1954-01-01,Cape Town,South Africa,1954,2,43,112,1,1,639,1815,13,596,1703,12,49.15384615384615,>30,SA,Away,Upto 2014
EW Dempster,NZ,Spin,1954-02-05,Gqeberha,South Africa,1954,1,27,40,0,1,529,1620,15,502,1580,15,35.266666666666666,>30,SA,Away,Upto 2014
EW Freeman,AUS,Pace,1968-01-19,Brisbane,Australia,1968,2,85,232,3,1,552,1226,17,467,994,14,32.470588235294116,>30,AUS,Home,Upto 2014
EW Freeman,AUS,Pace,1968-01-26,Sydney,Australia,1968,2,112,177,4,1,498,913,9,386,736,5,55.333333333333336,>30,AUS,Home,Upto 2014
EW Freeman,AUS,Pace,1968-07-11,Birmingham,England,1968,2,101,239,5,1,595,1325,15,494,1086,10,39.666666666666664,>30,ENG,Away,Upto 2014
EW Freeman,AUS,Pace,1968-07-25,Leeds,England,1968,2,85,168,1,1,706,1746,18,621,1578,17,39.22222222222222,>30,ENG,Away,Upto 2014
EW Freeman,AUS,Pace,1968-12-26,Melbourne,Australia,1968,2,63,144,2,1,513,1176,14,450,1032,12,36.642857142857146,>30,AUS,Home,Upto 2014
EW Freeman,AUS,Pace,1969-01-03,Sydney,Australia,1969,2,116,224,6,1,677,1377,20,561,1153,14,33.85,>30,AUS,Home,Upto 2014
EW Freeman,AUS,Pace,1969-01-24,Adelaide,Australia,1969,2,148,227,4,1,674,1285,19,526,1058,15,35.473684210526315,>30,AUS,Home,Upto 2014
EW Freeman,AUS,Pace,1969-02-14,Sydney,Australia,1969,2,64,112,1,1,820,1525,21,756,1413,20,39.04761904761905,>30,AUS,Home,Upto 2014
EW Freeman,AUS,Pace,1969-12-12,Eden Gardens,India,1969,2,97,258,4,1,336,899,15,239,641,11,22.4,<=30,IND,Away,Upto 2014
EW Freeman,AUS,Pace,1970-02-05,Durban,South Africa,1970,1,120,168,2,1,686,1387,21,566,1219,19,32.666666666666664,>30,SA,Away,Upto 2014
EW Freeman,AUS,Pace,1970-02-19,Johannesburg,South Africa,1970,2,137,234,2,1,766,1822,28,629,1588,26,27.357142857142858,<=30,SA,Away,Upto 2014
EZ Matambanadzo,ZIM,Pace,1996-10-24,Faisalabad,Pakistan,1996,2,89,96,2,1,475,908,25,386,812,23,19.0,<=30,PAK,Away,Upto 2014
EZ Matambanadzo,ZIM,Pace,1997-09-25,Bulawayo,Zimbabwe,1997,2,66,102,0,1,606,1326,9,540,1224,9,67.33333333333333,>30,ZIM,Home,Upto 2014
EZ Matambanadzo,ZIM,Pace,1999-11-26,Harare,Zimbabwe,1999,1,95,186,2,1,681,1742,19,586,1556,17,35.8421052631579,>30,ZIM,Home,Upto 2014
Ebadot Hossain,BAN,Pace,2019-02-28,Hamilton,New Zealand,2019,1,107,162,1,1,1009,1490,23,902,1328,22,43.869565217391305,>30,NZ,Away,After 1965
Ebadot Hossain,BAN,Pace,2019-03-08,Wellington,New Zealand,2019,1,84,96,0,1,692,1031,24,608,935,24,28.833333333333332,<=30,NZ,Away,After 1965
Ebadot Hossain,BAN,Pace,2019-11-14,Indore,India,2019,1,115,186,1,1,430,819,19,315,633,18,22.63157894736842,<=30,IND,Away,After 1965
Ebadot Hossain,BAN,Pace,2019-11-22,Eden Gardens,India,2019,1,91,126,3,1,491,776,27,400,650,24,18.185185185185187,<=30,IND,Away,After 1965
Ebadot Hossain,BAN,Pace,2020-02-07,Rawalpindi,Pakistan,2020,1,97,150,1,1,527,1060,20,430,910,19,26.35,<=30,PAK,Away,After 1965
Ebadot Hossain,BAN,Pace,2020-02-22,Mirpur,Bangladesh,2020,2,42,132,0,1,385,792,7,343,660,7,55.0,>30,BAN,Home,After 1965
Ebadot Hossain,BAN,Pace,2021-04-21,Pallekele,Sri Lanka,2021,1,99,126,1,1,611,1140,12,512,1014,11,50.916666666666664,>30,SL,Away,After 1965
Ebadot Hossain,BAN,Pace,2021-07-07,Harare,Zimbabwe,2021,2,97,192,1,1,697,1302,16,600,1110,15,43.5625,>30,ZIM,Away,After 1965
Ebadot Hossain,BAN,Pace,2021-11-26,Chattogram,Bangladesh,2021,2,77,204,2,1,416,874,18,339,670,16,23.11111111111111,<=30,BAN,Home,After 1965
Ebadot Hossain,BAN,Pace,2021-12-04,Mirpur,Bangladesh,2021,1,88,138,1,1,208,447,7,120,309,6,29.714285714285715,<=30,BAN,Home,After 1965
Ebadot Hossain,BAN,Pace,2022-01-01,Mount Maunganui,New Zealand,2022,2,121,234,7,1,752,1693,25,631,1459,18,30.08,>30,NZ,Away,After 1965
Ebadot Hossain,BAN,Pace,2022-01-09,Christchurch,New Zealand,2022,1,143,180,2,1,738,1267,23,595,1087,21,32.08695652173913,>30,NZ,Away,After 1965
Ebadot Hossain,BAN,Pace,2022-03-31,Durban,South Africa,2022,2,126,252,5,1,457,911,16,331,659,11,28.5625,<=30,SA,Away,After 1965
Ebadot Hossain,BAN,Pace,2022-04-08,Gqeberha,South Africa,2022,2,150,198,0,1,403,672,9,253,474,9,44.77777777777778,>30,SA,Away,After 1965
Ebadot Hossain,BAN,Pace,2022-05-23,Mirpur,Bangladesh,2022,2,153,234,4,1,494,899,21,341,665,17,23.523809523809526,<=30,BAN,Home,After 1965
Ebadot Hossain,BAN,Pace,2022-06-16,North Sound,West Indies,2022,2,95,192,2,1,515,1150,28,420,958,26,18.392857142857142,<=30,WI,Away,After 1965
Ebadot Hossain,BAN,Pace,2022-06-24,Gros Islet,West Indies,2022,2,65,125,0,1,658,1090,26,593,965,26,25.307692307692307,<=30,WI,Away,After 1965
Ebadot Hossain,BAN,Pace,2022-12-14,Chattogram,Bangladesh,2022,1,70,126,1,1,311,654,9,241,528,8,34.55555555555556,>30,BAN,Home,After 1965
Ebadot Hossain,BAN,Pace,2023-04-04,Mirpur,Bangladesh,2023,2,91,162,5,1,400,606,10,309,444,5,40.0,>30,BAN,Home,After 1965
Ebadot Hossain,BAN,Pace,2023-06-14,Mirpur,Bangladesh,2023,2,69,102,5,1,553,731,21,484,629,16,26.333333333333332,<=30,BAN,Home,After 1965
Ehsan Adil,PAK,Pace,2013-02-22,Centurion,South Africa,2013,1,54,73,2,1,578,1050,26,524,977,24,22.23076923076923,<=30,SA,Away,Upto 2014
Ehsan Adil,PAK,Pace,2014-11-17,Dubai (DICS),UAE,2014,2,106,222,2,1,426,1086,12,320,864,10,35.5,>30,UAE,Away,After 1965
Ehsan Adil,PAK,Pace,2015-07-03,Pallekele,Sri Lanka,2015,2,103,186,1,1,740,1384,19,637,1198,18,38.94736842105263,>30,SL,Away,After 1965
Ehsanul Haque,BAN,Spin,2002-07-21,Colombo (PSS),Sri Lanka,2002,1,18,18,0,1,331,649,16,313,631,16,20.6875,<=30,SL,Away,Upto 2014
Ehteshamuddin,PAK,Pace,1979-11-21,Bengaluru,India,1979,1,52,108,2,1,355,754,9,303,646,7,39.44444444444444,>30,IND,Away,Upto 2014
Ehteshamuddin,PAK,Pace,1979-12-25,Kanpur,India,1979,2,87,316,6,1,450,1133,20,363,817,14,22.5,<=30,IND,Away,Upto 2014
Ehteshamuddin,PAK,Pace,1980-01-29,Eden Gardens,India,1980,2,131,324,6,1,644,1456,21,513,1132,15,30.666666666666668,>30,IND,Away,Upto 2014
Ehteshamuddin,PAK,Pace,1980-03-06,Faisalabad,Pakistan,1980,1,59,108,1,1,357,750,4,298,642,3,89.25,>30,PAK,Home,Upto 2014
Ehteshamuddin,PAK,Pace,1982-08-26,Leeds,England,1982,1,46,84,1,1,717,1887,34,671,1803,33,21.08823529411765,<=30,ENG,Away,Upto 2014
Elias Sunny,BAN,Spin,2011-10-21,Chattogram,Bangladesh,2011,2,128,174,7,1,473,864,18,345,690,11,26.27777777777778,<=30,BAN,Home,Upto 2014
Elias Sunny,BAN,Spin,2011-12-09,Chattogram,Bangladesh,2011,1,123,282,3,1,717,1447,18,594,1165,15,39.833333333333336,>30,BAN,Home,Upto 2014
Elias Sunny,BAN,Spin,2011-12-17,Mirpur,Bangladesh,2011,2,102,167,2,1,690,1381,17,588,1214,15,40.588235294117645,>30,BAN,Home,Upto 2014
Elias Sunny,BAN,Spin,2013-03-08,Galle,Sri Lanka,2013,2,165,240,0,1,1160,1920,13,995,1680,13,89.23076923076923,>30,SL,Away,Upto 2014
Enamul Haque,BAN,Spin,2001-04-26,Harare,Zimbabwe,2001,2,102,294,3,1,348,861,12,246,567,9,29.0,<=30,ZIM,Away,Upto 2014
Enamul Haque,BAN,Spin,2001-08-29,Multan,Pakistan,2001,1,78,96,0,1,304,445,14,226,349,14,21.714285714285715,<=30,PAK,Away,Upto 2014
Enamul Haque,BAN,Spin,2001-11-08,Dhaka,Bangladesh,2001,1,74,258,3,1,256,612,4,182,354,1,64.0,>30,BAN,Home,Upto 2014
Enamul Haque,BAN,Spin,2001-11-15,Chattogram,Bangladesh,2001,2,135,330,2,1,538,1183,18,403,853,16,29.88888888888889,<=30,BAN,Home,Upto 2014
Enamul Haque,BAN,Spin,2002-01-09,Dhaka,Bangladesh,2002,1,136,238,4,1,399,740,13,263,502,9,30.692307692307693,>30,BAN,Home,Upto 2014
Enamul Haque,BAN,Spin,2002-01-16,Chattogram,Bangladesh,2002,1,114,198,0,1,412,718,14,298,520,14,29.428571428571427,<=30,BAN,Home,Upto 2014
Enamul Haque,BAN,Spin,2002-07-21,Colombo (PSS),Sri Lanka,2002,1,144,228,4,1,331,649,16,187,421,12,20.6875,<=30,SL,Away,Upto 2014
Enamul Haque,BAN,Spin,2002-12-08,Dhaka,Bangladesh,2002,1,101,276,1,1,276,570,4,175,294,3,69.0,>30,BAN,Home,Upto 2014
Enamul Haque,BAN,Spin,2002-12-16,Chattogram,Bangladesh,2002,1,62,114,1,1,127,195,2,65,81,1,63.5,>30,BAN,Home,Upto 2014
Enamul Haque,BAN,Spin,2003-04-24,Chattogram,Bangladesh,2003,1,81,198,0,1,336,618,11,255,420,11,30.545454545454547,>30,BAN,Home,Upto 2014
Enamul Haque jnr,BAN,Spin,2003-10-21,Dhaka,Bangladesh,2003,2,80,180,2,1,443,953,10,363,773,8,44.3,>30,BAN,Home,Upto 2014
Enamul Haque jnr,BAN,Spin,2003-10-29,Chattogram,Bangladesh,2003,2,121,222,2,1,331,702,7,210,480,5,47.285714285714285,>30,BAN,Home,Upto 2014
Enamul Haque jnr,BAN,Spin,2004-10-26,Chattogram,Bangladesh,2004,1,142,252,2,1,719,1390,23,577,1138,21,31.26086956521739,>30,BAN,Home,Upto 2014
Enamul Haque jnr,BAN,Spin,2005-01-06,Chattogram,Bangladesh,2005,2,100,290,6,1,450,957,14,350,667,8,32.142857142857146,>30,BAN,Home,Upto 2014
Enamul Haque jnr,BAN,Spin,2005-01-14,Dhaka,Bangladesh,2005,2,200,438,12,1,497,1234,18,297,796,6,27.61111111111111,<=30,BAN,Home,Upto 2014
Enamul Haque jnr,BAN,Spin,2005-09-12,Colombo (RPS),Sri Lanka,2005,1,106,198,0,1,396,772,20,290,574,20,19.8,<=30,SL,Away,Upto 2014
Enamul Haque jnr,BAN,Spin,2005-09-20,Colombo (PSS),Sri Lanka,2005,1,70,108,0,1,417,656,12,347,548,12,34.75,>30,SL,Away,Upto 2014
Enamul Haque jnr,BAN,Spin,2006-02-28,Chattogram,Bangladesh,2006,2,126,199,3,1,666,1170,22,540,971,19,30.272727272727273,>30,BAN,Home,Upto 2014
Enamul Haque jnr,BAN,Spin,2006-03-08,Bogra,Bangladesh,2006,2,90,192,2,1,552,1040,19,462,848,17,29.05263157894737,<=30,BAN,Home,Upto 2014
Enamul Haque jnr,BAN,Spin,2006-04-09,Fatullah,Bangladesh,2006,2,163,312,3,1,739,1451,25,576,1139,22,29.56,<=30,BAN,Home,Upto 2014
Enamul Haque jnr,BAN,Spin,2007-05-18,Chattogram,Bangladesh,2007,2,65,96,0,1,447,726,13,382,630,13,34.38461538461539,>30,BAN,Home,Upto 2014
Enamul Haque jnr,BAN,Spin,2008-01-04,Dunedin,New Zealand,2008,1,57,132,0,1,288,481,9,231,349,9,32.0,>30,NZ,Away,Upto 2014
Enamul Haque jnr,BAN,Spin,2009-01-03,Chattogram,Bangladesh,2009,2,179,330,3,1,931,1570,27,752,1240,24,34.48148148148148,>30,BAN,Home,Upto 2014
Enamul Haque jnr,BAN,Spin,2009-07-17,St George's,West Indies,2009,2,110,246,6,1,462,930,22,352,684,16,21.0,<=30,WI,Away,Upto 2014
Enamul Haque jnr,BAN,Spin,2013-04-17,Harare,Zimbabwe,2013,2,178,360,3,1,326,755,9,148,395,6,36.22222222222222,>30,ZIM,Away,Upto 2014
F Barratt,ENG,Pace,1929-07-27,Manchester,England,1929,2,38,180,2,1,396,1059,11,358,879,9,36.0,>30,ENG,Home,Upto 2014
F Barratt,ENG,Pace,1930-01-10,Christchurch,New Zealand,1930,2,24,78,1,1,310,868,23,286,790,22,13.478260869565217,<=30,NZ,Away,Upto 2014
F Barratt,ENG,Pace,1930-01-24,Wellington,New Zealand,1930,1,87,198,0,1,569,1265,15,482,1067,15,37.93333333333333,>30,NZ,Away,Upto 2014
F Barratt,ENG,Pace,1930-02-14,Auckland,New Zealand,1930,1,26,72,1,1,146,336,1,120,264,0,146.0,>30,NZ,Away,Upto 2014
F Barratt,ENG,Pace,1930-02-21,Auckland,New Zealand,1930,1,60,222,1,1,366,961,11,306,739,10,33.27272727272727,>30,NZ,Away,Upto 2014
F Hand,IRE,Pace,2023-06-01,Lord's,England,2023,1,113,114,1,1,757,1010,16,644,896,15,47.3125,>30,ENG,Away,After 1965
F Hearne,SA,Pace,1892-03-19,Cape Town,South Africa,1892,1,40,62,2,1,379,805,14,339,743,12,27.071428571428573,<=30,SA,Home,After 1965
F Kuys,SA,Spin,1899-04-01,Cape Town,South Africa,1899,1,31,60,2,1,347,777,19,316,717,17,18.263157894736842,<=30,SA,Home,After 1965
F Martin,ENG,Pace,1890-08-11,The Oval,England,1890,2,102,287,12,1,285,909,28,183,622,16,10.178571428571429,<=30,ENG,Home,After 1965
F Martin,ENG,Pace,1892-03-19,Cape Town,South Africa,1892,1,39,123,2,1,379,805,14,340,682,12,27.071428571428573,<=30,SA,Away,After 1965
F Morley,ENG,Pace,1880-09-06,The Oval,England,1880,2,146,372,8,1,186,458,12,40,86,4,15.5,<=30,ENG,Home,After 1965
F Morley,ENG,Pace,1883-01-19,Melbourne,Australia,1883,2,20,100,0,1,335,900,10,315,800,10,33.5,>30,AUS,Away,After 1965
F Morley,ENG,Pace,1883-01-26,Sydney,Australia,1883,2,81,276,6,1,439,1288,28,358,1012,22,15.678571428571429,<=30,AUS,Away,After 1965
F Morley,ENG,Pace,1883-02-17,Sydney,Australia,1883,2,49,224,2,1,382,973,10,333,749,8,38.2,>30,AUS,Away,After 1965
F Penn,ENG,Spin,1880-09-06,The Oval,England,1880,1,2,12,0,1,721,1528,21,719,1516,21,34.333333333333336,>30,ENG,Home,After 1965
F Ridgway,ENG,Pace,1951-11-02,Delhi,India,1951,1,55,120,0,1,354,1056,2,299,936,2,177.0,>30,IND,Away,Upto 2014
F Ridgway,ENG,Pace,1951-12-14,Brabourne,India,1951,2,170,288,2,1,609,1495,17,439,1207,15,35.8235294117647,>30,IND,Away,Upto 2014
F Ridgway,ENG,Pace,1951-12-30,Eden Gardens,India,1951,2,91,241,4,1,283,907,5,192,666,1,56.6,>30,IND,Away,Upto 2014
F Ridgway,ENG,Pace,1952-01-12,Kanpur,India,1952,1,16,42,0,1,37,120,0,21,78,0,inf,>30,IND,Away,Upto 2014
F Ridgway,ENG,Pace,1952-02-06,Chennai,India,1952,1,47,102,1,1,228,540,4,181,438,3,57.0,>30,IND,Away,Upto 2014
F de Wet,SA,Pace,2009-12-16,Centurion,South Africa,2009,2,127,258,5,1,848,1757,22,721,1499,17,38.54545454545455,>30,SA,Home,Upto 2014
F de Wet,SA,Pace,2010-01-03,Cape Town,South Africa,2010,2,59,168,1,1,868,1767,26,809,1599,25,33.38461538461539,>30,SA,Home,Upto 2014
F du Plessis,SA,Spin,2012-11-22,Adelaide,Australia,2012,2,42,48,0,1,554,1050,7,512,1002,7,79.14285714285714,>30,AUS,Away,Upto 2014
F du Plessis,SA,Spin,2012-11-30,W.A.C.A,Australia,2012,1,18,12,0,1,376,409,9,358,397,9,41.77777777777778,>30,AUS,Away,Upto 2014
F du Plessis,SA,Spin,2013-10-14,Abu Dhabi,UAE,2013,1,8,12,0,1,474,946,13,466,934,13,36.46153846153846,>30,UAE,Away,Upto 2014
F du Plessis,SA,Spin,2013-12-26,Durban,South Africa,2013,1,1,6,0,1,373,798,11,372,792,11,33.90909090909091,>30,SA,Home,Upto 2014
FA Iredale,AUS,Spin,1894-12-14,Sydney,Australia,1894,1,3,12,0,1,459,958,15,456,946,15,30.6,>30,AUS,Home,After 1965
FA Rose,WI,Pace,1997-03-06,Kingston,West Indies,1997,2,123,252,7,1,612,1409,17,489,1157,10,36.0,>30,WI,Home,Upto 2014
FA Rose,WI,Pace,1997-03-14,Port of Spain,West Indies,1997,1,93,210,1,1,527,1480,12,434,1270,11,43.916666666666664,>30,WI,Home,Upto 2014
FA Rose,WI,Pace,1997-03-27,Bridgetown,West Indies,1997,2,96,186,7,1,738,1569,38,642,1383,31,19.42105263157895,<=30,WI,Home,Upto 2014
FA Rose,WI,Pace,1997-04-17,Georgetown,West Indies,1997,1,90,199,3,1,344,855,6,254,656,3,57.333333333333336,>30,WI,Home,Upto 2014
FA Rose,WI,Pace,1997-06-13,St John's,West Indies,1997,2,75,114,3,1,500,775,20,425,661,17,25.0,<=30,WI,Home,Upto 2014
FA Rose,WI,Pace,1997-06-20,Kingstown,West Indies,1997,2,68,108,2,1,630,1024,21,562,916,19,30.0,<=30,WI,Home,Upto 2014
FA Rose,WI,Pace,1997-11-29,Rawalpindi,Pakistan,1997,1,92,198,3,1,728,1434,26,636,1236,23,28.0,<=30,PAK,Away,Upto 2014
FA Rose,WI,Pace,1997-12-06,Karachi,Pakistan,1997,2,48,84,0,1,528,879,18,480,795,18,29.333333333333332,<=30,PAK,Away,Upto 2014
FA Rose,WI,Pace,1998-03-20,St John's,West Indies,1998,2,53,120,1,1,587,1147,18,534,1027,17,32.611111111111114,>30,WI,Home,Upto 2014
FA Rose,WI,Pace,1998-12-26,Durban,South Africa,1998,2,115,222,7,1,645,1347,28,530,1125,21,23.035714285714285,<=30,SA,Away,Upto 2014
FA Rose,WI,Pace,1999-12-16,Hamilton,New Zealand,1999,2,131,198,0,1,615,1231,21,484,1033,21,29.285714285714285,<=30,NZ,Away,Upto 2014
FA Rose,WI,Pace,1999-12-26,Wellington,New Zealand,1999,1,113,195,3,1,571,1324,20,458,1129,17,28.55,<=30,NZ,Away,Upto 2014
FA Rose,WI,Pace,2000-03-16,Port of Spain,West Indies,2000,2,60,192,5,1,483,1518,30,423,1326,25,16.1,<=30,WI,Home,Upto 2014
FA Rose,WI,Pace,2000-03-24,Kingston,West Indies,2000,2,93,216,4,1,544,1582,25,451,1366,21,21.76,<=30,WI,Home,Upto 2014
FA Rose,WI,Pace,2000-05-25,St John's,West Indies,2000,2,117,234,3,1,652,1622,32,535,1388,29,20.375,<=30,WI,Home,Upto 2014
FA Rose,WI,Pace,2000-06-15,Birmingham,England,2000,2,88,138,3,1,606,1373,25,518,1235,22,24.24,<=30,ENG,Away,Upto 2014
FA Rose,WI,Pace,2000-06-29,Lord's,England,2000,2,99,138,1,1,573,1340,36,474,1202,35,15.916666666666666,<=30,ENG,Away,Upto 2014
FA Rose,WI,Pace,2000-08-03,Manchester,England,2000,1,83,120,0,1,672,1537,23,589,1417,23,29.217391304347824,<=30,ENG,Away,Upto 2014
FA Ward,AUS,Spin,1936-12-04,Brisbane,Australia,1936,2,240,656,8,1,566,1790,14,326,1134,6,40.42857142857143,>30,AUS,Home,Upto 2014
FA Ward,AUS,Spin,1936-12-18,Sydney,Australia,1936,1,132,336,2,1,468,1160,7,336,824,5,66.85714285714286,>30,AUS,Home,Upto 2014
FA Ward,AUS,Spin,1937-01-01,Melbourne,Australia,1937,1,60,96,1,1,614,1405,21,554,1309,20,29.238095238095237,<=30,AUS,Home,Upto 2014
FA Ward,AUS,Spin,1938-06-10,Nottingham,England,1938,1,142,180,0,1,958,2061,18,816,1881,18,53.22222222222222,>30,ENG,Away,Upto 2014
FAW Freer,AUS,Pace,1946-12-13,Sydney,Australia,1946,2,74,160,3,1,412,1072,9,338,912,6,45.77777777777778,>30,AUS,Home,Upto 2014
FDM Karunaratne,SL,Pace,2014-02-04,Chattogram,Bangladesh,2014,1,5,12,0,1,379,646,2,374,634,2,189.5,>30,BAN,Away,After 1965
FDM Karunaratne,SL,Pace,2017-08-03,Colombo (SSC),Sri Lanka,2017,1,31,48,1,1,216,460,7,185,412,6,30.857142857142858,>30,SL,Home,After 1965
FDM Karunaratne,SL,Pace,2017-08-12,Pallekele,Sri Lanka,2017,1,30,42,0,1,344,606,10,314,564,10,34.4,>30,SL,Home,After 1965
FDM Karunaratne,SL,Pace,2017-09-28,Abu Dhabi,UAE,2017,1,6,18,0,1,437,1023,13,431,1005,13,33.61538461538461,>30,UAE,Away,After 1965
FDM Karunaratne,SL,Pace,2017-11-16,Eden Gardens,India,2017,1,17,12,0,1,743,1322,32,726,1310,32,23.21875,<=30,IND,Away,After 1965
FDM Karunaratne,SL,Pace,2017-11-24,Nagpur,India,2017,1,8,12,0,1,472,859,9,464,847,9,52.44444444444444,>30,IND,Away,After 1965
FDM Karunaratne,SL,Pace,2018-12-26,Christchurch,New Zealand,2018,1,6,24,0,1,838,1658,30,832,1634,30,27.933333333333334,<=30,NZ,Away,After 1965
FDM Karunaratne,SL,Pace,2019-01-24,Brisbane,Australia,2019,1,14,18,0,1,398,892,24,384,874,24,16.583333333333332,<=30,AUS,Away,After 1965
FDM Karunaratne,SL,Pace,2019-02-13,Durban,South Africa,2019,1,9,18,0,1,725,1312,28,716,1294,28,25.892857142857142,<=30,SA,Away,After 1965
FDM Karunaratne,SL,Pace,2019-02-21,Gqeberha,South Africa,2019,1,12,27,1,1,552,954,24,540,927,23,23.0,<=30,SA,Away,After 1965
FDM Karunaratne,SL,Pace,2019-12-19,Karachi,Pakistan,2019,1,11,6,0,1,653,1162,24,642,1156,24,27.208333333333332,<=30,PAK,Away,After 1965
FDM Karunaratne,SL,Pace,2020-12-26,Centurion,South Africa,2020,1,36,41,0,1,827,1226,23,791,1185,23,35.95652173913044,>30,SA,Away,After 1965
FDM Karunaratne,SL,Pace,2021-04-21,Pallekele,Sri Lanka,2021,1,6,6,0,1,611,1140,12,605,1134,12,50.916666666666664,>30,SL,Home,After 1965
FDM Karunaratne,SL,Pace,2022-05-23,Mirpur,Bangladesh,2022,1,8,24,0,1,494,899,21,486,875,21,23.523809523809526,<=30,BAN,Away,After 1965
FE Allan,AUS,Spin,1879-01-02,Melbourne,Australia,1879,2,80,180,4,1,184,410,8,104,230,4,23.0,<=30,AUS,Home,After 1965
FE Fisher,NZ,Pace,1953-03-06,Wellington,New Zealand,1953,1,78,204,1,1,299,1005,14,221,801,13,21.357142857142858,<=30,NZ,Home,Upto 2014
FE Rumsey,ENG,Pace,1964-07-23,Manchester,England,1964,1,99,215,2,1,759,1991,14,660,1776,12,54.214285714285715,>30,ENG,Home,Upto 2014
FE Rumsey,ENG,Pace,1965-05-27,Birmingham,England,1965,2,54,156,0,1,468,1202,15,414,1046,15,31.2,>30,ENG,Home,Upto 2014
FE Rumsey,ENG,Pace,1965-06-17,Lord's,England,1965,2,67,234,5,1,637,1471,22,570,1237,17,28.954545454545453,<=30,ENG,Home,Upto 2014
FE Rumsey,ENG,Pace,1965-07-08,Leeds,England,1965,2,108,234,4,1,607,1237,14,499,1003,10,43.357142857142854,>30,ENG,Home,Upto 2014
FE Rumsey,ENG,Pace,1965-07-22,Lord's,England,1965,2,133,306,6,1,689,1908,25,556,1602,19,27.56,<=30,ENG,Home,Upto 2014
FE Woolley,ENG,Spin,1909-08-09,The Oval,England,1909,2,37,60,0,1,627,1104,11,590,1044,11,57.0,>30,ENG,Home,Upto 2014
FE Woolley,ENG,Spin,1910-01-01,Johannesburg,South Africa,1910,2,17,30,0,1,593,1077,29,576,1047,29,20.448275862068964,<=30,SA,Away,Upto 2014
FE Woolley,ENG,Spin,1910-01-21,Durban,South Africa,1910,2,57,150,2,1,565,1312,24,508,1162,22,23.541666666666668,<=30,SA,Away,Upto 2014
FE Woolley,ENG,Spin,1910-02-26,Johannesburg,South Africa,1910,2,83,234,1,1,662,1226,24,579,992,23,27.583333333333332,<=30,SA,Away,Upto 2014
FE Woolley,ENG,Spin,1910-03-07,Cape Town,South Africa,1910,2,47,54,1,1,379,765,17,332,711,16,22.294117647058822,<=30,SA,Away,Upto 2014
FE Woolley,ENG,Spin,1910-03-11,Cape Town,South Africa,1910,1,47,78,3,1,488,932,19,441,854,16,25.68421052631579,<=30,SA,Away,Upto 2014
FE Woolley,ENG,Spin,1911-12-15,Sydney,Australia,1911,2,92,162,2,1,459,926,15,367,764,13,30.6,>30,AUS,Away,Upto 2014
FE Woolley,ENG,Spin,1911-12-30,Melbourne,Australia,1911,2,21,19,1,1,222,429,6,201,410,5,37.0,>30,AUS,Away,Upto 2014
FE Woolley,ENG,Spin,1912-01-12,Adelaide,Australia,1912,1,30,42,1,1,429,843,6,399,801,5,71.5,>30,AUS,Away,Upto 2014
FE Woolley,ENG,Spin,1912-02-09,Melbourne,Australia,1912,2,29,78,1,1,357,761,7,328,683,6,51.0,>30,AUS,Away,Upto 2014
FE Woolley,ENG,Spin,1912-02-23,Sydney,Australia,1912,2,37,108,3,1,473,1119,22,436,1011,19,21.5,<=30,AUS,Away,Upto 2014
FE Woolley,ENG,Spin,1912-06-10,Lord's,England,1912,1,19,24,0,1,275,582,7,256,558,7,39.285714285714285,>30,ENG,Home,Upto 2014
FE Woolley,ENG,Spin,1912-07-08,Leeds,England,1912,1,13,36,1,1,384,746,14,371,710,13,27.428571428571427,<=30,ENG,Home,Upto 2014
FE Woolley,ENG,Spin,1912-07-29,Manchester,England,1912,1,6,36,0,1,128,395,6,122,359,6,21.333333333333332,<=30,ENG,Home,Upto 2014
FE Woolley,ENG,Spin,1912-08-12,The Oval,England,1912,2,65,147,6,1,234,496,16,169,349,10,14.625,<=30,ENG,Home,Upto 2014
FE Woolley,ENG,Spin,1912-08-19,The Oval,England,1912,2,49,104,10,1,252,792,19,203,688,9,13.263157894736842,<=30,ENG,Home,Upto 2014
FE Woolley,ENG,Spin,1913-12-13,Durban,South Africa,1913,2,40,96,3,1,212,468,8,172,372,5,26.5,<=30,SA,Away,Upto 2014
FE Woolley,ENG,Spin,1913-12-26,Johannesburg,South Africa,1913,2,50,144,1,1,283,660,6,233,516,5,47.166666666666664,>30,SA,Away,Upto 2014
FE Woolley,ENG,Spin,1914-01-01,Johannesburg,South Africa,1914,2,37,72,0,1,388,857,18,351,785,18,21.555555555555557,<=30,SA,Away,Upto 2014
FE Woolley,ENG,Spin,1914-02-14,Durban,South Africa,1914,2,53,138,0,1,337,984,14,284,846,14,24.071428571428573,<=30,SA,Away,Upto 2014
FE Woolley,ENG,Spin,1914-02-27,Gqeberha,South Africa,1914,2,94,162,3,1,377,889,10,283,727,7,37.7,>30,SA,Away,Upto 2014
FE Woolley,ENG,Spin,1920-12-17,Sydney,Australia,1920,2,125,354,4,1,783,1682,19,658,1328,15,41.21052631578947,>30,AUS,Away,Upto 2014
FE Woolley,ENG,Spin,1920-12-31,Melbourne,Australia,1920,1,87,162,2,1,436,860,13,349,698,11,33.53846153846154,>30,AUS,Away,Upto 2014
FE Woolley,ENG,Spin,1921-01-14,Adelaide,Australia,1921,2,138,354,0,1,920,1706,23,782,1352,23,40.0,>30,AUS,Away,Upto 2014
FE Woolley,ENG,Spin,1921-02-11,Melbourne,Australia,1921,2,95,277,3,1,636,1301,23,541,1024,20,27.652173913043477,<=30,AUS,Away,Upto 2014
FE Woolley,ENG,Spin,1921-02-25,Sydney,Australia,1921,2,85,156,0,1,605,1063,17,520,907,17,35.588235294117645,>30,AUS,Away,Upto 2014
FE Woolley,ENG,Spin,1921-05-28,Nottingham,England,1921,1,46,132,3,1,235,583,9,189,451,6,26.11111111111111,<=30,ENG,Home,Upto 2014
FE Woolley,ENG,Spin,1921-06-11,Lord's,England,1921,2,54,84,0,1,448,876,15,394,792,15,29.866666666666667,<=30,ENG,Home,Upto 2014
FE Woolley,ENG,Spin,1921-07-02,Leeds,England,1921,2,79,138,2,1,678,1167,22,599,1029,20,30.818181818181817,>30,ENG,Home,Upto 2014
FE Woolley,ENG,Spin,1921-07-23,Manchester,England,1921,1,38,234,0,1,239,952,12,201,718,12,19.916666666666668,<=30,ENG,Home,Upto 2014
FE Woolley,ENG,Spin,1921-08-13,The Oval,England,1921,1,31,66,2,1,509,810,8,478,744,6,63.625,>30,ENG,Home,Upto 2014
FE Woolley,ENG,Spin,1922-12-23,Johannesburg,South Africa,1922,1,33,96,0,1,279,546,8,246,450,8,34.875,>30,SA,Away,Upto 2014
FE Woolley,ENG,Spin,1923-01-01,Cape Town,South Africa,1923,2,23,78,0,1,228,702,14,205,624,14,16.285714285714285,<=30,SA,Away,Upto 2014
FE Woolley,ENG,Spin,1923-01-18,Durban,South Africa,1923,1,47,90,0,1,244,574,4,197,484,4,61.0,>30,SA,Away,Upto 2014
FE Woolley,ENG,Spin,1923-02-09,Johannesburg,South Africa,1923,2,36,72,0,1,356,732,8,320,660,8,44.5,>30,SA,Away,Upto 2014
FE Woolley,ENG,Spin,1923-02-16,Durban,South Africa,1923,2,12,54,0,1,141,426,6,129,372,6,23.5,<=30,SA,Away,Upto 2014
FE Woolley,ENG,Spin,1924-06-14,Birmingham,England,1924,1,41,60,0,1,396,946,10,355,886,10,39.6,>30,ENG,Home,Upto 2014
FE Woolley,ENG,Spin,1924-06-28,Lord's,England,1924,1,9,24,0,1,563,1396,14,554,1372,14,40.214285714285715,>30,ENG,Home,Upto 2014
FE Woolley,ENG,Spin,1924-07-12,Leeds,England,1924,1,21,54,0,1,557,1271,20,536,1217,20,27.85,<=30,ENG,Home,Upto 2014
FE Woolley,ENG,Spin,1924-08-16,The Oval,England,1924,1,22,84,1,1,425,954,15,403,870,14,28.333333333333332,<=30,ENG,Home,Upto 2014
FE Woolley,ENG,Spin,1924-12-19,Sydney,Australia,1924,1,35,72,0,1,978,2361,24,943,2289,24,40.75,>30,AUS,Away,Upto 2014
FE Woolley,ENG,Spin,1925-01-01,Melbourne,Australia,1925,1,26,88,0,1,988,2427,24,962,2339,24,41.166666666666664,>30,AUS,Away,Upto 2014
FE Woolley,ENG,Spin,1925-01-16,Adelaide,Australia,1925,2,212,496,5,1,1079,2740,29,867,2244,24,37.206896551724135,>30,AUS,Away,Upto 2014
FE Woolley,ENG,Spin,1925-02-13,Melbourne,Australia,1925,2,70,120,2,1,718,1606,23,648,1486,21,31.217391304347824,>30,AUS,Away,Upto 2014
FE Woolley,ENG,Spin,1925-02-27,Sydney,Australia,1925,2,32,104,1,1,638,1899,28,606,1795,27,22.785714285714285,<=30,AUS,Away,Upto 2014
FE Woolley,ENG,Spin,1926-06-26,Lord's,England,1926,2,18,54,1,1,556,1523,10,538,1469,9,55.6,>30,ENG,Home,Upto 2014
FE Woolley,ENG,Spin,1926-07-10,Leeds,England,1926,1,26,24,0,1,810,1836,19,784,1812,19,42.63157894736842,>30,ENG,Home,Upto 2014
FE Woolley,ENG,Spin,1926-07-24,Manchester,England,1926,1,19,12,0,1,479,1184,11,460,1172,11,43.54545454545455,>30,ENG,Home,Upto 2014
FE Woolley,ENG,Spin,1929-07-13,Leeds,England,1929,1,35,79,3,1,624,1466,25,589,1387,22,24.96,<=30,ENG,Home,Upto 2014
FE Woolley,ENG,Spin,1929-07-27,Manchester,England,1929,2,73,162,1,1,374,874,16,301,712,15,23.375,<=30,ENG,Home,Upto 2014
FE Woolley,ENG,Spin,1929-08-17,The Oval,England,1929,1,25,78,1,1,557,1110,10,532,1032,9,55.7,>30,ENG,Home,Upto 2014
FE Woolley,ENG,Spin,1930-01-10,Christchurch,New Zealand,1930,1,37,54,2,1,139,270,9,102,216,7,15.444444444444445,<=30,NZ,Away,Upto 2014
FE Woolley,ENG,Spin,1930-01-24,Wellington,New Zealand,1930,2,124,309,9,1,379,753,13,255,444,4,29.153846153846153,<=30,NZ,Away,Upto 2014
FE Woolley,ENG,Spin,1930-02-21,Auckland,New Zealand,1930,1,100,246,2,1,488,1141,10,388,895,8,48.8,>30,NZ,Away,Upto 2014
FE Woolley,ENG,Spin,1930-06-13,Nottingham,England,1930,1,3,18,0,1,620,1484,29,617,1466,29,21.379310344827587,<=30,ENG,Home,Upto 2014
FE Woolley,ENG,Spin,1930-06-27,Lord's,England,1930,1,35,36,0,1,960,1932,18,925,1896,18,53.333333333333336,>30,ENG,Home,Upto 2014
FGJ Ford,ENG,Spin,1894-12-14,Sydney,Australia,1894,1,47,66,1,1,459,958,15,412,892,14,30.6,>30,AUS,Away,After 1965
FGJ Ford,ENG,Spin,1894-12-29,Melbourne,Australia,1894,1,7,30,0,1,327,823,10,320,793,10,32.7,>30,AUS,Away,After 1965
FGJ Ford,ENG,Spin,1895-01-11,Adelaide,Australia,1895,2,52,84,0,1,335,726,15,283,642,15,22.333333333333332,<=30,AUS,Away,After 1965
FGJ Ford,ENG,Spin,1895-02-01,Sydney,Australia,1895,1,14,12,0,1,174,372,10,160,360,10,17.4,<=30,AUS,Away,After 1965
FGJ Ford,ENG,Spin,1895-03-01,Melbourne,Australia,1895,1,9,12,0,1,689,1631,19,680,1619,19,36.26315789473684,>30,AUS,Away,After 1965
FH Edwards,WI,Pace,2003-06-27,Kingston,West Indies,2003,2,90,184,6,1,610,1045,26,520,861,20,23.46153846153846,<=30,WI,Home,Upto 2014
FH Edwards,WI,Pace,2003-11-04,Harare,Zimbabwe,2003,2,185,303,6,1,904,1627,24,719,1324,18,37.666666666666664,>30,ZIM,Away,Upto 2014
FH Edwards,WI,Pace,2003-11-12,Bulawayo,Zimbabwe,2003,1,48,90,2,1,595,1210,25,547,1120,23,23.8,<=30,ZIM,Away,Upto 2014
FH Edwards,WI,Pace,2003-12-12,Johannesburg,South Africa,2003,2,162,240,2,1,1112,2121,34,950,1881,32,32.705882352941174,>30,SA,Away,Upto 2014
FH Edwards,WI,Pace,2003-12-26,Durban,South Africa,2003,1,115,150,1,1,1030,1831,26,915,1681,25,39.61538461538461,>30,SA,Away,Upto 2014
FH Edwards,WI,Pace,2004-01-02,Cape Town,South Africa,2004,2,218,264,4,1,1140,1873,23,922,1609,19,49.56521739130435,>30,SA,Away,Upto 2014
FH Edwards,WI,Pace,2004-01-16,Centurion,South Africa,2004,2,153,154,1,1,1068,1800,24,915,1646,23,44.5,>30,SA,Away,Upto 2014
FH Edwards,WI,Pace,2004-03-11,Kingston,West Indies,2004,1,72,117,3,1,561,1123,25,489,1006,22,22.44,<=30,WI,Home,Upto 2014
FH Edwards,WI,Pace,2004-04-01,Bridgetown,West Indies,2004,2,102,156,4,1,550,1209,31,448,1053,27,17.741935483870968,<=30,WI,Home,Upto 2014
FH Edwards,WI,Pace,2004-04-10,St John's,West Indies,2004,2,151,228,3,1,955,1635,13,804,1407,10,73.46153846153847,>30,WI,Home,Upto 2014
FH Edwards,WI,Pace,2004-05-28,Gros Islet,West Indies,2004,2,139,240,2,1,821,1459,16,682,1219,14,51.3125,>30,WI,Home,Upto 2014
FH Edwards,WI,Pace,2004-06-04,Kingston,West Indies,2004,1,66,120,2,1,592,1032,15,526,912,13,39.46666666666667,>30,WI,Home,Upto 2014
FH Edwards,WI,Pace,2004-07-22,Lord's,England,2004,2,143,204,0,1,966,1493,22,823,1289,22,43.90909090909091,>30,ENG,Away,Upto 2014
FH Edwards,WI,Pace,2004-08-12,Manchester,England,2004,2,119,174,1,1,785,1467,28,666,1293,27,28.035714285714285,<=30,ENG,Away,Upto 2014
FH Edwards,WI,Pace,2004-08-19,The Oval,England,2004,2,68,117,2,1,794,1252,26,726,1135,24,30.53846153846154,>30,ENG,Away,Upto 2014
FH Edwards,WI,Pace,2005-04-21,Bridgetown,West Indies,2005,1,112,197,0,1,712,1449,24,600,1252,24,29.666666666666668,<=30,WI,Home,Upto 2014
FH Edwards,WI,Pace,2005-05-26,Bridgetown,West Indies,2005,2,38,92,6,1,722,1198,25,684,1106,19,28.88,<=30,WI,Home,Upto 2014
FH Edwards,WI,Pace,2005-11-03,Brisbane,Australia,2005,2,121,159,2,1,772,1215,25,651,1056,23,30.88,>30,AUS,Away,Upto 2014
FH Edwards,WI,Pace,2005-11-17,Hobart,Australia,2005,2,132,196,3,1,632,1261,19,500,1065,16,33.26315789473684,>30,AUS,Away,Upto 2014
FH Edwards,WI,Pace,2005-11-25,Adelaide,Australia,2005,2,166,204,3,1,853,1575,23,687,1371,20,37.08695652173913,>30,AUS,Away,Upto 2014
FH Edwards,WI,Pace,2006-03-09,Auckland,New Zealand,2006,2,141,216,2,1,867,1612,27,726,1396,25,32.111111111111114,>30,NZ,Away,Upto 2014
FH Edwards,WI,Pace,2006-03-17,Wellington,New Zealand,2006,1,65,93,5,1,633,1165,28,568,1072,23,22.607142857142858,<=30,NZ,Away,Upto 2014
FH Edwards,WI,Pace,2006-06-02,St John's,West Indies,2006,2,69,147,2,1,716,1427,15,647,1280,13,47.733333333333334,>30,WI,Home,Upto 2014
FH Edwards,WI,Pace,2006-11-11,Lahore,Pakistan,2006,2,116,169,1,1,669,1208,21,553,1039,20,31.857142857142858,>30,PAK,Away,Upto 2014
FH Edwards,WI,Pace,2007-06-07,Manchester,England,2007,2,148,193,4,1,901,1654,29,753,1461,25,31.06896551724138,>30,ENG,Away,Upto 2014
FH Edwards,WI,Pace,2007-06-15,Chester-le-Street,England,2007,2,158,180,5,1,807,1380,26,649,1200,21,31.03846153846154,>30,ENG,Away,Upto 2014
FH Edwards,WI,Pace,2007-12-26,Gqeberha,South Africa,2007,2,93,168,3,1,900,1655,32,807,1487,29,28.125,<=30,SA,Away,Upto 2014
FH Edwards,WI,Pace,2008-01-02,Cape Town,South Africa,2008,1,12,29,0,1,787,1720,28,775,1691,28,28.107142857142858,<=30,SA,Away,Upto 2014
FH Edwards,WI,Pace,2008-01-10,Durban,South Africa,2008,1,129,138,0,1,883,1304,22,754,1166,22,40.13636363636363,>30,SA,Away,Upto 2014
FH Edwards,WI,Pace,2008-04-03,Port of Spain,West Indies,2008,2,146,192,5,1,851,1278,24,705,1086,19,35.458333333333336,>30,WI,Home,Upto 2014
FH Edwards,WI,Pace,2008-05-22,Kingston,West Indies,2008,2,144,257,8,1,802,1720,34,658,1463,26,23.58823529411765,<=30,WI,Home,Upto 2014
FH Edwards,WI,Pace,2008-05-30,North Sound,West Indies,2008,2,126,215,3,1,984,1871,24,858,1656,21,41.0,>30,WI,Home,Upto 2014
FH Edwards,WI,Pace,2008-06-12,Bridgetown,West Indies,2008,2,107,181,4,1,809,1396,25,702,1215,21,32.36,>30,WI,Home,Upto 2014
FH Edwards,WI,Pace,2008-12-11,Dunedin,New Zealand,2008,2,113,162,3,1,619,1080,13,506,918,10,47.61538461538461,>30,NZ,Away,Upto 2014
FH Edwards,WI,Pace,2008-12-19,Napier,New Zealand,2008,2,133,244,8,1,774,1324,23,641,1080,15,33.65217391304348,>30,NZ,Away,Upto 2014
FH Edwards,WI,Pace,2009-02-04,Kingston,West Indies,2009,2,59,90,1,1,444,1066,20,385,976,19,22.2,<=30,WI,Home,Upto 2014
FH Edwards,WI,Pace,2009-02-13,North Sound,West Indies,2009,1,2,4,0,1,7,10,0,5,6,0,inf,>30,WI,Home,Upto 2014
FH Edwards,WI,Pace,2009-02-15,St John's,West Indies,2009,2,111,210,3,1,803,1574,19,692,1364,16,42.26315789473684,>30,WI,Home,Upto 2014
FH Edwards,WI,Pace,2009-02-26,Bridgetown,West Indies,2009,2,192,240,3,1,977,1508,9,785,1268,6,108.55555555555556,>30,WI,Home,Upto 2014
FH Edwards,WI,Pace,2009-03-06,Port of Spain,West Indies,2009,2,130,214,2,1,770,1390,15,640,1176,13,51.333333333333336,>30,WI,Home,Upto 2014
FH Edwards,WI,Pace,2009-05-06,Lord's,England,2009,2,104,178,6,1,625,1023,22,521,845,16,28.40909090909091,<=30,ENG,Away,Upto 2014
FH Edwards,WI,Pace,2009-05-14,Chester-le-Street,England,2009,1,113,150,1,1,746,1203,21,633,1053,20,35.523809523809526,>30,ENG,Away,Upto 2014
FH Edwards,WI,Pace,2011-06-20,Kingston,West Indies,2011,2,126,216,5,1,535,1130,25,409,914,20,21.4,<=30,WI,Home,Upto 2014
FH Edwards,WI,Pace,2011-06-28,Bridgetown,West Indies,2011,2,132,252,8,1,639,1424,28,507,1172,20,22.821428571428573,<=30,WI,Home,Upto 2014
FH Edwards,WI,Pace,2011-07-06,Roseau,West Indies,2011,2,122,218,6,1,449,995,20,327,777,14,22.45,<=30,WI,Home,Upto 2014
FH Edwards,WI,Pace,2011-10-21,Chattogram,Bangladesh,2011,2,125,166,2,1,310,664,6,185,498,4,51.666666666666664,>30,BAN,Away,Upto 2014
FH Edwards,WI,Pace,2011-10-29,Mirpur,Bangladesh,2011,2,119,162,6,1,378,650,10,259,488,4,37.8,>30,BAN,Away,Upto 2014
FH Edwards,WI,Pace,2011-11-06,Delhi,India,2011,2,108,156,2,1,494,839,13,386,683,11,38.0,>30,IND,Away,Upto 2014
FH Edwards,WI,Pace,2011-11-14,Eden Gardens,India,2011,1,81,134,1,1,531,767,14,450,633,13,37.92857142857143,>30,IND,Away,Upto 2014
FH Edwards,WI,Pace,2011-11-22,Wankhede,India,2011,2,144,210,2,1,622,1054,14,478,844,12,44.42857142857143,>30,IND,Away,Upto 2014
FH Edwards,WI,Pace,2012-04-07,Bridgetown,West Indies,2012,2,111,222,2,1,725,1642,25,614,1420,23,29.0,<=30,WI,Home,Upto 2014
FH Edwards,WI,Pace,2012-04-15,Port of Spain,West Indies,2012,2,73,198,1,1,412,924,17,339,726,16,24.235294117647058,<=30,WI,Home,Upto 2014
FH Edwards,WI,Pace,2012-05-17,Lord's,England,2012,2,112,198,1,1,939,1916,29,827,1718,28,32.37931034482759,>30,ENG,Away,Upto 2014
FH Edwards,WI,Pace,2012-11-21,Khulna,Bangladesh,2012,2,185,211,7,1,562,872,18,377,661,11,31.22222222222222,>30,BAN,Away,Upto 2014
FH Tyson,ENG,Pace,1954-08-12,The Oval,England,1954,2,57,136,5,1,370,1087,27,313,951,22,13.703703703703704,<=30,ENG,Home,Upto 2014
FH Tyson,ENG,Pace,1954-11-26,Brisbane,Australia,1954,1,160,232,1,1,750,1616,15,590,1384,14,50.0,>30,AUS,Away,Upto 2014
FH Tyson,ENG,Pace,1954-12-17,Sydney,Australia,1954,2,130,252,10,1,649,1696,33,519,1444,23,19.666666666666668,<=30,AUS,Away,Upto 2014
FH Tyson,ENG,Pace,1954-12-31,Melbourne,Australia,1954,2,95,267,9,1,538,1484,30,443,1217,21,17.933333333333334,<=30,AUS,Away,Upto 2014
FH Tyson,ENG,Pace,1955-01-28,Adelaide,Australia,1955,2,132,329,6,1,511,1397,23,379,1068,17,22.217391304347824,<=30,AUS,Away,Upto 2014
FH Tyson,ENG,Pace,1955-02-25,Sydney,Australia,1955,2,66,128,2,1,382,806,7,316,678,5,54.57142857142857,>30,AUS,Away,Upto 2014
FH Tyson,ENG,Pace,1955-03-11,Dunedin,New Zealand,1955,2,39,186,7,1,287,993,22,248,807,15,13.045454545454545,<=30,NZ,Away,Upto 2014
FH Tyson,ENG,Pace,1955-03-25,Auckland,New Zealand,1955,2,51,108,4,1,296,880,23,245,772,19,12.869565217391305,<=30,NZ,Away,Upto 2014
FH Tyson,ENG,Pace,1955-06-09,Nottingham,England,1955,2,79,273,8,1,443,1507,20,364,1234,12,22.15,<=30,ENG,Home,Upto 2014
FH Tyson,ENG,Pace,1955-07-07,Manchester,England,1955,2,179,345,6,1,835,1929,28,656,1584,22,29.821428571428573,<=30,ENG,Home,Upto 2014
FH Tyson,ENG,Pace,1956-08-23,The Oval,England,1956,1,34,84,1,1,409,1082,18,375,998,17,22.72222222222222,<=30,ENG,Home,Upto 2014
FH Tyson,ENG,Pace,1956-12-24,Johannesburg,South Africa,1956,1,22,72,0,1,465,1730,29,443,1658,29,16.03448275862069,<=30,SA,Away,Upto 2014
FH Tyson,ENG,Pace,1957-03-01,Gqeberha,South Africa,1957,2,78,320,8,1,275,1498,30,197,1178,22,9.166666666666666,<=30,SA,Away,Upto 2014
FH Tyson,ENG,Pace,1959-01-30,Adelaide,Australia,1959,1,100,224,1,1,681,1789,20,581,1565,19,34.05,>30,AUS,Away,Upto 2014
FH Tyson,ENG,Pace,1959-02-13,Melbourne,Australia,1959,2,93,208,2,1,613,1344,20,520,1136,18,30.65,>30,AUS,Away,Upto 2014
FH Tyson,ENG,Pace,1959-02-27,Christchurch,New Zealand,1959,2,46,168,5,1,293,707,12,247,539,7,24.416666666666668,<=30,NZ,Away,Upto 2014
FH Tyson,ENG,Pace,1959-03-14,Auckland,New Zealand,1959,1,50,120,1,1,267,780,10,217,660,9,26.7,<=30,NZ,Away,Upto 2014
FI de Caires,WI,Spin,1930-01-11,Bridgetown,West Indies,1930,1,9,12,0,1,542,1217,16,533,1205,16,33.875,>30,WI,Home,Upto 2014
FJ Cameron,NZ,Spin,1961-12-08,Durban,South Africa,1961,2,92,254,6,1,285,733,16,193,479,10,17.8125,<=30,SA,Away,Upto 2014
FJ Cameron,NZ,Spin,1961-12-26,Johannesburg,South Africa,1961,2,133,296,5,1,298,572,6,165,276,1,49.666666666666664,>30,SA,Away,Upto 2014
FJ Cameron,NZ,Spin,1962-01-01,Cape Town,South Africa,1962,2,90,304,6,1,569,1566,23,479,1262,17,24.73913043478261,<=30,SA,Away,Upto 2014
FJ Cameron,NZ,Spin,1962-02-02,Johannesburg,South Africa,1962,1,84,180,0,1,312,504,6,228,324,6,52.0,>30,SA,Away,Upto 2014
FJ Cameron,NZ,Spin,1962-02-16,Gqeberha,South Africa,1962,2,94,174,3,1,338,1102,14,244,928,11,24.142857142857142,<=30,SA,Away,Upto 2014
FJ Cameron,NZ,Spin,1963-02-23,Auckland,New Zealand,1963,1,118,258,4,1,567,1236,14,449,978,10,40.5,>30,NZ,Home,Upto 2014
FJ Cameron,NZ,Spin,1963-03-01,Wellington,New Zealand,1963,1,98,258,2,1,364,1047,13,266,789,11,28.0,<=30,NZ,Home,Upto 2014
FJ Cameron,NZ,Spin,1963-03-15,Christchurch,New Zealand,1963,2,85,216,2,1,329,813,12,244,597,10,27.416666666666668,<=30,NZ,Home,Upto 2014
FJ Cameron,NZ,Spin,1964-02-21,Wellington,New Zealand,1964,2,118,294,4,1,335,893,10,217,599,6,33.5,>30,NZ,Home,Upto 2014
FJ Cameron,NZ,Spin,1964-02-28,Dunedin,New Zealand,1964,2,62,128,2,1,207,662,16,145,534,14,12.9375,<=30,NZ,Home,Upto 2014
FJ Cameron,NZ,Spin,1964-03-13,Auckland,New Zealand,1964,2,146,312,3,1,351,809,9,205,497,6,39.0,>30,NZ,Home,Upto 2014
FJ Cameron,NZ,Spin,1965-01-22,Wellington,New Zealand,1965,2,43,162,1,1,356,1080,8,313,918,7,44.5,>30,NZ,Home,Upto 2014
FJ Cameron,NZ,Spin,1965-01-29,Auckland,New Zealand,1965,2,70,294,9,1,450,1734,24,380,1440,15,18.75,<=30,NZ,Home,Upto 2014
FJ Cameron,NZ,Spin,1965-02-12,Christchurch,New Zealand,1965,2,90,228,3,1,466,1098,16,376,870,13,29.125,<=30,NZ,Home,Upto 2014
FJ Cameron,NZ,Spin,1965-03-19,Delhi,India,1965,2,115,180,2,1,716,1840,21,601,1660,19,34.095238095238095,>30,IND,Away,Upto 2014
FJ Cameron,NZ,Spin,1965-04-02,Lahore,Pakistan,1965,2,105,330,6,1,697,1836,15,592,1506,9,46.46666666666667,>30,PAK,Away,Upto 2014
FJ Cameron,NZ,Spin,1965-04-09,Karachi,Pakistan,1965,2,99,234,2,1,606,1528,19,507,1294,17,31.894736842105264,>30,PAK,Away,Upto 2014
FJ Cameron,NZ,Spin,1965-05-27,Birmingham,England,1965,2,128,276,1,1,528,1355,15,400,1079,14,35.2,>30,ENG,Away,Upto 2014
FJ Cameron,NZ,Spin,1965-06-17,Lord's,England,1965,2,79,192,1,1,329,839,9,250,647,8,36.55555555555556,>30,ENG,Away,Upto 2014
FJ Cameron,WI,Spin,1948-11-10,Delhi,India,1948,2,123,324,3,1,804,1710,13,681,1386,10,61.84615384615385,>30,IND,Away,Upto 2014
FJ Cameron,WI,Spin,1948-12-09,Brabourne,India,1948,2,61,222,0,1,780,1868,11,719,1646,11,70.9090909090909,>30,IND,Away,Upto 2014
FJ Cameron,WI,Spin,1948-12-31,Eden Gardens,India,1948,2,79,222,0,1,677,1523,19,598,1301,19,35.63157894736842,>30,IND,Away,Upto 2014
FJ Cameron,WI,Spin,1949-02-04,Brabourne,India,1949,1,15,18,0,1,580,1268,18,565,1250,18,32.22222222222222,>30,IND,Away,Upto 2014
FJ Durston,ENG,Spin,1921-06-11,Lord's,England,1921,2,136,202,5,1,448,876,15,312,674,10,29.866666666666667,<=30,ENG,Home,Upto 2014
FJ Laver,AUS,Pace,1899-06-15,Lord's,England,1899,1,36,80,3,1,490,1002,18,454,922,15,27.22222222222222,<=30,ENG,Away,After 1965
FJ Laver,AUS,Pace,1899-06-29,Leeds,England,1899,1,7,15,0,1,374,834,15,367,819,15,24.933333333333334,<=30,ENG,Away,After 1965
FJ Laver,AUS,Pace,1899-07-17,Manchester,England,1899,1,27,65,1,1,742,1679,23,715,1614,22,32.26086956521739,>30,ENG,Away,After 1965
FJ Laver,AUS,Pace,1901-12-13,Sydney,Australia,1901,1,39,102,2,1,416,1027,14,377,925,12,29.714285714285715,<=30,AUS,Home,Upto 2014
FJ Laver,AUS,Pace,1903-12-11,Sydney,Australia,1903,2,156,318,1,1,649,1476,14,493,1158,13,46.357142857142854,>30,AUS,Home,Upto 2014
FJ Laver,AUS,Pace,1905-05-29,Nottingham,England,1905,2,185,393,8,1,577,1196,21,392,803,13,27.476190476190474,<=30,ENG,Away,Upto 2014
FJ Laver,AUS,Pace,1905-06-15,Lord's,England,1905,2,103,264,3,1,344,822,16,241,558,13,21.5,<=30,ENG,Away,Upto 2014
FJ Laver,AUS,Pace,1905-07-03,Leeds,England,1905,2,90,234,2,1,525,1232,17,435,998,15,30.88235294117647,>30,ENG,Away,Upto 2014
FJ Laver,AUS,Pace,1905-07-24,Manchester,England,1905,1,73,126,1,1,572,1050,20,499,924,19,28.6,<=30,ENG,Away,Upto 2014
FJ Laver,AUS,Pace,1905-08-14,The Oval,England,1905,2,59,120,2,1,775,1333,24,716,1213,22,32.291666666666664,>30,ENG,Away,Upto 2014
FJ Laver,AUS,Pace,1909-06-14,Lord's,England,1909,2,99,270,4,1,465,1001,12,366,731,8,38.75,>30,ENG,Away,Upto 2014
FJ Laver,AUS,Pace,1909-07-01,Leeds,England,1909,2,21,90,1,1,393,1142,20,372,1052,19,19.65,<=30,ENG,Away,Upto 2014
FJ Laver,AUS,Pace,1909-07-26,Manchester,England,1909,2,56,236,9,1,310,803,19,254,567,10,16.31578947368421,<=30,ENG,Away,Upto 2014
FJ Laver,AUS,Pace,1909-08-09,The Oval,England,1909,1,13,48,0,1,457,871,15,444,823,15,30.466666666666665,>30,ENG,Away,Upto 2014
FJ Titmus,ENG,Spin,1955-06-23,Lord's,England,1955,1,50,84,1,1,220,561,12,170,477,11,18.333333333333332,<=30,ENG,Home,Upto 2014
FJ Titmus,ENG,Spin,1955-07-07,Manchester,England,1955,1,51,114,0,1,419,1223,6,368,1109,6,69.83333333333333,>30,ENG,Home,Upto 2014
FJ Titmus,ENG,Spin,1962-07-05,Leeds,England,1962,2,23,90,2,1,208,474,7,185,384,5,29.714285714285715,<=30,ENG,Home,Upto 2014
FJ Titmus,ENG,Spin,1962-07-26,Nottingham,England,1962,2,51,174,1,1,232,572,3,181,398,2,77.33333333333333,>30,ENG,Home,Upto 2014
FJ Titmus,ENG,Spin,1962-11-30,Brisbane,Australia,1962,2,172,472,2,1,507,1344,11,335,872,9,46.09090909090909,>30,AUS,Away,Upto 2014
FJ Titmus,ENG,Spin,1962-12-29,Melbourne,Australia,1962,2,68,232,5,1,341,714,6,273,482,1,56.833333333333336,>30,AUS,Away,Upto 2014
FJ Titmus,ENG,Spin,1963-01-11,Sydney,Australia,1963,1,79,296,7,1,280,848,15,201,552,8,18.666666666666668,<=30,AUS,Away,Upto 2014
FJ Titmus,ENG,Spin,1963-01-25,Adelaide,Australia,1963,2,157,353,2,1,524,1033,6,367,680,4,87.33333333333333,>30,AUS,Away,Upto 2014
FJ Titmus,ENG,Spin,1963-02-15,Sydney,Australia,1963,2,140,538,5,1,588,2042,17,448,1504,12,34.588235294117645,>30,AUS,Away,Upto 2014
FJ Titmus,ENG,Spin,1963-02-23,Auckland,New Zealand,1963,2,46,186,3,1,567,1236,14,521,1050,11,40.5,>30,NZ,Away,Upto 2014
FJ Titmus,ENG,Spin,1963-03-01,Wellington,New Zealand,1963,2,90,294,5,1,364,1047,13,274,753,8,28.0,<=30,NZ,Away,Upto 2014
FJ Titmus,ENG,Spin,1963-03-15,Christchurch,New Zealand,1963,2,91,306,5,1,329,813,12,238,507,7,27.416666666666668,<=30,NZ,Away,Upto 2014
FJ Titmus,ENG,Spin,1963-06-06,Manchester,England,1963,1,105,240,1,1,595,1480,19,490,1240,18,31.31578947368421,>30,ENG,Home,Upto 2014
FJ Titmus,ENG,Spin,1963-06-20,Lord's,England,1963,1,47,102,0,1,329,816,7,282,714,7,47.0,>30,ENG,Home,Upto 2014
FJ Titmus,ENG,Spin,1963-07-25,Leeds,England,1963,2,104,264,5,1,443,1017,19,339,753,14,23.31578947368421,<=30,ENG,Home,Upto 2014
FJ Titmus,ENG,Spin,1964-01-10,Chennai,India,1964,2,162,419,9,1,876,2493,27,714,2074,18,32.44444444444444,>30,IND,Away,Upto 2014
FJ Titmus,ENG,Spin,1964-01-21,Brabourne,India,1964,2,135,492,5,1,560,2208,16,425,1716,11,35.0,>30,IND,Away,Upto 2014
FJ Titmus,ENG,Spin,1964-01-29,Eden Gardens,India,1964,2,113,366,3,1,555,1794,16,442,1428,13,34.6875,>30,IND,Away,Upto 2014
FJ Titmus,ENG,Spin,1964-02-08,Delhi,India,1964,2,205,552,3,1,1001,2631,20,796,2079,17,50.05,>30,IND,Away,Upto 2014
FJ Titmus,ENG,Spin,1964-02-15,Kanpur,India,1964,2,132,564,7,1,987,2874,18,855,2310,11,54.833333333333336,>30,IND,Away,Upto 2014
FJ Titmus,ENG,Spin,1964-06-04,Nottingham,England,1964,1,6,24,1,1,92,264,7,86,240,6,13.142857142857142,<=30,ENG,Home,Upto 2014
FJ Titmus,ENG,Spin,1964-06-18,Lord's,England,1964,2,50,204,2,1,149,558,5,99,354,3,29.8,<=30,ENG,Home,Upto 2014
FJ Titmus,ENG,Spin,1964-07-02,Leeds,England,1964,2,94,462,6,1,349,1116,11,255,654,5,31.727272727272727,>30,ENG,Home,Upto 2014
FJ Titmus,ENG,Spin,1964-07-23,Manchester,England,1964,2,100,270,0,1,477,1315,3,377,1045,3,159.0,>30,ENG,Home,Upto 2014
FJ Titmus,ENG,Spin,1964-08-13,The Oval,England,1964,1,51,252,1,1,191,690,2,140,438,1,95.5,>30,ENG,Home,Upto 2014
FJ Titmus,ENG,Spin,1964-12-04,Durban,South Africa,1964,2,86,395,6,1,464,1264,16,378,869,10,29.0,<=30,SA,Away,Upto 2014
FJ Titmus,ENG,Spin,1964-12-23,Johannesburg,South Africa,1964,2,174,509,5,1,545,1457,14,371,948,9,38.92857142857143,>30,SA,Away,Upto 2014
FJ Titmus,ENG,Spin,1965-01-01,Cape Town,South Africa,1965,2,154,338,2,1,605,1499,14,451,1161,12,43.214285714285715,>30,SA,Away,Upto 2014
FJ Titmus,ENG,Spin,1965-01-22,Johannesburg,South Africa,1965,2,166,360,2,1,443,1146,10,277,786,8,44.3,>30,SA,Away,Upto 2014
FJ Titmus,ENG,Spin,1965-02-12,Gqeberha,South Africa,1965,2,114,253,3,1,437,1309,10,323,1056,7,43.7,>30,SA,Away,Upto 2014
FJ Titmus,ENG,Spin,1965-05-27,Birmingham,England,1965,2,103,510,6,1,528,1355,15,425,845,9,35.2,>30,ENG,Home,Upto 2014
FJ Titmus,ENG,Spin,1965-06-17,Lord's,England,1965,2,96,324,4,1,329,839,9,233,515,5,36.55555555555556,>30,ENG,Home,Upto 2014
FJ Titmus,ENG,Spin,1965-07-08,Leeds,England,1965,2,35,192,5,1,275,702,9,240,510,4,30.555555555555557,>30,ENG,Home,Upto 2014
FJ Titmus,ENG,Spin,1965-07-22,Lord's,England,1965,2,95,330,3,1,281,779,9,186,449,6,31.22222222222222,>30,ENG,Home,Upto 2014
FJ Titmus,ENG,Spin,1965-08-05,Nottingham,England,1965,2,90,250,3,1,259,688,8,169,438,5,32.375,>30,ENG,Home,Upto 2014
FJ Titmus,ENG,Spin,1965-08-26,The Oval,England,1965,2,131,318,2,1,295,744,6,164,426,4,49.166666666666664,>30,ENG,Home,Upto 2014
FJ Titmus,ENG,Spin,1965-12-10,Brisbane,Australia,1965,1,99,304,1,1,514,1281,8,415,977,7,64.25,>30,AUS,Away,Upto 2014
FJ Titmus,ENG,Spin,1965-12-30,Melbourne,Australia,1965,2,136,424,0,1,661,1476,9,525,1052,9,73.44444444444444,>30,AUS,Away,Upto 2014
FJ Titmus,ENG,Spin,1966-01-07,Sydney,Australia,1966,2,80,323,4,1,404,1124,13,324,801,9,31.076923076923077,>30,AUS,Away,Upto 2014
FJ Titmus,ENG,Spin,1966-01-28,Adelaide,Australia,1966,1,116,296,3,1,423,991,7,307,695,4,60.42857142857143,>30,AUS,Away,Upto 2014
FJ Titmus,ENG,Spin,1966-02-11,Melbourne,Australia,1966,1,86,336,1,1,369,880,3,283,544,2,123.0,>30,AUS,Away,Upto 2014
FJ Titmus,ENG,Spin,1966-06-02,Manchester,England,1966,1,83,210,5,1,479,1280,24,396,1070,19,19.958333333333332,<=30,ENG,Home,Upto 2014
FJ Titmus,ENG,Spin,1966-06-16,Lord's,England,1966,2,48,144,0,1,279,801,4,231,657,4,69.75,>30,ENG,Home,Upto 2014
FJ Titmus,ENG,Spin,1966-08-04,Leeds,England,1966,1,59,132,0,1,445,946,16,386,814,16,27.8125,<=30,ENG,Home,Upto 2014
FJ Titmus,ENG,Spin,1967-08-10,Nottingham,England,1967,2,48,180,2,1,240,772,12,192,592,10,20.0,<=30,ENG,Home,Upto 2014
FJ Titmus,ENG,Spin,1967-08-24,The Oval,England,1967,2,85,253,4,1,475,1075,13,390,822,9,36.53846153846154,>30,ENG,Home,Upto 2014
FJ Titmus,ENG,Spin,1968-01-19,Port of Spain,West Indies,1968,2,133,366,3,1,688,1548,12,555,1182,9,57.333333333333336,>30,WI,Away,Upto 2014
FJ Titmus,ENG,Spin,1968-02-08,Kingston,West Indies,1968,1,32,42,1,1,308,929,12,276,887,11,25.666666666666668,<=30,WI,Away,Upto 2014
FJ Titmus,ENG,Spin,1974-12-13,W.A.C.A,Australia,1974,1,84,224,2,1,230,481,6,146,257,4,38.333333333333336,>30,AUS,Away,Upto 2014
FJ Titmus,ENG,Spin,1974-12-26,Melbourne,Australia,1974,2,107,408,4,1,428,1384,16,321,976,12,26.75,<=30,AUS,Away,Upto 2014
FJ Titmus,ENG,Spin,1975-01-04,Sydney,Australia,1975,2,89,187,1,1,427,863,11,338,676,10,38.81818181818182,>30,AUS,Away,Upto 2014
FJ Titmus,ENG,Spin,1975-01-25,Adelaide,Australia,1975,2,80,160,0,1,485,1136,17,405,976,17,28.529411764705884,<=30,AUS,Away,Upto 2014
FL le Roux,SA,Pace,1914-02-14,Durban,South Africa,1914,2,24,54,0,1,410,971,20,386,917,20,20.5,<=30,SA,Home,Upto 2014
FLH Mooney,NZ,Spin,1954-02-05,Gqeberha,South Africa,1954,1,0,8,0,1,529,1620,15,529,1612,15,35.266666666666666,>30,SA,Away,Upto 2014
FM King,WI,Pace,1953-01-21,Port of Spain,West Indies,1953,2,110,391,3,1,431,1261,9,321,870,6,47.888888888888886,>30,WI,Home,Upto 2014
FM King,WI,Pace,1953-02-07,Bridgetown,West Indies,1953,2,84,222,3,1,175,498,7,91,276,4,25.0,<=30,WI,Home,Upto 2014
FM King,WI,Pace,1953-02-19,Port of Spain,West Indies,1953,2,103,318,6,1,346,1003,10,243,685,4,34.6,>30,WI,Home,Upto 2014
FM King,WI,Pace,1953-03-11,Georgetown,West Indies,1953,2,36,138,1,1,150,444,4,114,306,3,37.5,>30,WI,Home,Upto 2014
FM King,WI,Pace,1953-03-28,Kingston,West Indies,1953,2,147,360,4,1,439,1284,11,292,924,7,39.90909090909091,>30,WI,Home,Upto 2014
FM King,WI,Pace,1954-02-06,Bridgetown,West Indies,1954,2,84,192,2,1,376,820,10,292,628,8,37.6,>30,WI,Home,Upto 2014
FM King,WI,Pace,1954-03-17,Port of Spain,West Indies,1954,1,97,290,3,1,458,1100,10,361,810,7,45.8,>30,WI,Home,Upto 2014
FM King,WI,Pace,1954-03-30,Kingston,West Indies,1954,2,66,180,3,1,363,910,17,297,730,14,21.352941176470587,<=30,WI,Home,Upto 2014
FM King,WI,Pace,1955-03-26,Kingston,West Indies,1955,2,132,180,0,1,487,1027,18,355,847,18,27.055555555555557,<=30,WI,Home,Upto 2014
FM King,WI,Pace,1955-04-11,Port of Spain,West Indies,1955,1,98,222,1,1,686,1163,14,588,941,13,49.0,>30,WI,Home,Upto 2014
FM King,WI,Pace,1955-04-26,Georgetown,West Indies,1955,2,47,90,0,1,285,510,7,238,420,7,40.714285714285715,>30,WI,Home,Upto 2014
FM King,WI,Pace,1955-06-11,Kingston,West Indies,1955,1,126,186,2,1,633,1010,16,507,824,14,39.5625,>30,WI,Home,Upto 2014
FM King,WI,Pace,1956-02-03,Dunedin,New Zealand,1956,1,11,48,0,1,148,341,6,137,293,6,24.666666666666668,<=30,NZ,Away,Upto 2014
FM King,WI,Pace,1956-03-03,Wellington,New Zealand,1956,1,18,52,1,1,372,822,9,354,770,8,41.333333333333336,>30,NZ,Away,Upto 2014
FM Misson,AUS,Pace,1960-12-30,Melbourne,Australia,1960,2,72,184,2,1,364,824,18,292,640,16,20.22222222222222,<=30,AUS,Home,Upto 2014
FM Misson,AUS,Pace,1961-01-27,Adelaide,Australia,1961,2,185,365,3,1,414,757,8,229,392,5,51.75,>30,AUS,Home,Upto 2014
FM Misson,AUS,Pace,1961-02-10,Melbourne,Australia,1961,2,116,192,4,1,407,855,11,291,663,7,37.0,>30,AUS,Home,Upto 2014
FM Misson,AUS,Pace,1961-06-08,Birmingham,England,1961,2,129,258,3,1,708,1529,14,579,1271,11,50.57142857142857,>30,ENG,Away,Upto 2014
FM Misson,AUS,Pace,1961-06-22,Lord's,England,1961,2,114,198,4,1,687,1676,33,573,1478,29,20.818181818181817,<=30,ENG,Away,Upto 2014
FMM Worrell,WI,Spin,1948-02-11,Port of Spain,West Indies,1948,2,85,222,1,1,644,1409,17,559,1187,16,37.88235294117647,>30,WI,Home,Upto 2014
FMM Worrell,WI,Spin,1948-03-03,Georgetown,West Indies,1948,1,5,12,0,1,451,1064,19,446,1052,19,23.736842105263158,<=30,WI,Home,Upto 2014
FMM Worrell,WI,Spin,1948-03-27,Kingston,West Indies,1948,2,66,186,0,1,658,1636,13,592,1450,13,50.61538461538461,>30,WI,Home,Upto 2014
FMM Worrell,WI,Spin,1950-06-08,Manchester,England,1950,2,23,59,2,1,787,2271,35,764,2212,33,22.485714285714284,<=30,ENG,Away,Upto 2014
FMM Worrell,WI,Spin,1950-06-24,Lord's,England,1950,2,59,195,1,1,844,2771,30,785,2576,29,28.133333333333333,<=30,ENG,Away,Upto 2014
FMM Worrell,WI,Spin,1950-07-20,Nottingham,England,1950,2,70,216,3,1,728,2103,19,658,1887,16,38.31578947368421,>30,ENG,Away,Upto 2014
FMM Worrell,WI,Spin,1950-08-12,The Oval,England,1950,1,30,120,0,1,654,1981,25,624,1861,25,26.16,<=30,ENG,Away,Upto 2014
FMM Worrell,WI,Spin,1951-11-09,Brisbane,Australia,1951,2,40,80,1,1,714,1815,27,674,1735,26,26.444444444444443,<=30,AUS,Away,Upto 2014
FMM Worrell,WI,Spin,1951-11-30,Sydney,Australia,1951,2,67,104,2,1,842,1964,19,775,1860,17,44.31578947368421,>30,AUS,Away,Upto 2014
FMM Worrell,WI,Spin,1951-12-22,Adelaide,Australia,1951,2,67,175,6,1,501,1145,26,434,970,20,19.26923076923077,<=30,AUS,Away,Upto 2014
FMM Worrell,WI,Spin,1951-12-31,Melbourne,Australia,1951,1,18,72,1,1,557,1523,18,539,1451,17,30.944444444444443,>30,AUS,Away,Upto 2014
FMM Worrell,WI,Spin,1952-01-25,Sydney,Australia,1952,2,137,282,7,1,474,1237,15,337,955,8,31.6,>30,AUS,Away,Upto 2014
FMM Worrell,WI,Spin,1952-02-08,Christchurch,New Zealand,1952,2,49,156,1,1,593,1754,25,544,1598,24,23.72,<=30,NZ,Away,Upto 2014
FMM Worrell,WI,Spin,1952-02-15,Auckland,New Zealand,1952,2,32,126,1,1,442,1192,12,410,1066,11,36.833333333333336,>30,NZ,Away,Upto 2014
FMM Worrell,WI,Spin,1953-01-21,Port of Spain,West Indies,1953,1,32,120,2,1,842,2177,19,810,2057,17,44.31578947368421,>30,WI,Home,Upto 2014
FMM Worrell,WI,Spin,1953-02-07,Bridgetown,West Indies,1953,2,38,114,1,1,692,2028,31,654,1914,30,22.322580645161292,<=30,WI,Home,Upto 2014
FMM Worrell,WI,Spin,1953-02-19,Port of Spain,West Indies,1953,2,109,342,4,1,777,2186,14,668,1844,10,55.5,>30,WI,Home,Upto 2014
FMM Worrell,WI,Spin,1953-03-11,Georgetown,West Indies,1953,2,35,102,0,1,639,1831,18,604,1729,18,35.5,>30,WI,Home,Upto 2014
FMM Worrell,WI,Spin,1953-03-28,Kingston,West Indies,1953,2,48,132,0,1,921,2154,20,873,2022,20,46.05,>30,WI,Home,Upto 2014
FMM Worrell,WI,Spin,1954-02-06,Bridgetown,West Indies,1954,2,31,60,0,1,772,2250,20,741,2190,20,38.6,>30,WI,Home,Upto 2014
FMM Worrell,WI,Spin,1954-02-24,Georgetown,West Indies,1954,1,33,90,0,1,666,2079,21,633,1989,21,31.714285714285715,>30,WI,Home,Upto 2014
FMM Worrell,WI,Spin,1954-03-17,Port of Spain,West Indies,1954,2,87,174,2,1,1025,1930,13,938,1756,11,78.84615384615384,>30,WI,Home,Upto 2014
FMM Worrell,WI,Spin,1954-03-30,Kingston,West Indies,1954,2,42,90,0,1,581,1630,14,539,1540,14,41.5,>30,WI,Home,Upto 2014
FMM Worrell,WI,Spin,1955-03-26,Kingston,West Indies,1955,1,13,42,0,1,550,1394,11,537,1352,11,50.0,>30,WI,Home,Upto 2014
FMM Worrell,WI,Spin,1955-04-26,Georgetown,West Indies,1955,2,37,96,0,1,484,1365,24,447,1269,24,20.166666666666668,<=30,WI,Home,Upto 2014
FMM Worrell,WI,Spin,1955-05-14,Bridgetown,West Indies,1955,2,145,282,2,1,1042,2444,22,897,2162,20,47.36363636363637,>30,WI,Home,Upto 2014
FMM Worrell,WI,Spin,1955-06-11,Kingston,West Indies,1955,1,116,270,1,1,758,1737,11,642,1467,10,68.9090909090909,>30,WI,Home,Upto 2014
FMM Worrell,WI,Spin,1957-05-30,Birmingham,England,1957,1,27,54,0,1,809,2558,20,782,2504,20,40.45,>30,ENG,Away,Upto 2014
FMM Worrell,WI,Spin,1957-06-20,Lord's,England,1957,1,114,252,2,1,343,654,7,229,402,5,49.0,>30,ENG,Away,Upto 2014
FMM Worrell,WI,Spin,1957-07-04,Nottingham,England,1957,2,106,168,1,1,731,1812,9,625,1644,8,81.22222222222223,>30,ENG,Away,Upto 2014
FMM Worrell,WI,Spin,1957-07-25,Leeds,England,1957,1,70,230,7,1,269,814,12,199,584,5,22.416666666666668,<=30,ENG,Away,Upto 2014
FMM Worrell,WI,Spin,1957-08-22,The Oval,England,1957,1,26,66,0,1,485,1435,24,459,1369,24,20.208333333333332,<=30,ENG,Away,Upto 2014
FMM Worrell,WI,Spin,1960-01-06,Bridgetown,West Indies,1960,1,39,90,1,1,518,1446,6,479,1356,5,86.33333333333333,>30,WI,Home,Upto 2014
FMM Worrell,WI,Spin,1960-01-28,Port of Spain,West Indies,1960,2,50,143,1,1,448,1444,13,398,1301,12,34.46153846153846,>30,WI,Home,Upto 2014
FMM Worrell,WI,Spin,1960-03-09,Georgetown,West Indies,1960,2,71,282,4,1,501,1694,13,430,1412,9,38.53846153846154,>30,WI,Home,Upto 2014
FMM Worrell,WI,Spin,1960-03-25,Port of Spain,West Indies,1960,2,73,180,0,1,649,1404,16,576,1224,16,40.5625,>30,WI,Home,Upto 2014
FMM Worrell,WI,Spin,1960-12-09,Brisbane,Australia,1960,2,134,368,1,1,778,1958,13,644,1590,12,59.84615384615385,>30,AUS,Away,Upto 2014
FMM Worrell,WI,Spin,1960-12-30,Melbourne,Australia,1960,1,50,72,2,1,443,1051,13,393,979,11,34.07692307692308,>30,AUS,Away,Upto 2014
FMM Worrell,WI,Spin,1961-01-13,Sydney,Australia,1961,2,25,104,0,1,670,1732,26,645,1628,26,25.76923076923077,<=30,AUS,Away,Upto 2014
FMM Worrell,WI,Spin,1961-01-27,Adelaide,Australia,1961,2,61,192,4,1,1001,2526,24,940,2334,20,41.708333333333336,>30,AUS,Away,Upto 2014
FMM Worrell,WI,Spin,1961-02-10,Melbourne,Australia,1961,2,87,336,3,1,762,2498,25,675,2162,22,30.48,>30,AUS,Away,Upto 2014
FMM Worrell,WI,Spin,1962-02-16,Port of Spain,West Indies,1962,1,14,48,0,1,339,916,17,325,868,17,19.941176470588236,<=30,WI,Home,Upto 2014
FMM Worrell,WI,Spin,1962-03-07,Kingston,West Indies,1962,2,61,114,0,1,783,1924,16,722,1810,16,48.9375,>30,WI,Home,Upto 2014
FMM Worrell,WI,Spin,1962-03-23,Bridgetown,West Indies,1962,2,28,205,2,1,596,2431,22,568,2226,20,27.09090909090909,<=30,WI,Home,Upto 2014
FMM Worrell,WI,Spin,1962-04-04,Port of Spain,West Indies,1962,1,10,18,0,1,911,2452,24,901,2434,24,37.958333333333336,>30,WI,Home,Upto 2014
FMM Worrell,WI,Spin,1962-04-13,Kingston,West Indies,1962,1,8,30,0,1,527,1208,20,519,1178,20,26.35,<=30,WI,Home,Upto 2014
FMM Worrell,WI,Spin,1963-06-06,Manchester,England,1963,2,23,30,1,1,595,1480,19,572,1450,18,31.31578947368421,>30,ENG,Away,Upto 2014
FMM Worrell,WI,Spin,1963-06-20,Lord's,England,1963,1,12,78,2,1,329,816,7,317,738,5,47.0,>30,ENG,Away,Upto 2014
FMM Worrell,WI,Spin,1963-07-04,Birmingham,England,1963,2,43,132,0,1,265,746,12,222,614,12,22.083333333333332,<=30,ENG,Away,Upto 2014
FMM Worrell,WI,Spin,1963-08-22,The Oval,England,1963,1,26,30,0,1,379,930,8,353,900,8,47.375,>30,ENG,Away,Upto 2014
FR Brown,ENG,Spin,1931-07-29,The Oval,England,1931,2,90,270,3,1,591,1465,18,501,1195,15,32.833333333333336,>30,ENG,Home,Upto 2014
FR Brown,ENG,Spin,1932-06-25,Lord's,England,1932,2,102,234,3,1,320,726,9,218,492,6,35.55555555555556,>30,ENG,Home,Upto 2014
FR Brown,ENG,Spin,1933-03-24,Christchurch,New Zealand,1933,1,34,114,1,1,316,759,7,282,645,6,45.142857142857146,>30,NZ,Away,Upto 2014
FR Brown,ENG,Spin,1933-03-31,Auckland,New Zealand,1933,1,19,12,0,1,345,534,4,326,522,4,86.25,>30,NZ,Away,Upto 2014
FR Brown,ENG,Spin,1937-07-24,Manchester,England,1937,2,95,166,4,1,559,1166,19,464,1000,15,29.42105263157895,<=30,ENG,Home,Upto 2014
FR Brown,ENG,Spin,1949-07-23,Manchester,England,1949,2,114,234,2,1,586,1224,13,472,990,11,45.07692307692308,>30,ENG,Home,Upto 2014
FR Brown,ENG,Spin,1949-08-13,The Oval,England,1949,2,43,90,0,1,597,1082,15,554,992,15,39.8,>30,ENG,Home,Upto 2014
FR Brown,ENG,Spin,1950-08-12,The Oval,England,1950,1,74,126,1,1,654,1981,25,580,1855,24,26.16,<=30,ENG,Home,Upto 2014
FR Brown,ENG,Spin,1950-12-01,Brisbane,Australia,1950,1,63,88,2,1,252,496,14,189,408,12,18.0,<=30,AUS,Away,Upto 2014
FR Brown,ENG,Spin,1950-12-22,Melbourne,Australia,1950,2,54,168,5,1,357,991,20,303,823,15,17.85,<=30,AUS,Away,Upto 2014
FR Brown,ENG,Spin,1951-01-05,Sydney,Australia,1951,1,153,352,4,1,426,1236,15,273,884,11,28.4,<=30,AUS,Away,Upto 2014
FR Brown,ENG,Spin,1951-02-02,Adelaide,Australia,1951,2,38,48,1,1,793,1857,24,755,1809,23,33.041666666666664,>30,AUS,Away,Upto 2014
FR Brown,ENG,Spin,1951-02-23,Melbourne,Australia,1951,2,81,216,6,1,462,1120,13,381,904,7,35.53846153846154,>30,AUS,Away,Upto 2014
FR Brown,ENG,Spin,1951-03-17,Christchurch,New Zealand,1951,1,34,92,1,1,586,1337,15,552,1245,14,39.06666666666667,>30,NZ,Away,Upto 2014
FR Brown,ENG,Spin,1951-03-24,Wellington,New Zealand,1951,2,11,42,1,1,366,1136,25,355,1094,24,14.64,<=30,NZ,Away,Upto 2014
FR Brown,ENG,Spin,1951-06-07,Nottingham,England,1951,1,74,204,2,1,552,1676,17,478,1472,15,32.470588235294116,>30,ENG,Home,Upto 2014
FR Brown,ENG,Spin,1951-07-26,Leeds,England,1951,2,133,294,3,1,749,2072,16,616,1778,13,46.8125,>30,ENG,Home,Upto 2014
FR Brown,ENG,Spin,1951-08-16,The Oval,England,1951,2,51,198,2,1,352,1033,18,301,835,16,19.555555555555557,<=30,ENG,Home,Upto 2014
FR Brown,ENG,Spin,1953-06-25,Lord's,England,1953,2,135,312,4,1,753,1644,18,618,1332,14,41.833333333333336,>30,ENG,Home,Upto 2014
FR Foster,ENG,Pace,1911-12-15,Sydney,Australia,1911,2,197,363,7,1,824,1814,23,627,1451,16,35.82608695652174,>30,AUS,Away,Upto 2014
FR Foster,ENG,Pace,1911-12-30,Melbourne,Australia,1911,2,143,324,7,1,685,1483,24,542,1159,17,28.541666666666668,<=30,AUS,Away,Upto 2014
FR Foster,ENG,Pace,1912-01-12,Adelaide,Australia,1912,2,139,450,6,1,730,1756,27,591,1306,21,27.037037037037038,<=30,AUS,Away,Upto 2014
FR Foster,ENG,Pace,1912-02-09,Melbourne,Australia,1912,2,115,246,7,1,546,1146,23,431,900,16,23.73913043478261,<=30,AUS,Away,Upto 2014
FR Foster,ENG,Pace,1912-02-23,Sydney,Australia,1912,2,98,277,5,1,454,1009,16,356,732,11,28.375,<=30,AUS,Away,Upto 2014
FR Foster,ENG,Pace,1912-06-10,Lord's,England,1912,2,70,241,8,1,280,781,22,210,540,14,12.727272727272727,<=30,ENG,Home,Upto 2014
FR Foster,ENG,Pace,1912-06-24,Lord's,England,1912,1,42,216,2,1,300,774,7,258,558,5,42.857142857142854,>30,ENG,Home,Upto 2014
FR Foster,ENG,Pace,1912-07-08,Leeds,England,1912,2,80,234,2,1,355,954,24,275,720,22,14.791666666666666,<=30,ENG,Home,Upto 2014
FR Foster,ENG,Pace,1912-07-29,Manchester,England,1912,1,3,6,0,1,68,240,4,65,234,4,17.0,<=30,ENG,Home,Upto 2014
FR Foster,ENG,Pace,1912-08-12,The Oval,England,1912,2,34,78,1,1,101,319,14,67,241,13,7.214285714285714,<=30,ENG,Home,Upto 2014
FR Foster,ENG,Pace,1912-08-19,The Oval,England,1912,1,5,12,0,1,291,877,20,286,865,20,14.55,<=30,ENG,Home,Upto 2014
FR Martin,WI,Spin,1928-06-23,Lord's,England,1928,1,22,48,0,1,284,808,17,262,760,17,16.705882352941178,<=30,ENG,Away,Upto 2014
FR Martin,WI,Spin,1928-08-11,The Oval,England,1928,1,9,12,0,1,308,610,14,299,598,14,22.0,<=30,ENG,Away,Upto 2014
FR Martin,WI,Spin,1930-04-03,Kingston,West Indies,1930,2,140,324,1,1,1040,2209,18,900,1885,17,57.77777777777778,>30,WI,Home,Upto 2014
FR Martin,WI,Spin,1930-12-12,Adelaide,Australia,1930,2,101,240,0,1,578,1434,23,477,1194,23,25.130434782608695,<=30,AUS,Away,Upto 2014
FR Martin,WI,Spin,1931-01-01,Sydney,Australia,1931,1,60,108,0,1,251,536,17,191,428,17,14.764705882352942,<=30,AUS,Away,Upto 2014
FR Martin,WI,Spin,1931-01-16,Brisbane,Australia,1931,1,85,162,0,1,426,888,13,341,726,13,32.76923076923077,>30,AUS,Away,Upto 2014
FR Martin,WI,Spin,1931-02-13,Melbourne,Australia,1931,1,91,182,3,1,273,612,18,182,430,15,15.166666666666666,<=30,AUS,Away,Upto 2014
FR Martin,WI,Spin,1931-02-27,Sydney,Australia,1931,2,111,270,4,1,469,1050,14,358,780,10,33.5,>30,AUS,Away,Upto 2014
FR Spofforth,AUS,Pace,1877-03-31,Melbourne,Australia,1877,2,111,176,4,1,269,577,12,158,401,8,22.416666666666668,<=30,AUS,Home,After 1965
FR Spofforth,AUS,Pace,1879-01-02,Melbourne,Australia,1879,2,110,240,13,1,316,788,22,206,548,9,14.363636363636363,<=30,AUS,Home,After 1965
FR Spofforth,AUS,Pace,1882-03-10,Melbourne,Australia,1882,2,128,264,1,1,399,909,9,271,645,8,44.333333333333336,>30,AUS,Home,After 1965
FR Spofforth,AUS,Pace,1882-08-28,The Oval,England,1882,2,90,259,14,1,213,651,23,123,392,9,9.26086956521739,<=30,ENG,Away,After 1965
FR Spofforth,AUS,Pace,1882-12-30,Melbourne,Australia,1882,2,121,276,4,1,380,1024,17,259,748,13,22.352941176470587,<=30,AUS,Home,After 1965
FR Spofforth,AUS,Pace,1883-01-19,Melbourne,Australia,1883,1,57,136,0,1,335,900,10,278,764,10,33.5,>30,AUS,Home,After 1965
FR Spofforth,AUS,Pace,1883-01-26,Sydney,Australia,1883,2,117,369,11,1,439,1288,28,322,919,17,15.678571428571429,<=30,AUS,Home,After 1965
FR Spofforth,AUS,Pace,1883-02-17,Sydney,Australia,1883,2,113,196,3,1,382,973,10,269,777,7,38.2,>30,AUS,Home,After 1965
FR Spofforth,AUS,Pace,1884-07-10,Manchester,England,1884,2,94,292,6,1,208,652,12,114,360,6,17.333333333333332,<=30,ENG,Away,After 1965
FR Spofforth,AUS,Pace,1884-07-21,Lord's,England,1884,1,112,221,2,1,404,842,13,292,621,11,31.076923076923077,>30,ENG,Away,After 1965
FR Spofforth,AUS,Pace,1884-08-11,The Oval,England,1884,2,95,256,2,1,468,1104,7,373,848,5,66.85714285714286,>30,ENG,Away,After 1965
FR Spofforth,AUS,Pace,1885-02-20,Sydney,Australia,1885,2,144,385,10,1,367,1227,19,223,842,9,19.31578947368421,<=30,AUS,Home,After 1965
FR Spofforth,AUS,Pace,1885-03-14,Sydney,Australia,1885,2,91,196,7,1,423,931,23,332,735,16,18.391304347826086,<=30,AUS,Home,After 1965
FR Spofforth,AUS,Pace,1885-03-21,Melbourne,Australia,1885,1,71,196,2,1,490,1192,20,419,996,18,24.5,<=30,AUS,Home,After 1965
FR Spofforth,AUS,Pace,1886-07-05,Manchester,England,1886,2,122,330,6,1,434,1426,26,312,1096,20,16.692307692307693,<=30,ENG,Away,After 1965
FR Spofforth,AUS,Pace,1886-07-19,Lord's,England,1886,1,73,224,4,1,322,1023,13,249,799,9,24.76923076923077,<=30,ENG,Away,After 1965
FR Spofforth,AUS,Pace,1886-08-12,The Oval,England,1886,1,65,121,4,1,385,1143,19,320,1022,15,20.263157894736842,<=30,ENG,Away,After 1965
FR Spofforth,AUS,Pace,1887-01-28,Sydney,Australia,1887,1,17,48,1,1,241,1003,28,224,955,27,8.607142857142858,<=30,AUS,Home,After 1965
FS Ahangama,SL,Pace,1985-08-30,Colombo (SSC),Sri Lanka,1985,2,109,303,5,1,634,1521,27,525,1218,22,23.48148148148148,<=30,SL,Home,Upto 2014
FS Ahangama,SL,Pace,1985-09-06,Colombo (PSS),Sri Lanka,1985,2,115,192,5,1,740,1533,28,625,1341,23,26.428571428571427,<=30,SL,Home,Upto 2014
FS Ahangama,SL,Pace,1985-09-14,Kandy,Sri Lanka,1985,2,124,306,8,1,808,1515,25,684,1209,17,32.32,>30,SL,Home,Upto 2014
FS Trueman,ENG,Pace,1952-06-05,Leeds,England,1952,2,116,210,7,1,376,1124,14,260,914,7,26.857142857142858,<=30,ENG,Home,Upto 2014
FS Trueman,ENG,Pace,1952-06-19,Lord's,England,1952,2,182,312,8,1,486,1206,17,304,894,9,28.58823529411765,<=30,ENG,Home,Upto 2014
FS Trueman,ENG,Pace,1952-07-17,Manchester,England,1952,2,40,100,9,1,188,520,17,148,420,8,11.058823529411764,<=30,ENG,Home,Upto 2014
FS Trueman,ENG,Pace,1952-08-14,The Oval,England,1952,1,48,96,5,1,139,287,11,91,191,6,12.636363636363637,<=30,ENG,Home,Upto 2014
FS Trueman,ENG,Pace,1953-08-15,The Oval,England,1953,2,90,159,4,1,504,1206,15,414,1047,11,33.6,>30,ENG,Home,Upto 2014
FS Trueman,ENG,Pace,1954-01-15,Kingston,West Indies,1954,2,139,244,2,1,630,1500,20,491,1256,18,31.5,>30,WI,Away,Upto 2014
FS Trueman,ENG,Pace,1954-03-17,Port of Spain,West Indies,1954,2,154,288,2,1,458,1100,10,304,812,8,45.8,>30,WI,Away,Upto 2014
FS Trueman,ENG,Pace,1954-03-30,Kingston,West Indies,1954,2,127,268,5,1,363,910,17,236,642,12,21.352941176470587,<=30,WI,Away,Upto 2014
FS Trueman,ENG,Pace,1955-06-23,Lord's,England,1955,2,112,210,2,1,632,1622,27,520,1412,25,23.40740740740741,<=30,ENG,Home,Upto 2014
FS Trueman,ENG,Pace,1956-06-21,Lord's,England,1956,2,144,336,7,1,698,1897,33,554,1561,26,21.151515151515152,<=30,ENG,Home,Upto 2014
FS Trueman,ENG,Pace,1956-07-12,Leeds,England,1956,2,40,114,2,1,232,778,8,192,664,6,29.0,<=30,ENG,Home,Upto 2014
FS Trueman,ENG,Pace,1957-05-30,Birmingham,England,1957,2,106,210,4,1,447,978,10,341,768,6,44.7,>30,ENG,Home,Upto 2014
FS Trueman,ENG,Pace,1957-06-20,Lord's,England,1957,2,103,213,4,1,433,973,23,330,760,19,18.82608695652174,<=30,ENG,Home,Upto 2014
FS Trueman,ENG,Pace,1957-07-04,Nottingham,England,1957,2,143,390,9,1,642,1416,17,499,1026,8,37.76470588235294,>30,ENG,Home,Upto 2014
FS Trueman,ENG,Pace,1957-07-25,Leeds,England,1957,2,75,168,4,1,268,663,16,193,495,12,16.75,<=30,ENG,Home,Upto 2014
FS Trueman,ENG,Pace,1957-08-22,The Oval,England,1957,2,28,60,1,1,85,210,3,57,150,2,28.333333333333332,<=30,ENG,Home,Upto 2014
FS Trueman,ENG,Pace,1958-06-05,Birmingham,England,1958,2,64,228,6,1,493,1493,26,429,1265,20,18.96153846153846,<=30,ENG,Home,Upto 2014
FS Trueman,ENG,Pace,1958-06-19,Lord's,England,1958,2,30,90,3,1,233,706,14,203,616,11,16.642857142857142,<=30,ENG,Home,Upto 2014
FS Trueman,ENG,Pace,1958-07-03,Leeds,England,1958,2,40,150,1,1,193,612,2,153,462,1,96.5,>30,ENG,Home,Upto 2014
FS Trueman,ENG,Pace,1958-07-24,Manchester,England,1958,2,78,191,3,1,389,953,12,311,762,9,32.416666666666664,>30,ENG,Home,Upto 2014
FS Trueman,ENG,Pace,1958-08-21,The Oval,England,1958,2,44,132,2,1,285,708,12,241,576,10,23.75,<=30,ENG,Home,Upto 2014
FS Trueman,ENG,Pace,1959-01-09,Sydney,Australia,1959,2,46,176,1,1,297,1016,5,251,840,4,59.4,>30,AUS,Away,Upto 2014
FS Trueman,ENG,Pace,1959-01-30,Adelaide,Australia,1959,2,93,265,4,1,681,1789,20,588,1524,16,34.05,>30,AUS,Away,Upto 2014
FS Trueman,ENG,Pace,1959-02-13,Melbourne,Australia,1959,2,137,255,4,1,613,1344,20,476,1089,16,30.65,>30,AUS,Away,Upto 2014
FS Trueman,ENG,Pace,1959-02-27,Christchurch,New Zealand,1959,2,59,113,2,1,293,707,12,234,594,10,24.416666666666668,<=30,NZ,Away,Upto 2014
FS Trueman,ENG,Pace,1959-03-14,Auckland,New Zealand,1959,1,46,156,3,1,267,780,10,221,624,7,26.7,<=30,NZ,Away,Upto 2014
FS Trueman,ENG,Pace,1959-06-04,Nottingham,England,1959,2,89,279,6,1,398,1106,18,309,827,12,22.11111111111111,<=30,ENG,Home,Upto 2014
FS Trueman,ENG,Pace,1959-06-18,Lord's,England,1959,2,95,222,3,1,428,1122,20,333,900,17,21.4,<=30,ENG,Home,Upto 2014
FS Trueman,ENG,Pace,1959-07-02,Leeds,England,1959,2,59,150,5,1,379,911,14,320,761,9,27.071428571428573,<=30,ENG,Home,Upto 2014
FS Trueman,ENG,Pace,1959-07-23,Manchester,England,1959,2,104,229,3,1,572,1208,15,468,979,12,38.13333333333333,>30,ENG,Home,Upto 2014
FS Trueman,ENG,Pace,1959-08-20,The Oval,England,1959,2,54,186,7,1,341,1038,21,287,852,14,16.238095238095237,<=30,ENG,Home,Upto 2014
FS Trueman,ENG,Pace,1960-01-06,Bridgetown,West Indies,1960,1,93,282,4,1,552,1376,10,459,1094,6,55.2,>30,WI,Away,Upto 2014
FS Trueman,ENG,Pace,1960-01-28,Port of Spain,West Indies,1960,2,79,240,6,1,471,1183,24,392,943,18,19.625,<=30,WI,Away,Upto 2014
FS Trueman,ENG,Pace,1960-02-17,Kingston,West Indies,1960,2,136,306,6,1,593,1359,23,457,1053,17,25.782608695652176,<=30,WI,Away,Upto 2014
FS Trueman,ENG,Pace,1960-03-09,Georgetown,West Indies,1960,1,116,240,3,1,483,950,12,367,710,9,40.25,>30,WI,Away,Upto 2014
FS Trueman,ENG,Pace,1960-03-25,Port of Spain,West Indies,1960,2,125,255,2,1,604,1109,11,479,854,9,54.90909090909091,>30,WI,Away,Upto 2014
FS Trueman,ENG,Pace,1960-06-09,Birmingham,England,1960,2,116,281,7,1,549,1558,25,433,1277,18,21.96,<=30,ENG,Home,Upto 2014
FS Trueman,ENG,Pace,1960-06-23,Lord's,England,1960,2,93,180,2,1,549,1209,28,456,1029,26,19.607142857142858,<=30,ENG,Home,Upto 2014
FS Trueman,ENG,Pace,1960-07-07,Nottingham,England,1960,2,104,219,9,1,545,1319,26,441,1100,17,20.96153846153846,<=30,ENG,Home,Upto 2014
FS Trueman,ENG,Pace,1960-07-21,Manchester,England,1960,2,68,156,3,1,475,1326,23,407,1170,20,20.652173913043477,<=30,ENG,Home,Upto 2014
FS Trueman,ENG,Pace,1960-08-18,The Oval,England,1960,2,127,247,4,1,792,1752,24,665,1505,20,33.0,>30,ENG,Home,Upto 2014
FS Trueman,ENG,Pace,1961-06-08,Birmingham,England,1961,1,136,221,2,1,708,1529,14,572,1308,12,50.57142857142857,>30,ENG,Home,Upto 2014
FS Trueman,ENG,Pace,1961-06-22,Lord's,England,1961,2,158,264,6,1,687,1676,33,529,1412,27,20.818181818181817,<=30,ENG,Home,Upto 2014
FS Trueman,ENG,Pace,1961-07-06,Leeds,England,1961,2,88,227,11,1,372,1169,24,284,942,13,15.5,<=30,ENG,Home,Upto 2014
FS Trueman,ENG,Pace,1961-07-27,Manchester,England,1961,2,147,276,1,1,869,2028,25,722,1752,24,34.76,>30,ENG,Home,Upto 2014
FS Trueman,ENG,Pace,1962-05-31,Birmingham,England,1962,2,129,222,4,1,384,834,12,255,612,8,32.0,>30,ENG,Home,Upto 2014
FS Trueman,ENG,Pace,1962-06-21,Lord's,England,1962,2,116,307,9,1,524,1195,25,408,888,16,20.96,<=30,ENG,Home,Upto 2014
FS Trueman,ENG,Pace,1962-07-05,Leeds,England,1962,2,88,202,4,1,501,1157,23,413,955,19,21.782608695652176,<=30,ENG,Home,Upto 2014
FS Trueman,ENG,Pace,1962-07-26,Nottingham,England,1962,2,106,258,5,1,602,1369,18,496,1111,13,33.44444444444444,>30,ENG,Home,Upto 2014
FS Trueman,ENG,Pace,1962-11-30,Brisbane,Australia,1962,2,135,264,3,1,871,1952,19,736,1688,16,45.8421052631579,>30,AUS,Away,Upto 2014
FS Trueman,ENG,Pace,1962-12-29,Melbourne,Australia,1962,2,145,344,8,1,758,2009,23,613,1665,15,32.95652173913044,>30,AUS,Away,Upto 2014
FS Trueman,ENG,Pace,1963-01-11,Sydney,Australia,1963,2,88,208,2,1,454,1207,16,366,999,14,28.375,<=30,AUS,Away,Upto 2014
FS Trueman,ENG,Pace,1963-01-25,Adelaide,Australia,1963,2,114,339,5,1,686,1693,27,572,1354,22,25.40740740740741,<=30,AUS,Away,Upto 2014
FS Trueman,ENG,Pace,1963-02-15,Sydney,Australia,1963,2,39,112,2,1,466,1318,15,427,1206,13,31.066666666666666,>30,AUS,Away,Upto 2014
FS Trueman,ENG,Pace,1963-03-01,Wellington,New Zealand,1963,2,73,228,5,1,394,894,13,321,666,8,30.307692307692307,>30,NZ,Away,Upto 2014
FS Trueman,ENG,Pace,1963-03-15,Christchurch,New Zealand,1963,2,91,300,9,1,462,1331,21,371,1031,12,22.0,<=30,NZ,Away,Upto 2014
FS Trueman,ENG,Pace,1963-06-06,Manchester,England,1963,1,95,240,2,1,370,899,6,275,659,4,61.666666666666664,>30,ENG,Home,Upto 2014
FS Trueman,ENG,Pace,1963-06-20,Lord's,England,1963,2,152,420,11,1,666,1730,31,514,1310,20,21.483870967741936,<=30,ENG,Home,Upto 2014
FS Trueman,ENG,Pace,1963-07-04,Birmingham,England,1963,2,119,243,12,1,467,1099,27,348,856,15,17.296296296296298,<=30,ENG,Home,Upto 2014
FS Trueman,ENG,Pace,1963-07-25,Leeds,England,1963,2,163,354,6,1,551,1254,21,388,900,15,26.238095238095237,<=30,ENG,Home,Upto 2014
FS Trueman,ENG,Pace,1963-08-22,The Oval,England,1963,2,65,163,3,1,581,1365,22,516,1202,19,26.40909090909091,<=30,ENG,Home,Upto 2014
FS Trueman,ENG,Pace,1964-06-04,Nottingham,England,1964,2,86,153,3,1,492,1276,20,406,1123,17,24.6,<=30,ENG,Home,Upto 2014
FS Trueman,ENG,Pace,1964-06-18,Lord's,England,1964,2,100,258,6,1,401,987,19,301,729,13,21.105263157894736,<=30,ENG,Home,Upto 2014
FS Trueman,ENG,Pace,1964-07-02,Leeds,England,1964,2,126,189,4,1,604,1337,21,478,1148,17,28.761904761904763,<=30,ENG,Home,Upto 2014
FS Trueman,ENG,Pace,1964-08-13,The Oval,England,1964,1,87,201,4,1,732,1783,22,645,1582,18,33.27272727272727,>30,ENG,Home,Upto 2014
FS Trueman,ENG,Pace,1965-05-27,Birmingham,England,1965,2,128,304,4,1,468,1202,15,340,898,11,31.2,>30,ENG,Home,Upto 2014
FS Trueman,ENG,Pace,1965-06-17,Lord's,England,1965,2,109,275,2,1,637,1471,22,528,1196,20,28.954545454545453,<=30,ENG,Home,Upto 2014
FT Badcock,NZ,Pace,1930-01-10,Christchurch,New Zealand,1930,1,29,108,2,1,310,868,23,281,760,21,13.478260869565217,<=30,NZ,Home,Upto 2014
FT Badcock,NZ,Pace,1930-01-24,Wellington,New Zealand,1930,2,102,318,5,1,569,1265,15,467,947,10,37.93333333333333,>30,NZ,Home,Upto 2014
FT Badcock,NZ,Pace,1930-02-14,Auckland,New Zealand,1930,1,22,66,0,1,146,336,1,124,270,1,146.0,>30,NZ,Home,Upto 2014
FT Badcock,NZ,Pace,1932-02-27,Christchurch,New Zealand,1932,1,88,228,2,1,481,1211,11,393,983,9,43.72727272727273,>30,NZ,Home,Upto 2014
FT Badcock,NZ,Pace,1932-03-04,Wellington,New Zealand,1932,2,101,210,2,1,449,1052,12,348,842,10,37.416666666666664,>30,NZ,Home,Upto 2014
FT Badcock,NZ,Pace,1933-03-24,Christchurch,New Zealand,1933,1,142,324,3,1,467,920,9,325,596,6,51.888888888888886,>30,NZ,Home,Upto 2014
FT Badcock,NZ,Pace,1933-03-31,Auckland,New Zealand,1933,1,126,354,2,1,344,794,12,218,440,10,28.666666666666668,<=30,NZ,Home,Upto 2014
FW Milligan,ENG,Pace,1899-02-14,Johannesburg,South Africa,1899,1,29,35,0,1,218,395,7,189,360,7,31.142857142857142,>30,SA,Away,After 1965
FW Milligan,ENG,Pace,1899-04-01,Cape Town,South Africa,1899,1,0,10,0,1,255,526,19,255,516,19,13.421052631578947,<=30,SA,Away,After 1965
FW Tate,ENG,Pace,1902-07-24,Manchester,England,1902,2,51,96,2,1,194,433,13,143,337,11,14.923076923076923,<=30,ENG,Home,Upto 2014
Faheem Ashraf,PAK,Pace,2018-05-11,Dublin (Malahide),Ireland,2018,2,69,138,1,1,792,1625,28,723,1487,27,28.285714285714285,<=30,IRE,Away,After 1965
Faheem Ashraf,PAK,Pace,2018-05-24,Lord's,England,2018,2,59,108,1,1,631,1332,28,572,1224,27,22.535714285714285,<=30,ENG,Away,After 1965
Faheem Ashraf,PAK,Pace,2018-06-01,Leeds,England,2018,1,60,120,3,1,552,1035,26,492,915,23,21.23076923076923,<=30,ENG,Away,After 1965
Faheem Ashraf,PAK,Pace,2019-01-11,Johannesburg,South Africa,2019,2,99,174,6,1,906,1496,35,807,1322,29,25.885714285714286,<=30,SA,Away,After 1965
Faheem Ashraf,PAK,Pace,2020-12-26,Mount Maunganui,New Zealand,2020,2,58,138,1,1,873,2105,28,815,1967,27,31.178571428571427,>30,NZ,Away,After 1965
Faheem Ashraf,PAK,Pace,2021-01-03,Christchurch,New Zealand,2021,1,106,168,2,1,918,1730,25,812,1562,23,36.72,>30,NZ,Away,After 1965
Faheem Ashraf,PAK,Pace,2021-01-26,Karachi,Pakistan,2021,2,20,84,0,1,546,968,13,526,884,13,42.0,>30,PAK,Home,After 1965
Faheem Ashraf,PAK,Pace,2021-02-04,Rawalpindi,Pakistan,2021,2,57,108,1,1,534,1105,24,477,997,23,22.25,<=30,PAK,Home,After 1965
Faheem Ashraf,PAK,Pace,2021-04-29,Harare,Zimbabwe,2021,2,36,102,1,1,469,921,23,433,819,22,20.391304347826086,<=30,ZIM,Away,After 1965
Faheem Ashraf,PAK,Pace,2021-08-12,Kingston,West Indies,2021,2,66,132,3,1,661,1558,37,595,1426,34,17.864864864864863,<=30,WI,Away,After 1965
Faheem Ashraf,PAK,Pace,2021-08-20,Kingston,West Indies,2021,2,50,120,1,1,688,1393,29,638,1273,28,23.724137931034484,<=30,WI,Away,After 1965
Faheem Ashraf,PAK,Pace,2021-11-26,Chattogram,Bangladesh,2021,2,70,132,2,1,416,874,18,346,742,16,23.11111111111111,<=30,BAN,Away,After 1965
Faheem Ashraf,PAK,Pace,2021-12-04,Mirpur,Bangladesh,2021,1,0,24,0,1,208,447,7,208,423,7,29.714285714285715,<=30,BAN,Away,After 1965
Faheem Ashraf,PAK,Pace,2022-03-12,Karachi,Pakistan,2022,2,68,144,2,1,534,1143,14,466,999,12,38.142857142857146,>30,PAK,Home,After 1965
Faheem Ashraf,PAK,Pace,2022-12-09,Multan,Pakistan,2022,2,28,54,0,1,291,582,12,263,528,12,24.25,<=30,PAK,Home,After 1965
Faheem Ashraf,PAK,Pace,2022-12-17,Karachi,Pakistan,2022,2,15,18,0,1,137,318,3,122,300,3,45.666666666666664,>30,PAK,Home,After 1965
Faheem Ashraf,PAK,Pace,2023-12-14,Perth,Australia,2023,2,130,144,1,1,810,1410,28,680,1266,27,28.928571428571427,<=30,AUS,Away,After 1965
Fahim Muntasir,BAN,Spin,2002-01-09,Dhaka,Bangladesh,2002,1,109,192,0,1,399,740,13,290,548,13,30.692307692307693,>30,BAN,Home,Upto 2014
Fahim Muntasir,BAN,Spin,2002-01-16,Chattogram,Bangladesh,2002,1,131,162,3,1,412,718,14,281,556,11,29.428571428571427,<=30,BAN,Home,Upto 2014
Fahim Muntasir,BAN,Spin,2002-07-28,Colombo (SSC),Sri Lanka,2002,2,102,222,2,1,450,838,15,348,616,13,30.0,<=30,SL,Away,Upto 2014
Faisal Iqbal,PAK,Spin,2001-03-15,Christchurch,New Zealand,2001,1,7,6,0,1,390,912,6,383,906,6,65.0,>30,NZ,Away,Upto 2014
Fareed Ahmad,AFG,Spin,2025-01-02,Bulawayo,Zimbabwe,2025,2,71,156,2,1,588,1149,23,517,993,21,25.565217391304348,<=30,ZIM,Away,After 1965
Farooq Hamid,PAK,Pace,1964-12-04,Melbourne,Australia,1964,2,107,184,1,1,621,1276,24,514,1092,23,25.875,<=30,AUS,Away,Upto 2014
Farrukh Zaman,PAK,Spin,1976-10-23,Hyderabad (Sind),Pakistan,1976,2,15,80,0,1,481,1360,16,466,1280,16,30.0625,>30,PAK,Home,Upto 2014
Fawad Alam,PAK,Spin,2020-08-21,Southampton,England,2020,1,46,72,2,1,389,624,7,343,552,5,55.57142857142857,>30,ENG,Away,After 1965
Fawad Alam,PAK,Spin,2021-02-04,Rawalpindi,Pakistan,2021,1,5,6,0,1,496,1138,13,491,1132,13,38.15384615384615,>30,PAK,Home,After 1965
Fawad Alam,PAK,Spin,2021-08-20,Kingston,West Indies,2021,1,3,18,0,1,122,240,4,119,222,4,30.5,>30,WI,Away,After 1965
Fazal Mahmood,PAK,Pace,1952-10-16,Delhi,India,1952,1,92,240,2,1,227,672,5,135,432,3,45.4,>30,IND,Away,Upto 2014
Fazal Mahmood,PAK,Pace,1952-10-23,Lucknow,India,1952,2,94,310,12,1,415,1291,25,321,981,13,16.6,<=30,IND,Away,Upto 2014
Fazal Mahmood,PAK,Pace,1952-11-13,Brabourne,India,1952,2,133,278,0,1,405,896,8,272,618,8,50.625,>30,IND,Away,Upto 2014
Fazal Mahmood,PAK,Pace,1952-11-28,Chennai,India,1952,1,52,162,2,1,235,515,6,183,353,4,39.166666666666664,>30,IND,Away,Upto 2014
Fazal Mahmood,PAK,Pace,1952-12-12,Eden Gardens,India,1952,1,141,384,4,1,409,1086,14,268,702,10,29.214285714285715,<=30,IND,Away,Upto 2014
Fazal Mahmood,PAK,Pace,1954-06-10,Lord's,England,1954,1,54,96,4,1,164,348,14,110,252,10,11.714285714285714,<=30,ENG,Away,Upto 2014
Fazal Mahmood,PAK,Pace,1954-07-01,Nottingham,England,1954,1,148,282,0,1,686,1378,19,538,1096,19,36.10526315789474,>30,ENG,Away,Upto 2014
Fazal Mahmood,PAK,Pace,1954-07-22,Manchester,England,1954,1,107,252,4,1,265,605,10,158,353,6,26.5,<=30,ENG,Away,Upto 2014
Fazal Mahmood,PAK,Pace,1954-08-12,The Oval,England,1954,2,99,360,12,1,370,1087,27,271,727,15,13.703703703703704,<=30,ENG,Away,Upto 2014
Fazal Mahmood,PAK,Pace,1955-01-01,Dhaka,Bangladesh,1955,2,52,288,0,1,253,947,14,201,659,14,18.071428571428573,<=30,BAN,Away,Upto 2014
Fazal Mahmood,PAK,Pace,1955-01-15,Bahawalpur,Pakistan,1955,2,144,485,6,1,416,1187,15,272,702,9,27.733333333333334,<=30,PAK,Home,Upto 2014
Fazal Mahmood,PAK,Pace,1955-01-29,Lahore,Pakistan,1955,2,64,288,3,1,171,571,7,107,283,4,24.428571428571427,<=30,PAK,Home,Upto 2014
Fazal Mahmood,PAK,Pace,1955-02-26,Karachi,Pakistan,1955,2,69,237,6,1,257,771,19,188,534,13,13.526315789473685,<=30,PAK,Home,Upto 2014
Fazal Mahmood,PAK,Pace,1955-10-13,Karachi,Pakistan,1955,1,46,186,1,1,260,769,8,214,583,7,32.5,>30,PAK,Home,Upto 2014
Fazal Mahmood,PAK,Pace,1955-11-07,Dhaka,Bangladesh,1955,2,46,156,4,1,196,674,16,150,518,12,12.25,<=30,BAN,Away,Upto 2014
Fazal Mahmood,PAK,Pace,1956-10-11,Karachi,Pakistan,1956,2,114,450,13,1,382,1421,26,268,971,13,14.692307692307692,<=30,PAK,Home,Upto 2014
Fazal Mahmood,PAK,Pace,1958-01-17,Bridgetown,West Indies,1958,2,148,384,3,1,627,1370,15,479,986,12,41.8,>30,WI,Away,Upto 2014
Fazal Mahmood,PAK,Pace,1958-02-05,Port of Spain,West Indies,1958,2,165,606,6,1,632,1494,19,467,888,13,33.26315789473684,>30,WI,Away,Upto 2014
Fazal Mahmood,PAK,Pace,1958-02-26,Kingston,West Indies,1958,1,247,512,2,1,916,1594,17,669,1082,15,53.88235294117647,>30,WI,Away,Upto 2014
Fazal Mahmood,PAK,Pace,1958-03-13,Georgetown,West Indies,1958,2,86,174,1,1,363,620,8,277,446,7,45.375,>30,WI,Away,Upto 2014
Fazal Mahmood,PAK,Pace,1958-03-26,Port of Spain,West Indies,1958,2,118,246,8,1,413,869,16,295,623,8,25.8125,<=30,WI,Away,Upto 2014
Fazal Mahmood,PAK,Pace,1959-02-20,Karachi,Pakistan,1959,2,124,348,7,1,346,942,12,222,594,5,28.833333333333332,<=30,PAK,Home,Upto 2014
Fazal Mahmood,PAK,Pace,1959-03-06,Dhaka,Bangladesh,1959,2,100,273,12,1,310,823,30,210,550,18,10.333333333333334,<=30,BAN,Away,Upto 2014
Fazal Mahmood,PAK,Pace,1959-03-26,Lahore,Pakistan,1959,1,109,240,2,1,381,764,12,272,524,10,31.75,>30,PAK,Home,Upto 2014
Fazal Mahmood,PAK,Pace,1959-11-13,Dhaka,Bangladesh,1959,2,123,336,6,1,428,1301,20,305,965,14,21.4,<=30,BAN,Away,Upto 2014
Fazal Mahmood,PAK,Pace,1959-12-04,Karachi,Pakistan,1959,2,90,242,5,1,568,1464,19,478,1222,14,29.894736842105264,<=30,PAK,Home,Upto 2014
Fazal Mahmood,PAK,Pace,1960-12-02,Brabourne,India,1960,1,5,36,0,1,494,1042,13,489,1006,13,38.0,>30,IND,Away,Upto 2014
Fazal Mahmood,PAK,Pace,1960-12-16,Kanpur,India,1960,1,37,216,1,1,201,695,5,164,479,4,40.2,>30,IND,Away,Upto 2014
Fazal Mahmood,PAK,Pace,1960-12-30,Eden Gardens,India,1960,2,45,225,5,1,412,1155,15,367,930,10,27.466666666666665,<=30,IND,Away,Upto 2014
Fazal Mahmood,PAK,Pace,1961-01-13,Chennai,India,1961,1,66,258,0,1,342,929,6,276,671,6,57.0,>30,IND,Away,Upto 2014
Fazal Mahmood,PAK,Pace,1961-02-08,Delhi,India,1961,1,86,228,3,1,579,1092,16,493,864,13,36.1875,>30,IND,Away,Upto 2014
Fazal Mahmood,PAK,Pace,1962-02-02,Karachi,Pakistan,1962,1,98,378,0,1,353,912,11,255,534,11,32.09090909090909,>30,PAK,Home,Upto 2014
Fazal Mahmood,PAK,Pace,1962-07-26,Nottingham,England,1962,1,130,360,3,1,602,1369,18,472,1009,15,33.44444444444444,>30,ENG,Away,Upto 2014
Fazal Mahmood,PAK,Pace,1962-08-16,The Oval,England,1962,2,202,318,2,1,534,1069,17,332,751,15,31.41176470588235,>30,ENG,Away,Upto 2014
Fazl-e-Akbar,PAK,Pace,1998-02-26,Durban,South Africa,1998,2,32,78,3,1,733,1519,29,701,1441,26,25.275862068965516,<=30,SA,Away,Upto 2014
Fazl-e-Akbar,PAK,Pace,1999-03-04,Lahore,Pakistan,1999,2,119,162,1,1,638,1047,15,519,885,14,42.53333333333333,>30,PAK,Home,Upto 2014
Fazl-e-Akbar,PAK,Pace,2001-03-15,Christchurch,New Zealand,2001,2,113,234,3,1,802,1722,12,689,1488,9,66.83333333333333,>30,NZ,Away,Upto 2014
Fazl-e-Akbar,PAK,Pace,2001-03-27,Hamilton,New Zealand,2001,1,85,164,3,1,506,942,23,421,778,20,22.0,<=30,NZ,Away,Upto 2014
Fazl-e-Akbar,PAK,Pace,2004-04-13,Rawalpindi,Pakistan,2004,1,162,244,1,1,687,1266,18,525,1022,17,38.166666666666664,>30,PAK,Home,Upto 2014
G Alexander,AUS,Spin,1880-09-06,The Oval,England,1880,1,69,128,2,1,721,1528,21,652,1400,19,34.333333333333336,>30,ENG,Away,After 1965
G Alexander,AUS,Spin,1884-12-12,Adelaide,Australia,1884,1,24,40,0,1,511,1330,22,487,1290,22,23.227272727272727,<=30,AUS,Home,After 1965
G Boycott,ENG,Pace,1964-07-23,Manchester,England,1964,1,3,6,0,1,759,1991,14,756,1985,14,54.214285714285715,>30,ENG,Home,Upto 2014
G Boycott,ENG,Pace,1964-12-23,Johannesburg,South Africa,1964,1,3,30,0,1,619,1341,11,616,1311,11,56.27272727272727,>30,SA,Away,Upto 2014
G Boycott,ENG,Pace,1965-01-01,Cape Town,South Africa,1965,1,47,120,3,1,647,1572,12,600,1452,9,53.916666666666664,>30,SA,Away,Upto 2014
G Boycott,ENG,Pace,1965-01-22,Johannesburg,South Africa,1965,1,25,48,0,1,754,1664,13,729,1616,13,58.0,>30,SA,Away,Upto 2014
G Boycott,ENG,Pace,1965-02-12,Gqeberha,South Africa,1965,2,82,168,2,1,624,1549,12,542,1381,10,52.0,>30,SA,Away,Upto 2014
G Boycott,ENG,Pace,1965-08-05,Nottingham,England,1965,1,60,156,0,1,718,1736,30,658,1580,30,23.933333333333334,<=30,ENG,Home,Upto 2014
G Boycott,ENG,Pace,1965-12-10,Brisbane,Australia,1965,1,16,32,0,1,379,960,11,363,928,11,34.45454545454545,>30,AUS,Away,Upto 2014
G Boycott,ENG,Pace,1965-12-30,Melbourne,Australia,1965,1,32,72,2,1,657,1479,19,625,1407,17,34.578947368421055,>30,AUS,Away,Upto 2014
G Boycott,ENG,Pace,1966-01-07,Sydney,Australia,1966,1,8,24,0,1,445,1015,16,437,991,16,27.8125,<=30,AUS,Away,Upto 2014
G Boycott,ENG,Pace,1966-01-28,Adelaide,Australia,1966,1,33,56,0,1,581,1367,21,548,1311,21,27.666666666666668,<=30,AUS,Away,Upto 2014
G Boycott,ENG,Pace,1966-02-25,Christchurch,New Zealand,1966,1,30,72,0,1,629,1668,27,599,1596,27,23.296296296296298,<=30,NZ,Away,Upto 2014
G Boycott,ENG,Pace,1970-12-11,W.A.C.A,Australia,1970,1,7,8,0,1,852,2129,21,845,2121,21,40.57142857142857,>30,AUS,Away,Upto 2014
G Boycott,ENG,Pace,1977-12-14,Lahore,Pakistan,1977,1,4,24,0,1,359,1064,11,355,1040,11,32.63636363636363,>30,PAK,Away,Upto 2014
G Boycott,ENG,Pace,1979-02-10,Sydney,Australia,1979,1,6,8,0,1,293,735,11,287,727,11,26.636363636363637,<=30,AUS,Away,Upto 2014
G Boycott,ENG,Pace,1979-07-12,Birmingham,England,1979,1,8,30,0,1,689,1489,22,681,1459,22,31.318181818181817,>30,ENG,Home,Upto 2014
G Boycott,ENG,Pace,1979-08-16,Leeds,England,1979,1,0,12,0,1,293,690,9,293,678,9,32.55555555555556,>30,ENG,Home,Upto 2014
G Boycott,ENG,Pace,1980-06-19,Lord's,England,1980,1,11,42,0,1,667,1407,18,656,1365,18,37.05555555555556,>30,ENG,Home,Upto 2014
G Boycott,ENG,Pace,1981-03-27,St John's,West Indies,1981,1,5,18,0,1,702,1430,20,697,1412,20,35.1,>30,WI,Away,Upto 2014
G Boycott,ENG,Pace,1981-07-16,Leeds,England,1981,1,2,18,0,1,892,1859,38,890,1841,38,23.473684210526315,<=30,ENG,Home,Upto 2014
G Coetzee,SA,Pace,2023-02-28,Centurion,South Africa,2023,2,65,108,3,1,738,1209,39,673,1101,36,18.923076923076923,<=30,SA,Home,After 1965
G Coetzee,SA,Pace,2023-03-08,Johannesburg,South Africa,2023,2,78,132,6,1,575,1146,28,497,1014,22,20.535714285714285,<=30,SA,Home,After 1965
G Coetzee,SA,Pace,2023-12-26,Centurion,South Africa,2023,2,102,126,1,1,718,1149,27,616,1023,26,26.59259259259259,<=30,SA,Home,After 1965
G Coetzee,SA,Pace,2024-11-27,Durban,South Africa,2024,2,85,96,4,1,556,1001,29,471,905,25,19.17241379310345,<=30,SA,Home,After 1965
G Cook,ENG,Spin,1982-06-10,Lord's,England,1982,1,4,6,0,1,261,594,2,257,588,2,130.5,>30,ENG,Home,Upto 2014
G Cook,ENG,Spin,1982-11-12,W.A.C.A,Australia,1982,1,16,24,0,1,325,796,12,309,772,12,27.083333333333332,<=30,AUS,Away,Upto 2014
G Cook,ENG,Spin,1983-01-02,Sydney,Australia,1983,1,7,12,0,1,585,1269,15,578,1257,15,39.0,>30,AUS,Away,Upto 2014
G Cripps,SA,Spin,1892-03-19,Cape Town,South Africa,1892,1,23,15,0,1,141,332,14,118,317,14,10.071428571428571,<=30,SA,Home,After 1965
G Dymock,AUS,Pace,1974-01-26,Adelaide,Australia,1974,2,102,368,7,1,505,1312,13,403,944,6,38.84615384615385,>30,AUS,Home,Upto 2014
G Dymock,AUS,Pace,1974-03-01,Wellington,New Zealand,1974,1,77,280,3,1,960,1997,18,883,1717,15,53.333333333333336,>30,NZ,Away,Upto 2014
G Dymock,AUS,Pace,1974-03-08,Christchurch,New Zealand,1974,2,143,392,3,1,814,2050,32,671,1658,29,25.4375,<=30,NZ,Away,Upto 2014
G Dymock,AUS,Pace,1975-02-08,Melbourne,Australia,1975,1,130,312,1,1,711,1562,25,581,1250,24,28.44,<=30,AUS,Home,Upto 2014
G Dymock,AUS,Pace,1978-12-15,W.A.C.A,Australia,1978,2,125,403,2,1,652,1878,31,527,1475,29,21.032258064516128,<=30,AUS,Home,Upto 2014
G Dymock,AUS,Pace,1978-12-29,Melbourne,Australia,1978,2,75,270,5,1,456,1463,27,381,1193,22,16.88888888888889,<=30,AUS,Home,Upto 2014
G Dymock,AUS,Pace,1979-01-06,Sydney,Australia,1979,2,69,240,0,1,452,1414,19,383,1174,19,23.789473684210527,<=30,AUS,Home,Upto 2014
G Dymock,AUS,Pace,1979-03-24,W.A.C.A,Australia,1979,2,137,358,4,1,924,2172,25,787,1814,21,36.96,>30,AUS,Home,Upto 2014
G Dymock,AUS,Pace,1979-09-11,Chennai,India,1979,1,65,144,0,1,448,938,6,383,794,6,74.66666666666667,>30,IND,Away,Upto 2014
G Dymock,AUS,Pace,1979-10-02,Kanpur,India,1979,2,166,382,12,1,482,1119,27,316,737,15,17.85185185185185,<=30,IND,Away,Upto 2014
G Dymock,AUS,Pace,1979-10-13,Delhi,India,1979,1,135,254,4,1,509,1106,14,374,852,10,36.357142857142854,>30,IND,Away,Upto 2014
G Dymock,AUS,Pace,1979-10-26,Eden Gardens,India,1979,2,119,310,6,1,481,1011,15,362,701,9,32.06666666666667,>30,IND,Away,Upto 2014
G Dymock,AUS,Pace,1979-11-03,Wankhede,India,1979,1,95,186,2,1,295,643,9,200,457,7,32.77777777777778,>30,IND,Away,Upto 2014
G Dymock,AUS,Pace,1979-12-14,W.A.C.A,Australia,1979,2,86,279,9,1,716,1874,34,630,1595,25,21.058823529411764,<=30,AUS,Home,Upto 2014
G Dymock,AUS,Pace,1979-12-29,Melbourne,Australia,1979,2,111,204,4,1,659,1369,27,548,1165,23,24.40740740740741,<=30,AUS,Home,Upto 2014
G Dymock,AUS,Pace,1980-01-04,Sydney,Australia,1980,2,90,270,7,1,548,1437,28,458,1167,21,19.571428571428573,<=30,AUS,Home,Upto 2014
G Dymock,AUS,Pace,1980-01-26,Adelaide,Australia,1980,2,178,353,7,1,844,1627,35,666,1274,28,24.114285714285714,<=30,AUS,Home,Upto 2014
G Dymock,AUS,Pace,1980-02-01,Melbourne,Australia,1980,2,84,234,1,1,694,1833,26,610,1599,25,26.692307692307693,<=30,AUS,Home,Upto 2014
G Dymock,AUS,Pace,1980-02-27,Karachi,Pakistan,1980,2,14,42,0,1,240,648,5,226,606,5,48.0,>30,PAK,Away,Upto 2014
G Dymock,AUS,Pace,1980-03-06,Faisalabad,Pakistan,1980,1,49,120,1,1,357,750,4,308,630,3,89.25,>30,PAK,Away,Upto 2014
G Dymock,AUS,Pace,1980-03-18,Lahore,Pakistan,1980,1,66,144,0,1,489,1014,8,423,870,8,61.125,>30,PAK,Away,Upto 2014
G Fowler,ENG,Pace,1984-03-12,Faisalabad,Pakistan,1984,1,3,6,0,1,538,960,13,535,954,13,41.38461538461539,>30,PAK,Away,Upto 2014
G Fowler,ENG,Pace,1984-08-23,Lord's,England,1984,1,8,6,0,1,850,1633,19,842,1627,19,44.73684210526316,>30,ENG,Home,Upto 2014
G Fowler,ENG,Pace,1984-12-31,Eden Gardens,India,1984,1,0,6,0,1,288,729,8,288,723,8,36.0,>30,IND,Away,Upto 2014
G Gambhir,IND,Spin,2012-12-13,Nagpur,India,2012,1,4,12,0,1,722,2045,15,718,2033,15,48.13333333333333,>30,IND,Home,Upto 2014
G Geary,ENG,Pace,1924-07-26,Manchester,England,1924,1,21,66,0,1,41,114,0,20,48,0,inf,>30,ENG,Home,Upto 2014
G Geary,ENG,Pace,1926-07-10,Leeds,England,1926,1,130,246,2,1,205,438,2,75,192,0,102.5,>30,ENG,Home,Upto 2014
G Geary,ENG,Pace,1926-08-14,The Oval,England,1926,2,58,201,1,1,263,687,10,205,486,9,26.3,<=30,ENG,Home,Upto 2014
G Geary,ENG,Pace,1927-12-24,Johannesburg,South Africa,1927,2,130,327,12,1,371,971,19,241,644,7,19.526315789473685,<=30,SA,Away,Upto 2014
G Geary,ENG,Pace,1927-12-31,Cape Town,South Africa,1927,1,50,138,0,1,474,1145,15,424,1007,15,31.6,>30,SA,Away,Upto 2014
G Geary,ENG,Pace,1928-12-14,Sydney,Australia,1928,2,90,298,7,1,483,1249,14,393,951,7,34.5,>30,AUS,Away,Upto 2014
G Geary,ENG,Pace,1928-12-29,Melbourne,Australia,1928,2,177,371,5,1,730,1882,14,553,1511,9,52.142857142857146,>30,AUS,Away,Upto 2014
G Geary,ENG,Pace,1929-02-01,Adelaide,Australia,1929,2,74,168,1,1,620,1906,12,546,1738,11,51.666666666666664,>30,AUS,Away,Upto 2014
G Geary,ENG,Pace,1929-03-08,Melbourne,Australia,1929,2,136,606,6,1,826,2351,25,690,1745,19,33.04,>30,AUS,Away,Upto 2014
G Geary,ENG,Pace,1929-07-27,Manchester,England,1929,2,68,357,4,1,396,1059,11,328,702,7,36.0,>30,ENG,Home,Upto 2014
G Geary,ENG,Pace,1929-08-17,The Oval,England,1929,1,121,294,3,1,426,1011,9,305,717,6,47.333333333333336,>30,ENG,Home,Upto 2014
G Geary,ENG,Pace,1930-07-11,Leeds,England,1930,1,95,210,1,1,460,1116,6,365,906,5,76.66666666666667,>30,ENG,Home,Upto 2014
G Geary,ENG,Pace,1934-06-08,Nottingham,England,1934,2,147,396,4,1,503,1268,16,356,872,12,31.4375,>30,ENG,Home,Upto 2014
G Geary,ENG,Pace,1934-06-22,Lord's,England,1934,1,56,132,0,1,436,1038,10,380,906,10,43.6,>30,ENG,Home,Upto 2014
G Giffen,AUS,Pace,1881-12-31,Melbourne,Australia,1881,1,12,12,0,1,185,448,5,173,436,5,37.0,>30,AUS,Home,After 1965
G Giffen,AUS,Pace,1882-03-10,Melbourne,Australia,1882,2,42,87,2,1,399,909,9,357,822,7,44.333333333333336,>30,AUS,Home,After 1965
G Giffen,AUS,Pace,1882-12-30,Melbourne,Australia,1882,1,38,80,4,1,380,1024,17,342,944,13,22.352941176470587,<=30,AUS,Home,After 1965
G Giffen,AUS,Pace,1883-01-19,Melbourne,Australia,1883,1,89,196,4,1,335,900,10,246,704,6,33.5,>30,AUS,Home,After 1965
G Giffen,AUS,Pace,1883-01-26,Sydney,Australia,1883,1,37,48,0,1,439,1288,28,402,1240,28,15.678571428571429,<=30,AUS,Home,After 1965
G Giffen,AUS,Pace,1884-07-10,Manchester,England,1884,1,25,116,1,1,208,652,12,183,536,11,17.333333333333332,<=30,ENG,Away,After 1965
G Giffen,AUS,Pace,1884-07-21,Lord's,England,1884,1,68,88,1,1,404,842,13,336,754,12,31.076923076923077,>30,ENG,Away,After 1965
G Giffen,AUS,Pace,1884-08-11,The Oval,England,1884,2,54,132,2,1,468,1104,7,414,972,5,66.85714285714286,>30,ENG,Away,After 1965
G Giffen,AUS,Pace,1884-12-12,Adelaide,Australia,1884,2,99,250,2,1,319,830,6,220,580,4,53.166666666666664,>30,AUS,Home,After 1965
G Giffen,AUS,Pace,1885-03-14,Sydney,Australia,1885,1,117,208,7,1,423,931,23,306,723,16,18.391304347826086,<=30,AUS,Home,After 1965
G Giffen,AUS,Pace,1885-03-21,Melbourne,Australia,1885,1,132,299,2,1,490,1192,20,358,893,18,24.5,<=30,AUS,Home,After 1965
G Giffen,AUS,Pace,1886-07-05,Manchester,England,1886,2,75,224,3,1,434,1426,26,359,1202,23,16.692307692307693,<=30,ENG,Away,After 1965
G Giffen,AUS,Pace,1886-07-19,Lord's,England,1886,1,63,160,1,1,322,1023,13,259,863,12,24.76923076923077,<=30,ENG,Away,After 1965
G Giffen,AUS,Pace,1886-08-12,The Oval,England,1886,1,96,248,0,1,385,1143,19,289,895,19,20.263157894736842,<=30,ENG,Away,After 1965
G Giffen,AUS,Pace,1892-01-01,Melbourne,Australia,1892,2,83,138,3,1,677,2425,30,594,2287,27,22.566666666666666,<=30,AUS,Home,After 1965
G Giffen,AUS,Pace,1892-01-29,Sydney,Australia,1892,2,160,338,10,1,735,2292,31,575,1954,21,23.70967741935484,<=30,AUS,Home,After 1965
G Giffen,AUS,Pace,1892-03-24,Adelaide,Australia,1892,1,154,307,2,1,529,1333,15,375,1026,13,35.266666666666666,>30,AUS,Home,After 1965
G Giffen,AUS,Pace,1893-07-17,Lord's,England,1893,2,91,224,5,1,548,1355,26,457,1131,21,21.076923076923077,<=30,ENG,Away,After 1965
G Giffen,AUS,Pace,1893-08-14,The Oval,England,1893,1,128,270,7,1,575,1100,17,447,830,10,33.8235294117647,>30,ENG,Away,After 1965
G Giffen,AUS,Pace,1893-08-24,Manchester,England,1893,2,123,365,4,1,557,1484,22,434,1119,18,25.318181818181817,<=30,ENG,Away,After 1965
G Giffen,AUS,Pace,1894-12-14,Sydney,Australia,1894,2,239,708,8,1,993,2418,24,754,1710,16,41.375,>30,AUS,Home,After 1965
G Giffen,AUS,Pace,1894-12-29,Melbourne,Australia,1894,1,155,470,6,1,653,1784,28,498,1314,22,23.321428571428573,<=30,AUS,Home,After 1965
G Giffen,AUS,Pace,1895-01-11,Adelaide,Australia,1895,2,150,367,7,1,553,1201,23,403,834,16,24.043478260869566,<=30,AUS,Home,After 1965
G Giffen,AUS,Pace,1895-02-01,Sydney,Australia,1895,2,40,125,8,1,216,539,18,176,414,10,12.0,<=30,AUS,Home,After 1965
G Giffen,AUS,Pace,1895-03-01,Melbourne,Australia,1895,2,236,456,5,1,615,1328,15,379,872,10,41.0,>30,AUS,Home,After 1965
G Giffen,AUS,Pace,1896-06-22,Lord's,England,1896,2,104,135,3,1,652,1288,29,548,1153,26,22.482758620689655,<=30,ENG,Away,After 1965
G Giffen,AUS,Pace,1896-07-16,Manchester,England,1896,2,113,175,4,1,587,1233,20,474,1058,16,29.35,<=30,ENG,Away,After 1965
G Giffen,AUS,Pace,1896-08-10,The Oval,England,1896,2,68,165,2,1,180,416,13,112,251,11,13.846153846153847,<=30,ENG,Away,After 1965
G Gladstone,WI,Spin,1930-04-03,Kingston,West Indies,1930,2,189,300,1,1,1040,2209,18,851,1909,17,57.77777777777778,>30,WI,Home,Upto 2014
G Gunn,ENG,Spin,1930-01-11,Bridgetown,West Indies,1930,1,8,12,0,1,542,1217,16,534,1205,16,33.875,>30,WI,Away,Upto 2014
G Kirsten,SA,Spin,1994-01-28,Adelaide,Australia,1994,1,62,138,1,1,289,1015,8,227,877,7,36.125,>30,AUS,Away,Upto 2014
G Kirsten,SA,Spin,1994-03-04,Johannesburg,South Africa,1994,1,7,24,0,1,318,779,9,311,755,9,35.333333333333336,>30,SA,Home,Upto 2014
G Kirsten,SA,Spin,1994-03-17,Cape Town,South Africa,1994,2,23,31,0,1,182,607,6,159,576,6,30.333333333333332,>30,SA,Home,Upto 2014
G Kirsten,SA,Spin,1994-03-25,Durban,South Africa,1994,2,20,54,0,1,158,468,4,138,414,4,39.5,>30,SA,Home,Upto 2014
G Kirsten,SA,Spin,1994-08-04,Leeds,England,1994,1,10,12,0,1,136,384,4,126,372,4,34.0,>30,ENG,Away,Upto 2014
G Kirsten,SA,Spin,1994-12-26,Durban,South Africa,1994,1,0,12,1,1,116,208,3,116,196,2,38.666666666666664,>30,SA,Home,Upto 2014
G Kirsten,SA,Spin,1995-01-02,Cape Town,South Africa,1995,2,11,18,0,1,383,1034,9,372,1016,9,42.55555555555556,>30,SA,Home,Upto 2014
G Kirsten,SA,Spin,1995-11-16,Centurion,South Africa,1995,1,1,12,0,1,1,12,0,0,0,0,inf,>30,SA,Home,Upto 2014
G Kirsten,SA,Spin,1995-11-30,Johannesburg,South Africa,1995,1,0,12,0,1,180,594,4,180,582,4,45.0,>30,SA,Home,Upto 2014
G Kirsten,SA,Spin,1995-12-26,Gqeberha,South Africa,1995,1,1,12,0,1,309,845,10,308,833,10,30.9,>30,SA,Home,Upto 2014
G Kirsten,SA,Spin,2001-09-14,Bulawayo,Zimbabwe,2001,1,6,12,0,1,460,1130,12,454,1118,12,38.333333333333336,>30,ZIM,Away,Upto 2014
G Kirsten,SA,Spin,2004-01-02,Cape Town,South Africa,2004,1,1,12,0,1,458,726,4,457,714,4,114.5,>30,SA,Home,Upto 2014
G Miller,ENG,Spin,1976-08-12,The Oval,England,1976,1,106,162,1,1,635,1217,8,529,1055,7,79.375,>30,ENG,Home,Upto 2014
G Miller,ENG,Spin,1977-07-07,Manchester,England,1977,2,42,114,3,1,431,1095,17,389,981,14,25.352941176470587,<=30,ENG,Home,Upto 2014
G Miller,ENG,Spin,1977-07-28,Nottingham,England,1977,1,5,30,0,1,239,584,5,234,554,5,47.8,>30,ENG,Home,Upto 2014
G Miller,ENG,Spin,1977-12-14,Lahore,Pakistan,1977,2,126,376,3,1,395,1311,10,269,935,7,39.5,>30,PAK,Away,Upto 2014
G Miller,ENG,Spin,1978-01-02,Hyderabad (Sind),Pakistan,1978,2,65,88,0,1,585,1882,17,520,1794,17,34.411764705882355,>30,PAK,Away,Upto 2014
G Miller,ENG,Spin,1978-01-18,Karachi,Pakistan,1978,1,71,112,1,1,466,1665,20,395,1553,19,23.3,<=30,PAK,Away,Upto 2014
G Miller,ENG,Spin,1978-03-04,Auckland,New Zealand,1978,2,99,248,3,1,296,915,11,197,667,8,26.90909090909091,<=30,NZ,Away,Upto 2014
G Miller,ENG,Spin,1978-06-01,Birmingham,England,1978,1,19,72,2,1,153,396,7,134,324,5,21.857142857142858,<=30,ENG,Home,Upto 2014
G Miller,ENG,Spin,1978-06-15,Lord's,England,1978,1,9,54,0,1,186,426,8,177,372,8,23.25,<=30,ENG,Home,Upto 2014
G Miller,ENG,Spin,1978-06-29,Leeds,England,1978,1,22,54,0,1,69,204,1,47,150,1,69.0,>30,ENG,Home,Upto 2014
G Miller,ENG,Spin,1978-07-27,The Oval,England,1978,2,66,354,4,1,243,991,11,177,637,7,22.09090909090909,<=30,ENG,Home,Upto 2014
G Miller,ENG,Spin,1978-08-10,Nottingham,England,1978,2,24,72,0,1,118,533,8,94,461,8,14.75,<=30,ENG,Home,Upto 2014
G Miller,ENG,Spin,1978-12-01,Brisbane,Australia,1978,1,52,272,2,1,206,680,3,154,408,1,68.66666666666667,>30,AUS,Away,Upto 2014
G Miller,ENG,Spin,1978-12-15,W.A.C.A,Australia,1978,2,52,184,4,1,155,496,8,103,312,4,19.375,<=30,AUS,Away,Upto 2014
G Miller,ENG,Spin,1978-12-29,Melbourne,Australia,1978,2,74,264,5,1,223,866,11,149,602,6,20.272727272727273,<=30,AUS,Away,Upto 2014
G Miller,ENG,Spin,1979-01-06,Sydney,Australia,1979,2,75,264,4,1,399,1440,18,324,1176,14,22.166666666666668,<=30,AUS,Away,Upto 2014
G Miller,ENG,Spin,1979-01-27,Adelaide,Australia,1979,1,36,144,2,1,239,776,7,203,632,5,34.142857142857146,>30,AUS,Away,Upto 2014
G Miller,ENG,Spin,1979-02-10,Sydney,Australia,1979,2,57,289,6,1,364,1147,19,307,858,13,19.157894736842106,<=30,AUS,Away,Upto 2014
G Miller,ENG,Spin,1979-07-12,Birmingham,England,1979,2,45,120,0,1,393,774,2,348,654,2,196.5,>30,ENG,Home,Upto 2014
G Miller,ENG,Spin,1979-08-02,Lord's,England,1979,1,37,102,0,1,266,749,5,229,647,5,53.2,>30,ENG,Home,Upto 2014
G Miller,ENG,Spin,1979-08-16,Leeds,England,1979,1,52,192,2,1,162,455,6,110,263,4,27.0,<=30,ENG,Home,Upto 2014
G Miller,ENG,Spin,1979-12-14,W.A.C.A,Australia,1979,2,66,126,0,1,247,666,5,181,540,5,49.4,>30,AUS,Away,Upto 2014
G Miller,ENG,Spin,1981-02-13,Port of Spain,West Indies,1981,1,42,108,1,1,213,606,8,171,498,7,26.625,<=30,WI,Away,Upto 2014
G Miller,ENG,Spin,1982-06-24,Manchester,England,1982,1,51,96,1,1,341,811,11,290,715,10,31.0,>30,ENG,Home,Upto 2014
G Miller,ENG,Spin,1982-07-29,Birmingham,England,1982,2,27,58,2,1,280,691,9,253,633,7,31.11111111111111,>30,ENG,Home,Upto 2014
G Miller,ENG,Spin,1982-11-12,W.A.C.A,Australia,1982,2,78,222,4,1,325,796,12,247,574,8,27.083333333333332,<=30,AUS,Away,Upto 2014
G Miller,ENG,Spin,1982-11-26,Brisbane,Australia,1982,2,45,135,1,1,274,868,5,229,733,4,54.8,>30,AUS,Away,Upto 2014
G Miller,ENG,Spin,1982-12-10,Adelaide,Australia,1982,1,33,84,0,1,299,810,4,266,726,4,74.75,>30,AUS,Away,Upto 2014
G Miller,ENG,Spin,1982-12-26,Melbourne,Australia,1982,2,74,186,4,1,230,438,8,156,252,4,28.75,<=30,AUS,Away,Upto 2014
G Miller,ENG,Spin,1983-01-02,Sydney,Australia,1983,2,167,399,4,1,585,1269,15,418,870,11,39.0,>30,AUS,Away,Upto 2014
G Miller,ENG,Spin,1984-06-14,Birmingham,England,1984,1,83,90,1,1,266,420,4,183,330,3,66.5,>30,ENG,Home,Upto 2014
G Miller,ENG,Spin,1984-06-28,Lord's,England,1984,2,59,78,0,1,102,174,1,43,96,1,102.0,>30,ENG,Home,Upto 2014
G Motie,WI,Spin,2022-06-16,North Sound,West Indies,2022,2,43,96,0,1,173,401,5,130,305,5,34.6,>30,WI,Home,After 1965
G Motie,WI,Spin,2023-02-04,Bulawayo,Zimbabwe,2023,2,160,342,6,1,573,1170,18,413,828,12,31.833333333333332,>30,ZIM,Away,After 1965
G Motie,WI,Spin,2023-02-12,Bulawayo,Zimbabwe,2023,2,99,194,13,1,284,566,18,185,372,5,15.777777777777779,<=30,ZIM,Away,After 1965
G Motie,WI,Spin,2023-03-08,Johannesburg,South Africa,2023,2,115,174,3,1,406,700,11,291,526,8,36.90909090909091,>30,SA,Away,After 1965
G Motie,WI,Spin,2024-01-17,Adelaide,Australia,2024,1,42,72,0,1,82,165,3,40,93,3,27.333333333333332,<=30,AUS,Away,After 1965
G Motie,WI,Spin,2024-07-10,Lord's,England,2024,1,41,96,2,1,47,110,2,6,14,0,23.5,<=30,ENG,Away,After 1965
G Motie,WI,Spin,2024-07-26,Birmingham,England,2024,1,61,114,1,1,163,267,3,102,153,2,54.333333333333336,>30,ENG,Away,After 1965
G Motie,WI,Spin,2024-08-07,Port of Spain,West Indies,2024,2,116,180,0,1,492,926,15,376,746,15,32.8,>30,WI,Home,After 1965
G Motie,WI,Spin,2024-08-15,Providence,West Indies,2024,2,89,168,3,1,233,450,12,144,282,9,19.416666666666668,<=30,WI,Home,After 1965
G Motie,WI,Spin,2025-01-17,Multan,Pakistan,2025,2,96,160,2,1,519,896,34,423,736,32,15.264705882352942,<=30,PAK,Away,After 1965
G Motie,WI,Spin,2025-01-25,Multan,Pakistan,2025,2,84,144,5,1,637,1154,37,553,1010,32,17.216216216216218,<=30,PAK,Away,After 1965
G Noblet,AUS,Pace,1950-03-03,Gqeberha,South Africa,1950,2,37,209,3,1,363,833,11,326,624,8,33.0,>30,SA,Away,Upto 2014
G Noblet,AUS,Pace,1951-12-22,Adelaide,Australia,1951,2,37,133,2,1,142,445,7,105,312,5,20.285714285714285,<=30,AUS,Home,Upto 2014
G Noblet,AUS,Pace,1953-02-06,Melbourne,Australia,1953,2,109,432,2,1,486,1431,11,377,999,9,44.18181818181818,>30,AUS,Home,Upto 2014
G Onions,ENG,Pace,2009-05-06,Lord's,England,2009,2,102,129,7,1,625,1023,22,523,894,15,28.40909090909091,<=30,ENG,Home,Upto 2014
G Onions,ENG,Pace,2009-05-14,Chester-le-Street,England,2009,2,98,144,3,1,746,1203,21,648,1059,18,35.523809523809526,>30,ENG,Home,Upto 2014
G Onions,ENG,Pace,2009-07-16,Lord's,England,2009,2,91,120,3,1,1009,1590,27,918,1470,24,37.370370370370374,>30,ENG,Home,Upto 2014
G Onions,ENG,Pace,2009-07-30,Birmingham,England,2009,2,132,214,5,1,806,1353,22,674,1139,17,36.63636363636363,>30,ENG,Home,Upto 2014
G Onions,ENG,Pace,2009-08-07,Leeds,England,2009,1,80,132,2,1,700,1101,30,620,969,28,23.333333333333332,<=30,ENG,Home,Upto 2014
G Onions,ENG,Pace,2009-12-16,Centurion,South Africa,2009,2,136,276,4,1,848,1757,22,712,1481,18,38.54545454545455,>30,SA,Away,Upto 2014
G Onions,ENG,Pace,2009-12-26,Durban,South Africa,2009,2,74,162,1,1,616,1251,15,542,1089,14,41.06666666666667,>30,SA,Away,Upto 2014
G Onions,ENG,Pace,2010-01-03,Cape Town,South Africa,2010,2,156,252,3,1,868,1767,26,712,1515,23,33.38461538461539,>30,SA,Away,Upto 2014
G Onions,ENG,Pace,2012-06-07,Birmingham,England,2012,1,88,177,4,1,443,825,14,355,648,10,31.642857142857142,>30,ENG,Home,Upto 2014
G Pullar,ENG,Spin,1960-03-25,Port of Spain,West Indies,1960,1,1,6,1,1,649,1404,16,648,1398,15,40.5625,>30,WI,Away,Upto 2014
G Pullar,ENG,Spin,1960-07-21,Manchester,England,1960,1,6,6,0,1,183,377,4,177,371,4,45.75,>30,ENG,Home,Upto 2014
G Pullar,ENG,Spin,1962-01-19,Dhaka,Bangladesh,1962,1,30,54,0,1,862,2494,25,832,2440,25,34.48,>30,BAN,Away,Upto 2014
G Sharma,IND,Spin,1985-01-31,Kanpur,India,1985,2,132,426,3,1,695,1644,9,563,1218,6,77.22222222222223,>30,IND,Home,Upto 2014
G Sharma,IND,Spin,1985-08-30,Colombo (SSC),Sri Lanka,1985,1,35,90,0,1,225,696,4,190,606,4,56.25,>30,SL,Away,Upto 2014
G Sharma,IND,Spin,1987-02-21,Jaipur,India,1987,1,88,197,4,1,591,1283,13,503,1086,9,45.46153846153846,>30,IND,Home,Upto 2014
G Sharma,IND,Spin,1987-03-04,Ahmedabad,India,1987,2,98,372,2,1,616,1851,11,518,1479,9,56.0,>30,IND,Home,Upto 2014
G Sharma,IND,Spin,1990-11-23,Chandigarh,India,1990,2,65,222,1,1,286,1097,16,221,875,15,17.875,<=30,IND,Home,Upto 2014
G Thornton,SA,Spin,1902-10-11,Johannesburg,South Africa,1902,1,20,24,1,1,619,846,16,599,822,15,38.6875,>30,SA,Home,Upto 2014
G Ulyett,ENG,Pace,1877-03-15,Melbourne,Australia,1877,2,75,176,3,1,194,465,7,119,289,4,27.714285714285715,<=30,AUS,Away,After 1965
G Ulyett,ENG,Pace,1877-03-31,Melbourne,Australia,1877,2,48,133,3,1,269,577,12,221,444,9,22.416666666666668,<=30,AUS,Away,After 1965
G Ulyett,ENG,Pace,1879-01-02,Melbourne,Australia,1879,2,102,252,1,1,316,788,22,214,536,21,14.363636363636363,<=30,AUS,Away,After 1965
G Ulyett,ENG,Pace,1881-12-31,Melbourne,Australia,1881,2,71,140,3,1,185,448,5,114,308,2,37.0,>30,AUS,Away,After 1965
G Ulyett,ENG,Pace,1882-02-17,Sydney,Australia,1882,2,59,150,4,1,195,434,9,136,284,5,21.666666666666668,<=30,AUS,Away,After 1965
G Ulyett,ENG,Pace,1882-03-03,Sydney,Australia,1882,1,10,12,0,1,221,493,9,211,481,9,24.555555555555557,<=30,AUS,Away,After 1965
G Ulyett,ENG,Pace,1882-03-10,Melbourne,Australia,1882,1,40,96,1,1,399,909,9,359,813,8,44.333333333333336,>30,AUS,Away,After 1965
G Ulyett,ENG,Pace,1882-08-28,The Oval,England,1882,2,21,60,2,1,213,651,23,192,591,21,9.26086956521739,<=30,ENG,Home,After 1965
G Ulyett,ENG,Pace,1884-07-10,Manchester,England,1884,1,41,120,3,1,208,652,12,167,532,9,17.333333333333332,<=30,ENG,Home,After 1965
G Ulyett,ENG,Pace,1884-07-21,Lord's,England,1884,2,57,201,7,1,404,842,13,347,641,6,31.076923076923077,>30,ENG,Home,After 1965
G Ulyett,ENG,Pace,1884-08-11,The Oval,England,1884,1,96,224,1,1,468,1104,7,372,880,6,66.85714285714286,>30,ENG,Home,After 1965
G Ulyett,ENG,Pace,1884-12-12,Adelaide,Australia,1884,2,26,48,0,1,319,830,6,293,782,6,53.166666666666664,>30,AUS,Away,After 1965
G Ulyett,ENG,Pace,1885-01-01,Melbourne,Australia,1885,2,42,92,1,1,410,1218,21,368,1126,20,19.523809523809526,<=30,AUS,Away,After 1965
G Ulyett,ENG,Pace,1885-02-20,Sydney,Australia,1885,2,59,206,3,1,367,1227,19,308,1021,16,19.31578947368421,<=30,AUS,Away,After 1965
G Ulyett,ENG,Pace,1885-03-14,Sydney,Australia,1885,1,91,216,3,1,423,931,23,332,715,20,18.391304347826086,<=30,AUS,Away,After 1965
G Ulyett,ENG,Pace,1885-03-21,Melbourne,Australia,1885,2,77,152,7,1,490,1192,20,413,1040,13,24.5,<=30,AUS,Away,After 1965
G Ulyett,ENG,Pace,1886-07-05,Manchester,England,1886,2,53,172,5,1,434,1426,26,381,1254,21,16.692307692307693,<=30,ENG,Home,After 1965
G Ulyett,ENG,Pace,1886-07-19,Lord's,England,1886,1,13,32,0,1,322,1023,13,309,991,13,24.76923076923077,<=30,ENG,Home,After 1965
G Ulyett,ENG,Pace,1889-03-12,Gqeberha,South Africa,1889,2,28,84,2,1,261,668,19,233,584,17,13.736842105263158,<=30,SA,Away,After 1965
G Ulyett,ENG,Pace,1889-03-25,Cape Town,South Africa,1889,1,0,16,0,1,290,589,13,290,573,13,22.307692307692307,<=30,SA,Away,After 1965
G Ulyett,ENG,Pace,1890-07-21,Lord's,England,1890,2,11,45,1,1,361,1213,17,350,1168,16,21.235294117647058,<=30,ENG,Home,After 1965
G Wijekoon,SL,Pace,2005-07-13,Colombo (SSC),Sri Lanka,2005,1,49,60,2,1,469,856,25,420,796,23,18.76,<=30,SL,Home,Upto 2014
G Wijekoon,SL,Pace,2005-07-22,Kandy,Sri Lanka,2005,2,17,54,0,1,490,931,20,473,877,20,24.5,<=30,SL,Home,Upto 2014
GA Bartlett,NZ,Pace,1961-12-08,Durban,South Africa,1961,2,50,108,1,1,481,1242,23,431,1134,22,20.91304347826087,<=30,SA,Away,Upto 2014
GA Bartlett,NZ,Pace,1961-12-26,Johannesburg,South Africa,1961,2,126,204,3,1,549,1269,21,423,1065,18,26.142857142857142,<=30,SA,Away,Upto 2014
GA Bartlett,NZ,Pace,1962-01-01,Cape Town,South Africa,1962,2,57,162,2,1,494,1176,15,437,1014,13,32.93333333333333,>30,SA,Away,Upto 2014
GA Bartlett,NZ,Pace,1962-02-02,Johannesburg,South Africa,1962,1,57,108,0,1,533,1091,23,476,983,23,23.17391304347826,<=30,SA,Away,Upto 2014
GA Bartlett,NZ,Pace,1962-02-16,Gqeberha,South Africa,1962,2,36,102,2,1,563,1365,25,527,1263,23,22.52,<=30,SA,Away,Upto 2014
GA Bartlett,NZ,Pace,1965-02-12,Christchurch,New Zealand,1965,2,93,195,0,1,416,1052,17,323,857,17,24.470588235294116,<=30,NZ,Home,Upto 2014
GA Bartlett,NZ,Pace,1966-02-25,Christchurch,New Zealand,1966,2,107,284,4,1,629,1668,27,522,1384,23,23.296296296296298,<=30,NZ,Home,Upto 2014
GA Bartlett,NZ,Pace,1966-03-04,Dunedin,New Zealand,1966,1,70,174,2,1,364,1194,18,294,1020,16,20.22222222222222,<=30,NZ,Home,Upto 2014
GA Bartlett,NZ,Pace,1968-02-22,Christchurch,New Zealand,1968,2,90,185,6,1,471,977,17,381,792,11,27.705882352941178,<=30,NZ,Home,Upto 2014
GA Bartlett,NZ,Pace,1968-03-07,Auckland,New Zealand,1968,2,106,246,4,1,377,874,14,271,628,10,26.928571428571427,<=30,NZ,Home,Upto 2014
GA Chevalier,SA,Spin,1970-01-22,Cape Town,South Africa,1970,2,100,253,5,1,547,1442,19,447,1189,14,28.789473684210527,<=30,SA,Home,Upto 2014
GA Cope,ENG,Spin,1977-12-14,Lahore,Pakistan,1977,2,109,336,3,1,395,1311,10,286,975,7,39.5,>30,PAK,Away,Upto 2014
GA Cope,ENG,Spin,1978-01-02,Hyderabad (Sind),Pakistan,1978,2,91,304,4,1,585,1882,17,494,1578,13,34.411764705882355,>30,PAK,Away,Upto 2014
GA Cope,ENG,Spin,1978-01-18,Karachi,Pakistan,1978,1,77,224,1,1,466,1665,20,389,1441,19,23.3,<=30,PAK,Away,Upto 2014
GA Faulkner,SA,Spin,1906-01-02,Johannesburg,South Africa,1906,2,61,209,6,1,455,1132,23,394,923,17,19.782608695652176,<=30,SA,Home,Upto 2014
GA Faulkner,SA,Spin,1906-03-06,Johannesburg,South Africa,1906,2,57,144,3,1,287,726,15,230,582,12,19.133333333333333,<=30,SA,Home,Upto 2014
GA Faulkner,SA,Spin,1906-03-10,Johannesburg,South Africa,1906,2,67,138,0,1,622,1254,10,555,1116,10,62.2,>30,SA,Home,Upto 2014
GA Faulkner,SA,Spin,1906-03-24,Cape Town,South Africa,1906,2,70,185,5,1,339,907,20,269,722,15,16.95,<=30,SA,Home,Upto 2014
GA Faulkner,SA,Spin,1906-03-30,Cape Town,South Africa,1906,2,17,42,0,1,364,776,15,347,734,15,24.266666666666666,<=30,SA,Home,Upto 2014
GA Faulkner,SA,Spin,1907-07-01,Lord's,England,1907,1,59,72,1,1,478,962,15,419,890,14,31.866666666666667,>30,ENG,Away,Upto 2014
GA Faulkner,SA,Spin,1907-07-29,Leeds,England,1907,2,75,186,9,1,289,661,31,214,475,22,9.32258064516129,<=30,ENG,Away,Upto 2014
GA Faulkner,SA,Spin,1907-08-19,The Oval,England,1907,2,84,180,2,1,462,1059,21,378,879,19,22.0,<=30,ENG,Away,Upto 2014
GA Faulkner,SA,Spin,1910-01-01,Johannesburg,South Africa,1910,2,160,302,8,1,593,1077,29,433,775,21,20.448275862068964,<=30,SA,Home,Upto 2014
GA Faulkner,SA,Spin,1910-01-21,Durban,South Africa,1910,2,138,305,8,1,565,1312,24,427,1007,16,23.541666666666668,<=30,SA,Home,Upto 2014
GA Faulkner,SA,Spin,1910-02-26,Johannesburg,South Africa,1910,2,164,322,6,1,662,1226,24,498,904,18,27.583333333333332,<=30,SA,Home,Upto 2014
GA Faulkner,SA,Spin,1910-03-07,Cape Town,South Africa,1910,2,101,174,4,1,379,765,17,278,591,13,22.294117647058822,<=30,SA,Home,Upto 2014
GA Faulkner,SA,Spin,1910-03-11,Cape Town,South Africa,1910,1,72,152,3,1,488,932,19,416,780,16,25.68421052631579,<=30,SA,Home,Upto 2014
GA Faulkner,SA,Spin,1910-12-09,Sydney,Australia,1910,1,71,72,0,1,388,570,5,317,498,5,77.6,>30,AUS,Away,Upto 2014
GA Faulkner,SA,Spin,1910-12-31,Melbourne,Australia,1910,2,89,136,3,1,675,1063,21,586,927,18,32.142857142857146,>30,AUS,Away,Upto 2014
GA Faulkner,SA,Spin,1911-01-07,Adelaide,Australia,1911,2,115,156,3,1,814,1502,20,699,1346,17,40.7,>30,AUS,Away,Upto 2014
GA Faulkner,SA,Spin,1911-02-17,Melbourne,Australia,1911,2,183,278,4,1,844,1322,23,661,1044,19,36.69565217391305,>30,AUS,Away,Upto 2014
GA Faulkner,SA,Spin,1911-03-03,Sydney,Australia,1911,2,56,102,0,1,638,1067,19,582,965,19,33.578947368421055,>30,AUS,Away,Upto 2014
GA Faulkner,SA,Spin,1912-05-27,Manchester,England,1912,1,55,96,0,1,525,1035,18,470,939,18,29.166666666666668,<=30,ENG,Away,Upto 2014
GA Faulkner,SA,Spin,1912-06-10,Lord's,England,1912,1,72,174,0,1,275,582,7,203,408,7,39.285714285714285,>30,ENG,Away,Upto 2014
GA Faulkner,SA,Spin,1912-07-08,Leeds,England,1912,2,100,224,6,1,384,746,14,284,522,8,27.428571428571427,<=30,ENG,Away,Upto 2014
GA Faulkner,SA,Spin,1912-07-15,Lord's,England,1912,2,96,180,1,1,501,1026,19,405,846,18,26.36842105263158,<=30,ENG,Away,Upto 2014
GA Faulkner,SA,Spin,1912-08-05,Nottingham,England,1912,1,43,121,3,1,399,1038,15,356,917,12,26.6,<=30,ENG,Away,Upto 2014
GA Faulkner,SA,Spin,1912-08-12,The Oval,England,1912,2,88,175,7,1,234,496,16,146,321,9,14.625,<=30,ENG,Away,Upto 2014
GA Faulkner,SA,Spin,1924-06-28,Lord's,England,1924,1,87,102,0,1,563,1396,14,476,1294,14,40.214285714285715,>30,ENG,Away,Upto 2014
GA Gooch,ENG,Pace,1978-08-24,Lord's,England,1978,1,29,60,0,1,614,1515,29,585,1455,29,21.17241379310345,<=30,ENG,Home,Upto 2014
GA Gooch,ENG,Pace,1978-12-01,Brisbane,Australia,1978,1,1,8,0,1,633,1750,28,632,1742,28,22.607142857142858,<=30,AUS,Away,Upto 2014
GA Gooch,ENG,Pace,1979-01-06,Sydney,Australia,1979,1,14,40,0,1,452,1414,19,438,1374,19,23.789473684210527,<=30,AUS,Away,Upto 2014
GA Gooch,ENG,Pace,1979-07-12,Birmingham,England,1979,1,8,36,0,1,689,1489,22,681,1453,22,31.318181818181817,>30,ENG,Home,Upto 2014
GA Gooch,ENG,Pace,1979-08-02,Lord's,England,1979,2,24,72,1,1,523,1253,16,499,1181,15,32.6875,>30,ENG,Home,Upto 2014
GA Gooch,ENG,Pace,1979-08-16,Leeds,England,1979,1,2,18,0,1,293,690,9,291,672,9,32.55555555555556,>30,ENG,Home,Upto 2014
GA Gooch,ENG,Pace,1979-08-30,The Oval,England,1979,2,15,24,0,1,700,1610,24,685,1586,24,29.166666666666668,<=30,ENG,Home,Upto 2014
GA Gooch,ENG,Pace,1980-01-04,Sydney,Australia,1980,2,36,114,2,1,548,1437,28,512,1323,26,19.571428571428573,<=30,AUS,Away,Upto 2014
GA Gooch,ENG,Pace,1980-02-15,Wankhede,India,1980,1,3,24,0,1,555,1195,28,552,1171,28,19.821428571428573,<=30,IND,Away,Upto 2014
GA Gooch,ENG,Pace,1980-06-05,Nottingham,England,1980,2,13,54,1,1,897,2129,36,884,2075,35,24.916666666666668,<=30,ENG,Home,Upto 2014
GA Gooch,ENG,Pace,1980-06-19,Lord's,England,1980,1,26,42,0,1,667,1407,18,641,1365,18,37.05555555555556,>30,ENG,Home,Upto 2014
GA Gooch,ENG,Pace,1980-07-24,The Oval,England,1980,1,2,6,0,1,630,1595,25,628,1589,25,25.2,<=30,ENG,Home,Upto 2014
GA Gooch,ENG,Pace,1980-08-07,Leeds,England,1980,1,18,48,2,1,526,1199,25,508,1151,23,21.04,<=30,ENG,Home,Upto 2014
GA Gooch,ENG,Pace,1980-08-28,Lord's,England,1980,1,16,48,0,1,636,1262,19,620,1214,19,33.473684210526315,>30,ENG,Home,Upto 2014
GA Gooch,ENG,Pace,1981-02-13,Port of Spain,West Indies,1981,1,3,12,0,1,521,1338,21,518,1326,21,24.80952380952381,<=30,WI,Away,Upto 2014
GA Gooch,ENG,Pace,1981-03-13,Bridgetown,West Indies,1981,1,13,12,0,1,801,1640,34,788,1628,34,23.558823529411764,<=30,WI,Away,Upto 2014
GA Gooch,ENG,Pace,1981-03-27,St John's,West Indies,1981,1,0,12,0,1,702,1430,20,702,1418,20,35.1,>30,WI,Away,Upto 2014
GA Gooch,ENG,Pace,1981-04-10,Kingston,West Indies,1981,1,20,48,0,1,705,1477,22,685,1429,22,32.04545454545455,>30,WI,Away,Upto 2014
GA Gooch,ENG,Pace,1981-07-02,Lord's,England,1981,1,28,60,0,1,755,1760,25,727,1700,25,30.2,>30,ENG,Home,Upto 2014
GA Gooch,ENG,Pace,1981-12-23,Delhi,India,1981,1,12,49,2,1,608,1217,15,596,1168,13,40.53333333333333,>30,IND,Away,Upto 2014
GA Gooch,ENG,Pace,1982-01-01,Eden Gardens,India,1982,2,14,48,0,1,453,960,12,439,912,12,37.75,>30,IND,Away,Upto 2014
GA Gooch,ENG,Pace,1982-01-13,Chennai,India,1982,2,51,102,0,1,631,1176,8,580,1074,8,78.875,>30,IND,Away,Upto 2014
GA Gooch,ENG,Pace,1985-06-13,Leeds,England,1985,2,78,180,2,1,1140,1931,28,1062,1751,26,40.714285714285715,>30,ENG,Home,Upto 2014
GA Gooch,ENG,Pace,1985-06-27,Lord's,England,1985,1,11,18,0,1,753,1358,25,742,1340,25,30.12,>30,ENG,Home,Upto 2014
GA Gooch,ENG,Pace,1985-07-11,Nottingham,England,1985,1,13,50,0,1,706,1344,15,693,1294,15,47.06666666666667,>30,ENG,Home,Upto 2014
GA Gooch,ENG,Pace,1986-02-21,Kingston,West Indies,1986,1,6,12,0,1,543,1027,29,537,1015,29,18.724137931034484,<=30,WI,Away,Upto 2014
GA Gooch,ENG,Pace,1986-04-11,St John's,West Indies,1986,1,21,30,1,1,906,1622,22,885,1592,21,41.18181818181818,>30,WI,Away,Upto 2014
GA Gooch,ENG,Pace,1986-06-19,Leeds,England,1986,2,31,78,1,1,608,1416,31,577,1338,30,19.612903225806452,<=30,ENG,Home,Upto 2014
GA Gooch,ENG,Pace,1986-07-24,Lord's,England,1986,1,23,78,1,1,599,1428,17,576,1350,16,35.23529411764706,>30,ENG,Home,Upto 2014
GA Gooch,ENG,Pace,1986-08-07,Nottingham,England,1986,1,0,12,0,1,656,1476,21,656,1464,21,31.238095238095237,>30,ENG,Home,Upto 2014
GA Gooch,ENG,Pace,1986-08-21,The Oval,England,1986,1,15,24,0,1,479,811,12,464,787,12,39.916666666666664,>30,ENG,Home,Upto 2014
GA Gooch,ENG,Pace,1987-12-07,Faisalabad,Pakistan,1987,1,4,12,0,1,157,324,5,153,312,5,31.4,>30,PAK,Away,Upto 2014
GA Gooch,ENG,Pace,1989-06-08,Leeds,England,1989,1,31,54,0,1,1372,2385,30,1341,2331,30,45.733333333333334,>30,ENG,Home,Upto 2014
GA Gooch,ENG,Pace,1989-06-22,Lord's,England,1989,1,9,36,0,1,1092,2047,30,1083,2011,30,36.4,>30,ENG,Home,Upto 2014
GA Gooch,ENG,Pace,1989-07-06,Birmingham,England,1989,1,30,84,1,1,670,1413,17,640,1329,16,39.411764705882355,>30,ENG,Home,Upto 2014
GA Gooch,ENG,Pace,1989-08-24,The Oval,England,1989,1,2,12,0,1,921,1691,26,919,1679,26,35.42307692307692,>30,ENG,Home,Upto 2014
GA Gooch,ENG,Pace,1990-06-21,Lord's,England,1990,1,25,78,0,1,748,1364,15,723,1286,15,49.86666666666667,>30,ENG,Home,Upto 2014
GA Gooch,ENG,Pace,1990-07-26,Lord's,England,1990,1,26,36,1,1,1076,1683,21,1050,1647,20,51.23809523809524,>30,ENG,Home,Upto 2014
GA Gooch,ENG,Pace,1990-08-23,The Oval,England,1990,1,44,72,0,1,853,1642,16,809,1570,16,53.3125,>30,ENG,Home,Upto 2014
GA Gooch,ENG,Pace,1991-01-04,Sydney,Australia,1991,1,46,84,1,1,621,1201,14,575,1117,13,44.357142857142854,>30,AUS,Away,Upto 2014
GA Gooch,ENG,Pace,1991-01-25,Adelaide,Australia,1991,1,23,54,1,1,1030,2159,28,1007,2105,27,36.785714285714285,>30,AUS,Away,Upto 2014
GA Gooch,ENG,Pace,1991-06-20,Lord's,England,1991,1,3,12,0,1,685,1326,19,682,1314,19,36.05263157894737,>30,ENG,Home,Upto 2014
GA Gooch,ENG,Pace,1991-07-25,Birmingham,England,1991,1,11,36,0,1,722,1721,32,711,1685,32,22.5625,<=30,ENG,Home,Upto 2014
GA Gooch,ENG,Pace,1992-06-04,Birmingham,England,1992,1,9,60,0,1,641,1086,9,632,1026,9,71.22222222222223,>30,ENG,Home,Upto 2014
GA Gooch,ENG,Pace,1992-07-02,Manchester,England,1992,2,69,204,5,1,841,1528,24,772,1324,19,35.041666666666664,>30,ENG,Home,Upto 2014
GA Gooch,ENG,Pace,1992-07-23,Leeds,England,1992,2,16,42,0,1,719,1557,27,703,1515,27,26.62962962962963,<=30,ENG,Home,Upto 2014
GA Gooch,ENG,Pace,1993-06-17,Lord's,England,1993,1,26,54,0,1,536,1020,6,510,966,6,89.33333333333333,>30,ENG,Home,Upto 2014
GA Gooch,ENG,Pace,1993-07-22,Leeds,England,1993,1,40,96,0,1,901,1757,18,861,1661,18,50.05555555555556,>30,ENG,Home,Upto 2014
GA Gooch,ENG,Pace,1994-06-16,Lord's,England,1994,1,13,30,0,1,756,1458,24,743,1428,24,31.5,>30,ENG,Home,Upto 2014
GA Gooch,ENG,Pace,1994-06-30,Manchester,England,1994,1,13,12,0,1,638,1439,22,625,1427,22,29.0,<=30,ENG,Home,Upto 2014
GA Gooch,ENG,Pace,1994-08-04,Leeds,England,1994,1,9,18,0,1,1145,2209,21,1136,2191,21,54.523809523809526,>30,ENG,Home,Upto 2014
GA Gooch,ENG,Pace,1994-11-25,Brisbane,Australia,1994,2,25,72,1,1,726,1262,21,701,1190,20,34.57142857142857,>30,AUS,Away,Upto 2014
GA Gooch,ENG,Pace,1995-01-01,Sydney,Australia,1995,1,27,42,0,1,651,1345,27,624,1303,27,24.11111111111111,<=30,AUS,Away,Upto 2014
GA Gooch,ENG,Pace,1995-01-26,Adelaide,Australia,1995,1,22,30,0,1,823,1644,27,801,1614,27,30.48148148148148,>30,AUS,Away,Upto 2014
GA Gooch,ENG,Pace,1995-02-03,W.A.C.A,Australia,1995,1,0,6,0,1,946,1817,29,946,1811,29,32.62068965517241,>30,AUS,Away,Upto 2014
GA Greenidge,WI,Spin,1972-04-06,Georgetown,West Indies,1972,1,34,84,0,1,489,1488,3,455,1404,3,163.0,>30,WI,Home,Upto 2014
GA Greenidge,WI,Spin,1972-04-20,Port of Spain,West Indies,1972,1,2,6,0,1,509,1648,17,507,1642,17,29.941176470588236,<=30,WI,Home,Upto 2014
GA Greenidge,WI,Spin,1973-03-09,Bridgetown,West Indies,1973,1,24,42,0,1,470,1314,10,446,1272,10,47.0,>30,WI,Home,Upto 2014
GA Greenidge,WI,Spin,1973-04-06,Georgetown,West Indies,1973,1,15,24,0,1,241,564,5,226,540,5,48.2,>30,WI,Home,Upto 2014
GA Headley,WI,Spin,1930-01-11,Bridgetown,West Indies,1930,2,16,30,0,1,542,1217,16,526,1187,16,33.875,>30,WI,Home,Upto 2014
GA Headley,WI,Spin,1930-02-01,Port of Spain,West Indies,1930,1,30,66,0,1,356,890,8,326,824,8,44.5,>30,WI,Home,Upto 2014
GA Headley,WI,Spin,1930-02-21,Georgetown,West Indies,1930,1,8,12,0,1,461,1269,13,453,1257,13,35.46153846153846,>30,WI,Home,Upto 2014
GA Headley,WI,Spin,1930-04-03,Kingston,West Indies,1930,1,23,30,0,1,1040,2209,18,1017,2179,18,57.77777777777778,>30,WI,Home,Upto 2014
GA Headley,WI,Spin,1933-07-22,Manchester,England,1933,1,65,90,0,1,521,1061,15,456,971,15,34.733333333333334,>30,ENG,Away,Upto 2014
GA Headley,WI,Spin,1933-08-12,The Oval,England,1933,1,16,24,0,1,194,451,12,178,427,12,16.166666666666668,<=30,ENG,Away,Upto 2014
GA Headley,WI,Spin,1935-01-24,Port of Spain,West Indies,1935,1,3,24,0,1,418,1002,12,415,978,12,34.833333333333336,>30,WI,Home,Upto 2014
GA Headley,WI,Spin,1935-02-14,Georgetown,West Indies,1935,1,0,6,0,1,339,996,16,339,990,16,21.1875,<=30,WI,Home,Upto 2014
GA Headley,WI,Spin,1939-08-19,The Oval,England,1939,1,17,32,0,1,434,768,4,417,736,4,108.5,>30,ENG,Away,Upto 2014
GA Headley,WI,Spin,1948-01-21,Bridgetown,West Indies,1948,1,11,36,0,1,610,1348,22,599,1312,22,27.727272727272727,<=30,WI,Home,Upto 2014
GA Headley,WI,Spin,1948-11-10,Delhi,India,1948,2,18,18,0,1,804,1710,13,786,1692,13,61.84615384615385,>30,IND,Away,Upto 2014
GA Headley,WI,Spin,1954-01-15,Kingston,West Indies,1954,1,23,30,0,1,426,1149,15,403,1119,15,28.4,<=30,WI,Home,Upto 2014
GA Hick,ENG,Spin,1991-06-20,Lord's,England,1991,1,77,108,2,1,87,138,3,10,30,1,29.0,<=30,ENG,Home,Upto 2014
GA Hick,ENG,Spin,1991-07-04,Nottingham,England,1991,1,18,30,0,1,144,282,3,126,252,3,48.0,>30,ENG,Home,Upto 2014
GA Hick,ENG,Spin,1991-07-25,Birmingham,England,1991,1,0,6,0,1,126,226,1,126,220,1,126.0,>30,ENG,Home,Upto 2014
GA Hick,ENG,Spin,1992-01-18,Christchurch,New Zealand,1992,2,22,102,0,1,362,1021,13,340,919,13,27.846153846153847,<=30,NZ,Away,Upto 2014
GA Hick,ENG,Spin,1992-01-30,Auckland,New Zealand,1992,1,0,6,0,1,104,264,4,104,258,4,26.0,<=30,NZ,Away,Upto 2014
GA Hick,ENG,Spin,1992-02-06,Wellington,New Zealand,1992,1,126,414,4,1,491,1353,13,365,939,9,37.76923076923077,>30,NZ,Away,Upto 2014
GA Hick,ENG,Spin,1992-06-04,Birmingham,England,1992,1,46,78,0,1,247,450,2,201,372,2,123.5,>30,ENG,Home,Upto 2014
GA Hick,ENG,Spin,1992-07-02,Manchester,England,1992,2,17,30,0,1,251,294,0,234,264,0,inf,>30,ENG,Home,Upto 2014
GA Hick,ENG,Spin,1993-01-29,Eden Gardens,India,1993,2,28,113,5,1,470,1482,23,442,1369,18,20.434782608695652,<=30,IND,Away,Upto 2014
GA Hick,ENG,Spin,1993-02-11,Chennai,India,1993,1,77,174,1,1,792,1720,20,715,1546,19,39.6,>30,IND,Away,Upto 2014
GA Hick,ENG,Spin,1993-02-19,Wankhede,India,1993,1,97,174,2,1,804,1796,20,707,1622,18,40.2,>30,IND,Away,Upto 2014
GA Hick,ENG,Spin,1993-03-13,Colombo (SSC),Sri Lanka,1993,2,38,60,0,1,805,1517,22,767,1457,22,36.59090909090909,>30,SL,Away,Upto 2014
GA Hick,ENG,Spin,1993-06-03,Manchester,England,1993,1,20,54,0,1,496,1275,19,476,1221,19,26.105263157894736,<=30,ENG,Home,Upto 2014
GA Hick,ENG,Spin,1993-06-17,Lord's,England,1993,1,21,48,0,1,634,1745,17,613,1697,17,37.294117647058826,>30,ENG,Home,Upto 2014
GA Hick,ENG,Spin,1993-08-19,The Oval,England,1993,1,11,48,0,1,310,756,7,299,708,7,44.285714285714285,>30,ENG,Home,Upto 2014
GA Hick,ENG,Spin,1994-02-19,Kingston,West Indies,1994,2,57,144,1,1,97,216,2,40,72,1,48.5,>30,WI,Away,Upto 2014
GA Hick,ENG,Spin,1994-03-17,Georgetown,West Indies,1994,1,61,120,0,1,318,558,4,257,438,4,79.5,>30,WI,Away,Upto 2014
GA Hick,ENG,Spin,1994-03-25,Port of Spain,West Indies,1994,1,5,18,0,1,162,288,3,157,270,3,54.0,>30,WI,Away,Upto 2014
GA Hick,ENG,Spin,1994-04-08,Bridgetown,West Indies,1994,1,3,24,1,1,263,593,6,260,569,5,43.833333333333336,>30,WI,Away,Upto 2014
GA Hick,ENG,Spin,1994-04-16,St John's,West Indies,1994,2,72,156,0,1,364,732,3,292,576,3,121.33333333333333,>30,WI,Away,Upto 2014
GA Hick,ENG,Spin,1994-06-02,Nottingham,England,1994,1,12,84,1,1,324,936,7,312,852,6,46.285714285714285,>30,ENG,Home,Upto 2014
GA Hick,ENG,Spin,1994-06-16,Lord's,England,1994,2,9,24,0,1,425,1219,7,416,1195,7,60.714285714285715,>30,ENG,Home,Upto 2014
GA Hick,ENG,Spin,1994-07-21,Lord's,England,1994,2,60,204,2,1,242,564,5,182,360,3,48.4,>30,ENG,Home,Upto 2014
GA Hick,ENG,Spin,1994-08-04,Leeds,England,1994,2,14,42,0,1,136,384,4,122,342,4,34.0,>30,ENG,Home,Upto 2014
GA Hick,ENG,Spin,1994-08-18,The Oval,England,1994,2,24,42,0,1,24,42,0,0,0,0,inf,>30,ENG,Home,Upto 2014
GA Hick,ENG,Spin,1994-11-25,Brisbane,Australia,1994,2,23,36,0,1,405,1216,16,382,1180,16,25.3125,<=30,AUS,Away,Upto 2014
GA Hick,ENG,Spin,1994-12-24,Melbourne,Australia,1994,2,14,30,0,1,290,880,14,276,850,14,20.714285714285715,<=30,AUS,Away,Upto 2014
GA Hick,ENG,Spin,1995-01-01,Sydney,Australia,1995,1,21,30,0,1,330,790,1,309,760,1,330.0,>30,AUS,Away,Upto 2014
GA Hick,ENG,Spin,1995-06-08,Leeds,England,1995,1,15,24,1,1,96,186,2,81,162,1,48.0,>30,ENG,Home,Upto 2014
GA Hick,ENG,Spin,1995-08-10,Nottingham,England,1995,1,11,24,0,1,465,1032,7,454,1008,7,66.42857142857143,>30,ENG,Home,Upto 2014
GA Hick,ENG,Spin,1995-08-24,The Oval,England,1995,1,38,60,0,1,255,528,1,217,468,1,255.0,>30,ENG,Home,Upto 2014
GA Hick,ENG,Spin,1995-11-30,Johannesburg,South Africa,1995,2,73,180,1,1,180,594,4,107,414,3,45.0,>30,SA,Away,Upto 2014
GA Hick,ENG,Spin,1995-12-14,Durban,South Africa,1995,1,5,12,0,1,42,186,3,37,174,3,14.0,<=30,SA,Away,Upto 2014
GA Hick,ENG,Spin,1995-12-26,Gqeberha,South Africa,1995,1,32,72,0,1,309,845,10,277,773,10,30.9,>30,SA,Away,Upto 2014
GA Hick,ENG,Spin,1996-01-02,Cape Town,South Africa,1996,1,7,10,0,1,171,377,6,164,367,6,28.5,<=30,SA,Away,Upto 2014
GA Hick,ENG,Spin,1996-06-06,Birmingham,England,1996,1,12,24,0,1,130,258,1,118,234,1,130.0,>30,ENG,Home,Upto 2014
GA Hick,ENG,Spin,1996-06-20,Lord's,England,1996,1,8,12,0,1,159,498,3,151,486,3,53.0,>30,ENG,Home,Upto 2014
GA Hick,ENG,Spin,1996-07-04,Nottingham,England,1996,2,31,78,0,1,381,828,3,350,750,3,127.0,>30,ENG,Home,Upto 2014
GA Hick,ENG,Spin,1996-07-25,Lord's,England,1996,2,42,78,1,1,309,758,8,267,680,7,38.625,>30,ENG,Home,Upto 2014
GA Hick,ENG,Spin,1998-12-11,Adelaide,Australia,1998,1,1,6,0,1,473,1152,14,472,1146,14,33.785714285714285,>30,AUS,Away,Upto 2014
GA Hick,ENG,Spin,1999-08-05,Manchester,England,1999,1,8,6,0,1,316,834,9,308,828,9,35.111111111111114,>30,ENG,Home,Upto 2014
GA Hick,ENG,Spin,2000-11-15,Lahore,Pakistan,2000,1,42,48,1,1,697,1762,20,655,1714,19,34.85,>30,PAK,Away,Upto 2014
GA Hick,ENG,Spin,2001-02-22,Galle,Sri Lanka,2001,1,8,24,0,1,636,1872,18,628,1848,18,35.333333333333336,>30,SL,Away,Upto 2014
GA Kempis,SA,Pace,1889-03-12,Gqeberha,South Africa,1889,2,76,168,4,1,261,668,19,185,500,15,13.736842105263158,<=30,SA,Home,After 1965
GA Lamb,ZIM,Spin,2011-09-01,Bulawayo,Zimbabwe,2011,2,141,192,3,1,525,1193,17,384,1001,14,30.88235294117647,>30,ZIM,Home,Upto 2014
GA Lohmann,ENG,Pace,1886-07-05,Manchester,England,1886,2,55,112,1,1,434,1426,26,379,1314,25,16.692307692307693,<=30,ENG,Home,After 1965
GA Lohmann,ENG,Pace,1886-07-19,Lord's,England,1886,2,32,84,0,1,322,1023,13,290,939,13,24.76923076923077,<=30,ENG,Home,After 1965
GA Lohmann,ENG,Pace,1886-08-12,The Oval,England,1886,2,104,270,12,1,385,1143,19,281,873,7,20.263157894736842,<=30,ENG,Home,After 1965
GA Lohmann,ENG,Pace,1887-01-28,Sydney,Australia,1887,2,50,180,6,1,241,1003,28,191,823,22,8.607142857142858,<=30,AUS,Away,After 1965
GA Lohmann,ENG,Pace,1887-02-25,Sydney,Australia,1887,2,87,269,10,1,222,846,20,135,577,10,11.1,<=30,AUS,Away,After 1965
GA Lohmann,ENG,Pace,1888-02-10,Sydney,Australia,1888,2,52,204,9,1,187,670,24,135,466,15,7.791666666666667,<=30,AUS,Away,After 1965
GA Lohmann,ENG,Pace,1888-07-16,Lord's,England,1888,2,61,136,6,1,147,372,17,86,236,11,8.647058823529411,<=30,ENG,Home,After 1965
GA Lohmann,ENG,Pace,1888-08-13,The Oval,England,1888,2,32,143,1,1,274,691,16,242,548,15,17.125,<=30,ENG,Home,After 1965
GA Lohmann,ENG,Pace,1888-08-30,Manchester,England,1888,2,51,100,4,1,172,393,11,121,293,7,15.636363636363637,<=30,ENG,Home,After 1965
GA Lohmann,ENG,Pace,1890-07-21,Lord's,England,1890,2,71,250,3,1,361,1213,17,290,963,14,21.235294117647058,<=30,ENG,Home,After 1965
GA Lohmann,ENG,Pace,1890-08-11,The Oval,England,1890,2,66,267,6,1,285,909,28,219,642,22,10.178571428571429,<=30,ENG,Home,After 1965
GA Lohmann,ENG,Pace,1892-01-01,Melbourne,Australia,1892,2,93,402,2,1,677,2425,30,584,2023,28,22.566666666666666,<=30,AUS,Away,After 1965
GA Lohmann,ENG,Pace,1892-01-29,Sydney,Australia,1892,2,142,566,10,1,735,2292,31,593,1726,21,23.70967741935484,<=30,AUS,Away,After 1965
GA Lohmann,ENG,Pace,1892-03-24,Adelaide,Australia,1892,2,54,162,4,1,529,1333,15,475,1171,11,35.266666666666666,>30,AUS,Away,After 1965
GA Lohmann,ENG,Pace,1896-02-13,Gqeberha,South Africa,1896,2,45,128,15,1,376,688,29,331,560,14,12.96551724137931,<=30,SA,Away,After 1965
GA Lohmann,ENG,Pace,1896-03-02,Johannesburg,South Africa,1896,2,71,157,12,1,539,922,24,468,765,12,22.458333333333332,<=30,SA,Away,After 1965
GA Lohmann,ENG,Pace,1896-03-21,Cape Town,South Africa,1896,2,87,235,8,1,245,540,16,158,305,8,15.3125,<=30,SA,Away,After 1965
GA Lohmann,ENG,Pace,1896-06-22,Lord's,England,1896,2,52,165,3,1,652,1288,29,600,1123,26,22.482758620689655,<=30,ENG,Home,After 1965
GA Rowe,SA,Spin,1896-03-02,Johannesburg,South Africa,1896,1,115,245,5,1,186,315,5,71,70,0,37.2,>30,SA,Home,After 1965
GA Rowe,SA,Spin,1896-03-21,Cape Town,South Africa,1896,1,72,160,2,1,223,529,14,151,369,12,15.928571428571429,<=30,SA,Home,After 1965
GA Rowe,SA,Spin,1899-02-14,Johannesburg,South Africa,1899,2,74,232,4,1,466,1319,30,392,1087,26,15.533333333333333,<=30,SA,Home,After 1965
GA Rowe,SA,Spin,1899-04-01,Cape Town,South Africa,1899,2,112,265,3,1,347,777,19,235,512,16,18.263157894736842,<=30,SA,Home,After 1965
GA Rowe,SA,Spin,1902-10-11,Johannesburg,South Africa,1902,2,83,96,1,1,619,846,16,536,750,15,38.6875,>30,SA,Home,Upto 2014
GA Stuurman,SA,Pace,2022-02-17,Christchurch,New Zealand,2022,1,124,174,1,1,630,1205,28,506,1031,27,22.5,<=30,NZ,Away,After 1965
GAE Paine,ENG,Spin,1935-01-08,Bridgetown,West Indies,1935,2,14,60,3,1,82,234,6,68,174,3,13.666666666666666,<=30,WI,Away,Upto 2014
GAE Paine,ENG,Spin,1935-01-24,Port of Spain,West Indies,1935,2,194,408,5,1,418,1002,12,224,594,7,34.833333333333336,>30,WI,Away,Upto 2014
GAE Paine,ENG,Spin,1935-02-14,Georgetown,West Indies,1935,2,91,240,4,1,339,996,16,248,756,12,21.1875,<=30,WI,Away,Upto 2014
GAE Paine,ENG,Spin,1935-03-14,Kingston,West Indies,1935,1,168,336,5,1,453,1026,10,285,690,5,45.3,>30,WI,Away,Upto 2014
GAR Lock,ENG,Spin,1952-07-17,Manchester,England,1952,1,36,57,4,1,285,693,12,249,636,8,23.75,<=30,ENG,Home,Upto 2014
GAR Lock,ENG,Spin,1952-08-14,The Oval,England,1952,1,1,36,0,1,267,870,5,266,834,5,53.4,>30,ENG,Home,Upto 2014
GAR Lock,ENG,Spin,1953-07-23,Leeds,England,1953,2,101,186,2,1,195,432,3,94,246,1,65.0,>30,ENG,Home,Upto 2014
GAR Lock,ENG,Spin,1953-08-15,The Oval,England,1953,2,64,180,6,1,335,826,14,271,646,8,23.928571428571427,<=30,ENG,Home,Upto 2014
GAR Lock,ENG,Spin,1954-01-15,Kingston,West Indies,1954,2,112,330,5,1,426,1149,15,314,819,10,28.4,<=30,WI,Away,Upto 2014
GAR Lock,ENG,Spin,1954-02-06,Bridgetown,West Indies,1954,2,216,444,1,1,772,2250,20,556,1806,19,38.6,>30,WI,Away,Upto 2014
GAR Lock,ENG,Spin,1954-02-24,Georgetown,West Indies,1954,2,101,317,3,1,666,2079,21,565,1762,18,31.714285714285715,>30,WI,Away,Upto 2014
GAR Lock,ENG,Spin,1954-03-17,Port of Spain,West Indies,1954,2,218,438,3,1,1025,1930,13,807,1492,10,78.84615384615384,>30,WI,Away,Upto 2014
GAR Lock,ENG,Spin,1954-03-30,Kingston,West Indies,1954,2,71,252,2,1,581,1630,14,510,1378,12,41.5,>30,WI,Away,Upto 2014
GAR Lock,ENG,Spin,1955-07-07,Manchester,England,1955,2,144,426,3,1,419,1223,6,275,797,3,69.83333333333333,>30,ENG,Home,Upto 2014
GAR Lock,ENG,Spin,1955-07-21,Leeds,England,1955,2,108,288,2,1,458,1267,15,350,979,13,30.533333333333335,>30,ENG,Home,Upto 2014
GAR Lock,ENG,Spin,1955-08-13,The Oval,England,1955,2,101,330,8,1,308,1166,23,207,836,15,13.391304347826088,<=30,ENG,Home,Upto 2014
GAR Lock,ENG,Spin,1956-06-07,Nottingham,England,1956,2,84,348,4,1,279,1027,11,195,679,7,25.363636363636363,<=30,ENG,Home,Upto 2014
GAR Lock,ENG,Spin,1956-07-12,Leeds,England,1956,2,81,403,7,1,342,1252,22,261,849,15,15.545454545454545,<=30,ENG,Home,Upto 2014
GAR Lock,ENG,Spin,1956-07-26,Manchester,England,1956,2,106,414,1,1,491,1434,26,385,1020,25,18.884615384615383,<=30,ENG,Home,Upto 2014
GAR Lock,ENG,Spin,1956-08-23,The Oval,England,1956,2,66,259,3,1,234,721,10,168,462,7,23.4,<=30,ENG,Home,Upto 2014
GAR Lock,ENG,Spin,1957-03-01,Gqeberha,South Africa,1957,2,38,208,2,1,222,803,10,184,595,8,22.2,<=30,SA,Away,Upto 2014
GAR Lock,ENG,Spin,1957-05-30,Birmingham,England,1957,2,86,370,3,1,809,2558,20,723,2188,17,40.45,>30,ENG,Home,Upto 2014
GAR Lock,ENG,Spin,1957-07-25,Leeds,England,1957,2,29,90,1,1,269,814,12,240,724,11,22.416666666666668,<=30,ENG,Home,Upto 2014
GAR Lock,ENG,Spin,1957-08-22,The Oval,England,1957,2,48,226,11,1,485,1435,24,437,1209,13,20.208333333333332,<=30,ENG,Home,Upto 2014
GAR Lock,ENG,Spin,1958-06-05,Birmingham,England,1958,2,25,63,3,1,161,422,9,136,359,6,17.88888888888889,<=30,ENG,Home,Upto 2014
GAR Lock,ENG,Spin,1958-06-19,Lord's,England,1958,2,29,144,9,1,155,534,16,126,390,7,9.6875,<=30,ENG,Home,Upto 2014
GAR Lock,ENG,Spin,1958-07-03,Leeds,England,1958,2,65,321,11,1,241,963,20,176,642,9,12.05,<=30,ENG,Home,Upto 2014
GAR Lock,ENG,Spin,1958-07-24,Manchester,England,1958,2,96,342,8,1,295,909,16,199,567,8,18.4375,<=30,ENG,Home,Upto 2014
GAR Lock,ENG,Spin,1958-08-21,The Oval,England,1958,2,39,186,3,1,171,485,8,132,299,5,21.375,<=30,ENG,Home,Upto 2014
GAR Lock,ENG,Spin,1958-12-05,Brisbane,Australia,1958,2,54,199,1,1,271,1070,11,217,871,10,24.636363636363637,<=30,AUS,Away,Upto 2014
GAR Lock,ENG,Spin,1958-12-31,Melbourne,Australia,1958,2,65,161,0,1,227,617,2,162,456,2,113.5,>30,AUS,Away,Upto 2014
GAR Lock,ENG,Spin,1959-01-09,Sydney,Australia,1959,2,153,434,4,1,574,1742,24,421,1308,20,23.916666666666668,<=30,AUS,Away,Upto 2014
GAR Lock,ENG,Spin,1959-01-30,Adelaide,Australia,1959,2,104,216,0,1,300,723,9,196,507,9,33.333333333333336,>30,AUS,Away,Upto 2014
GAR Lock,ENG,Spin,1959-02-27,Christchurch,New Zealand,1959,2,84,326,11,1,315,1017,18,231,691,7,17.5,<=30,NZ,Away,Upto 2014
GAR Lock,ENG,Spin,1959-03-14,Auckland,New Zealand,1959,1,29,123,2,1,206,465,5,177,342,3,41.2,>30,NZ,Away,Upto 2014
GAR Lock,ENG,Spin,1961-06-22,Lord's,England,1961,1,48,156,0,1,96,339,2,48,183,2,48.0,>30,ENG,Home,Upto 2014
GAR Lock,ENG,Spin,1961-07-06,Leeds,England,1961,2,100,234,2,1,330,840,7,230,606,5,47.142857142857146,>30,ENG,Home,Upto 2014
GAR Lock,ENG,Spin,1961-08-17,The Oval,England,1961,1,102,252,1,1,415,906,9,313,654,8,46.111111111111114,>30,ENG,Home,Upto 2014
GAR Lock,ENG,Spin,1961-11-11,Brabourne,India,1961,2,107,366,5,1,727,1890,18,620,1524,13,40.388888888888886,>30,IND,Away,Upto 2014
GAR Lock,ENG,Spin,1961-12-01,Kanpur,India,1961,1,93,264,3,1,792,2016,16,699,1752,13,49.5,>30,IND,Away,Upto 2014
GAR Lock,ENG,Spin,1961-12-13,Delhi,India,1961,1,83,240,1,1,505,1242,8,422,1002,7,63.125,>30,IND,Away,Upto 2014
GAR Lock,ENG,Spin,1961-12-30,Eden Gardens,India,1961,2,174,492,6,1,632,1788,29,458,1296,23,21.79310344827586,<=30,IND,Away,Upto 2014
GAR Lock,ENG,Spin,1962-01-10,Chennai,India,1962,2,171,477,7,1,866,2320,33,695,1843,26,26.242424242424242,<=30,IND,Away,Upto 2014
GAR Lock,ENG,Spin,1962-01-19,Dhaka,Bangladesh,1962,2,225,690,8,1,862,2494,25,637,1804,17,34.48,>30,BAN,Away,Upto 2014
GAR Lock,ENG,Spin,1962-02-02,Karachi,Pakistan,1962,2,111,306,2,1,769,2063,17,658,1757,15,45.23529411764706,>30,PAK,Away,Upto 2014
GAR Lock,ENG,Spin,1962-05-31,Birmingham,England,1962,2,117,330,5,1,664,1386,13,547,1056,8,51.07692307692308,>30,ENG,Home,Upto 2014
GAR Lock,ENG,Spin,1962-06-21,Lord's,England,1962,1,78,84,0,1,359,496,6,281,412,6,59.833333333333336,>30,ENG,Home,Upto 2014
GAR Lock,ENG,Spin,1962-07-26,Nottingham,England,1962,2,46,174,1,1,232,572,3,186,398,2,77.33333333333333,>30,ENG,Home,Upto 2014
GAR Lock,ENG,Spin,1963-07-04,Birmingham,England,1963,1,5,12,0,1,265,746,12,260,734,12,22.083333333333332,<=30,ENG,Home,Upto 2014
GAR Lock,ENG,Spin,1963-07-25,Leeds,England,1963,2,108,215,4,1,443,1017,19,335,802,15,23.31578947368421,<=30,ENG,Home,Upto 2014
GAR Lock,ENG,Spin,1963-08-22,The Oval,England,1963,2,117,324,2,1,379,930,8,262,606,6,47.375,>30,ENG,Home,Upto 2014
GAR Lock,ENG,Spin,1968-03-14,Port of Spain,West Indies,1968,1,129,192,1,1,721,1580,15,592,1388,14,48.06666666666667,>30,WI,Away,Upto 2014
GAR Lock,ENG,Spin,1968-03-28,Georgetown,West Indies,1968,2,83,222,3,1,621,1884,22,538,1662,19,28.227272727272727,<=30,WI,Away,Upto 2014
GB Brent,ZIM,Pace,1999-11-18,Bulawayo,Zimbabwe,1999,1,55,192,2,1,569,1220,18,514,1028,16,31.61111111111111,>30,ZIM,Home,Upto 2014
GB Brent,ZIM,Pace,1999-11-26,Harare,Zimbabwe,1999,2,89,176,3,1,681,1742,19,592,1566,16,35.8421052631579,>30,ZIM,Home,Upto 2014
GB Brent,ZIM,Pace,2001-11-15,Chattogram,Bangladesh,2001,2,88,252,1,1,536,1126,10,448,874,9,53.6,>30,BAN,Away,Upto 2014
GB Brent,ZIM,Pace,2001-12-27,Colombo (SSC),Sri Lanka,2001,1,82,198,1,1,677,1297,14,595,1099,13,48.357142857142854,>30,SL,Away,Upto 2014
GB Hogg,AUS,Spin,1996-10-10,Delhi,India,1996,1,69,102,1,1,528,1278,19,459,1176,18,27.789473684210527,<=30,IND,Away,Upto 2014
GB Hogg,AUS,Spin,2003-04-10,Georgetown,West Indies,2003,2,108,138,3,1,403,631,9,295,493,6,44.77777777777778,>30,WI,Away,Upto 2014
GB Hogg,AUS,Spin,2003-04-19,Port of Spain,West Indies,2003,2,156,210,2,1,510,828,7,354,618,5,72.85714285714286,>30,WI,Away,Upto 2014
GB Hogg,AUS,Spin,2003-10-17,Sydney,Australia,2003,2,119,324,3,1,468,933,15,349,609,12,31.2,>30,AUS,Home,Upto 2014
GB Hogg,AUS,Spin,2007-12-26,Melbourne,Australia,2007,2,133,228,4,1,518,912,15,385,684,11,34.53333333333333,>30,AUS,Home,Upto 2014
GB Hogg,AUS,Spin,2008-01-02,Sydney,Australia,2008,2,176,264,2,1,764,1280,20,588,1016,18,38.2,>30,AUS,Home,Upto 2014
GB Hogg,AUS,Spin,2008-01-24,Adelaide,Australia,2008,2,172,258,2,1,579,1086,9,407,828,7,64.33333333333333,>30,AUS,Home,Upto 2014
GB Hole,AUS,Spin,1951-02-23,Melbourne,Australia,1951,2,13,48,1,1,462,1120,13,449,1072,12,35.53846153846154,>30,AUS,Home,Upto 2014
GB Hole,AUS,Spin,1951-11-09,Brisbane,Australia,1951,1,3,8,0,1,714,1815,27,711,1807,27,26.444444444444443,<=30,AUS,Home,Upto 2014
GB Hole,AUS,Spin,1951-11-30,Sydney,Australia,1951,1,9,32,1,1,842,1964,19,833,1932,18,44.31578947368421,>30,AUS,Home,Upto 2014
GB Hole,AUS,Spin,1951-12-31,Melbourne,Australia,1951,1,6,16,0,1,557,1523,18,551,1507,18,30.944444444444443,>30,AUS,Home,Upto 2014
GB Hole,AUS,Spin,1952-12-05,Brisbane,Australia,1952,1,5,24,0,1,592,1609,17,587,1585,17,34.8235294117647,>30,AUS,Home,Upto 2014
GB Hole,AUS,Spin,1952-12-24,Melbourne,Australia,1952,1,24,56,0,1,730,1899,24,706,1843,24,30.416666666666668,>30,AUS,Home,Upto 2014
GB Hole,AUS,Spin,1953-01-09,Sydney,Australia,1953,1,11,16,0,1,515,1280,12,504,1264,12,42.916666666666664,>30,AUS,Home,Upto 2014
GB Hole,AUS,Spin,1953-01-24,Adelaide,Australia,1953,2,22,96,1,1,857,2379,23,835,2283,22,37.26086956521739,>30,AUS,Home,Upto 2014
GB Hole,AUS,Spin,1953-06-25,Lord's,England,1953,1,0,6,0,1,753,1644,18,753,1638,18,41.833333333333336,>30,ENG,Away,Upto 2014
GB Hole,AUS,Spin,1953-07-09,Manchester,England,1953,1,16,12,0,1,250,603,14,234,591,14,17.857142857142858,<=30,ENG,Away,Upto 2014
GB Hole,AUS,Spin,1953-07-23,Leeds,England,1953,1,6,18,0,1,195,432,3,189,414,3,65.0,>30,ENG,Away,Upto 2014
GB Hole,AUS,Spin,1953-08-15,The Oval,England,1953,1,11,66,0,1,335,826,14,324,760,14,23.928571428571427,<=30,ENG,Away,Upto 2014
GB Lawrence,SA,Pace,1961-12-08,Durban,South Africa,1961,2,103,324,3,1,481,1242,23,378,918,20,20.91304347826087,<=30,SA,Home,Upto 2014
GB Lawrence,SA,Pace,1961-12-26,Johannesburg,South Africa,1961,2,98,315,9,1,549,1269,21,451,954,12,26.142857142857142,<=30,SA,Home,Upto 2014
GB Lawrence,SA,Pace,1962-01-01,Cape Town,South Africa,1962,1,46,138,1,1,494,1176,15,448,1038,14,32.93333333333333,>30,SA,Home,Upto 2014
GB Lawrence,SA,Pace,1962-02-02,Johannesburg,South Africa,1962,2,109,231,9,1,533,1091,23,424,860,14,23.17391304347826,<=30,SA,Home,Upto 2014
GB Lawrence,SA,Pace,1962-02-16,Gqeberha,South Africa,1962,2,156,326,6,1,563,1365,25,407,1039,19,22.52,<=30,SA,Home,Upto 2014
GB Legge,ENG,Spin,1930-02-14,Auckland,New Zealand,1930,1,34,30,0,1,274,396,3,240,366,3,91.33333333333333,>30,NZ,Away,Upto 2014
GB Stevenson,ENG,Pace,1980-02-15,Wankhede,India,1980,2,72,114,2,1,555,1195,28,483,1081,26,19.821428571428573,<=30,IND,Away,Upto 2014
GB Stevenson,ENG,Pace,1981-03-27,St John's,West Indies,1981,1,111,198,3,1,702,1430,20,591,1232,17,35.1,>30,WI,Away,Upto 2014
GB Troup,NZ,Pace,1976-11-18,Kanpur,India,1976,2,116,180,1,1,425,720,6,309,540,5,70.83333333333333,>30,IND,Away,Upto 2014
GB Troup,NZ,Pace,1979-02-16,Napier,New Zealand,1979,2,111,309,1,1,699,1749,19,588,1440,18,36.78947368421053,>30,NZ,Home,Upto 2014
GB Troup,NZ,Pace,1979-02-23,Auckland,New Zealand,1979,1,70,176,2,1,754,1863,27,684,1687,25,27.925925925925927,<=30,NZ,Home,Upto 2014
GB Troup,NZ,Pace,1980-02-08,Dunedin,New Zealand,1980,2,83,322,5,1,533,1670,35,450,1348,30,15.228571428571428,<=30,NZ,Home,Upto 2014
GB Troup,NZ,Pace,1980-02-22,Christchurch,New Zealand,1980,2,122,288,3,1,946,1857,20,824,1569,17,47.3,>30,NZ,Home,Upto 2014
GB Troup,NZ,Pace,1980-02-29,Auckland,New Zealand,1980,2,166,363,10,1,786,1985,29,620,1622,19,27.103448275862068,<=30,NZ,Home,Upto 2014
GB Troup,NZ,Pace,1980-12-12,W.A.C.A,Australia,1980,2,58,138,1,1,516,1220,27,458,1082,26,19.11111111111111,<=30,AUS,Away,Upto 2014
GB Troup,NZ,Pace,1980-12-26,Melbourne,Australia,1980,2,85,222,1,1,683,1801,29,598,1579,28,23.551724137931036,<=30,AUS,Away,Upto 2014
GB Troup,NZ,Pace,1981-02-21,Wellington,New Zealand,1981,2,77,180,5,1,725,1705,33,648,1525,28,21.96969696969697,<=30,NZ,Home,Upto 2014
GB Troup,NZ,Pace,1981-03-06,Christchurch,New Zealand,1981,1,60,156,0,1,349,1020,11,289,864,11,31.727272727272727,>30,NZ,Home,Upto 2014
GB Troup,NZ,Pace,1982-03-12,Auckland,New Zealand,1982,2,113,201,4,1,673,1668,23,560,1467,19,29.26086956521739,<=30,NZ,Home,Upto 2014
GB Troup,NZ,Pace,1982-03-19,Christchurch,New Zealand,1982,1,53,66,1,1,665,1336,24,612,1270,23,27.708333333333332,<=30,NZ,Home,Upto 2014
GB Troup,NZ,Pace,1985-05-04,Kingston,West Indies,1985,2,100,120,2,1,691,1483,26,591,1363,24,26.576923076923077,<=30,WI,Away,Upto 2014
GB Troup,NZ,Pace,1986-02-21,Wellington,New Zealand,1986,1,86,168,2,1,687,1390,14,601,1222,12,49.07142857142857,>30,NZ,Home,Upto 2014
GB Troup,NZ,Pace,1986-02-28,Christchurch,New Zealand,1986,2,154,294,1,1,712,1681,22,558,1387,21,32.36363636363637,>30,NZ,Home,Upto 2014
GC Grant,WI,Pace,1931-01-16,Brisbane,Australia,1931,1,1,6,0,1,443,984,16,442,978,16,27.6875,<=30,AUS,Away,Upto 2014
GC Grant,WI,Pace,1933-07-22,Manchester,England,1933,1,12,12,0,1,416,958,13,404,946,13,32.0,>30,ENG,Away,Upto 2014
GC Grant,WI,Pace,1935-03-14,Kingston,West Indies,1935,1,5,6,0,1,412,902,15,407,896,15,27.466666666666665,<=30,WI,Home,Upto 2014
GC Shillingford,WI,Pace,1969-06-26,Lord's,England,1969,2,83,192,4,1,864,2111,25,781,1919,21,34.56,>30,ENG,Away,Upto 2014
GC Shillingford,WI,Pace,1969-07-10,Leeds,England,1969,2,77,166,2,1,581,1581,25,504,1415,23,23.24,<=30,ENG,Away,Upto 2014
GC Shillingford,WI,Pace,1971-02-18,Kingston,West Indies,1971,1,70,156,2,1,178,430,6,108,274,4,29.666666666666668,<=30,WI,Home,Upto 2014
GC Shillingford,WI,Pace,1971-03-06,Port of Spain,West Indies,1971,2,58,156,1,1,181,456,3,123,300,2,60.333333333333336,>30,WI,Home,Upto 2014
GC Shillingford,WI,Pace,1971-03-19,Georgetown,West Indies,1971,2,89,138,1,1,313,504,3,224,366,2,104.33333333333333,>30,WI,Home,Upto 2014
GC Shillingford,WI,Pace,1972-02-16,Kingston,West Indies,1972,2,95,227,3,1,643,1221,11,548,994,8,58.45454545454545,>30,WI,Home,Upto 2014
GC Shillingford,WI,Pace,1972-03-23,Bridgetown,West Indies,1972,1,65,146,2,1,605,1337,20,540,1191,18,30.25,>30,WI,Home,Upto 2014
GC Small,ENG,Pace,1986-08-07,Nottingham,England,1986,2,98,276,4,1,656,1476,21,558,1200,17,31.238095238095237,>30,ENG,Home,Upto 2014
GC Small,ENG,Pace,1986-08-21,The Oval,England,1986,1,36,108,0,1,479,811,12,443,703,12,39.916666666666664,>30,ENG,Home,Upto 2014
GC Small,ENG,Pace,1986-12-26,Melbourne,Australia,1986,2,88,226,7,1,497,1065,22,409,839,15,22.59090909090909,<=30,AUS,Away,Upto 2014
GC Small,ENG,Pace,1987-01-10,Sydney,Australia,1987,2,92,246,5,1,483,1157,14,391,911,9,34.5,>30,AUS,Away,Upto 2014
GC Small,ENG,Pace,1988-06-16,Lord's,England,1988,2,140,227,4,1,943,1804,37,803,1577,33,25.486486486486488,<=30,ENG,Home,Upto 2014
GC Small,ENG,Pace,1989-08-24,The Oval,England,1989,2,198,360,4,1,921,1691,26,723,1331,22,35.42307692307692,>30,ENG,Home,Upto 2014
GC Small,ENG,Pace,1990-02-24,Kingston,West Indies,1990,2,102,222,5,1,668,1460,29,566,1238,24,23.03448275862069,<=30,WI,Away,Upto 2014
GC Small,ENG,Pace,1990-03-23,Port of Spain,West Indies,1990,2,97,228,3,1,773,1811,34,676,1583,31,22.735294117647058,<=30,WI,Away,Upto 2014
GC Small,ENG,Pace,1990-04-05,Bridgetown,West Indies,1990,2,183,330,8,1,1177,2232,37,994,1902,29,31.81081081081081,>30,WI,Away,Upto 2014
GC Small,ENG,Pace,1990-04-12,St John's,West Indies,1990,1,123,186,1,1,830,1554,26,707,1368,25,31.923076923076923,>30,WI,Away,Upto 2014
GC Small,ENG,Pace,1990-06-07,Nottingham,England,1990,2,63,210,3,1,425,1056,17,362,846,14,25.0,<=30,ENG,Home,Upto 2014
GC Small,ENG,Pace,1990-06-21,Lord's,England,1990,1,127,210,1,1,748,1364,15,621,1154,14,49.86666666666667,>30,ENG,Home,Upto 2014
GC Small,ENG,Pace,1990-07-05,Birmingham,England,1990,2,100,204,1,1,730,1539,27,630,1335,26,27.037037037037038,<=30,ENG,Home,Upto 2014
GC Small,ENG,Pace,1990-11-23,Brisbane,Australia,1990,2,70,186,3,1,544,1327,29,474,1141,26,18.75862068965517,<=30,AUS,Away,Upto 2014
GC Small,ENG,Pace,1991-01-04,Sydney,Australia,1991,2,109,198,1,1,621,1201,14,512,1003,13,44.357142857142854,>30,AUS,Away,Upto 2014
GC Small,ENG,Pace,1991-01-25,Adelaide,Australia,1991,2,156,312,3,1,1030,2159,28,874,1847,25,36.785714285714285,>30,AUS,Away,Upto 2014
GC Small,ENG,Pace,1991-02-01,W.A.C.A,Australia,1991,2,89,198,2,1,771,1442,29,682,1244,27,26.586206896551722,<=30,AUS,Away,Upto 2014
GC Smith,SA,Spin,2002-11-15,Centurion,South Africa,2002,1,12,24,0,1,191,489,4,179,465,4,47.75,>30,SA,Home,Upto 2014
GC Smith,SA,Spin,2003-04-24,Chattogram,Bangladesh,2003,1,9,30,1,1,336,618,11,327,588,10,30.545454545454547,>30,BAN,Away,Upto 2014
GC Smith,SA,Spin,2003-05-01,Dhaka,Bangladesh,2003,1,19,42,0,1,312,727,15,293,685,15,20.8,<=30,BAN,Away,Upto 2014
GC Smith,SA,Spin,2003-10-17,Lahore,Pakistan,2003,2,27,79,1,1,515,1054,21,488,975,20,24.523809523809526,<=30,PAK,Away,Upto 2014
GC Smith,SA,Spin,2003-10-24,Faisalabad,Pakistan,2003,2,37,30,0,1,613,1195,9,576,1165,9,68.11111111111111,>30,PAK,Away,Upto 2014
GC Smith,SA,Spin,2003-12-12,Johannesburg,South Africa,2003,1,17,24,0,1,214,258,1,197,234,1,214.0,>30,SA,Home,Upto 2014
GC Smith,SA,Spin,2004-01-16,Centurion,South Africa,2004,2,31,70,0,1,187,304,2,156,234,2,93.5,>30,SA,Home,Upto 2014
GC Smith,SA,Spin,2004-03-10,Hamilton,New Zealand,2004,1,14,12,0,1,513,956,8,499,944,8,64.125,>30,NZ,Away,Upto 2014
GC Smith,SA,Spin,2004-03-18,Auckland,New Zealand,2004,1,19,30,1,1,247,374,2,228,344,1,123.5,>30,NZ,Away,Upto 2014
GC Smith,SA,Spin,2004-08-11,Colombo (SSC),Sri Lanka,2004,1,15,24,0,1,470,988,13,455,964,13,36.15384615384615,>30,SL,Away,Upto 2014
GC Smith,SA,Spin,2004-11-28,Eden Gardens,India,2004,1,16,42,0,1,470,978,15,454,936,15,31.333333333333332,>30,IND,Away,Upto 2014
GC Smith,SA,Spin,2004-12-17,Gqeberha,South Africa,2004,2,64,108,1,1,172,364,5,108,256,4,34.4,>30,SA,Home,Upto 2014
GC Smith,SA,Spin,2004-12-26,Durban,South Africa,2004,1,27,30,1,1,324,528,5,297,498,4,64.8,>30,SA,Home,Upto 2014
GC Smith,SA,Spin,2005-01-02,Cape Town,South Africa,2005,1,11,12,0,1,243,528,7,232,516,7,34.714285714285715,>30,SA,Home,Upto 2014
GC Smith,SA,Spin,2005-01-21,Centurion,South Africa,2005,2,19,66,0,1,140,288,1,121,222,1,140.0,>30,SA,Home,Upto 2014
GC Smith,SA,Spin,2005-03-11,Centurion,South Africa,2005,1,39,42,0,1,252,431,4,213,389,4,63.0,>30,SA,Home,Upto 2014
GC Smith,SA,Spin,2005-03-31,Georgetown,West Indies,2005,1,50,60,0,1,281,750,4,231,690,4,70.25,>30,WI,Away,Upto 2014
GC Smith,SA,Spin,2005-04-08,Port of Spain,West Indies,2005,1,9,42,0,1,187,617,7,178,575,7,26.714285714285715,<=30,WI,Away,Upto 2014
GC Smith,SA,Spin,2005-04-21,Bridgetown,West Indies,2005,2,31,60,0,1,288,498,4,257,438,4,72.0,>30,WI,Away,Upto 2014
GC Smith,SA,Spin,2005-04-29,St John's,West Indies,2005,1,145,258,2,1,410,840,3,265,582,1,136.66666666666666,>30,WI,Away,Upto 2014
GC Smith,SA,Spin,2005-12-26,Melbourne,Australia,2005,1,41,42,1,1,426,859,14,385,817,13,30.428571428571427,>30,AUS,Away,Upto 2014
GC Smith,SA,Spin,2006-04-15,Centurion,South Africa,2006,1,11,18,0,1,126,259,2,115,241,2,63.0,>30,SA,Home,Upto 2014
GC Smith,SA,Spin,2006-04-27,Cape Town,South Africa,2006,1,61,102,0,1,434,954,6,373,852,6,72.33333333333333,>30,SA,Home,Upto 2014
GC Smith,SA,Spin,2006-12-15,Johannesburg,South Africa,2006,1,26,18,0,1,82,150,5,56,132,5,16.4,<=30,SA,Home,Upto 2014
GC Smith,SA,Spin,2007-10-01,Karachi,Pakistan,2007,2,51,54,0,1,692,1416,21,641,1362,21,32.95238095238095,>30,PAK,Away,Upto 2014
GC Smith,SA,Spin,2010-06-10,Port of Spain,West Indies,2010,1,4,3,0,1,480,983,16,476,980,16,30.0,<=30,WI,Away,Upto 2014
GC Smith,SA,Spin,2011-01-02,Cape Town,South Africa,2011,1,27,24,0,1,346,804,9,319,780,9,38.44444444444444,>30,SA,Home,Upto 2014
GC Smith,SA,Spin,2012-01-03,Cape Town,South Africa,2012,1,7,12,0,1,307,606,6,300,594,6,51.166666666666664,>30,SA,Home,Upto 2014
GC Smith,SA,Spin,2012-11-09,Brisbane,Australia,2012,1,36,54,0,1,246,390,4,210,336,4,61.5,>30,AUS,Away,Upto 2014
GC Smith,SA,Spin,2013-01-11,Gqeberha,South Africa,2013,1,10,6,0,1,217,449,5,207,443,5,43.4,>30,SA,Home,Upto 2014
GC Tonge,WI,Pace,2009-12-16,W.A.C.A,Australia,2009,2,113,168,1,1,927,1486,27,814,1318,26,34.333333333333336,>30,AUS,Away,Upto 2014
GC Viljoen,SA,Pace,2016-01-14,Johannesburg,South Africa,2016,2,94,114,1,1,692,1271,29,598,1157,28,23.862068965517242,<=30,SA,Home,After 1965
GC White,SA,Spin,1906-01-02,Johannesburg,South Africa,1906,2,28,54,2,1,455,1132,23,427,1078,21,19.782608695652176,<=30,SA,Home,Upto 2014
GC White,SA,Spin,1906-03-10,Johannesburg,South Africa,1906,1,2,12,0,1,622,1254,10,620,1242,10,62.2,>30,SA,Home,Upto 2014
GC White,SA,Spin,1907-07-01,Lord's,England,1907,1,52,90,0,1,478,962,15,426,872,15,31.866666666666667,>30,ENG,Away,Upto 2014
GC White,SA,Spin,1907-07-29,Leeds,England,1907,1,47,96,4,1,289,661,31,242,565,27,9.32258064516129,<=30,ENG,Away,Upto 2014
GC White,SA,Spin,1907-08-19,The Oval,England,1907,1,28,54,0,1,462,1059,21,434,1005,21,22.0,<=30,ENG,Away,Upto 2014
GC White,SA,Spin,1910-01-01,Johannesburg,South Africa,1910,2,48,42,0,1,593,1077,29,545,1035,29,20.448275862068964,<=30,SA,Home,Upto 2014
GC White,SA,Spin,1910-01-21,Durban,South Africa,1910,2,19,60,0,1,565,1312,24,546,1252,24,23.541666666666668,<=30,SA,Home,Upto 2014
GC White,SA,Spin,1910-02-26,Johannesburg,South Africa,1910,1,28,24,0,1,662,1226,24,634,1202,24,27.583333333333332,<=30,SA,Home,Upto 2014
GC White,SA,Spin,1910-03-07,Cape Town,South Africa,1910,2,20,30,2,1,379,765,17,359,735,15,22.294117647058822,<=30,SA,Home,Upto 2014
GC White,SA,Spin,1912-05-27,Manchester,England,1912,1,29,36,1,1,525,1035,18,496,999,17,29.166666666666668,<=30,ENG,Away,Upto 2014
GD Campbell,AUS,Pace,1989-06-08,Leeds,England,1989,2,124,144,1,1,1372,2385,30,1248,2241,29,45.733333333333334,>30,ENG,Away,Upto 2014
GD Campbell,AUS,Pace,1989-12-16,Hobart,Australia,1989,2,143,336,5,1,998,1920,27,855,1584,22,36.96296296296296,>30,AUS,Home,Upto 2014
GD Campbell,AUS,Pace,1990-01-19,Adelaide,Australia,1990,2,162,303,4,1,759,1677,27,597,1374,23,28.11111111111111,<=30,AUS,Home,Upto 2014
GD Campbell,AUS,Pace,1990-03-15,Wellington,New Zealand,1990,2,74,168,3,1,504,1412,21,430,1244,18,24.0,<=30,NZ,Away,Upto 2014
GD Elliott,NZ,Pace,2008-03-22,Napier,New Zealand,2008,2,85,144,1,1,793,1402,23,708,1258,22,34.47826086956522,>30,NZ,Home,Upto 2014
GD Elliott,NZ,Pace,2008-11-20,Brisbane,Australia,2008,2,44,96,1,1,700,1373,36,656,1277,35,19.444444444444443,<=30,AUS,Away,Upto 2014
GD Elliott,NZ,Pace,2009-11-24,Dunedin,New Zealand,2009,1,3,12,0,1,862,1655,33,859,1643,33,26.12121212121212,<=30,NZ,Home,Upto 2014
GD Elliott,NZ,Pace,2009-12-03,Wellington,New Zealand,2009,1,8,30,2,1,635,1257,30,627,1227,28,21.166666666666668,<=30,NZ,Home,Upto 2014
GD McGrath,AUS,Pace,1993-11-12,W.A.C.A,Australia,1993,2,142,330,3,1,942,1817,19,800,1487,16,49.578947368421055,>30,AUS,Home,Upto 2014
GD McGrath,AUS,Pace,1993-12-03,Brisbane,Australia,1993,2,111,246,3,1,683,1440,13,572,1194,10,52.53846153846154,>30,AUS,Home,Upto 2014
GD McGrath,AUS,Pace,1994-01-02,Sydney,Australia,1994,2,62,198,2,1,459,1326,25,397,1128,23,18.36,<=30,AUS,Home,Upto 2014
GD McGrath,AUS,Pace,1994-03-17,Cape Town,South Africa,1994,2,91,253,4,1,830,1910,22,739,1657,18,37.72727272727273,>30,SA,Away,Upto 2014
GD McGrath,AUS,Pace,1994-03-25,Durban,South Africa,1994,1,78,246,0,1,810,2116,20,732,1870,20,40.5,>30,SA,Away,Upto 2014
GD McGrath,AUS,Pace,1994-09-28,Karachi,Pakistan,1994,2,88,186,2,1,553,1041,23,465,855,21,24.043478260869566,<=30,PAK,Away,Upto 2014
GD McGrath,AUS,Pace,1994-11-01,Lahore,Pakistan,1994,2,157,295,5,1,516,907,10,359,612,5,51.6,>30,PAK,Away,Upto 2014
GD McGrath,AUS,Pace,1994-11-25,Brisbane,Australia,1994,2,101,174,0,1,726,1262,21,625,1088,21,34.57142857142857,>30,AUS,Home,Upto 2014
GD McGrath,AUS,Pace,1995-02-03,W.A.C.A,Australia,1995,2,128,228,6,1,946,1817,29,818,1589,23,32.62068965517241,>30,AUS,Home,Upto 2014
GD McGrath,AUS,Pace,1995-03-31,Bridgetown,West Indies,1995,2,114,205,8,1,554,1046,24,440,841,16,23.083333333333332,<=30,WI,Away,Upto 2014
GD McGrath,AUS,Pace,1995-04-08,St John's,West Indies,1995,2,79,157,1,1,658,1384,24,579,1227,23,27.416666666666668,<=30,WI,Away,Upto 2014
GD McGrath,AUS,Pace,1995-04-21,Port of Spain,West Indies,1995,2,69,167,6,1,399,876,29,330,709,23,13.758620689655173,<=30,WI,Away,Upto 2014
GD McGrath,AUS,Pace,1995-04-29,Kingston,West Indies,1995,2,107,198,2,1,658,1221,21,551,1023,19,31.333333333333332,>30,WI,Away,Upto 2014
GD McGrath,AUS,Pace,1995-11-09,Brisbane,Australia,1995,2,109,234,5,1,520,1074,13,411,840,8,40.0,>30,AUS,Home,Upto 2014
GD McGrath,AUS,Pace,1995-11-17,Hobart,Australia,1995,2,107,261,8,1,693,1398,29,586,1137,21,23.896551724137932,<=30,AUS,Home,Upto 2014
GD McGrath,AUS,Pace,1995-11-30,Sydney,Australia,1995,2,126,236,2,1,445,1017,19,319,781,17,23.42105263157895,<=30,AUS,Home,Upto 2014
GD McGrath,AUS,Pace,1995-12-08,W.A.C.A,Australia,1995,2,167,288,7,1,613,1126,16,446,838,9,38.3125,>30,AUS,Home,Upto 2014
GD McGrath,AUS,Pace,1995-12-26,Melbourne,Australia,1995,2,132,345,7,1,608,1377,17,476,1032,10,35.76470588235294,>30,AUS,Home,Upto 2014
GD McGrath,AUS,Pace,1996-01-25,Adelaide,Australia,1996,2,139,296,7,1,886,1812,32,747,1516,25,27.6875,<=30,AUS,Home,Upto 2014
GD McGrath,AUS,Pace,1996-10-10,Delhi,India,1996,2,86,216,2,1,274,681,13,188,465,11,21.076923076923077,<=30,IND,Away,Upto 2014
GD McGrath,AUS,Pace,1996-11-22,Brisbane,Australia,1996,2,92,305,6,1,925,1944,28,833,1639,22,33.035714285714285,>30,AUS,Home,Upto 2014
GD McGrath,AUS,Pace,1996-11-29,Sydney,Australia,1996,2,118,288,7,1,754,1620,23,636,1332,16,32.78260869565217,>30,AUS,Home,Upto 2014
GD McGrath,AUS,Pace,1996-12-26,Melbourne,Australia,1996,2,91,234,8,1,553,1299,28,462,1065,20,19.75,<=30,AUS,Home,Upto 2014
GD McGrath,AUS,Pace,1997-01-25,Adelaide,Australia,1997,2,52,174,3,1,488,1017,11,436,843,8,44.36363636363637,>30,AUS,Home,Upto 2014
GD McGrath,AUS,Pace,1997-02-01,W.A.C.A,Australia,1997,2,100,204,2,1,699,1242,25,599,1038,23,27.96,<=30,AUS,Home,Upto 2014
GD McGrath,AUS,Pace,1997-02-28,Johannesburg,South Africa,1997,2,94,216,4,1,660,1282,14,566,1066,10,47.142857142857146,>30,SA,Away,Upto 2014
GD McGrath,AUS,Pace,1997-03-14,Gqeberha,South Africa,1997,2,109,210,3,1,528,1387,24,419,1177,21,22.0,<=30,SA,Away,Upto 2014
GD McGrath,AUS,Pace,1997-03-21,Centurion,South Africa,1997,1,86,244,6,1,500,1229,28,414,985,22,17.857142857142858,<=30,SA,Away,Upto 2014
GD McGrath,AUS,Pace,1997-06-05,Birmingham,England,1997,2,149,234,2,1,837,1443,24,688,1209,22,34.875,>30,ENG,Away,Upto 2014
GD McGrath,AUS,Pace,1997-06-19,Lord's,England,1997,2,103,243,9,1,411,849,18,308,606,9,22.833333333333332,<=30,ENG,Away,Upto 2014
GD McGrath,AUS,Pace,1997-07-03,Manchester,England,1997,2,86,268,7,1,664,1429,26,578,1161,19,25.53846153846154,<=30,ENG,Away,Upto 2014
GD McGrath,AUS,Pace,1997-07-24,Leeds,England,1997,2,147,264,4,1,800,1403,28,653,1139,24,28.571428571428573,<=30,ENG,Away,Upto 2014
GD McGrath,AUS,Pace,1997-08-07,Nottingham,England,1997,2,107,262,7,1,974,1617,31,867,1355,24,31.419354838709676,>30,ENG,Away,Upto 2014
GD McGrath,AUS,Pace,1997-08-21,The Oval,England,1997,2,109,228,7,1,435,825,24,326,597,17,18.125,<=30,ENG,Away,Upto 2014
GD McGrath,AUS,Pace,1997-11-07,Brisbane,Australia,1997,2,128,296,7,1,809,1711,25,681,1415,18,32.36,>30,AUS,Home,Upto 2014
GD McGrath,AUS,Pace,1997-12-26,Melbourne,Australia,1997,2,77,270,2,1,627,1621,23,550,1351,21,27.26086956521739,<=30,AUS,Home,Upto 2014
GD McGrath,AUS,Pace,1998-01-02,Sydney,Australia,1998,2,59,150,2,1,405,1054,13,346,904,11,31.153846153846153,>30,AUS,Home,Upto 2014
GD McGrath,AUS,Pace,1998-10-01,Rawalpindi,Pakistan,1998,2,107,251,4,1,337,761,10,230,510,6,33.7,>30,PAK,Away,Upto 2014
GD McGrath,AUS,Pace,1998-10-15,Peshawar,Pakistan,1998,1,131,216,3,1,690,1183,11,559,967,8,62.72727272727273,>30,PAK,Away,Upto 2014
GD McGrath,AUS,Pace,1998-10-22,Karachi,Pakistan,1998,2,106,258,5,1,309,770,9,203,512,4,34.333333333333336,>30,PAK,Away,Upto 2014
GD McGrath,AUS,Pace,1998-11-20,Brisbane,Australia,1998,2,115,302,7,1,919,1808,20,804,1506,13,45.95,>30,AUS,Home,Upto 2014
GD McGrath,AUS,Pace,1998-11-28,W.A.C.A,Australia,1998,2,84,252,3,1,564,1246,31,480,994,28,18.193548387096776,<=30,AUS,Home,Upto 2014
GD McGrath,AUS,Pace,1998-12-11,Adelaide,Australia,1998,2,98,210,6,1,622,1222,21,524,1012,15,29.61904761904762,<=30,AUS,Home,Upto 2014
GD McGrath,AUS,Pace,1998-12-26,Melbourne,Australia,1998,2,120,254,5,1,840,1515,33,720,1261,28,25.454545454545453,<=30,AUS,Home,Upto 2014
GD McGrath,AUS,Pace,1999-01-02,Sydney,Australia,1999,2,75,162,3,1,361,687,17,286,525,14,21.235294117647058,<=30,AUS,Home,Upto 2014
GD McGrath,AUS,Pace,1999-03-05,Port of Spain,West Indies,1999,2,78,144,10,1,566,1392,32,488,1248,22,17.6875,<=30,WI,Away,Upto 2014
GD McGrath,AUS,Pace,1999-03-13,Kingston,West Indies,1999,2,96,213,5,1,494,1032,18,398,819,13,27.444444444444443,<=30,WI,Away,Upto 2014
GD McGrath,AUS,Pace,1999-03-26,Bridgetown,West Indies,1999,2,220,462,9,1,815,1748,29,595,1286,20,28.103448275862068,<=30,WI,Away,Upto 2014
GD McGrath,AUS,Pace,1999-04-03,St John's,West Indies,1999,2,114,379,6,1,621,1546,25,507,1167,19,24.84,<=30,WI,Away,Upto 2014
GD McGrath,AUS,Pace,1999-09-09,Kandy,Sri Lanka,1999,2,85,150,2,1,252,546,11,167,396,9,22.90909090909091,<=30,SL,Away,Upto 2014
GD McGrath,AUS,Pace,1999-09-22,Galle,Sri Lanka,1999,2,104,203,3,1,252,497,5,148,294,2,50.4,>30,SL,Away,Upto 2014
GD McGrath,AUS,Pace,1999-09-30,Colombo (SSC),Sri Lanka,1999,1,25,60,1,1,116,297,8,91,237,7,14.5,<=30,SL,Away,Upto 2014
GD McGrath,AUS,Pace,1999-10-14,Harare,Zimbabwe,1999,2,90,324,6,1,535,1322,16,445,998,10,33.4375,>30,ZIM,Away,Upto 2014
GD McGrath,AUS,Pace,1999-11-05,Brisbane,Australia,1999,2,179,294,4,1,895,1510,23,716,1216,19,38.91304347826087,>30,AUS,Home,Upto 2014
GD McGrath,AUS,Pace,1999-11-18,Hobart,Australia,1999,2,121,270,3,1,857,1577,19,736,1307,16,45.10526315789474,>30,AUS,Home,Upto 2014
GD McGrath,AUS,Pace,1999-11-26,W.A.C.A,Australia,1999,2,93,240,7,1,717,1143,27,624,903,20,26.555555555555557,<=30,AUS,Home,Upto 2014
GD McGrath,AUS,Pace,1999-12-10,Adelaide,Australia,1999,2,84,252,5,1,755,1459,27,671,1207,22,27.962962962962962,<=30,AUS,Home,Upto 2014
GD McGrath,AUS,Pace,1999-12-26,Melbourne,Australia,1999,2,61,211,3,1,715,1451,26,654,1240,23,27.5,<=30,AUS,Home,Upto 2014
GD McGrath,AUS,Pace,2000-01-02,Sydney,Australia,2000,2,103,215,10,1,643,1127,22,540,912,12,29.227272727272727,<=30,AUS,Home,Upto 2014
GD McGrath,AUS,Pace,2000-03-11,Auckland,New Zealand,2000,2,66,205,5,1,234,565,12,168,360,7,19.5,<=30,NZ,Away,Upto 2014
GD McGrath,AUS,Pace,2000-03-24,Wellington,New Zealand,2000,2,95,236,1,1,802,1476,20,707,1240,19,40.1,>30,NZ,Away,Upto 2014
GD McGrath,AUS,Pace,2000-03-31,Hamilton,New Zealand,2000,2,108,251,6,1,633,1061,24,525,810,18,26.375,<=30,NZ,Away,Upto 2014
GD McGrath,AUS,Pace,2000-11-23,Brisbane,Australia,2000,2,27,198,10,1,456,1175,24,429,977,14,19.0,<=30,AUS,Home,Upto 2014
GD McGrath,AUS,Pace,2000-12-01,W.A.C.A,Australia,2000,2,74,222,4,1,637,1158,23,563,936,19,27.695652173913043,<=30,AUS,Home,Upto 2014
GD McGrath,AUS,Pace,2000-12-15,Adelaide,Australia,2000,2,110,275,3,1,620,1329,20,510,1054,17,31.0,>30,AUS,Home,Upto 2014
GD McGrath,AUS,Pace,2000-12-26,Melbourne,Australia,2000,2,25,150,0,1,686,1407,27,661,1257,27,25.40740740740741,<=30,AUS,Home,Upto 2014
GD McGrath,AUS,Pace,2001-01-02,Sydney,Australia,2001,2,123,258,4,1,570,1068,13,447,810,9,43.84615384615385,>30,AUS,Home,Upto 2014
GD McGrath,AUS,Pace,2001-02-27,Wankhede,India,2001,2,44,217,5,1,373,790,15,329,573,10,24.866666666666667,<=30,IND,Away,Upto 2014
GD McGrath,AUS,Pace,2001-03-11,Eden Gardens,India,2001,2,121,318,7,1,800,1488,16,679,1170,9,50.0,>30,IND,Away,Upto 2014
GD McGrath,AUS,Pace,2001-03-18,Chennai,India,2001,2,96,283,5,1,331,733,10,235,450,5,33.1,>30,IND,Away,Upto 2014
GD McGrath,AUS,Pace,2001-07-05,Birmingham,England,2001,2,101,183,4,1,685,933,19,584,750,15,36.05263157894737,>30,ENG,Away,Upto 2014
GD McGrath,AUS,Pace,2001-07-19,Lord's,England,2001,2,114,258,8,1,636,1130,28,522,872,20,22.714285714285715,<=30,ENG,Away,Upto 2014
GD McGrath,AUS,Pace,2001-08-02,Nottingham,England,2001,2,80,174,5,1,583,930,24,503,756,19,24.291666666666668,<=30,ENG,Away,Upto 2014
GD McGrath,AUS,Pace,2001-08-16,Leeds,England,2001,2,137,278,8,1,1054,1608,26,917,1330,18,40.53846153846154,>30,ENG,Away,Upto 2014
GD McGrath,AUS,Pace,2001-08-23,The Oval,England,2001,2,110,273,7,1,586,1029,9,476,756,2,65.11111111111111,>30,ENG,Away,Upto 2014
GD McGrath,AUS,Pace,2001-11-08,Brisbane,Australia,2001,2,146,276,1,1,871,1428,20,725,1152,19,43.55,>30,AUS,Home,Upto 2014
GD McGrath,AUS,Pace,2001-11-22,Hobart,Australia,2001,1,46,162,2,1,554,972,8,508,810,6,69.25,>30,AUS,Home,Upto 2014
GD McGrath,AUS,Pace,2001-11-30,W.A.C.A,Australia,2001,2,135,264,2,1,1026,1787,22,891,1523,20,46.63636363636363,>30,AUS,Home,Upto 2014
GD McGrath,AUS,Pace,2001-12-14,Adelaide,Australia,2001,2,107,282,6,1,773,1644,20,666,1362,14,38.65,>30,AUS,Home,Upto 2014
GD McGrath,AUS,Pace,2001-12-26,Melbourne,Australia,2001,2,113,282,4,1,710,1446,22,597,1164,18,32.27272727272727,>30,AUS,Home,Upto 2014
GD McGrath,AUS,Pace,2002-01-02,Sydney,Australia,2002,2,130,270,4,1,596,1002,11,466,732,7,54.18181818181818,>30,AUS,Home,Upto 2014
GD McGrath,AUS,Pace,2002-02-22,Johannesburg,South Africa,2002,2,49,159,8,1,698,1059,20,649,900,12,34.9,>30,SA,Away,Upto 2014
GD McGrath,AUS,Pace,2002-03-08,Cape Town,South Africa,2002,2,98,270,3,1,927,1517,20,829,1247,17,46.35,>30,SA,Away,Upto 2014
GD McGrath,AUS,Pace,2002-03-15,Durban,South Africa,2002,2,80,234,1,1,733,1239,21,653,1005,20,34.904761904761905,>30,SA,Away,Upto 2014
GD McGrath,AUS,Pace,2002-10-03,Colombo (PSS),Sri Lanka,2002,2,78,236,4,1,672,1175,21,594,939,17,32.0,>30,SL,Away,Upto 2014
GD McGrath,AUS,Pace,2002-10-11,Sharjah,UAE,2002,2,15,78,3,1,167,426,14,152,348,11,11.928571428571429,<=30,UAE,Away,Upto 2014
GD McGrath,AUS,Pace,2002-10-19,Sharjah,UAE,2002,2,59,138,7,1,365,713,15,306,575,8,24.333333333333332,<=30,UAE,Away,Upto 2014
GD McGrath,AUS,Pace,2002-11-07,Brisbane,Australia,2002,2,123,252,8,1,677,1218,20,554,966,12,33.85,>30,AUS,Home,Upto 2014
GD McGrath,AUS,Pace,2002-11-21,Adelaide,Australia,2002,2,118,284,5,1,643,1143,16,525,859,11,40.1875,>30,AUS,Home,Upto 2014
GD McGrath,AUS,Pace,2002-11-29,W.A.C.A,Australia,2002,2,54,228,4,1,590,1095,16,536,867,12,36.875,>30,AUS,Home,Upto 2014
GD McGrath,AUS,Pace,2002-12-26,Melbourne,Australia,2002,2,85,210,2,1,740,1406,19,655,1196,17,38.94736842105263,>30,AUS,Home,Upto 2014
GD McGrath,AUS,Pace,2003-05-01,Bridgetown,West Indies,2003,2,64,216,0,1,652,1455,15,588,1239,15,43.46666666666667,>30,WI,Away,Upto 2014
GD McGrath,AUS,Pace,2003-05-09,St John's,West Indies,2003,2,94,252,3,1,870,1573,29,776,1321,26,30.0,<=30,WI,Away,Upto 2014
GD McGrath,AUS,Pace,2003-07-18,Darwin,Australia,2003,2,45,138,4,1,496,985,17,451,847,13,29.176470588235293,<=30,AUS,Home,Upto 2014
GD McGrath,AUS,Pace,2003-07-25,Cairns,Australia,2003,2,79,193,1,1,637,1169,12,558,976,11,53.083333333333336,>30,AUS,Home,Upto 2014
GD McGrath,AUS,Pace,2004-07-01,Darwin,Australia,2004,2,61,186,7,1,425,1034,30,364,848,23,14.166666666666666,<=30,AUS,Home,Upto 2014
GD McGrath,AUS,Pace,2004-07-09,Cairns,Australia,2004,2,110,300,3,1,844,1536,15,734,1236,12,56.266666666666666,>30,AUS,Home,Upto 2014
GD McGrath,AUS,Pace,2004-10-06,Bengaluru,India,2004,2,94,270,6,1,461,1068,18,367,798,12,25.61111111111111,<=30,IND,Away,Upto 2014
GD McGrath,AUS,Pace,2004-10-14,Chennai,India,2004,2,92,162,0,1,378,888,4,286,726,4,94.5,>30,IND,Away,Upto 2014
GD McGrath,AUS,Pace,2004-10-26,Nagpur,India,2004,2,106,246,5,1,596,1196,23,490,950,18,25.91304347826087,<=30,IND,Away,Upto 2014
GD McGrath,AUS,Pace,2004-11-03,Wankhede,India,2004,2,64,168,3,1,204,507,11,140,339,8,18.545454545454547,<=30,IND,Away,Upto 2014
GD McGrath,AUS,Pace,2004-11-18,Brisbane,Australia,2004,2,86,210,3,1,723,1283,17,637,1073,14,42.529411764705884,>30,AUS,Home,Upto 2014
GD McGrath,AUS,Pace,2004-11-26,Adelaide,Australia,2004,2,98,193,6,1,602,1087,15,504,894,9,40.13333333333333,>30,AUS,Home,Upto 2014
GD McGrath,AUS,Pace,2004-12-16,W.A.C.A,Australia,2004,2,68,210,9,1,677,1213,30,609,1003,21,22.566666666666666,<=30,AUS,Home,Upto 2014
GD McGrath,AUS,Pace,2004-12-26,Melbourne,Australia,2004,2,89,236,5,1,584,1094,18,495,858,13,32.44444444444444,>30,AUS,Home,Upto 2014
GD McGrath,AUS,Pace,2005-01-02,Sydney,Australia,2005,2,103,196,4,1,541,846,9,438,650,5,60.111111111111114,>30,AUS,Home,Upto 2014
GD McGrath,AUS,Pace,2005-03-10,Christchurch,New Zealand,2005,2,134,336,7,1,768,1398,17,634,1062,10,45.1764705882353,>30,NZ,Away,Upto 2014
GD McGrath,AUS,Pace,2005-03-18,Wellington,New Zealand,2005,2,60,120,4,1,569,942,15,509,822,11,37.93333333333333,>30,NZ,Away,Upto 2014
GD McGrath,AUS,Pace,2005-03-26,Auckland,New Zealand,2005,2,89,302,7,1,759,1379,20,670,1077,13,37.95,>30,NZ,Away,Upto 2014
GD McGrath,AUS,Pace,2005-07-21,Lord's,England,2005,2,82,211,9,1,726,1256,32,644,1045,23,22.6875,<=30,ENG,Away,Upto 2014
GD McGrath,AUS,Pace,2005-08-11,Manchester,England,2005,2,201,275,5,1,929,1432,27,728,1157,22,34.407407407407405,>30,ENG,Away,Upto 2014
GD McGrath,AUS,Pace,2005-09-08,The Oval,England,2005,2,157,318,5,1,707,1205,18,550,887,13,39.27777777777778,>30,ENG,Away,Upto 2014
GD McGrath,AUS,Pace,2005-10-14,Sydney,Australia,2005,2,42,108,3,1,422,699,17,380,591,14,24.823529411764707,<=30,AUS,Home,Upto 2014
GD McGrath,AUS,Pace,2005-11-03,Brisbane,Australia,2005,2,94,198,4,1,772,1215,25,678,1017,21,30.88,>30,AUS,Home,Upto 2014
GD McGrath,AUS,Pace,2005-11-17,Hobart,Australia,2005,2,60,288,6,1,632,1261,19,572,973,13,33.26315789473684,>30,AUS,Home,Upto 2014
GD McGrath,AUS,Pace,2005-11-25,Adelaide,Australia,2005,2,131,288,3,1,853,1575,23,722,1287,20,37.08695652173913,>30,AUS,Home,Upto 2014
GD McGrath,AUS,Pace,2005-12-16,W.A.C.A,Australia,2005,2,98,252,1,1,1099,2050,27,1001,1798,26,40.7037037037037,>30,AUS,Home,Upto 2014
GD McGrath,AUS,Pace,2005-12-26,Melbourne,Australia,2005,2,101,252,4,1,712,1466,23,611,1214,19,30.956521739130434,>30,AUS,Home,Upto 2014
GD McGrath,AUS,Pace,2006-01-02,Sydney,Australia,2006,2,126,294,3,1,752,1301,17,626,1007,14,44.23529411764706,>30,AUS,Home,Upto 2014
GD McGrath,AUS,Pace,2006-11-23,Brisbane,Australia,2006,2,103,253,7,1,985,1659,24,882,1406,17,41.041666666666664,>30,AUS,Home,Upto 2014
GD McGrath,AUS,Pace,2006-12-01,Adelaide,Australia,2006,2,122,240,2,1,876,1646,21,754,1406,19,41.714285714285715,>30,AUS,Home,Upto 2014
GD McGrath,AUS,Pace,2006-12-14,W.A.C.A,Australia,2006,2,109,270,4,1,846,1471,19,737,1201,15,44.526315789473685,>30,AUS,Home,Upto 2014
GD McGrath,AUS,Pace,2006-12-26,Melbourne,Australia,2006,2,63,192,2,1,551,1154,23,488,962,21,23.956521739130434,<=30,AUS,Home,Upto 2014
GD McGrath,AUS,Pace,2007-01-02,Sydney,Australia,2007,2,105,300,6,1,646,1259,24,541,959,18,26.916666666666668,<=30,AUS,Home,Upto 2014
GD McKenzie,AUS,Pace,1961-06-22,Lord's,England,1961,2,118,330,6,1,687,1676,33,569,1346,27,20.818181818181817,<=30,ENG,Away,Upto 2014
GD McKenzie,AUS,Pace,1961-07-06,Leeds,England,1961,2,79,192,3,1,372,1169,24,293,977,21,15.5,<=30,ENG,Away,Upto 2014
GD McKenzie,AUS,Pace,1961-07-27,Manchester,England,1961,2,126,252,2,1,869,2028,25,743,1776,23,34.76,>30,ENG,Away,Upto 2014
GD McKenzie,AUS,Pace,1962-11-30,Brisbane,Australia,1962,2,139,363,5,1,871,1952,19,732,1589,14,45.8421052631579,>30,AUS,Home,Upto 2014
GD McKenzie,AUS,Pace,1962-12-29,Melbourne,Australia,1962,2,153,392,3,1,758,2009,23,605,1617,20,32.95652173913044,>30,AUS,Home,Upto 2014
GD McKenzie,AUS,Pace,1963-01-11,Sydney,Australia,1963,2,78,232,3,1,454,1207,16,376,975,13,28.375,<=30,AUS,Home,Upto 2014
GD McKenzie,AUS,Pace,1963-01-25,Adelaide,Australia,1963,2,153,376,6,1,686,1693,27,533,1317,21,25.40740740740741,<=30,AUS,Home,Upto 2014
GD McKenzie,AUS,Pace,1963-02-15,Sydney,Australia,1963,2,96,280,3,1,466,1318,15,370,1038,12,31.066666666666666,>30,AUS,Home,Upto 2014
GD McKenzie,AUS,Pace,1963-12-06,Brisbane,Australia,1963,2,91,211,2,1,562,1265,13,471,1054,11,43.23076923076923,>30,AUS,Home,Upto 2014
GD McKenzie,AUS,Pace,1964-01-01,Melbourne,Australia,1964,2,163,352,6,1,870,1955,24,707,1603,18,36.25,>30,AUS,Home,Upto 2014
GD McKenzie,AUS,Pace,1964-01-10,Sydney,Australia,1964,2,131,264,4,1,926,1995,29,795,1731,25,31.93103448275862,>30,AUS,Home,Upto 2014
GD McKenzie,AUS,Pace,1964-01-24,Adelaide,Australia,1964,2,178,273,1,1,1036,2074,26,858,1801,25,39.84615384615385,>30,AUS,Home,Upto 2014
GD McKenzie,AUS,Pace,1964-02-07,Sydney,Australia,1964,2,126,328,3,1,694,1880,20,568,1552,17,34.7,>30,AUS,Home,Upto 2014
GD McKenzie,AUS,Pace,1964-06-04,Nottingham,England,1964,2,106,312,6,1,492,1276,20,386,964,14,24.6,<=30,ENG,Away,Upto 2014
GD McKenzie,AUS,Pace,1964-06-18,Lord's,England,1964,1,69,156,3,1,401,987,19,332,831,16,21.105263157894736,<=30,ENG,Away,Upto 2014
GD McKenzie,AUS,Pace,1964-07-02,Leeds,England,1964,2,127,324,7,1,604,1337,21,477,1013,14,28.761904761904763,<=30,ENG,Away,Upto 2014
GD McKenzie,AUS,Pace,1964-07-23,Manchester,England,1964,1,153,360,7,1,759,1991,14,606,1631,7,54.214285714285715,>30,ENG,Away,Upto 2014
GD McKenzie,AUS,Pace,1964-08-13,The Oval,England,1964,2,199,384,6,1,732,1783,22,533,1399,16,33.27272727272727,>30,ENG,Away,Upto 2014
GD McKenzie,AUS,Pace,1964-10-02,Chennai,India,1964,2,91,315,10,1,256,741,16,165,426,6,16.0,<=30,IND,Away,Upto 2014
GD McKenzie,AUS,Pace,1964-10-10,Brabourne,India,1964,2,92,258,2,1,329,735,10,237,477,8,32.9,>30,IND,Away,Upto 2014
GD McKenzie,AUS,Pace,1964-10-17,Eden Gardens,India,1964,1,31,78,1,1,116,312,5,85,234,4,23.2,<=30,IND,Away,Upto 2014
GD McKenzie,AUS,Pace,1964-10-24,Karachi,Pakistan,1964,2,131,330,8,1,349,725,11,218,395,3,31.727272727272727,>30,PAK,Away,Upto 2014
GD McKenzie,AUS,Pace,1964-12-04,Melbourne,Australia,1964,2,140,372,7,1,621,1276,24,481,904,17,25.875,<=30,AUS,Home,Upto 2014
GD McKenzie,AUS,Pace,1965-03-03,Kingston,West Indies,1965,2,126,318,1,1,497,1218,24,371,900,23,20.708333333333332,<=30,WI,Away,Upto 2014
GD McKenzie,AUS,Pace,1965-03-26,Port of Spain,West Indies,1965,2,156,342,2,1,537,1194,10,381,852,8,53.7,>30,WI,Away,Upto 2014
GD McKenzie,AUS,Pace,1965-04-14,Georgetown,West Indies,1965,2,145,264,2,1,434,874,16,289,610,14,27.125,<=30,WI,Away,Upto 2014
GD McKenzie,AUS,Pace,1965-05-05,Bridgetown,West Indies,1965,2,174,426,6,1,670,1290,13,496,864,7,51.53846153846154,>30,WI,Away,Upto 2014
GD McKenzie,AUS,Pace,1965-05-14,Port of Spain,West Indies,1965,2,76,186,6,1,271,612,18,195,426,12,15.055555555555555,<=30,WI,Away,Upto 2014
GD McKenzie,AUS,Pace,1965-12-30,Melbourne,Australia,1965,2,136,290,5,1,657,1479,19,521,1189,14,34.578947368421055,>30,AUS,Home,Upto 2014
GD McKenzie,AUS,Pace,1966-01-07,Sydney,Australia,1966,1,113,200,0,1,445,1015,16,332,815,16,27.8125,<=30,AUS,Home,Upto 2014
GD McKenzie,AUS,Pace,1966-01-28,Adelaide,Australia,1966,2,101,319,7,1,581,1367,21,480,1048,14,27.666666666666668,<=30,AUS,Home,Upto 2014
GD McKenzie,AUS,Pace,1966-02-11,Melbourne,Australia,1966,2,117,256,4,1,701,1506,15,584,1250,11,46.733333333333334,>30,AUS,Home,Upto 2014
GD McKenzie,AUS,Pace,1966-12-23,Johannesburg,South Africa,1966,2,164,365,6,1,809,1914,26,645,1549,20,31.115384615384617,>30,SA,Away,Upto 2014
GD McKenzie,AUS,Pace,1966-12-31,Cape Town,South Africa,1966,2,132,435,8,1,762,1783,22,630,1348,14,34.63636363636363,>30,SA,Away,Upto 2014
GD McKenzie,AUS,Pace,1967-01-20,Durban,South Africa,1967,2,129,306,3,1,725,1921,25,596,1615,22,29.0,<=30,SA,Away,Upto 2014
GD McKenzie,AUS,Pace,1967-02-03,Johannesburg,South Africa,1967,1,96,234,0,1,518,1312,23,422,1078,23,22.52173913043478,<=30,SA,Away,Upto 2014
GD McKenzie,AUS,Pace,1967-02-24,Gqeberha,South Africa,1967,2,103,312,7,1,655,1640,26,552,1328,19,25.192307692307693,<=30,SA,Away,Upto 2014
GD McKenzie,AUS,Pace,1967-12-23,Adelaide,Australia,1967,2,161,256,3,1,596,1119,26,435,863,23,22.923076923076923,<=30,AUS,Home,Upto 2014
GD McKenzie,AUS,Pace,1967-12-30,Melbourne,Australia,1967,2,151,324,10,1,704,1270,18,553,946,8,39.111111111111114,>30,AUS,Home,Upto 2014
GD McKenzie,AUS,Pace,1968-06-06,Manchester,England,1968,2,85,276,5,1,493,1497,18,408,1221,13,27.38888888888889,<=30,ENG,Away,Upto 2014
GD McKenzie,AUS,Pace,1968-06-20,Lord's,England,1968,1,111,270,3,1,427,1141,15,316,871,12,28.466666666666665,<=30,ENG,Away,Upto 2014
GD McKenzie,AUS,Pace,1968-07-11,Birmingham,England,1968,2,172,390,1,1,595,1325,15,423,935,14,39.666666666666664,>30,ENG,Away,Upto 2014
GD McKenzie,AUS,Pace,1968-07-25,Leeds,England,1968,2,126,384,3,1,706,1746,18,580,1362,15,39.22222222222222,>30,ENG,Away,Upto 2014
GD McKenzie,AUS,Pace,1968-08-22,The Oval,England,1968,2,101,264,1,1,485,1288,15,384,1024,14,32.333333333333336,>30,ENG,Away,Upto 2014
GD McKenzie,AUS,Pace,1968-12-06,Brisbane,Australia,1968,2,110,296,4,1,316,792,11,206,496,7,28.727272727272727,<=30,AUS,Home,Upto 2014
GD McKenzie,AUS,Pace,1968-12-26,Melbourne,Australia,1968,2,159,384,10,1,513,1176,14,354,792,4,36.642857142857146,>30,AUS,Home,Upto 2014
GD McKenzie,AUS,Pace,1969-01-03,Sydney,Australia,1969,2,165,369,6,1,677,1377,20,512,1008,14,33.85,>30,AUS,Home,Upto 2014
GD McKenzie,AUS,Pace,1969-01-24,Adelaide,Australia,1969,2,141,290,4,1,674,1285,19,533,995,15,35.473684210526315,>30,AUS,Home,Upto 2014
GD McKenzie,AUS,Pace,1969-02-14,Sydney,Australia,1969,2,183,310,6,1,820,1525,21,637,1215,15,39.04761904761905,>30,AUS,Home,Upto 2014
GD McKenzie,AUS,Pace,1969-11-04,Brabourne,India,1969,2,102,270,5,1,298,821,12,196,551,7,24.833333333333332,<=30,IND,Away,Upto 2014
GD McKenzie,AUS,Pace,1969-11-15,Kanpur,India,1969,2,133,354,4,1,379,992,12,246,638,8,31.583333333333332,>30,IND,Away,Upto 2014
GD McKenzie,AUS,Pace,1969-11-28,Delhi,India,1969,2,41,154,0,1,173,466,3,132,312,3,57.666666666666664,>30,IND,Away,Upto 2014
GD McKenzie,AUS,Pace,1969-12-12,Eden Gardens,India,1969,2,101,310,7,1,336,899,15,235,589,8,22.4,<=30,IND,Away,Upto 2014
GD McKenzie,AUS,Pace,1969-12-24,Chennai,India,1969,2,64,244,5,1,213,718,10,149,474,5,21.3,<=30,IND,Away,Upto 2014
GD McKenzie,AUS,Pace,1970-01-22,Cape Town,South Africa,1970,2,103,228,0,1,471,1312,21,368,1084,21,22.428571428571427,<=30,SA,Away,Upto 2014
GD McKenzie,AUS,Pace,1970-02-05,Durban,South Africa,1970,1,92,155,0,1,686,1387,21,594,1232,21,32.666666666666664,>30,SA,Away,Upto 2014
GD McKenzie,AUS,Pace,1970-03-05,Gqeberha,South Africa,1970,2,138,282,1,1,887,1974,33,749,1692,32,26.87878787878788,<=30,SA,Away,Upto 2014
GD McKenzie,AUS,Pace,1970-11-27,Brisbane,Australia,1970,2,96,248,2,1,624,1629,19,528,1381,17,32.8421052631579,>30,AUS,Home,Upto 2014
GD McKenzie,AUS,Pace,1970-12-11,W.A.C.A,Australia,1970,2,116,396,4,1,852,2129,21,736,1733,17,40.57142857142857,>30,AUS,Home,Upto 2014
GD McKenzie,AUS,Pace,1971-01-09,Sydney,Australia,1971,2,139,240,1,1,480,1339,18,341,1099,17,26.666666666666668,<=30,AUS,Home,Upto 2014
GD Phillips,NZ,Spin,2023-11-28,Sylhet,Bangladesh,2023,2,100,192,5,1,883,1678,32,783,1486,27,27.59375,<=30,BAN,Away,After 1965
GD Phillips,NZ,Spin,2023-12-06,Mirpur,Bangladesh,2023,1,31,72,3,1,542,923,30,511,851,27,18.066666666666666,<=30,BAN,Away,After 1965
GD Phillips,NZ,Spin,2024-02-04,Mount Maunganui,New Zealand,2024,1,30,54,1,1,328,671,17,298,617,16,19.294117647058822,<=30,NZ,Home,After 1965
GD Phillips,NZ,Spin,2024-02-13,Hamilton,New Zealand,2024,1,50,90,2,1,415,855,14,365,765,12,29.642857142857142,<=30,NZ,Home,After 1965
GD Phillips,NZ,Spin,2024-02-29,Wellington,New Zealand,2024,1,45,96,5,1,189,379,17,144,283,12,11.117647058823529,<=30,NZ,Home,After 1965
GD Phillips,NZ,Spin,2024-03-08,Christchurch,New Zealand,2024,2,41,102,1,1,112,230,4,71,128,3,28.0,<=30,NZ,Home,After 1965
GD Phillips,NZ,Spin,2024-09-18,Galle,Sri Lanka,2024,2,102,180,2,1,849,1559,29,747,1379,27,29.275862068965516,<=30,SL,Away,After 1965
GD Phillips,NZ,Spin,2024-09-26,Galle,Sri Lanka,2024,1,141,228,3,1,824,1411,22,683,1183,19,37.45454545454545,>30,SL,Away,After 1965
GD Phillips,NZ,Spin,2024-10-16,Bengaluru,India,2024,1,69,90,1,1,524,637,10,455,547,9,52.4,>30,IND,Away,After 1965
GD Phillips,NZ,Spin,2024-10-24,Pune,India,2024,2,86,132,3,1,741,1336,37,655,1204,34,20.027027027027028,<=30,IND,Away,After 1965
GD Phillips,NZ,Spin,2024-11-01,Wankhede,India,2024,2,126,192,4,1,671,1028,34,545,836,30,19.735294117647058,<=30,IND,Away,After 1965
GD Phillips,NZ,Spin,2024-11-28,Christchurch,New Zealand,2024,1,35,54,0,1,459,659,17,424,605,17,27.0,<=30,NZ,Home,After 1965
GD Phillips,NZ,Spin,2024-12-06,Wellington,New Zealand,2024,2,107,120,1,1,476,526,13,369,406,12,36.61538461538461,>30,NZ,Home,After 1965
GD Varnals,SA,Spin,1965-01-01,Cape Town,South Africa,1965,1,2,12,0,1,605,1499,14,603,1487,14,43.214285714285715,>30,SA,Home,Upto 2014
GD Watson,AUS,Pace,1966-12-31,Cape Town,South Africa,1966,1,27,66,0,1,762,1783,22,735,1717,22,34.63636363636363,>30,SA,Away,Upto 2014
GD Watson,AUS,Pace,1967-02-03,Johannesburg,South Africa,1967,1,67,120,2,1,518,1312,23,451,1192,21,22.52173913043478,<=30,SA,Away,Upto 2014
GD Watson,AUS,Pace,1967-02-24,Gqeberha,South Africa,1967,2,68,126,1,1,655,1640,26,587,1514,25,25.192307692307693,<=30,SA,Away,Upto 2014
GD Watson,AUS,Pace,1972-06-08,Manchester,England,1972,2,37,54,1,1,656,1682,30,619,1628,29,21.866666666666667,<=30,ENG,Away,Upto 2014
GD Watson,AUS,Pace,1972-08-10,The Oval,England,1972,2,55,186,2,1,662,1491,19,607,1305,17,34.8421052631579,>30,ENG,Away,Upto 2014
GE Bond,SA,Pace,1938-12-24,Johannesburg,South Africa,1938,1,16,16,0,1,680,1468,10,664,1452,10,68.0,>30,SA,Home,Upto 2014
GE Bradburn,NZ,Spin,1990-10-10,Karachi,Pakistan,1990,1,56,102,1,1,202,384,2,146,282,1,101.0,>30,PAK,Away,Upto 2014
GE Bradburn,NZ,Spin,1990-10-18,Lahore,Pakistan,1990,1,32,78,1,1,149,339,4,117,261,3,37.25,>30,PAK,Away,Upto 2014
GE Bradburn,NZ,Spin,1990-10-26,Faisalabad,Pakistan,1990,1,23,36,0,1,81,132,1,58,96,1,81.0,>30,PAK,Away,Upto 2014
GE Bradburn,NZ,Spin,1991-01-31,Wellington,New Zealand,1991,1,83,156,0,1,378,792,0,295,636,0,inf,>30,NZ,Home,Upto 2014
GE Bradburn,NZ,Spin,1992-12-06,Colombo (SSC),Sri Lanka,1992,2,142,243,3,1,505,1022,18,363,779,15,28.055555555555557,<=30,SL,Away,Upto 2014
GE Bradburn,NZ,Spin,2001-03-15,Christchurch,New Zealand,2001,1,124,252,1,1,390,912,6,266,660,5,65.0,>30,NZ,Home,Upto 2014
GE Corling,AUS,Pace,1964-06-04,Nottingham,England,1964,2,92,233,3,1,492,1276,20,400,1043,17,24.6,<=30,ENG,Away,Upto 2014
GE Corling,AUS,Pace,1964-06-18,Lord's,England,1964,1,60,165,4,1,401,987,19,341,822,15,21.105263157894736,<=30,ENG,Away,Upto 2014
GE Corling,AUS,Pace,1964-07-02,Leeds,England,1964,2,102,251,4,1,604,1337,21,502,1086,17,28.761904761904763,<=30,ENG,Away,Upto 2014
GE Corling,AUS,Pace,1964-07-23,Manchester,England,1964,1,96,276,0,1,759,1991,14,663,1715,14,54.214285714285715,>30,ENG,Away,Upto 2014
GE Corling,AUS,Pace,1964-08-13,The Oval,England,1964,2,97,234,1,1,732,1783,22,635,1549,21,33.27272727272727,>30,ENG,Away,Upto 2014
GE Gomez,WI,Pace,1948-02-11,Port of Spain,West Indies,1948,1,22,48,1,1,529,1106,15,507,1058,14,35.266666666666666,>30,WI,Home,Upto 2014
GE Gomez,WI,Pace,1948-03-03,Georgetown,West Indies,1948,1,9,6,0,1,265,632,11,256,626,11,24.09090909090909,<=30,WI,Home,Upto 2014
GE Gomez,WI,Pace,1948-11-10,Delhi,India,1948,2,93,294,2,1,457,956,11,364,662,9,41.54545454545455,>30,IND,Away,Upto 2014
GE Gomez,WI,Pace,1948-12-09,Brabourne,India,1948,2,69,312,3,1,410,1014,5,341,702,2,82.0,>30,IND,Away,Upto 2014
GE Gomez,WI,Pace,1948-12-31,Eden Gardens,India,1948,2,112,366,4,1,577,1272,12,465,906,8,48.083333333333336,>30,IND,Away,Upto 2014
GE Gomez,WI,Pace,1949-01-27,Chennai,India,1949,2,95,291,4,1,442,1095,18,347,804,14,24.555555555555557,<=30,IND,Away,Upto 2014
GE Gomez,WI,Pace,1949-02-04,Brabourne,India,1949,2,85,282,3,1,462,1177,18,377,895,15,25.666666666666668,<=30,IND,Away,Upto 2014
GE Gomez,WI,Pace,1950-06-08,Manchester,England,1950,2,76,210,2,1,157,402,3,81,192,1,52.333333333333336,>30,ENG,Away,Upto 2014
GE Gomez,WI,Pace,1950-06-24,Lord's,England,1950,1,25,78,0,1,279,874,5,254,796,5,55.8,>30,ENG,Away,Upto 2014
GE Gomez,WI,Pace,1950-07-20,Nottingham,England,1950,2,32,84,0,1,535,1228,10,503,1144,10,53.5,>30,ENG,Away,Upto 2014
GE Gomez,WI,Pace,1950-08-12,The Oval,England,1950,2,30,108,0,1,259,680,4,229,572,4,64.75,>30,ENG,Away,Upto 2014
GE Gomez,WI,Pace,1951-11-09,Brisbane,Australia,1951,2,22,85,3,1,179,501,9,157,416,6,19.88888888888889,<=30,AUS,Away,Upto 2014
GE Gomez,WI,Pace,1951-11-30,Sydney,Australia,1951,2,56,184,1,1,387,1058,13,331,874,12,29.76923076923077,<=30,AUS,Away,Upto 2014
GE Gomez,WI,Pace,1951-12-22,Adelaide,Australia,1951,2,22,96,3,1,142,445,7,120,349,4,20.285714285714285,<=30,AUS,Away,Upto 2014
GE Gomez,WI,Pace,1951-12-31,Melbourne,Australia,1951,2,43,179,1,1,342,918,16,299,739,15,21.375,<=30,AUS,Away,Upto 2014
GE Gomez,WI,Pace,1952-01-25,Sydney,Australia,1952,2,113,290,10,1,268,736,24,155,446,14,11.166666666666666,<=30,AUS,Away,Upto 2014
GE Gomez,WI,Pace,1952-02-08,Christchurch,New Zealand,1952,2,72,240,3,1,219,588,9,147,348,6,24.333333333333332,<=30,NZ,Away,Upto 2014
GE Gomez,WI,Pace,1953-01-21,Port of Spain,West Indies,1953,2,135,360,3,1,431,1261,9,296,901,6,47.888888888888886,>30,WI,Home,Upto 2014
GE Gomez,WI,Pace,1953-02-07,Bridgetown,West Indies,1953,2,36,132,1,1,175,498,7,139,366,6,25.0,<=30,WI,Home,Upto 2014
GE Gomez,WI,Pace,1953-02-19,Port of Spain,West Indies,1953,2,68,373,2,1,346,1003,10,278,630,8,34.6,>30,WI,Home,Upto 2014
GE Gomez,WI,Pace,1953-03-28,Kingston,West Indies,1953,2,112,450,5,1,439,1284,11,327,834,6,39.90909090909091,>30,WI,Home,Upto 2014
GE Gomez,WI,Pace,1954-01-15,Kingston,West Indies,1954,2,79,236,4,1,630,1500,20,551,1264,16,31.5,>30,WI,Home,Upto 2014
GE Gomez,WI,Pace,1954-02-06,Bridgetown,West Indies,1954,2,38,160,3,1,376,820,10,338,660,7,37.6,>30,WI,Home,Upto 2014
GE Gomez,WI,Pace,1954-02-24,Georgetown,West Indies,1954,2,90,222,0,1,302,702,8,212,480,8,37.75,>30,WI,Home,Upto 2014
GE Gomez,WI,Pace,1954-03-30,Kingston,West Indies,1954,1,56,150,0,1,363,910,17,307,760,17,21.352941176470587,<=30,WI,Home,Upto 2014
GE Palmer,AUS,Spin,1880-09-06,The Oval,England,1880,2,151,347,4,1,721,1528,21,570,1181,17,34.333333333333336,>30,ENG,Away,After 1965
GE Palmer,AUS,Spin,1881-12-31,Melbourne,Australia,1881,2,150,452,3,1,812,2321,24,662,1869,21,33.833333333333336,>30,AUS,Home,After 1965
GE Palmer,AUS,Spin,1882-02-17,Sydney,Australia,1882,2,165,496,11,1,520,1846,24,355,1350,13,21.666666666666668,<=30,AUS,Home,After 1965
GE Palmer,AUS,Spin,1882-03-03,Sydney,Australia,1882,2,90,342,9,1,374,1277,25,284,935,16,14.96,<=30,AUS,Home,After 1965
GE Palmer,AUS,Spin,1882-03-10,Melbourne,Australia,1882,2,117,172,1,1,397,773,12,280,601,11,33.083333333333336,>30,AUS,Home,After 1965
GE Palmer,AUS,Spin,1882-12-30,Melbourne,Australia,1882,2,126,355,10,1,291,692,13,165,337,3,22.384615384615383,<=30,AUS,Home,After 1965
GE Palmer,AUS,Spin,1883-01-19,Melbourne,Australia,1883,1,103,267,5,1,205,505,19,102,238,14,10.789473684210526,<=30,AUS,Home,After 1965
GE Palmer,AUS,Spin,1883-01-26,Sydney,Australia,1883,2,57,188,2,1,194,600,10,137,412,8,19.4,<=30,AUS,Home,After 1965
GE Palmer,AUS,Spin,1883-02-17,Sydney,Australia,1883,2,111,271,4,1,484,1391,24,373,1120,20,20.166666666666668,<=30,AUS,Home,After 1965
GE Palmer,AUS,Spin,1884-07-10,Manchester,England,1884,2,57,168,4,1,222,640,17,165,472,13,13.058823529411764,<=30,ENG,Away,After 1965
GE Palmer,AUS,Spin,1884-07-21,Lord's,England,1884,1,111,300,6,1,320,694,15,209,394,9,21.333333333333332,<=30,ENG,Away,After 1965
GE Palmer,AUS,Spin,1884-08-11,The Oval,England,1884,2,92,224,4,1,469,1036,14,377,812,10,33.5,>30,ENG,Away,After 1965
GE Palmer,AUS,Spin,1884-12-12,Adelaide,Australia,1884,2,104,356,6,1,511,1330,22,407,974,16,23.227272727272727,<=30,AUS,Home,After 1965
GE Palmer,AUS,Spin,1885-03-14,Sydney,Australia,1885,2,67,141,4,1,238,508,7,171,367,3,34.0,>30,AUS,Home,After 1965
GE Palmer,AUS,Spin,1886-07-05,Manchester,England,1886,2,52,98,4,1,205,538,9,153,440,5,22.77777777777778,<=30,ENG,Away,After 1965
GE Palmer,AUS,Spin,1886-07-19,Lord's,England,1886,1,45,152,1,1,231,789,16,186,637,15,14.4375,<=30,ENG,Away,After 1965
GE Palmer,AUS,Spin,1886-08-12,The Oval,England,1886,1,80,188,0,1,247,704,10,167,516,10,24.7,<=30,ENG,Away,After 1965
GE Tribe,AUS,Spin,1946-11-29,Brisbane,Australia,1946,2,67,168,2,1,284,598,7,217,430,5,40.57142857142857,>30,AUS,Home,Upto 2014
GE Tribe,AUS,Spin,1946-12-13,Sydney,Australia,1946,2,110,256,0,1,831,1933,19,721,1677,19,43.73684210526316,>30,AUS,Home,Upto 2014
GE Tribe,AUS,Spin,1947-02-28,Sydney,Australia,1947,2,153,336,0,1,494,1134,15,341,798,15,32.93333333333333,>30,AUS,Home,Upto 2014
GE Tyldesley,ENG,Spin,1928-02-04,Durban,South Africa,1928,1,2,3,0,1,423,969,13,421,966,13,32.53846153846154,>30,SA,Away,Upto 2014
GE Vivian,NZ,Spin,1965-03-05,Eden Gardens,India,1965,2,51,90,1,1,632,1531,17,581,1441,16,37.1764705882353,>30,IND,Away,Upto 2014
GE Vivian,NZ,Spin,1972-03-09,Port of Spain,West Indies,1972,1,10,24,0,1,722,2183,14,712,2159,14,51.57142857142857,>30,WI,Away,Upto 2014
GE Vivian,NZ,Spin,1972-03-23,Bridgetown,West Indies,1972,1,20,48,0,1,454,1224,7,434,1176,7,64.85714285714286,>30,WI,Away,Upto 2014
GE Vivian,NZ,Spin,1972-04-06,Georgetown,West Indies,1972,2,26,36,0,1,489,1488,3,463,1452,3,163.0,>30,WI,Away,Upto 2014
GF Bissett,SA,Pace,1927-12-31,Cape Town,South Africa,1927,2,136,293,8,1,474,1145,15,338,852,7,31.6,>30,SA,Home,Upto 2014
GF Bissett,SA,Pace,1928-01-21,Durban,South Africa,1928,2,130,246,0,1,482,1079,8,352,833,8,60.25,>30,SA,Home,Upto 2014
GF Bissett,SA,Pace,1928-01-28,Johannesburg,South Africa,1928,2,113,240,8,1,503,1258,23,390,1018,15,21.869565217391305,<=30,SA,Home,Upto 2014
GF Bissett,SA,Pace,1928-02-04,Durban,South Africa,1928,2,90,210,9,1,338,797,16,248,587,7,21.125,<=30,SA,Home,Upto 2014
GF Cresswell,NZ,Spin,1949-08-13,The Oval,England,1949,1,168,248,6,1,597,1082,15,429,834,9,39.8,>30,ENG,Away,Upto 2014
GF Cresswell,NZ,Spin,1951-03-17,Christchurch,New Zealand,1951,1,75,204,2,1,586,1337,15,511,1133,13,39.06666666666667,>30,NZ,Home,Upto 2014
GF Cresswell,NZ,Spin,1951-03-24,Wellington,New Zealand,1951,2,49,198,5,1,366,1136,25,317,938,20,14.64,<=30,NZ,Home,Upto 2014
GF Labrooy,SL,Pace,1986-12-17,Kanpur,India,1986,1,164,210,1,1,810,1291,13,646,1081,12,62.30769230769231,>30,IND,Away,Upto 2014
GF Labrooy,SL,Pace,1988-02-12,W.A.C.A,Australia,1988,1,108,216,2,1,710,1536,29,602,1320,27,24.482758620689655,<=30,AUS,Away,Upto 2014
GF Labrooy,SL,Pace,1988-08-25,Lord's,England,1988,2,143,294,4,1,947,1904,31,804,1610,27,30.548387096774192,>30,ENG,Away,Upto 2014
GF Labrooy,SL,Pace,1989-12-08,Brisbane,Australia,1989,2,202,331,5,1,901,1884,23,699,1553,18,39.17391304347826,>30,AUS,Away,Upto 2014
GF Labrooy,SL,Pace,1989-12-16,Hobart,Australia,1989,2,161,246,2,1,998,1920,27,837,1674,25,36.96296296296296,>30,AUS,Away,Upto 2014
GF Labrooy,SL,Pace,1990-11-23,Chandigarh,India,1990,1,59,72,0,1,244,603,12,185,531,12,20.333333333333332,<=30,IND,Away,Upto 2014
GF Labrooy,SL,Pace,1991-01-31,Wellington,New Zealand,1991,2,156,294,4,1,940,1788,23,784,1494,19,40.869565217391305,>30,NZ,Away,Upto 2014
GF Labrooy,SL,Pace,1991-02-22,Hamilton,New Zealand,1991,2,111,252,2,1,916,2000,25,805,1748,23,36.64,>30,NZ,Away,Upto 2014
GF Labrooy,SL,Pace,1991-03-01,Auckland,New Zealand,1991,2,90,243,7,1,890,1772,29,800,1529,22,30.689655172413794,>30,NZ,Away,Upto 2014
GF Lawson,AUS,Pace,1980-11-28,Brisbane,Australia,1980,2,65,120,3,1,530,1227,24,465,1107,21,22.083333333333332,<=30,AUS,Home,Upto 2014
GF Lawson,AUS,Pace,1981-06-18,Nottingham,England,1981,1,25,48,0,1,571,1418,36,546,1370,36,15.86111111111111,<=30,ENG,Away,Upto 2014
GF Lawson,AUS,Pace,1981-07-02,Lord's,England,1981,2,132,373,8,1,755,1760,25,623,1387,17,30.2,>30,ENG,Away,Upto 2014
GF Lawson,AUS,Pace,1981-07-16,Leeds,England,1981,2,128,216,4,1,892,1859,38,764,1643,34,23.473684210526315,<=30,ENG,Away,Upto 2014
GF Lawson,AUS,Pace,1981-12-26,Melbourne,Australia,1981,2,64,156,1,1,642,1526,35,578,1370,34,18.34285714285714,<=30,AUS,Home,Upto 2014
GF Lawson,AUS,Pace,1982-09-22,Karachi,Pakistan,1982,1,93,234,2,1,384,853,11,291,619,9,34.90909090909091,>30,PAK,Away,Upto 2014
GF Lawson,AUS,Pace,1982-09-30,Faisalabad,Pakistan,1982,1,97,198,4,1,292,720,7,195,522,3,41.714285714285715,>30,PAK,Away,Upto 2014
GF Lawson,AUS,Pace,1982-10-14,Lahore,Pakistan,1982,2,112,252,3,1,661,1346,22,549,1094,19,30.045454545454547,>30,PAK,Away,Upto 2014
GF Lawson,AUS,Pace,1982-11-12,W.A.C.A,Australia,1982,2,197,366,6,1,850,1760,19,653,1394,13,44.73684210526316,>30,AUS,Home,Upto 2014
GF Lawson,AUS,Pace,1982-11-26,Brisbane,Australia,1982,2,134,324,11,1,686,1313,27,552,989,16,25.40740740740741,<=30,AUS,Home,Upto 2014
GF Lawson,AUS,Pace,1982-12-10,Adelaide,Australia,1982,2,122,252,9,1,666,1305,27,544,1053,18,24.666666666666668,<=30,AUS,Home,Upto 2014
GF Lawson,AUS,Pace,1982-12-26,Melbourne,Australia,1982,2,114,232,4,1,837,1586,32,723,1354,28,26.15625,<=30,AUS,Home,Upto 2014
GF Lawson,AUS,Pace,1983-01-02,Sydney,Australia,1983,2,120,210,4,1,595,1175,21,475,965,17,28.333333333333332,<=30,AUS,Home,Upto 2014
GF Lawson,AUS,Pace,1983-11-11,W.A.C.A,Australia,1983,2,101,122,3,1,628,1218,24,527,1096,21,26.166666666666668,<=30,AUS,Home,Upto 2014
GF Lawson,AUS,Pace,1983-11-25,Brisbane,Australia,1983,2,73,163,6,1,428,757,16,355,594,10,26.75,<=30,AUS,Home,Upto 2014
GF Lawson,AUS,Pace,1983-12-09,Adelaide,Australia,1983,1,127,222,2,1,947,1786,20,820,1564,18,47.35,>30,AUS,Home,Upto 2014
GF Lawson,AUS,Pace,1983-12-26,Melbourne,Australia,1983,2,172,354,4,1,818,1728,17,646,1374,13,48.11764705882353,>30,AUS,Home,Upto 2014
GF Lawson,AUS,Pace,1984-01-02,Sydney,Australia,1984,2,107,270,9,1,768,1631,25,661,1361,16,30.72,>30,AUS,Home,Upto 2014
GF Lawson,AUS,Pace,1984-03-02,Georgetown,West Indies,1984,2,113,232,3,1,692,1314,20,579,1082,17,34.6,>30,WI,Away,Upto 2014
GF Lawson,AUS,Pace,1984-03-16,Port of Spain,West Indies,1984,1,132,192,2,1,693,1381,19,561,1189,17,36.473684210526315,>30,WI,Away,Upto 2014
GF Lawson,AUS,Pace,1984-03-30,Bridgetown,West Indies,1984,2,153,212,2,1,810,1566,27,657,1354,25,30.0,<=30,WI,Away,Upto 2014
GF Lawson,AUS,Pace,1984-04-07,St John's,West Indies,1984,1,125,174,2,1,745,1490,28,620,1316,26,26.607142857142858,<=30,WI,Away,Upto 2014
GF Lawson,AUS,Pace,1984-04-28,Kingston,West Indies,1984,2,115,210,3,1,537,1132,24,422,922,21,22.375,<=30,WI,Away,Upto 2014
GF Lawson,AUS,Pace,1984-11-09,W.A.C.A,Australia,1984,1,79,144,0,1,700,1337,30,621,1193,30,23.333333333333332,<=30,AUS,Home,Upto 2014
GF Lawson,AUS,Pace,1984-11-23,Brisbane,Australia,1984,2,126,214,6,1,749,1407,30,623,1193,24,24.966666666666665,<=30,AUS,Home,Upto 2014
GF Lawson,AUS,Pace,1984-12-07,Adelaide,Australia,1984,2,181,384,11,1,771,1535,30,590,1151,19,25.7,<=30,AUS,Home,Upto 2014
GF Lawson,AUS,Pace,1984-12-22,Melbourne,Australia,1984,2,162,336,5,1,827,1673,26,665,1337,21,31.807692307692307,>30,AUS,Home,Upto 2014
GF Lawson,AUS,Pace,1984-12-30,Sydney,Australia,1984,2,41,90,1,1,535,1040,12,494,950,11,44.583333333333336,>30,AUS,Home,Upto 2014
GF Lawson,AUS,Pace,1985-06-13,Leeds,England,1985,2,168,252,5,1,1140,1931,28,972,1679,23,40.714285714285715,>30,ENG,Away,Upto 2014
GF Lawson,AUS,Pace,1985-06-27,Lord's,England,1985,2,177,288,6,1,753,1358,25,576,1070,19,30.12,>30,ENG,Away,Upto 2014
GF Lawson,AUS,Pace,1985-07-11,Nottingham,England,1985,2,135,316,5,1,706,1344,15,571,1028,10,47.06666666666667,>30,ENG,Away,Upto 2014
GF Lawson,AUS,Pace,1985-08-01,Manchester,England,1985,1,114,222,0,1,622,1074,12,508,852,12,51.833333333333336,>30,ENG,Away,Upto 2014
GF Lawson,AUS,Pace,1985-08-15,Birmingham,England,1985,1,135,222,2,1,829,1344,20,694,1122,18,41.45,>30,ENG,Away,Upto 2014
GF Lawson,AUS,Pace,1985-08-29,The Oval,England,1985,1,101,176,4,1,567,1067,25,466,891,21,22.68,<=30,ENG,Away,Upto 2014
GF Lawson,AUS,Pace,1985-11-08,Brisbane,Australia,1985,1,96,221,1,1,699,1580,23,603,1359,22,30.391304347826086,>30,AUS,Home,Upto 2014
GF Lawson,AUS,Pace,1985-11-30,W.A.C.A,Australia,1985,2,114,408,4,1,726,2093,28,612,1685,24,25.928571428571427,<=30,AUS,Home,Upto 2014
GF Lawson,AUS,Pace,1986-11-28,W.A.C.A,Australia,1986,2,170,300,0,1,963,1802,22,793,1502,22,43.77272727272727,>30,AUS,Home,Upto 2014
GF Lawson,AUS,Pace,1988-12-02,W.A.C.A,Australia,1988,1,97,192,3,1,1183,2020,32,1086,1828,29,36.96875,>30,AUS,Home,Upto 2014
GF Lawson,AUS,Pace,1989-06-08,Leeds,England,1989,2,163,275,5,1,1372,2385,30,1209,2110,25,45.733333333333334,>30,ENG,Away,Upto 2014
GF Lawson,AUS,Pace,1989-06-22,Lord's,England,1989,2,187,396,4,1,1092,2047,30,905,1651,26,36.4,>30,ENG,Away,Upto 2014
GF Lawson,AUS,Pace,1989-07-06,Birmingham,England,1989,1,54,126,2,1,670,1413,17,616,1287,15,39.411764705882355,>30,ENG,Away,Upto 2014
GF Lawson,AUS,Pace,1989-07-27,Manchester,England,1989,2,153,384,9,1,673,1605,23,520,1221,14,29.26086956521739,<=30,ENG,Away,Upto 2014
GF Lawson,AUS,Pace,1989-08-10,Nottingham,England,1989,2,108,216,4,1,695,1373,18,587,1157,14,38.611111111111114,>30,ENG,Away,Upto 2014
GF Lawson,AUS,Pace,1989-08-24,The Oval,England,1989,2,126,266,5,1,921,1691,26,795,1425,21,35.42307692307692,>30,ENG,Away,Upto 2014
GF Lawson,AUS,Pace,1989-11-24,W.A.C.A,Australia,1989,2,142,360,2,1,939,2255,25,797,1895,23,37.56,>30,AUS,Home,Upto 2014
GF Lawson,AUS,Pace,1989-12-08,Brisbane,Australia,1989,1,51,198,1,1,901,1884,23,850,1686,22,39.17391304347826,>30,AUS,Home,Upto 2014
GF Linde,SA,Spin,2019-10-19,Ranchi,India,2019,1,133,186,4,1,405,692,13,272,506,9,31.153846153846153,>30,IND,Away,After 1965
GF Linde,SA,Spin,2021-01-26,Karachi,Pakistan,2021,2,51,96,0,1,369,904,18,318,808,18,20.5,<=30,PAK,Away,After 1965
GF Linde,SA,Spin,2021-02-04,Rawalpindi,Pakistan,2021,2,68,191,5,1,496,1138,13,428,947,8,38.15384615384615,>30,PAK,Away,After 1965
GF Rorke,AUS,Pace,1959-01-30,Adelaide,Australia,1959,2,101,417,5,1,681,1789,20,580,1372,15,34.05,>30,AUS,Home,Upto 2014
GF Rorke,AUS,Pace,1959-02-13,Melbourne,Australia,1959,2,64,148,3,1,613,1344,20,549,1196,17,30.65,>30,AUS,Home,Upto 2014
GF Rorke,AUS,Pace,1959-12-12,Delhi,India,1959,2,35,126,2,1,410,963,10,375,837,8,41.0,>30,IND,Away,Upto 2014
GF Rorke,AUS,Pace,1959-12-19,Kanpur,India,1959,1,3,12,0,1,231,796,13,228,784,13,17.76923076923077,<=30,IND,Away,Upto 2014
GG Arnold,ENG,Pace,1967-08-10,Nottingham,England,1967,2,40,132,3,1,254,846,14,214,714,11,18.142857142857142,<=30,ENG,Home,Upto 2014
GG Arnold,ENG,Pace,1967-08-24,The Oval,England,1967,2,107,276,5,1,449,1200,19,342,924,14,23.63157894736842,<=30,ENG,Home,Upto 2014
GG Arnold,ENG,Pace,1969-08-21,The Oval,England,1969,2,30,108,0,1,397,1023,15,367,915,15,26.466666666666665,<=30,ENG,Home,Upto 2014
GG Arnold,ENG,Pace,1972-06-08,Manchester,England,1972,2,121,270,5,1,656,1682,30,535,1412,25,21.866666666666667,<=30,ENG,Home,Upto 2014
GG Arnold,ENG,Pace,1972-07-27,Leeds,England,1972,2,45,95,4,1,173,528,9,128,433,5,19.22222222222222,<=30,ENG,Home,Upto 2014
GG Arnold,ENG,Pace,1972-08-10,The Oval,England,1972,2,113,300,4,1,662,1491,19,549,1191,15,34.8421052631579,>30,ENG,Home,Upto 2014
GG Arnold,ENG,Pace,1972-12-20,Delhi,India,1972,2,91,266,9,1,207,536,11,116,270,2,18.818181818181817,<=30,IND,Away,Upto 2014
GG Arnold,ENG,Pace,1973-01-12,Chennai,India,1973,2,45,163,3,1,119,343,5,74,180,2,23.8,<=30,IND,Away,Upto 2014
GG Arnold,ENG,Pace,1973-01-25,Kanpur,India,1973,2,87,252,2,1,253,624,7,166,372,5,36.142857142857146,>30,IND,Away,Upto 2014
GG Arnold,ENG,Pace,1973-02-06,Brabourne,India,1973,2,77,144,3,1,226,386,7,149,242,4,32.285714285714285,>30,IND,Away,Upto 2014
GG Arnold,ENG,Pace,1973-03-02,Lahore,Pakistan,1973,2,107,282,2,1,401,966,6,294,684,4,66.83333333333333,>30,PAK,Away,Upto 2014
GG Arnold,ENG,Pace,1973-03-16,Hyderabad (Sind),Pakistan,1973,1,78,144,1,1,221,462,4,143,318,3,55.25,>30,PAK,Away,Upto 2014
GG Arnold,ENG,Pace,1973-03-24,Karachi,Pakistan,1973,2,121,204,0,1,291,630,3,170,426,3,97.0,>30,PAK,Away,Upto 2014
GG Arnold,ENG,Pace,1973-06-07,Nottingham,England,1973,2,154,426,7,1,817,1990,27,663,1564,20,30.25925925925926,>30,ENG,Home,Upto 2014
GG Arnold,ENG,Pace,1973-06-21,Lord's,England,1973,1,108,246,1,1,777,1763,19,669,1517,18,40.89473684210526,>30,ENG,Home,Upto 2014
GG Arnold,ENG,Pace,1973-07-05,Leeds,England,1973,2,89,294,8,1,624,1466,29,535,1172,21,21.517241379310345,<=30,ENG,Home,Upto 2014
GG Arnold,ENG,Pace,1973-07-26,The Oval,England,1973,2,162,343,8,1,552,1154,24,390,811,16,23.0,<=30,ENG,Home,Upto 2014
GG Arnold,ENG,Pace,1973-08-09,Birmingham,England,1973,2,117,342,7,1,555,1416,18,438,1074,11,30.833333333333332,>30,ENG,Home,Upto 2014
GG Arnold,ENG,Pace,1973-08-23,Lord's,England,1973,1,111,210,0,1,497,984,19,386,774,19,26.157894736842106,<=30,ENG,Home,Upto 2014
GG Arnold,ENG,Pace,1974-03-06,Bridgetown,West Indies,1974,1,91,156,1,1,627,1356,14,536,1200,13,44.785714285714285,>30,WI,Away,Upto 2014
GG Arnold,ENG,Pace,1974-03-22,Georgetown,West Indies,1974,1,17,60,0,1,242,634,5,225,574,5,48.4,>30,WI,Away,Upto 2014
GG Arnold,ENG,Pace,1974-03-30,Port of Spain,West Indies,1974,2,40,81,1,1,172,537,8,132,456,7,21.5,<=30,WI,Away,Upto 2014
GG Arnold,ENG,Pace,1974-06-20,Lord's,England,1974,2,100,197,5,1,408,797,19,308,600,14,21.473684210526315,<=30,ENG,Home,Upto 2014
GG Arnold,ENG,Pace,1974-07-04,Birmingham,England,1974,2,104,198,5,1,333,648,16,229,450,11,20.8125,<=30,ENG,Home,Upto 2014
GG Arnold,ENG,Pace,1974-07-25,Leeds,England,1974,2,103,330,6,1,703,1746,31,600,1416,25,22.677419354838708,<=30,ENG,Home,Upto 2014
GG Arnold,ENG,Pace,1974-08-08,Lord's,England,1974,2,69,138,1,1,356,858,8,287,720,7,44.5,>30,ENG,Home,Upto 2014
GG Arnold,ENG,Pace,1974-08-22,The Oval,England,1974,2,128,258,3,1,675,1389,8,547,1131,5,84.375,>30,ENG,Home,Upto 2014
GG Arnold,ENG,Pace,1974-12-13,W.A.C.A,Australia,1974,2,144,231,3,1,728,1672,24,584,1441,21,30.333333333333332,>30,AUS,Away,Upto 2014
GG Arnold,ENG,Pace,1975-01-04,Sydney,Australia,1975,2,164,408,6,1,724,1665,23,560,1257,17,31.47826086956522,>30,AUS,Away,Upto 2014
GG Arnold,ENG,Pace,1975-01-25,Adelaide,Australia,1975,2,113,258,2,1,469,911,17,356,653,15,27.58823529411765,<=30,AUS,Away,Upto 2014
GG Arnold,ENG,Pace,1975-02-08,Melbourne,Australia,1975,2,107,232,3,1,711,1562,25,604,1330,22,28.44,<=30,AUS,Away,Upto 2014
GG Arnold,ENG,Pace,1975-02-20,Auckland,New Zealand,1975,2,100,208,1,1,616,1261,8,516,1053,7,77.0,>30,NZ,Away,Upto 2014
GG Arnold,ENG,Pace,1975-02-28,Christchurch,New Zealand,1975,1,80,200,3,1,449,1000,7,369,800,4,64.14285714285714,>30,NZ,Away,Upto 2014
GG Arnold,ENG,Pace,1975-07-10,Birmingham,England,1975,1,91,198,3,1,502,1221,27,411,1023,24,18.59259259259259,<=30,ENG,Home,Upto 2014
GG Hall,SA,Spin,1965-01-01,Cape Town,South Africa,1965,1,94,186,1,1,605,1499,14,511,1313,13,43.214285714285715,>30,SA,Home,Upto 2014
GG Macaulay,ENG,Spin,1923-01-01,Cape Town,South Africa,1923,2,83,300,7,1,228,702,14,145,402,7,16.285714285714285,<=30,SA,Away,Upto 2014
GG Macaulay,ENG,Spin,1923-01-18,Durban,South Africa,1923,1,55,174,1,1,244,574,4,189,400,3,61.0,>30,SA,Away,Upto 2014
GG Macaulay,ENG,Spin,1923-02-09,Johannesburg,South Africa,1923,2,107,264,3,1,356,732,8,249,468,5,44.5,>30,SA,Away,Upto 2014
GG Macaulay,ENG,Spin,1923-02-16,Durban,South Africa,1923,2,81,228,5,1,141,426,6,60,198,1,23.5,<=30,SA,Away,Upto 2014
GG Macaulay,ENG,Spin,1924-07-12,Leeds,England,1924,2,83,231,2,1,557,1271,20,474,1040,18,27.85,<=30,ENG,Home,Upto 2014
GG Macaulay,ENG,Spin,1926-07-10,Leeds,England,1926,1,123,192,1,1,810,1836,19,687,1644,18,42.63157894736842,>30,ENG,Home,Upto 2014
GG Macaulay,ENG,Spin,1933-06-24,Lord's,England,1933,2,82,228,5,1,304,786,19,222,558,14,16.0,<=30,ENG,Home,Upto 2014
GG Macaulay,ENG,Spin,1933-07-22,Manchester,England,1933,1,48,84,0,1,521,1061,15,473,977,15,34.733333333333334,>30,ENG,Home,Upto 2014
GH Dockrell,IRE,Spin,2019-03-15,Dehradun,India,2019,2,121,240,2,1,656,1295,22,535,1055,20,29.818181818181817,<=30,IND,Away,After 1965
GH Dockrell,IRE,Spin,2023-04-16,Galle,Sri Lanka,2023,1,112,129,1,1,643,1027,18,531,898,17,35.72222222222222,>30,SL,Away,After 1965
GH Hirst,ENG,Pace,1897-12-13,Sydney,Australia,1897,2,106,246,0,1,722,1597,21,616,1351,21,34.38095238095238,>30,AUS,Away,After 1965
GH Hirst,ENG,Pace,1898-01-01,Melbourne,Australia,1898,1,89,150,1,1,464,1032,7,375,882,6,66.28571428571429,>30,AUS,Away,After 1965
GH Hirst,ENG,Pace,1898-01-14,Adelaide,Australia,1898,1,62,145,1,1,674,1910,19,612,1765,18,35.473684210526315,>30,AUS,Away,After 1965
GH Hirst,ENG,Pace,1898-02-26,Sydney,Australia,1898,2,47,66,0,1,648,1334,24,601,1268,24,27.0,<=30,AUS,Away,After 1965
GH Hirst,ENG,Pace,1899-06-01,Nottingham,England,1899,2,62,175,1,1,533,1449,20,471,1274,19,26.65,<=30,ENG,Home,After 1965
GH Hirst,ENG,Pace,1902-05-29,Birmingham,England,1902,2,25,120,3,1,229,582,9,204,462,6,25.444444444444443,<=30,ENG,Home,Upto 2014
GH Hirst,ENG,Pace,1902-07-03,Sheffield,England,1902,2,99,150,0,1,311,559,11,212,409,11,28.272727272727273,<=30,ENG,Home,Upto 2014
GH Hirst,ENG,Pace,1902-08-11,The Oval,England,1902,2,84,204,6,1,298,648,14,214,444,8,21.285714285714285,<=30,ENG,Home,Upto 2014
GH Hirst,ENG,Pace,1903-12-11,Sydney,Australia,1903,2,126,318,2,1,649,1476,14,523,1158,12,46.357142857142854,>30,AUS,Away,Upto 2014
GH Hirst,ENG,Pace,1904-01-01,Melbourne,Australia,1904,2,71,130,3,1,196,525,10,125,395,7,19.6,<=30,AUS,Away,Upto 2014
GH Hirst,ENG,Pace,1904-01-15,Adelaide,Australia,1904,2,94,168,3,1,683,1465,19,589,1297,16,35.94736842105263,>30,AUS,Away,Upto 2014
GH Hirst,ENG,Pace,1904-02-26,Sydney,Australia,1904,2,68,191,2,1,327,845,17,259,654,15,19.235294117647058,<=30,AUS,Away,Upto 2014
GH Hirst,ENG,Pace,1904-03-05,Melbourne,Australia,1904,2,92,215,5,1,250,529,16,158,314,11,15.625,<=30,AUS,Away,Upto 2014
GH Hirst,ENG,Pace,1905-07-03,Leeds,England,1905,2,63,102,2,1,525,1232,17,462,1130,15,30.88235294117647,>30,ENG,Home,Upto 2014
GH Hirst,ENG,Pace,1905-07-24,Manchester,England,1905,2,31,54,0,1,572,1050,20,541,996,20,28.6,<=30,ENG,Home,Upto 2014
GH Hirst,ENG,Pace,1905-08-14,The Oval,England,1905,2,118,192,4,1,775,1333,24,657,1141,20,32.291666666666664,>30,ENG,Home,Upto 2014
GH Hirst,ENG,Pace,1907-07-01,Lord's,England,1907,2,61,204,2,1,214,540,7,153,336,5,30.571428571428573,>30,ENG,Home,Upto 2014
GH Hirst,ENG,Pace,1907-07-29,Leeds,England,1907,2,43,108,2,1,113,315,7,70,207,5,16.142857142857142,<=30,ENG,Home,Upto 2014
GH Hirst,ENG,Pace,1907-08-19,The Oval,England,1907,2,81,210,6,1,261,564,14,180,354,8,18.642857142857142,<=30,ENG,Home,Upto 2014
GH Hirst,ENG,Pace,1909-05-27,Birmingham,England,1909,2,86,281,9,1,206,487,10,120,206,1,20.6,<=30,ENG,Home,Upto 2014
GH Hirst,ENG,Pace,1909-06-14,Lord's,England,1909,2,111,209,3,1,465,1001,12,354,792,9,38.75,>30,ENG,Home,Upto 2014
GH Hirst,ENG,Pace,1909-07-01,Leeds,England,1909,2,104,258,3,1,393,1142,20,289,884,17,19.65,<=30,ENG,Home,Upto 2014
GH Hirst,ENG,Pace,1909-07-26,Manchester,England,1909,2,47,114,1,1,310,803,19,263,689,18,16.31578947368421,<=30,ENG,Home,Upto 2014
GH Mudie,WI,Spin,1935-03-14,Kingston,West Indies,1935,2,40,174,3,1,453,1026,10,413,852,7,45.3,>30,WI,Home,Upto 2014
GH Pope,ENG,Pace,1947-06-21,Lord's,England,1947,2,85,218,1,1,440,1124,10,355,906,9,44.0,>30,ENG,Home,Upto 2014
GH Shepstone,SA,Pace,1896-03-02,Johannesburg,South Africa,1896,1,39,100,0,1,539,922,24,500,822,24,22.458333333333332,<=30,SA,Home,After 1965
GH Shepstone,SA,Pace,1899-02-14,Johannesburg,South Africa,1899,1,8,15,0,1,218,395,7,210,380,7,31.142857142857142,>30,SA,Home,After 1965
GH Vihari,IND,Spin,2018-09-07,The Oval,England,2018,2,38,63,3,1,513,915,16,475,852,13,32.0625,>30,ENG,Away,After 1965
GH Vihari,IND,Spin,2018-12-14,Perth,Australia,2018,2,84,168,2,1,200,497,10,116,329,8,20.0,<=30,AUS,Away,After 1965
GH Vihari,IND,Spin,2018-12-26,Melbourne,Australia,2018,2,8,36,0,1,293,756,6,285,720,6,48.833333333333336,>30,AUS,Away,After 1965
GH Vihari,IND,Spin,2019-01-03,Sydney,Australia,2019,1,2,6,0,1,448,853,11,446,847,11,40.72727272727273,>30,AUS,Away,After 1965
GH Vihari,IND,Spin,2019-08-22,North Sound,West Indies,2019,1,7,12,0,1,347,560,8,340,548,8,43.375,>30,WI,Away,After 1965
GH Vihari,IND,Spin,2019-08-30,Kingston,West Indies,2019,1,3,6,0,1,328,690,8,325,684,8,41.0,>30,WI,Away,After 1965
GH Vihari,IND,Spin,2019-10-02,Visakhapatnam,India,2019,1,38,54,0,1,1062,1652,22,1024,1598,22,48.27272727272727,>30,IND,Home,After 1965
GHS Trott,AUS,Spin,1888-08-13,The Oval,England,1888,1,25,28,0,1,208,504,11,183,476,11,18.90909090909091,<=30,ENG,Away,After 1965
GHS Trott,AUS,Spin,1890-07-21,Lord's,England,1890,1,16,15,0,1,250,845,14,234,830,14,17.857142857142858,<=30,ENG,Away,After 1965
GHS Trott,AUS,Spin,1892-01-01,Melbourne,Australia,1892,2,77,174,3,1,195,677,9,118,503,6,21.666666666666668,<=30,AUS,Home,After 1965
GHS Trott,AUS,Spin,1892-01-29,Sydney,Australia,1892,2,53,114,2,1,229,676,7,176,562,5,32.714285714285715,>30,AUS,Home,After 1965
GHS Trott,AUS,Spin,1892-03-24,Adelaide,Australia,1892,1,80,72,1,1,216,371,13,136,299,12,16.615384615384617,<=30,AUS,Home,After 1965
GHS Trott,AUS,Spin,1893-07-17,Lord's,England,1893,2,43,55,0,1,216,425,2,173,370,2,108.0,>30,ENG,Away,After 1965
GHS Trott,AUS,Spin,1893-08-14,The Oval,England,1893,1,33,30,0,1,282,513,11,249,483,11,25.636363636363637,<=30,ENG,Away,After 1965
GHS Trott,AUS,Spin,1894-12-14,Sydney,Australia,1894,2,81,166,3,1,459,958,15,378,792,12,30.6,>30,AUS,Home,After 1965
GHS Trott,AUS,Spin,1894-12-29,Melbourne,Australia,1894,1,60,102,0,1,327,823,10,267,721,10,32.7,>30,AUS,Home,After 1965
GHS Trott,AUS,Spin,1895-02-01,Sydney,Australia,1895,1,21,84,3,1,174,372,10,153,288,7,17.4,<=30,AUS,Home,After 1965
GHS Trott,AUS,Spin,1895-03-01,Melbourne,Australia,1895,2,134,265,6,1,689,1631,19,555,1366,13,36.26315789473684,>30,AUS,Home,After 1965
GHS Trott,AUS,Spin,1896-06-22,Lord's,England,1896,2,17,40,2,1,123,265,4,106,225,2,30.75,>30,ENG,Away,After 1965
GHS Trott,AUS,Spin,1896-07-16,Manchester,England,1896,2,63,85,2,1,461,941,15,398,856,13,30.733333333333334,>30,ENG,Away,After 1965
GHS Trott,AUS,Spin,1897-12-13,Sydney,Australia,1897,1,78,138,1,1,519,948,7,441,810,6,74.14285714285714,>30,AUS,Home,After 1965
GHS Trott,AUS,Spin,1898-01-01,Melbourne,Australia,1898,2,66,144,1,1,483,1191,22,417,1047,21,21.954545454545453,<=30,AUS,Home,After 1965
GHS Trott,AUS,Spin,1898-01-14,Adelaide,Australia,1898,2,32,60,0,1,414,1001,10,382,941,10,41.4,>30,AUS,Home,After 1965
GHS Trott,AUS,Spin,1898-01-29,Melbourne,Australia,1898,2,72,139,3,1,328,761,11,256,622,8,29.818181818181817,<=30,AUS,Home,After 1965
GHS Trott,AUS,Spin,1898-02-26,Sydney,Australia,1898,2,68,180,2,1,340,888,10,272,708,8,34.0,>30,AUS,Home,After 1965
GHT Simpson-Hayward,ENG,Spin,1910-01-01,Johannesburg,South Africa,1910,2,102,240,8,1,593,1077,29,491,837,21,20.448275862068964,<=30,SA,Away,Upto 2014
GHT Simpson-Hayward,ENG,Spin,1910-01-21,Durban,South Africa,1910,2,108,281,7,1,565,1312,24,457,1031,17,23.541666666666668,<=30,SA,Away,Upto 2014
GHT Simpson-Hayward,ENG,Spin,1910-02-26,Johannesburg,South Africa,1910,2,115,216,6,1,662,1226,24,547,1010,18,27.583333333333332,<=30,SA,Away,Upto 2014
GHT Simpson-Hayward,ENG,Spin,1910-03-07,Cape Town,South Africa,1910,2,45,84,1,1,379,765,17,334,681,16,22.294117647058822,<=30,SA,Away,Upto 2014
GHT Simpson-Hayward,ENG,Spin,1910-03-11,Cape Town,South Africa,1910,2,50,77,1,1,488,932,19,438,855,18,25.68421052631579,<=30,SA,Away,Upto 2014
GI Allott,NZ,Pace,1996-01-13,Hamilton,New Zealand,1996,2,100,144,1,1,657,1344,21,557,1200,20,31.285714285714285,>30,NZ,Home,Upto 2014
GI Allott,NZ,Pace,1996-01-20,Auckland,New Zealand,1996,2,109,252,3,1,908,2025,23,799,1773,20,39.47826086956522,>30,NZ,Home,Upto 2014
GI Allott,NZ,Pace,1997-02-06,Wellington,New Zealand,1997,1,91,186,1,1,457,1115,23,366,929,22,19.869565217391305,<=30,NZ,Home,Upto 2014
GI Allott,NZ,Pace,1997-02-14,Christchurch,New Zealand,1997,2,106,184,4,1,695,1595,19,589,1411,15,36.578947368421055,>30,NZ,Home,Upto 2014
GI Allott,NZ,Pace,1997-11-07,Brisbane,Australia,1997,2,177,305,2,1,809,1711,25,632,1406,23,32.36,>30,AUS,Away,Upto 2014
GI Allott,NZ,Pace,1997-11-20,W.A.C.A,Australia,1997,1,84,132,0,1,605,1158,21,521,1026,21,28.80952380952381,<=30,AUS,Away,Upto 2014
GI Allott,NZ,Pace,1999-02-27,Auckland,New Zealand,1999,1,153,228,1,1,841,1949,13,688,1721,12,64.6923076923077,>30,NZ,Home,Upto 2014
GI Allott,NZ,Pace,1999-03-11,Christchurch,New Zealand,1999,1,109,258,0,1,581,1404,8,472,1146,8,72.625,>30,NZ,Home,Upto 2014
GI Allott,NZ,Pace,1999-07-01,Birmingham,England,1999,2,109,174,4,1,580,1146,27,471,972,23,21.48148148148148,<=30,ENG,Away,Upto 2014
GI Allott,NZ,Pace,1999-07-22,Lord's,England,1999,2,73,160,3,1,642,1427,25,569,1267,22,25.68,<=30,ENG,Away,Upto 2014
GI Hume,IRE,Pace,2023-04-04,Mirpur,Bangladesh,2023,1,37,66,0,1,400,606,10,363,540,10,40.0,>30,BAN,Away,After 1965
GI Hume,IRE,Pace,2023-04-24,Galle,Sri Lanka,2023,1,87,132,1,1,403,633,9,316,501,8,44.77777777777778,>30,SL,Away,After 1965
GI Hume,IRE,Pace,2023-06-01,Lord's,England,2023,1,85,102,1,1,757,1010,16,672,908,15,47.3125,>30,ENG,Away,After 1965
GJ Batty,ENG,Spin,2003-10-21,Dhaka,Bangladesh,2003,2,108,246,2,1,443,953,10,335,707,8,44.3,>30,BAN,Away,Upto 2014
GJ Batty,ENG,Spin,2003-12-02,Galle,Sri Lanka,2003,2,153,326,5,1,603,1823,28,450,1497,23,21.535714285714285,<=30,SL,Away,Upto 2014
GJ Batty,ENG,Spin,2003-12-10,Kandy,Sri Lanka,2003,2,106,174,1,1,692,1702,20,586,1528,19,34.6,>30,SL,Away,Upto 2014
GJ Batty,ENG,Spin,2003-12-18,Colombo (SSC),Sri Lanka,2003,1,137,246,0,1,552,1368,13,415,1122,13,42.46153846153846,>30,SL,Away,Upto 2014
GJ Batty,ENG,Spin,2004-04-10,St John's,West Indies,2004,1,185,312,2,1,477,993,7,292,681,5,68.14285714285714,>30,WI,Away,Upto 2014
GJ Batty,ENG,Spin,2005-06-03,Chester-le-Street,England,2005,1,44,90,1,1,151,198,1,107,108,0,151.0,>30,ENG,Home,Upto 2014
GJ Batty,ENG,Spin,2016-10-20,Chattogram,Bangladesh,2016,2,116,204,4,1,760,1579,30,644,1375,26,25.333333333333332,<=30,BAN,Away,After 1965
GJ Batty,ENG,Spin,2016-11-26,Mohali,India,2016,2,65,116,0,1,572,1216,17,507,1100,17,33.64705882352941,>30,IND,Away,After 1965
GJ Bonnor,AUS,Pace,1884-07-10,Manchester,England,1884,1,5,16,1,1,208,652,12,203,636,11,17.333333333333332,<=30,ENG,Away,After 1965
GJ Bonnor,AUS,Pace,1884-07-21,Lord's,England,1884,1,23,32,1,1,404,842,13,381,810,12,31.076923076923077,>30,ENG,Away,After 1965
GJ Bonnor,AUS,Pace,1884-08-11,The Oval,England,1884,1,33,52,0,1,468,1104,7,435,1052,7,66.85714285714286,>30,ENG,Away,After 1965
GJ Bonnor,AUS,Pace,1884-12-12,Adelaide,Australia,1884,1,23,64,0,1,319,830,6,296,766,6,53.166666666666664,>30,AUS,Home,After 1965
GJ Cosier,AUS,Pace,1975-12-26,Melbourne,Australia,1975,1,15,32,0,1,804,1499,27,789,1467,27,29.77777777777778,<=30,AUS,Home,Upto 2014
GJ Cosier,AUS,Pace,1976-01-03,Sydney,Australia,1976,1,13,24,0,1,784,1539,30,771,1515,30,26.133333333333333,<=30,AUS,Home,Upto 2014
GJ Cosier,AUS,Pace,1976-01-23,Adelaide,Australia,1976,1,23,40,0,1,939,1486,26,916,1446,26,36.11538461538461,>30,AUS,Home,Upto 2014
GJ Cosier,AUS,Pace,1976-12-24,Adelaide,Australia,1976,1,11,40,0,1,783,1646,15,772,1606,15,52.2,>30,AUS,Home,Upto 2014
GJ Cosier,AUS,Pace,1977-01-01,Melbourne,Australia,1977,1,10,16,0,1,882,1510,22,872,1494,22,40.09090909090909,>30,AUS,Home,Upto 2014
GJ Cosier,AUS,Pace,1977-12-02,Brisbane,Australia,1977,2,16,64,0,1,540,1279,27,524,1215,27,20.0,<=30,AUS,Home,Upto 2014
GJ Cosier,AUS,Pace,1977-12-30,Melbourne,Australia,1977,2,83,199,2,1,588,1273,19,505,1074,17,30.94736842105263,>30,AUS,Home,Upto 2014
GJ Cosier,AUS,Pace,1978-01-07,Sydney,Australia,1978,1,26,72,2,1,322,871,11,296,799,9,29.272727272727273,<=30,AUS,Home,Upto 2014
GJ Cosier,AUS,Pace,1978-01-28,Adelaide,Australia,1978,2,25,136,0,1,564,1391,22,539,1255,22,25.636363636363637,<=30,AUS,Home,Upto 2014
GJ Cosier,AUS,Pace,1978-03-03,Port of Spain,West Indies,1978,1,45,78,0,1,396,789,19,351,711,19,20.842105263157894,<=30,WI,Away,Upto 2014
GJ Cosier,AUS,Pace,1978-03-17,Bridgetown,West Indies,1978,1,24,54,0,1,577,955,26,553,901,26,22.192307692307693,<=30,WI,Away,Upto 2014
GJ Cosier,AUS,Pace,1978-03-31,Georgetown,West Indies,1978,2,15,48,1,1,786,1458,28,771,1410,27,28.071428571428573,<=30,WI,Away,Upto 2014
GJ Cosier,AUS,Pace,1978-12-01,Brisbane,Australia,1978,2,21,64,0,1,633,1750,28,612,1686,28,22.607142857142858,<=30,AUS,Home,Upto 2014
GJ Cosier,AUS,Pace,1978-12-15,W.A.C.A,Australia,1978,1,14,32,0,1,652,1878,31,638,1846,31,21.032258064516128,<=30,AUS,Home,Upto 2014
GJ Crocker,ZIM,Pace,1992-10-18,Harare,Zimbabwe,1992,1,41,210,1,1,480,1630,15,439,1420,14,32.0,>30,ZIM,Home,Upto 2014
GJ Crocker,ZIM,Pace,1992-11-01,Bulawayo,Zimbabwe,1992,2,87,114,0,1,481,878,7,394,764,7,68.71428571428571,>30,ZIM,Home,Upto 2014
GJ Crocker,ZIM,Pace,1992-11-07,Harare,Zimbabwe,1992,2,89,132,2,1,623,1378,20,534,1246,18,31.15,>30,ZIM,Home,Upto 2014
GJ Gilmour,AUS,Pace,1973-12-29,Melbourne,Australia,1973,2,91,200,4,1,539,1189,14,448,989,10,38.5,>30,AUS,Home,Upto 2014
GJ Gilmour,AUS,Pace,1974-01-05,Sydney,Australia,1974,2,140,320,4,1,618,1375,28,478,1055,24,22.071428571428573,<=30,AUS,Home,Upto 2014
GJ Gilmour,AUS,Pace,1974-03-22,Auckland,New Zealand,1974,2,116,248,7,1,628,1262,29,512,1014,22,21.655172413793103,<=30,NZ,Away,Upto 2014
GJ Gilmour,AUS,Pace,1975-08-14,Leeds,England,1975,2,157,308,9,1,612,1447,21,455,1139,12,29.142857142857142,<=30,ENG,Away,Upto 2014
GJ Gilmour,AUS,Pace,1975-11-28,Brisbane,Australia,1975,2,68,184,6,1,663,1224,17,595,1040,11,39.0,>30,AUS,Home,Upto 2014
GJ Gilmour,AUS,Pace,1975-12-12,W.A.C.A,Australia,1975,1,103,112,2,1,857,1286,28,754,1174,26,30.607142857142858,>30,AUS,Home,Upto 2014
GJ Gilmour,AUS,Pace,1976-01-03,Sydney,Australia,1976,2,94,200,2,1,784,1539,30,690,1339,28,26.133333333333333,<=30,AUS,Home,Upto 2014
GJ Gilmour,AUS,Pace,1976-01-23,Adelaide,Australia,1976,2,81,150,5,1,939,1486,26,858,1336,21,36.11538461538461,>30,AUS,Home,Upto 2014
GJ Gilmour,AUS,Pace,1976-01-31,Melbourne,Australia,1976,2,60,136,5,1,775,1378,27,715,1242,22,28.703703703703702,<=30,AUS,Home,Upto 2014
GJ Gilmour,AUS,Pace,1976-12-24,Adelaide,Australia,1976,2,122,226,2,1,783,1646,15,661,1420,13,52.2,>30,AUS,Home,Upto 2014
GJ Gilmour,AUS,Pace,1977-01-01,Melbourne,Australia,1977,2,97,153,3,1,882,1510,22,785,1357,19,40.09090909090909,>30,AUS,Home,Upto 2014
GJ Gilmour,AUS,Pace,1977-01-14,Sydney,Australia,1977,1,81,128,3,1,681,1364,30,600,1236,27,22.7,<=30,AUS,Home,Upto 2014
GJ Gilmour,AUS,Pace,1977-02-18,Christchurch,New Zealand,1977,2,96,160,1,1,990,2047,22,894,1887,21,45.0,>30,NZ,Away,Upto 2014
GJ Gilmour,AUS,Pace,1977-02-25,Auckland,New Zealand,1977,2,67,64,1,1,733,1600,29,666,1536,28,25.275862068965516,<=30,NZ,Away,Upto 2014
GJ Gilmour,AUS,Pace,1977-03-12,Melbourne,Australia,1977,2,33,72,0,1,769,1725,30,736,1653,30,25.633333333333333,<=30,AUS,Home,Upto 2014
GJ Maxwell,AUS,Spin,2013-03-02,Hyderabad,India,2013,1,127,156,4,1,504,1093,21,377,937,17,24.0,<=30,IND,Away,Upto 2014
GJ Maxwell,AUS,Spin,2013-03-22,Delhi,India,2013,2,66,90,3,1,535,1112,29,469,1022,26,18.448275862068964,<=30,IND,Away,Upto 2014
GJ Maxwell,AUS,Spin,2014-10-30,Abu Dhabi,UAE,2014,1,78,96,0,1,756,1259,18,678,1163,18,42.0,>30,UAE,Away,After 1965
GJ Maxwell,AUS,Spin,2017-03-16,Ranchi,India,2017,1,13,24,0,1,755,1725,15,742,1701,15,50.333333333333336,>30,IND,Away,After 1965
GJ Maxwell,AUS,Spin,2017-03-25,Dharamsala,India,2017,1,5,12,0,1,468,1025,18,463,1013,18,26.0,<=30,IND,Away,After 1965
GJ Maxwell,AUS,Spin,2017-08-27,Mirpur,Bangladesh,2017,2,39,60,1,1,693,1433,34,654,1373,33,20.38235294117647,<=30,BAN,Away,After 1965
GJ Maxwell,AUS,Spin,2017-09-04,Chattogram,Bangladesh,2017,1,13,24,0,1,709,1537,24,696,1513,24,29.541666666666668,<=30,BAN,Away,After 1965
GJ Rennie,ZIM,Spin,2000-09-12,Bulawayo,Zimbabwe,2000,1,40,81,1,1,456,1365,20,416,1284,19,22.8,<=30,ZIM,Home,Upto 2014
GJ Rennie,ZIM,Spin,2000-09-19,Harare,Zimbabwe,2000,1,16,18,0,1,218,549,3,202,531,3,72.66666666666667,>30,ZIM,Home,Upto 2014
GJ Rennie,ZIM,Spin,2000-11-18,Delhi,India,2000,1,19,21,0,1,622,1309,9,603,1288,9,69.11111111111111,>30,IND,Away,Upto 2014
GJ Rennie,ZIM,Spin,2002-01-12,Galle,Sri Lanka,2002,1,9,6,0,1,515,1423,24,506,1417,24,21.458333333333332,<=30,SL,Away,Upto 2014
GJ Thompson,ENG,Pace,1909-05-27,Birmingham,England,1909,1,19,24,0,1,206,487,10,187,463,10,20.6,<=30,ENG,Home,Upto 2014
GJ Thompson,ENG,Pace,1910-01-01,Johannesburg,South Africa,1910,2,125,234,1,1,440,846,11,315,612,10,40.0,>30,SA,Away,Upto 2014
GJ Thompson,ENG,Pace,1910-01-21,Durban,South Africa,1910,2,130,398,5,1,379,1058,15,249,660,10,25.266666666666666,<=30,SA,Away,Upto 2014
GJ Thompson,ENG,Pace,1910-02-26,Johannesburg,South Africa,1910,2,128,240,5,1,366,667,10,238,427,5,36.6,>30,SA,Away,Upto 2014
GJ Thompson,ENG,Pace,1910-03-07,Cape Town,South Africa,1910,2,112,219,7,1,321,621,18,209,402,11,17.833333333333332,<=30,SA,Away,Upto 2014
GJ Thompson,ENG,Pace,1910-03-11,Cape Town,South Africa,1910,2,124,252,5,1,301,570,12,177,318,7,25.083333333333332,<=30,SA,Away,Upto 2014
GJ Whittall,ZIM,Pace,1993-12-01,Karachi,Pakistan,1993,1,26,72,1,1,605,1326,22,579,1254,21,27.5,<=30,PAK,Away,Upto 2014
GJ Whittall,ZIM,Pace,1993-12-09,Rawalpindi,Pakistan,1993,2,49,126,0,1,816,1939,40,767,1813,40,20.4,<=30,PAK,Away,Upto 2014
GJ Whittall,ZIM,Pace,1993-12-16,Lahore,Pakistan,1993,1,17,65,0,1,467,1213,21,450,1148,21,22.238095238095237,<=30,PAK,Away,Upto 2014
GJ Whittall,ZIM,Pace,1994-10-11,Harare,Zimbabwe,1994,1,70,198,4,1,445,1241,16,375,1043,12,27.8125,<=30,ZIM,Home,Upto 2014
GJ Whittall,ZIM,Pace,1994-10-20,Bulawayo,Zimbabwe,1994,2,64,205,3,1,524,1630,17,460,1425,14,30.823529411764707,>30,ZIM,Home,Upto 2014
GJ Whittall,ZIM,Pace,1994-10-26,Harare,Zimbabwe,1994,1,74,168,0,1,659,1576,19,585,1408,19,34.68421052631579,>30,ZIM,Home,Upto 2014
GJ Whittall,ZIM,Pace,1995-01-31,Harare,Zimbabwe,1995,2,107,270,5,1,693,1542,23,586,1272,18,30.130434782608695,>30,ZIM,Home,Upto 2014
GJ Whittall,ZIM,Pace,1995-02-07,Bulawayo,Zimbabwe,1995,1,42,90,1,1,563,1357,30,521,1267,29,18.766666666666666,<=30,ZIM,Home,Upto 2014
GJ Whittall,ZIM,Pace,1995-02-15,Harare,Zimbabwe,1995,2,139,240,4,1,795,1808,39,656,1568,35,20.384615384615383,<=30,ZIM,Home,Upto 2014
GJ Whittall,ZIM,Pace,1995-10-13,Harare,Zimbabwe,1995,1,11,12,0,1,728,1549,32,717,1537,32,22.75,<=30,ZIM,Home,Upto 2014
GJ Whittall,ZIM,Pace,1996-01-20,Auckland,New Zealand,1996,2,76,150,1,1,908,2025,23,832,1875,22,39.47826086956522,>30,NZ,Away,Upto 2014
GJ Whittall,ZIM,Pace,1996-09-11,Colombo (RPS),Sri Lanka,1996,1,43,72,0,1,295,564,9,252,492,9,32.77777777777778,>30,SL,Away,Upto 2014
GJ Whittall,ZIM,Pace,1996-09-18,Colombo (SSC),Sri Lanka,1996,1,48,101,1,1,332,732,8,284,631,7,41.5,>30,SL,Away,Upto 2014
GJ Whittall,ZIM,Pace,1996-10-17,Sheikhupura,Pakistan,1996,1,73,150,2,1,489,1024,12,416,874,10,40.75,>30,PAK,Away,Upto 2014
GJ Whittall,ZIM,Pace,1996-10-24,Faisalabad,Pakistan,1996,1,11,42,0,1,475,908,25,464,866,25,19.0,<=30,PAK,Away,Upto 2014
GJ Whittall,ZIM,Pace,1996-12-18,Bulawayo,Zimbabwe,1996,2,35,72,1,1,665,1230,17,630,1158,16,39.11764705882353,>30,ZIM,Home,Upto 2014
GJ Whittall,ZIM,Pace,1996-12-26,Harare,Zimbabwe,1996,2,34,180,4,1,330,1045,15,296,865,11,22.0,<=30,ZIM,Home,Upto 2014
GJ Whittall,ZIM,Pace,1997-09-18,Harare,Zimbabwe,1997,2,34,60,0,1,808,1794,25,774,1734,25,32.32,>30,ZIM,Home,Upto 2014
GJ Whittall,ZIM,Pace,1997-09-25,Bulawayo,Zimbabwe,1997,1,14,36,0,1,606,1326,9,592,1290,9,67.33333333333333,>30,ZIM,Home,Upto 2014
GJ Whittall,ZIM,Pace,1998-01-14,Colombo (SSC),Sri Lanka,1998,2,30,60,0,1,369,728,14,339,668,14,26.357142857142858,<=30,SL,Away,Upto 2014
GJ Whittall,ZIM,Pace,1998-02-19,Wellington,New Zealand,1998,1,12,30,0,1,429,1062,17,417,1032,17,25.235294117647058,<=30,NZ,Away,Upto 2014
GJ Whittall,ZIM,Pace,1998-02-26,Auckland,New Zealand,1998,1,68,84,0,1,557,1155,25,489,1071,25,22.28,<=30,NZ,Away,Upto 2014
GJ Whittall,ZIM,Pace,1998-03-14,Bulawayo,Zimbabwe,1998,2,124,270,4,1,726,1690,25,602,1420,21,29.04,<=30,ZIM,Home,Upto 2014
GJ Whittall,ZIM,Pace,1998-03-21,Harare,Zimbabwe,1998,2,113,287,5,1,727,1780,29,614,1493,24,25.06896551724138,<=30,ZIM,Home,Upto 2014
GJ Whittall,ZIM,Pace,1999-10-14,Harare,Zimbabwe,1999,1,74,130,1,1,535,1322,16,461,1192,15,33.4375,>30,ZIM,Home,Upto 2014
GJ Whittall,ZIM,Pace,1999-10-29,Bloemfontein,South Africa,1999,1,95,180,2,1,728,1549,24,633,1369,22,30.333333333333332,>30,SA,Away,Upto 2014
GJ Whittall,ZIM,Pace,1999-11-11,Harare,Zimbabwe,1999,1,78,162,0,1,560,1277,25,482,1115,25,22.4,<=30,ZIM,Home,Upto 2014
GJ Whittall,ZIM,Pace,1999-11-18,Bulawayo,Zimbabwe,1999,1,48,84,0,1,569,1220,18,521,1136,18,31.61111111111111,>30,ZIM,Home,Upto 2014
GJ Whittall,ZIM,Pace,1999-11-26,Harare,Zimbabwe,1999,1,60,114,1,1,681,1742,19,621,1628,18,35.8421052631579,>30,ZIM,Home,Upto 2014
GJ Whittall,ZIM,Pace,1999-12-04,Harare,Zimbabwe,1999,1,37,102,2,1,525,1358,25,488,1256,23,21.0,<=30,ZIM,Home,Upto 2014
GJ Whittall,ZIM,Pace,2000-05-18,Lord's,England,2000,1,27,42,3,1,527,1078,29,500,1036,26,18.17241379310345,<=30,ENG,Away,Upto 2014
GJ Whittall,ZIM,Pace,2000-06-01,Nottingham,England,2000,2,61,162,5,1,655,1521,23,594,1359,18,28.47826086956522,<=30,ENG,Away,Upto 2014
GJ Whittall,ZIM,Pace,2000-12-26,Wellington,New Zealand,2000,2,57,156,0,1,550,1397,13,493,1241,13,42.30769230769231,>30,NZ,Away,Upto 2014
GJ Whittall,ZIM,Pace,2001-06-15,Harare,Zimbabwe,2001,1,15,42,0,1,726,1580,27,711,1538,27,26.88888888888889,<=30,ZIM,Home,Upto 2014
GJ Whittall,ZIM,Pace,2001-07-19,Bulawayo,Zimbabwe,2001,1,2,6,0,1,603,1276,18,601,1270,18,33.5,>30,ZIM,Home,Upto 2014
GJ Whittall,ZIM,Pace,2001-09-07,Harare,Zimbabwe,2001,1,34,72,0,1,919,1718,19,885,1646,19,48.36842105263158,>30,ZIM,Home,Upto 2014
GJ Whittall,ZIM,Pace,2001-09-14,Bulawayo,Zimbabwe,2001,1,80,178,0,1,548,1308,7,468,1130,7,78.28571428571429,>30,ZIM,Home,Upto 2014
GJ Whittall,ZIM,Pace,2002-11-09,Harare,Zimbabwe,2002,2,106,216,1,1,875,1422,31,769,1206,30,28.225806451612904,<=30,ZIM,Home,Upto 2014
GK Glover,SA,Spin,1896-03-21,Cape Town,South Africa,1896,1,28,65,1,1,223,529,14,195,464,13,15.928571428571429,<=30,SA,Home,After 1965
GK Robertson,NZ,Pace,1986-03-13,Auckland,New Zealand,1986,1,91,144,1,1,481,1210,15,390,1066,14,32.06666666666667,>30,NZ,Home,Upto 2014
GL Gibbs,WI,Spin,1955-03-26,Kingston,West Indies,1955,2,7,24,0,1,550,1394,11,543,1370,11,50.0,>30,WI,Home,Upto 2014
GL Jessop,ENG,Pace,1899-06-15,Lord's,England,1899,2,124,216,3,1,490,1002,18,366,786,15,27.22222222222222,<=30,ENG,Home,After 1965
GL Jessop,ENG,Pace,1901-12-13,Sydney,Australia,1901,1,4,6,0,1,416,1027,14,412,1021,14,29.714285714285715,<=30,AUS,Away,Upto 2014
GL Jessop,ENG,Pace,1902-01-01,Melbourne,Australia,1902,1,9,6,0,1,229,661,13,220,655,13,17.615384615384617,<=30,AUS,Away,Upto 2014
GL Jessop,ENG,Pace,1902-01-17,Adelaide,Australia,1902,2,60,180,2,1,342,876,5,282,696,3,68.4,>30,AUS,Away,Upto 2014
GL Jessop,ENG,Pace,1902-02-14,Sydney,Australia,1902,2,91,198,4,1,131,330,4,40,132,0,32.75,>30,AUS,Away,Upto 2014
GL Jessop,ENG,Pace,1902-02-28,Melbourne,Australia,1902,1,13,6,0,1,141,297,8,128,291,8,17.625,<=30,AUS,Away,Upto 2014
GL Jessop,ENG,Pace,1902-07-03,Sheffield,England,1902,1,15,24,0,1,311,559,11,296,535,11,28.272727272727273,<=30,ENG,Home,Upto 2014
GL Jessop,ENG,Pace,1902-08-11,The Oval,England,1902,1,11,36,0,1,298,648,14,287,612,14,21.285714285714285,<=30,ENG,Home,Upto 2014
GL Jessop,ENG,Pace,1905-05-29,Nottingham,England,1905,2,19,48,1,1,577,1196,21,558,1148,20,27.476190476190474,<=30,ENG,Home,Upto 2014
GL Jessop,ENG,Pace,1907-07-01,Lord's,England,1907,1,8,12,0,1,214,540,7,206,528,7,30.571428571428573,>30,ENG,Home,Upto 2014
GL Weir,NZ,Pace,1930-01-24,Wellington,New Zealand,1930,1,1,12,1,1,569,1265,15,568,1253,14,37.93333333333333,>30,NZ,Home,Upto 2014
GL Weir,NZ,Pace,1930-02-14,Auckland,New Zealand,1930,1,20,24,0,1,146,336,1,126,312,1,146.0,>30,NZ,Home,Upto 2014
GL Weir,NZ,Pace,1930-02-21,Auckland,New Zealand,1930,1,29,60,1,1,366,961,11,337,901,10,33.27272727272727,>30,NZ,Home,Upto 2014
GL Weir,NZ,Pace,1931-06-27,Lord's,England,1931,2,56,78,3,1,463,1131,13,407,1053,10,35.61538461538461,>30,ENG,Away,Upto 2014
GL Weir,NZ,Pace,1931-07-29,The Oval,England,1931,1,36,60,0,1,180,402,5,144,342,5,36.0,>30,ENG,Away,Upto 2014
GL Weir,NZ,Pace,1933-03-24,Christchurch,New Zealand,1933,1,28,42,0,1,467,920,9,439,878,9,51.888888888888886,>30,NZ,Home,Upto 2014
GL Weir,NZ,Pace,1933-03-31,Auckland,New Zealand,1933,1,39,66,2,1,344,794,12,305,728,10,28.666666666666668,<=30,NZ,Home,Upto 2014
GM Carew,WI,Spin,1948-12-31,Eden Gardens,India,1948,1,2,18,0,1,677,1523,19,675,1505,19,35.63157894736842,>30,IND,Away,Upto 2014
GM Ewing,ZIM,Spin,2003-10-17,Sydney,Australia,2003,2,73,84,0,1,468,933,15,395,849,15,31.2,>30,AUS,Away,Upto 2014
GM Ewing,ZIM,Spin,2004-02-19,Harare,Zimbabwe,2004,2,46,90,1,1,538,1129,14,492,1039,13,38.42857142857143,>30,ZIM,Home,Upto 2014
GM Ewing,ZIM,Spin,2005-09-13,Bulawayo,Zimbabwe,2005,1,141,252,1,1,509,995,11,368,743,10,46.27272727272727,>30,ZIM,Home,Upto 2014
GM Griffin,SA,Pace,1960-06-09,Birmingham,England,1960,2,105,252,4,1,549,1558,25,444,1306,21,21.96,<=30,ENG,Away,Upto 2014
GM Griffin,SA,Pace,1960-06-23,Lord's,England,1960,1,87,180,4,1,549,1209,28,462,1029,24,19.607142857142858,<=30,ENG,Away,Upto 2014
GM Guard,IND,Pace,1958-11-28,Brabourne,India,1958,2,88,192,3,1,439,1262,18,351,1070,15,24.38888888888889,<=30,IND,Home,Upto 2014
GM Guard,IND,Pace,1960-01-01,Brabourne,India,1960,2,94,204,0,1,552,1475,15,458,1271,15,36.8,>30,IND,Home,Upto 2014
GM Hamilton,ENG,Pace,1999-11-25,Johannesburg,South Africa,1999,1,63,90,0,1,668,1442,28,605,1352,28,23.857142857142858,<=30,SA,Away,Upto 2014
GM Parker,SA,Pace,1924-06-14,Birmingham,England,1924,1,152,222,6,1,406,735,19,254,513,13,21.36842105263158,<=30,ENG,Away,Upto 2014
GM Parker,SA,Pace,1924-06-28,Lord's,England,1924,1,121,144,2,1,434,750,7,313,606,5,62.0,>30,ENG,Away,Upto 2014
GM Ritchie,AUS,Pace,1985-07-11,Nottingham,England,1985,1,10,6,0,1,706,1344,15,696,1338,15,47.06666666666667,>30,ENG,Away,Upto 2014
GM Turner,NZ,Spin,1972-04-06,Georgetown,West Indies,1972,1,5,12,0,1,489,1488,3,484,1476,3,163.0,>30,WI,Away,Upto 2014
GN Francis,WI,Pace,1928-06-23,Lord's,England,1928,1,72,150,2,1,399,886,12,327,736,10,33.25,>30,ENG,Away,Upto 2014
GN Francis,WI,Pace,1928-07-21,Manchester,England,1928,1,68,138,0,1,337,660,7,269,522,7,48.142857142857146,>30,ENG,Away,Upto 2014
GN Francis,WI,Pace,1928-08-11,The Oval,England,1928,1,112,162,4,1,476,809,16,364,647,12,29.75,<=30,ENG,Away,Upto 2014
GN Francis,WI,Pace,1930-02-21,Georgetown,West Indies,1930,2,109,287,6,1,688,1706,25,579,1419,19,27.52,<=30,WI,Home,Upto 2014
GN Francis,WI,Pace,1930-12-12,Adelaide,Australia,1930,2,73,168,2,1,453,957,5,380,789,3,90.6,>30,AUS,Away,Upto 2014
GN Francis,WI,Pace,1931-01-01,Sydney,Australia,1931,1,70,162,2,1,284,648,9,214,486,7,31.555555555555557,>30,AUS,Away,Upto 2014
GN Francis,WI,Pace,1931-01-16,Brisbane,Australia,1931,1,76,156,3,1,443,984,16,367,828,13,27.6875,<=30,AUS,Away,Upto 2014
GN Francis,WI,Pace,1931-02-13,Melbourne,Australia,1931,1,51,78,0,1,238,438,7,187,360,7,34.0,>30,AUS,Away,Upto 2014
GN Francis,WI,Pace,1931-02-27,Sydney,Australia,1931,2,80,210,4,1,407,995,14,327,785,10,29.071428571428573,<=30,AUS,Away,Upto 2014
GN Francis,WI,Pace,1933-06-24,Lord's,England,1933,1,52,108,0,1,246,540,10,194,432,10,24.6,<=30,ENG,Away,Upto 2014
GN Yallop,AUS,Pace,1978-04-28,Kingston,West Indies,1978,1,8,18,0,1,520,1042,12,512,1024,12,43.333333333333336,>30,WI,Away,Upto 2014
GN Yallop,AUS,Pace,1979-09-11,Chennai,India,1979,1,21,36,1,1,448,938,6,427,902,5,74.66666666666667,>30,IND,Away,Upto 2014
GN Yallop,AUS,Pace,1979-09-19,Bengaluru,India,1979,1,6,12,0,1,384,678,4,378,666,4,96.0,>30,IND,Away,Upto 2014
GN Yallop,AUS,Pace,1979-10-13,Delhi,India,1979,1,21,30,0,1,509,1106,14,488,1076,14,36.357142857142854,>30,IND,Away,Upto 2014
GN Yallop,AUS,Pace,1979-10-26,Eden Gardens,India,1979,2,2,12,0,1,481,1011,15,479,999,15,32.06666666666667,>30,IND,Away,Upto 2014
GN Yallop,AUS,Pace,1979-11-03,Wankhede,India,1979,1,12,6,0,1,295,643,9,283,637,9,32.77777777777778,>30,IND,Away,Upto 2014
GN Yallop,AUS,Pace,1980-02-27,Karachi,Pakistan,1980,1,14,12,0,1,240,648,5,226,636,5,48.0,>30,PAK,Away,Upto 2014
GN Yallop,AUS,Pace,1980-03-06,Faisalabad,Pakistan,1980,1,15,18,0,1,357,750,4,342,732,4,89.25,>30,PAK,Away,Upto 2014
GN Yallop,AUS,Pace,1981-08-27,The Oval,England,1981,1,17,48,0,1,972,2088,35,955,2040,35,27.771428571428572,<=30,ENG,Away,Upto 2014
GO Rabone,NZ,Spin,1949-06-11,Leeds,England,1949,2,112,210,0,1,545,1101,10,433,891,10,54.5,>30,ENG,Away,Upto 2014
GO Rabone,NZ,Spin,1949-06-25,Lord's,England,1949,2,172,252,4,1,624,1342,19,452,1090,15,32.8421052631579,>30,ENG,Away,Upto 2014
GO Rabone,NZ,Spin,1949-07-23,Manchester,England,1949,1,43,60,0,1,586,1224,13,543,1164,13,45.07692307692308,>30,ENG,Away,Upto 2014
GO Rabone,NZ,Spin,1952-02-08,Christchurch,New Zealand,1952,1,17,36,0,1,593,1754,25,576,1718,25,23.72,<=30,NZ,Home,Upto 2014
GO Rabone,NZ,Spin,1952-02-15,Auckland,New Zealand,1952,1,48,90,0,1,442,1192,12,394,1102,12,36.833333333333336,>30,NZ,Home,Upto 2014
GO Rabone,NZ,Spin,1953-03-13,Auckland,New Zealand,1953,2,108,246,4,1,495,1529,18,387,1283,14,27.5,<=30,NZ,Home,Upto 2014
GO Rabone,NZ,Spin,1953-12-11,Durban,South Africa,1953,1,31,64,1,1,371,1319,16,340,1255,15,23.1875,<=30,SA,Away,Upto 2014
GO Rabone,NZ,Spin,1953-12-24,Johannesburg,South Africa,1953,1,16,24,0,1,206,522,9,190,498,9,22.88888888888889,<=30,SA,Away,Upto 2014
GO Rabone,NZ,Spin,1954-01-01,Cape Town,South Africa,1954,2,84,391,7,1,639,1815,13,555,1424,6,49.15384615384615,>30,SA,Away,Upto 2014
GO Rabone,NZ,Spin,1955-03-25,Auckland,New Zealand,1955,1,4,12,0,1,138,529,7,134,517,7,19.714285714285715,<=30,NZ,Home,Upto 2014
GOB Allen,ENG,Pace,1930-06-27,Lord's,England,1930,1,115,204,0,1,579,1102,10,464,898,10,57.9,>30,ENG,Home,Upto 2014
GOB Allen,ENG,Pace,1931-06-27,Lord's,England,1931,2,92,240,3,1,463,1131,13,371,891,10,35.61538461538461,>30,ENG,Home,Upto 2014
GOB Allen,ENG,Pace,1931-07-29,The Oval,England,1931,2,37,156,5,1,180,402,5,143,246,0,36.0,>30,ENG,Home,Upto 2014
GOB Allen,ENG,Pace,1932-12-02,Sydney,Australia,1932,2,78,144,1,1,694,1474,26,616,1330,25,26.692307692307693,<=30,AUS,Away,Upto 2014
GOB Allen,ENG,Pace,1932-12-30,Melbourne,Australia,1932,2,85,174,4,1,475,1034,22,390,860,18,21.59090909090909,<=30,AUS,Away,Upto 2014
GOB Allen,ENG,Pace,1933-01-13,Adelaide,Australia,1933,2,121,242,8,1,549,1333,23,428,1091,15,23.869565217391305,<=30,AUS,Away,Upto 2014
GOB Allen,ENG,Pace,1933-02-10,Brisbane,Australia,1933,2,127,246,5,1,508,1171,18,381,925,13,28.22222222222222,<=30,AUS,Away,Upto 2014
GOB Allen,ENG,Pace,1933-02-23,Sydney,Australia,1933,2,182,220,3,1,693,1194,12,511,974,9,57.75,>30,AUS,Away,Upto 2014
GOB Allen,ENG,Pace,1933-03-24,Christchurch,New Zealand,1933,2,51,145,2,1,467,920,9,416,775,7,51.888888888888886,>30,NZ,Away,Upto 2014
GOB Allen,ENG,Pace,1933-03-31,Auckland,New Zealand,1933,2,15,48,0,1,344,794,12,329,746,12,28.666666666666668,<=30,NZ,Away,Upto 2014
GOB Allen,ENG,Pace,1933-06-24,Lord's,England,1933,2,46,144,3,1,246,540,10,200,396,7,24.6,<=30,ENG,Home,Upto 2014
GOB Allen,ENG,Pace,1934-07-06,Manchester,England,1934,2,136,222,1,1,754,1551,6,618,1329,5,125.66666666666667,>30,ENG,Home,Upto 2014
GOB Allen,ENG,Pace,1934-08-18,The Oval,England,1934,2,233,300,4,1,874,1331,25,641,1031,21,34.96,>30,ENG,Home,Upto 2014
GOB Allen,ENG,Pace,1936-06-27,Lord's,England,1936,2,78,210,10,1,273,772,20,195,562,10,13.65,<=30,ENG,Home,Upto 2014
GOB Allen,ENG,Pace,1936-07-25,Manchester,England,1936,2,135,198,2,1,650,1176,8,515,978,6,81.25,>30,ENG,Home,Upto 2014
GOB Allen,ENG,Pace,1936-08-15,The Oval,England,1936,2,117,192,8,1,678,1230,17,561,1038,9,39.88235294117647,>30,ENG,Home,Upto 2014
GOB Allen,ENG,Pace,1936-12-04,Brisbane,Australia,1936,2,107,176,8,1,297,839,25,190,663,17,11.88,<=30,AUS,Away,Upto 2014
GOB Allen,ENG,Pace,1936-12-18,Sydney,Australia,1936,2,80,199,4,1,331,936,17,251,737,13,19.470588235294116,<=30,AUS,Away,Upto 2014
GOB Allen,ENG,Pace,1937-01-01,Melbourne,Australia,1937,2,119,280,3,1,510,1173,17,391,893,14,30.0,<=30,AUS,Away,Upto 2014
GOB Allen,ENG,Pace,1937-01-29,Adelaide,Australia,1937,2,121,240,2,1,675,1448,20,554,1208,18,33.75,>30,AUS,Away,Upto 2014
GOB Allen,ENG,Pace,1937-02-26,Melbourne,Australia,1937,1,99,136,0,1,632,1154,16,533,1018,16,39.5,>30,AUS,Away,Upto 2014
GOB Allen,ENG,Pace,1948-02-11,Port of Spain,West Indies,1948,2,103,122,3,1,529,1106,15,426,984,12,35.266666666666666,>30,WI,Away,Upto 2014
GOB Allen,ENG,Pace,1948-03-03,Georgetown,West Indies,1948,1,5,16,1,1,265,632,11,260,616,10,24.09090909090909,<=30,WI,Away,Upto 2014
GOB Allen,ENG,Pace,1948-03-27,Kingston,West Indies,1948,2,97,132,1,1,401,1001,16,304,869,15,25.0625,<=30,WI,Away,Upto 2014
GP Howarth,NZ,Spin,1975-02-20,Auckland,New Zealand,1975,1,47,112,1,1,416,1136,17,369,1024,16,24.470588235294116,<=30,NZ,Home,Upto 2014
GP Howarth,NZ,Spin,1975-02-28,Christchurch,New Zealand,1975,1,19,56,0,1,134,381,5,115,325,5,26.8,<=30,NZ,Home,Upto 2014
GP Howarth,NZ,Spin,1976-10-09,Lahore,Pakistan,1976,1,13,24,1,1,495,1028,17,482,1004,16,29.11764705882353,<=30,PAK,Away,Upto 2014
GP Howarth,NZ,Spin,1976-11-18,Kanpur,India,1976,1,21,30,0,1,806,2159,22,785,2129,22,36.63636363636363,>30,IND,Away,Upto 2014
GP Howarth,NZ,Spin,1976-11-26,Chennai,India,1976,1,9,18,0,1,433,1077,20,424,1059,20,21.65,<=30,IND,Away,Upto 2014
GP Howarth,NZ,Spin,1979-02-02,Christchurch,New Zealand,1979,2,32,72,0,1,329,962,17,297,890,17,19.352941176470587,<=30,NZ,Home,Upto 2014
GP Howarth,NZ,Spin,1979-02-16,Napier,New Zealand,1979,2,26,48,0,1,237,587,3,211,539,3,79.0,>30,NZ,Home,Upto 2014
GP Howarth,NZ,Spin,1979-02-23,Auckland,New Zealand,1979,1,0,8,0,1,67,144,1,67,136,1,67.0,>30,NZ,Home,Upto 2014
GP Howarth,NZ,Spin,1980-02-22,Christchurch,New Zealand,1980,1,32,30,1,1,117,178,4,85,148,3,29.25,<=30,NZ,Home,Upto 2014
GP Howarth,NZ,Spin,1981-03-06,Christchurch,New Zealand,1981,1,2,18,0,1,157,612,3,155,594,3,52.333333333333336,>30,NZ,Home,Upto 2014
GP Howarth,NZ,Spin,1981-03-13,Auckland,New Zealand,1981,2,22,54,0,1,519,1803,22,497,1749,22,23.59090909090909,<=30,NZ,Home,Upto 2014
GP Howarth,NZ,Spin,1982-03-12,Auckland,New Zealand,1982,2,12,30,0,1,260,652,9,248,622,9,28.88888888888889,<=30,NZ,Home,Upto 2014
GP Howarth,NZ,Spin,1983-07-14,The Oval,England,1983,1,1,18,0,1,330,901,10,329,883,10,33.0,>30,ENG,Away,Upto 2014
GP Howarth,NZ,Spin,1984-02-10,Auckland,New Zealand,1984,1,18,42,0,1,236,653,6,218,611,6,39.333333333333336,>30,NZ,Home,Upto 2014
GP Howarth,NZ,Spin,1985-04-06,Georgetown,West Indies,1985,2,17,54,0,1,331,798,0,314,744,0,inf,>30,WI,Away,Upto 2014
GP Swann,ENG,Spin,2008-12-11,Chennai,India,2008,2,145,231,4,1,742,1371,17,597,1140,13,43.64705882352941,>30,IND,Away,Upto 2014
GP Swann,ENG,Spin,2008-12-19,Mohali,India,2008,2,171,372,4,1,508,989,13,337,617,9,39.07692307692308,>30,IND,Away,Upto 2014
GP Swann,ENG,Spin,2009-02-15,St John's,West Indies,2009,2,149,378,8,1,563,1022,15,414,644,7,37.53333333333333,>30,WI,Away,Upto 2014
GP Swann,ENG,Spin,2009-02-26,Bridgetown,West Indies,2009,1,165,304,5,1,611,1066,8,446,762,3,76.375,>30,WI,Away,Upto 2014
GP Swann,ENG,Spin,2009-03-06,Port of Spain,West Indies,2009,2,143,400,6,1,578,1262,14,435,862,8,41.285714285714285,>30,WI,Away,Upto 2014
GP Swann,ENG,Spin,2009-05-06,Lord's,England,2009,2,55,132,6,1,150,312,8,95,180,2,18.75,<=30,ENG,Home,Upto 2014
GP Swann,ENG,Spin,2009-05-14,Chester-le-Street,England,2009,2,64,102,1,1,248,450,4,184,348,3,62.0,>30,ENG,Home,Upto 2014
GP Swann,ENG,Spin,2009-07-08,Cardiff,England,2009,1,131,228,0,1,464,923,7,333,695,7,66.28571428571429,>30,ENG,Home,Upto 2014
GP Swann,ENG,Spin,2009-07-16,Lord's,England,2009,2,91,174,4,1,283,468,8,192,294,4,35.375,>30,ENG,Home,Upto 2014
GP Swann,ENG,Spin,2009-07-30,Birmingham,England,2009,2,123,198,2,1,180,306,3,57,108,1,60.0,>30,ENG,Home,Upto 2014
GP Swann,ENG,Spin,2009-08-07,Leeds,England,2009,1,64,96,0,1,64,96,0,0,0,0,inf,>30,ENG,Home,Upto 2014
GP Swann,ENG,Spin,2009-08-20,The Oval,England,2009,2,158,326,8,1,318,638,12,160,312,4,26.5,<=30,ENG,Home,Upto 2014
GP Swann,ENG,Spin,2009-12-16,Centurion,South Africa,2009,2,201,434,5,1,399,878,13,198,444,8,30.692307692307693,>30,SA,Away,Upto 2014
GP Swann,ENG,Spin,2009-12-26,Durban,South Africa,2009,2,164,336,9,1,406,720,13,242,384,4,31.23076923076923,>30,SA,Away,Upto 2014
GP Swann,ENG,Spin,2010-01-03,Cape Town,South Africa,2010,2,201,354,5,1,394,792,10,193,438,5,39.4,>30,SA,Away,Upto 2014
GP Swann,ENG,Spin,2010-01-14,Johannesburg,South Africa,2010,1,93,138,2,1,103,149,4,10,11,2,25.75,<=30,SA,Away,Upto 2014
GP Swann,ENG,Spin,2010-03-12,Chattogram,Bangladesh,2010,2,217,471,10,1,894,1491,22,677,1020,12,40.63636363636363,>30,BAN,Away,Upto 2014
GP Swann,ENG,Spin,2010-03-20,Mirpur,Bangladesh,2010,2,187,397,6,1,865,1792,20,678,1395,14,43.25,>30,BAN,Away,Upto 2014
GP Swann,ENG,Spin,2010-05-27,Lord's,England,2010,2,100,228,0,1,517,907,10,417,679,10,51.7,>30,ENG,Home,Upto 2014
GP Swann,ENG,Spin,2010-06-04,Manchester,England,2010,2,110,176,6,1,455,779,14,345,603,8,32.5,>30,ENG,Home,Upto 2014
GP Swann,ENG,Spin,2010-07-29,Nottingham,England,2010,1,12,12,0,1,267,351,3,255,339,3,89.0,>30,ENG,Home,Upto 2014
GP Swann,ENG,Spin,2010-08-06,Birmingham,England,2010,1,65,222,6,1,211,502,11,146,280,5,19.181818181818183,<=30,ENG,Home,Upto 2014
GP Swann,ENG,Spin,2010-08-18,The Oval,England,2010,2,118,276,7,1,230,537,12,112,261,5,19.166666666666668,<=30,ENG,Home,Upto 2014
GP Swann,ENG,Spin,2010-08-26,Lord's,England,2010,2,74,131,9,1,226,461,11,152,330,2,20.545454545454547,<=30,ENG,Home,Upto 2014
GP Swann,ENG,Spin,2010-11-25,Brisbane,Australia,2010,2,161,306,2,1,363,731,5,202,425,3,72.6,>30,AUS,Away,Upto 2014
GP Swann,ENG,Spin,2010-12-03,Adelaide,Australia,2010,2,161,421,7,1,391,709,9,230,288,2,43.44444444444444,>30,AUS,Away,Upto 2014
GP Swann,ENG,Spin,2010-12-16,W.A.C.A,Australia,2010,2,103,150,2,1,103,150,2,0,0,0,51.5,>30,AUS,Away,Upto 2014
GP Swann,ENG,Spin,2010-12-26,Melbourne,Australia,2010,2,60,174,2,1,144,302,2,84,128,0,72.0,>30,AUS,Away,Upto 2014
GP Swann,ENG,Spin,2011-01-03,Sydney,Australia,2011,2,112,264,2,1,291,570,3,179,306,1,97.0,>30,AUS,Away,Upto 2014
GP Swann,ENG,Spin,2011-05-26,Cardiff,England,2011,2,94,190,7,1,338,682,10,244,492,3,33.8,>30,ENG,Home,Upto 2014
GP Swann,ENG,Spin,2011-06-03,Lord's,England,2011,2,120,268,3,1,315,597,8,195,329,5,39.375,>30,ENG,Home,Upto 2014
GP Swann,ENG,Spin,2011-06-16,Southampton,England,2011,2,69,162,2,1,132,258,2,63,96,0,66.0,>30,ENG,Home,Upto 2014
GP Swann,ENG,Spin,2011-07-21,Lord's,England,2011,2,114,246,2,1,415,658,4,301,412,2,103.75,>30,ENG,Home,Upto 2014
GP Swann,ENG,Spin,2011-07-29,Nottingham,England,2011,2,97,90,0,1,280,322,2,183,232,2,140.0,>30,ENG,Home,Upto 2014
GP Swann,ENG,Spin,2011-08-10,Birmingham,England,2011,2,110,102,2,1,372,564,6,262,462,4,62.0,>30,ENG,Home,Upto 2014
GP Swann,ENG,Spin,2011-08-18,The Oval,England,2011,2,208,414,9,1,491,822,11,283,408,2,44.63636363636363,>30,ENG,Home,Upto 2014
GP Swann,ENG,Spin,2012-01-17,Dubai (DICS),UAE,2012,1,107,179,4,1,302,659,19,195,480,15,15.894736842105264,<=30,UAE,Away,Upto 2014
GP Swann,ENG,Spin,2012-01-25,Abu Dhabi,UAE,2012,2,118,270,5,1,558,1443,31,440,1173,26,18.0,<=30,UAE,Away,Upto 2014
GP Swann,ENG,Spin,2012-02-03,Dubai (DICS),UAE,2012,2,101,240,4,1,528,1381,25,427,1141,21,21.12,<=30,UAE,Away,Upto 2014
GP Swann,ENG,Spin,2012-03-26,Galle,Sri Lanka,2012,2,174,318,6,1,607,1324,28,433,1006,22,21.678571428571427,<=30,SL,Away,Upto 2014
GP Swann,ENG,Spin,2012-04-03,Colombo (PSS),Sri Lanka,2012,2,181,409,10,1,698,1454,22,517,1045,12,31.727272727272727,>30,SL,Away,Upto 2014
GP Swann,ENG,Spin,2012-05-17,Lord's,England,2012,2,111,221,3,1,200,366,4,89,145,1,50.0,>30,ENG,Home,Upto 2014
GP Swann,ENG,Spin,2012-05-25,Nottingham,England,2012,2,86,158,3,1,256,436,7,170,278,4,36.57142857142857,>30,ENG,Home,Upto 2014
GP Swann,ENG,Spin,2012-06-07,Birmingham,England,2012,1,85,156,0,1,184,300,1,99,144,1,184.0,>30,ENG,Home,Upto 2014
GP Swann,ENG,Spin,2012-07-19,The Oval,England,2012,1,151,312,0,1,301,684,4,150,372,4,75.25,>30,ENG,Home,Upto 2014
GP Swann,ENG,Spin,2012-08-16,Lord's,England,2012,2,157,428,4,1,299,656,5,142,228,1,59.8,>30,ENG,Home,Upto 2014
GP Swann,ENG,Spin,2012-11-15,Ahmedabad,India,2012,2,190,351,6,1,729,1559,21,539,1208,15,34.714285714285715,>30,IND,Away,Upto 2014
GP Swann,ENG,Spin,2012-11-23,Wankhede,India,2012,2,113,314,8,1,747,1449,28,634,1135,20,26.678571428571427,<=30,IND,Away,Upto 2014
GP Swann,ENG,Spin,2012-12-05,Eden Gardens,India,2012,2,116,264,3,1,665,1360,18,549,1096,15,36.94444444444444,>30,IND,Away,Upto 2014
GP Swann,ENG,Spin,2012-12-13,Nagpur,India,2012,1,76,186,3,1,722,2045,15,646,1859,12,48.13333333333333,>30,IND,Away,Upto 2014
GP Swann,ENG,Spin,2013-05-16,Lord's,England,2013,1,19,48,0,1,125,351,3,106,303,3,41.666666666666664,>30,ENG,Home,Upto 2014
GP Swann,ENG,Spin,2013-05-24,Leeds,England,2013,2,132,246,10,1,291,492,14,159,246,4,20.785714285714285,<=30,ENG,Home,Upto 2014
GP Swann,ENG,Spin,2013-07-10,Nottingham,England,2013,2,165,378,4,1,277,642,7,112,264,3,39.57142857142857,>30,ENG,Home,Upto 2014
GP Swann,ENG,Spin,2013-07-18,Lord's,England,2013,2,122,312,9,1,356,726,15,234,414,6,23.733333333333334,<=30,ENG,Home,Upto 2014
GP Swann,ENG,Spin,2013-08-01,Manchester,England,2013,2,233,348,6,1,362,618,7,129,270,1,51.714285714285715,>30,ENG,Home,Upto 2014
GP Swann,ENG,Spin,2013-08-09,Chester-le-Street,England,2013,2,101,216,4,1,200,493,11,99,277,7,18.181818181818183,<=30,ENG,Home,Upto 2014
GP Swann,ENG,Spin,2013-08-21,The Oval,England,2013,2,134,240,3,1,310,576,4,176,336,1,77.5,>30,ENG,Home,Upto 2014
GP Swann,ENG,Spin,2013-11-21,Brisbane,Australia,2013,2,215,318,2,1,355,624,6,140,306,4,59.166666666666664,>30,AUS,Away,Upto 2014
GP Swann,ENG,Spin,2013-12-05,Adelaide,Australia,2013,2,182,270,2,1,565,912,7,383,642,5,80.71428571428571,>30,AUS,Away,Upto 2014
GP Swann,ENG,Spin,2013-12-13,W.A.C.A,Australia,2013,2,163,264,3,1,300,552,7,137,288,4,42.857142857142854,>30,AUS,Away,Upto 2014
GP Thorpe,ENG,Pace,1993-07-22,Leeds,England,1993,1,14,36,0,1,901,1757,18,887,1721,18,50.05555555555556,>30,ENG,Home,Upto 2014
GP Thorpe,ENG,Pace,1994-04-16,St John's,West Indies,1994,1,1,12,0,1,833,1731,12,832,1719,12,69.41666666666667,>30,WI,Away,Upto 2014
GP Thorpe,ENG,Pace,1996-07-04,Nottingham,England,1996,1,3,6,0,1,859,1781,24,856,1775,24,35.791666666666664,>30,ENG,Home,Upto 2014
GP Thorpe,ENG,Pace,1996-08-08,Leeds,England,1996,2,19,78,0,1,963,1933,22,944,1855,22,43.77272727272727,>30,ENG,Home,Upto 2014
GP Thorpe,ENG,Pace,1997-02-14,Christchurch,New Zealand,1997,1,0,6,0,1,695,1595,19,695,1589,19,36.578947368421055,>30,NZ,Away,Upto 2014
GP Wickramasinghe,SL,Pace,1991-12-12,Sialkot,Pakistan,1991,1,120,162,1,1,611,1329,14,491,1167,13,43.642857142857146,>30,PAK,Away,Upto 2014
GP Wickramasinghe,SL,Pace,1991-12-20,Gujranwala,Pakistan,1991,1,27,42,1,1,97,210,2,70,168,1,48.5,>30,PAK,Away,Upto 2014
GP Wickramasinghe,SL,Pace,1992-01-02,Faisalabad,Pakistan,1992,2,126,348,6,1,743,1706,36,617,1358,30,20.63888888888889,<=30,PAK,Away,Upto 2014
GP Wickramasinghe,SL,Pace,1992-08-17,Colombo (SSC),Sri Lanka,1992,2,148,222,3,1,793,1548,19,645,1326,16,41.73684210526316,>30,SL,Home,Upto 2014
GP Wickramasinghe,SL,Pace,1993-07-27,Colombo (SSC),Sri Lanka,1993,2,141,294,3,1,627,1409,18,486,1115,15,34.833333333333336,>30,SL,Home,Upto 2014
GP Wickramasinghe,SL,Pace,1993-08-04,Colombo (PSS),Sri Lanka,1993,1,95,228,3,1,384,1057,10,289,829,7,38.4,>30,SL,Home,Upto 2014
GP Wickramasinghe,SL,Pace,1993-08-25,Moratuwa,Sri Lanka,1993,2,117,246,4,1,501,1154,19,384,908,15,26.36842105263158,<=30,SL,Home,Upto 2014
GP Wickramasinghe,SL,Pace,1993-09-06,Colombo (SSC),Sri Lanka,1993,1,111,186,1,1,464,972,21,353,786,20,22.095238095238095,<=30,SL,Home,Upto 2014
GP Wickramasinghe,SL,Pace,1993-12-08,Moratuwa,Sri Lanka,1993,1,35,66,0,1,179,537,9,144,471,9,19.88888888888889,<=30,SL,Home,Upto 2014
GP Wickramasinghe,SL,Pace,1994-01-18,Lucknow,India,1994,1,84,120,1,1,249,514,6,165,394,5,41.5,>30,IND,Away,Upto 2014
GP Wickramasinghe,SL,Pace,1994-01-26,Bengaluru,India,1994,1,98,120,1,1,326,460,11,228,340,10,29.636363636363637,<=30,IND,Away,Upto 2014
GP Wickramasinghe,SL,Pace,1994-02-08,Ahmedabad,India,1994,1,108,216,2,1,174,408,3,66,192,1,58.0,>30,IND,Away,Upto 2014
GP Wickramasinghe,SL,Pace,1994-08-09,Colombo (PSS),Sri Lanka,1994,2,84,102,0,1,293,474,11,209,372,11,26.636363636363637,<=30,SL,Home,Upto 2014
GP Wickramasinghe,SL,Pace,1994-10-11,Harare,Zimbabwe,1994,1,60,156,1,1,445,1241,16,385,1085,15,27.8125,<=30,ZIM,Away,Upto 2014
GP Wickramasinghe,SL,Pace,1994-10-20,Bulawayo,Zimbabwe,1994,1,125,234,2,1,524,1630,17,399,1396,15,30.823529411764707,>30,ZIM,Away,Upto 2014
GP Wickramasinghe,SL,Pace,1995-03-11,Napier,New Zealand,1995,2,75,192,3,1,717,1794,34,642,1602,31,21.08823529411765,<=30,NZ,Away,Upto 2014
GP Wickramasinghe,SL,Pace,1995-03-18,Dunedin,New Zealand,1995,1,49,156,0,1,657,1600,18,608,1444,18,36.5,>30,NZ,Away,Upto 2014
GP Wickramasinghe,SL,Pace,1995-09-08,Peshawar,Pakistan,1995,1,98,192,0,1,562,1039,16,464,847,16,35.125,>30,PAK,Away,Upto 2014
GP Wickramasinghe,SL,Pace,1995-09-15,Faisalabad,Pakistan,1995,2,76,204,2,1,465,1059,21,389,855,19,22.142857142857142,<=30,PAK,Away,Upto 2014
GP Wickramasinghe,SL,Pace,1995-09-22,Sialkot,Pakistan,1995,2,84,186,6,1,584,1401,24,500,1215,18,24.333333333333332,<=30,PAK,Away,Upto 2014
GP Wickramasinghe,SL,Pace,1995-12-08,W.A.C.A,Australia,1995,1,123,186,0,1,613,1126,16,490,940,16,38.3125,>30,AUS,Away,Upto 2014
GP Wickramasinghe,SL,Pace,1995-12-26,Melbourne,Australia,1995,1,77,182,2,1,608,1377,17,531,1195,15,35.76470588235294,>30,AUS,Away,Upto 2014
GP Wickramasinghe,SL,Pace,1996-01-25,Adelaide,Australia,1996,2,159,315,4,1,886,1812,32,727,1497,28,27.6875,<=30,AUS,Away,Upto 2014
GP Wickramasinghe,SL,Pace,1997-03-07,Dunedin,New Zealand,1997,1,117,150,1,1,739,1295,21,622,1145,20,35.19047619047619,>30,NZ,Away,Upto 2014
GP Wickramasinghe,SL,Pace,1997-12-03,Wankhede,India,1997,2,96,217,3,1,639,1269,12,543,1052,9,53.25,>30,IND,Away,Upto 2014
GP Wickramasinghe,SL,Pace,1998-03-19,Cape Town,South Africa,1998,2,99,220,3,1,757,1378,22,658,1158,19,34.40909090909091,>30,SA,Away,Upto 2014
GP Wickramasinghe,SL,Pace,1998-03-27,Centurion,South Africa,1998,2,43,126,1,1,463,1134,19,420,1008,18,24.36842105263158,<=30,SA,Away,Upto 2014
GP Wickramasinghe,SL,Pace,1998-05-27,Colombo (RPS),Sri Lanka,1998,2,76,126,2,1,355,626,8,279,500,6,44.375,>30,SL,Home,Upto 2014
GP Wickramasinghe,SL,Pace,1998-06-03,Galle,Sri Lanka,1998,2,26,54,0,1,157,358,1,131,304,1,157.0,>30,SL,Home,Upto 2014
GP Wickramasinghe,SL,Pace,1998-06-10,Colombo (SSC),Sri Lanka,1998,2,12,75,2,1,230,457,11,218,382,9,20.90909090909091,<=30,SL,Home,Upto 2014
GP Wickramasinghe,SL,Pace,1998-08-27,The Oval,England,1998,2,97,204,2,1,707,1308,12,610,1104,10,58.916666666666664,>30,ENG,Away,Upto 2014
GP Wickramasinghe,SL,Pace,1999-03-04,Lahore,Pakistan,1999,2,130,229,6,1,638,1047,15,508,818,9,42.53333333333333,>30,PAK,Away,Upto 2014
GP Wickramasinghe,SL,Pace,1999-03-12,Dhaka,Bangladesh,1999,1,53,120,0,1,404,794,8,351,674,8,50.5,>30,BAN,Away,Upto 2014
GP Wickramasinghe,SL,Pace,1999-11-18,Bulawayo,Zimbabwe,1999,2,80,176,6,1,569,1220,18,489,1044,12,31.61111111111111,>30,ZIM,Away,Upto 2014
GP Wickramasinghe,SL,Pace,1999-11-26,Harare,Zimbabwe,1999,2,82,276,1,1,681,1742,19,599,1466,18,35.8421052631579,>30,ZIM,Away,Upto 2014
GP Wickramasinghe,SL,Pace,1999-12-04,Harare,Zimbabwe,1999,2,71,222,2,1,525,1358,25,454,1136,23,21.0,<=30,ZIM,Away,Upto 2014
GP Wickramasinghe,SL,Pace,2000-02-26,Rawalpindi,Pakistan,2000,2,113,264,4,1,697,1541,24,584,1277,20,29.041666666666668,<=30,PAK,Away,Upto 2014
GP Wickramasinghe,SL,Pace,2000-03-05,Peshawar,Pakistan,2000,2,47,137,2,1,480,1060,20,433,923,18,24.0,<=30,PAK,Away,Upto 2014
GP Wickramasinghe,SL,Pace,2000-03-12,Karachi,Pakistan,2000,2,146,234,2,1,750,1272,22,604,1038,20,34.09090909090909,>30,PAK,Away,Upto 2014
GP Wickramasinghe,SL,Pace,2001-01-20,Centurion,South Africa,2001,1,51,75,2,1,628,1061,26,577,986,24,24.153846153846153,<=30,SA,Away,Upto 2014
GPD Hartigan,SA,Pace,1912-05-27,Manchester,England,1912,1,31,54,0,1,239,566,12,208,512,12,19.916666666666668,<=30,ENG,Away,Upto 2014
GPD Hartigan,SA,Pace,1912-06-10,Lord's,England,1912,1,14,60,0,1,280,781,22,266,721,22,12.727272727272727,<=30,ENG,Away,Upto 2014
GPD Hartigan,SA,Pace,1913-12-13,Durban,South Africa,1913,1,72,108,1,1,479,1054,20,407,946,19,23.95,<=30,SA,Home,Upto 2014
GPD Hartigan,SA,Pace,1913-12-26,Johannesburg,South Africa,1913,1,24,30,0,1,455,1029,24,431,999,24,18.958333333333332,<=30,SA,Home,Upto 2014
GR Beard,AUS,Spin,1980-02-27,Karachi,Pakistan,1980,2,53,109,0,1,432,1328,28,379,1219,28,15.428571428571429,<=30,PAK,Away,Upto 2014
GR Beard,AUS,Spin,1980-03-06,Faisalabad,Pakistan,1980,1,30,90,0,1,592,1272,6,562,1182,6,98.66666666666667,>30,PAK,Away,Upto 2014
GR Beard,AUS,Spin,1980-03-18,Lahore,Pakistan,1980,1,26,60,1,1,686,1374,15,660,1314,14,45.733333333333334,>30,PAK,Away,Upto 2014
GR Breese,WI,Spin,2002-10-17,Chennai,India,2002,2,135,188,2,1,464,965,17,329,777,15,27.294117647058822,<=30,IND,Away,Upto 2014
GR Dickinson,NZ,Pace,1930-01-10,Christchurch,New Zealand,1930,2,44,78,1,1,310,868,23,266,790,22,13.478260869565217,<=30,NZ,Home,Upto 2014
GR Dickinson,NZ,Pace,1930-01-24,Wellington,New Zealand,1930,2,90,167,4,1,569,1265,15,479,1098,11,37.93333333333333,>30,NZ,Home,Upto 2014
GR Dickinson,NZ,Pace,1932-03-04,Wellington,New Zealand,1932,2,111,206,3,1,449,1052,12,338,846,9,37.416666666666664,>30,NZ,Home,Upto 2014
GR Dilley,ENG,Pace,1979-12-14,W.A.C.A,Australia,1979,2,97,216,3,1,716,1874,34,619,1658,31,21.058823529411764,<=30,AUS,Away,Upto 2014
GR Dilley,ENG,Pace,1980-01-04,Sydney,Australia,1980,2,46,102,0,1,548,1437,28,502,1335,28,19.571428571428573,<=30,AUS,Away,Upto 2014
GR Dilley,ENG,Pace,1980-07-10,Manchester,England,1980,1,47,168,3,1,678,1412,23,631,1244,20,29.47826086956522,<=30,ENG,Home,Upto 2014
GR Dilley,ENG,Pace,1980-07-24,The Oval,England,1980,1,57,138,4,1,630,1595,25,573,1457,21,25.2,<=30,ENG,Home,Upto 2014
GR Dilley,ENG,Pace,1980-08-07,Leeds,England,1980,1,79,138,4,1,526,1199,25,447,1061,21,21.04,<=30,ENG,Home,Upto 2014
GR Dilley,ENG,Pace,1981-02-13,Port of Spain,West Indies,1981,1,73,168,0,1,521,1338,21,448,1170,21,24.80952380952381,<=30,WI,Away,Upto 2014
GR Dilley,ENG,Pace,1981-03-13,Bridgetown,West Indies,1981,2,162,288,4,1,801,1640,34,639,1352,30,23.558823529411764,<=30,WI,Away,Upto 2014
GR Dilley,ENG,Pace,1981-03-27,St John's,West Indies,1981,1,99,150,2,1,702,1430,20,603,1280,18,35.1,>30,WI,Away,Upto 2014
GR Dilley,ENG,Pace,1981-04-10,Kingston,West Indies,1981,1,116,172,4,1,705,1477,22,589,1305,18,32.04545454545455,>30,WI,Away,Upto 2014
GR Dilley,ENG,Pace,1981-06-18,Nottingham,England,1981,2,62,187,7,1,571,1418,36,509,1231,29,15.86111111111111,<=30,ENG,Home,Upto 2014
GR Dilley,ENG,Pace,1981-07-02,Lord's,England,1981,2,124,227,5,1,755,1760,25,631,1533,20,30.2,>30,ENG,Home,Upto 2014
GR Dilley,ENG,Pace,1981-07-16,Leeds,England,1981,2,89,174,2,1,892,1859,38,803,1685,36,23.473684210526315,<=30,ENG,Home,Upto 2014
GR Dilley,ENG,Pace,1981-11-27,Wankhede,India,1981,2,108,186,5,1,460,1013,28,352,827,23,16.428571428571427,<=30,IND,Away,Upto 2014
GR Dilley,ENG,Pace,1981-12-09,Bengaluru,India,1981,1,75,144,0,1,557,1122,12,482,978,12,46.416666666666664,>30,IND,Away,Upto 2014
GR Dilley,ENG,Pace,1982-01-13,Chennai,India,1982,2,100,216,1,1,631,1176,8,531,960,7,78.875,>30,IND,Away,Upto 2014
GR Dilley,ENG,Pace,1982-01-30,Kanpur,India,1982,1,67,84,1,1,435,720,7,368,636,6,62.142857142857146,>30,IND,Away,Upto 2014
GR Dilley,ENG,Pace,1983-07-28,Leeds,England,1983,2,52,150,0,1,786,1782,32,734,1632,32,24.5625,<=30,ENG,Home,Upto 2014
GR Dilley,ENG,Pace,1984-03-12,Faisalabad,Pakistan,1984,2,142,222,5,1,538,960,13,396,738,8,41.38461538461539,>30,PAK,Away,Upto 2014
GR Dilley,ENG,Pace,1986-06-05,Lord's,England,1986,2,174,264,6,1,690,1580,26,516,1316,20,26.53846153846154,<=30,ENG,Home,Upto 2014
GR Dilley,ENG,Pace,1986-06-19,Leeds,England,1986,2,125,248,4,1,608,1416,31,483,1168,27,19.612903225806452,<=30,ENG,Home,Upto 2014
GR Dilley,ENG,Pace,1986-07-24,Lord's,England,1986,2,87,247,5,1,599,1428,17,512,1181,12,35.23529411764706,>30,ENG,Home,Upto 2014
GR Dilley,ENG,Pace,1986-08-21,The Oval,England,1986,1,92,170,4,1,479,811,12,387,641,8,39.916666666666664,>30,ENG,Home,Upto 2014
GR Dilley,ENG,Pace,1986-11-14,Brisbane,Australia,1986,2,115,268,6,1,755,1483,27,640,1215,21,27.962962962962962,<=30,AUS,Away,Upto 2014
GR Dilley,ENG,Pace,1986-11-28,W.A.C.A,Australia,1986,2,132,238,5,1,963,1802,22,831,1564,17,43.77272727272727,>30,AUS,Away,Upto 2014
GR Dilley,ENG,Pace,1986-12-12,Adelaide,Australia,1986,2,149,318,2,1,567,1198,11,418,880,9,51.54545454545455,>30,AUS,Away,Upto 2014
GR Dilley,ENG,Pace,1987-01-10,Sydney,Australia,1987,2,115,233,3,1,483,1157,14,368,924,11,34.5,>30,AUS,Away,Upto 2014
GR Dilley,ENG,Pace,1987-07-02,Leeds,England,1987,1,89,198,1,1,511,1279,29,422,1081,28,17.620689655172413,<=30,ENG,Home,Upto 2014
GR Dilley,ENG,Pace,1987-07-23,Birmingham,England,1987,2,145,318,7,1,1037,2130,29,892,1812,22,35.758620689655174,>30,ENG,Home,Upto 2014
GR Dilley,ENG,Pace,1987-08-06,The Oval,England,1987,1,154,285,6,1,607,1188,10,453,903,4,60.7,>30,ENG,Home,Upto 2014
GR Dilley,ENG,Pace,1987-12-16,Karachi,Pakistan,1987,1,102,126,1,1,422,869,15,320,743,14,28.133333333333333,<=30,PAK,Away,Upto 2014
GR Dilley,ENG,Pace,1988-01-29,Sydney,Australia,1988,2,102,193,3,1,421,1098,12,319,905,9,35.083333333333336,>30,AUS,Away,Upto 2014
GR Dilley,ENG,Pace,1988-02-12,Christchurch,New Zealand,1988,2,70,257,8,1,693,1999,33,623,1742,25,21.0,<=30,NZ,Away,Upto 2014
GR Dilley,ENG,Pace,1988-02-25,Auckland,New Zealand,1988,2,104,306,7,1,724,1989,22,620,1683,15,32.90909090909091,>30,NZ,Away,Upto 2014
GR Dilley,ENG,Pace,1988-03-03,Wellington,New Zealand,1988,1,36,66,0,1,376,817,5,340,751,5,75.2,>30,NZ,Away,Upto 2014
GR Dilley,ENG,Pace,1988-06-02,Nottingham,England,1988,1,101,204,1,1,781,1741,19,680,1537,18,41.10526315789474,>30,ENG,Home,Upto 2014
GR Dilley,ENG,Pace,1988-06-16,Lord's,England,1988,2,128,300,9,1,943,1804,37,815,1504,28,25.486486486486488,<=30,ENG,Home,Upto 2014
GR Dilley,ENG,Pace,1988-06-30,Manchester,England,1988,1,99,169,4,1,423,1051,26,324,882,22,16.26923076923077,<=30,ENG,Home,Upto 2014
GR Dilley,ENG,Pace,1988-07-21,Leeds,England,1988,2,75,144,1,1,613,1328,28,538,1184,27,21.892857142857142,<=30,ENG,Home,Upto 2014
GR Dilley,ENG,Pace,1989-06-22,Lord's,England,1989,2,168,264,3,1,1092,2047,30,924,1783,27,36.4,>30,ENG,Home,Upto 2014
GR Dilley,ENG,Pace,1989-07-06,Birmingham,England,1989,2,150,246,2,1,670,1413,17,520,1167,15,39.411764705882355,>30,ENG,Home,Upto 2014
GR Hazlitt,AUS,Spin,1907-12-13,Sydney,Australia,1907,2,56,78,0,1,592,1308,17,536,1230,17,34.8235294117647,>30,AUS,Home,Upto 2014
GR Hazlitt,AUS,Spin,1908-01-01,Melbourne,Australia,1908,2,42,90,0,1,799,1914,21,757,1824,21,38.04761904761905,>30,AUS,Home,Upto 2014
GR Hazlitt,AUS,Spin,1912-02-23,Sydney,Australia,1912,2,127,258,4,1,473,1119,22,346,861,18,21.5,<=30,AUS,Home,Upto 2014
GR Hazlitt,AUS,Spin,1912-05-27,Manchester,England,1912,1,46,96,1,1,525,1035,18,479,939,17,29.166666666666668,<=30,ENG,Away,Upto 2014
GR Hazlitt,AUS,Spin,1912-06-24,Lord's,England,1912,1,68,150,1,1,243,530,6,175,380,5,40.5,>30,ENG,Away,Upto 2014
GR Hazlitt,AUS,Spin,1912-07-15,Lord's,England,1912,2,86,192,4,1,501,1026,19,415,834,15,26.36842105263158,<=30,ENG,Away,Upto 2014
GR Hazlitt,AUS,Spin,1912-07-29,Manchester,England,1912,1,77,245,4,1,128,395,6,51,150,2,21.333333333333332,<=30,ENG,Away,Upto 2014
GR Hazlitt,AUS,Spin,1912-08-05,Nottingham,England,1912,1,48,168,2,1,399,1038,15,351,870,13,26.6,<=30,ENG,Away,Upto 2014
GR Hazlitt,AUS,Spin,1912-08-19,The Oval,England,1912,2,73,286,7,1,252,792,19,179,506,12,13.263157894736842,<=30,ENG,Away,Upto 2014
GR Larsen,NZ,Pace,1994-06-02,Nottingham,England,1994,1,116,268,2,1,704,1313,20,588,1045,18,35.2,>30,ENG,Away,Upto 2014
GR Larsen,NZ,Pace,1995-03-04,Auckland,New Zealand,1995,2,88,255,5,1,789,1800,31,701,1545,26,25.451612903225808,<=30,NZ,Home,Upto 2014
GR Larsen,NZ,Pace,1995-03-11,Napier,New Zealand,1995,2,112,336,5,1,717,1794,34,605,1458,29,21.08823529411765,<=30,NZ,Home,Upto 2014
GR Larsen,NZ,Pace,1995-03-18,Dunedin,New Zealand,1995,2,61,232,2,1,657,1600,18,596,1368,16,36.5,>30,NZ,Home,Upto 2014
GR Larsen,NZ,Pace,1995-12-08,Christchurch,New Zealand,1995,2,102,264,4,1,844,1657,28,742,1393,24,30.142857142857142,>30,NZ,Home,Upto 2014
GR Larsen,NZ,Pace,1996-01-20,Auckland,New Zealand,1996,2,38,156,1,1,908,2025,23,870,1869,22,39.47826086956522,>30,NZ,Home,Upto 2014
GR Larsen,NZ,Pace,1996-04-19,Bridgetown,West Indies,1996,1,76,240,3,1,918,1755,25,842,1515,22,36.72,>30,WI,Away,Upto 2014
GR Larsen,NZ,Pace,1996-04-27,St John's,West Indies,1996,2,96,216,2,1,915,1920,26,819,1704,24,35.19230769230769,>30,WI,Away,Upto 2014
GR Robertson,AUS,Spin,1998-03-06,Chennai,India,1998,2,164,332,5,1,809,1753,28,645,1421,23,28.892857142857142,<=30,IND,Away,Upto 2014
GR Robertson,AUS,Spin,1998-03-18,Eden Gardens,India,1998,1,163,198,2,1,634,1306,12,471,1108,10,52.833333333333336,>30,IND,Away,Upto 2014
GR Robertson,AUS,Spin,1998-03-25,Bengaluru,India,1998,2,86,140,5,1,817,1511,22,731,1371,17,37.13636363636363,>30,IND,Away,Upto 2014
GR Robertson,AUS,Spin,1998-10-22,Karachi,Pakistan,1998,2,102,228,1,1,832,1892,24,730,1664,23,34.666666666666664,>30,PAK,Away,Upto 2014
GR Stead,NZ,Spin,1999-03-11,Christchurch,New Zealand,1999,1,1,6,0,1,135,274,3,134,268,3,45.0,>30,NZ,Home,Upto 2014
GR Sunderam,IND,Pace,1955-12-16,Delhi,India,1955,2,107,252,1,1,511,1457,6,404,1205,5,85.16666666666667,>30,IND,Home,Upto 2014
GR Sunderam,IND,Pace,1955-12-28,Eden Gardens,India,1955,2,59,144,2,1,465,1398,12,406,1254,10,38.75,>30,IND,Home,Upto 2014
GR Viswanath,IND,Spin,1969-11-15,Kanpur,India,1969,2,8,12,0,1,657,2057,13,649,2045,13,50.53846153846154,>30,IND,Home,Upto 2014
GR Viswanath,IND,Spin,1973-01-25,Kanpur,India,1973,1,10,12,0,1,638,1919,18,628,1907,18,35.44444444444444,>30,IND,Home,Upto 2014
GR Viswanath,IND,Spin,1978-10-27,Lahore,Pakistan,1978,1,7,4,0,1,591,988,6,584,984,6,98.5,>30,PAK,Away,Upto 2014
GR Viswanath,IND,Spin,1979-10-13,Delhi,India,1979,1,11,21,1,1,604,1308,12,593,1287,11,50.333333333333336,>30,IND,Home,Upto 2014
GR Viswanath,IND,Spin,1979-11-21,Bengaluru,India,1979,1,6,18,0,1,552,1383,11,546,1365,11,50.18181818181818,>30,IND,Home,Upto 2014
GR Viswanath,IND,Spin,1980-02-15,Wankhede,India,1980,1,4,3,0,1,158,297,1,154,294,1,158.0,>30,IND,Home,Upto 2014
GRA de Silva,SL,Spin,1982-02-17,Colombo (PSS),Sri Lanka,1982,2,98,282,4,1,442,1264,21,344,982,17,21.047619047619047,<=30,SL,Home,Upto 2014
GRA de Silva,SL,Spin,1982-03-05,Karachi,Pakistan,1982,2,143,314,1,1,669,1411,22,526,1097,21,30.40909090909091,>30,PAK,Away,Upto 2014
GRA de Silva,SL,Spin,1982-03-14,Faisalabad,Pakistan,1982,2,66,258,2,1,699,1740,27,633,1482,25,25.88888888888889,<=30,PAK,Away,Upto 2014
GRA de Silva,SL,Spin,1982-09-17,Chennai,India,1982,1,78,108,0,1,682,1194,13,604,1086,13,52.46153846153846,>30,IND,Away,Upto 2014
GRJ Matthews,AUS,Spin,1983-12-26,Melbourne,Australia,1983,2,143,298,4,1,391,853,9,248,555,5,43.44444444444444,>30,AUS,Home,Upto 2014
GRJ Matthews,AUS,Spin,1984-01-02,Sydney,Australia,1984,2,76,150,1,1,181,354,1,105,204,0,181.0,>30,AUS,Home,Upto 2014
GRJ Matthews,AUS,Spin,1984-04-28,Kingston,West Indies,1984,1,10,12,0,1,133,378,4,123,366,4,33.25,>30,WI,Away,Upto 2014
GRJ Matthews,AUS,Spin,1984-12-22,Melbourne,Australia,1984,1,67,87,2,1,287,501,7,220,414,5,41.0,>30,AUS,Home,Upto 2014
GRJ Matthews,AUS,Spin,1985-08-01,Manchester,England,1985,1,21,54,0,1,424,1147,11,403,1093,11,38.54545454545455,>30,ENG,Away,Upto 2014
GRJ Matthews,AUS,Spin,1985-11-08,Brisbane,Australia,1985,1,110,186,3,1,336,547,4,226,361,1,84.0,>30,AUS,Home,Upto 2014
GRJ Matthews,AUS,Spin,1985-11-22,Sydney,Australia,1985,2,87,282,2,1,694,1882,25,607,1600,23,27.76,<=30,AUS,Home,Upto 2014
GRJ Matthews,AUS,Spin,1985-11-30,W.A.C.A,Australia,1985,2,19,84,1,1,164,587,6,145,503,5,27.333333333333332,<=30,AUS,Home,Upto 2014
GRJ Matthews,AUS,Spin,1985-12-13,Adelaide,Australia,1985,1,60,102,0,1,282,786,3,222,684,3,94.0,>30,AUS,Home,Upto 2014
GRJ Matthews,AUS,Spin,1985-12-26,Melbourne,Australia,1985,1,81,186,2,1,583,1474,19,502,1288,17,30.68421052631579,>30,AUS,Home,Upto 2014
GRJ Matthews,AUS,Spin,1986-01-02,Sydney,Australia,1986,1,95,174,0,1,700,1797,15,605,1623,15,46.666666666666664,>30,AUS,Home,Upto 2014
GRJ Matthews,AUS,Spin,1986-02-21,Wellington,New Zealand,1986,1,107,222,2,1,108,246,2,1,24,0,54.0,>30,NZ,Away,Upto 2014
GRJ Matthews,AUS,Spin,1986-02-28,Christchurch,New Zealand,1986,2,22,54,1,1,196,528,6,174,474,5,32.666666666666664,>30,NZ,Away,Upto 2014
GRJ Matthews,AUS,Spin,1986-03-13,Auckland,New Zealand,1986,2,107,390,5,1,300,1053,17,193,663,12,17.647058823529413,<=30,NZ,Away,Upto 2014
GRJ Matthews,AUS,Spin,1986-09-18,Chennai,India,1986,2,249,409,10,1,1032,1788,27,783,1379,17,38.22222222222222,>30,IND,Away,Upto 2014
GRJ Matthews,AUS,Spin,1986-10-15,Wankhede,India,1986,1,158,312,4,1,676,1768,13,518,1456,9,52.0,>30,IND,Away,Upto 2014
GRJ Matthews,AUS,Spin,1986-11-14,Brisbane,Australia,1986,2,59,108,0,1,263,785,6,204,677,6,43.833333333333336,>30,AUS,Home,Upto 2014
GRJ Matthews,AUS,Spin,1986-11-28,W.A.C.A,Australia,1986,1,124,204,1,1,361,930,7,237,726,6,51.57142857142857,>30,AUS,Home,Upto 2014
GRJ Matthews,AUS,Spin,1986-12-12,Adelaide,Australia,1986,2,112,186,1,1,609,1398,9,497,1212,8,67.66666666666667,>30,AUS,Home,Upto 2014
GRJ Matthews,AUS,Spin,1990-11-23,Brisbane,Australia,1990,2,30,102,1,1,46,114,1,16,12,0,46.0,>30,AUS,Home,Upto 2014
GRJ Matthews,AUS,Spin,1990-12-26,Melbourne,Australia,1990,2,105,312,3,1,220,612,3,115,300,0,73.33333333333333,>30,AUS,Home,Upto 2014
GRJ Matthews,AUS,Spin,1991-01-04,Sydney,Australia,1991,2,171,402,3,1,645,1458,16,474,1056,13,40.3125,>30,AUS,Home,Upto 2014
GRJ Matthews,AUS,Spin,1991-01-25,Adelaide,Australia,1991,1,100,186,0,1,183,342,1,83,156,1,183.0,>30,AUS,Home,Upto 2014
GRJ Matthews,AUS,Spin,1991-02-01,W.A.C.A,Australia,1991,1,16,12,0,1,50,60,2,34,48,2,25.0,<=30,AUS,Home,Upto 2014
GRJ Matthews,AUS,Spin,1991-03-01,Kingston,West Indies,1991,2,118,216,0,1,221,516,2,103,300,2,110.5,>30,WI,Away,Upto 2014
GRJ Matthews,AUS,Spin,1991-03-23,Georgetown,West Indies,1991,1,155,227,3,1,331,635,8,176,408,5,41.375,>30,WI,Away,Upto 2014
GRJ Matthews,AUS,Spin,1992-08-17,Colombo (SSC),Sri Lanka,1992,2,169,348,7,1,598,1075,17,429,727,10,35.1764705882353,>30,SL,Away,Upto 2014
GRJ Matthews,AUS,Spin,1992-08-28,Colombo (RPS),Sri Lanka,1992,2,79,186,0,1,357,918,7,278,732,7,51.0,>30,SL,Away,Upto 2014
GRJ Matthews,AUS,Spin,1992-09-08,Moratuwa,Sri Lanka,1992,1,64,186,1,1,347,775,4,283,589,3,86.75,>30,SL,Away,Upto 2014
GRJ Matthews,AUS,Spin,1992-11-27,Brisbane,Australia,1992,2,59,240,2,1,220,633,7,161,393,5,31.428571428571427,>30,AUS,Home,Upto 2014
GRJ Matthews,AUS,Spin,1993-01-02,Sydney,Australia,1993,1,169,354,2,1,617,1258,8,448,904,6,77.125,>30,AUS,Home,Upto 2014
GRJ Roope,ENG,Pace,1973-01-25,Kanpur,India,1973,1,14,30,0,1,253,624,7,239,594,7,36.142857142857146,>30,IND,Away,Upto 2014
GRJ Roope,ENG,Pace,1973-06-07,Nottingham,England,1973,1,17,54,0,1,817,1990,27,800,1936,27,30.25925925925926,>30,ENG,Home,Upto 2014
GRJ Roope,ENG,Pace,1973-06-21,Lord's,England,1973,1,15,36,0,1,777,1763,19,762,1727,19,40.89473684210526,>30,ENG,Home,Upto 2014
GRJ Roope,ENG,Pace,1973-07-26,The Oval,England,1973,1,26,36,0,1,552,1154,24,526,1118,24,23.0,<=30,ENG,Home,Upto 2014
GRJ Roope,ENG,Pace,1978-01-02,Hyderabad (Sind),Pakistan,1978,1,2,8,0,1,260,806,5,258,798,5,52.0,>30,PAK,Away,Upto 2014
GRJ Roope,ENG,Pace,1978-03-04,Auckland,New Zealand,1978,1,2,8,0,1,754,2126,17,752,2118,17,44.35294117647059,>30,NZ,Away,Upto 2014
GS Ballance,ENG,Spin,2014-07-09,Nottingham,England,2014,1,0,6,0,1,324,594,5,324,588,5,64.8,>30,ENG,Home,After 1965
GS Ballance,ENG,Spin,2014-07-27,Southampton,England,2014,1,5,6,0,1,407,690,15,402,684,15,27.133333333333333,<=30,ENG,Home,After 1965
GS Blewett,AUS,Pace,1995-01-26,Adelaide,Australia,1995,2,82,120,0,1,823,1644,27,741,1524,27,30.48148148148148,>30,AUS,Home,Upto 2014
GS Blewett,AUS,Pace,1995-02-03,W.A.C.A,Australia,1995,1,9,24,0,1,946,1817,29,937,1793,29,32.62068965517241,>30,AUS,Home,Upto 2014
GS Blewett,AUS,Pace,1995-11-17,Hobart,Australia,1995,1,25,60,2,1,693,1398,29,668,1338,27,23.896551724137932,<=30,AUS,Home,Upto 2014
GS Blewett,AUS,Pace,1995-11-30,Sydney,Australia,1995,2,6,36,0,1,445,1017,19,439,981,19,23.42105263157895,<=30,AUS,Home,Upto 2014
GS Blewett,AUS,Pace,1996-11-29,Sydney,Australia,1996,1,13,24,1,1,754,1620,23,741,1596,22,32.78260869565217,>30,AUS,Home,Upto 2014
GS Blewett,AUS,Pace,1996-12-26,Melbourne,Australia,1996,2,32,71,0,1,553,1299,28,521,1228,28,19.75,<=30,AUS,Home,Upto 2014
GS Blewett,AUS,Pace,1997-01-25,Adelaide,Australia,1997,1,0,12,0,1,488,1017,11,488,1005,11,44.36363636363637,>30,AUS,Home,Upto 2014
GS Blewett,AUS,Pace,1997-02-01,W.A.C.A,Australia,1997,1,19,36,0,1,699,1242,25,680,1206,25,27.96,<=30,AUS,Home,Upto 2014
GS Blewett,AUS,Pace,1997-02-28,Johannesburg,South Africa,1997,1,23,24,0,1,660,1282,14,637,1258,14,47.142857142857146,>30,SA,Away,Upto 2014
GS Blewett,AUS,Pace,1997-03-14,Gqeberha,South Africa,1997,2,19,69,0,1,528,1387,24,509,1318,24,22.0,<=30,SA,Away,Upto 2014
GS Blewett,AUS,Pace,1997-03-21,Centurion,South Africa,1997,2,32,48,1,1,500,1229,28,468,1181,27,17.857142857142858,<=30,SA,Away,Upto 2014
GS Blewett,AUS,Pace,1997-07-24,Leeds,England,1997,1,17,18,0,1,800,1403,28,783,1385,28,28.571428571428573,<=30,ENG,Away,Upto 2014
GS Blewett,AUS,Pace,1997-11-07,Brisbane,Australia,1997,1,11,36,1,1,809,1711,25,798,1675,24,32.36,>30,AUS,Home,Upto 2014
GS Blewett,AUS,Pace,1997-11-20,W.A.C.A,Australia,1997,1,9,12,0,1,605,1158,21,596,1146,21,28.80952380952381,<=30,AUS,Home,Upto 2014
GS Blewett,AUS,Pace,1997-11-27,Hobart,Australia,1997,1,10,30,0,1,691,1411,18,681,1381,18,38.388888888888886,>30,AUS,Home,Upto 2014
GS Blewett,AUS,Pace,1997-12-26,Melbourne,Australia,1997,1,4,6,0,1,627,1621,23,623,1615,23,27.26086956521739,<=30,AUS,Home,Upto 2014
GS Blewett,AUS,Pace,1998-01-02,Sydney,Australia,1998,2,31,90,1,1,405,1054,13,374,964,12,31.153846153846153,>30,AUS,Home,Upto 2014
GS Blewett,AUS,Pace,1998-01-30,Adelaide,Australia,1998,1,26,84,1,1,879,2002,24,853,1918,23,36.625,>30,AUS,Home,Upto 2014
GS Blewett,AUS,Pace,1998-03-06,Chennai,India,1998,1,35,60,1,1,310,705,5,275,645,4,62.0,>30,IND,Away,Upto 2014
GS Blewett,AUS,Pace,1998-03-18,Eden Gardens,India,1998,1,65,120,1,1,398,718,11,333,598,10,36.18181818181818,>30,IND,Away,Upto 2014
GS Blewett,AUS,Pace,1998-03-25,Bengaluru,India,1998,2,52,90,0,1,319,612,10,267,522,10,31.9,>30,IND,Away,Upto 2014
GS Blewett,AUS,Pace,1999-03-05,Port of Spain,West Indies,1999,1,1,6,0,1,566,1392,32,565,1386,32,17.6875,<=30,WI,Away,Upto 2014
GS Blewett,AUS,Pace,1999-03-13,Kingston,West Indies,1999,1,48,60,0,1,494,1032,18,446,972,18,27.444444444444443,<=30,WI,Away,Upto 2014
GS Blewett,AUS,Pace,1999-04-03,St John's,West Indies,1999,1,9,48,2,1,621,1546,25,612,1498,23,24.84,<=30,WI,Away,Upto 2014
GS Blewett,AUS,Pace,1999-09-22,Galle,Sri Lanka,1999,1,12,18,0,1,252,497,5,240,479,5,50.4,>30,SL,Away,Upto 2014
GS Blewett,AUS,Pace,1999-10-14,Harare,Zimbabwe,1999,1,10,30,0,1,535,1322,16,525,1292,16,33.4375,>30,ZIM,Away,Upto 2014
GS Blewett,AUS,Pace,1999-11-05,Brisbane,Australia,1999,1,22,30,0,1,895,1510,23,873,1480,23,38.91304347826087,>30,AUS,Home,Upto 2014
GS Blewett,AUS,Pace,1999-11-18,Hobart,Australia,1999,2,10,24,0,1,857,1577,19,847,1553,19,45.10526315789474,>30,AUS,Home,Upto 2014
GS Blewett,AUS,Pace,1999-12-10,Adelaide,Australia,1999,1,11,36,0,1,755,1459,27,744,1423,27,27.962962962962962,<=30,AUS,Home,Upto 2014
GS Blewett,AUS,Pace,1999-12-26,Melbourne,Australia,1999,1,17,18,1,1,715,1451,26,698,1433,25,27.5,<=30,AUS,Home,Upto 2014
GS Blewett,AUS,Pace,2000-01-02,Sydney,Australia,2000,2,21,30,1,1,643,1127,22,622,1097,21,29.227272727272727,<=30,AUS,Home,Upto 2014
GS Blewett,AUS,Pace,2000-03-24,Wellington,New Zealand,2000,2,39,66,1,1,802,1476,20,763,1410,19,40.1,>30,NZ,Away,Upto 2014
GS Camacho,WI,Spin,1968-01-19,Port of Spain,West Indies,1968,1,12,18,0,1,688,1548,12,676,1530,12,57.333333333333336,>30,WI,Home,Upto 2014
GS Chappell,AUS,Pace,1970-12-11,W.A.C.A,Australia,1970,2,71,224,1,1,852,2129,21,781,1905,20,40.57142857142857,>30,AUS,Home,Upto 2014
GS Chappell,AUS,Pace,1971-01-09,Sydney,Australia,1971,2,54,208,2,1,480,1339,18,426,1131,16,26.666666666666668,<=30,AUS,Home,Upto 2014
GS Chappell,AUS,Pace,1971-01-21,Melbourne,Australia,1971,2,40,104,0,1,660,1712,13,620,1608,13,50.76923076923077,>30,AUS,Home,Upto 2014
GS Chappell,AUS,Pace,1971-01-29,Adelaide,Australia,1971,2,81,184,2,1,768,1851,22,687,1667,20,34.90909090909091,>30,AUS,Home,Upto 2014
GS Chappell,AUS,Pace,1971-02-12,Sydney,Australia,1971,1,9,24,0,1,479,1333,21,470,1309,21,22.80952380952381,<=30,AUS,Home,Upto 2014
GS Chappell,AUS,Pace,1972-06-08,Manchester,England,1972,2,70,224,2,1,656,1682,30,586,1458,28,21.866666666666667,<=30,ENG,Away,Upto 2014
GS Chappell,AUS,Pace,1972-06-22,Lord's,England,1972,1,18,36,0,1,594,1418,30,576,1382,30,19.8,<=30,ENG,Away,Upto 2014
GS Chappell,AUS,Pace,1972-07-13,Nottingham,England,1972,1,16,54,0,1,670,1779,23,654,1725,23,29.130434782608695,<=30,ENG,Away,Upto 2014
GS Chappell,AUS,Pace,1972-07-27,Leeds,England,1972,1,3,12,0,1,173,528,9,170,516,9,19.22222222222222,<=30,ENG,Away,Upto 2014
GS Chappell,AUS,Pace,1972-08-10,The Oval,England,1972,1,18,12,0,1,662,1491,19,644,1479,19,34.8421052631579,>30,ENG,Away,Upto 2014
GS Chappell,AUS,Pace,1972-12-22,Adelaide,Australia,1972,2,50,120,0,1,517,1131,14,467,1011,14,36.92857142857143,>30,AUS,Home,Upto 2014
GS Chappell,AUS,Pace,1972-12-29,Melbourne,Australia,1972,1,10,8,0,1,925,1467,16,915,1459,16,57.8125,>30,AUS,Home,Upto 2014
GS Chappell,AUS,Pace,1973-01-06,Sydney,Australia,1973,1,61,150,5,1,767,1875,36,706,1725,31,21.305555555555557,<=30,AUS,Home,Upto 2014
GS Chappell,AUS,Pace,1973-02-16,Kingston,West Indies,1973,2,22,72,2,1,629,1295,15,607,1223,13,41.93333333333333,>30,WI,Away,Upto 2014
GS Chappell,AUS,Pace,1973-03-09,Bridgetown,West Indies,1973,1,37,132,0,1,508,1217,11,471,1085,11,46.18181818181818,>30,WI,Away,Upto 2014
GS Chappell,AUS,Pace,1973-03-23,Port of Spain,West Indies,1973,2,81,276,2,1,317,912,10,236,636,8,31.7,>30,WI,Away,Upto 2014
GS Chappell,AUS,Pace,1973-04-06,Georgetown,West Indies,1973,1,56,96,0,1,667,1551,23,611,1455,23,29.0,<=30,WI,Away,Upto 2014
GS Chappell,AUS,Pace,1973-04-21,Port of Spain,West Indies,1973,2,32,78,0,1,343,870,9,311,792,9,38.111111111111114,>30,WI,Away,Upto 2014
GS Chappell,AUS,Pace,1973-12-29,Melbourne,Australia,1973,2,22,88,0,1,539,1189,14,517,1101,14,38.5,>30,AUS,Home,Upto 2014
GS Chappell,AUS,Pace,1974-01-05,Sydney,Australia,1974,2,130,280,5,1,618,1375,28,488,1095,23,22.071428571428573,<=30,AUS,Home,Upto 2014
GS Chappell,AUS,Pace,1974-03-01,Wellington,New Zealand,1974,1,27,56,0,1,960,1997,18,933,1941,18,53.333333333333336,>30,NZ,Away,Upto 2014
GS Chappell,AUS,Pace,1974-03-08,Christchurch,New Zealand,1974,2,114,302,3,1,814,2050,32,700,1748,29,25.4375,<=30,NZ,Away,Upto 2014
GS Chappell,AUS,Pace,1975-08-28,The Oval,England,1975,1,53,72,0,1,686,1764,24,633,1692,24,28.583333333333332,<=30,ENG,Away,Upto 2014
GS Chappell,AUS,Pace,1975-12-26,Melbourne,Australia,1975,1,23,56,1,1,804,1499,27,781,1443,26,29.77777777777778,<=30,AUS,Home,Upto 2014
GS Chappell,AUS,Pace,1976-01-03,Sydney,Australia,1976,2,15,50,2,1,784,1539,30,769,1489,28,26.133333333333333,<=30,AUS,Home,Upto 2014
GS Chappell,AUS,Pace,1976-01-23,Adelaide,Australia,1976,2,25,48,0,1,939,1486,26,914,1438,26,36.11538461538461,>30,AUS,Home,Upto 2014
GS Chappell,AUS,Pace,1976-01-31,Melbourne,Australia,1976,1,6,16,0,1,775,1378,27,769,1362,27,28.703703703703702,<=30,AUS,Home,Upto 2014
GS Chappell,AUS,Pace,1976-12-24,Adelaide,Australia,1976,2,45,144,2,1,783,1646,15,738,1502,13,52.2,>30,AUS,Home,Upto 2014
GS Chappell,AUS,Pace,1977-02-18,Christchurch,New Zealand,1977,1,33,88,0,1,990,2047,22,957,1959,22,45.0,>30,NZ,Away,Upto 2014
GS Chappell,AUS,Pace,1977-02-25,Auckland,New Zealand,1977,2,43,176,2,1,733,1600,29,690,1424,27,25.275862068965516,<=30,NZ,Away,Upto 2014
GS Chappell,AUS,Pace,1977-03-12,Melbourne,Australia,1977,1,29,128,1,1,769,1725,30,740,1597,29,25.633333333333333,<=30,AUS,Home,Upto 2014
GS Chappell,AUS,Pace,1977-06-16,Lord's,England,1977,2,36,90,0,1,753,1756,32,717,1666,32,23.53125,<=30,ENG,Away,Upto 2014
GS Chappell,AUS,Pace,1977-07-07,Manchester,England,1977,1,25,36,0,1,525,1242,14,500,1206,14,37.5,>30,ENG,Away,Upto 2014
GS Chappell,AUS,Pace,1977-07-28,Nottingham,England,1977,1,19,48,0,1,788,1906,27,769,1858,27,29.185185185185187,<=30,ENG,Away,Upto 2014
GS Chappell,AUS,Pace,1977-08-11,Leeds,England,1977,1,25,60,0,1,569,1338,25,544,1278,25,22.76,<=30,ENG,Away,Upto 2014
GS Chappell,AUS,Pace,1979-12-01,Brisbane,Australia,1979,1,25,72,1,1,937,2006,27,912,1934,26,34.7037037037037,>30,AUS,Home,Upto 2014
GS Chappell,AUS,Pace,1979-12-14,W.A.C.A,Australia,1979,2,11,102,1,1,716,1874,34,705,1772,33,21.058823529411764,<=30,AUS,Home,Upto 2014
GS Chappell,AUS,Pace,1979-12-29,Melbourne,Australia,1979,1,3,30,0,1,659,1369,27,656,1339,27,24.40740740740741,<=30,AUS,Home,Upto 2014
GS Chappell,AUS,Pace,1980-01-04,Sydney,Australia,1980,2,55,150,3,1,548,1437,28,493,1287,25,19.571428571428573,<=30,AUS,Home,Upto 2014
GS Chappell,AUS,Pace,1980-02-27,Karachi,Pakistan,1980,1,49,120,3,1,240,648,5,191,528,2,48.0,>30,PAK,Away,Upto 2014
GS Chappell,AUS,Pace,1980-03-06,Faisalabad,Pakistan,1980,1,5,36,0,1,357,750,4,352,714,4,89.25,>30,PAK,Away,Upto 2014
GS Chappell,AUS,Pace,1980-03-18,Lahore,Pakistan,1980,1,20,48,0,1,489,1014,8,469,966,8,61.125,>30,PAK,Away,Upto 2014
GS Chappell,AUS,Pace,1980-08-28,Lord's,England,1980,1,2,12,0,1,636,1262,19,634,1250,19,33.473684210526315,>30,ENG,Away,Upto 2014
GS Chappell,AUS,Pace,1980-11-28,Brisbane,Australia,1980,1,18,24,0,1,530,1227,24,512,1203,24,22.083333333333332,<=30,AUS,Home,Upto 2014
GS Chappell,AUS,Pace,1980-12-12,W.A.C.A,Australia,1980,2,12,60,0,1,516,1220,27,504,1160,27,19.11111111111111,<=30,AUS,Home,Upto 2014
GS Chappell,AUS,Pace,1980-12-26,Melbourne,Australia,1980,2,12,54,2,1,683,1801,29,671,1747,27,23.551724137931036,<=30,AUS,Home,Upto 2014
GS Chappell,AUS,Pace,1981-01-23,Adelaide,Australia,1981,2,18,90,1,1,673,1308,18,655,1218,17,37.388888888888886,>30,AUS,Home,Upto 2014
GS Chappell,AUS,Pace,1981-02-07,Melbourne,Australia,1981,1,9,30,0,1,509,1262,25,500,1232,25,20.36,<=30,AUS,Home,Upto 2014
GS Chappell,AUS,Pace,1981-11-27,Brisbane,Australia,1981,1,6,18,1,1,651,1292,22,645,1274,21,29.59090909090909,<=30,AUS,Home,Upto 2014
GS Chappell,AUS,Pace,1981-12-11,Melbourne,Australia,1981,1,17,54,1,1,395,1019,11,378,965,10,35.90909090909091,>30,AUS,Home,Upto 2014
GS Chappell,AUS,Pace,1981-12-26,Melbourne,Australia,1981,1,0,12,0,1,642,1526,35,642,1514,35,18.34285714285714,<=30,AUS,Home,Upto 2014
GS Chappell,AUS,Pace,1982-02-26,Wellington,New Zealand,1982,1,18,48,0,1,258,786,4,240,738,4,64.5,>30,NZ,Away,Upto 2014
GS Chappell,AUS,Pace,1982-03-12,Auckland,New Zealand,1982,1,3,30,0,1,673,1668,23,670,1638,23,29.26086956521739,<=30,NZ,Away,Upto 2014
GS Chappell,AUS,Pace,1982-03-19,Christchurch,New Zealand,1982,1,30,108,1,1,665,1336,24,635,1228,23,27.708333333333332,<=30,NZ,Away,Upto 2014
GS Chappell,AUS,Pace,1982-11-12,W.A.C.A,Australia,1982,2,19,33,1,1,850,1760,19,831,1727,18,44.73684210526316,>30,AUS,Home,Upto 2014
GS Chappell,AUS,Pace,1982-11-26,Brisbane,Australia,1982,1,8,36,0,1,686,1313,27,678,1277,27,25.40740740740741,<=30,AUS,Home,Upto 2014
GS Chappell,AUS,Pace,1982-12-26,Melbourne,Australia,1982,2,11,12,0,1,837,1586,32,826,1574,32,26.15625,<=30,AUS,Home,Upto 2014
GS Chappell,AUS,Pace,1983-01-02,Sydney,Australia,1983,1,6,6,0,1,595,1175,21,589,1169,21,28.333333333333332,<=30,AUS,Home,Upto 2014
GS Chappell,AUS,Pace,1983-04-22,Kandy,Sri Lanka,1983,1,2,6,0,1,440,696,7,438,690,7,62.857142857142854,>30,SL,Away,Upto 2014
GS Chappell,AUS,Pace,1983-11-11,W.A.C.A,Australia,1983,1,20,54,0,1,628,1218,24,608,1164,24,26.166666666666668,<=30,AUS,Home,Upto 2014
GS Chappell,AUS,Pace,1983-12-09,Adelaide,Australia,1983,1,82,192,0,1,947,1786,20,865,1594,20,47.35,>30,AUS,Home,Upto 2014
GS Chappell,AUS,Pace,1983-12-26,Melbourne,Australia,1983,2,28,90,0,1,818,1728,17,790,1638,17,48.11764705882353,>30,AUS,Home,Upto 2014
GS Chappell,AUS,Pace,1984-01-02,Sydney,Australia,1984,1,25,48,0,1,768,1631,25,743,1583,25,30.72,>30,AUS,Home,Upto 2014
GS Ramchand,IND,Pace,1952-06-05,Leeds,England,1952,2,104,320,2,1,376,1124,14,272,804,12,26.857142857142858,<=30,ENG,Away,Upto 2014
GS Ramchand,IND,Pace,1952-06-19,Lord's,England,1952,2,72,180,0,1,486,1206,17,414,1026,17,28.58823529411765,<=30,ENG,Away,Upto 2014
GS Ramchand,IND,Pace,1952-07-17,Manchester,England,1952,1,78,198,1,1,188,520,17,110,322,16,11.058823529411764,<=30,ENG,Away,Upto 2014
GS Ramchand,IND,Pace,1952-08-14,The Oval,England,1952,1,50,84,1,1,139,287,11,89,203,10,12.636363636363637,<=30,ENG,Away,Upto 2014
GS Ramchand,IND,Pace,1952-10-16,Delhi,India,1952,2,45,120,0,1,227,672,5,182,552,5,45.4,>30,IND,Home,Upto 2014
GS Ramchand,IND,Pace,1952-11-28,Chennai,India,1952,1,66,120,1,1,235,515,6,169,395,5,39.166666666666664,>30,IND,Home,Upto 2014
GS Ramchand,IND,Pace,1952-12-12,Eden Gardens,India,1952,2,63,174,5,1,409,1086,14,346,912,9,29.214285714285715,<=30,IND,Home,Upto 2014
GS Ramchand,IND,Pace,1953-01-21,Port of Spain,West Indies,1953,2,87,210,1,1,431,1261,9,344,1051,8,47.888888888888886,>30,WI,Away,Upto 2014
GS Ramchand,IND,Pace,1953-02-07,Bridgetown,West Indies,1953,2,41,78,1,1,175,498,7,134,420,6,25.0,<=30,WI,Away,Upto 2014
GS Ramchand,IND,Pace,1953-02-19,Port of Spain,West Indies,1953,2,109,210,2,1,346,1003,10,237,793,8,34.6,>30,WI,Away,Upto 2014
GS Ramchand,IND,Pace,1953-03-11,Georgetown,West Indies,1953,1,48,102,2,1,150,444,4,102,342,2,37.5,>30,WI,Away,Upto 2014
GS Ramchand,IND,Pace,1953-03-28,Kingston,West Indies,1953,2,117,306,2,1,439,1284,11,322,978,9,39.90909090909091,>30,WI,Away,Upto 2014
GS Ramchand,IND,Pace,1955-01-01,Dhaka,Bangladesh,1955,2,49,204,2,1,253,947,14,204,743,12,18.071428571428573,<=30,BAN,Away,Upto 2014
GS Ramchand,IND,Pace,1955-01-15,Bahawalpur,Pakistan,1955,1,26,78,0,1,416,1187,15,390,1109,15,27.733333333333334,<=30,PAK,Away,Upto 2014
GS Ramchand,IND,Pace,1955-01-29,Lahore,Pakistan,1955,2,32,96,0,1,171,571,7,139,475,7,24.428571428571427,<=30,PAK,Away,Upto 2014
GS Ramchand,IND,Pace,1955-02-12,Peshawar,Pakistan,1955,2,16,54,1,1,201,612,7,185,558,6,28.714285714285715,<=30,PAK,Away,Upto 2014
GS Ramchand,IND,Pace,1955-02-26,Karachi,Pakistan,1955,2,76,234,7,1,257,771,19,181,537,12,13.526315789473685,<=30,PAK,Away,Upto 2014
GS Ramchand,IND,Pace,1955-11-19,Hyderabad (Deccan),India,1955,2,47,204,1,1,344,973,5,297,769,4,68.8,>30,IND,Home,Upto 2014
GS Ramchand,IND,Pace,1955-12-02,Brabourne,India,1955,2,57,222,2,1,320,942,10,263,720,8,32.0,>30,IND,Home,Upto 2014
GS Ramchand,IND,Pace,1955-12-16,Delhi,India,1955,2,93,246,0,1,511,1457,6,418,1211,6,85.16666666666667,>30,IND,Home,Upto 2014
GS Ramchand,IND,Pace,1955-12-28,Eden Gardens,India,1955,2,68,228,2,1,465,1398,12,397,1170,10,38.75,>30,IND,Home,Upto 2014
GS Ramchand,IND,Pace,1956-01-06,Chennai,India,1956,2,11,72,0,1,296,750,1,285,678,1,296.0,>30,IND,Home,Upto 2014
GS Ramchand,IND,Pace,1956-10-19,Chennai,India,1956,1,12,30,0,1,145,569,11,133,539,11,13.181818181818182,<=30,IND,Home,Upto 2014
GS Ramchand,IND,Pace,1956-10-26,Brabourne,India,1956,1,78,108,1,1,321,854,10,243,746,9,32.1,>30,IND,Home,Upto 2014
GS Ramchand,IND,Pace,1956-11-02,Eden Gardens,India,1956,2,7,24,1,1,49,278,4,42,254,3,12.25,<=30,IND,Home,Upto 2014
GS Ramchand,IND,Pace,1958-11-28,Brabourne,India,1958,2,53,132,2,1,439,1262,18,386,1130,16,24.38888888888889,<=30,IND,Home,Upto 2014
GS Ramchand,IND,Pace,1958-12-12,Kanpur,India,1958,2,136,300,2,1,403,1061,19,267,761,17,21.210526315789473,<=30,IND,Home,Upto 2014
GS Ramchand,IND,Pace,1959-01-21,Chennai,India,1959,2,58,168,1,1,372,990,12,314,822,11,31.0,>30,IND,Home,Upto 2014
GS Ramchand,IND,Pace,1959-12-12,Delhi,India,1959,1,27,42,1,1,410,963,10,383,921,9,41.0,>30,IND,Home,Upto 2014
GS Ramchand,IND,Pace,1959-12-19,Kanpur,India,1959,2,21,54,0,1,231,796,13,210,742,13,17.76923076923077,<=30,IND,Home,Upto 2014
GS Ramchand,IND,Pace,1960-01-01,Brabourne,India,1960,1,85,210,0,1,552,1475,15,467,1265,15,36.8,>30,IND,Home,Upto 2014
GS Ramchand,IND,Pace,1960-01-13,Chennai,India,1960,1,26,90,0,1,260,780,12,234,690,12,21.666666666666668,<=30,IND,Home,Upto 2014
GS Ramchand,IND,Pace,1960-01-23,Eden Gardens,India,1960,2,41,78,0,1,523,1340,17,482,1262,17,30.764705882352942,>30,IND,Home,Upto 2014
GS Sobers,WI,Spin,1954-03-30,Kingston,West Indies,1954,2,81,179,4,1,581,1630,14,500,1451,10,41.5,>30,WI,Home,Upto 2014
GS Sobers,WI,Spin,1955-04-11,Port of Spain,West Indies,1955,1,10,18,0,1,545,1044,8,535,1026,8,68.125,>30,WI,Home,Upto 2014
GS Sobers,WI,Spin,1955-04-26,Georgetown,West Indies,1955,2,39,162,3,1,484,1365,24,445,1203,21,20.166666666666668,<=30,WI,Home,Upto 2014
GS Sobers,WI,Spin,1955-05-14,Bridgetown,West Indies,1955,2,65,155,2,1,1042,2444,22,977,2289,20,47.36363636363637,>30,WI,Home,Upto 2014
GS Sobers,WI,Spin,1955-06-11,Kingston,West Indies,1955,1,99,228,1,1,758,1737,11,659,1509,10,68.9090909090909,>30,WI,Home,Upto 2014
GS Sobers,WI,Spin,1956-02-03,Dunedin,New Zealand,1956,1,0,24,0,1,439,1372,20,439,1348,20,21.95,<=30,NZ,Away,Upto 2014
GS Sobers,WI,Spin,1956-03-03,Wellington,New Zealand,1956,2,14,137,2,1,421,1506,19,407,1369,17,22.157894736842106,<=30,NZ,Away,Upto 2014
GS Sobers,WI,Spin,1956-03-09,Auckland,New Zealand,1956,1,35,120,0,1,420,1482,16,385,1362,16,26.25,<=30,NZ,Away,Upto 2014
GS Sobers,WI,Spin,1957-05-30,Birmingham,England,1957,1,77,180,0,1,809,2558,20,732,2378,20,40.45,>30,ENG,Away,Upto 2014
GS Sobers,WI,Spin,1957-06-20,Lord's,England,1957,1,28,42,2,1,343,654,7,315,612,5,49.0,>30,ENG,Away,Upto 2014
GS Sobers,WI,Spin,1957-07-04,Nottingham,England,1957,1,60,126,1,1,731,1812,9,671,1686,8,81.22222222222223,>30,ENG,Away,Upto 2014
GS Sobers,WI,Spin,1957-07-25,Leeds,England,1957,1,79,192,1,1,269,814,12,190,622,11,22.416666666666668,<=30,ENG,Away,Upto 2014
GS Sobers,WI,Spin,1957-08-22,The Oval,England,1957,1,111,264,1,1,485,1435,24,374,1171,23,20.208333333333332,<=30,ENG,Away,Upto 2014
GS Sobers,WI,Spin,1958-01-17,Bridgetown,West Indies,1958,1,94,342,1,1,679,1898,11,585,1556,10,61.72727272727273,>30,WI,Home,Upto 2014
GS Sobers,WI,Spin,1958-02-05,Port of Spain,West Indies,1958,2,55,165,3,1,477,1223,18,422,1058,15,26.5,<=30,WI,Home,Upto 2014
GS Sobers,WI,Spin,1958-02-26,Kingston,West Indies,1958,2,54,120,0,1,450,846,3,396,726,3,150.0,>30,WI,Home,Upto 2014
GS Sobers,WI,Spin,1958-03-13,Georgetown,West Indies,1958,2,79,198,0,1,1032,2327,20,953,2129,20,51.6,>30,WI,Home,Upto 2014
GS Sobers,WI,Spin,1958-03-26,Port of Spain,West Indies,1958,1,95,204,0,1,527,1152,14,432,948,14,37.642857142857146,>30,WI,Home,Upto 2014
GS Sobers,WI,Spin,1958-11-28,Brabourne,India,1958,2,27,36,0,1,512,1219,9,485,1183,9,56.888888888888886,>30,IND,Away,Upto 2014
GS Sobers,WI,Spin,1958-12-12,Kanpur,India,1958,2,91,270,2,1,669,1431,13,578,1161,11,51.46153846153846,>30,IND,Away,Upto 2014
GS Sobers,WI,Spin,1958-12-31,Eden Gardens,India,1958,2,43,48,2,1,513,906,7,470,858,5,73.28571428571429,>30,IND,Away,Upto 2014
GS Sobers,WI,Spin,1959-01-21,Chennai,India,1959,2,65,217,6,1,586,1441,19,521,1224,13,30.842105263157894,>30,IND,Away,Upto 2014
GS Sobers,WI,Spin,1959-02-06,Delhi,India,1959,1,66,144,0,1,775,1794,11,709,1650,11,70.45454545454545,>30,IND,Away,Upto 2014
GS Sobers,WI,Spin,1959-02-20,Karachi,Pakistan,1959,2,57,294,0,1,375,1262,15,318,968,15,25.0,<=30,PAK,Away,Upto 2014
GS Sobers,WI,Spin,1959-03-06,Dhaka,Bangladesh,1959,2,11,66,0,1,170,591,9,159,525,9,18.88888888888889,<=30,BAN,Away,Upto 2014
GS Sobers,WI,Spin,1959-03-26,Lahore,Pakistan,1959,1,9,36,0,1,360,902,15,351,866,15,24.0,<=30,PAK,Away,Upto 2014
GS Sobers,WI,Spin,1960-01-06,Bridgetown,West Indies,1960,1,53,126,0,1,518,1446,6,465,1320,6,86.33333333333333,>30,WI,Home,Upto 2014
GS Sobers,WI,Spin,1960-01-28,Port of Spain,West Indies,1960,1,16,18,0,1,448,1444,13,432,1426,13,34.46153846153846,>30,WI,Home,Upto 2014
GS Sobers,WI,Spin,1960-02-17,Kingston,West Indies,1960,2,32,60,0,1,443,1323,11,411,1263,11,40.27272727272727,>30,WI,Home,Upto 2014
GS Sobers,WI,Spin,1960-03-09,Georgetown,West Indies,1960,2,95,186,4,1,501,1694,13,406,1508,9,38.53846153846154,>30,WI,Home,Upto 2014
GS Sobers,WI,Spin,1960-03-25,Port of Spain,West Indies,1960,2,159,294,5,1,649,1404,16,490,1110,11,40.5625,>30,WI,Home,Upto 2014
GS Sobers,WI,Spin,1960-12-09,Brisbane,Australia,1960,2,145,320,2,1,778,1958,13,633,1638,11,59.84615384615385,>30,AUS,Away,Upto 2014
GS Sobers,WI,Spin,1960-12-30,Melbourne,Australia,1960,1,88,136,1,1,443,1051,13,355,915,12,34.07692307692308,>30,AUS,Away,Upto 2014
GS Sobers,WI,Spin,1961-01-13,Sydney,Australia,1961,2,52,112,2,1,670,1732,26,618,1620,24,25.76923076923077,<=30,AUS,Away,Upto 2014
GS Sobers,WI,Spin,1961-01-27,Adelaide,Australia,1961,2,151,504,5,1,1001,2526,24,850,2022,19,41.708333333333336,>30,AUS,Away,Upto 2014
GS Sobers,WI,Spin,1961-02-10,Melbourne,Australia,1961,2,152,456,5,1,762,2498,25,610,2042,20,30.48,>30,AUS,Away,Upto 2014
GS Sobers,WI,Spin,1962-02-16,Port of Spain,West Indies,1962,2,50,147,6,1,339,916,17,289,769,11,19.941176470588236,<=30,WI,Home,Upto 2014
GS Sobers,WI,Spin,1962-03-07,Kingston,West Indies,1962,2,116,336,5,1,783,1924,16,667,1588,11,48.9375,>30,WI,Home,Upto 2014
GS Sobers,WI,Spin,1962-03-23,Bridgetown,West Indies,1962,2,60,198,2,1,596,2431,22,536,2233,20,27.09090909090909,<=30,WI,Home,Upto 2014
GS Sobers,WI,Spin,1962-04-04,Port of Spain,West Indies,1962,2,164,432,5,1,911,2452,24,747,2020,19,37.958333333333336,>30,WI,Home,Upto 2014
GS Sobers,WI,Spin,1962-04-13,Kingston,West Indies,1962,2,83,228,5,1,527,1208,20,444,980,15,26.35,<=30,WI,Home,Upto 2014
GS Sobers,WI,Spin,1963-06-06,Manchester,England,1963,2,156,354,4,1,595,1480,19,439,1126,15,31.31578947368421,>30,ENG,Away,Upto 2014
GS Sobers,WI,Spin,1963-06-20,Lord's,England,1963,2,49,132,1,1,329,816,7,280,684,6,47.0,>30,ENG,Away,Upto 2014
GS Sobers,WI,Spin,1963-07-04,Birmingham,England,1963,2,140,348,7,1,265,746,12,125,398,5,22.083333333333332,<=30,ENG,Away,Upto 2014
GS Sobers,WI,Spin,1963-07-25,Leeds,England,1963,2,105,228,3,1,443,1017,19,338,789,16,23.31578947368421,<=30,ENG,Away,Upto 2014
GS Sobers,WI,Spin,1963-08-22,The Oval,England,1963,2,121,324,5,1,379,930,8,258,606,3,47.375,>30,ENG,Away,Upto 2014
GS Sobers,WI,Spin,1965-03-03,Kingston,West Indies,1965,2,94,226,2,1,482,1161,15,388,935,13,32.13333333333333,>30,WI,Home,Upto 2014
GS Sobers,WI,Spin,1965-03-26,Port of Spain,West Indies,1965,1,75,167,3,1,736,1898,17,661,1731,14,43.294117647058826,>30,WI,Home,Upto 2014
GS Sobers,WI,Spin,1965-04-14,Georgetown,West Indies,1965,2,77,186,4,1,385,975,21,308,789,17,18.333333333333332,<=30,WI,Home,Upto 2014
GS Sobers,WI,Spin,1965-05-05,Bridgetown,West Indies,1965,2,172,342,2,1,856,1946,10,684,1604,8,85.6,>30,WI,Home,Upto 2014
GS Sobers,WI,Spin,1965-05-14,Port of Spain,West Indies,1965,2,72,234,1,1,396,885,11,324,651,10,36.0,>30,WI,Home,Upto 2014
GS Sobers,WI,Spin,1966-06-02,Manchester,England,1966,2,103,294,3,1,479,1280,24,376,986,21,19.958333333333332,<=30,ENG,Away,Upto 2014
GS Sobers,WI,Spin,1966-06-16,Lord's,England,1966,2,97,282,1,1,279,801,4,182,519,3,69.75,>30,ENG,Away,Upto 2014
GS Sobers,WI,Spin,1966-06-30,Nottingham,England,1966,2,161,480,5,1,501,1422,8,340,942,3,62.625,>30,ENG,Away,Upto 2014
GS Sobers,WI,Spin,1966-08-04,Leeds,England,1966,2,80,238,8,1,445,946,16,365,708,8,27.8125,<=30,ENG,Away,Upto 2014
GS Sobers,WI,Spin,1966-08-18,The Oval,England,1966,1,104,324,3,1,515,1218,14,411,894,11,36.785714285714285,>30,ENG,Away,Upto 2014
GS Sobers,WI,Spin,1966-12-13,Brabourne,India,1966,2,125,312,5,1,1023,2319,28,898,2007,23,36.535714285714285,>30,IND,Away,Upto 2014
GS Sobers,WI,Spin,1966-12-31,Eden Gardens,India,1966,2,98,293,7,1,445,1335,20,347,1042,13,22.25,<=30,IND,Away,Upto 2014
GS Sobers,WI,Spin,1967-01-13,Chennai,India,1967,2,127,326,2,1,841,1944,23,714,1618,21,36.56521739130435,>30,IND,Away,Upto 2014
GS Sobers,WI,Spin,1968-01-19,Port of Spain,West Indies,1968,1,83,156,1,1,688,1548,12,605,1392,11,57.333333333333336,>30,WI,Home,Upto 2014
GS Sobers,WI,Spin,1968-02-08,Kingston,West Indies,1968,2,89,287,4,1,308,929,12,219,642,8,25.666666666666668,<=30,WI,Home,Upto 2014
GS Sobers,WI,Spin,1968-02-29,Bridgetown,West Indies,1968,1,76,246,2,1,405,1049,8,329,803,6,50.625,>30,WI,Home,Upto 2014
GS Sobers,WI,Spin,1968-03-14,Port of Spain,West Indies,1968,2,135,300,0,1,721,1580,15,586,1280,15,48.06666666666667,>30,WI,Home,Upto 2014
GS Sobers,WI,Spin,1968-03-28,Georgetown,West Indies,1968,2,125,408,6,1,621,1884,22,496,1476,16,28.227272727272727,<=30,WI,Home,Upto 2014
GS Sobers,WI,Spin,1968-12-06,Brisbane,Australia,1968,2,103,382,7,1,799,2162,28,696,1780,21,28.535714285714285,<=30,AUS,Away,Upto 2014
GS Sobers,WI,Spin,1968-12-26,Melbourne,Australia,1968,1,97,267,4,1,459,1287,15,362,1020,11,30.6,>30,AUS,Away,Upto 2014
GS Sobers,WI,Spin,1969-01-03,Sydney,Australia,1969,1,109,168,0,1,463,1006,8,354,838,8,57.875,>30,AUS,Away,Upto 2014
GS Sobers,WI,Spin,1969-01-24,Adelaide,Australia,1969,2,213,400,2,1,1020,2021,15,807,1621,13,68.0,>30,AUS,Away,Upto 2014
GS Sobers,WI,Spin,1969-02-14,Sydney,Australia,1969,2,211,432,5,1,776,1562,17,565,1130,12,45.64705882352941,>30,AUS,Away,Upto 2014
GS Sobers,WI,Spin,1969-02-27,Auckland,New Zealand,1969,2,166,392,3,1,637,1524,17,471,1132,14,37.470588235294116,>30,NZ,Away,Upto 2014
GS Sobers,WI,Spin,1969-03-07,Wellington,New Zealand,1969,2,44,136,1,1,243,621,7,199,485,6,34.714285714285715,>30,NZ,Away,Upto 2014
GS Sobers,WI,Spin,1969-03-13,Christchurch,New Zealand,1969,2,91,312,3,1,515,1459,16,424,1147,13,32.1875,>30,NZ,Away,Upto 2014
GS Sobers,WI,Spin,1969-06-12,Manchester,England,1969,2,79,174,1,1,322,1014,6,243,840,5,53.666666666666664,>30,ENG,Away,Upto 2014
GS Sobers,WI,Spin,1969-06-26,Lord's,England,1969,2,129,330,3,1,394,1024,8,265,694,5,49.25,>30,ENG,Away,Upto 2014
GS Sobers,WI,Spin,1969-07-10,Leeds,England,1969,2,110,366,7,1,278,822,14,168,456,7,19.857142857142858,<=30,ENG,Away,Upto 2014
GS Sobers,WI,Spin,1971-02-18,Kingston,West Indies,1971,1,57,180,2,1,757,1901,17,700,1721,15,44.529411764705884,>30,WI,Home,Upto 2014
GS Sobers,WI,Spin,1971-03-06,Port of Spain,West Indies,1971,2,81,258,0,1,708,1890,29,627,1632,29,24.413793103448278,<=30,WI,Home,Upto 2014
GS Sobers,WI,Spin,1971-03-19,Georgetown,West Indies,1971,2,86,288,3,1,785,2232,14,699,1944,11,56.07142857142857,>30,WI,Home,Upto 2014
GS Sobers,WI,Spin,1971-04-01,Bridgetown,West Indies,1971,2,65,258,4,1,692,1614,11,627,1356,7,62.90909090909091,>30,WI,Home,Upto 2014
GS Sobers,WI,Spin,1971-04-13,Port of Spain,West Indies,1971,2,112,330,3,1,963,2470,24,851,2140,21,40.125,>30,WI,Home,Upto 2014
GS Sobers,WI,Spin,1972-02-16,Kingston,West Indies,1972,2,36,144,0,1,653,1794,11,617,1650,11,59.36363636363637,>30,WI,Home,Upto 2014
GS Sobers,WI,Spin,1972-03-09,Port of Spain,West Indies,1972,2,94,276,3,1,722,2183,14,628,1907,11,51.57142857142857,>30,WI,Home,Upto 2014
GS Sobers,WI,Spin,1972-03-23,Bridgetown,West Indies,1972,1,64,174,4,1,454,1224,7,390,1050,3,64.85714285714286,>30,WI,Home,Upto 2014
GS Sobers,WI,Spin,1972-04-06,Georgetown,West Indies,1972,1,76,252,0,1,489,1488,3,413,1236,3,163.0,>30,WI,Home,Upto 2014
GS Sobers,WI,Spin,1972-04-20,Port of Spain,West Indies,1972,2,62,240,3,1,509,1648,17,447,1408,14,29.941176470588236,<=30,WI,Home,Upto 2014
GS Sobers,WI,Spin,1973-07-26,The Oval,England,1973,2,49,199,3,1,563,1459,15,514,1260,12,37.53333333333333,>30,ENG,Away,Upto 2014
GS Sobers,WI,Spin,1973-08-09,Birmingham,England,1973,2,83,222,3,1,511,1445,13,428,1223,10,39.30769230769231,>30,ENG,Away,Upto 2014
GS Sobers,WI,Spin,1973-08-23,Lord's,England,1973,2,37,72,0,1,503,859,9,466,787,9,55.888888888888886,>30,ENG,Away,Upto 2014
GS Sobers,WI,Spin,1974-02-02,Port of Spain,West Indies,1974,2,91,288,5,1,671,1657,22,580,1369,17,30.5,>30,WI,Home,Upto 2014
GS Sobers,WI,Spin,1974-02-16,Kingston,West Indies,1974,2,138,402,4,1,880,2436,16,742,2034,12,55.0,>30,WI,Home,Upto 2014
GS Sobers,WI,Spin,1974-03-06,Bridgetown,West Indies,1974,2,112,318,2,1,534,1195,11,422,877,9,48.54545454545455,>30,WI,Home,Upto 2014
GS Sobers,WI,Spin,1974-03-30,Port of Spain,West Indies,1974,2,80,332,3,1,805,2406,29,725,2074,26,27.75862068965517,<=30,WI,Home,Upto 2014
GT Dowling,NZ,Pace,1965-03-05,Eden Gardens,India,1965,1,19,36,1,1,421,713,14,402,677,13,30.071428571428573,>30,IND,Away,Upto 2014
GTS Stevens,ENG,Spin,1922-12-23,Johannesburg,South Africa,1922,1,19,24,0,1,279,546,8,260,522,8,34.875,>30,SA,Away,Upto 2014
GTS Stevens,ENG,Spin,1926-07-24,Manchester,England,1926,1,86,192,3,1,479,1184,11,393,992,8,43.54545454545455,>30,ENG,Home,Upto 2014
GTS Stevens,ENG,Spin,1926-08-14,The Oval,England,1926,2,98,192,2,1,808,2213,28,710,2021,26,28.857142857142858,<=30,ENG,Home,Upto 2014
GTS Stevens,ENG,Spin,1927-12-24,Johannesburg,South Africa,1927,2,71,162,3,1,312,867,11,241,705,8,28.363636363636363,<=30,SA,Away,Upto 2014
GTS Stevens,ENG,Spin,1927-12-31,Cape Town,South Africa,1927,2,43,90,1,1,504,1376,23,461,1286,22,21.91304347826087,<=30,SA,Away,Upto 2014
GTS Stevens,ENG,Spin,1928-01-21,Durban,South Africa,1928,2,70,90,0,1,719,1581,22,649,1491,22,32.68181818181818,>30,SA,Away,Upto 2014
GTS Stevens,ENG,Spin,1928-01-28,Johannesburg,South Africa,1928,2,9,12,0,1,407,779,13,398,767,13,31.307692307692307,>30,SA,Away,Upto 2014
GTS Stevens,ENG,Spin,1928-02-04,Durban,South Africa,1928,1,11,12,0,1,423,969,13,412,957,13,32.53846153846154,>30,SA,Away,Upto 2014
GTS Stevens,ENG,Spin,1930-01-11,Bridgetown,West Indies,1930,2,195,322,10,1,542,1217,16,347,895,6,33.875,>30,WI,Away,Upto 2014
GTS Stevens,ENG,Spin,1930-02-01,Port of Spain,West Indies,1930,2,46,90,1,1,356,890,8,310,800,7,44.5,>30,WI,Away,Upto 2014
GW Flower,ZIM,Spin,1992-10-18,Harare,Zimbabwe,1992,1,15,30,0,1,383,1070,9,368,1040,9,42.55555555555556,>30,ZIM,Home,Upto 2014
GW Flower,ZIM,Spin,1992-11-01,Bulawayo,Zimbabwe,1992,2,37,72,1,1,469,976,10,432,904,9,46.9,>30,ZIM,Home,Upto 2014
GW Flower,ZIM,Spin,1992-11-07,Harare,Zimbabwe,1992,2,56,60,0,1,372,723,13,316,663,13,28.615384615384617,<=30,ZIM,Home,Upto 2014
GW Flower,ZIM,Spin,1993-12-01,Karachi,Pakistan,1993,1,8,36,1,1,291,834,6,283,798,5,48.5,>30,PAK,Away,Upto 2014
GW Flower,ZIM,Spin,1993-12-09,Rawalpindi,Pakistan,1993,1,13,24,0,1,59,150,0,46,126,0,inf,>30,PAK,Away,Upto 2014
GW Flower,ZIM,Spin,1993-12-16,Lahore,Pakistan,1993,1,15,60,0,1,31,97,0,16,37,0,inf,>30,PAK,Away,Upto 2014
GW Flower,ZIM,Spin,1994-10-11,Harare,Zimbabwe,1994,1,16,48,0,1,210,576,2,194,528,2,105.0,>30,ZIM,Home,Upto 2014
GW Flower,ZIM,Spin,1994-10-20,Bulawayo,Zimbabwe,1994,2,13,36,0,1,318,948,5,305,912,5,63.6,>30,ZIM,Home,Upto 2014
GW Flower,ZIM,Spin,1995-10-13,Harare,Zimbabwe,1995,1,14,18,0,1,142,312,1,128,294,1,142.0,>30,ZIM,Home,Upto 2014
GW Flower,ZIM,Spin,1996-01-13,Hamilton,New Zealand,1996,1,7,18,0,1,166,401,6,159,383,6,27.666666666666668,<=30,NZ,Away,Upto 2014
GW Flower,ZIM,Spin,1996-01-20,Auckland,New Zealand,1996,1,20,30,0,1,314,606,5,294,576,5,62.8,>30,NZ,Away,Upto 2014
GW Flower,ZIM,Spin,1996-09-11,Colombo (RPS),Sri Lanka,1996,1,16,24,0,1,302,952,21,286,928,21,14.380952380952381,<=30,SL,Away,Upto 2014
GW Flower,ZIM,Spin,1996-09-18,Colombo (SSC),Sri Lanka,1996,1,13,12,0,1,399,1111,19,386,1099,19,21.0,<=30,SL,Away,Upto 2014
GW Flower,ZIM,Spin,1996-10-17,Sheikhupura,Pakistan,1996,1,10,60,0,1,616,1340,14,606,1280,14,44.0,>30,PAK,Away,Upto 2014
GW Flower,ZIM,Spin,1996-10-24,Faisalabad,Pakistan,1996,1,4,12,1,1,168,373,4,164,361,3,42.0,>30,PAK,Away,Upto 2014
GW Flower,ZIM,Spin,1996-12-18,Bulawayo,Zimbabwe,1996,2,56,90,0,1,518,1335,18,462,1245,18,28.77777777777778,<=30,ZIM,Home,Upto 2014
GW Flower,ZIM,Spin,1996-12-26,Harare,Zimbabwe,1996,1,9,42,0,1,217,642,8,208,600,8,27.125,<=30,ZIM,Home,Upto 2014
GW Flower,ZIM,Spin,1997-09-25,Bulawayo,Zimbabwe,1997,2,29,78,0,1,722,1402,21,693,1324,21,34.38095238095238,>30,ZIM,Home,Upto 2014
GW Flower,ZIM,Spin,1998-03-14,Bulawayo,Zimbabwe,1998,1,3,6,0,1,364,712,5,361,706,5,72.8,>30,ZIM,Home,Upto 2014
GW Flower,ZIM,Spin,1999-10-14,Harare,Zimbabwe,1999,1,38,108,1,1,296,763,10,258,655,9,29.6,<=30,ZIM,Home,Upto 2014
GW Flower,ZIM,Spin,1999-10-29,Bloemfontein,South Africa,1999,1,44,138,1,1,80,229,5,36,91,4,16.0,<=30,SA,Away,Upto 2014
GW Flower,ZIM,Spin,1999-11-11,Harare,Zimbabwe,1999,1,52,108,0,1,131,233,4,79,125,4,32.75,>30,ZIM,Home,Upto 2014
GW Flower,ZIM,Spin,1999-11-18,Bulawayo,Zimbabwe,1999,1,3,24,0,1,248,534,3,245,510,3,82.66666666666667,>30,ZIM,Home,Upto 2014
GW Flower,ZIM,Spin,1999-11-26,Harare,Zimbabwe,1999,1,34,57,1,1,215,630,10,181,573,9,21.5,<=30,ZIM,Home,Upto 2014
GW Flower,ZIM,Spin,2000-03-16,Port of Spain,West Indies,2000,2,19,66,0,1,105,340,7,86,274,7,15.0,<=30,WI,Away,Upto 2014
GW Flower,ZIM,Spin,2000-03-24,Kingston,West Indies,2000,2,14,114,0,1,234,532,3,220,418,3,78.0,>30,WI,Away,Upto 2014
GW Flower,ZIM,Spin,2000-06-01,Nottingham,England,2000,1,2,6,0,1,131,266,2,129,260,2,65.5,>30,ENG,Away,Upto 2014
GW Flower,ZIM,Spin,2000-09-12,Bulawayo,Zimbabwe,2000,2,31,105,0,1,456,1365,20,425,1260,20,22.8,<=30,ZIM,Home,Upto 2014
GW Flower,ZIM,Spin,2000-09-19,Harare,Zimbabwe,2000,1,59,123,1,1,218,549,3,159,426,2,72.66666666666667,>30,ZIM,Home,Upto 2014
GW Flower,ZIM,Spin,2000-11-18,Delhi,India,2000,2,62,92,0,1,622,1309,9,560,1217,9,69.11111111111111,>30,IND,Away,Upto 2014
GW Flower,ZIM,Spin,2000-11-25,Nagpur,India,2000,1,101,144,2,1,810,1427,12,709,1283,10,67.5,>30,IND,Away,Upto 2014
GW Flower,ZIM,Spin,2001-04-26,Harare,Zimbabwe,2001,1,13,36,0,1,348,861,12,335,825,12,29.0,<=30,ZIM,Home,Upto 2014
GW Flower,ZIM,Spin,2001-06-07,Bulawayo,Zimbabwe,2001,1,23,48,1,1,315,644,5,292,596,4,63.0,>30,ZIM,Home,Upto 2014
GW Flower,ZIM,Spin,2001-06-15,Harare,Zimbabwe,2001,2,4,12,0,1,185,428,8,181,416,8,23.125,<=30,ZIM,Home,Upto 2014
GW Flower,ZIM,Spin,2001-07-19,Bulawayo,Zimbabwe,2001,1,52,78,0,1,317,696,7,265,618,7,45.285714285714285,>30,ZIM,Home,Upto 2014
GW Flower,ZIM,Spin,2001-07-27,Harare,Zimbabwe,2001,1,14,36,0,1,386,944,10,372,908,10,38.6,>30,ZIM,Home,Upto 2014
GW Flower,ZIM,Spin,2001-09-07,Harare,Zimbabwe,2001,1,18,36,0,1,406,782,4,388,746,4,101.5,>30,ZIM,Home,Upto 2014
GW Flower,ZIM,Spin,2001-09-14,Bulawayo,Zimbabwe,2001,1,45,48,0,1,460,1130,12,415,1082,12,38.333333333333336,>30,ZIM,Home,Upto 2014
GW Flower,ZIM,Spin,2001-11-15,Chattogram,Bangladesh,2001,2,104,325,8,1,538,1183,18,434,858,10,29.88888888888889,<=30,BAN,Away,Upto 2014
GW Flower,ZIM,Spin,2001-12-27,Colombo (SSC),Sri Lanka,2001,1,89,132,0,1,311,756,12,222,624,12,25.916666666666668,<=30,SL,Away,Upto 2014
GW Flower,ZIM,Spin,2002-01-04,Kandy,Sri Lanka,2002,1,66,168,3,1,367,934,16,301,766,13,22.9375,<=30,SL,Away,Upto 2014
GW Flower,ZIM,Spin,2002-01-12,Galle,Sri Lanka,2002,2,127,288,2,1,515,1423,24,388,1135,22,21.458333333333332,<=30,SL,Away,Upto 2014
GW Flower,ZIM,Spin,2002-02-21,Nagpur,India,2002,1,96,180,0,1,556,1425,18,460,1245,18,30.88888888888889,>30,IND,Away,Upto 2014
GW Flower,ZIM,Spin,2002-02-28,Delhi,India,2002,2,39,66,2,1,467,1232,22,428,1166,20,21.227272727272727,<=30,IND,Away,Upto 2014
GW Flower,ZIM,Spin,2002-11-16,Bulawayo,Zimbabwe,2002,1,26,72,0,1,335,808,14,309,736,14,23.928571428571427,<=30,ZIM,Home,Upto 2014
GW Flower,ZIM,Spin,2003-05-22,Lord's,England,2003,1,3,6,0,1,157,306,4,154,300,4,39.25,>30,ENG,Away,Upto 2014
GW Flower,ZIM,Spin,2003-06-05,Chester-le-Street,England,2003,1,5,6,0,1,179,420,2,174,414,2,89.5,>30,ENG,Away,Upto 2014
GWA Chubb,SA,Pace,1951-06-07,Nottingham,England,1951,2,155,314,4,1,538,1446,18,383,1132,14,29.88888888888889,<=30,ENG,Away,Upto 2014
GWA Chubb,SA,Pace,1951-06-21,Lord's,England,1951,1,77,208,5,1,253,682,13,176,474,8,19.46153846153846,<=30,ENG,Away,Upto 2014
GWA Chubb,SA,Pace,1951-07-05,Manchester,England,1951,2,123,297,6,1,355,980,20,232,683,14,17.75,<=30,ENG,Away,Upto 2014
GWA Chubb,SA,Pace,1951-07-26,Leeds,England,1951,1,99,258,1,1,354,984,3,255,726,2,118.0,>30,ENG,Away,Upto 2014
GWA Chubb,SA,Pace,1951-08-16,The Oval,England,1951,2,123,348,5,1,309,956,16,186,608,11,19.3125,<=30,ENG,Away,Upto 2014
GWF Overton,NZ,Pace,1953-12-11,Durban,South Africa,1953,1,92,216,2,1,403,1104,13,311,888,11,31.0,>30,SA,Away,Upto 2014
GWF Overton,NZ,Pace,1953-12-24,Johannesburg,South Africa,1953,2,101,257,4,1,463,1350,29,362,1093,25,15.96551724137931,<=30,SA,Away,Upto 2014
GWF Overton,NZ,Pace,1954-01-29,Johannesburg,South Africa,1954,1,65,256,3,1,358,1413,20,293,1157,17,17.9,<=30,SA,Away,Upto 2014
Ghulam Ahmed,IND,Spin,1948-12-31,Eden Gardens,India,1948,2,181,362,6,1,677,1523,19,496,1161,13,35.63157894736842,>30,IND,Home,Upto 2014
Ghulam Ahmed,IND,Spin,1949-01-27,Chennai,India,1949,1,88,192,0,1,495,939,11,407,747,11,45.0,>30,IND,Home,Upto 2014
Ghulam Ahmed,IND,Spin,1949-02-04,Brabourne,India,1949,2,92,222,2,1,580,1268,18,488,1046,16,32.22222222222222,>30,IND,Home,Upto 2014
Ghulam Ahmed,IND,Spin,1952-01-12,Kanpur,India,1952,2,80,283,6,1,484,1339,31,404,1056,25,15.612903225806452,<=30,IND,Home,Upto 2014
Ghulam Ahmed,IND,Spin,1952-02-06,Chennai,India,1952,2,130,264,4,1,648,1564,25,518,1300,21,25.92,<=30,IND,Home,Upto 2014
Ghulam Ahmed,IND,Spin,1952-06-05,Leeds,England,1952,2,137,510,7,1,495,1359,19,358,849,12,26.05263157894737,<=30,ENG,Away,Upto 2014
Ghulam Ahmed,IND,Spin,1952-06-19,Lord's,England,1952,2,137,402,4,1,669,1629,14,532,1227,10,47.785714285714285,>30,ENG,Away,Upto 2014
Ghulam Ahmed,IND,Spin,1952-07-17,Manchester,England,1952,1,43,54,3,1,285,693,12,242,639,9,23.75,<=30,ENG,Away,Upto 2014
Ghulam Ahmed,IND,Spin,1952-08-14,The Oval,England,1952,1,54,144,1,1,267,870,5,213,726,4,53.4,>30,ENG,Away,Upto 2014
Ghulam Ahmed,IND,Spin,1952-10-16,Delhi,India,1952,2,86,273,5,1,404,1143,24,318,870,19,16.833333333333332,<=30,IND,Home,Upto 2014
Ghulam Ahmed,IND,Spin,1952-10-23,Lucknow,India,1952,1,83,270,3,1,185,666,5,102,396,2,37.0,>30,IND,Home,Upto 2014
Ghulam Ahmed,IND,Spin,1952-11-13,Brabourne,India,1952,2,50,168,0,1,433,1202,15,383,1034,15,28.866666666666667,<=30,IND,Home,Upto 2014
Ghulam Ahmed,IND,Spin,1952-12-12,Eden Gardens,India,1952,2,105,330,4,1,455,1230,13,350,900,9,35.0,>30,IND,Home,Upto 2014
Ghulam Ahmed,IND,Spin,1955-01-01,Dhaka,Bangladesh,1955,1,109,270,5,1,438,1378,15,329,1108,10,29.2,<=30,BAN,Away,Upto 2014
Ghulam Ahmed,IND,Spin,1955-01-15,Bahawalpur,Pakistan,1955,1,63,216,1,1,306,1050,8,243,834,7,38.25,>30,PAK,Away,Upto 2014
Ghulam Ahmed,IND,Spin,1955-01-29,Lahore,Pakistan,1955,2,142,360,1,1,591,2024,18,449,1664,17,32.833333333333336,>30,PAK,Away,Upto 2014
Ghulam Ahmed,IND,Spin,1955-02-12,Peshawar,Pakistan,1955,2,21,156,2,1,400,1761,19,379,1605,17,21.05263157894737,<=30,PAK,Away,Upto 2014
Ghulam Ahmed,IND,Spin,1955-11-19,Hyderabad (Deccan),India,1955,2,92,312,1,1,665,1888,11,573,1576,10,60.45454545454545,>30,IND,Home,Upto 2014
Ghulam Ahmed,IND,Spin,1956-10-19,Chennai,India,1956,1,67,228,2,1,458,1218,19,391,990,17,24.105263157894736,<=30,IND,Home,Upto 2014
Ghulam Ahmed,IND,Spin,1956-11-02,Eden Gardens,India,1956,2,130,297,10,1,552,1533,35,422,1236,25,15.771428571428572,<=30,IND,Home,Upto 2014
Ghulam Ahmed,IND,Spin,1958-12-12,Kanpur,India,1958,2,110,240,0,1,669,1431,13,559,1191,13,51.46153846153846,>30,IND,Home,Upto 2014
Ghulam Ahmed,IND,Spin,1958-12-31,Eden Gardens,India,1958,1,52,97,1,1,513,906,7,461,809,6,73.28571428571429,>30,IND,Home,Upto 2014
Gul Mohammad,IND,Pace,1946-06-22,Lord's,England,1946,1,2,12,0,1,522,1272,22,520,1260,22,23.727272727272727,<=30,ENG,Away,Upto 2014
Gul Mohammad,IND,Pace,1948-01-01,Melbourne,Australia,1948,1,1,8,0,1,380,833,9,379,825,9,42.22222222222222,>30,AUS,Away,Upto 2014
Gul Mohammad,IND,Pace,1952-10-16,Delhi,India,1952,1,0,12,0,1,227,672,5,227,660,5,45.4,>30,IND,Home,Upto 2014
Gul Mohammad,IND,Pace,1952-10-23,Lucknow,India,1952,1,21,45,2,1,415,1291,25,394,1246,23,16.6,<=30,IND,Home,Upto 2014
H Dean,ENG,Pace,1912-06-24,Lord's,England,1912,1,49,174,2,1,300,774,7,251,600,5,42.857142857142854,>30,ENG,Home,Upto 2014
H Dean,ENG,Pace,1912-07-08,Leeds,England,1912,2,56,123,5,1,355,954,24,299,831,19,14.791666666666666,<=30,ENG,Home,Upto 2014
H Dean,ENG,Pace,1912-08-19,The Oval,England,1912,2,48,150,4,1,291,877,20,243,727,16,14.55,<=30,ENG,Home,Upto 2014
H Donnan,AUS,Pace,1892-03-24,Adelaide,Australia,1892,1,22,54,0,1,529,1333,15,507,1279,15,35.266666666666666,>30,AUS,Home,After 1965
H Howell,ENG,Pace,1920-12-31,Melbourne,Australia,1920,1,142,222,3,1,456,894,15,314,672,12,30.4,>30,AUS,Away,Upto 2014
H Howell,ENG,Pace,1921-01-14,Adelaide,Australia,1921,2,204,360,4,1,770,1488,14,566,1128,10,55.0,>30,AUS,Away,Upto 2014
H Howell,ENG,Pace,1921-02-11,Melbourne,Australia,1921,2,122,162,0,1,517,1056,6,395,894,6,86.16666666666667,>30,AUS,Away,Upto 2014
H Howell,ENG,Pace,1921-05-28,Nottingham,England,1921,1,22,54,0,1,251,658,20,229,604,20,12.55,<=30,ENG,Home,Upto 2014
H Howell,ENG,Pace,1924-08-16,The Oval,England,1924,1,69,120,0,1,298,576,2,229,456,2,149.0,>30,ENG,Home,Upto 2014
H Ironmonger,AUS,Spin,1928-11-30,Brisbane,Australia,1928,2,164,567,4,1,545,1303,22,381,736,18,24.772727272727273,<=30,AUS,Home,Upto 2014
H Ironmonger,AUS,Spin,1928-12-14,Sydney,Australia,1928,1,142,408,2,1,782,1986,12,640,1578,10,65.16666666666667,>30,AUS,Home,Upto 2014
H Ironmonger,AUS,Spin,1931-01-01,Sydney,Australia,1931,2,33,102,4,1,251,536,17,218,434,13,14.764705882352942,<=30,AUS,Home,Upto 2014
H Ironmonger,AUS,Spin,1931-01-16,Brisbane,Australia,1931,2,72,246,3,1,426,888,13,354,642,10,32.76923076923077,>30,AUS,Home,Upto 2014
H Ironmonger,AUS,Spin,1931-02-13,Melbourne,Australia,1931,2,79,222,11,1,273,612,18,194,390,7,15.166666666666666,<=30,AUS,Home,Upto 2014
H Ironmonger,AUS,Spin,1931-02-27,Sydney,Australia,1931,2,139,348,4,1,469,1050,14,330,702,10,33.5,>30,AUS,Home,Upto 2014
H Ironmonger,AUS,Spin,1931-11-27,Brisbane,Australia,1931,2,86,462,9,1,332,1063,15,246,601,6,22.133333333333333,<=30,AUS,Home,Upto 2014
H Ironmonger,AUS,Spin,1931-12-18,Sydney,Australia,1931,2,60,186,4,1,364,897,16,304,711,12,22.75,<=30,AUS,Home,Upto 2014
H Ironmonger,AUS,Spin,1931-12-31,Melbourne,Australia,1931,2,126,546,7,1,678,1818,23,552,1272,16,29.47826086956522,<=30,AUS,Home,Upto 2014
H Ironmonger,AUS,Spin,1932-02-12,Melbourne,Australia,1932,2,24,137,11,1,112,305,17,88,168,6,6.588235294117647,<=30,AUS,Home,Upto 2014
H Ironmonger,AUS,Spin,1932-12-30,Melbourne,Australia,1932,2,54,199,4,1,223,670,15,169,471,11,14.866666666666667,<=30,AUS,Home,Upto 2014
H Ironmonger,AUS,Spin,1933-01-13,Adelaide,Australia,1933,2,137,462,4,1,546,1683,15,409,1221,11,36.4,>30,AUS,Home,Upto 2014
H Ironmonger,AUS,Spin,1933-02-10,Brisbane,Australia,1933,2,116,468,5,1,466,1558,15,350,1090,10,31.066666666666666,>30,AUS,Home,Upto 2014
H Ironmonger,AUS,Spin,1933-02-23,Sydney,Australia,1933,2,98,342,2,1,492,1240,17,394,898,15,28.941176470588236,<=30,AUS,Home,Upto 2014
H Larwood,ENG,Pace,1926-06-26,Lord's,England,1926,2,136,282,3,1,441,942,8,305,660,5,55.125,>30,ENG,Home,Upto 2014
H Larwood,ENG,Pace,1926-08-14,The Oval,England,1926,2,116,288,6,1,263,687,10,147,399,4,26.3,<=30,ENG,Home,Upto 2014
H Larwood,ENG,Pace,1928-06-23,Lord's,England,1928,1,27,90,1,1,399,886,12,372,796,11,33.25,>30,ENG,Home,Upto 2014
H Larwood,ENG,Pace,1928-08-11,The Oval,England,1928,2,87,210,5,1,476,809,16,389,599,11,29.75,<=30,ENG,Home,Upto 2014
H Larwood,ENG,Pace,1928-11-30,Brisbane,Australia,1928,2,62,130,8,1,486,1018,12,424,888,4,40.5,>30,AUS,Away,Upto 2014
H Larwood,ENG,Pace,1928-12-14,Sydney,Australia,1928,2,182,368,4,1,483,1249,14,301,881,10,34.5,>30,AUS,Away,Upto 2014
H Larwood,ENG,Pace,1928-12-29,Melbourne,Australia,1928,2,164,318,4,1,730,1882,14,566,1564,10,52.142857142857146,>30,AUS,Away,Upto 2014
H Larwood,ENG,Pace,1929-02-01,Adelaide,Australia,1929,2,152,342,1,1,620,1906,12,468,1564,11,51.666666666666664,>30,AUS,Away,Upto 2014
H Larwood,ENG,Pace,1929-03-08,Melbourne,Australia,1929,2,164,397,1,1,826,2351,25,662,1954,24,33.04,>30,AUS,Away,Upto 2014
H Larwood,ENG,Pace,1929-06-15,Birmingham,England,1929,2,69,322,5,1,506,1355,18,437,1033,13,28.11111111111111,<=30,ENG,Home,Upto 2014
H Larwood,ENG,Pace,1929-06-29,Lord's,England,1929,2,82,192,2,1,601,1182,21,519,990,19,28.61904761904762,<=30,ENG,Home,Upto 2014
H Larwood,ENG,Pace,1929-07-13,Leeds,England,1929,1,35,102,1,1,359,767,10,324,665,9,35.9,>30,ENG,Home,Upto 2014
H Larwood,ENG,Pace,1930-06-13,Nottingham,England,1930,2,21,120,2,1,383,898,10,362,778,8,38.3,>30,ENG,Home,Upto 2014
H Larwood,ENG,Pace,1930-07-11,Leeds,England,1930,1,139,198,1,1,460,1116,6,321,918,5,76.66666666666667,>30,ENG,Home,Upto 2014
H Larwood,ENG,Pace,1930-08-16,The Oval,England,1930,1,132,288,1,1,505,1314,10,373,1026,9,50.5,>30,ENG,Home,Upto 2014
H Larwood,ENG,Pace,1932-12-02,Sydney,Australia,1932,2,124,294,10,1,694,1474,26,570,1180,16,26.692307692307693,<=30,AUS,Away,Upto 2014
H Larwood,ENG,Pace,1932-12-30,Melbourne,Australia,1932,2,102,213,4,1,475,1034,22,373,821,18,21.59090909090909,<=30,AUS,Away,Upto 2014
H Larwood,ENG,Pace,1933-01-13,Adelaide,Australia,1933,2,126,264,7,1,549,1333,23,423,1069,16,23.869565217391305,<=30,AUS,Away,Upto 2014
H Larwood,ENG,Pace,1933-02-10,Brisbane,Australia,1933,2,150,291,7,1,508,1171,18,358,880,11,28.22222222222222,<=30,AUS,Away,Upto 2014
H Larwood,ENG,Pace,1933-02-23,Sydney,Australia,1933,2,142,260,5,1,693,1194,12,551,934,7,57.75,>30,AUS,Away,Upto 2014
H Masakadza,ZIM,Pace,2001-07-27,Harare,Zimbabwe,2001,1,3,6,0,1,709,1347,18,706,1341,18,39.388888888888886,>30,ZIM,Home,Upto 2014
H Masakadza,ZIM,Pace,2002-01-04,Kandy,Sri Lanka,2002,1,9,18,1,1,529,977,13,520,959,12,40.69230769230769,>30,SL,Away,Upto 2014
H Masakadza,ZIM,Pace,2005-01-14,Dhaka,Bangladesh,2005,2,27,102,1,1,545,1416,17,518,1314,16,32.05882352941177,>30,BAN,Away,Upto 2014
H Masakadza,ZIM,Pace,2011-09-01,Bulawayo,Zimbabwe,2011,1,13,42,1,1,539,1117,15,526,1075,14,35.93333333333333,>30,ZIM,Home,Upto 2014
H Masakadza,ZIM,Pace,2011-11-01,Bulawayo,Zimbabwe,2011,1,20,66,1,1,759,1445,23,739,1379,22,33.0,>30,ZIM,Home,Upto 2014
H Masakadza,ZIM,Pace,2012-01-26,Napier,New Zealand,2012,1,45,126,1,1,497,972,21,452,846,20,23.666666666666668,<=30,NZ,Away,Upto 2014
H Masakadza,ZIM,Pace,2013-03-12,Bridgetown,West Indies,2013,1,25,60,2,1,330,750,17,305,690,15,19.41176470588235,<=30,WI,Away,Upto 2014
H Masakadza,ZIM,Pace,2013-03-20,Roseau,West Indies,2013,1,48,102,0,1,341,648,7,293,546,7,48.714285714285715,>30,WI,Away,Upto 2014
H Masakadza,ZIM,Pace,2013-04-25,Harare,Zimbabwe,2013,1,24,66,3,1,755,1568,25,731,1502,22,30.2,>30,ZIM,Home,Upto 2014
H Masakadza,ZIM,Pace,2013-09-03,Harare,Zimbabwe,2013,2,30,96,0,1,657,1465,18,627,1369,18,36.5,>30,ZIM,Home,Upto 2014
H Masakadza,ZIM,Pace,2013-09-10,Harare,Zimbabwe,2013,2,26,78,0,1,558,1504,28,532,1426,28,19.928571428571427,<=30,ZIM,Home,Upto 2014
H Masakadza,ZIM,Pace,2014-11-03,Khulna,Bangladesh,2014,1,28,36,1,1,338,810,9,310,774,8,37.55555555555556,>30,BAN,Away,After 1965
H Masakadza,ZIM,Pace,2014-11-12,Chattogram,Bangladesh,2014,2,62,96,2,1,456,862,15,394,766,13,30.4,>30,BAN,Away,After 1965
H Masakadza,ZIM,Pace,2016-07-28,Bulawayo,Zimbabwe,2016,1,25,54,1,1,542,1115,20,517,1061,19,27.1,<=30,ZIM,Home,After 1965
H Masakadza,ZIM,Pace,2016-10-29,Harare,Zimbabwe,2016,2,53,90,0,1,716,1330,16,663,1240,16,44.75,>30,ZIM,Home,After 1965
H Masakadza,ZIM,Pace,2016-11-06,Harare,Zimbabwe,2016,2,35,90,2,1,650,1231,14,615,1141,12,46.42857142857143,>30,ZIM,Home,After 1965
H Masakadza,ZIM,Pace,2017-10-29,Bulawayo,Zimbabwe,2017,1,9,24,0,1,339,949,11,330,925,11,30.818181818181817,>30,ZIM,Home,After 1965
H Masakadza,ZIM,Pace,2018-11-11,Mirpur,Bangladesh,2018,1,7,12,0,1,422,1002,13,415,990,13,32.46153846153846,>30,BAN,Away,After 1965
H Trumble,AUS,Spin,1890-07-21,Lord's,England,1890,2,38,100,2,1,250,845,14,212,745,12,17.857142857142858,<=30,ENG,Away,After 1965
H Trumble,AUS,Spin,1890-08-11,The Oval,England,1890,1,7,10,0,1,81,250,9,74,240,9,9.0,<=30,ENG,Away,After 1965
H Trumble,AUS,Spin,1893-07-17,Lord's,England,1893,2,75,150,1,1,216,425,2,141,275,1,108.0,>30,ENG,Away,After 1965
H Trumble,AUS,Spin,1893-08-14,The Oval,England,1893,1,101,235,1,1,282,513,11,181,278,10,25.636363636363637,<=30,ENG,Away,After 1965
H Trumble,AUS,Spin,1893-08-24,Manchester,England,1893,2,58,142,4,1,203,495,10,145,353,6,20.3,<=30,ENG,Away,After 1965
H Trumble,AUS,Spin,1894-12-29,Melbourne,Australia,1894,2,87,211,3,1,327,823,10,240,612,7,32.7,>30,AUS,Home,After 1965
H Trumble,AUS,Spin,1896-06-22,Lord's,England,1896,2,92,195,2,1,123,265,4,31,70,2,30.75,>30,ENG,Away,After 1965
H Trumble,AUS,Spin,1896-07-16,Manchester,England,1896,2,158,331,4,1,461,941,15,303,610,11,30.733333333333334,>30,ENG,Away,After 1965
H Trumble,AUS,Spin,1896-08-10,The Oval,England,1896,2,89,325,12,1,198,633,25,109,308,13,7.92,<=30,ENG,Away,After 1965
H Trumble,AUS,Spin,1897-12-13,Sydney,Australia,1897,2,178,324,1,1,519,948,7,341,624,6,74.14285714285714,>30,AUS,Home,After 1965
H Trumble,AUS,Spin,1898-01-01,Melbourne,Australia,1898,2,107,345,8,1,483,1191,22,376,846,14,21.954545454545453,<=30,AUS,Home,After 1965
H Trumble,AUS,Spin,1898-01-14,Adelaide,Australia,1898,2,76,198,1,1,414,1001,10,338,803,9,41.4,>30,AUS,Home,After 1965
H Trumble,AUS,Spin,1898-01-29,Melbourne,Australia,1898,2,70,228,4,1,328,761,11,258,533,7,29.818181818181817,<=30,AUS,Home,After 1965
H Trumble,AUS,Spin,1898-02-26,Sydney,Australia,1898,2,104,300,5,1,340,888,10,236,588,5,34.0,>30,AUS,Home,After 1965
H Trumble,AUS,Spin,1899-06-01,Nottingham,England,1899,2,56,210,3,1,270,732,12,214,522,9,22.5,<=30,ENG,Away,After 1965
H Trumble,AUS,Spin,1899-06-15,Lord's,England,1899,2,47,150,2,1,387,894,12,340,744,10,32.25,>30,ENG,Away,After 1965
H Trumble,AUS,Spin,1899-06-29,Leeds,England,1899,1,60,198,5,1,225,608,11,165,410,6,20.454545454545453,<=30,ENG,Away,After 1965
H Trumble,AUS,Spin,1899-07-17,Manchester,England,1899,2,105,210,3,1,220,480,7,115,270,4,31.428571428571427,>30,ENG,Away,After 1965
H Trumble,AUS,Spin,1899-08-14,The Oval,England,1899,1,107,195,2,1,465,899,10,358,704,8,46.5,>30,ENG,Away,After 1965
H Trumble,AUS,Spin,1901-12-13,Sydney,Australia,1901,1,85,204,1,1,360,868,16,275,664,15,22.5,<=30,AUS,Home,Upto 2014
H Trumble,AUS,Spin,1902-01-01,Melbourne,Australia,1902,2,87,185,7,1,445,1043,26,358,858,19,17.115384615384617,<=30,AUS,Home,Upto 2014
H Trumble,AUS,Spin,1902-01-17,Adelaide,Australia,1902,2,198,654,9,1,888,2292,24,690,1638,15,37.0,>30,AUS,Home,Upto 2014
H Trumble,AUS,Spin,1902-02-14,Sydney,Australia,1902,1,65,228,3,1,685,1842,29,620,1614,26,23.620689655172413,<=30,AUS,Home,Upto 2014
H Trumble,AUS,Spin,1902-02-28,Melbourne,Australia,1902,2,126,333,8,1,602,1354,31,476,1021,23,19.419354838709676,<=30,AUS,Home,Upto 2014
H Trumble,AUS,Spin,1902-07-03,Sheffield,England,1902,2,70,239,4,1,486,1005,28,416,766,24,17.357142857142858,<=30,ENG,Away,Upto 2014
H Trumble,AUS,Spin,1902-07-24,Manchester,England,1902,2,128,408,10,1,549,1292,26,421,884,16,21.115384615384617,<=30,ENG,Away,Upto 2014
H Trumble,AUS,Spin,1902-08-11,The Oval,England,1902,2,173,389,12,1,548,1222,24,375,833,12,22.833333333333332,<=30,ENG,Away,Upto 2014
H Trumble,AUS,Spin,1902-10-11,Johannesburg,South Africa,1902,2,127,204,0,1,619,846,16,492,642,16,38.6875,>30,SA,Away,Upto 2014
H Trumble,AUS,Spin,1904-01-01,Melbourne,Australia,1904,2,141,365,9,1,442,925,27,301,560,18,16.37037037037037,<=30,AUS,Home,Upto 2014
H Trumble,AUS,Spin,1904-01-15,Adelaide,Australia,1904,2,122,366,5,1,537,1176,17,415,810,12,31.58823529411765,>30,AUS,Home,Upto 2014
H Trumble,AUS,Spin,1904-02-26,Sydney,Australia,1904,2,107,426,3,1,399,1183,23,292,757,20,17.347826086956523,<=30,AUS,Home,Upto 2014
H Trumble,AUS,Spin,1904-03-05,Melbourne,Australia,1904,1,28,41,7,1,273,552,23,245,511,16,11.869565217391305,<=30,AUS,Home,Upto 2014
H Verity,ENG,Spin,1931-07-29,The Oval,England,1931,2,85,208,4,1,591,1465,18,506,1257,14,32.833333333333336,>30,ENG,Home,Upto 2014
H Verity,ENG,Spin,1932-12-02,Sydney,Australia,1932,2,50,102,0,1,288,900,4,238,798,4,72.0,>30,AUS,Away,Upto 2014
H Verity,ENG,Spin,1933-01-13,Adelaide,Australia,1933,2,57,216,1,1,546,1683,15,489,1467,14,36.4,>30,AUS,Away,Upto 2014
H Verity,ENG,Spin,1933-02-10,Brisbane,Australia,1933,2,69,276,2,1,466,1558,15,397,1282,13,31.066666666666666,>30,AUS,Away,Upto 2014
H Verity,ENG,Spin,1933-02-23,Sydney,Australia,1933,2,95,216,8,1,492,1240,17,397,1024,9,28.941176470588236,<=30,AUS,Away,Upto 2014
H Verity,ENG,Spin,1933-03-24,Christchurch,New Zealand,1933,2,64,156,1,1,316,759,7,252,603,6,45.142857142857146,>30,NZ,Away,Upto 2014
H Verity,ENG,Spin,1933-06-24,Lord's,England,1933,2,66,205,5,1,304,786,19,238,581,14,16.0,<=30,ENG,Home,Upto 2014
H Verity,ENG,Spin,1933-07-22,Manchester,England,1933,2,87,270,2,1,521,1061,15,434,791,13,34.733333333333334,>30,ENG,Home,Upto 2014
H Verity,ENG,Spin,1933-12-15,Mumbai,India,1933,2,94,282,4,1,373,858,11,279,576,7,33.90909090909091,>30,IND,Away,Upto 2014
H Verity,ENG,Spin,1934-01-05,Eden Gardens,India,1934,2,140,358,8,1,342,922,15,202,564,7,22.8,<=30,IND,Away,Upto 2014
H Verity,ENG,Spin,1934-02-10,Chennai,India,1934,2,153,307,11,1,484,943,18,331,636,7,26.88888888888889,<=30,IND,Away,Upto 2014
H Verity,ENG,Spin,1934-06-08,Nottingham,England,1934,2,113,306,2,1,499,1663,22,386,1357,20,22.681818181818183,<=30,ENG,Home,Upto 2014
H Verity,ENG,Spin,1934-06-22,Lord's,England,1934,2,104,351,15,1,377,1128,20,273,777,5,18.85,<=30,ENG,Home,Upto 2014
H Verity,ENG,Spin,1934-07-06,Manchester,England,1934,2,80,348,4,1,477,1272,12,397,924,8,39.75,>30,ENG,Home,Upto 2014
H Verity,ENG,Spin,1934-07-20,Leeds,England,1934,1,113,281,3,1,569,1652,17,456,1371,14,33.470588235294116,>30,ENG,Home,Upto 2014
H Verity,ENG,Spin,1934-08-18,The Oval,England,1934,2,166,342,0,1,526,1194,12,360,852,12,43.833333333333336,>30,ENG,Home,Upto 2014
H Verity,ENG,Spin,1935-06-15,Nottingham,England,1935,1,52,246,3,1,343,876,8,291,630,5,42.875,>30,ENG,Home,Upto 2014
H Verity,ENG,Spin,1935-06-29,Lord's,England,1935,2,117,396,6,1,484,1320,22,367,924,16,22.0,<=30,ENG,Home,Upto 2014
H Verity,ENG,Spin,1935-07-13,Leeds,England,1935,2,9,150,2,1,260,741,11,251,591,9,23.636363636363637,<=30,ENG,Home,Upto 2014
H Verity,ENG,Spin,1935-07-27,Manchester,England,1935,2,72,240,1,1,449,1029,11,377,789,10,40.81818181818182,>30,ENG,Home,Upto 2014
H Verity,ENG,Spin,1936-06-27,Lord's,England,1936,2,59,205,6,1,182,439,11,123,234,5,16.545454545454547,<=30,ENG,Home,Upto 2014
H Verity,ENG,Spin,1936-07-25,Manchester,England,1936,2,107,234,5,1,479,775,14,372,541,9,34.214285714285715,>30,ENG,Home,Upto 2014
H Verity,ENG,Spin,1936-08-15,The Oval,England,1936,2,62,246,4,1,349,695,12,287,449,8,29.083333333333332,<=30,ENG,Home,Upto 2014
H Verity,ENG,Spin,1936-12-04,Brisbane,Australia,1936,1,52,224,1,1,566,1790,14,514,1566,13,40.42857142857143,>30,AUS,Away,Upto 2014
H Verity,ENG,Spin,1936-12-18,Sydney,Australia,1936,2,72,176,3,1,468,1160,7,396,984,4,66.85714285714286,>30,AUS,Away,Upto 2014
H Verity,ENG,Spin,1937-01-01,Melbourne,Australia,1937,2,103,415,5,1,614,1405,21,511,990,16,29.238095238095237,<=30,AUS,Away,Upto 2014
H Verity,ENG,Spin,1937-01-29,Adelaide,Australia,1937,2,101,424,0,1,554,1660,17,453,1236,17,32.588235294117645,>30,AUS,Away,Upto 2014
H Verity,ENG,Spin,1937-02-26,Melbourne,Australia,1937,1,127,328,1,1,349,938,13,222,610,12,26.846153846153847,<=30,AUS,Away,Upto 2014
H Verity,ENG,Spin,1937-06-26,Lord's,England,1937,2,81,234,2,1,512,1098,11,431,864,9,46.54545454545455,>30,ENG,Home,Upto 2014
H Verity,ENG,Spin,1938-06-10,Nottingham,England,1938,2,138,417,4,1,958,2061,18,820,1644,14,53.22222222222222,>30,ENG,Home,Upto 2014
H Verity,ENG,Spin,1938-06-24,Lord's,England,1938,2,132,292,6,1,622,1129,16,490,837,10,38.875,>30,ENG,Home,Upto 2014
H Verity,ENG,Spin,1938-07-22,Leeds,England,1938,2,54,144,2,1,387,966,24,333,822,22,16.125,<=30,ENG,Home,Upto 2014
H Verity,ENG,Spin,1938-08-20,The Oval,England,1938,2,30,72,2,1,776,1827,9,746,1755,7,86.22222222222223,>30,ENG,Home,Upto 2014
H Verity,ENG,Spin,1938-12-24,Johannesburg,South Africa,1938,2,78,481,4,1,478,1422,15,400,941,11,31.866666666666667,>30,SA,Away,Upto 2014
H Verity,ENG,Spin,1938-12-31,Cape Town,South Africa,1938,2,83,374,5,1,556,1422,11,473,1048,6,50.54545454545455,>30,SA,Away,Upto 2014
H Verity,ENG,Spin,1939-01-20,Durban,South Africa,1939,2,80,344,3,1,407,989,9,327,645,6,45.22222222222222,>30,SA,Away,Upto 2014
H Verity,ENG,Spin,1939-02-18,Johannesburg,South Africa,1939,1,127,301,3,1,359,773,7,232,472,4,51.285714285714285,>30,SA,Away,Upto 2014
H Verity,ENG,Spin,1939-03-03,Durban,South Africa,1939,2,184,766,4,1,794,1998,16,610,1232,12,49.625,>30,SA,Away,Upto 2014
H Verity,ENG,Spin,1939-06-24,Lord's,England,1939,2,54,240,2,1,311,784,11,257,544,9,28.272727272727273,<=30,ENG,Home,Upto 2014
HA Gomes,WI,Spin,1976-06-03,Nottingham,England,1976,2,26,78,0,1,293,652,6,267,574,6,48.833333333333336,>30,ENG,Away,Upto 2014
HA Gomes,WI,Spin,1978-03-31,Georgetown,West Indies,1978,1,8,18,0,1,414,708,7,406,690,7,59.142857142857146,>30,WI,Home,Upto 2014
HA Gomes,WI,Spin,1978-12-01,Wankhede,India,1978,1,2,18,0,1,556,1295,9,554,1277,9,61.77777777777778,>30,IND,Away,Upto 2014
HA Gomes,WI,Spin,1978-12-29,Eden Gardens,India,1978,2,3,12,0,1,375,1048,13,372,1036,13,28.846153846153847,<=30,IND,Away,Upto 2014
HA Gomes,WI,Spin,1979-01-12,Chennai,India,1979,1,2,6,0,1,234,496,9,232,490,9,26.0,<=30,IND,Away,Upto 2014
HA Gomes,WI,Spin,1979-01-24,Delhi,India,1979,1,54,54,1,1,226,544,8,172,490,7,28.25,<=30,IND,Away,Upto 2014
HA Gomes,WI,Spin,1979-02-02,Kanpur,India,1979,1,4,6,0,1,445,1037,7,441,1031,7,63.57142857142857,>30,IND,Away,Upto 2014
HA Gomes,WI,Spin,1980-11-24,Lahore,Pakistan,1980,1,9,24,0,1,274,622,12,265,598,12,22.833333333333332,<=30,PAK,Away,Upto 2014
HA Gomes,WI,Spin,1980-12-22,Karachi,Pakistan,1980,1,14,36,0,1,122,421,6,108,385,6,20.333333333333332,<=30,PAK,Away,Upto 2014
HA Gomes,WI,Spin,1981-02-13,Port of Spain,West Indies,1981,2,18,66,1,1,213,606,8,195,540,7,26.625,<=30,WI,Home,Upto 2014
HA Gomes,WI,Spin,1981-03-27,St John's,West Indies,1981,1,21,78,0,1,220,600,1,199,522,1,220.0,>30,WI,Home,Upto 2014
HA Gomes,WI,Spin,1981-04-10,Kingston,West Indies,1981,1,18,78,0,1,271,768,4,253,690,4,67.75,>30,WI,Home,Upto 2014
HA Gomes,WI,Spin,1982-01-02,Sydney,Australia,1982,2,39,144,3,1,278,654,13,239,510,10,21.384615384615383,<=30,AUS,Away,Upto 2014
HA Gomes,WI,Spin,1982-01-30,Adelaide,Australia,1982,2,48,126,0,1,305,605,5,257,479,5,61.0,>30,AUS,Away,Upto 2014
HA Gomes,WI,Spin,1983-02-23,Kingston,West Indies,1983,2,40,96,0,1,239,624,5,199,528,5,47.8,>30,WI,Home,Upto 2014
HA Gomes,WI,Spin,1983-03-11,Port of Spain,West Indies,1983,2,47,126,1,1,280,699,7,233,573,6,40.0,>30,WI,Home,Upto 2014
HA Gomes,WI,Spin,1983-03-31,Georgetown,West Indies,1983,1,35,84,0,1,357,630,4,322,546,4,89.25,>30,WI,Home,Upto 2014
HA Gomes,WI,Spin,1983-04-15,Bridgetown,West Indies,1983,2,23,60,0,1,302,625,5,279,565,5,60.4,>30,WI,Home,Upto 2014
HA Gomes,WI,Spin,1983-04-28,St John's,West Indies,1983,2,58,138,2,1,460,934,5,402,796,3,92.0,>30,WI,Home,Upto 2014
HA Gomes,WI,Spin,1983-10-21,Kanpur,India,1983,1,24,36,0,1,219,474,3,195,438,3,73.0,>30,IND,Away,Upto 2014
HA Gomes,WI,Spin,1983-10-29,Delhi,India,1983,2,105,247,2,1,373,864,8,268,617,6,46.625,>30,IND,Away,Upto 2014
HA Gomes,WI,Spin,1983-11-12,Ahmedabad,India,1983,1,22,36,0,1,250,501,5,228,465,5,50.0,>30,IND,Away,Upto 2014
HA Gomes,WI,Spin,1983-11-24,Wankhede,India,1983,1,3,24,0,1,386,913,10,383,889,10,38.6,>30,IND,Away,Upto 2014
HA Gomes,WI,Spin,1983-12-24,Chennai,India,1983,1,24,48,0,1,365,891,7,341,843,7,52.142857142857146,>30,IND,Away,Upto 2014
HA Gomes,WI,Spin,1984-03-02,Georgetown,West Indies,1984,2,60,156,0,1,284,720,8,224,564,8,35.5,>30,WI,Home,Upto 2014
HA Gomes,WI,Spin,1984-03-16,Port of Spain,West Indies,1984,2,86,222,1,1,293,601,6,207,379,5,48.833333333333336,>30,WI,Home,Upto 2014
HA Gomes,WI,Spin,1984-11-09,W.A.C.A,Australia,1984,1,1,6,0,1,5,12,0,4,6,0,inf,>30,AUS,Away,Upto 2014
HA Gomes,WI,Spin,1984-12-22,Melbourne,Australia,1984,1,0,12,1,1,287,501,7,287,489,6,41.0,>30,AUS,Away,Upto 2014
HA Gomes,WI,Spin,1984-12-30,Sydney,Australia,1984,1,29,72,1,1,308,779,16,279,707,15,19.25,<=30,AUS,Away,Upto 2014
HA Gomes,WI,Spin,1985-03-29,Port of Spain,West Indies,1985,2,3,18,0,1,167,462,3,164,444,3,55.666666666666664,>30,WI,Home,Upto 2014
HA Gomes,WI,Spin,1985-04-06,Georgetown,West Indies,1985,1,20,48,0,1,331,798,0,311,750,0,inf,>30,WI,Home,Upto 2014
HA Gomes,WI,Spin,1985-04-26,Bridgetown,West Indies,1985,1,10,24,0,1,111,198,1,101,174,1,111.0,>30,WI,Home,Upto 2014
HA Gomes,WI,Spin,1985-05-04,Kingston,West Indies,1985,1,11,18,0,1,118,270,2,107,252,2,59.0,>30,WI,Home,Upto 2014
HA Gomes,WI,Spin,1986-03-07,Port of Spain,West Indies,1986,1,0,6,0,1,243,525,10,243,519,10,24.3,<=30,WI,Home,Upto 2014
HA Gomes,WI,Spin,1987-02-20,Wellington,New Zealand,1987,2,38,132,1,1,313,876,9,275,744,8,34.77777777777778,>30,NZ,Away,Upto 2014
HA Gomes,WI,Spin,1987-02-27,Auckland,New Zealand,1987,1,9,24,1,1,278,540,5,269,516,4,55.6,>30,NZ,Away,Upto 2014
HA Gomes,WI,Spin,1987-03-12,Christchurch,New Zealand,1987,1,16,24,0,1,79,120,0,63,96,0,inf,>30,NZ,Away,Upto 2014
HB Cave,NZ,Pace,1949-06-11,Leeds,England,1949,2,188,318,3,1,597,1077,16,409,759,13,37.3125,>30,ENG,Away,Upto 2014
HB Cave,NZ,Pace,1949-06-25,Lord's,England,1949,2,102,204,1,1,435,853,4,333,649,3,108.75,>30,ENG,Away,Upto 2014
HB Cave,NZ,Pace,1949-07-23,Manchester,England,1949,1,97,180,0,1,464,974,13,367,794,13,35.69230769230769,>30,ENG,Away,Upto 2014
HB Cave,NZ,Pace,1949-08-13,The Oval,England,1949,1,78,144,0,1,489,877,14,411,733,14,34.92857142857143,>30,ENG,Away,Upto 2014
HB Cave,NZ,Pace,1955-03-11,Dunedin,New Zealand,1955,1,27,144,2,1,287,993,22,260,849,20,13.045454545454545,<=30,NZ,Home,Upto 2014
HB Cave,NZ,Pace,1955-03-25,Auckland,New Zealand,1955,1,25,144,1,1,296,880,23,271,736,22,12.869565217391305,<=30,NZ,Home,Upto 2014
HB Cave,NZ,Pace,1955-10-13,Karachi,Pakistan,1955,1,56,144,3,1,260,769,8,204,625,5,32.5,>30,PAK,Away,Upto 2014
HB Cave,NZ,Pace,1955-10-26,Lahore,Pakistan,1955,2,110,210,0,1,619,1402,11,509,1192,11,56.27272727272727,>30,PAK,Away,Upto 2014
HB Cave,NZ,Pace,1955-11-07,Dhaka,Bangladesh,1955,1,45,120,3,1,196,674,16,151,554,13,12.25,<=30,BAN,Away,Upto 2014
HB Cave,NZ,Pace,1955-11-19,Hyderabad (Deccan),India,1955,1,59,246,0,1,344,973,5,285,727,5,68.8,>30,IND,Away,Upto 2014
HB Cave,NZ,Pace,1955-12-02,Brabourne,India,1955,1,77,288,3,1,320,942,10,243,654,7,32.0,>30,IND,Away,Upto 2014
HB Cave,NZ,Pace,1955-12-16,Delhi,India,1955,1,68,300,1,1,511,1457,6,443,1157,5,85.16666666666667,>30,IND,Away,Upto 2014
HB Cave,NZ,Pace,1955-12-28,Eden Gardens,India,1955,2,114,426,3,1,465,1398,12,351,972,9,38.75,>30,IND,Away,Upto 2014
HB Cave,NZ,Pace,1956-01-06,Chennai,India,1956,1,94,264,0,1,296,750,1,202,486,1,296.0,>30,IND,Away,Upto 2014
HB Cave,NZ,Pace,1956-02-03,Dunedin,New Zealand,1956,1,47,156,2,1,148,341,6,101,185,4,24.666666666666668,<=30,NZ,Home,Upto 2014
HB Cave,NZ,Pace,1956-03-03,Wellington,New Zealand,1956,1,96,222,2,1,372,822,9,276,600,7,41.333333333333336,>30,NZ,Home,Upto 2014
HB Cave,NZ,Pace,1956-03-09,Auckland,New Zealand,1956,2,43,244,8,1,188,741,21,145,497,13,8.952380952380953,<=30,NZ,Home,Upto 2014
HB Cave,NZ,Pace,1958-06-05,Birmingham,England,1958,2,99,242,2,1,493,1493,26,394,1251,24,18.96153846153846,<=30,ENG,Away,Upto 2014
HB Cave,NZ,Pace,1958-07-03,Leeds,England,1958,1,42,78,0,1,193,612,2,151,534,2,96.5,>30,ENG,Away,Upto 2014
HC Brook,ENG,Pace,2023-02-24,Wellington,New Zealand,2023,1,25,48,1,1,965,1553,25,940,1505,24,38.6,>30,NZ,Away,After 1965
HC Brook,ENG,Pace,2023-06-16,Birmingham,England,2023,1,5,18,0,1,808,1386,24,803,1368,24,33.666666666666664,>30,ENG,Home,After 1965
HC Brook,ENG,Pace,2023-07-27,The Oval,England,2023,1,7,18,0,1,971,1598,29,964,1580,29,33.48275862068966,>30,ENG,Home,After 1965
HC Brook,ENG,Pace,2024-12-14,Hamilton,New Zealand,2024,1,13,12,0,1,652,1099,24,639,1087,24,27.166666666666668,<=30,NZ,Away,After 1965
HC Griffith,WI,Pace,1928-06-23,Lord's,England,1928,1,78,174,2,1,399,886,12,321,712,10,33.25,>30,ENG,Away,Upto 2014
HC Griffith,WI,Pace,1928-07-21,Manchester,England,1928,1,69,150,3,1,337,660,7,268,510,4,48.142857142857146,>30,ENG,Away,Upto 2014
HC Griffith,WI,Pace,1928-08-11,The Oval,England,1928,1,103,155,6,1,476,809,16,373,654,10,29.75,<=30,ENG,Away,Upto 2014
HC Griffith,WI,Pace,1930-01-11,Bridgetown,West Indies,1930,2,139,306,4,1,797,1692,15,658,1386,11,53.13333333333333,>30,WI,Home,Upto 2014
HC Griffith,WI,Pace,1930-02-01,Port of Spain,West Indies,1930,2,162,360,8,1,688,1491,29,526,1131,21,23.724137931034484,<=30,WI,Home,Upto 2014
HC Griffith,WI,Pace,1930-04-03,Kingston,West Indies,1930,2,207,475,4,1,684,1474,14,477,999,10,48.857142857142854,>30,WI,Home,Upto 2014
HC Griffith,WI,Pace,1930-12-12,Adelaide,Australia,1930,2,89,228,2,1,453,957,5,364,729,3,90.6,>30,AUS,Away,Upto 2014
HC Griffith,WI,Pace,1931-01-01,Sydney,Australia,1931,1,57,168,2,1,284,648,9,227,480,7,31.555555555555557,>30,AUS,Away,Upto 2014
HC Griffith,WI,Pace,1931-01-16,Brisbane,Australia,1931,1,133,198,4,1,443,984,16,310,786,12,27.6875,<=30,AUS,Away,Upto 2014
HC Griffith,WI,Pace,1931-02-13,Melbourne,Australia,1931,1,33,48,1,1,238,438,7,205,390,6,34.0,>30,AUS,Away,Upto 2014
HC Griffith,WI,Pace,1931-02-27,Sydney,Australia,1931,2,81,161,5,1,407,995,14,326,834,9,29.071428571428573,<=30,AUS,Away,Upto 2014
HC Griffith,WI,Pace,1933-06-24,Lord's,England,1933,1,48,120,3,1,246,540,10,198,420,7,24.6,<=30,ENG,Away,Upto 2014
HC Griffith,WI,Pace,1933-08-12,The Oval,England,1933,1,44,120,0,1,389,809,16,345,689,16,24.3125,<=30,ENG,Away,Upto 2014
HD Bromfield,SA,Spin,1961-12-08,Durban,South Africa,1961,2,60,198,3,1,285,733,16,225,535,13,17.8125,<=30,SA,Home,Upto 2014
HD Bromfield,SA,Spin,1961-12-26,Johannesburg,South Africa,1961,2,64,138,1,1,298,572,6,234,434,5,49.666666666666664,>30,SA,Home,Upto 2014
HD Bromfield,SA,Spin,1962-01-01,Cape Town,South Africa,1962,2,152,420,3,1,569,1566,23,417,1146,20,24.73913043478261,<=30,SA,Home,Upto 2014
HD Bromfield,SA,Spin,1962-02-02,Johannesburg,South Africa,1962,2,30,42,0,1,312,504,6,282,462,6,52.0,>30,SA,Home,Upto 2014
HD Bromfield,SA,Spin,1962-02-16,Gqeberha,South Africa,1962,2,15,108,1,1,338,1102,14,323,994,13,24.142857142857142,<=30,SA,Home,Upto 2014
HD Bromfield,SA,Spin,1965-01-01,Cape Town,South Africa,1965,1,88,344,5,1,605,1499,14,517,1155,9,43.214285714285715,>30,SA,Home,Upto 2014
HD Bromfield,SA,Spin,1965-01-22,Johannesburg,South Africa,1965,2,58,180,1,1,443,1146,10,385,966,9,44.3,>30,SA,Home,Upto 2014
HD Bromfield,SA,Spin,1965-02-12,Gqeberha,South Africa,1965,1,57,198,1,1,437,1309,10,380,1111,9,43.7,>30,SA,Home,Upto 2014
HD Bromfield,SA,Spin,1965-07-22,Lord's,England,1965,2,75,182,2,1,281,779,9,206,597,7,31.22222222222222,>30,ENG,Away,Upto 2014
HD Read,ENG,Pace,1935-08-17,The Oval,England,1935,2,200,270,6,1,741,1240,14,541,970,8,52.92857142857143,>30,ENG,Home,Upto 2014
HD Rutherford,NZ,Spin,2015-01-03,Wellington,New Zealand,2015,1,2,6,0,1,277,577,6,275,571,6,46.166666666666664,>30,NZ,Home,After 1965
HD Smith,NZ,Pace,1933-03-24,Christchurch,New Zealand,1933,1,113,120,1,1,467,920,9,354,800,8,51.888888888888886,>30,NZ,Home,Upto 2014
HDPK Dharmasena,SL,Spin,1993-09-06,Colombo (SSC),Sri Lanka,1993,1,91,270,0,1,286,744,8,195,474,8,35.75,>30,SL,Home,Upto 2014
HDPK Dharmasena,SL,Spin,1993-09-14,Colombo (PSS),Sri Lanka,1993,2,108,276,2,1,296,757,9,188,481,7,32.888888888888886,>30,SL,Home,Upto 2014
HDPK Dharmasena,SL,Spin,1994-08-09,Colombo (PSS),Sri Lanka,1994,2,183,458,8,1,791,1520,23,608,1062,15,34.391304347826086,>30,SL,Home,Upto 2014
HDPK Dharmasena,SL,Spin,1994-08-26,Kandy,Sri Lanka,1994,1,75,173,4,1,159,284,7,84,111,3,22.714285714285715,<=30,SL,Home,Upto 2014
HDPK Dharmasena,SL,Spin,1994-10-20,Bulawayo,Zimbabwe,1994,1,109,270,2,1,318,948,5,209,678,3,63.6,>30,ZIM,Away,Upto 2014
HDPK Dharmasena,SL,Spin,1994-10-26,Harare,Zimbabwe,1994,1,71,210,1,1,179,444,4,108,234,3,44.75,>30,ZIM,Away,Upto 2014
HDPK Dharmasena,SL,Spin,1995-09-15,Faisalabad,Pakistan,1995,2,122,313,3,1,624,1381,17,502,1068,14,36.705882352941174,>30,PAK,Away,Upto 2014
HDPK Dharmasena,SL,Spin,1995-09-22,Sialkot,Pakistan,1995,2,56,156,2,1,336,832,11,280,676,9,30.545454545454547,>30,PAK,Away,Upto 2014
HDPK Dharmasena,SL,Spin,1995-12-08,W.A.C.A,Australia,1995,1,84,186,0,1,558,1018,9,474,832,9,62.0,>30,AUS,Away,Upto 2014
HDPK Dharmasena,SL,Spin,1996-01-25,Adelaide,Australia,1996,2,147,282,1,1,356,732,3,209,450,2,118.66666666666667,>30,AUS,Away,Upto 2014
HDPK Dharmasena,SL,Spin,1996-09-11,Colombo (RPS),Sri Lanka,1996,2,42,138,2,1,302,952,21,260,814,19,14.380952380952381,<=30,SL,Home,Upto 2014
HDPK Dharmasena,SL,Spin,1997-03-14,Hamilton,New Zealand,1997,2,114,276,3,1,413,1010,18,299,734,15,22.944444444444443,<=30,NZ,Away,Upto 2014
HDPK Dharmasena,SL,Spin,1997-04-19,Colombo (RPS),Sri Lanka,1997,1,93,317,1,1,757,2006,23,664,1689,22,32.91304347826087,>30,SL,Home,Upto 2014
HDPK Dharmasena,SL,Spin,1997-06-13,St John's,West Indies,1997,2,40,90,2,1,220,504,11,180,414,9,20.0,<=30,WI,Away,Upto 2014
HDPK Dharmasena,SL,Spin,1997-06-20,Kingstown,West Indies,1997,2,88,192,3,1,276,646,16,188,454,13,17.25,<=30,WI,Away,Upto 2014
HDPK Dharmasena,SL,Spin,1997-11-19,Mohali,India,1997,1,65,204,0,1,502,1356,8,437,1152,8,62.75,>30,IND,Away,Upto 2014
HDPK Dharmasena,SL,Spin,1997-12-03,Wankhede,India,1997,2,201,364,8,1,533,1312,21,332,948,13,25.38095238095238,<=30,IND,Away,Upto 2014
HDPK Dharmasena,SL,Spin,1998-06-03,Galle,Sri Lanka,1998,2,88,181,6,1,443,1219,25,355,1038,19,17.72,<=30,SL,Home,Upto 2014
HDPK Dharmasena,SL,Spin,1998-06-10,Colombo (SSC),Sri Lanka,1998,2,49,168,2,1,526,1430,27,477,1262,25,19.48148148148148,<=30,SL,Home,Upto 2014
HDPK Dharmasena,SL,Spin,1998-08-27,The Oval,England,1998,2,67,225,0,1,481,1390,17,414,1165,17,28.294117647058822,<=30,ENG,Away,Upto 2014
HDPK Dharmasena,SL,Spin,2000-07-20,Galle,Sri Lanka,2000,2,107,210,1,1,705,1392,24,598,1182,23,29.375,<=30,SL,Home,Upto 2014
HDPK Dharmasena,SL,Spin,2000-07-30,Kandy,Sri Lanka,2000,2,105,216,4,1,551,1139,19,446,923,15,29.0,<=30,SL,Home,Upto 2014
HDPK Dharmasena,SL,Spin,2001-02-22,Galle,Sri Lanka,2001,2,72,228,1,1,636,1872,18,564,1644,17,35.333333333333336,>30,SL,Home,Upto 2014
HDPK Dharmasena,SL,Spin,2001-03-07,Kandy,Sri Lanka,2001,2,99,210,2,1,679,1658,18,580,1448,16,37.72222222222222,>30,SL,Home,Upto 2014
HDPK Dharmasena,SL,Spin,2003-04-25,Colombo (PSS),Sri Lanka,2003,2,153,336,3,1,714,1571,15,561,1235,12,47.6,>30,SL,Home,Upto 2014
HDPK Dharmasena,SL,Spin,2003-05-03,Kandy,Sri Lanka,2003,2,72,162,1,1,468,1155,15,396,993,14,31.2,>30,SL,Home,Upto 2014
HDPK Dharmasena,SL,Spin,2003-06-27,Kingston,West Indies,2003,2,39,42,1,1,148,370,7,109,328,6,21.142857142857142,<=30,WI,Away,Upto 2014
HDPK Dharmasena,SL,Spin,2003-12-02,Galle,Sri Lanka,2003,2,91,252,2,1,603,1823,28,512,1571,26,21.535714285714285,<=30,SL,Home,Upto 2014
HDPK Dharmasena,SL,Spin,2003-12-10,Kandy,Sri Lanka,2003,2,137,270,2,1,692,1702,20,555,1432,18,34.6,>30,SL,Home,Upto 2014
HDPK Dharmasena,SL,Spin,2004-03-08,Galle,Sri Lanka,2004,2,152,264,2,1,953,1791,32,801,1527,30,29.78125,<=30,SL,Home,Upto 2014
HDRL Thirimanne,SL,Pace,2011-09-16,Colombo (SSC),Sri Lanka,2011,1,7,6,0,1,825,1634,20,818,1628,20,41.25,>30,SL,Home,Upto 2014
HDRL Thirimanne,SL,Pace,2013-03-08,Galle,Sri Lanka,2013,1,13,12,0,1,420,696,6,407,684,6,70.0,>30,SL,Home,Upto 2014
HDRL Thirimanne,SL,Pace,2014-06-12,Lord's,England,2014,1,7,6,0,1,1099,1996,30,1092,1990,30,36.63333333333333,>30,ENG,Away,After 1965
HDRL Thirimanne,SL,Pace,2014-12-26,Christchurch,New Zealand,2014,1,5,12,0,1,757,1417,28,752,1405,28,27.035714285714285,<=30,NZ,Away,After 1965
HDRL Thirimanne,SL,Pace,2015-01-03,Wellington,New Zealand,2015,1,19,48,0,1,987,1835,28,968,1787,28,35.25,>30,NZ,Away,After 1965
HF Boyle,AUS,Spin,1879-01-02,Melbourne,Australia,1879,2,27,68,2,1,184,410,8,157,342,6,23.0,<=30,AUS,Home,After 1965
HF Boyle,AUS,Spin,1880-09-06,The Oval,England,1880,2,92,244,2,1,721,1528,21,629,1284,19,34.333333333333336,>30,ENG,Away,After 1965
HF Boyle,AUS,Spin,1881-12-31,Melbourne,Australia,1881,2,37,131,2,1,812,2321,24,775,2190,22,33.833333333333336,>30,AUS,Home,After 1965
HF Boyle,AUS,Spin,1882-03-03,Sydney,Australia,1882,2,27,124,2,1,374,1277,25,347,1153,23,14.96,<=30,AUS,Home,After 1965
HF Boyle,AUS,Spin,1882-03-10,Melbourne,Australia,1882,2,71,172,2,1,397,773,12,326,601,10,33.083333333333336,>30,AUS,Home,After 1965
HF Boyle,AUS,Spin,1882-08-28,The Oval,England,1882,2,43,156,5,1,130,428,15,87,272,10,8.666666666666666,<=30,ENG,Away,After 1965
HF Boyle,AUS,Spin,1883-02-17,Sydney,Australia,1883,2,87,252,5,1,484,1391,24,397,1139,19,20.166666666666668,<=30,AUS,Home,After 1965
HF Boyle,AUS,Spin,1884-07-10,Manchester,England,1884,2,69,180,7,1,222,640,17,153,460,10,13.058823529411764,<=30,ENG,Away,After 1965
HF Boyle,AUS,Spin,1884-07-21,Lord's,England,1884,1,16,44,0,1,320,694,15,304,650,15,21.333333333333332,<=30,ENG,Away,After 1965
HF Boyle,AUS,Spin,1884-08-11,The Oval,England,1884,2,56,84,2,1,469,1036,14,413,952,12,33.5,>30,ENG,Away,After 1965
HF Boyle,AUS,Spin,1884-12-12,Adelaide,Australia,1884,2,116,288,3,1,511,1330,22,395,1042,19,23.227272727272727,<=30,AUS,Home,After 1965
HG Gaekwad,IND,Spin,1952-10-23,Lucknow,India,1952,1,47,222,0,1,185,666,5,138,444,5,37.0,>30,IND,Home,Upto 2014
HG Vivian,NZ,Spin,1931-07-29,The Oval,England,1931,1,96,207,2,1,591,1465,18,495,1258,16,32.833333333333336,>30,ENG,Away,Upto 2014
HG Vivian,NZ,Spin,1931-08-15,Manchester,England,1931,1,54,84,2,1,146,258,2,92,174,0,73.0,>30,ENG,Away,Upto 2014
HG Vivian,NZ,Spin,1932-03-04,Wellington,New Zealand,1932,2,73,162,4,1,627,1075,19,554,913,15,33.0,>30,NZ,Home,Upto 2014
HG Vivian,NZ,Spin,1933-03-24,Christchurch,New Zealand,1933,1,72,114,1,1,316,759,7,244,645,6,45.142857142857146,>30,NZ,Home,Upto 2014
HG Vivian,NZ,Spin,1937-06-26,Lord's,England,1937,2,137,300,2,1,512,1098,11,375,798,9,46.54545454545455,>30,ENG,Away,Upto 2014
HG Vivian,NZ,Spin,1937-07-24,Manchester,England,1937,2,139,270,4,1,559,1166,19,420,896,15,29.42105263157895,<=30,ENG,Away,Upto 2014
HG Vivian,NZ,Spin,1937-08-14,The Oval,England,1937,1,62,174,2,1,331,715,12,269,541,10,27.583333333333332,<=30,ENG,Away,Upto 2014
HGO Owen-Smith,SA,Spin,1929-06-15,Birmingham,England,1929,1,29,36,0,1,416,1126,6,387,1090,6,69.33333333333333,>30,ENG,Away,Upto 2014
HGO Owen-Smith,SA,Spin,1929-06-29,Lord's,England,1929,1,3,6,0,1,382,1002,11,379,996,11,34.72727272727273,>30,ENG,Away,Upto 2014
HGO Owen-Smith,SA,Spin,1929-07-13,Leeds,England,1929,1,8,12,0,1,624,1466,25,616,1454,25,24.96,<=30,ENG,Away,Upto 2014
HGO Owen-Smith,SA,Spin,1929-07-27,Manchester,England,1929,1,16,30,0,1,374,874,16,358,844,16,23.375,<=30,ENG,Away,Upto 2014
HGO Owen-Smith,SA,Spin,1929-08-17,The Oval,England,1929,2,57,72,0,1,557,1110,10,500,1038,10,55.7,>30,ENG,Away,Upto 2014
HH Alexander,AUS,Pace,1933-02-23,Sydney,Australia,1933,2,154,276,1,1,693,1194,12,539,918,11,57.75,>30,AUS,Home,Upto 2014
HH Dippenaar,SA,Spin,2005-04-29,St John's,West Indies,2005,1,1,12,0,1,410,840,3,409,828,3,136.66666666666666,>30,WI,Away,Upto 2014
HH Gibbs,SA,Spin,2005-04-29,St John's,West Indies,2005,1,4,6,0,1,410,840,3,406,834,3,136.66666666666666,>30,WI,Away,Upto 2014
HH Kanitkar,IND,Spin,2000-01-02,Sydney,Australia,2000,1,2,6,0,1,279,470,1,277,464,1,279.0,>30,AUS,Away,Upto 2014
HH Pandya,IND,Pace,2017-07-26,Galle,Sri Lanka,2017,2,34,60,1,1,627,805,16,593,745,15,39.1875,>30,SL,Away,After 1965
HH Pandya,IND,Pace,2017-08-03,Colombo (SSC),Sri Lanka,2017,1,31,90,2,1,216,460,7,185,370,5,30.857142857142858,>30,SL,Away,After 1965
HH Pandya,IND,Pace,2017-08-12,Pallekele,Sri Lanka,2017,2,30,42,1,1,344,606,10,314,564,9,34.4,>30,SL,Away,After 1965
HH Pandya,IND,Pace,2018-01-05,Cape Town,South Africa,2018,2,80,108,3,1,684,1276,37,604,1168,34,18.486486486486488,<=30,SA,Away,After 1965
HH Pandya,IND,Pace,2018-01-13,Centurion,South Africa,2018,2,64,150,0,1,739,1521,29,675,1371,29,25.482758620689655,<=30,SA,Away,After 1965
HH Pandya,IND,Pace,2018-01-24,Johannesburg,South Africa,2018,2,18,48,0,1,749,1777,40,731,1729,40,18.725,<=30,SA,Away,After 1965
HH Pandya,IND,Pace,2018-06-14,Bengaluru,India,2018,2,24,54,0,1,280,456,13,256,402,13,21.53846153846154,<=30,IND,Home,After 1965
HH Pandya,IND,Pace,2018-08-01,Birmingham,England,2018,1,46,60,0,1,700,1284,29,654,1224,29,24.137931034482758,<=30,ENG,Away,After 1965
HH Pandya,IND,Pace,2018-08-09,Lord's,England,2018,1,66,103,3,1,483,867,26,417,764,23,18.576923076923077,<=30,ENG,Away,After 1965
HH Pandya,IND,Pace,2018-08-18,Nottingham,England,2018,2,50,120,6,1,905,1711,32,855,1591,26,28.28125,<=30,ENG,Away,After 1965
HH Pandya,IND,Pace,2018-08-30,Southampton,England,2018,2,85,102,1,1,624,1317,26,539,1215,25,24.0,<=30,ENG,Away,After 1965
HH Streak,ZIM,Pace,1993-12-01,Karachi,Pakistan,1993,2,117,234,0,1,605,1326,22,488,1092,22,27.5,<=30,PAK,Away,Upto 2014
HH Streak,ZIM,Pace,1993-12-09,Rawalpindi,Pakistan,1993,2,114,263,8,1,816,1939,40,702,1676,32,20.4,<=30,PAK,Away,Upto 2014
HH Streak,ZIM,Pace,1993-12-16,Lahore,Pakistan,1993,2,53,168,0,1,467,1213,21,414,1045,21,22.238095238095237,<=30,PAK,Away,Upto 2014
HH Streak,ZIM,Pace,1994-10-11,Harare,Zimbabwe,1994,1,79,257,4,1,445,1241,16,366,984,12,27.8125,<=30,ZIM,Home,Upto 2014
HH Streak,ZIM,Pace,1994-10-20,Bulawayo,Zimbabwe,1994,2,96,252,4,1,524,1630,17,428,1378,13,30.823529411764707,>30,ZIM,Home,Upto 2014
HH Streak,ZIM,Pace,1994-10-26,Harare,Zimbabwe,1994,2,129,300,5,1,659,1576,19,530,1276,14,34.68421052631579,>30,ZIM,Home,Upto 2014
HH Streak,ZIM,Pace,1995-01-31,Harare,Zimbabwe,1995,2,105,300,9,1,693,1542,23,588,1242,14,30.130434782608695,>30,ZIM,Home,Upto 2014
HH Streak,ZIM,Pace,1995-02-07,Bulawayo,Zimbabwe,1995,2,88,192,5,1,563,1357,30,475,1165,25,18.766666666666666,<=30,ZIM,Home,Upto 2014
HH Streak,ZIM,Pace,1995-02-15,Harare,Zimbabwe,1995,2,105,216,8,1,795,1808,39,690,1592,31,20.384615384615383,<=30,ZIM,Home,Upto 2014
HH Streak,ZIM,Pace,1995-10-13,Harare,Zimbabwe,1995,2,103,210,3,1,728,1549,32,625,1339,29,22.75,<=30,ZIM,Home,Upto 2014
HH Streak,ZIM,Pace,1996-01-13,Hamilton,New Zealand,1996,2,108,282,5,1,657,1344,21,549,1062,16,31.285714285714285,>30,NZ,Away,Upto 2014
HH Streak,ZIM,Pace,1996-01-20,Auckland,New Zealand,1996,2,160,312,7,1,908,2025,23,748,1713,16,39.47826086956522,>30,NZ,Away,Upto 2014
HH Streak,ZIM,Pace,1996-09-11,Colombo (RPS),Sri Lanka,1996,1,54,120,3,1,295,564,9,241,444,6,32.77777777777778,>30,SL,Away,Upto 2014
HH Streak,ZIM,Pace,1996-12-18,Bulawayo,Zimbabwe,1996,2,150,282,3,1,665,1230,17,515,948,14,39.11764705882353,>30,ZIM,Home,Upto 2014
HH Streak,ZIM,Pace,1996-12-26,Harare,Zimbabwe,1996,2,90,253,5,1,330,1045,15,240,792,10,22.0,<=30,ZIM,Home,Upto 2014
HH Streak,ZIM,Pace,1997-09-18,Harare,Zimbabwe,1997,2,115,264,3,1,808,1794,25,693,1530,22,32.32,>30,ZIM,Home,Upto 2014
HH Streak,ZIM,Pace,1997-09-25,Bulawayo,Zimbabwe,1997,1,26,90,0,1,606,1326,9,580,1236,9,67.33333333333333,>30,ZIM,Home,Upto 2014
HH Streak,ZIM,Pace,1998-01-07,Kandy,Sri Lanka,1998,2,100,210,4,1,383,839,8,283,629,4,47.875,>30,SL,Away,Upto 2014
HH Streak,ZIM,Pace,1998-01-14,Colombo (SSC),Sri Lanka,1998,2,112,240,6,1,369,728,14,257,488,8,26.357142857142858,<=30,SL,Away,Upto 2014
HH Streak,ZIM,Pace,1998-02-19,Wellington,New Zealand,1998,2,87,144,2,1,429,1062,17,342,918,15,25.235294117647058,<=30,NZ,Away,Upto 2014
HH Streak,ZIM,Pace,1998-02-26,Auckland,New Zealand,1998,1,105,186,3,1,557,1155,25,452,969,22,22.28,<=30,NZ,Away,Upto 2014
HH Streak,ZIM,Pace,1998-03-14,Bulawayo,Zimbabwe,1998,2,116,252,4,1,726,1690,25,610,1438,21,29.04,<=30,ZIM,Home,Upto 2014
HH Streak,ZIM,Pace,1998-03-21,Harare,Zimbabwe,1998,2,123,264,3,1,727,1780,29,604,1516,26,25.06896551724138,<=30,ZIM,Home,Upto 2014
HH Streak,ZIM,Pace,1998-10-07,Harare,Zimbabwe,1998,2,111,258,5,1,643,1431,26,532,1173,21,24.73076923076923,<=30,ZIM,Home,Upto 2014
HH Streak,ZIM,Pace,1998-11-27,Peshawar,Pakistan,1998,2,112,214,6,1,700,1353,31,588,1139,25,22.580645161290324,<=30,PAK,Away,Upto 2014
HH Streak,ZIM,Pace,1998-12-10,Lahore,Pakistan,1998,1,75,198,1,1,457,1020,11,382,822,10,41.54545454545455,>30,PAK,Away,Upto 2014
HH Streak,ZIM,Pace,1999-10-14,Harare,Zimbabwe,1999,1,93,204,5,1,535,1322,16,442,1118,11,33.4375,>30,ZIM,Home,Upto 2014
HH Streak,ZIM,Pace,2000-03-16,Port of Spain,West Indies,2000,2,72,246,9,1,483,1518,30,411,1272,21,16.1,<=30,WI,Away,Upto 2014
HH Streak,ZIM,Pace,2000-05-18,Lord's,England,2000,1,87,215,6,1,527,1078,29,440,863,23,18.17241379310345,<=30,ENG,Away,Upto 2014
HH Streak,ZIM,Pace,2000-06-01,Nottingham,England,2000,2,95,294,3,1,655,1521,23,560,1227,20,28.47826086956522,<=30,ENG,Away,Upto 2014
HH Streak,ZIM,Pace,2000-09-12,Bulawayo,Zimbabwe,2000,2,88,186,2,1,470,1291,13,382,1105,11,36.15384615384615,>30,ZIM,Home,Upto 2014
HH Streak,ZIM,Pace,2000-09-19,Harare,Zimbabwe,2000,2,107,222,2,1,838,2129,25,731,1907,23,33.52,>30,ZIM,Home,Upto 2014
HH Streak,ZIM,Pace,2000-11-18,Delhi,India,2000,2,96,210,2,1,620,1261,15,524,1051,13,41.333333333333336,>30,IND,Away,Upto 2014
HH Streak,ZIM,Pace,2000-11-25,Nagpur,India,2000,1,87,186,1,1,629,1195,8,542,1009,7,78.625,>30,IND,Away,Upto 2014
HH Streak,ZIM,Pace,2000-12-26,Wellington,New Zealand,2000,2,92,252,2,1,550,1397,13,458,1145,11,42.30769230769231,>30,NZ,Away,Upto 2014
HH Streak,ZIM,Pace,2001-04-19,Bulawayo,Zimbabwe,2001,2,89,240,5,1,731,1458,26,642,1218,21,28.115384615384617,<=30,ZIM,Home,Upto 2014
HH Streak,ZIM,Pace,2001-04-26,Harare,Zimbabwe,2001,2,85,306,6,1,669,1497,14,584,1191,8,47.785714285714285,>30,ZIM,Home,Upto 2014
HH Streak,ZIM,Pace,2001-06-07,Bulawayo,Zimbabwe,2001,1,63,144,3,1,658,1325,23,595,1181,20,28.608695652173914,<=30,ZIM,Home,Upto 2014
HH Streak,ZIM,Pace,2001-06-15,Harare,Zimbabwe,2001,2,115,282,7,1,726,1580,27,611,1298,20,26.88888888888889,<=30,ZIM,Home,Upto 2014
HH Streak,ZIM,Pace,2001-07-19,Bulawayo,Zimbabwe,2001,1,110,210,2,1,603,1276,18,493,1066,16,33.5,>30,ZIM,Home,Upto 2014
HH Streak,ZIM,Pace,2001-07-27,Harare,Zimbabwe,2001,2,109,224,2,1,709,1347,18,600,1123,16,39.388888888888886,>30,ZIM,Home,Upto 2014
HH Streak,ZIM,Pace,2001-09-07,Harare,Zimbabwe,2001,2,130,228,0,1,919,1718,19,789,1490,19,48.36842105263158,>30,ZIM,Home,Upto 2014
HH Streak,ZIM,Pace,2001-09-14,Bulawayo,Zimbabwe,2001,1,64,150,0,1,548,1308,7,484,1158,7,78.28571428571429,>30,ZIM,Home,Upto 2014
HH Streak,ZIM,Pace,2001-11-08,Dhaka,Bangladesh,2001,2,55,174,2,1,386,858,18,331,684,16,21.444444444444443,<=30,BAN,Away,Upto 2014
HH Streak,ZIM,Pace,2001-11-15,Chattogram,Bangladesh,2001,1,32,114,2,1,536,1126,10,504,1012,8,53.6,>30,BAN,Away,Upto 2014
HH Streak,ZIM,Pace,2001-12-27,Colombo (SSC),Sri Lanka,2001,1,113,204,3,1,677,1297,14,564,1093,11,48.357142857142854,>30,SL,Away,Upto 2014
HH Streak,ZIM,Pace,2002-01-04,Kandy,Sri Lanka,2002,1,85,197,2,1,529,977,13,444,780,11,40.69230769230769,>30,SL,Away,Upto 2014
HH Streak,ZIM,Pace,2002-01-12,Galle,Sri Lanka,2002,2,105,258,2,1,402,843,7,297,585,5,57.42857142857143,>30,SL,Away,Upto 2014
HH Streak,ZIM,Pace,2002-02-21,Nagpur,India,2002,1,108,204,1,1,439,839,7,331,635,6,62.714285714285715,>30,IND,Away,Upto 2014
HH Streak,ZIM,Pace,2002-02-28,Delhi,India,2002,2,145,325,5,1,446,889,10,301,564,5,44.6,>30,IND,Away,Upto 2014
HH Streak,ZIM,Pace,2003-05-22,Lord's,England,2003,1,99,222,3,1,641,1236,26,542,1014,23,24.653846153846153,<=30,ENG,Away,Upto 2014
HH Streak,ZIM,Pace,2003-06-05,Chester-le-Street,England,2003,1,64,205,4,1,554,1098,27,490,893,23,20.51851851851852,<=30,ENG,Away,Upto 2014
HH Streak,ZIM,Pace,2003-10-09,W.A.C.A,Australia,2003,1,131,156,0,1,658,1277,15,527,1121,15,43.86666666666667,>30,AUS,Away,Upto 2014
HH Streak,ZIM,Pace,2003-10-17,Sydney,Australia,2003,2,129,180,2,1,646,1058,15,517,878,13,43.06666666666667,>30,AUS,Away,Upto 2014
HH Streak,ZIM,Pace,2003-11-04,Harare,Zimbabwe,2003,2,102,258,4,1,904,1627,24,802,1369,20,37.666666666666664,>30,ZIM,Home,Upto 2014
HH Streak,ZIM,Pace,2003-11-12,Bulawayo,Zimbabwe,2003,2,126,234,4,1,595,1210,25,469,976,21,23.8,<=30,ZIM,Home,Upto 2014
HH Streak,ZIM,Pace,2004-02-19,Harare,Zimbabwe,2004,1,44,158,4,1,617,1260,23,573,1102,19,26.82608695652174,<=30,ZIM,Home,Upto 2014
HH Streak,ZIM,Pace,2004-02-26,Bulawayo,Zimbabwe,2004,1,19,90,1,1,218,510,6,199,420,5,36.333333333333336,>30,ZIM,Home,Upto 2014
HH Streak,ZIM,Pace,2005-03-04,Cape Town,South Africa,2005,1,90,78,0,1,443,710,15,353,632,15,29.533333333333335,<=30,SA,Away,Upto 2014
HH Streak,ZIM,Pace,2005-03-11,Centurion,South Africa,2005,1,78,120,2,1,611,1095,23,533,975,21,26.565217391304348,<=30,SA,Away,Upto 2014
HH Streak,ZIM,Pace,2005-08-07,Harare,Zimbabwe,2005,1,102,142,2,1,432,774,20,330,632,18,21.6,<=30,ZIM,Home,Upto 2014
HH Streak,ZIM,Pace,2005-08-15,Bulawayo,Zimbabwe,2005,1,73,132,4,1,584,919,19,511,787,15,30.736842105263158,>30,ZIM,Home,Upto 2014
HH Streak,ZIM,Pace,2005-09-13,Bulawayo,Zimbabwe,2005,1,91,156,0,1,492,794,18,401,638,18,27.333333333333332,<=30,ZIM,Home,Upto 2014
HH Streak,ZIM,Pace,2005-09-20,Harare,Zimbabwe,2005,1,73,192,6,1,559,997,27,486,805,21,20.703703703703702,<=30,ZIM,Home,Upto 2014
HHH Johnson,WI,Pace,1948-03-27,Kingston,West Indies,1948,2,96,395,10,1,401,1001,16,305,606,6,25.0625,<=30,WI,Home,Upto 2014
HHH Johnson,WI,Pace,1950-06-08,Manchester,England,1950,1,18,60,0,1,157,402,3,139,342,3,52.333333333333336,>30,ENG,Away,Upto 2014
HHH Johnson,WI,Pace,1950-07-20,Nottingham,England,1950,2,124,334,3,1,535,1228,10,411,894,7,53.5,>30,ENG,Away,Upto 2014
HI Ebeling,AUS,Pace,1934-08-18,The Oval,England,1934,2,89,186,3,1,874,1331,25,785,1145,22,34.96,>30,ENG,Away,Upto 2014
HI Young,ENG,Pace,1899-06-29,Leeds,England,1899,2,102,226,6,1,374,834,15,272,608,9,24.933333333333334,<=30,ENG,Home,After 1965
HI Young,ENG,Pace,1899-07-17,Manchester,England,1899,2,160,330,6,1,742,1679,23,582,1349,17,32.26086956521739,>30,ENG,Home,After 1965
HJ Butler,ENG,Pace,1947-07-26,Leeds,England,1947,2,66,312,7,1,268,799,16,202,487,9,16.75,<=30,ENG,Home,Upto 2014
HJ Butler,ENG,Pace,1948-02-11,Port of Spain,West Indies,1948,2,149,240,5,1,529,1106,15,380,866,10,35.266666666666666,>30,WI,Away,Upto 2014
HJ Howarth,NZ,Spin,1969-07-24,Lord's,England,1969,2,126,408,5,1,319,1131,22,193,723,17,14.5,<=30,ENG,Away,Upto 2014
HJ Howarth,NZ,Spin,1969-08-07,Nottingham,England,1969,1,89,246,1,1,236,642,5,147,396,4,47.2,>30,ENG,Away,Upto 2014
HJ Howarth,NZ,Spin,1969-08-21,The Oval,England,1969,2,98,342,2,1,310,1074,17,212,732,15,18.235294117647058,<=30,ENG,Away,Upto 2014
HJ Howarth,NZ,Spin,1969-09-25,Brabourne,India,1969,2,102,354,2,1,396,1358,19,294,1004,17,20.842105263157894,<=30,IND,Away,Upto 2014
HJ Howarth,NZ,Spin,1969-10-03,Nagpur,India,1969,2,100,318,9,1,677,1910,37,577,1592,28,18.2972972972973,<=30,IND,Away,Upto 2014
HJ Howarth,NZ,Spin,1969-10-15,Hyderabad (Deccan),India,1969,2,16,84,1,1,301,978,13,285,894,12,23.153846153846153,<=30,IND,Away,Upto 2014
HJ Howarth,NZ,Spin,1969-10-24,Karachi,Pakistan,1969,2,140,384,7,1,665,1813,26,525,1429,19,25.576923076923077,<=30,PAK,Away,Upto 2014
HJ Howarth,NZ,Spin,1969-10-30,Lahore,Pakistan,1969,2,98,286,5,1,434,1339,23,336,1053,18,18.869565217391305,<=30,PAK,Away,Upto 2014
HJ Howarth,NZ,Spin,1969-11-08,Dhaka,Bangladesh,1969,1,85,199,4,1,498,1577,22,413,1378,18,22.636363636363637,<=30,BAN,Away,Upto 2014
HJ Howarth,NZ,Spin,1971-02-25,Christchurch,New Zealand,1971,2,63,184,4,1,395,1134,21,332,950,17,18.80952380952381,<=30,NZ,Home,Upto 2014
HJ Howarth,NZ,Spin,1971-03-05,Auckland,New Zealand,1971,2,78,224,1,1,315,824,7,237,600,6,45.0,>30,NZ,Home,Upto 2014
HJ Howarth,NZ,Spin,1972-02-16,Kingston,West Indies,1972,2,151,366,3,1,653,1794,11,502,1428,8,59.36363636363637,>30,WI,Away,Upto 2014
HJ Howarth,NZ,Spin,1972-03-09,Port of Spain,West Indies,1972,2,138,438,4,1,722,2183,14,584,1745,10,51.57142857142857,>30,WI,Away,Upto 2014
HJ Howarth,NZ,Spin,1972-03-23,Bridgetown,West Indies,1972,2,144,462,2,1,454,1224,7,310,762,5,64.85714285714286,>30,WI,Away,Upto 2014
HJ Howarth,NZ,Spin,1972-04-06,Georgetown,West Indies,1972,2,91,282,0,1,489,1488,3,398,1206,3,163.0,>30,WI,Away,Upto 2014
HJ Howarth,NZ,Spin,1972-04-20,Port of Spain,West Indies,1972,2,179,480,5,1,509,1648,17,330,1168,12,29.941176470588236,<=30,WI,Away,Upto 2014
HJ Howarth,NZ,Spin,1973-02-02,Wellington,New Zealand,1973,2,172,448,4,1,304,776,6,132,328,2,50.666666666666664,>30,NZ,Home,Upto 2014
HJ Howarth,NZ,Spin,1973-02-07,Dunedin,New Zealand,1973,1,83,232,1,1,480,1145,19,397,913,18,25.263157894736842,<=30,NZ,Home,Upto 2014
HJ Howarth,NZ,Spin,1973-02-16,Auckland,New Zealand,1973,2,185,504,5,1,488,1070,18,303,566,13,27.11111111111111,<=30,NZ,Home,Upto 2014
HJ Howarth,NZ,Spin,1973-06-21,Lord's,England,1973,2,186,570,7,1,444,1278,9,258,708,2,49.333333333333336,>30,ENG,Away,Upto 2014
HJ Howarth,NZ,Spin,1973-07-05,Leeds,England,1973,1,44,108,0,1,170,420,1,126,312,1,170.0,>30,ENG,Away,Upto 2014
HJ Howarth,NZ,Spin,1974-03-01,Wellington,New Zealand,1974,2,210,368,2,1,424,1008,5,214,640,3,84.8,>30,NZ,Home,Upto 2014
HJ Howarth,NZ,Spin,1974-03-08,Christchurch,New Zealand,1974,1,22,88,0,1,60,216,2,38,128,2,30.0,<=30,NZ,Home,Upto 2014
HJ Howarth,NZ,Spin,1974-03-22,Auckland,New Zealand,1974,1,83,224,3,1,164,410,11,81,186,8,14.909090909090908,<=30,NZ,Home,Upto 2014
HJ Howarth,NZ,Spin,1975-02-20,Auckland,New Zealand,1975,1,135,368,1,1,416,1136,17,281,768,16,24.470588235294116,<=30,NZ,Home,Upto 2014
HJ Howarth,NZ,Spin,1975-02-28,Christchurch,New Zealand,1975,1,53,144,1,1,134,381,5,81,237,4,26.8,<=30,NZ,Home,Upto 2014
HJ Howarth,NZ,Spin,1976-01-24,Auckland,New Zealand,1976,2,112,274,4,1,633,1676,24,521,1402,20,26.375,<=30,NZ,Home,Upto 2014
HJ Howarth,NZ,Spin,1976-02-05,Christchurch,New Zealand,1976,1,48,176,1,1,255,744,3,207,568,2,85.0,>30,NZ,Home,Upto 2014
HJ Howarth,NZ,Spin,1977-02-18,Christchurch,New Zealand,1977,2,131,232,2,1,288,616,8,157,384,6,36.0,>30,NZ,Home,Upto 2014
HJ Howarth,NZ,Spin,1977-02-25,Auckland,New Zealand,1977,1,16,40,0,1,30,80,0,14,40,0,inf,>30,NZ,Home,Upto 2014
HJ Keith,SA,Spin,1953-02-06,Melbourne,Australia,1953,1,44,72,0,1,952,2221,20,908,2149,20,47.6,>30,AUS,Away,Upto 2014
HJ Keith,SA,Spin,1955-07-07,Manchester,England,1955,1,19,36,0,1,419,1223,6,400,1187,6,69.83333333333333,>30,ENG,Away,Upto 2014
HJ Rhodes,ENG,Pace,1959-07-02,Leeds,England,1959,2,85,173,4,1,379,911,14,294,738,10,27.071428571428573,<=30,ENG,Home,Upto 2014
HJ Rhodes,ENG,Pace,1959-07-23,Manchester,England,1959,2,159,276,5,1,572,1208,15,413,932,10,38.13333333333333,>30,ENG,Home,Upto 2014
HJ Tayfield,SA,Spin,1949-12-24,Johannesburg,South Africa,1949,1,93,224,3,1,426,1143,20,333,919,17,21.3,<=30,SA,Home,Upto 2014
HJ Tayfield,SA,Spin,1949-12-31,Cape Town,South Africa,1949,2,172,344,2,1,803,1732,19,631,1388,17,42.26315789473684,>30,SA,Home,Upto 2014
HJ Tayfield,SA,Spin,1950-01-20,Durban,South Africa,1950,2,167,460,9,1,552,1758,29,385,1298,20,19.03448275862069,<=30,SA,Home,Upto 2014
HJ Tayfield,SA,Spin,1950-02-10,Johannesburg,South Africa,1950,2,191,360,1,1,517,1176,4,326,816,3,129.25,>30,SA,Home,Upto 2014
HJ Tayfield,SA,Spin,1950-03-03,Gqeberha,South Africa,1950,1,103,200,2,1,463,890,16,360,690,14,28.9375,<=30,SA,Home,Upto 2014
HJ Tayfield,SA,Spin,1952-12-05,Brisbane,Australia,1952,2,175,387,4,1,592,1609,17,417,1222,13,34.8235294117647,>30,AUS,Away,Upto 2014
HJ Tayfield,SA,Spin,1952-12-24,Melbourne,Australia,1952,2,165,533,13,1,730,1899,24,565,1366,11,30.416666666666668,>30,AUS,Away,Upto 2014
HJ Tayfield,SA,Spin,1953-01-09,Sydney,Australia,1953,1,94,304,3,1,515,1280,12,421,976,9,42.916666666666664,>30,AUS,Away,Upto 2014
HJ Tayfield,SA,Spin,1953-01-24,Adelaide,Australia,1953,2,207,464,4,1,857,2379,23,650,1915,19,37.26086956521739,>30,AUS,Away,Upto 2014
HJ Tayfield,SA,Spin,1953-02-06,Melbourne,Australia,1953,2,202,540,6,1,952,2221,20,750,1681,14,47.6,>30,AUS,Away,Upto 2014
HJ Tayfield,SA,Spin,1953-03-06,Wellington,New Zealand,1953,2,95,420,5,1,540,1494,12,445,1074,7,45.0,>30,NZ,Away,Upto 2014
HJ Tayfield,SA,Spin,1953-03-13,Auckland,New Zealand,1953,2,67,293,5,1,495,1529,18,428,1236,13,27.5,<=30,NZ,Away,Upto 2014
HJ Tayfield,SA,Spin,1953-12-11,Durban,South Africa,1953,2,97,497,9,1,371,1319,16,274,822,7,23.1875,<=30,SA,Home,Upto 2014
HJ Tayfield,SA,Spin,1953-12-24,Johannesburg,South Africa,1953,1,53,66,1,1,206,522,9,153,456,8,22.88888888888889,<=30,SA,Home,Upto 2014
HJ Tayfield,SA,Spin,1954-01-01,Cape Town,South Africa,1954,1,80,264,1,1,639,1815,13,559,1551,12,49.15384615384615,>30,SA,Home,Upto 2014
HJ Tayfield,SA,Spin,1954-01-29,Johannesburg,South Africa,1954,2,61,344,8,1,148,530,8,87,186,0,18.5,<=30,SA,Home,Upto 2014
HJ Tayfield,SA,Spin,1954-02-05,Gqeberha,South Africa,1954,2,86,371,2,1,529,1620,15,443,1249,13,35.266666666666666,>30,SA,Home,Upto 2014
HJ Tayfield,SA,Spin,1955-06-09,Nottingham,England,1955,1,66,222,2,1,185,768,8,119,546,6,23.125,<=30,ENG,Away,Upto 2014
HJ Tayfield,SA,Spin,1955-06-23,Lord's,England,1955,1,80,233,5,1,220,561,12,140,328,7,18.333333333333332,<=30,ENG,Away,Upto 2014
HJ Tayfield,SA,Spin,1955-07-07,Manchester,England,1955,2,159,521,2,1,419,1223,6,260,702,4,69.83333333333333,>30,ENG,Away,Upto 2014
HJ Tayfield,SA,Spin,1955-07-21,Leeds,England,1955,2,164,469,9,1,458,1267,15,294,798,6,30.533333333333335,>30,ENG,Away,Upto 2014
HJ Tayfield,SA,Spin,1955-08-13,The Oval,England,1955,2,99,436,8,1,308,1166,23,209,730,15,13.391304347826088,<=30,ENG,Away,Upto 2014
HJ Tayfield,SA,Spin,1956-12-24,Johannesburg,South Africa,1956,2,70,302,3,1,201,734,9,131,432,6,22.333333333333332,<=30,SA,Home,Upto 2014
HJ Tayfield,SA,Spin,1957-01-01,Cape Town,South Africa,1957,2,163,520,6,1,343,1239,21,180,719,15,16.333333333333332,<=30,SA,Home,Upto 2014
HJ Tayfield,SA,Spin,1957-01-25,Durban,South Africa,1957,2,90,495,9,1,361,1289,21,271,794,12,17.19047619047619,<=30,SA,Home,Upto 2014
HJ Tayfield,SA,Spin,1957-02-15,Johannesburg,South Africa,1957,2,192,592,13,1,404,1102,19,212,510,6,21.263157894736842,<=30,SA,Home,Upto 2014
HJ Tayfield,SA,Spin,1957-03-01,Gqeberha,South Africa,1957,2,121,371,6,1,222,803,10,101,432,4,22.2,<=30,SA,Home,Upto 2014
HJ Tayfield,SA,Spin,1957-12-23,Johannesburg,South Africa,1957,2,171,496,4,1,467,1272,8,296,776,4,58.375,>30,SA,Home,Upto 2014
HJ Tayfield,SA,Spin,1957-12-31,Cape Town,South Africa,1957,1,120,408,5,1,376,1269,21,256,861,16,17.904761904761905,<=30,SA,Home,Upto 2014
HJ Tayfield,SA,Spin,1958-01-24,Durban,South Africa,1958,2,135,640,3,1,339,1343,10,204,703,7,33.9,>30,SA,Home,Upto 2014
HJ Tayfield,SA,Spin,1958-02-07,Johannesburg,South Africa,1958,1,107,392,1,1,358,1230,15,251,838,14,23.866666666666667,<=30,SA,Home,Upto 2014
HJ Tayfield,SA,Spin,1958-02-28,Gqeberha,South Africa,1958,2,106,275,4,1,259,749,14,153,474,10,18.5,<=30,SA,Home,Upto 2014
HJ Tayfield,SA,Spin,1960-06-09,Birmingham,England,1960,2,155,462,7,1,303,864,14,148,402,7,21.642857142857142,<=30,ENG,Away,Upto 2014
HJ Tayfield,SA,Spin,1960-06-23,Lord's,England,1960,1,64,162,0,1,64,168,0,0,6,0,inf,>30,ENG,Away,Upto 2014
HJ Tayfield,SA,Spin,1960-07-07,Nottingham,England,1960,1,58,171,3,1,109,321,3,51,150,0,36.333333333333336,>30,ENG,Away,Upto 2014
HJ Tayfield,SA,Spin,1960-07-21,Manchester,England,1960,1,69,108,0,1,183,377,4,114,269,4,45.75,>30,ENG,Away,Upto 2014
HJ Tayfield,SA,Spin,1960-08-18,The Oval,England,1960,1,108,222,2,1,312,852,6,204,630,4,52.0,>30,ENG,Away,Upto 2014
HJH Marshall,NZ,Pace,2000-12-08,Johannesburg,South Africa,2000,1,4,6,0,1,417,1127,13,413,1121,13,32.07692307692308,>30,SA,Away,Upto 2014
HJH Scott,AUS,Pace,1884-08-11,The Oval,England,1884,1,17,12,0,1,468,1104,7,451,1092,7,66.85714285714286,>30,ENG,Away,After 1965
HJH Scott,AUS,Pace,1884-12-12,Adelaide,Australia,1884,1,9,16,0,1,319,830,6,310,814,6,53.166666666666664,>30,AUS,Home,After 1965
HK Badani,IND,Spin,2001-08-29,Colombo (SSC),Sri Lanka,2001,1,17,48,0,1,579,1257,16,562,1209,16,36.1875,>30,SL,Away,Upto 2014
HK Bennett,NZ,Pace,2010-11-04,Ahmedabad,India,2010,1,47,90,0,1,415,862,12,368,772,12,34.583333333333336,>30,IND,Away,Upto 2014
HK Olonga,ZIM,Pace,1995-01-31,Harare,Zimbabwe,1995,1,27,60,1,1,693,1542,23,666,1482,22,30.130434782608695,>30,ZIM,Home,Upto 2014
HK Olonga,ZIM,Pace,1996-01-13,Hamilton,New Zealand,1996,2,85,102,1,1,657,1344,21,572,1242,20,31.285714285714285,>30,NZ,Away,Upto 2014
HK Olonga,ZIM,Pace,1996-09-11,Colombo (RPS),Sri Lanka,1996,1,57,102,2,1,295,564,9,238,462,7,32.77777777777778,>30,SL,Away,Upto 2014
HK Olonga,ZIM,Pace,1996-09-18,Colombo (SSC),Sri Lanka,1996,2,98,178,0,1,332,732,8,234,554,8,41.5,>30,SL,Away,Upto 2014
HK Olonga,ZIM,Pace,1996-10-17,Sheikhupura,Pakistan,1996,1,60,114,1,1,489,1024,12,429,910,11,40.75,>30,PAK,Away,Upto 2014
HK Olonga,ZIM,Pace,1996-12-18,Bulawayo,Zimbabwe,1996,2,106,150,4,1,665,1230,17,559,1080,13,39.11764705882353,>30,ZIM,Home,Upto 2014
HK Olonga,ZIM,Pace,1996-12-26,Harare,Zimbabwe,1996,2,54,96,1,1,330,1045,15,276,949,14,22.0,<=30,ZIM,Home,Upto 2014
HK Olonga,ZIM,Pace,1998-10-07,Harare,Zimbabwe,1998,2,110,216,6,1,643,1431,26,533,1215,20,24.73076923076923,<=30,ZIM,Home,Upto 2014
HK Olonga,ZIM,Pace,1998-11-27,Peshawar,Pakistan,1998,2,89,168,6,1,700,1353,31,611,1185,25,22.580645161290324,<=30,PAK,Away,Upto 2014
HK Olonga,ZIM,Pace,1998-12-10,Lahore,Pakistan,1998,1,63,150,3,1,457,1020,11,394,870,8,41.54545454545455,>30,PAK,Away,Upto 2014
HK Olonga,ZIM,Pace,1999-10-14,Harare,Zimbabwe,1999,1,83,102,0,1,535,1322,16,452,1220,16,33.4375,>30,ZIM,Home,Upto 2014
HK Olonga,ZIM,Pace,1999-10-29,Bloemfontein,South Africa,1999,1,93,199,4,1,728,1549,24,635,1350,20,30.333333333333332,>30,SA,Away,Upto 2014
HK Olonga,ZIM,Pace,1999-11-11,Harare,Zimbabwe,1999,1,107,198,3,1,560,1277,25,453,1079,22,22.4,<=30,ZIM,Home,Upto 2014
HK Olonga,ZIM,Pace,1999-11-18,Bulawayo,Zimbabwe,1999,1,103,192,4,1,569,1220,18,466,1028,14,31.61111111111111,>30,ZIM,Home,Upto 2014
HK Olonga,ZIM,Pace,1999-11-26,Harare,Zimbabwe,1999,2,102,210,2,1,681,1742,19,579,1532,17,35.8421052631579,>30,ZIM,Home,Upto 2014
HK Olonga,ZIM,Pace,1999-12-04,Harare,Zimbabwe,1999,2,65,160,3,1,525,1358,25,460,1198,22,21.0,<=30,ZIM,Home,Upto 2014
HK Olonga,ZIM,Pace,2000-03-16,Port of Spain,West Indies,2000,2,72,186,3,1,483,1518,30,411,1332,27,16.1,<=30,WI,Away,Upto 2014
HK Olonga,ZIM,Pace,2000-03-24,Kingston,West Indies,2000,2,85,205,3,1,544,1582,25,459,1377,22,21.76,<=30,WI,Away,Upto 2014
HK Olonga,ZIM,Pace,2000-09-19,Harare,Zimbabwe,2000,1,115,162,3,1,838,2129,25,723,1967,22,33.52,>30,ZIM,Home,Upto 2014
HK Olonga,ZIM,Pace,2000-11-18,Delhi,India,2000,2,105,156,2,1,620,1261,15,515,1105,13,41.333333333333336,>30,IND,Away,Upto 2014
HK Olonga,ZIM,Pace,2000-11-25,Nagpur,India,2000,1,98,144,0,1,629,1195,8,531,1051,8,78.625,>30,IND,Away,Upto 2014
HK Olonga,ZIM,Pace,2000-12-26,Wellington,New Zealand,2000,2,117,192,0,1,550,1397,13,433,1205,13,42.30769230769231,>30,NZ,Away,Upto 2014
HK Olonga,ZIM,Pace,2001-06-07,Bulawayo,Zimbabwe,2001,1,35,48,1,1,658,1325,23,623,1277,22,28.608695652173914,<=30,ZIM,Home,Upto 2014
HK Olonga,ZIM,Pace,2001-11-08,Dhaka,Bangladesh,2001,2,35,68,3,1,386,858,18,351,790,15,21.444444444444443,<=30,BAN,Away,Upto 2014
HK Olonga,ZIM,Pace,2001-11-15,Chattogram,Bangladesh,2001,2,71,162,2,1,536,1126,10,465,964,8,53.6,>30,BAN,Away,Upto 2014
HK Olonga,ZIM,Pace,2001-12-27,Colombo (SSC),Sri Lanka,2001,1,103,138,0,1,677,1297,14,574,1159,14,48.357142857142854,>30,SL,Away,Upto 2014
HK Olonga,ZIM,Pace,2002-01-04,Kandy,Sri Lanka,2002,1,131,144,0,1,529,977,13,398,833,13,40.69230769230769,>30,SL,Away,Upto 2014
HK Olonga,ZIM,Pace,2002-01-12,Galle,Sri Lanka,2002,2,108,150,1,1,402,843,7,294,693,6,57.42857142857143,>30,SL,Away,Upto 2014
HK Olonga,ZIM,Pace,2002-11-09,Harare,Zimbabwe,2002,2,139,203,6,1,875,1422,31,736,1219,25,28.225806451612904,<=30,ZIM,Home,Upto 2014
HK Olonga,ZIM,Pace,2002-11-16,Bulawayo,Zimbabwe,2002,2,104,147,3,1,555,1011,16,451,864,13,34.6875,>30,ZIM,Home,Upto 2014
HL Collins,AUS,Spin,1920-12-31,Melbourne,Australia,1920,2,84,156,2,1,436,860,13,352,704,11,33.53846153846154,>30,AUS,Home,Upto 2014
HL Collins,AUS,Spin,1921-08-13,The Oval,England,1921,1,39,42,0,1,509,810,8,470,768,8,63.625,>30,ENG,Away,Upto 2014
HL Collins,AUS,Spin,1921-11-12,Johannesburg,South Africa,1921,2,16,126,1,1,332,785,12,316,659,11,27.666666666666668,<=30,SA,Away,Upto 2014
HL Collins,AUS,Spin,1921-11-26,Cape Town,South Africa,1921,1,0,6,0,1,400,850,17,400,844,17,23.529411764705884,<=30,SA,Away,Upto 2014
HL Collins,AUS,Spin,1925-01-01,Melbourne,Australia,1925,1,10,88,0,1,988,2427,24,978,2339,24,41.166666666666664,>30,AUS,Home,Upto 2014
HL Collins,AUS,Spin,1925-01-16,Adelaide,Australia,1925,2,38,112,0,1,1079,2740,29,1041,2628,29,37.206896551724135,>30,AUS,Home,Upto 2014
HL Collins,AUS,Spin,1925-02-13,Melbourne,Australia,1925,1,18,48,0,1,718,1606,23,700,1558,23,31.217391304347824,>30,AUS,Home,Upto 2014
HL Collins,AUS,Spin,1925-02-27,Sydney,Australia,1925,1,36,64,1,1,638,1899,28,602,1835,27,22.785714285714285,<=30,AUS,Home,Upto 2014
HL Collins,AUS,Spin,1926-06-26,Lord's,England,1926,1,11,12,0,1,556,1523,10,545,1511,10,55.6,>30,ENG,Away,Upto 2014
HL Jackson,ENG,Pace,1949-07-23,Manchester,England,1949,2,72,234,3,1,464,974,13,392,740,10,35.69230769230769,>30,ENG,Home,Upto 2014
HL Jackson,ENG,Pace,1961-07-06,Leeds,England,1961,2,83,264,4,1,372,1169,24,289,905,20,15.5,<=30,ENG,Home,Upto 2014
HLE Promnitz,SA,Spin,1927-12-24,Johannesburg,South Africa,1927,2,72,258,5,1,312,867,11,240,609,6,28.363636363636363,<=30,SA,Home,Upto 2014
HLE Promnitz,SA,Spin,1927-12-31,Cape Town,South Africa,1927,2,89,270,3,1,504,1376,23,415,1106,20,21.91304347826087,<=30,SA,Home,Upto 2014
HM Amla,SA,Spin,2006-04-27,Cape Town,South Africa,2006,1,4,6,0,1,434,954,6,430,948,6,72.33333333333333,>30,SA,Home,Upto 2014
HM Amla,SA,Spin,2007-10-01,Karachi,Pakistan,2007,1,7,6,0,1,692,1416,21,685,1410,21,32.95238095238095,>30,PAK,Away,Upto 2014
HM Amla,SA,Spin,2008-01-10,Durban,South Africa,2008,1,11,18,0,1,101,144,1,90,126,1,101.0,>30,SA,Home,Upto 2014
HM Amla,SA,Spin,2008-04-11,Kanpur,India,2008,1,6,12,0,1,399,844,18,393,832,18,22.166666666666668,<=30,IND,Away,Upto 2014
HM Amla,SA,Spin,2012-11-09,Brisbane,Australia,2012,1,9,12,0,1,246,390,4,237,378,4,61.5,>30,AUS,Away,Upto 2014
HM McGirr,NZ,Pace,1930-02-14,Auckland,New Zealand,1930,1,46,72,0,1,146,336,1,100,264,1,146.0,>30,NZ,Home,Upto 2014
HM McGirr,NZ,Pace,1930-02-21,Auckland,New Zealand,1930,2,69,108,1,1,366,961,11,297,853,10,33.27272727272727,>30,NZ,Home,Upto 2014
HM Taberer,SA,Pace,1902-10-11,Johannesburg,South Africa,1902,2,48,60,1,1,545,690,15,497,630,14,36.333333333333336,>30,SA,Home,Upto 2014
HM Thurlow,AUS,Pace,1932-01-29,Adelaide,Australia,1932,2,86,234,0,1,508,1020,9,422,786,9,56.44444444444444,>30,AUS,Home,Upto 2014
HMCM Bandara,SL,Spin,1998-05-27,Colombo (RPS),Sri Lanka,1998,2,79,126,0,1,939,2077,27,860,1951,27,34.77777777777778,>30,SL,Home,Upto 2014
HMCM Bandara,SL,Spin,2005-12-02,Chennai,India,2005,1,15,68,1,1,150,362,6,135,294,5,25.0,<=30,IND,Away,Upto 2014
HMCM Bandara,SL,Spin,2005-12-10,Delhi,India,2005,2,128,222,3,1,668,1353,25,540,1131,22,26.72,<=30,IND,Away,Upto 2014
HMCM Bandara,SL,Spin,2005-12-18,Ahmedabad,India,2005,2,153,262,5,1,765,1419,29,612,1157,24,26.379310344827587,<=30,IND,Away,Upto 2014
HMCM Bandara,SL,Spin,2006-02-28,Chattogram,Bangladesh,2006,2,116,198,4,1,666,1170,22,550,972,18,30.272727272727273,>30,BAN,Away,Upto 2014
HMCM Bandara,SL,Spin,2006-03-08,Bogra,Bangladesh,2006,2,60,138,3,1,552,1040,19,492,902,16,29.05263157894737,<=30,BAN,Away,Upto 2014
HMCM Bandara,SL,Spin,2006-03-26,Colombo (SSC),Sri Lanka,2006,2,67,126,0,1,538,1125,13,471,999,13,41.38461538461539,>30,SL,Home,Upto 2014
HMCM Bandara,SL,Spin,2006-04-03,Kandy,Sri Lanka,2006,1,15,12,0,1,153,330,9,138,318,9,17.0,<=30,SL,Home,Upto 2014
HMRKB Herath,SL,Spin,1999-09-22,Galle,Sri Lanka,1999,1,97,207,4,1,307,827,13,210,620,9,23.615384615384617,<=30,SL,Home,Upto 2014
HMRKB Herath,SL,Spin,1999-09-30,Colombo (SSC),Sri Lanka,1999,1,98,210,2,1,278,654,6,180,444,4,46.333333333333336,>30,SL,Home,Upto 2014
HMRKB Herath,SL,Spin,2000-06-21,Galle,Sri Lanka,2000,1,115,216,0,1,434,852,7,319,636,7,62.0,>30,SL,Home,Upto 2014
HMRKB Herath,SL,Spin,2004-03-24,Colombo (SSC),Sri Lanka,2004,2,167,284,4,1,844,1656,26,677,1372,22,32.46153846153846,>30,SL,Home,Upto 2014
HMRKB Herath,SL,Spin,2004-08-11,Colombo (SSC),Sri Lanka,2004,2,73,198,3,1,470,988,13,397,790,10,36.15384615384615,>30,SL,Home,Upto 2014
HMRKB Herath,SL,Spin,2004-10-20,Faisalabad,Pakistan,2004,2,132,357,7,1,395,875,14,263,518,7,28.214285714285715,<=30,PAK,Away,Upto 2014
HMRKB Herath,SL,Spin,2004-10-28,Karachi,Pakistan,2004,2,188,288,4,1,509,1056,15,321,768,11,33.93333333333333,>30,PAK,Away,Upto 2014
HMRKB Herath,SL,Spin,2005-04-04,Napier,New Zealand,2005,2,120,247,3,1,443,871,8,323,624,5,55.375,>30,NZ,Away,Upto 2014
HMRKB Herath,SL,Spin,2005-07-13,Colombo (SSC),Sri Lanka,2005,2,64,102,0,1,301,612,9,237,510,9,33.44444444444444,>30,SL,Home,Upto 2014
HMRKB Herath,SL,Spin,2005-07-22,Kandy,Sri Lanka,2005,2,55,108,1,1,292,585,15,237,477,14,19.466666666666665,<=30,SL,Home,Upto 2014
HMRKB Herath,SL,Spin,2005-09-12,Colombo (RPS),Sri Lanka,2005,2,39,78,4,1,396,772,20,357,694,16,19.8,<=30,SL,Home,Upto 2014
HMRKB Herath,SL,Spin,2005-09-20,Colombo (PSS),Sri Lanka,2005,2,56,100,3,1,417,656,12,361,556,9,34.75,>30,SL,Home,Upto 2014
HMRKB Herath,SL,Spin,2008-03-22,Providence,West Indies,2008,2,99,282,0,1,634,1374,12,535,1092,12,52.833333333333336,>30,WI,Away,Upto 2014
HMRKB Herath,SL,Spin,2008-12-26,Mirpur,Bangladesh,2008,2,115,228,1,1,727,1408,21,612,1180,20,34.61904761904762,>30,BAN,Away,Upto 2014
HMRKB Herath,SL,Spin,2009-07-04,Galle,Sri Lanka,2009,2,67,165,5,1,354,709,16,287,544,11,22.125,<=30,SL,Home,Upto 2014
HMRKB Herath,SL,Spin,2009-07-12,Colombo (PSS),Sri Lanka,2009,2,104,246,5,1,425,767,15,321,521,10,28.333333333333332,<=30,SL,Home,Upto 2014
HMRKB Herath,SL,Spin,2009-07-20,Colombo (SSC),Sri Lanka,2009,2,233,414,5,1,647,1311,18,414,897,13,35.94444444444444,>30,SL,Home,Upto 2014
HMRKB Herath,SL,Spin,2009-08-26,Colombo (SSC),Sri Lanka,2009,2,209,492,8,1,760,1587,27,551,1095,19,28.14814814814815,<=30,SL,Home,Upto 2014
HMRKB Herath,SL,Spin,2009-11-16,Ahmedabad,India,2009,2,176,372,3,1,904,1575,9,728,1203,6,100.44444444444444,>30,IND,Away,Upto 2014
HMRKB Herath,SL,Spin,2009-11-24,Kanpur,India,2009,1,121,198,5,1,718,1197,20,597,999,15,35.9,>30,IND,Away,Upto 2014
HMRKB Herath,SL,Spin,2009-12-02,Brabourne,India,2009,1,240,321,3,1,870,1403,18,630,1082,15,48.333333333333336,>30,IND,Away,Upto 2014
HMRKB Herath,SL,Spin,2010-07-18,Galle,Sri Lanka,2010,2,122,270,1,1,643,1145,10,521,875,9,64.3,>30,SL,Home,Upto 2014
HMRKB Herath,SL,Spin,2010-11-23,Colombo (RPS),Sri Lanka,2010,2,76,144,3,1,280,519,10,204,375,7,28.0,<=30,SL,Home,Upto 2014
HMRKB Herath,SL,Spin,2010-12-01,Pallekele,Sri Lanka,2010,1,54,138,4,1,152,366,6,98,228,2,25.333333333333332,<=30,SL,Home,Upto 2014
HMRKB Herath,SL,Spin,2011-05-26,Cardiff,England,2011,1,115,264,1,1,338,682,10,223,418,9,33.8,>30,ENG,Away,Upto 2014
HMRKB Herath,SL,Spin,2011-06-03,Lord's,England,2011,2,151,257,5,1,315,597,8,164,340,3,39.375,>30,ENG,Away,Upto 2014
HMRKB Herath,SL,Spin,2011-06-16,Southampton,England,2011,1,33,54,0,1,132,258,2,99,204,2,66.0,>30,ENG,Away,Upto 2014
HMRKB Herath,SL,Spin,2011-08-31,Galle,Sri Lanka,2011,2,133,282,8,1,441,845,19,308,563,11,23.210526315789473,<=30,SL,Home,Upto 2014
HMRKB Herath,SL,Spin,2011-09-16,Colombo (SSC),Sri Lanka,2011,2,235,474,8,1,436,882,9,201,408,1,48.44444444444444,>30,SL,Home,Upto 2014
HMRKB Herath,SL,Spin,2011-10-18,Abu Dhabi,UAE,2011,2,134,382,3,1,499,1258,7,365,876,4,71.28571428571429,>30,UAE,Away,Upto 2014
HMRKB Herath,SL,Spin,2011-10-26,Dubai (DICS),UAE,2011,2,118,283,3,1,466,1189,19,348,906,16,24.526315789473685,<=30,UAE,Away,Upto 2014
HMRKB Herath,SL,Spin,2011-11-03,Sharjah,UAE,2011,2,104,384,4,1,589,1524,15,485,1140,11,39.266666666666666,>30,UAE,Away,Upto 2014
HMRKB Herath,SL,Spin,2011-12-15,Centurion,South Africa,2011,1,41,138,0,1,95,240,3,54,102,3,31.666666666666668,>30,SA,Away,Upto 2014
HMRKB Herath,SL,Spin,2011-12-26,Durban,South Africa,2011,2,128,303,9,1,329,669,13,201,366,4,25.307692307692307,<=30,SA,Away,Upto 2014
HMRKB Herath,SL,Spin,2012-01-03,Cape Town,South Africa,2012,1,108,252,1,1,307,606,6,199,354,5,51.166666666666664,>30,SA,Away,Upto 2014
HMRKB Herath,SL,Spin,2012-03-26,Galle,Sri Lanka,2012,2,171,342,12,1,607,1324,28,436,982,16,21.678571428571427,<=30,SL,Home,Upto 2014
HMRKB Herath,SL,Spin,2012-04-03,Colombo (PSS),Sri Lanka,2012,2,170,372,7,1,698,1454,22,528,1082,15,31.727272727272727,>30,SL,Home,Upto 2014
HMRKB Herath,SL,Spin,2012-06-22,Galle,Sri Lanka,2012,2,121,378,5,1,621,1409,23,500,1031,18,27.0,<=30,SL,Home,Upto 2014
HMRKB Herath,SL,Spin,2012-06-30,Colombo (SSC),Sri Lanka,2012,2,165,300,3,1,609,1048,13,444,748,10,46.84615384615385,>30,SL,Home,Upto 2014
HMRKB Herath,SL,Spin,2012-07-08,Pallekele,Sri Lanka,2012,2,139,351,7,1,298,765,13,159,414,6,22.923076923076923,<=30,SL,Home,Upto 2014
HMRKB Herath,SL,Spin,2012-11-17,Galle,Sri Lanka,2012,2,108,288,11,1,290,649,16,182,361,5,18.125,<=30,SL,Home,Upto 2014
HMRKB Herath,SL,Spin,2012-11-25,Colombo (PSS),Sri Lanka,2012,2,170,420,9,1,489,1212,15,319,792,6,32.6,>30,SL,Home,Upto 2014
HMRKB Herath,SL,Spin,2012-12-14,Hobart,Australia,2012,2,170,287,5,1,352,719,7,182,432,2,50.285714285714285,>30,AUS,Away,Upto 2014
HMRKB Herath,SL,Spin,2012-12-26,Melbourne,Australia,2012,1,95,234,0,1,172,352,4,77,118,4,43.0,>30,AUS,Away,Upto 2014
HMRKB Herath,SL,Spin,2013-01-03,Sydney,Australia,2013,2,142,287,7,1,392,713,11,250,426,4,35.63636363636363,>30,AUS,Away,Upto 2014
HMRKB Herath,SL,Spin,2013-03-08,Galle,Sri Lanka,2013,2,176,396,2,1,1160,1920,13,984,1524,11,89.23076923076923,>30,SL,Home,Upto 2014
HMRKB Herath,SL,Spin,2013-03-16,Colombo (RPS),Sri Lanka,2013,2,157,387,12,1,481,1042,18,324,655,6,26.72222222222222,<=30,SL,Home,Upto 2014
HMRKB Herath,SL,Spin,2013-12-31,Abu Dhabi,UAE,2013,2,130,337,4,1,396,907,6,266,570,2,66.0,>30,UAE,Away,Upto 2014
HMRKB Herath,SL,Spin,2014-01-08,Dubai (DICS),UAE,2014,2,158,353,5,1,299,751,9,141,398,4,33.22222222222222,>30,UAE,Away,After 1965
HMRKB Herath,SL,Spin,2014-01-16,Sharjah,UAE,2014,2,225,343,5,1,637,1445,16,412,1102,11,39.8125,>30,UAE,Away,After 1965
HMRKB Herath,SL,Spin,2014-01-27,Mirpur,Bangladesh,2014,2,97,120,3,1,658,946,13,561,826,10,50.61538461538461,>30,BAN,Away,After 1965
HMRKB Herath,SL,Spin,2014-06-12,Lord's,England,2014,2,231,363,5,1,336,573,6,105,210,1,56.0,>30,ENG,Away,After 1965
HMRKB Herath,SL,Spin,2014-06-20,Leeds,England,2014,2,120,402,3,1,219,552,5,99,150,2,43.8,>30,ENG,Away,After 1965
HMRKB Herath,SL,Spin,2014-07-16,Galle,Sri Lanka,2014,2,232,492,3,1,723,1396,15,491,904,12,48.2,>30,SL,Home,After 1965
HMRKB Herath,SL,Spin,2014-07-24,Colombo (SSC),Sri Lanka,2014,2,111,540,9,1,647,1745,22,536,1205,13,29.40909090909091,<=30,SL,Home,After 1965
HMRKB Herath,SL,Spin,2014-08-06,Galle,Sri Lanka,2014,2,164,410,9,1,717,1430,22,553,1020,13,32.59090909090909,>30,SL,Home,After 1965
HMRKB Herath,SL,Spin,2014-08-14,Colombo (SSC),Sri Lanka,2014,2,184,332,14,1,617,1331,23,433,999,9,26.82608695652174,<=30,SL,Home,After 1965
HMRKB Herath,SL,Spin,2015-01-03,Wellington,New Zealand,2015,2,161,348,1,1,277,577,6,116,229,5,46.166666666666664,>30,NZ,Away,After 1965
HMRKB Herath,SL,Spin,2015-06-17,Galle,Sri Lanka,2015,2,129,206,1,1,617,1159,20,488,953,19,30.85,>30,SL,Home,After 1965
HMRKB Herath,SL,Spin,2015-06-25,Colombo (PSS),Sri Lanka,2015,1,89,204,1,1,521,1055,17,432,851,16,30.647058823529413,>30,SL,Home,After 1965
HMRKB Herath,SL,Spin,2015-08-12,Galle,Sri Lanka,2015,2,115,324,7,1,627,1167,31,512,843,24,20.225806451612904,<=30,SL,Home,After 1965
HMRKB Herath,SL,Spin,2015-08-20,Colombo (PSS),Sri Lanka,2015,2,177,324,4,1,596,1144,22,419,820,18,27.09090909090909,<=30,SL,Home,After 1965
HMRKB Herath,SL,Spin,2015-08-28,Colombo (SSC),Sri Lanka,2015,2,173,295,4,1,433,759,12,260,464,8,36.083333333333336,>30,SL,Home,After 1965
HMRKB Herath,SL,Spin,2015-10-14,Galle,Sri Lanka,2015,2,147,330,10,1,555,1017,18,408,687,8,30.833333333333332,>30,SL,Home,After 1965
HMRKB Herath,SL,Spin,2015-10-22,Colombo (PSS),Sri Lanka,2015,2,95,239,5,1,448,1072,27,353,833,22,16.59259259259259,<=30,SL,Home,After 1965
HMRKB Herath,SL,Spin,2015-12-10,Dunedin,New Zealand,2015,2,108,184,2,1,310,569,7,202,385,5,44.285714285714285,>30,NZ,Away,After 1965
HMRKB Herath,SL,Spin,2015-12-18,Hamilton,New Zealand,2015,2,123,198,2,1,163,255,2,40,57,0,81.5,>30,NZ,Away,After 1965
HMRKB Herath,SL,Spin,2016-05-19,Leeds,England,2016,1,25,69,2,1,27,75,3,2,6,1,9.0,<=30,ENG,Away,After 1965
HMRKB Herath,SL,Spin,2016-05-27,Chester-le-Street,England,2016,2,134,234,1,1,355,530,5,221,296,4,71.0,>30,ENG,Away,After 1965
HMRKB Herath,SL,Spin,2016-06-09,Lord's,England,2016,2,144,336,4,1,192,434,4,48,98,0,48.0,>30,ENG,Away,After 1965
HMRKB Herath,SL,Spin,2016-07-26,Pallekele,Sri Lanka,2016,2,103,351,9,1,503,1219,26,400,868,17,19.346153846153847,<=30,SL,Home,After 1965
HMRKB Herath,SL,Spin,2016-08-04,Galle,Sri Lanka,2016,2,109,181,6,1,555,873,24,446,692,18,23.125,<=30,SL,Home,After 1965
HMRKB Herath,SL,Spin,2016-08-13,Colombo (SSC),Sri Lanka,2016,2,145,338,13,1,860,1808,28,715,1470,15,30.714285714285715,>30,SL,Home,After 1965
HMRKB Herath,SL,Spin,2016-10-29,Harare,Zimbabwe,2016,2,135,402,6,1,573,1161,19,438,759,13,30.157894736842106,>30,ZIM,Away,After 1965
HMRKB Herath,SL,Spin,2016-11-06,Harare,Zimbabwe,2016,2,152,294,13,1,564,968,25,412,674,12,22.56,<=30,ZIM,Away,After 1965
HMRKB Herath,SL,Spin,2016-12-26,Gqeberha,South Africa,2016,2,132,269,3,1,359,638,9,227,369,6,39.888888888888886,>30,SA,Away,After 1965
HMRKB Herath,SL,Spin,2017-01-02,Cape Town,South Africa,2017,2,89,176,3,1,230,404,6,141,228,3,38.333333333333336,>30,SA,Away,After 1965
HMRKB Herath,SL,Spin,2017-01-12,Johannesburg,South Africa,2017,1,67,84,0,1,90,138,0,23,54,0,inf,>30,SA,Away,After 1965
HMRKB Herath,SL,Spin,2017-03-07,Galle,Sri Lanka,2017,2,131,280,9,1,752,1277,25,621,997,16,30.08,>30,SL,Home,After 1965
HMRKB Herath,SL,Spin,2017-03-15,Colombo (PSS),Sri Lanka,2017,2,157,354,7,1,916,1838,26,759,1484,19,35.23076923076923,>30,SL,Home,After 1965
HMRKB Herath,SL,Spin,2017-07-14,Colombo (RPS),Sri Lanka,2017,2,249,427,11,1,1059,1917,28,810,1490,17,37.82142857142857,>30,SL,Home,After 1965
HMRKB Herath,SL,Spin,2017-07-26,Galle,Sri Lanka,2017,2,193,294,1,1,734,1244,13,541,950,12,56.46153846153846,>30,SL,Home,After 1965
HMRKB Herath,SL,Spin,2017-08-03,Colombo (SSC),Sri Lanka,2017,1,154,252,4,1,953,1487,21,799,1235,17,45.38095238095238,>30,SL,Home,After 1965
HMRKB Herath,SL,Spin,2017-09-28,Abu Dhabi,UAE,2017,2,136,370,11,1,623,1568,26,487,1198,15,23.96153846153846,<=30,UAE,Away,After 1965
HMRKB Herath,SL,Spin,2017-10-06,Dubai (DICS),UAE,2017,2,141,272,5,1,608,1153,24,467,881,19,25.333333333333332,<=30,UAE,Away,After 1965
HMRKB Herath,SL,Spin,2017-11-16,Eden Gardens,India,2017,2,34,48,0,1,123,228,3,89,180,3,41.0,>30,IND,Away,After 1965
HMRKB Herath,SL,Spin,2017-11-24,Nagpur,India,2017,1,81,234,1,1,497,970,17,416,736,16,29.235294117647058,<=30,IND,Away,After 1965
HMRKB Herath,SL,Spin,2018-01-31,Chattogram,Bangladesh,2018,2,230,390,5,1,1210,2061,19,980,1671,14,63.68421052631579,>30,BAN,Away,After 1965
HMRKB Herath,SL,Spin,2018-02-08,Mirpur,Bangladesh,2018,2,80,141,4,1,561,1029,30,481,888,26,18.7,<=30,BAN,Away,After 1965
HMRKB Herath,SL,Spin,2018-06-06,Port of Spain,West Indies,2018,2,119,336,3,1,353,866,12,234,530,9,29.416666666666668,<=30,WI,Away,After 1965
HMRKB Herath,SL,Spin,2018-07-12,Galle,Sri Lanka,2018,2,77,198,5,1,416,921,25,339,723,20,16.64,<=30,SL,Home,After 1965
HMRKB Herath,SL,Spin,2018-07-20,Colombo (SSC),Sri Lanka,2018,2,130,251,7,1,722,1323,32,592,1072,25,22.5625,<=30,SL,Home,After 1965
HMRKB Herath,SL,Spin,2018-11-06,Galle,Sri Lanka,2018,2,137,288,3,1,876,1627,28,739,1339,25,31.285714285714285,>30,SL,Home,After 1965
HP Tillakaratne,SL,Spin,1992-11-27,Moratuwa,Sri Lanka,1992,1,1,6,0,1,176,750,7,175,744,7,25.142857142857142,<=30,SL,Home,Upto 2014
HP Tillakaratne,SL,Spin,1993-08-25,Moratuwa,Sri Lanka,1993,1,5,12,0,1,610,1439,14,605,1427,14,43.57142857142857,>30,SL,Home,Upto 2014
HP Tillakaratne,SL,Spin,1995-12-26,Melbourne,Australia,1995,1,5,4,0,1,439,892,9,434,888,9,48.77777777777778,>30,AUS,Away,Upto 2014
HP Tillakaratne,SL,Spin,1997-04-26,Colombo (SSC),Sri Lanka,1997,1,3,12,0,1,882,1775,14,879,1763,14,63.0,>30,SL,Home,Upto 2014
HP Tillakaratne,SL,Spin,1999-02-24,Colombo (SSC),Sri Lanka,1999,1,0,6,0,1,484,1002,12,484,996,12,40.333333333333336,>30,SL,Home,Upto 2014
HP Tillakaratne,SL,Spin,2001-11-21,Kandy,Sri Lanka,2001,1,1,12,0,1,458,1038,19,457,1026,19,24.105263157894736,<=30,SL,Home,Upto 2014
HP Tillakaratne,SL,Spin,2001-11-29,Colombo (SSC),Sri Lanka,2001,1,1,6,0,1,542,1074,5,541,1068,5,108.4,>30,SL,Home,Upto 2014
HP Tillakaratne,SL,Spin,2002-01-04,Kandy,Sri Lanka,2002,1,8,6,0,1,367,934,16,359,928,16,22.9375,<=30,SL,Home,Upto 2014
HP Tillakaratne,SL,Spin,2002-05-16,Lord's,England,2002,1,0,6,0,1,171,426,1,171,420,1,171.0,>30,ENG,Away,Upto 2014
HP Tillakaratne,SL,Spin,2003-12-10,Kandy,Sri Lanka,2003,1,1,6,0,1,692,1702,20,691,1696,20,34.6,>30,SL,Home,Upto 2014
HR Adhikari,IND,Spin,1948-02-06,Melbourne,Australia,1948,1,4,8,0,1,478,1056,12,474,1048,12,39.833333333333336,>30,AUS,Away,Upto 2014
HR Adhikari,IND,Spin,1949-01-27,Chennai,India,1949,1,10,6,0,1,495,939,11,485,933,11,45.0,>30,IND,Home,Upto 2014
HR Adhikari,IND,Spin,1959-02-06,Delhi,India,1959,1,68,156,3,1,775,1794,11,707,1638,8,70.45454545454545,>30,IND,Home,Upto 2014
HR Bromley-Davenport,ENG,Pace,1896-02-13,Gqeberha,South Africa,1896,2,69,95,3,1,376,688,29,307,593,26,12.96551724137931,<=30,SA,Away,After 1965
HR Bromley-Davenport,ENG,Pace,1896-03-02,Johannesburg,South Africa,1896,1,13,15,0,1,539,922,24,526,907,24,22.458333333333332,<=30,SA,Away,After 1965
HR Bromley-Davenport,ENG,Pace,1896-03-21,Cape Town,South Africa,1896,1,16,45,1,1,245,540,16,229,495,15,15.3125,<=30,SA,Away,After 1965
HR Lance,SA,Pace,1962-02-02,Johannesburg,South Africa,1962,2,80,156,4,1,533,1091,23,453,935,19,23.17391304347826,<=30,SA,Home,Upto 2014
HR Lance,SA,Pace,1962-02-16,Gqeberha,South Africa,1962,2,86,132,3,1,563,1365,25,477,1233,22,22.52,<=30,SA,Home,Upto 2014
HR Lance,SA,Pace,1965-07-22,Lord's,England,1965,1,18,30,0,1,689,1908,25,671,1878,25,27.56,<=30,ENG,Away,Upto 2014
HR Lance,SA,Pace,1965-08-26,The Oval,England,1965,2,17,24,0,1,786,1848,27,769,1824,27,29.11111111111111,<=30,ENG,Away,Upto 2014
HR Lance,SA,Pace,1966-12-23,Johannesburg,South Africa,1966,2,41,120,1,1,809,1914,26,768,1794,25,31.115384615384617,>30,SA,Home,Upto 2014
HR Lance,SA,Pace,1966-12-31,Cape Town,South Africa,1966,1,95,120,1,1,762,1783,22,667,1663,21,34.63636363636363,>30,SA,Home,Upto 2014
HR Lance,SA,Pace,1967-01-20,Durban,South Africa,1967,1,39,90,2,1,725,1921,25,686,1831,23,29.0,<=30,SA,Home,Upto 2014
HR Lance,SA,Pace,1967-02-03,Johannesburg,South Africa,1967,1,4,18,0,1,518,1312,23,514,1294,23,22.52173913043478,<=30,SA,Home,Upto 2014
HR Lance,SA,Pace,1967-02-24,Gqeberha,South Africa,1967,2,22,78,0,1,655,1640,26,633,1562,26,25.192307692307693,<=30,SA,Home,Upto 2014
HR Lance,SA,Pace,1970-02-05,Durban,South Africa,1970,2,22,54,0,1,686,1387,21,664,1333,21,32.666666666666664,>30,SA,Home,Upto 2014
HR Lance,SA,Pace,1970-02-19,Johannesburg,South Africa,1970,1,5,18,0,1,766,1822,28,761,1804,28,27.357142857142858,<=30,SA,Home,Upto 2014
HR Lance,SA,Pace,1970-03-05,Gqeberha,South Africa,1970,2,50,108,1,1,887,1974,33,837,1866,32,26.87878787878788,<=30,SA,Home,Upto 2014
HSTL Hendry,AUS,Pace,1921-05-28,Nottingham,England,1921,1,18,54,2,1,251,658,20,233,604,18,12.55,<=30,ENG,Away,Upto 2014
HSTL Hendry,AUS,Pace,1921-06-11,Lord's,England,1921,1,15,24,0,1,453,764,17,438,740,17,26.647058823529413,<=30,ENG,Away,Upto 2014
HSTL Hendry,AUS,Pace,1921-07-02,Leeds,England,1921,1,16,60,0,1,408,703,13,392,643,13,31.384615384615383,>30,ENG,Away,Upto 2014
HSTL Hendry,AUS,Pace,1921-07-23,Manchester,England,1921,2,86,174,1,1,286,546,3,200,372,2,95.33333333333333,>30,ENG,Away,Upto 2014
HSTL Hendry,AUS,Pace,1921-11-05,Durban,South Africa,1921,2,41,66,2,1,645,1385,24,604,1319,22,26.875,<=30,SA,Away,Upto 2014
HSTL Hendry,AUS,Pace,1921-11-12,Johannesburg,South Africa,1921,2,95,210,0,1,791,1453,15,696,1243,15,52.733333333333334,>30,SA,Away,Upto 2014
HSTL Hendry,AUS,Pace,1924-12-19,Sydney,Australia,1924,2,41,127,3,1,590,1278,15,549,1151,12,39.333333333333336,>30,AUS,Home,Upto 2014
HSTL Hendry,AUS,Pace,1928-11-30,Brisbane,Australia,1928,2,99,222,1,1,486,1018,12,387,796,11,40.5,>30,AUS,Home,Upto 2014
HSTL Hendry,AUS,Pace,1928-12-14,Sydney,Australia,1928,2,56,157,3,1,483,1249,14,427,1092,11,34.5,>30,AUS,Home,Upto 2014
HSTL Hendry,AUS,Pace,1928-12-29,Melbourne,Australia,1928,2,68,258,1,1,730,1882,14,662,1624,13,52.142857142857146,>30,AUS,Home,Upto 2014
HSTL Hendry,AUS,Pace,1929-02-01,Adelaide,Australia,1929,2,105,354,3,1,620,1906,12,515,1552,9,51.666666666666664,>30,AUS,Home,Upto 2014
HT Dani,IND,Spin,1952-11-13,Brabourne,India,1952,2,19,60,1,1,433,1202,15,414,1142,14,28.866666666666667,<=30,IND,Home,Upto 2014
HT Davis,NZ,Pace,1994-06-02,Nottingham,England,1994,1,93,126,1,1,704,1313,20,611,1187,19,35.2,>30,ENG,Away,Upto 2014
HT Davis,NZ,Pace,1997-02-14,Christchurch,New Zealand,1997,2,93,216,1,1,695,1595,19,602,1379,18,36.578947368421055,>30,NZ,Home,Upto 2014
HT Davis,NZ,Pace,1997-03-07,Dunedin,New Zealand,1997,2,113,246,4,1,739,1295,21,626,1049,17,35.19047619047619,>30,NZ,Home,Upto 2014
HT Davis,NZ,Pace,1997-03-14,Hamilton,New Zealand,1997,2,98,224,6,1,399,988,18,301,764,12,22.166666666666668,<=30,NZ,Home,Upto 2014
HT Davis,NZ,Pace,1997-09-18,Harare,Zimbabwe,1997,2,102,198,5,1,808,1794,25,706,1596,20,32.32,>30,ZIM,Away,Upto 2014
HT Tector,IRE,Spin,2023-04-04,Mirpur,Bangladesh,2023,2,26,24,0,1,595,1200,23,569,1176,23,25.869565217391305,<=30,BAN,Away,After 1965
HT Tector,IRE,Spin,2023-04-16,Galle,Sri Lanka,2023,1,12,12,0,1,643,1027,18,631,1015,18,35.72222222222222,>30,SL,Away,After 1965
HT Tector,IRE,Spin,2023-04-24,Galle,Sri Lanka,2023,1,45,48,0,1,963,1611,14,918,1563,14,68.78571428571429,>30,SL,Away,After 1965
HT Tector,IRE,Spin,2024-02-28,Tolerance Oval,UAE,2024,1,2,6,0,1,298,624,8,296,618,8,37.25,>30,UAE,Away,After 1965
HV Baumgartner,SA,Spin,1913-12-13,Durban,South Africa,1913,1,99,166,2,1,212,468,8,113,302,6,26.5,<=30,SA,Home,Upto 2014
HV Hordern,AUS,Spin,1911-02-17,Melbourne,Australia,1911,2,105,176,8,1,844,1322,23,739,1146,15,36.69565217391305,>30,AUS,Home,Upto 2014
HV Hordern,AUS,Spin,1911-03-03,Sydney,Australia,1911,2,190,307,6,1,638,1067,19,448,760,13,33.578947368421055,>30,AUS,Home,Upto 2014
HV Hordern,AUS,Spin,1911-12-15,Sydney,Australia,1911,2,175,416,12,1,459,926,15,284,510,3,30.6,>30,AUS,Home,Upto 2014
HV Hordern,AUS,Spin,1911-12-30,Melbourne,Australia,1911,2,132,241,4,1,222,429,6,90,188,2,37.0,>30,AUS,Home,Upto 2014
HV Hordern,AUS,Spin,1912-01-12,Adelaide,Australia,1912,2,175,349,3,1,429,843,6,254,494,3,71.5,>30,AUS,Home,Upto 2014
HV Hordern,AUS,Spin,1912-02-09,Melbourne,Australia,1912,1,137,287,3,1,357,761,7,220,474,4,51.0,>30,AUS,Home,Upto 2014
HV Hordern,AUS,Spin,1912-02-23,Sydney,Australia,1912,2,161,372,10,1,473,1119,22,312,747,12,21.5,<=30,AUS,Home,Upto 2014
HW Chapman,SA,Spin,1914-02-14,Durban,South Africa,1914,1,20,24,0,1,337,984,14,317,960,14,24.071428571428573,<=30,SA,Home,Upto 2014
HW Chapman,SA,Spin,1921-11-05,Durban,South Africa,1921,2,84,102,1,1,340,702,10,256,600,9,34.0,>30,SA,Home,Upto 2014
HW Taylor,SA,Spin,1912-07-15,Lord's,England,1912,1,12,12,0,1,501,1026,19,489,1014,19,26.36842105263158,<=30,ENG,Away,Upto 2014
HW Taylor,SA,Spin,1912-08-05,Nottingham,England,1912,1,19,72,0,1,399,1038,15,380,966,15,26.6,<=30,ENG,Away,Upto 2014
HW Taylor,SA,Spin,1913-12-13,Durban,South Africa,1913,1,7,36,0,1,212,468,8,205,432,8,26.5,<=30,SA,Home,Upto 2014
HW Taylor,SA,Spin,1913-12-26,Johannesburg,South Africa,1913,1,27,48,0,1,283,660,6,256,612,6,47.166666666666664,>30,SA,Home,Upto 2014
HW Taylor,SA,Spin,1914-01-01,Johannesburg,South Africa,1914,2,53,96,4,1,388,857,18,335,761,14,21.555555555555557,<=30,SA,Home,Upto 2014
HW Taylor,SA,Spin,1914-02-27,Gqeberha,South Africa,1914,1,5,6,0,1,377,889,10,372,883,10,37.7,>30,SA,Home,Upto 2014
HW Taylor,SA,Spin,1921-11-26,Cape Town,South Africa,1921,1,12,30,0,1,400,850,17,388,820,17,23.529411764705884,<=30,SA,Home,Upto 2014
HW Taylor,SA,Spin,1923-02-09,Johannesburg,South Africa,1923,1,0,12,0,1,356,732,8,356,720,8,44.5,>30,SA,Home,Upto 2014
HW Taylor,SA,Spin,1928-01-21,Durban,South Africa,1928,1,8,12,0,1,719,1581,22,711,1569,22,32.68181818181818,>30,SA,Home,Upto 2014
HW Taylor,SA,Spin,1931-02-21,Durban,South Africa,1931,1,13,18,1,1,436,1147,20,423,1129,19,21.8,<=30,SA,Home,Upto 2014
HWR Cartwright,AUS,Pace,2017-01-03,Sydney,Australia,2017,1,15,24,0,1,587,1109,15,572,1085,15,39.13333333333333,>30,AUS,Home,After 1965
HWR Cartwright,AUS,Pace,2017-09-04,Chattogram,Bangladesh,2017,1,16,30,0,1,189,383,7,173,353,7,27.0,<=30,BAN,Away,After 1965
Habibul Bashar,BAN,Spin,2000-11-10,Dhaka,Bangladesh,2000,1,39,48,0,1,558,1251,19,519,1203,19,29.36842105263158,<=30,BAN,Home,Upto 2014
Habibul Bashar,BAN,Spin,2001-09-06,Colombo (SSC),Sri Lanka,2001,1,34,30,0,1,422,724,14,388,694,14,30.142857142857142,>30,SL,Away,Upto 2014
Habibul Bashar,BAN,Spin,2002-07-21,Colombo (PSS),Sri Lanka,2002,1,43,54,0,1,331,649,16,288,595,16,20.6875,<=30,SL,Away,Upto 2014
Habibul Bashar,BAN,Spin,2002-07-28,Colombo (SSC),Sri Lanka,2002,2,38,48,0,1,450,838,15,412,790,15,30.0,<=30,SL,Away,Upto 2014
Habibul Bashar,BAN,Spin,2002-10-25,Potchefstroom,South Africa,2002,1,2,6,0,1,189,281,2,187,275,2,94.5,>30,SA,Away,Upto 2014
Habibul Bashar,BAN,Spin,2003-04-24,Chattogram,Bangladesh,2003,1,38,42,0,1,336,618,11,298,576,11,30.545454545454547,>30,BAN,Home,Upto 2014
Habibul Bashar,BAN,Spin,2003-07-18,Darwin,Australia,2003,1,1,6,0,1,161,283,8,160,277,8,20.125,<=30,AUS,Away,Upto 2014
Habibul Bashar,BAN,Spin,2007-06-25,Colombo (SSC),Sri Lanka,2007,1,22,48,0,1,605,1005,14,583,957,14,43.214285714285715,>30,SL,Away,Upto 2014
Hanif Mohammad,PAK,Spin,1952-12-12,Eden Gardens,India,1952,1,10,12,0,1,455,1230,13,445,1218,13,35.0,>30,IND,Away,Upto 2014
Hanif Mohammad,PAK,Spin,1955-01-01,Dhaka,Bangladesh,1955,1,15,30,0,1,438,1378,15,423,1348,15,29.2,<=30,BAN,Away,Upto 2014
Hanif Mohammad,PAK,Spin,1955-01-29,Lahore,Pakistan,1955,1,9,18,0,1,591,2024,18,582,2006,18,32.833333333333336,>30,PAK,Home,Upto 2014
Hanif Mohammad,PAK,Spin,1955-02-12,Peshawar,Pakistan,1955,1,1,24,1,1,400,1761,19,399,1737,18,21.05263157894737,<=30,PAK,Home,Upto 2014
Hanif Mohammad,PAK,Spin,1955-02-26,Karachi,Pakistan,1955,1,18,36,0,1,327,894,7,309,858,7,46.714285714285715,>30,PAK,Home,Upto 2014
Hanif Mohammad,PAK,Spin,1955-11-07,Dhaka,Bangladesh,1955,1,1,6,0,1,131,558,6,130,552,6,21.833333333333332,<=30,BAN,Away,Upto 2014
Hanif Mohammad,PAK,Spin,1958-01-17,Bridgetown,West Indies,1958,1,10,18,0,1,679,1898,11,669,1880,11,61.72727272727273,>30,WI,Away,Upto 2014
Hanif Mohammad,PAK,Spin,1958-02-26,Kingston,West Indies,1958,1,11,12,0,1,450,846,3,439,834,3,150.0,>30,WI,Away,Upto 2014
Hanif Mohammad,PAK,Spin,1960-12-30,Eden Gardens,India,1960,1,6,6,0,1,295,842,11,289,836,11,26.818181818181817,<=30,IND,Away,Upto 2014
Hanif Mohammad,PAK,Spin,1962-01-19,Dhaka,Bangladesh,1962,1,8,12,0,1,862,2494,25,854,2482,25,34.48,>30,BAN,Away,Upto 2014
Hanif Mohammad,PAK,Spin,1967-08-24,The Oval,England,1967,1,4,2,0,1,475,1075,13,471,1073,13,36.53846153846154,>30,ENG,Away,Upto 2014
Hanif Mohammad,PAK,Spin,1969-02-28,Dhaka,Bangladesh,1969,1,1,18,0,1,397,1246,15,396,1228,15,26.466666666666665,<=30,BAN,Away,Upto 2014
Hanif Mohammad,PAK,Spin,1969-10-24,Karachi,Pakistan,1969,1,1,12,0,1,665,1813,26,664,1801,26,25.576923076923077,<=30,PAK,Home,Upto 2014
Hanumant Singh,IND,Spin,1965-02-27,Chennai,India,1965,1,19,36,0,1,616,1705,17,597,1669,17,36.23529411764706,>30,IND,Home,Upto 2014
Hanumant Singh,IND,Spin,1965-03-19,Delhi,India,1965,1,5,12,0,1,716,1840,21,711,1828,21,34.095238095238095,>30,IND,Home,Upto 2014
Hanumant Singh,IND,Spin,1967-06-08,Leeds,England,1967,1,27,18,0,1,861,2089,19,834,2071,19,45.31578947368421,>30,ENG,Away,Upto 2014
Harbhajan Singh,IND,Spin,1998-03-25,Bengaluru,India,1998,2,136,174,2,1,817,1511,22,681,1337,20,37.13636363636363,>30,IND,Home,Upto 2014
Harbhajan Singh,IND,Spin,1998-10-07,Harare,Zimbabwe,1998,2,106,210,5,1,303,670,13,197,460,8,23.307692307692307,<=30,ZIM,Away,Upto 2014
Harbhajan Singh,IND,Spin,1998-12-26,Wellington,New Zealand,1998,2,72,180,0,1,442,922,12,370,742,12,36.833333333333336,>30,NZ,Away,Upto 2014
Harbhajan Singh,IND,Spin,1999-02-04,Delhi,India,1999,2,81,210,3,1,634,1395,31,553,1185,28,20.451612903225808,<=30,IND,Home,Upto 2014
Harbhajan Singh,IND,Spin,1999-02-16,Eden Gardens,India,1999,2,92,168,2,1,375,758,8,283,590,6,46.875,>30,IND,Home,Upto 2014
Harbhajan Singh,IND,Spin,1999-02-24,Colombo (SSC),Sri Lanka,1999,1,127,240,3,1,484,1002,12,357,762,9,40.333333333333336,>30,SL,Away,Upto 2014
Harbhajan Singh,IND,Spin,1999-10-22,Kanpur,India,1999,2,63,192,4,1,568,1375,24,505,1183,20,23.666666666666668,<=30,IND,Home,Upto 2014
Harbhajan Singh,IND,Spin,1999-10-29,Ahmedabad,India,1999,2,133,340,2,1,599,1348,12,466,1008,10,49.916666666666664,>30,IND,Home,Upto 2014
Harbhajan Singh,IND,Spin,2001-02-27,Wankhede,India,2001,2,132,180,4,1,392,686,14,260,506,10,28.0,<=30,IND,Home,Upto 2014
Harbhajan Singh,IND,Spin,2001-03-11,Eden Gardens,India,2001,2,196,410,13,1,625,1131,20,429,721,7,31.25,>30,IND,Home,Upto 2014
Harbhajan Singh,IND,Spin,2001-03-18,Chennai,India,2001,2,217,481,15,1,924,1783,26,707,1302,11,35.53846153846154,>30,IND,Home,Upto 2014
Harbhajan Singh,IND,Spin,2001-06-07,Bulawayo,Zimbabwe,2001,2,137,352,3,1,315,644,5,178,292,2,63.0,>30,ZIM,Away,Upto 2014
Harbhajan Singh,IND,Spin,2001-06-15,Harare,Zimbabwe,2001,2,96,270,5,1,185,428,8,89,158,3,23.125,<=30,ZIM,Away,Upto 2014
Harbhajan Singh,IND,Spin,2001-08-14,Galle,Sri Lanka,2001,1,69,198,1,1,169,548,10,100,350,9,16.9,<=30,SL,Away,Upto 2014
Harbhajan Singh,IND,Spin,2001-08-22,Kandy,Sri Lanka,2001,2,38,69,1,1,215,370,5,177,301,4,43.0,>30,SL,Away,Upto 2014
Harbhajan Singh,IND,Spin,2001-08-29,Colombo (SSC),Sri Lanka,2001,1,185,321,2,1,579,1257,16,394,936,14,36.1875,>30,SL,Away,Upto 2014
Harbhajan Singh,IND,Spin,2001-11-16,Gqeberha,South Africa,2001,2,168,324,3,1,330,708,5,162,384,2,66.0,>30,SA,Away,Upto 2014
Harbhajan Singh,IND,Spin,2001-12-03,Mohali,India,2001,2,110,261,7,1,507,1147,21,397,886,14,24.142857142857142,<=30,IND,Home,Upto 2014
Harbhajan Singh,IND,Spin,2001-12-11,Ahmedabad,India,2001,2,149,395,6,1,727,1868,25,578,1473,19,29.08,<=30,IND,Home,Upto 2014
Harbhajan Singh,IND,Spin,2001-12-19,Bengaluru,India,2001,2,60,163,0,1,308,742,5,248,579,5,61.6,>30,IND,Home,Upto 2014
Harbhajan Singh,IND,Spin,2002-02-21,Nagpur,India,2002,2,104,346,4,1,556,1425,18,452,1079,14,30.88888888888889,>30,IND,Home,Upto 2014
Harbhajan Singh,IND,Spin,2002-02-28,Delhi,India,2002,2,132,353,8,1,467,1232,22,335,879,14,21.227272727272727,<=30,IND,Home,Upto 2014
Harbhajan Singh,IND,Spin,2002-04-19,Port of Spain,West Indies,2002,2,117,299,3,1,184,491,4,67,192,1,46.0,>30,WI,Away,Upto 2014
Harbhajan Singh,IND,Spin,2002-05-02,Bridgetown,West Indies,2002,2,91,211,3,1,125,277,5,34,66,2,25.0,<=30,WI,Away,Upto 2014
Harbhajan Singh,IND,Spin,2002-05-18,Kingston,West Indies,2002,2,180,332,8,1,212,410,9,32,78,1,23.555555555555557,<=30,WI,Away,Upto 2014
Harbhajan Singh,IND,Spin,2002-08-08,Nottingham,England,2002,1,175,270,3,1,350,564,6,175,294,3,58.333333333333336,>30,ENG,Away,Upto 2014
Harbhajan Singh,IND,Spin,2002-08-22,Leeds,England,2002,2,96,270,4,1,393,893,12,297,623,8,32.75,>30,ENG,Away,Upto 2014
Harbhajan Singh,IND,Spin,2002-09-05,The Oval,England,2002,2,139,274,5,1,410,922,9,271,648,4,45.55555555555556,>30,ENG,Away,Upto 2014
Harbhajan Singh,IND,Spin,2002-10-09,Wankhede,India,2002,2,85,297,8,1,416,1045,19,331,748,11,21.894736842105264,<=30,IND,Home,Upto 2014
Harbhajan Singh,IND,Spin,2002-10-17,Chennai,India,2002,2,135,354,7,1,464,965,17,329,611,10,27.294117647058822,<=30,IND,Home,Upto 2014
Harbhajan Singh,IND,Spin,2002-10-30,Eden Gardens,India,2002,1,115,345,5,1,592,1269,12,477,924,7,49.333333333333336,>30,IND,Home,Upto 2014
Harbhajan Singh,IND,Spin,2002-12-12,Wellington,New Zealand,2002,2,35,114,2,1,35,114,2,0,0,0,17.5,<=30,NZ,Away,Upto 2014
Harbhajan Singh,IND,Spin,2002-12-19,Hamilton,New Zealand,2002,2,59,102,3,1,59,102,3,0,0,0,19.666666666666668,<=30,NZ,Away,Upto 2014
Harbhajan Singh,IND,Spin,2003-10-08,Ahmedabad,India,2003,2,151,444,4,1,719,1566,18,568,1122,14,39.94444444444444,>30,IND,Home,Upto 2014
Harbhajan Singh,IND,Spin,2003-10-16,Mohali,India,2003,1,149,288,2,1,664,1623,9,515,1335,7,73.77777777777777,>30,IND,Home,Upto 2014
Harbhajan Singh,IND,Spin,2003-12-04,Brisbane,Australia,2003,2,169,210,1,1,333,445,5,164,235,4,66.6,>30,AUS,Away,Upto 2014
Harbhajan Singh,IND,Spin,2004-10-06,Bengaluru,India,2004,2,224,427,11,1,685,1243,20,461,816,9,34.25,>30,IND,Home,Upto 2014
Harbhajan Singh,IND,Spin,2004-10-14,Chennai,India,2004,2,198,455,5,1,557,1169,24,359,714,19,23.208333333333332,<=30,IND,Home,Upto 2014
Harbhajan Singh,IND,Spin,2004-11-03,Wankhede,India,2004,2,82,191,5,1,365,706,29,283,515,24,12.586206896551724,<=30,IND,Home,Upto 2014
Harbhajan Singh,IND,Spin,2004-11-20,Kanpur,India,2004,2,166,364,4,1,586,1360,13,420,996,9,45.07692307692308,>30,IND,Home,Upto 2014
Harbhajan Singh,IND,Spin,2004-11-28,Eden Gardens,India,2004,2,141,309,9,1,470,978,15,329,669,6,31.333333333333332,>30,IND,Home,Upto 2014
Harbhajan Singh,IND,Spin,2004-12-10,Dhaka,Bangladesh,2004,2,67,126,1,1,324,603,8,257,477,7,40.5,>30,BAN,Away,Upto 2014
Harbhajan Singh,IND,Spin,2004-12-17,Chattogram,Bangladesh,2004,2,98,160,3,1,442,811,15,344,651,12,29.466666666666665,<=30,BAN,Away,Upto 2014
Harbhajan Singh,IND,Spin,2005-03-16,Eden Gardens,India,2005,2,145,363,4,1,693,1450,23,548,1087,19,30.130434782608695,>30,IND,Home,Upto 2014
Harbhajan Singh,IND,Spin,2005-03-24,Bengaluru,India,2005,2,187,347,6,1,834,1659,22,647,1312,16,37.90909090909091,>30,IND,Home,Upto 2014
Harbhajan Singh,IND,Spin,2005-09-13,Bulawayo,Zimbabwe,2005,2,114,251,4,1,509,995,11,395,744,7,46.27272727272727,>30,ZIM,Away,Upto 2014
Harbhajan Singh,IND,Spin,2005-09-20,Harare,Zimbabwe,2005,2,72,96,2,1,178,258,3,106,162,1,59.333333333333336,>30,ZIM,Away,Upto 2014
Harbhajan Singh,IND,Spin,2005-12-02,Chennai,India,2005,1,34,54,0,1,150,362,6,116,308,6,25.0,<=30,IND,Home,Upto 2014
Harbhajan Singh,IND,Spin,2005-12-10,Delhi,India,2005,2,137,245,4,1,668,1353,25,531,1108,21,26.72,<=30,IND,Home,Upto 2014
Harbhajan Singh,IND,Spin,2005-12-18,Ahmedabad,India,2005,2,141,320,10,1,765,1419,29,624,1099,19,26.379310344827587,<=30,IND,Home,Upto 2014
Harbhajan Singh,IND,Spin,2006-01-13,Lahore,Pakistan,2006,1,176,204,0,1,588,687,2,412,483,2,294.0,>30,PAK,Away,Upto 2014
Harbhajan Singh,IND,Spin,2006-01-21,Faisalabad,Pakistan,2006,2,179,282,0,1,770,1194,9,591,912,9,85.55555555555556,>30,PAK,Away,Upto 2014
Harbhajan Singh,IND,Spin,2006-03-01,Nagpur,India,2006,2,172,384,2,1,588,1296,7,416,912,5,84.0,>30,IND,Home,Upto 2014
Harbhajan Singh,IND,Spin,2006-03-09,Mohali,India,2006,2,83,210,1,1,492,1055,19,409,845,18,25.894736842105264,<=30,IND,Home,Upto 2014
Harbhajan Singh,IND,Spin,2006-03-18,Wankhede,India,2006,2,129,298,5,1,517,1300,19,388,1002,14,27.210526315789473,<=30,IND,Home,Upto 2014
Harbhajan Singh,IND,Spin,2006-06-22,Basseterre,West Indies,2006,2,186,306,6,1,722,1248,13,536,942,7,55.53846153846154,>30,WI,Away,Upto 2014
Harbhajan Singh,IND,Spin,2006-06-30,Kingston,West Indies,2006,2,78,123,5,1,275,517,14,197,394,9,19.642857142857142,<=30,WI,Away,Upto 2014
Harbhajan Singh,IND,Spin,2007-11-22,Delhi,India,2007,2,93,192,3,1,425,937,15,332,745,12,28.333333333333332,<=30,IND,Home,Upto 2014
Harbhajan Singh,IND,Spin,2007-11-30,Eden Gardens,India,2007,2,189,461,5,1,851,1606,18,662,1145,13,47.27777777777778,>30,IND,Home,Upto 2014
Harbhajan Singh,IND,Spin,2007-12-08,Bengaluru,India,2007,2,159,264,2,1,712,1214,14,553,950,12,50.857142857142854,>30,IND,Home,Upto 2014
Harbhajan Singh,IND,Spin,2007-12-26,Melbourne,Australia,2007,2,162,276,3,1,518,912,15,356,636,12,34.53333333333333,>30,AUS,Away,Upto 2014
Harbhajan Singh,IND,Spin,2008-01-02,Sydney,Australia,2008,2,200,360,4,1,764,1280,20,564,920,16,38.2,>30,AUS,Away,Upto 2014
Harbhajan Singh,IND,Spin,2008-01-24,Adelaide,Australia,2008,1,128,288,1,1,579,1086,9,451,798,8,64.33333333333333,>30,AUS,Away,Upto 2014
Harbhajan Singh,IND,Spin,2008-03-26,Chennai,India,2008,2,265,473,8,1,758,1458,16,493,985,8,47.375,>30,IND,Home,Upto 2014
Harbhajan Singh,IND,Spin,2008-04-03,Ahmedabad,India,2008,1,135,240,4,1,281,588,6,146,348,2,46.833333333333336,>30,IND,Home,Upto 2014
Harbhajan Singh,IND,Spin,2008-04-11,Kanpur,India,2008,2,96,324,7,1,399,844,18,303,520,11,22.166666666666668,<=30,IND,Home,Upto 2014
Harbhajan Singh,IND,Spin,2008-07-23,Colombo (SSC),Sri Lanka,2008,1,149,258,2,1,529,1031,21,380,773,19,25.19047619047619,<=30,SL,Away,Upto 2014
Harbhajan Singh,IND,Spin,2008-07-31,Galle,Sri Lanka,2008,2,153,327,10,1,684,1286,30,531,959,20,22.8,<=30,SL,Away,Upto 2014
Harbhajan Singh,IND,Spin,2008-08-08,Colombo (PSS),Sri Lanka,2008,2,148,327,4,1,613,1402,20,465,1075,16,30.65,>30,SL,Away,Upto 2014
Harbhajan Singh,IND,Spin,2008-10-09,Bengaluru,India,2008,2,179,408,3,1,536,1200,6,357,792,3,89.33333333333333,>30,IND,Home,Upto 2014
Harbhajan Singh,IND,Spin,2008-10-17,Mohali,India,2008,2,96,294,5,1,362,764,15,266,470,10,24.133333333333333,<=30,IND,Home,Upto 2014
Harbhajan Singh,IND,Spin,2008-11-06,Nagpur,India,2008,2,158,332,7,1,751,1259,24,593,927,17,31.291666666666668,>30,IND,Home,Upto 2014
Harbhajan Singh,IND,Spin,2008-12-11,Chennai,India,2008,2,187,408,4,1,742,1371,17,555,963,13,43.64705882352941,>30,IND,Home,Upto 2014
Harbhajan Singh,IND,Spin,2008-12-19,Mohali,India,2008,2,93,191,4,1,508,989,13,415,798,9,39.07692307692308,>30,IND,Home,Upto 2014
Harbhajan Singh,IND,Spin,2009-03-18,Hamilton,New Zealand,2009,2,120,300,7,1,359,787,15,239,487,8,23.933333333333334,<=30,NZ,Away,Upto 2014
Harbhajan Singh,IND,Spin,2009-03-26,Napier,New Zealand,2009,1,120,250,2,1,685,1306,9,565,1056,7,76.11111111111111,>30,NZ,Away,Upto 2014
Harbhajan Singh,IND,Spin,2009-04-03,Wellington,New Zealand,2009,2,102,336,7,1,383,840,12,281,504,5,31.916666666666668,>30,NZ,Away,Upto 2014
Harbhajan Singh,IND,Spin,2009-11-16,Ahmedabad,India,2009,1,189,292,2,1,904,1575,9,715,1283,7,100.44444444444444,>30,IND,Home,Upto 2014
Harbhajan Singh,IND,Spin,2009-11-24,Kanpur,India,2009,2,152,258,5,1,718,1197,20,566,939,15,35.9,>30,IND,Home,Upto 2014
Harbhajan Singh,IND,Spin,2009-12-02,Brabourne,India,2009,2,192,400,6,1,870,1403,18,678,1003,12,48.333333333333336,>30,IND,Home,Upto 2014
Harbhajan Singh,IND,Spin,2010-01-24,Mirpur,Bangladesh,2010,2,123,269,2,1,600,1045,11,477,776,9,54.54545454545455,>30,BAN,Away,Upto 2014
Harbhajan Singh,IND,Spin,2010-02-06,Nagpur,India,2010,1,166,276,2,1,517,1080,7,351,804,5,73.85714285714286,>30,IND,Home,Upto 2014
Harbhajan Singh,IND,Spin,2010-02-14,Eden Gardens,India,2010,2,123,435,8,1,547,1263,14,424,828,6,39.07142857142857,>30,IND,Home,Upto 2014
Harbhajan Singh,IND,Spin,2010-07-18,Galle,Sri Lanka,2010,2,122,193,0,1,643,1145,10,521,952,10,64.3,>30,SL,Away,Upto 2014
Harbhajan Singh,IND,Spin,2010-07-26,Colombo (SSC),Sri Lanka,2010,2,182,334,2,1,926,1870,14,744,1536,12,66.14285714285714,>30,SL,Away,Upto 2014
Harbhajan Singh,IND,Spin,2010-10-01,Mohali,India,2010,2,154,432,5,1,557,1225,12,403,793,7,46.416666666666664,>30,IND,Home,Upto 2014
Harbhajan Singh,IND,Spin,2010-10-09,Bengaluru,India,2010,2,211,384,6,1,696,1271,17,485,887,11,40.94117647058823,>30,IND,Home,Upto 2014
Harbhajan Singh,IND,Spin,2010-11-04,Ahmedabad,India,2010,1,112,258,1,1,781,1719,18,669,1461,17,43.388888888888886,>30,IND,Home,Upto 2014
Harbhajan Singh,IND,Spin,2010-11-12,Hyderabad,India,2010,2,193,441,5,1,691,1414,15,498,973,10,46.06666666666667,>30,IND,Home,Upto 2014
Harbhajan Singh,IND,Spin,2010-11-20,Nagpur,India,2010,2,115,216,4,1,493,909,15,378,693,11,32.86666666666667,>30,IND,Home,Upto 2014
Harbhajan Singh,IND,Spin,2010-12-16,Centurion,South Africa,2010,1,169,216,2,1,391,504,4,222,288,2,97.75,>30,SA,Away,Upto 2014
Harbhajan Singh,IND,Spin,2010-12-26,Durban,South Africa,2010,2,80,218,6,1,148,356,7,68,138,1,21.142857142857142,<=30,SA,Away,Upto 2014
Harbhajan Singh,IND,Spin,2011-01-02,Cape Town,South Africa,2011,2,195,390,7,1,346,804,9,151,414,2,38.44444444444444,>30,SA,Away,Upto 2014
Harbhajan Singh,IND,Spin,2011-06-20,Kingston,West Indies,2011,2,105,210,3,1,367,624,15,262,414,12,24.466666666666665,<=30,WI,Away,Upto 2014
Harbhajan Singh,IND,Spin,2011-06-28,Bridgetown,West Indies,2011,2,73,198,2,1,187,468,5,114,270,3,37.4,>30,WI,Away,Upto 2014
Harbhajan Singh,IND,Spin,2011-07-06,Roseau,West Indies,2011,2,101,342,6,1,478,1095,12,377,753,6,39.833333333333336,>30,WI,Away,Upto 2014
Harbhajan Singh,IND,Spin,2011-07-21,Lord's,England,2011,2,218,336,1,1,415,658,4,197,322,3,103.75,>30,ENG,Away,Upto 2014
Harbhajan Singh,IND,Spin,2011-07-29,Nottingham,England,2011,2,69,82,1,1,280,322,2,211,240,1,140.0,>30,ENG,Away,Upto 2014
Harbhajan Singh,IND,Spin,2012-11-23,Wankhede,India,2012,2,84,138,2,1,747,1449,28,663,1311,26,26.678571428571427,<=30,IND,Home,Upto 2014
Harbhajan Singh,IND,Spin,2013-02-22,Chennai,India,2013,2,142,312,3,1,771,1539,24,629,1227,21,32.125,>30,IND,Home,Upto 2014
Harbhajan Singh,IND,Spin,2013-03-02,Hyderabad,India,2013,2,62,192,2,1,504,1093,21,442,901,19,24.0,<=30,IND,Home,Upto 2014
Harbhajan Singh,IND,Spin,2015-06-10,Fatullah,Bangladesh,2015,2,75,137,3,1,528,806,14,453,669,11,37.714285714285715,>30,BAN,Away,After 1965
Harbhajan Singh,IND,Spin,2015-08-12,Galle,Sri Lanka,2015,2,90,150,1,1,627,1167,31,537,1017,30,20.225806451612904,<=30,SL,Away,After 1965
Haris Rauf,PAK,Pace,2022-12-01,Rawalpindi,Pakistan,2022,1,78,78,1,1,786,1181,21,708,1103,20,37.42857142857143,>30,PAK,Home,After 1965
Haris Sohail,PAK,Spin,2017-09-28,Abu Dhabi,UAE,2017,2,58,108,2,1,623,1568,26,565,1460,24,23.96153846153846,<=30,UAE,Away,After 1965
Haris Sohail,PAK,Spin,2017-10-06,Dubai (DICS),UAE,2017,2,35,90,3,1,608,1153,24,573,1063,21,25.333333333333332,<=30,UAE,Away,After 1965
Haris Sohail,PAK,Spin,2018-05-11,Dublin (Malahide),Ireland,2018,1,1,6,0,1,106,282,4,105,276,4,26.5,<=30,IRE,Away,After 1965
Haris Sohail,PAK,Spin,2018-10-07,Dubai (DICS),UAE,2018,1,16,54,0,1,793,1735,21,777,1681,21,37.76190476190476,>30,UAE,Away,After 1965
Haris Sohail,PAK,Spin,2018-11-16,Abu Dhabi,UAE,2018,2,23,90,2,1,468,1015,21,445,925,19,22.285714285714285,<=30,UAE,Away,After 1965
Haris Sohail,PAK,Spin,2018-11-24,Dubai (DICS),UAE,2018,1,16,24,0,1,473,968,16,457,944,16,29.5625,<=30,UAE,Away,After 1965
Haris Sohail,PAK,Spin,2018-12-03,Abu Dhabi,UAE,2018,1,7,12,0,1,612,1532,24,605,1520,24,25.5,<=30,UAE,Away,After 1965
Haris Sohail,PAK,Spin,2019-11-21,Brisbane,Australia,2019,1,75,114,2,1,515,790,8,440,676,6,64.375,>30,AUS,Away,After 1965
Haris Sohail,PAK,Spin,2019-12-11,Rawalpindi,Pakistan,2019,1,12,18,0,1,170,252,0,158,234,0,inf,>30,PAK,Home,After 1965
Haris Sohail,PAK,Spin,2019-12-19,Karachi,Pakistan,2019,2,21,42,2,1,548,873,9,527,831,7,60.888888888888886,>30,PAK,Home,After 1965
Haris Sohail,PAK,Spin,2020-02-07,Rawalpindi,Pakistan,2020,1,11,36,2,1,309,548,8,298,512,6,38.625,>30,PAK,Home,After 1965
Haris Sohail,PAK,Spin,2020-12-26,Mount Maunganui,New Zealand,2020,1,17,30,0,1,211,453,5,194,423,5,42.2,>30,NZ,Away,After 1965
Haris Sohail,PAK,Spin,2021-01-03,Christchurch,New Zealand,2021,1,2,6,0,1,177,216,1,175,210,1,177.0,>30,NZ,Away,After 1965
Haroon Rasheed,PAK,Pace,1978-01-18,Karachi,Pakistan,1978,1,3,8,0,1,226,792,5,223,784,5,45.2,>30,PAK,Home,Upto 2014
Harshit Rana,IND,Spin,2024-11-22,Perth,Australia,2024,2,117,174,4,1,374,651,9,257,477,5,41.55555555555556,>30,AUS,Away,After 1965
Harshit Rana,IND,Spin,2024-12-06,Adelaide,Australia,2024,1,86,96,0,1,178,252,2,92,156,2,89.0,>30,AUS,Away,After 1965
Harvinder Singh,IND,Pace,1998-03-06,Chennai,India,1998,2,37,78,1,1,310,705,5,273,627,4,62.0,>30,IND,Home,Upto 2014
Harvinder Singh,IND,Pace,1998-03-25,Bengaluru,India,1998,2,61,60,1,1,319,612,10,258,552,9,31.9,>30,IND,Home,Upto 2014
Harvinder Singh,IND,Pace,2001-08-22,Kandy,Sri Lanka,2001,2,87,135,2,1,745,1357,27,658,1222,25,27.59259259259259,<=30,SL,Away,Upto 2014
Hasan Ali,PAK,Pace,2017-05-10,Roseau,West Indies,2017,2,55,222,3,1,472,1494,20,417,1272,17,23.6,<=30,WI,Away,After 1965
Hasan Ali,PAK,Pace,2017-09-28,Abu Dhabi,UAE,2017,2,109,205,3,1,437,1023,13,328,818,10,33.61538461538461,>30,UAE,Away,After 1965
Hasan Ali,PAK,Pace,2018-05-24,Lord's,England,2018,2,109,206,4,1,631,1332,28,522,1126,24,22.535714285714285,<=30,ENG,Away,After 1965
Hasan Ali,PAK,Pace,2018-06-01,Leeds,England,2018,1,82,122,2,1,552,1035,26,470,913,24,21.23076923076923,<=30,ENG,Away,After 1965
Hasan Ali,PAK,Pace,2018-11-16,Abu Dhabi,UAE,2018,2,83,202,7,1,312,840,18,229,638,11,17.333333333333332,<=30,UAE,Away,After 1965
Hasan Ali,PAK,Pace,2018-11-24,Dubai (DICS),UAE,2018,2,71,174,4,1,331,924,7,260,750,3,47.285714285714285,>30,UAE,Away,After 1965
Hasan Ali,PAK,Pace,2018-12-03,Abu Dhabi,UAE,2018,2,120,216,2,1,467,990,12,347,774,10,38.916666666666664,>30,UAE,Away,After 1965
Hasan Ali,PAK,Pace,2018-12-26,Centurion,South Africa,2018,2,109,186,3,1,620,1128,33,511,942,30,18.78787878787879,<=30,SA,Away,After 1965
Hasan Ali,PAK,Pace,2019-01-11,Johannesburg,South Africa,2019,2,158,204,3,1,906,1496,35,748,1292,32,25.885714285714286,<=30,SA,Away,After 1965
Hasan Ali,PAK,Pace,2021-01-26,Karachi,Pakistan,2021,2,122,180,2,1,546,968,13,424,788,11,42.0,>30,PAK,Home,After 1965
Hasan Ali,PAK,Pace,2021-02-04,Rawalpindi,Pakistan,2021,2,114,190,10,1,534,1105,24,420,915,14,22.25,<=30,PAK,Home,After 1965
Hasan Ali,PAK,Pace,2021-04-29,Harare,Zimbabwe,2021,2,89,164,9,1,469,921,23,380,757,14,20.391304347826086,<=30,ZIM,Away,After 1965
Hasan Ali,PAK,Pace,2021-05-07,Harare,Zimbabwe,2021,2,36,138,5,1,481,1050,18,445,912,13,26.72222222222222,<=30,ZIM,Away,After 1965
Hasan Ali,PAK,Pace,2021-08-12,Kingston,West Indies,2021,2,91,215,4,1,661,1558,37,570,1343,33,17.864864864864863,<=30,WI,Away,After 1965
Hasan Ali,PAK,Pace,2021-08-20,Kingston,West Indies,2021,2,67,132,2,1,688,1393,29,621,1261,27,23.724137931034484,<=30,WI,Away,After 1965
Hasan Ali,PAK,Pace,2021-11-26,Chattogram,Bangladesh,2021,2,103,190,7,1,416,874,18,313,684,11,23.11111111111111,<=30,BAN,Away,After 1965
Hasan Ali,PAK,Pace,2021-12-04,Mirpur,Bangladesh,2021,1,37,66,2,1,208,447,7,171,381,5,29.714285714285715,<=30,BAN,Away,After 1965
Hasan Ali,PAK,Pace,2022-03-12,Karachi,Pakistan,2022,2,94,192,2,1,534,1143,14,440,951,12,38.142857142857146,>30,PAK,Home,After 1965
Hasan Ali,PAK,Pace,2022-03-21,Lahore,Pakistan,2022,2,98,186,0,1,523,1268,24,425,1082,24,21.791666666666668,<=30,PAK,Home,After 1965
Hasan Ali,PAK,Pace,2022-07-16,Galle,Sri Lanka,2022,2,42,144,3,1,258,511,10,216,367,7,25.8,<=30,SL,Away,After 1965
Hasan Ali,PAK,Pace,2022-07-24,Galle,Sri Lanka,2022,2,103,162,0,1,287,503,6,184,341,6,47.833333333333336,>30,SL,Away,After 1965
Hasan Ali,PAK,Pace,2023-01-02,Karachi,Pakistan,2023,2,111,204,1,1,583,1266,12,472,1062,11,48.583333333333336,>30,PAK,Home,After 1965
Hasan Ali,PAK,Pace,2023-12-26,Melbourne,Australia,2023,2,114,245,2,1,818,1640,35,704,1395,33,23.37142857142857,<=30,AUS,Away,After 1965
Hasan Ali,PAK,Pace,2024-01-03,Sydney,Australia,2024,2,68,150,0,1,504,897,22,436,747,22,22.90909090909091,<=30,AUS,Away,After 1965
Hasan Mahmud,BAN,Pace,2024-03-30,Chattogram,Bangladesh,2024,2,157,234,6,1,504,886,22,347,652,16,22.90909090909091,<=30,BAN,Home,After 1965
Hasan Mahmud,BAN,Pace,2024-08-21,Rawalpindi,Pakistan,2024,2,90,198,3,1,696,1287,16,606,1089,13,43.5,>30,PAK,Away,After 1965
Hasan Mahmud,BAN,Pace,2024-08-30,Rawalpindi,Pakistan,2024,2,103,148,5,1,585,958,24,482,810,19,24.375,<=30,PAK,Away,After 1965
Hasan Mahmud,BAN,Pace,2024-09-19,Chennai,India,2024,2,126,200,5,1,481,825,20,355,625,15,24.05,<=30,IND,Away,After 1965
Hasan Mahmud,BAN,Pace,2024-09-27,Kanpur,India,2024,1,66,36,1,1,315,492,12,249,456,11,26.25,<=30,IND,Away,After 1965
Hasan Mahmud,BAN,Pace,2024-10-21,Mirpur,Bangladesh,2024,2,78,144,3,1,212,443,16,134,299,13,13.25,<=30,BAN,Home,After 1965
Hasan Mahmud,BAN,Pace,2024-10-29,Chattogram,Bangladesh,2024,1,83,138,0,1,267,480,9,184,342,9,29.666666666666668,<=30,BAN,Home,After 1965
Hasan Mahmud,BAN,Pace,2024-11-22,North Sound,West Indies,2024,2,107,198,3,1,670,1327,30,563,1129,27,22.333333333333332,<=30,WI,Away,After 1965
Hasan Mahmud,BAN,Pace,2024-11-30,Kingston,West Indies,2024,2,39,102,4,1,598,1162,33,559,1060,29,18.12121212121212,<=30,WI,Away,After 1965
Hasan Raza,PAK,Spin,2002-11-16,Bulawayo,Zimbabwe,2002,1,1,6,0,1,335,808,14,334,802,14,23.928571428571427,<=30,ZIM,Away,Upto 2014
Haseeb Ahsan,PAK,Spin,1958-01-17,Bridgetown,West Indies,1958,1,84,126,0,1,679,1898,11,595,1772,11,61.72727272727273,>30,WI,Away,Upto 2014
Haseeb Ahsan,PAK,Spin,1958-03-13,Georgetown,West Indies,1958,2,275,510,3,1,1032,2327,20,757,1817,17,51.6,>30,WI,Away,Upto 2014
Haseeb Ahsan,PAK,Spin,1958-03-26,Port of Spain,West Indies,1958,2,137,228,2,1,527,1152,14,390,924,12,37.642857142857146,>30,WI,Away,Upto 2014
Haseeb Ahsan,PAK,Spin,1959-03-06,Dhaka,Bangladesh,1959,1,3,6,0,1,170,591,9,167,585,9,18.88888888888889,<=30,BAN,Away,Upto 2014
Haseeb Ahsan,PAK,Spin,1959-11-21,Lahore,Pakistan,1959,2,136,225,3,1,563,1378,18,427,1153,15,31.27777777777778,>30,PAK,Home,Upto 2014
Haseeb Ahsan,PAK,Spin,1960-12-02,Brabourne,India,1960,1,68,186,0,1,412,1324,9,344,1138,9,45.77777777777778,>30,IND,Away,Upto 2014
Haseeb Ahsan,PAK,Spin,1960-12-16,Kanpur,India,1960,1,121,336,5,1,619,1984,16,498,1648,11,38.6875,>30,IND,Away,Upto 2014
Haseeb Ahsan,PAK,Spin,1960-12-30,Eden Gardens,India,1960,2,42,126,3,1,295,842,11,253,716,8,26.818181818181817,<=30,IND,Away,Upto 2014
Haseeb Ahsan,PAK,Spin,1961-01-13,Chennai,India,1961,1,202,504,6,1,664,1638,11,462,1134,5,60.36363636363637,>30,IND,Away,Upto 2014
Haseeb Ahsan,PAK,Spin,1961-02-08,Delhi,India,1961,1,57,102,1,1,386,1389,14,329,1287,13,27.571428571428573,<=30,IND,Away,Upto 2014
Haseeb Ahsan,PAK,Spin,1961-10-21,Lahore,Pakistan,1961,2,137,270,2,1,702,1631,18,565,1361,16,39.0,>30,PAK,Home,Upto 2014
Haseeb Ahsan,PAK,Spin,1962-02-02,Karachi,Pakistan,1962,1,68,216,2,1,769,2063,17,701,1847,15,45.23529411764706,>30,PAK,Home,Upto 2014
Hashmatullah Shahidi,AFG,Spin,2023-06-14,Mirpur,Bangladesh,2023,2,28,36,0,1,497,697,11,469,661,11,45.18181818181818,>30,BAN,Away,After 1965
Hashmatullah Shahidi,AFG,Spin,2024-02-02,Colombo (SSC),Sri Lanka,2024,1,11,12,0,1,432,854,10,421,842,10,43.2,>30,SL,Away,After 1965
Hashmatullah Shahidi,AFG,Spin,2024-02-28,Tolerance Oval,UAE,2024,1,4,18,0,1,298,624,8,294,606,8,37.25,>30,UAE,Away,After 1965
Hashmatullah Shahidi,AFG,Spin,2024-12-26,Bulawayo,Zimbabwe,2024,1,16,18,0,1,1189,1856,20,1173,1838,20,59.45,>30,ZIM,Away,After 1965
Hasibul Hossain,BAN,Pace,2000-11-10,Dhaka,Bangladesh,2000,2,91,150,1,1,382,888,12,291,738,11,31.833333333333332,>30,BAN,Home,Upto 2014
Hasibul Hossain,BAN,Pace,2001-04-19,Bulawayo,Zimbabwe,2001,1,125,180,2,1,731,1458,26,606,1278,24,28.115384615384617,<=30,ZIM,Away,Upto 2014
Hasibul Hossain,BAN,Pace,2001-08-29,Multan,Pakistan,2001,1,145,186,1,1,512,738,9,367,552,8,56.888888888888886,>30,PAK,Away,Upto 2014
Hasibul Hossain,BAN,Pace,2001-09-06,Colombo (SSC),Sri Lanka,2001,1,122,138,1,1,535,726,8,413,588,7,66.875,>30,SL,Away,Upto 2014
Hasibul Hossain,BAN,Pace,2001-12-26,Wellington,New Zealand,2001,1,88,126,1,1,447,846,18,359,720,17,24.833333333333332,<=30,NZ,Away,Upto 2014
Hon.A Lyttelton,ENG,Spin,1884-08-11,The Oval,England,1884,1,19,48,4,1,469,1036,14,450,988,10,33.5,>30,ENG,Home,After 1965
Hon.FS Jackson,ENG,Pace,1893-07-17,Lord's,England,1893,1,10,25,0,1,548,1355,26,538,1330,26,21.076923076923077,<=30,ENG,Home,After 1965
Hon.FS Jackson,ENG,Pace,1893-08-14,The Oval,England,1893,1,33,55,0,1,575,1100,17,542,1045,17,33.8235294117647,>30,ENG,Home,After 1965
Hon.FS Jackson,ENG,Pace,1896-06-22,Lord's,England,1896,1,28,55,0,1,652,1288,29,624,1233,29,22.482758620689655,<=30,ENG,Home,After 1965
Hon.FS Jackson,ENG,Pace,1896-07-16,Manchester,England,1896,1,34,80,0,1,587,1233,20,553,1153,20,29.35,<=30,ENG,Home,After 1965
Hon.FS Jackson,ENG,Pace,1899-06-01,Nottingham,England,1899,2,84,185,3,1,533,1449,20,449,1264,17,26.65,<=30,ENG,Home,After 1965
Hon.FS Jackson,ENG,Pace,1899-06-15,Lord's,England,1899,1,31,90,0,1,490,1002,18,459,912,18,27.22222222222222,<=30,ENG,Home,After 1965
Hon.FS Jackson,ENG,Pace,1899-06-29,Leeds,England,1899,2,31,80,1,1,374,834,15,343,754,14,24.933333333333334,<=30,ENG,Home,After 1965
Hon.FS Jackson,ENG,Pace,1899-07-17,Manchester,England,1899,2,45,108,1,1,742,1679,23,697,1571,22,32.26086956521739,>30,ENG,Home,After 1965
Hon.FS Jackson,ENG,Pace,1899-08-14,The Oval,England,1899,2,93,135,0,1,660,1288,13,567,1153,13,50.76923076923077,>30,ENG,Home,After 1965
Hon.FS Jackson,ENG,Pace,1902-05-29,Birmingham,England,1902,1,7,24,0,1,229,582,9,222,558,9,25.444444444444443,<=30,ENG,Home,Upto 2014
Hon.FS Jackson,ENG,Pace,1902-07-03,Sheffield,England,1902,2,71,133,4,1,311,559,11,240,426,7,28.272727272727273,<=30,ENG,Home,Upto 2014
Hon.FS Jackson,ENG,Pace,1902-07-24,Manchester,England,1902,1,58,66,0,1,194,433,13,136,367,13,14.923076923076923,<=30,ENG,Home,Upto 2014
Hon.FS Jackson,ENG,Pace,1902-08-11,The Oval,England,1902,2,73,144,2,1,298,648,14,225,504,12,21.285714285714285,<=30,ENG,Home,Upto 2014
Hon.FS Jackson,ENG,Pace,1905-05-29,Nottingham,England,1905,2,58,119,5,1,577,1196,21,519,1077,16,27.476190476190474,<=30,ENG,Home,Upto 2014
Hon.FS Jackson,ENG,Pace,1905-06-15,Lord's,England,1905,1,50,90,4,1,344,822,16,294,732,12,21.5,<=30,ENG,Home,Upto 2014
Hon.FS Jackson,ENG,Pace,1905-07-03,Leeds,England,1905,2,20,72,1,1,525,1232,17,505,1160,16,30.88235294117647,>30,ENG,Home,Upto 2014
Hon.FS Jackson,ENG,Pace,1905-07-24,Manchester,England,1905,2,46,72,2,1,572,1050,20,526,978,18,28.6,<=30,ENG,Home,Upto 2014
Hon.FS Jackson,ENG,Pace,1905-08-14,The Oval,England,1905,1,27,54,1,1,775,1333,24,748,1279,23,32.291666666666664,>30,ENG,Home,Upto 2014
Hon.FSG Calthorpe,ENG,Pace,1930-01-11,Bridgetown,West Indies,1930,2,52,144,1,1,797,1692,15,745,1548,14,53.13333333333333,>30,WI,Away,Upto 2014
Hon.FSG Calthorpe,ENG,Pace,1930-02-21,Georgetown,West Indies,1930,1,23,36,0,1,688,1706,25,665,1670,25,27.52,<=30,WI,Away,Upto 2014
Hon.FSG Calthorpe,ENG,Pace,1930-04-03,Kingston,West Indies,1930,1,16,24,0,1,684,1474,14,668,1450,14,48.857142857142854,>30,WI,Away,Upto 2014
I Meckiff,AUS,Pace,1957-12-23,Johannesburg,South Africa,1957,2,177,456,8,1,682,1716,24,505,1260,16,28.416666666666668,<=30,SA,Away,Upto 2014
I Meckiff,AUS,Pace,1957-12-31,Cape Town,South Africa,1957,1,18,44,0,1,357,1102,8,339,1058,8,44.625,>30,SA,Away,Upto 2014
I Meckiff,AUS,Pace,1958-02-07,Johannesburg,South Africa,1958,2,62,272,2,1,425,1453,14,363,1181,12,30.357142857142858,>30,SA,Away,Upto 2014
I Meckiff,AUS,Pace,1958-02-28,Gqeberha,South Africa,1958,2,96,272,1,1,429,1409,18,333,1137,17,23.833333333333332,<=30,SA,Away,Upto 2014
I Meckiff,AUS,Pace,1958-12-05,Brisbane,Australia,1958,2,63,288,5,1,361,1352,20,298,1064,15,18.05,<=30,AUS,Home,Upto 2014
I Meckiff,AUS,Pace,1958-12-31,Melbourne,Australia,1958,2,107,314,9,1,456,1361,29,349,1047,20,15.724137931034482,<=30,AUS,Home,Upto 2014
I Meckiff,AUS,Pace,1959-01-09,Sydney,Australia,1959,2,52,144,1,1,297,1016,5,245,872,4,59.4,>30,AUS,Home,Upto 2014
I Meckiff,AUS,Pace,1959-02-13,Melbourne,Australia,1959,2,70,152,2,1,613,1344,20,543,1192,18,30.65,>30,AUS,Home,Upto 2014
I Meckiff,AUS,Pace,1959-11-13,Dhaka,Bangladesh,1959,2,41,78,0,1,428,1301,20,387,1223,20,21.4,<=30,BAN,Away,Upto 2014
I Meckiff,AUS,Pace,1959-11-21,Lahore,Pakistan,1959,2,89,246,3,1,401,960,14,312,714,11,28.642857142857142,<=30,PAK,Away,Upto 2014
I Meckiff,AUS,Pace,1959-12-12,Delhi,India,1959,2,85,186,1,1,410,963,10,325,777,9,41.0,>30,IND,Away,Upto 2014
I Meckiff,AUS,Pace,1959-12-19,Kanpur,India,1959,2,52,156,1,1,231,796,13,179,640,12,17.76923076923077,<=30,IND,Away,Upto 2014
I Meckiff,AUS,Pace,1960-01-01,Brabourne,India,1960,2,146,396,7,1,552,1475,15,406,1079,8,36.8,>30,IND,Away,Upto 2014
I Meckiff,AUS,Pace,1960-01-13,Chennai,India,1960,2,54,174,2,1,260,780,12,206,606,10,21.666666666666668,<=30,IND,Away,Upto 2014
I Meckiff,AUS,Pace,1960-01-23,Eden Gardens,India,1960,2,69,228,1,1,523,1340,17,454,1112,16,30.764705882352942,>30,IND,Away,Upto 2014
I Meckiff,AUS,Pace,1960-12-09,Brisbane,Australia,1960,2,148,176,1,1,640,1184,22,492,1008,21,29.09090909090909,<=30,AUS,Home,Upto 2014
I Meckiff,AUS,Pace,1961-01-13,Sydney,Australia,1961,2,86,144,1,1,402,914,14,316,770,13,28.714285714285715,<=30,AUS,Home,Upto 2014
I Meckiff,AUS,Pace,1963-12-06,Brisbane,Australia,1963,1,8,8,0,1,562,1265,13,554,1257,13,43.23076923076923,>30,AUS,Home,Upto 2014
I Sharma,IND,Pace,2007-05-25,Mirpur,Bangladesh,2007,2,49,78,1,1,511,762,11,462,684,10,46.45454545454545,>30,BAN,Away,Upto 2014
I Sharma,IND,Pace,2007-12-08,Bengaluru,India,2007,2,140,235,5,1,758,1372,19,618,1137,14,39.89473684210526,>30,IND,Home,Upto 2014
I Sharma,IND,Pace,2008-01-02,Sydney,Australia,2008,2,146,222,0,1,803,1292,17,657,1070,17,47.23529411764706,>30,AUS,Away,Upto 2014
I Sharma,IND,Pace,2008-01-16,W.A.C.A,Australia,2008,2,97,144,3,1,844,1397,31,747,1253,28,27.225806451612904,<=30,AUS,Away,Upto 2014
I Sharma,IND,Pace,2008-01-24,Adelaide,Australia,2008,1,115,240,3,1,710,1457,17,595,1217,14,41.76470588235294,>30,AUS,Away,Upto 2014
I Sharma,IND,Pace,2008-04-11,Kanpur,India,2008,2,73,135,5,1,346,693,14,273,558,9,24.714285714285715,<=30,IND,Home,Upto 2014
I Sharma,IND,Pace,2008-07-23,Colombo (SSC),Sri Lanka,2008,1,124,198,2,1,421,648,5,297,450,3,84.2,>30,SL,Away,Upto 2014
I Sharma,IND,Pace,2008-07-31,Galle,Sri Lanka,2008,2,56,138,3,1,302,510,9,246,372,6,33.55555555555556,>30,SL,Away,Upto 2014
I Sharma,IND,Pace,2008-08-08,Colombo (PSS),Sri Lanka,2008,1,33,93,1,1,381,610,11,348,517,10,34.63636363636363,>30,SL,Away,Upto 2014
I Sharma,IND,Pace,2008-10-09,Bengaluru,India,2008,2,117,264,7,1,560,1289,24,443,1025,17,23.333333333333332,<=30,IND,Home,Upto 2014
I Sharma,IND,Pace,2008-10-17,Mohali,India,2008,2,110,204,4,1,846,1398,17,736,1194,13,49.76470588235294,>30,IND,Home,Upto 2014
I Sharma,IND,Pace,2008-10-29,Delhi,India,2008,1,84,150,0,1,697,1278,10,613,1128,10,69.7,>30,IND,Home,Upto 2014
I Sharma,IND,Pace,2008-11-06,Nagpur,India,2008,2,95,210,4,1,502,1096,12,407,886,8,41.833333333333336,>30,IND,Home,Upto 2014
I Sharma,IND,Pace,2008-12-11,Chennai,India,2008,2,89,255,4,1,452,1045,16,363,790,12,28.25,<=30,IND,Home,Upto 2014
I Sharma,IND,Pace,2008-12-19,Mohali,India,2008,2,62,102,2,1,522,1070,12,460,968,10,43.5,>30,IND,Home,Upto 2014
I Sharma,IND,Pace,2009-03-18,Hamilton,New Zealand,2009,2,135,248,4,1,743,1246,14,608,998,10,53.07142857142857,>30,NZ,Away,Upto 2014
I Sharma,IND,Pace,2009-03-26,Napier,New Zealand,2009,1,95,162,3,1,682,1265,13,587,1103,10,52.46153846153846,>30,NZ,Away,Upto 2014
I Sharma,IND,Pace,2009-04-03,Wellington,New Zealand,2009,2,104,156,1,1,869,1366,23,765,1210,22,37.78260869565217,>30,NZ,Away,Upto 2014
I Sharma,IND,Pace,2009-11-16,Ahmedabad,India,2009,1,135,198,2,1,648,1044,12,513,846,10,54.0,>30,IND,Home,Upto 2014
I Sharma,IND,Pace,2010-01-17,Chattogram,Bangladesh,2010,2,95,168,5,1,609,842,14,514,674,9,43.5,>30,BAN,Away,Upto 2014
I Sharma,IND,Pace,2010-01-24,Mirpur,Bangladesh,2010,2,116,198,4,1,466,741,17,350,543,13,27.41176470588235,<=30,BAN,Away,Upto 2014
I Sharma,IND,Pace,2010-02-06,Nagpur,India,2010,1,85,168,0,1,534,1007,19,449,839,19,28.105263157894736,<=30,IND,Home,Upto 2014
I Sharma,IND,Pace,2010-02-14,Eden Gardens,India,2010,2,151,258,3,1,646,954,10,495,696,7,64.6,>30,IND,Home,Upto 2014
I Sharma,IND,Pace,2010-07-18,Galle,Sri Lanka,2010,2,173,192,3,1,560,768,16,387,576,13,35.0,>30,SL,Away,Upto 2014
I Sharma,IND,Pace,2010-07-26,Colombo (SSC),Sri Lanka,2010,2,133,162,1,1,508,710,3,375,548,2,169.33333333333334,>30,SL,Away,Upto 2014
I Sharma,IND,Pace,2010-08-03,Colombo (PSS),Sri Lanka,2010,2,126,240,3,1,534,849,8,408,609,5,66.75,>30,SL,Away,Upto 2014
I Sharma,IND,Pace,2010-10-01,Mohali,India,2010,2,105,124,3,1,619,1051,25,514,927,22,24.76,<=30,IND,Home,Upto 2014
I Sharma,IND,Pace,2010-11-20,Nagpur,India,2010,2,58,146,7,1,407,788,13,349,642,6,31.307692307692307,>30,IND,Home,Upto 2014
I Sharma,IND,Pace,2010-12-16,Centurion,South Africa,2010,1,120,163,2,1,795,1278,19,675,1115,17,41.8421052631579,>30,SA,Away,Upto 2014
I Sharma,IND,Pace,2010-12-26,Durban,South Africa,2010,2,78,123,2,1,613,1119,31,535,996,29,19.774193548387096,<=30,SA,Away,Upto 2014
I Sharma,IND,Pace,2011-01-02,Cape Town,South Africa,2011,2,139,270,3,1,846,1680,22,707,1410,19,38.45454545454545,>30,SA,Away,Upto 2014
I Sharma,IND,Pace,2011-06-20,Kingston,West Indies,2011,2,110,204,6,1,535,1130,25,425,926,19,21.4,<=30,WI,Away,Upto 2014
I Sharma,IND,Pace,2011-06-28,Bridgetown,West Indies,2011,2,108,248,10,1,639,1424,28,531,1176,18,22.821428571428573,<=30,WI,Away,Upto 2014
I Sharma,IND,Pace,2011-07-06,Roseau,West Indies,2011,2,153,291,6,1,449,995,20,296,704,14,22.45,<=30,WI,Away,Upto 2014
I Sharma,IND,Pace,2011-07-21,Lord's,England,2011,2,187,324,4,1,813,1712,30,626,1388,26,27.1,<=30,ENG,Away,Upto 2014
I Sharma,IND,Pace,2011-07-29,Nottingham,England,2011,2,197,308,5,1,899,1645,37,702,1337,32,24.2972972972973,<=30,ENG,Away,Upto 2014
I Sharma,IND,Pace,2011-08-10,Birmingham,England,2011,1,159,223,1,1,731,1272,20,572,1049,19,36.55,>30,ENG,Away,Upto 2014
I Sharma,IND,Pace,2011-08-18,The Oval,England,2011,1,97,186,1,1,633,1206,15,536,1020,14,42.2,>30,ENG,Away,Upto 2014
I Sharma,IND,Pace,2011-11-06,Delhi,India,2011,2,129,234,2,1,494,839,13,365,605,11,38.0,>30,IND,Home,Upto 2014
I Sharma,IND,Pace,2011-11-14,Eden Gardens,India,2011,2,109,180,2,1,531,767,14,422,587,12,37.92857142857143,>30,IND,Home,Upto 2014
I Sharma,IND,Pace,2011-11-22,Wankhede,India,2011,2,99,240,1,1,622,1054,14,523,814,13,44.42857142857143,>30,IND,Home,Upto 2014
I Sharma,IND,Pace,2011-12-26,Melbourne,Australia,2011,2,91,219,2,1,739,1504,35,648,1285,33,21.114285714285714,<=30,AUS,Away,Upto 2014
I Sharma,IND,Pace,2012-01-03,Sydney,Australia,2012,1,144,198,1,1,874,1376,22,730,1178,21,39.72727272727273,>30,AUS,Away,Upto 2014
I Sharma,IND,Pace,2012-01-13,W.A.C.A,Australia,2012,1,89,108,1,1,668,1156,29,579,1048,28,23.03448275862069,<=30,AUS,Away,Upto 2014
I Sharma,IND,Pace,2012-01-24,Adelaide,Australia,2012,2,127,228,1,1,749,1369,20,622,1141,19,37.45,>30,AUS,Away,Upto 2014
I Sharma,IND,Pace,2012-12-05,Eden Gardens,India,2012,1,78,174,1,1,417,856,12,339,682,11,34.75,>30,IND,Home,Upto 2014
I Sharma,IND,Pace,2012-12-13,Nagpur,India,2012,2,91,258,3,1,243,612,7,152,354,4,34.714285714285715,>30,IND,Home,Upto 2014
I Sharma,IND,Pace,2013-02-22,Chennai,India,2013,2,61,120,0,1,415,813,8,354,693,8,51.875,>30,IND,Home,Upto 2014
I Sharma,IND,Pace,2013-03-02,Hyderabad,India,2013,2,50,132,1,1,327,744,7,277,612,6,46.714285714285715,>30,IND,Home,Upto 2014
I Sharma,IND,Pace,2013-03-14,Mohali,India,2013,2,106,234,3,1,473,880,15,367,646,12,31.533333333333335,>30,IND,Home,Upto 2014
I Sharma,IND,Pace,2013-03-22,Delhi,India,2013,2,48,96,3,1,259,450,5,211,354,2,51.8,>30,IND,Home,Upto 2014
I Sharma,IND,Pace,2013-12-18,Johannesburg,South Africa,2013,2,170,324,5,1,1012,2037,30,842,1713,25,33.733333333333334,>30,SA,Away,Upto 2014
I Sharma,IND,Pace,2013-12-26,Durban,South Africa,2013,2,143,216,0,1,714,1389,18,571,1173,18,39.666666666666664,>30,SA,Away,Upto 2014
I Sharma,IND,Pace,2014-02-06,Auckland,New Zealand,2014,2,162,264,9,1,873,1527,37,711,1263,28,23.594594594594593,<=30,NZ,Away,After 1965
I Sharma,IND,Pace,2014-02-14,Wellington,New Zealand,2014,2,215,372,6,1,1271,2109,30,1056,1737,24,42.36666666666667,>30,NZ,Away,After 1965
I Sharma,IND,Pace,2014-07-09,Nottingham,England,2014,1,150,228,3,1,984,1979,23,834,1751,20,42.78260869565217,>30,ENG,Away,After 1965
I Sharma,IND,Pace,2014-07-17,Lord's,England,2014,2,135,282,7,1,890,1823,32,755,1541,25,27.8125,<=30,ENG,Away,After 1965
I Sharma,IND,Pace,2014-08-15,The Oval,England,2014,1,96,180,4,1,613,1107,25,517,927,21,24.52,<=30,ENG,Away,After 1965
I Sharma,IND,Pace,2014-12-09,Adelaide,Australia,2014,2,126,246,1,1,885,1420,15,759,1174,14,59.0,>30,AUS,Away,After 1965
I Sharma,IND,Pace,2014-12-17,Brisbane,Australia,2014,2,155,192,6,1,959,1402,28,804,1210,22,34.25,>30,AUS,Away,After 1965
I Sharma,IND,Pace,2014-12-26,Melbourne,Australia,2014,2,153,312,2,1,1069,1880,27,916,1568,25,39.592592592592595,>30,AUS,Away,After 1965
I Sharma,IND,Pace,2015-06-10,Fatullah,Bangladesh,2015,1,24,42,0,1,199,300,1,175,258,1,199.0,>30,BAN,Away,After 1965
I Sharma,IND,Pace,2015-08-12,Galle,Sri Lanka,2015,2,107,144,2,1,393,630,9,286,486,7,43.666666666666664,>30,SL,Away,After 1965
I Sharma,IND,Pace,2015-08-20,Colombo (PSS),Sri Lanka,2015,2,109,192,3,1,525,996,16,416,804,13,32.8125,>30,SL,Away,After 1965
I Sharma,IND,Pace,2015-08-28,Colombo (SSC),Sri Lanka,2015,2,86,204,8,1,606,1122,27,520,918,19,22.444444444444443,<=30,SL,Away,After 1965
I Sharma,IND,Pace,2015-11-14,Bengaluru,India,2015,1,40,78,0,1,150,258,1,110,180,1,150.0,>30,IND,Home,After 1965
I Sharma,IND,Pace,2015-11-25,Nagpur,India,2015,2,24,102,0,1,123,391,7,99,289,7,17.571428571428573,<=30,IND,Home,After 1965
I Sharma,IND,Pace,2015-12-03,Delhi,India,2015,2,51,192,1,1,288,947,15,237,755,14,19.2,<=30,IND,Home,After 1965
I Sharma,IND,Pace,2016-07-21,North Sound,West Indies,2016,2,71,186,1,1,466,972,12,395,786,11,38.833333333333336,>30,WI,Away,After 1965
I Sharma,IND,Pace,2016-07-30,Kingston,West Indies,2016,2,109,168,3,1,509,984,9,400,816,6,56.55555555555556,>30,WI,Away,After 1965
I Sharma,IND,Pace,2016-08-09,Gros Islet,West Indies,2016,2,70,120,3,1,570,1190,26,500,1070,23,21.923076923076923,<=30,WI,Away,After 1965
I Sharma,IND,Pace,2016-08-18,Port of Spain,West Indies,2016,1,7,30,1,1,34,102,1,27,72,0,34.0,>30,WI,Away,After 1965
I Sharma,IND,Pace,2016-12-16,Chennai,India,2016,2,59,186,3,1,437,846,9,378,660,6,48.55555555555556,>30,IND,Home,After 1965
I Sharma,IND,Pace,2017-02-09,Hyderabad,India,2017,2,109,198,3,1,567,906,10,458,708,7,56.7,>30,IND,Home,After 1965
I Sharma,IND,Pace,2017-02-23,Pune,India,2017,2,33,84,0,1,160,354,9,127,270,9,17.77777777777778,<=30,IND,Home,After 1965
I Sharma,IND,Pace,2017-03-04,Bengaluru,India,2017,2,76,198,2,1,391,822,14,315,624,12,27.928571428571427,<=30,IND,Home,After 1965
I Sharma,IND,Pace,2017-03-16,Ranchi,India,2017,2,100,186,1,1,451,960,9,351,774,8,50.111111111111114,>30,IND,Home,After 1965
I Sharma,IND,Pace,2017-11-24,Nagpur,India,2017,2,80,156,5,1,472,859,9,392,703,4,52.44444444444444,>30,IND,Home,After 1965
I Sharma,IND,Pace,2017-12-02,Delhi,India,2017,2,130,255,3,1,549,946,10,419,691,7,54.9,>30,IND,Home,After 1965
I Sharma,IND,Pace,2018-01-13,Centurion,South Africa,2018,2,86,234,5,1,739,1521,29,653,1287,24,25.482758620689655,<=30,SA,Away,After 1965
I Sharma,IND,Pace,2018-01-24,Johannesburg,South Africa,2018,2,64,180,3,1,749,1777,40,685,1597,37,18.725,<=30,SA,Away,After 1965
I Sharma,IND,Pace,2018-06-14,Bengaluru,India,2018,2,45,72,4,1,280,456,13,235,384,9,21.53846153846154,<=30,IND,Home,After 1965
I Sharma,IND,Pace,2018-08-01,Birmingham,England,2018,2,97,180,6,1,700,1284,29,603,1104,23,24.137931034482758,<=30,ENG,Away,After 1965
I Sharma,IND,Pace,2018-08-09,Lord's,England,2018,1,101,132,1,1,483,867,26,382,735,25,18.576923076923077,<=30,ENG,Away,After 1965
I Sharma,IND,Pace,2018-08-18,Nottingham,England,2018,2,102,174,4,1,905,1711,32,803,1537,28,28.28125,<=30,ENG,Away,After 1965
I Sharma,IND,Pace,2018-08-30,Southampton,England,2018,2,62,186,4,1,624,1317,26,562,1131,22,24.0,<=30,ENG,Away,After 1965
I Sharma,IND,Pace,2018-09-07,The Oval,England,2018,2,75,234,3,1,781,1629,21,706,1395,18,37.19047619047619,>30,ENG,Away,After 1965
I Sharma,IND,Pace,2018-12-06,Adelaide,Australia,2018,2,95,234,3,1,635,1467,25,540,1233,22,25.4,<=30,AUS,Away,After 1965
I Sharma,IND,Pace,2018-12-14,Perth,Australia,2018,2,86,219,5,1,753,1685,30,667,1466,25,25.1,<=30,AUS,Away,After 1965
I Sharma,IND,Pace,2018-12-26,Melbourne,Australia,2018,2,81,165,3,1,621,1425,29,540,1260,26,21.413793103448278,<=30,AUS,Away,After 1965
I Sharma,IND,Pace,2019-08-22,North Sound,West Indies,2019,2,74,161,8,1,576,1302,29,502,1141,21,19.862068965517242,<=30,WI,Away,After 1965
I Sharma,IND,Pace,2019-08-30,Kingston,West Indies,2019,2,61,137,3,1,512,1121,25,451,984,22,20.48,<=30,WI,Away,After 1965
I Sharma,IND,Pace,2019-10-02,Visakhapatnam,India,2019,2,72,138,1,1,350,737,9,278,599,8,38.888888888888886,>30,IND,Home,After 1965
I Sharma,IND,Pace,2019-10-10,Pune,India,2019,2,53,90,1,1,453,864,13,400,774,12,34.84615384615385,>30,IND,Home,After 1965
I Sharma,IND,Pace,2019-11-14,Indore,India,2019,2,51,138,3,1,430,819,19,379,681,16,22.63157894736842,<=30,IND,Home,After 1965
I Sharma,IND,Pace,2019-11-22,Eden Gardens,India,2019,2,78,150,9,1,491,776,27,413,626,18,18.185185185185187,<=30,IND,Home,After 1965
I Sharma,IND,Pace,2020-02-21,Wellington,New Zealand,2020,2,76,140,5,1,586,1297,26,510,1157,21,22.53846153846154,<=30,NZ,Away,After 1965
I Sharma,IND,Pace,2021-02-05,Chennai,India,2021,2,76,204,3,1,376,864,16,300,660,13,23.5,<=30,IND,Home,After 1965
I Sharma,IND,Pace,2021-02-13,Chennai,India,2021,2,35,66,2,1,192,382,7,157,316,5,27.428571428571427,<=30,IND,Home,After 1965
I Sharma,IND,Pace,2021-02-24,Ahmedabad,India,2021,1,26,30,1,1,124,228,2,98,198,1,62.0,>30,IND,Home,After 1965
I Sharma,IND,Pace,2021-03-04,Ahmedabad,India,2021,1,23,54,0,1,213,478,9,190,424,9,23.666666666666668,<=30,IND,Home,After 1965
I Sharma,IND,Pace,2021-06-18,Southampton,England,2021,2,69,188,3,1,643,1620,27,574,1432,24,23.814814814814813,<=30,ENG,Away,After 1965
I Sharma,IND,Pace,2021-08-12,Lord's,England,2021,2,82,204,5,1,917,2031,34,835,1827,29,26.970588235294116,<=30,ENG,Away,After 1965
I Sharma,IND,Pace,2021-08-25,Leeds,England,2021,1,92,132,0,1,610,1311,27,518,1179,27,22.59259259259259,<=30,ENG,Away,After 1965
I Sharma,IND,Pace,2021-11-25,Kanpur,India,2021,2,55,132,0,1,414,852,16,359,720,16,25.875,<=30,IND,Home,After 1965
IA Greig,ENG,Pace,1982-07-29,Birmingham,England,1982,2,72,110,4,1,641,1313,30,569,1203,26,21.366666666666667,<=30,ENG,Home,Upto 2014
IA Greig,ENG,Pace,1982-08-12,Lord's,England,1982,1,42,78,0,1,700,1644,21,658,1566,21,33.333333333333336,>30,ENG,Home,Upto 2014
IAR Peebles,ENG,Spin,1927-12-24,Johannesburg,South Africa,1927,2,47,114,0,1,312,867,11,265,753,11,28.363636363636363,<=30,SA,Away,Upto 2014
IAR Peebles,ENG,Spin,1927-12-31,Cape Town,South Africa,1927,2,53,157,1,1,504,1376,23,451,1219,22,21.91304347826087,<=30,SA,Away,Upto 2014
IAR Peebles,ENG,Spin,1928-01-21,Durban,South Africa,1928,2,98,162,4,1,719,1581,22,621,1419,18,32.68181818181818,>30,SA,Away,Upto 2014
IAR Peebles,ENG,Spin,1928-01-28,Johannesburg,South Africa,1928,1,48,72,0,1,407,779,13,359,707,13,31.307692307692307,>30,SA,Away,Upto 2014
IAR Peebles,ENG,Spin,1930-07-25,Manchester,England,1930,1,150,330,3,1,355,1021,7,205,691,4,50.714285714285715,>30,ENG,Home,Upto 2014
IAR Peebles,ENG,Spin,1930-08-16,The Oval,England,1930,1,204,426,6,1,762,1847,19,558,1421,13,40.10526315789474,>30,ENG,Home,Upto 2014
IAR Peebles,ENG,Spin,1930-12-24,Johannesburg,South Africa,1930,2,84,126,4,1,386,746,13,302,620,9,29.692307692307693,<=30,SA,Away,Upto 2014
IAR Peebles,ENG,Spin,1931-01-01,Cape Town,South Africa,1931,1,95,168,0,1,731,1678,19,636,1510,19,38.473684210526315,>30,SA,Away,Upto 2014
IAR Peebles,ENG,Spin,1931-02-13,Johannesburg,South Africa,1931,2,149,395,7,1,443,1089,15,294,694,8,29.533333333333335,<=30,SA,Away,Upto 2014
IAR Peebles,ENG,Spin,1931-02-21,Durban,South Africa,1931,2,138,316,7,1,436,1147,20,298,831,13,21.8,<=30,SA,Away,Upto 2014
IAR Peebles,ENG,Spin,1931-06-27,Lord's,England,1931,2,227,412,9,1,753,1396,20,526,984,11,37.65,>30,ENG,Home,Upto 2014
IAR Peebles,ENG,Spin,1931-07-29,The Oval,England,1931,2,98,204,4,1,591,1465,18,493,1261,14,32.833333333333336,>30,ENG,Home,Upto 2014
IB Cromb,NZ,Pace,1931-06-27,Lord's,England,1931,2,157,372,5,1,463,1131,13,306,759,8,35.61538461538461,>30,ENG,Away,Upto 2014
IB Cromb,NZ,Pace,1931-07-29,The Oval,England,1931,1,97,180,0,1,180,402,5,83,222,5,36.0,>30,ENG,Away,Upto 2014
IB Cromb,NZ,Pace,1931-08-15,Manchester,England,1931,1,33,96,1,1,73,168,1,40,72,0,73.0,>30,ENG,Away,Upto 2014
IB Cromb,NZ,Pace,1932-02-27,Christchurch,New Zealand,1932,1,94,156,1,1,481,1211,11,387,1055,10,43.72727272727273,>30,NZ,Home,Upto 2014
IB Cromb,NZ,Pace,1932-03-04,Wellington,New Zealand,1932,2,61,156,1,1,449,1052,12,388,896,11,37.416666666666664,>30,NZ,Home,Upto 2014
IB Leggat,NZ,Pace,1954-01-01,Cape Town,South Africa,1954,1,6,24,0,1,315,963,9,309,939,9,35.0,>30,SA,Away,Upto 2014
IBA Allen,WI,Pace,1991-06-20,Lord's,England,1991,1,88,138,2,1,685,1326,19,597,1188,17,36.05263157894737,>30,ENG,Away,Upto 2014
IBA Allen,WI,Pace,1991-07-04,Nottingham,England,1991,2,92,144,3,1,833,1718,28,741,1574,25,29.75,<=30,ENG,Away,Upto 2014
ID Blackwell,ENG,Spin,2006-03-01,Nagpur,India,2006,2,71,114,0,1,588,1296,7,517,1182,7,84.0,>30,IND,Away,Upto 2014
ID Buys,SA,Pace,1922-12-23,Johannesburg,South Africa,1922,2,52,144,0,1,634,1476,30,582,1332,30,21.133333333333333,<=30,SA,Home,Upto 2014
IDK Salisbury,ENG,Spin,1992-06-18,Lord's,England,1992,2,122,223,5,1,212,416,11,90,193,6,19.272727272727273,<=30,ENG,Home,Upto 2014
IDK Salisbury,ENG,Spin,1992-07-02,Manchester,England,1992,2,184,198,0,1,251,294,0,67,96,0,inf,>30,ENG,Home,Upto 2014
IDK Salisbury,ENG,Spin,1993-01-29,Eden Gardens,India,1993,2,88,138,1,1,470,1482,23,382,1344,22,20.434782608695652,<=30,IND,Away,Upto 2014
IDK Salisbury,ENG,Spin,1993-02-11,Chennai,India,1993,1,142,174,2,1,792,1720,20,650,1546,18,39.6,>30,IND,Away,Upto 2014
IDK Salisbury,ENG,Spin,1994-03-17,Georgetown,West Indies,1994,1,163,222,4,1,318,558,4,155,336,0,79.5,>30,WI,Away,Upto 2014
IDK Salisbury,ENG,Spin,1994-03-25,Port of Spain,West Indies,1994,2,113,186,3,1,162,288,3,49,102,0,54.0,>30,WI,Away,Upto 2014
IDK Salisbury,ENG,Spin,1994-07-21,Lord's,England,1994,2,121,264,1,1,242,564,5,121,300,4,48.4,>30,ENG,Home,Upto 2014
IDK Salisbury,ENG,Spin,1996-07-25,Lord's,England,1996,2,105,194,1,1,309,758,8,204,564,7,38.625,>30,ENG,Home,Upto 2014
IDK Salisbury,ENG,Spin,1996-08-22,The Oval,England,1996,1,116,174,1,1,418,892,11,302,718,10,38.0,>30,ENG,Home,Upto 2014
IDK Salisbury,ENG,Spin,1998-07-23,Nottingham,England,1998,2,66,84,0,1,120,210,0,54,126,0,inf,>30,ENG,Home,Upto 2014
IDK Salisbury,ENG,Spin,1998-08-06,Leeds,England,1998,2,40,66,0,1,41,72,0,1,6,0,inf,>30,ENG,Home,Upto 2014
IDK Salisbury,ENG,Spin,1998-08-27,The Oval,England,1998,1,86,155,1,1,481,1390,17,395,1235,16,28.294117647058822,<=30,ENG,Home,Upto 2014
IDK Salisbury,ENG,Spin,2000-11-15,Lahore,Pakistan,2000,1,71,186,0,1,697,1762,20,626,1576,20,34.85,>30,PAK,Away,Upto 2014
IDK Salisbury,ENG,Spin,2000-11-29,Faisalabad,Pakistan,2000,2,61,102,1,1,641,1582,20,580,1480,19,32.05,>30,PAK,Away,Upto 2014
IDK Salisbury,ENG,Spin,2000-12-07,Karachi,Pakistan,2000,2,61,126,0,1,624,1582,18,563,1456,18,34.666666666666664,>30,PAK,Away,Upto 2014
IDR Bradshaw,WI,Pace,2006-03-09,Auckland,New Zealand,2006,2,156,343,6,1,867,1612,27,711,1269,21,32.111111111111114,>30,NZ,Away,Upto 2014
IDR Bradshaw,WI,Pace,2006-03-17,Wellington,New Zealand,2006,2,113,138,1,1,633,1165,28,520,1027,27,22.607142857142858,<=30,NZ,Away,Upto 2014
IDR Bradshaw,WI,Pace,2006-06-02,St John's,West Indies,2006,2,191,384,1,1,716,1427,15,525,1043,14,47.733333333333334,>30,WI,Home,Upto 2014
IDR Bradshaw,WI,Pace,2006-06-10,Gros Islet,West Indies,2006,1,80,156,1,1,597,938,8,517,782,7,74.625,>30,WI,Home,Upto 2014
IDS Smith,NZ,Spin,1985-05-04,Kingston,West Indies,1985,1,5,18,0,1,118,270,2,113,252,2,59.0,>30,WI,Away,Upto 2014
IE O'Brien,NZ,Pace,2005-03-10,Christchurch,New Zealand,2005,2,100,114,1,1,768,1398,17,668,1284,16,45.1764705882353,>30,NZ,Home,Upto 2014
IE O'Brien,NZ,Pace,2005-03-18,Wellington,New Zealand,2005,1,97,144,1,1,569,942,15,472,798,14,37.93333333333333,>30,NZ,Home,Upto 2014
IE O'Brien,NZ,Pace,2007-11-08,Johannesburg,South Africa,2007,2,114,198,1,1,740,1372,29,626,1174,28,25.517241379310345,<=30,SA,Away,Upto 2014
IE O'Brien,NZ,Pace,2007-11-16,Centurion,South Africa,2007,1,78,129,2,1,609,994,26,531,865,24,23.423076923076923,<=30,SA,Away,Upto 2014
IE O'Brien,NZ,Pace,2008-01-04,Dunedin,New Zealand,2008,2,59,132,2,1,478,890,22,419,758,20,21.727272727272727,<=30,NZ,Home,Upto 2014
IE O'Brien,NZ,Pace,2008-01-12,Wellington,New Zealand,2008,2,57,156,5,1,450,866,22,393,710,17,20.454545454545453,<=30,NZ,Home,Upto 2014
IE O'Brien,NZ,Pace,2008-05-23,Manchester,England,2008,2,111,258,4,1,614,1172,16,503,914,12,38.375,>30,ENG,Away,Upto 2014
IE O'Brien,NZ,Pace,2008-06-05,Nottingham,England,2008,1,74,138,4,1,579,1236,29,505,1098,25,19.96551724137931,<=30,ENG,Away,Upto 2014
IE O'Brien,NZ,Pace,2008-10-17,Chattogram,Bangladesh,2008,2,64,240,5,1,258,774,7,194,534,2,36.857142857142854,>30,BAN,Away,Upto 2014
IE O'Brien,NZ,Pace,2008-10-25,Mirpur,Bangladesh,2008,1,31,79,3,1,137,265,6,106,186,3,22.833333333333332,<=30,BAN,Away,Upto 2014
IE O'Brien,NZ,Pace,2008-11-20,Brisbane,Australia,2008,2,102,216,4,1,700,1373,36,598,1157,32,19.444444444444443,<=30,AUS,Away,Upto 2014
IE O'Brien,NZ,Pace,2008-11-28,Adelaide,Australia,2008,1,111,186,3,1,688,1276,20,577,1090,17,34.4,>30,AUS,Away,Upto 2014
IE O'Brien,NZ,Pace,2008-12-11,Dunedin,New Zealand,2008,1,46,90,1,1,619,1080,13,573,990,12,47.61538461538461,>30,NZ,Home,Upto 2014
IE O'Brien,NZ,Pace,2008-12-19,Napier,New Zealand,2008,2,165,300,7,1,774,1324,23,609,1024,16,33.65217391304348,>30,NZ,Home,Upto 2014
IE O'Brien,NZ,Pace,2009-03-18,Hamilton,New Zealand,2009,1,103,198,3,1,743,1246,14,640,1048,11,53.07142857142857,>30,NZ,Home,Upto 2014
IE O'Brien,NZ,Pace,2009-03-26,Napier,New Zealand,2009,2,160,275,2,1,682,1265,13,522,990,11,52.46153846153846,>30,NZ,Home,Upto 2014
IE O'Brien,NZ,Pace,2009-04-03,Wellington,New Zealand,2009,2,189,282,4,1,869,1366,23,680,1084,19,37.78260869565217,>30,NZ,Home,Upto 2014
IE O'Brien,NZ,Pace,2009-08-18,Galle,Sri Lanka,2009,2,170,174,3,1,541,798,16,371,624,13,33.8125,>30,SL,Away,Upto 2014
IE O'Brien,NZ,Pace,2009-08-26,Colombo (SSC),Sri Lanka,2009,2,150,224,3,1,574,917,8,424,693,5,71.75,>30,SL,Away,Upto 2014
IE O'Brien,NZ,Pace,2009-11-24,Dunedin,New Zealand,2009,2,161,264,3,1,862,1655,33,701,1391,30,26.12121212121212,<=30,NZ,Home,Upto 2014
IE O'Brien,NZ,Pace,2009-12-03,Wellington,New Zealand,2009,2,144,267,6,1,635,1257,30,491,990,24,21.166666666666668,<=30,NZ,Home,Upto 2014
IE O'Brien,NZ,Pace,2009-12-11,Napier,New Zealand,2009,2,143,330,6,1,858,1683,18,715,1353,12,47.666666666666664,>30,NZ,Home,Upto 2014
IG Butler,NZ,Pace,2002-03-13,Christchurch,New Zealand,2002,2,196,234,5,1,1052,1583,35,856,1349,30,30.057142857142857,>30,NZ,Home,Upto 2014
IG Butler,NZ,Pace,2002-03-21,Wellington,New Zealand,2002,2,92,147,4,1,587,1212,18,495,1065,14,32.611111111111114,>30,NZ,Home,Upto 2014
IG Butler,NZ,Pace,2002-06-21,Bridgetown,West Indies,2002,2,84,150,4,1,787,1616,30,703,1466,26,26.233333333333334,<=30,WI,Away,Upto 2014
IG Butler,NZ,Pace,2002-06-28,St George's,West Indies,2002,1,83,126,1,1,623,1356,15,540,1230,14,41.53333333333333,>30,WI,Away,Upto 2014
IG Butler,NZ,Pace,2003-10-16,Mohali,India,2003,2,128,240,1,1,470,1014,9,342,774,8,52.22222222222222,>30,IND,Away,Upto 2014
IG Butler,NZ,Pace,2003-12-19,Hamilton,New Zealand,2003,1,113,142,2,1,863,1591,23,750,1449,21,37.52173913043478,>30,NZ,Home,Upto 2014
IG Butler,NZ,Pace,2003-12-26,Wellington,New Zealand,2003,2,146,233,7,1,696,1646,29,550,1413,22,24.0,<=30,NZ,Home,Upto 2014
IG Butler,NZ,Pace,2004-10-19,Dhaka,Bangladesh,2004,2,42,96,0,1,301,659,9,259,563,9,33.44444444444444,>30,BAN,Away,Upto 2014
IJ Jones,ENG,Pace,1964-01-21,Brabourne,India,1964,2,79,144,0,1,366,747,11,287,603,11,33.27272727272727,>30,IND,Away,Upto 2014
IJ Jones,ENG,Pace,1965-12-30,Melbourne,Australia,1965,2,184,352,4,1,657,1479,19,473,1127,15,34.578947368421055,>30,AUS,Away,Upto 2014
IJ Jones,ENG,Pace,1966-01-07,Sydney,Australia,1966,2,86,216,2,1,445,1015,16,359,799,14,27.8125,<=30,AUS,Away,Upto 2014
IJ Jones,ENG,Pace,1966-01-28,Adelaide,Australia,1966,1,118,232,6,1,581,1367,21,463,1135,15,27.666666666666668,<=30,AUS,Away,Upto 2014
IJ Jones,ENG,Pace,1966-02-11,Melbourne,Australia,1966,1,145,232,3,1,701,1506,15,556,1274,12,46.733333333333334,>30,AUS,Away,Upto 2014
IJ Jones,ENG,Pace,1966-02-25,Christchurch,New Zealand,1966,2,84,214,4,1,629,1668,27,545,1454,23,23.296296296296298,<=30,NZ,Away,Upto 2014
IJ Jones,ENG,Pace,1966-03-04,Dunedin,New Zealand,1966,2,78,246,5,1,364,1194,18,286,948,13,20.22222222222222,<=30,NZ,Away,Upto 2014
IJ Jones,ENG,Pace,1966-03-11,Auckland,New Zealand,1966,2,80,276,5,1,459,1620,21,379,1344,16,21.857142857142858,<=30,NZ,Away,Upto 2014
IJ Jones,ENG,Pace,1966-06-02,Manchester,England,1966,1,100,168,0,1,402,732,5,302,564,5,80.4,>30,ENG,Home,Upto 2014
IJ Jones,ENG,Pace,1966-06-16,Lord's,England,1966,2,159,276,1,1,864,1752,24,705,1476,23,36.0,>30,ENG,Home,Upto 2014
IJ Jones,ENG,Pace,1968-01-19,Port of Spain,West Indies,1968,2,95,204,4,1,435,1007,15,340,803,11,29.0,<=30,WI,Away,Upto 2014
IJ Jones,ENG,Pace,1968-02-08,Kingston,West Indies,1968,2,129,265,5,1,570,1419,25,441,1154,20,22.8,<=30,WI,Away,Upto 2014
IJ Jones,ENG,Pace,1968-02-29,Bridgetown,West Indies,1968,2,109,193,1,1,595,1213,17,486,1020,16,35.0,>30,WI,Away,Upto 2014
IJ Jones,ENG,Pace,1968-03-14,Port of Spain,West Indies,1968,2,128,240,2,1,441,768,6,313,528,4,73.5,>30,WI,Away,Upto 2014
IJ Jones,ENG,Pace,1968-03-28,Georgetown,West Indies,1968,2,195,288,2,1,579,1118,16,384,830,14,36.1875,>30,WI,Away,Upto 2014
IJ Siedle,SA,Spin,1931-02-21,Durban,South Africa,1931,1,7,19,1,1,436,1147,20,429,1128,19,21.8,<=30,SA,Home,Upto 2014
IJL Trott,ENG,Pace,2009-12-16,Centurion,South Africa,2009,1,9,12,0,1,848,1757,22,839,1745,22,38.54545454545455,>30,SA,Away,Upto 2014
IJL Trott,ENG,Pace,2009-12-26,Durban,South Africa,2009,1,19,24,0,1,616,1251,15,597,1227,15,41.06666666666667,>30,SA,Away,Upto 2014
IJL Trott,ENG,Pace,2010-01-03,Cape Town,South Africa,2010,1,30,30,0,1,868,1767,26,838,1737,26,33.38461538461539,>30,SA,Away,Upto 2014
IJL Trott,ENG,Pace,2010-03-12,Chattogram,Bangladesh,2010,1,5,12,0,1,497,924,10,492,912,10,49.7,>30,BAN,Away,Upto 2014
IJL Trott,ENG,Pace,2010-05-27,Lord's,England,2010,2,23,36,1,1,777,1274,20,754,1238,19,38.85,>30,ENG,Home,Upto 2014
IJL Trott,ENG,Pace,2011-05-26,Cardiff,England,2011,1,29,36,0,1,591,1108,14,562,1072,14,42.214285714285715,>30,ENG,Home,Upto 2014
IJL Trott,ENG,Pace,2011-06-03,Lord's,England,2011,1,5,24,1,1,1032,1597,21,1027,1573,20,49.142857142857146,>30,ENG,Home,Upto 2014
IJL Trott,ENG,Pace,2011-06-16,Southampton,England,2011,1,24,18,0,1,719,1308,21,695,1290,21,34.23809523809524,>30,ENG,Home,Upto 2014
IJL Trott,ENG,Pace,2011-07-21,Lord's,England,2011,2,23,48,0,1,813,1712,30,790,1664,30,27.1,<=30,ENG,Home,Upto 2014
IJL Trott,ENG,Pace,2011-07-29,Nottingham,England,2011,1,18,24,0,1,899,1645,37,881,1621,37,24.2972972972973,<=30,ENG,Home,Upto 2014
IJL Trott,ENG,Pace,2012-01-17,Dubai (DICS),UAE,2012,1,16,48,1,1,389,864,11,373,816,10,35.36363636363637,>30,UAE,Away,Upto 2014
IJL Trott,ENG,Pace,2012-01-25,Abu Dhabi,UAE,2012,1,12,12,0,1,271,622,9,259,610,9,30.11111111111111,>30,UAE,Away,Upto 2014
IJL Trott,ENG,Pace,2012-02-03,Dubai (DICS),UAE,2012,1,14,12,0,1,298,715,15,284,703,15,19.866666666666667,<=30,UAE,Away,Upto 2014
IJL Trott,ENG,Pace,2012-05-17,Lord's,England,2012,2,21,48,0,1,939,1916,29,918,1868,29,32.37931034482759,>30,ENG,Home,Upto 2014
IJL Trott,ENG,Pace,2012-05-25,Nottingham,England,2012,1,24,30,0,1,765,1507,24,741,1477,24,31.875,>30,ENG,Home,Upto 2014
IJL Trott,ENG,Pace,2012-06-07,Birmingham,England,2012,1,21,48,0,1,443,825,14,422,777,14,31.642857142857142,>30,ENG,Home,Upto 2014
IJL Trott,ENG,Pace,2012-07-19,The Oval,England,2012,1,12,24,0,1,900,1787,18,888,1763,18,50.0,>30,ENG,Home,Upto 2014
IJL Trott,ENG,Pace,2012-08-02,Leeds,England,2012,1,9,30,0,1,982,1920,23,973,1890,23,42.69565217391305,>30,ENG,Home,Upto 2014
IJL Trott,ENG,Pace,2012-08-16,Lord's,England,2012,2,25,60,0,1,927,1840,33,902,1780,33,28.09090909090909,<=30,ENG,Home,Upto 2014
IJL Trott,ENG,Pace,2012-12-13,Nagpur,India,2012,1,2,6,0,1,243,612,7,241,606,7,34.714285714285715,>30,IND,Away,Upto 2014
IJL Trott,ENG,Pace,2013-03-06,Dunedin,New Zealand,2013,1,4,12,0,1,764,1468,18,760,1456,18,42.44444444444444,>30,NZ,Away,Upto 2014
IJL Trott,ENG,Pace,2013-03-14,Wellington,New Zealand,2013,1,10,18,0,1,612,1184,15,602,1166,15,40.8,>30,NZ,Away,Upto 2014
IJL Trott,ENG,Pace,2013-03-22,Auckland,New Zealand,2013,2,13,42,1,1,822,1793,28,809,1751,27,29.357142857142858,<=30,NZ,Away,Upto 2014
IJL Trott,ENG,Pace,2013-05-16,Lord's,England,2013,1,2,6,0,1,569,1283,36,567,1277,36,15.805555555555555,<=30,ENG,Home,Upto 2014
IJL Trott,ENG,Pace,2013-08-01,Manchester,England,2013,1,6,6,0,1,710,1434,19,704,1428,19,37.36842105263158,>30,ENG,Home,Upto 2014
IJL Trott,ENG,Pace,2013-08-09,Chester-le-Street,England,2013,1,10,18,0,1,823,1578,29,813,1560,29,28.379310344827587,<=30,ENG,Home,Upto 2014
IJL Trott,ENG,Pace,2013-08-21,The Oval,England,2013,1,12,18,1,1,836,1443,25,824,1425,24,33.44,>30,ENG,Home,Upto 2014
IJL Trott,ENG,Pace,2015-04-21,St George's,West Indies,2015,1,2,6,0,1,731,1499,18,729,1493,18,40.611111111111114,>30,WI,Away,After 1965
IK Pathan,IND,Pace,2003-12-12,Adelaide,Australia,2003,2,160,204,1,1,872,1501,19,712,1297,18,45.89473684210526,>30,AUS,Away,Upto 2014
IK Pathan,IND,Pace,2004-01-02,Sydney,Australia,2004,2,106,204,3,1,876,1379,11,770,1175,8,79.63636363636364,>30,AUS,Away,Upto 2014
IK Pathan,IND,Pace,2004-03-28,Multan,Pakistan,2004,2,126,294,6,1,716,1290,10,590,996,4,71.6,>30,PAK,Away,Upto 2014
IK Pathan,IND,Pace,2004-04-05,Lahore,Pakistan,2004,2,132,288,3,1,744,1284,22,612,996,19,33.81818181818182,>30,PAK,Away,Upto 2014
IK Pathan,IND,Pace,2004-04-13,Rawalpindi,Pakistan,2004,2,84,222,3,1,687,1266,18,603,1044,15,38.166666666666664,>30,PAK,Away,Upto 2014
IK Pathan,IND,Pace,2004-10-06,Bengaluru,India,2004,2,100,198,2,1,461,1068,18,361,870,16,25.61111111111111,<=30,IND,Home,Upto 2014
IK Pathan,IND,Pace,2004-10-14,Chennai,India,2004,2,68,144,0,1,378,888,4,310,744,4,94.5,>30,IND,Home,Upto 2014
IK Pathan,IND,Pace,2004-11-28,Eden Gardens,India,2004,2,89,216,3,1,537,1338,17,448,1122,14,31.58823529411765,>30,IND,Home,Upto 2014
IK Pathan,IND,Pace,2004-12-10,Dhaka,Bangladesh,2004,2,96,186,11,1,566,884,20,470,698,9,28.3,<=30,BAN,Away,Upto 2014
IK Pathan,IND,Pace,2004-12-17,Chattogram,Bangladesh,2004,2,118,192,7,1,505,785,14,387,593,7,36.07142857142857,>30,BAN,Away,Upto 2014
IK Pathan,IND,Pace,2005-03-08,Mohali,India,2005,2,138,300,3,1,866,1468,17,728,1168,14,50.94117647058823,>30,IND,Home,Upto 2014
IK Pathan,IND,Pace,2005-03-16,Eden Gardens,India,2005,2,122,180,2,1,678,1069,14,556,889,12,48.42857142857143,>30,IND,Home,Upto 2014
IK Pathan,IND,Pace,2005-03-24,Bengaluru,India,2005,2,150,234,1,1,604,960,8,454,726,7,75.5,>30,IND,Home,Upto 2014
IK Pathan,IND,Pace,2005-09-13,Bulawayo,Zimbabwe,2005,2,111,185,9,1,492,794,18,381,609,9,27.333333333333332,<=30,ZIM,Away,Upto 2014
IK Pathan,IND,Pace,2005-09-20,Harare,Zimbabwe,2005,2,126,206,12,1,559,997,27,433,791,15,20.703703703703702,<=30,ZIM,Away,Upto 2014
IK Pathan,IND,Pace,2005-12-02,Chennai,India,2005,1,43,42,1,1,166,336,6,123,294,5,27.666666666666668,<=30,IND,Home,Upto 2014
IK Pathan,IND,Pace,2005-12-10,Delhi,India,2005,2,72,216,4,1,417,906,10,345,690,6,41.7,>30,IND,Home,Upto 2014
IK Pathan,IND,Pace,2005-12-18,Ahmedabad,India,2005,2,67,114,2,1,356,678,10,289,564,8,35.6,>30,IND,Home,Upto 2014
IK Pathan,IND,Pace,2006-01-13,Lahore,Pakistan,2006,1,133,192,1,1,476,638,4,343,446,3,119.0,>30,PAK,Away,Upto 2014
IK Pathan,IND,Pace,2006-01-21,Faisalabad,Pakistan,2006,2,186,246,1,1,888,1366,17,702,1120,16,52.23529411764706,>30,PAK,Away,Upto 2014
IK Pathan,IND,Pace,2006-01-29,Karachi,Pakistan,2006,2,167,253,6,1,991,1398,31,824,1145,25,31.967741935483872,>30,PAK,Away,Upto 2014
IK Pathan,IND,Pace,2006-03-01,Nagpur,India,2006,2,140,222,5,1,629,1284,22,489,1062,17,28.59090909090909,<=30,IND,Home,Upto 2014
IK Pathan,IND,Pace,2006-03-09,Mohali,India,2006,2,87,204,2,1,422,800,12,335,596,10,35.166666666666664,>30,IND,Home,Upto 2014
IK Pathan,IND,Pace,2006-03-18,Wankhede,India,2006,2,88,180,1,1,416,973,19,328,793,18,21.894736842105264,<=30,IND,Home,Upto 2014
IK Pathan,IND,Pace,2006-06-10,Gros Islet,West Indies,2006,2,93,156,2,1,597,938,8,504,782,6,74.625,>30,WI,Away,Upto 2014
IK Pathan,IND,Pace,2007-12-08,Bengaluru,India,2007,2,110,264,1,1,758,1372,19,648,1108,18,39.89473684210526,>30,IND,Home,Upto 2014
IK Pathan,IND,Pace,2008-01-16,W.A.C.A,Australia,2008,2,117,198,5,1,844,1397,31,727,1199,26,27.225806451612904,<=30,AUS,Away,Upto 2014
IK Pathan,IND,Pace,2008-01-24,Adelaide,Australia,2008,1,112,216,3,1,710,1457,17,598,1241,14,41.76470588235294,>30,AUS,Away,Upto 2014
IK Pathan,IND,Pace,2008-04-03,Ahmedabad,India,2008,1,85,128,0,1,574,946,21,489,818,21,27.333333333333332,<=30,IND,Home,Upto 2014
IM Chappell,AUS,Spin,1964-12-04,Melbourne,Australia,1964,2,80,208,0,1,473,1030,6,393,822,6,78.83333333333333,>30,AUS,Home,Upto 2014
IM Chappell,AUS,Spin,1966-01-28,Adelaide,Australia,1966,2,71,208,0,1,423,991,7,352,783,7,60.42857142857143,>30,AUS,Home,Upto 2014
IM Chappell,AUS,Spin,1966-02-11,Melbourne,Australia,1966,2,72,152,1,1,369,880,3,297,728,2,123.0,>30,AUS,Home,Upto 2014
IM Chappell,AUS,Spin,1966-12-23,Johannesburg,South Africa,1966,2,107,138,2,1,549,1041,11,442,903,9,49.90909090909091,>30,SA,Away,Upto 2014
IM Chappell,AUS,Spin,1966-12-31,Cape Town,South Africa,1966,2,122,312,2,1,643,1501,10,521,1189,8,64.3,>30,SA,Away,Upto 2014
IM Chappell,AUS,Spin,1967-01-20,Durban,South Africa,1967,1,39,42,0,1,209,570,4,170,528,4,52.25,>30,SA,Away,Upto 2014
IM Chappell,AUS,Spin,1967-02-24,Gqeberha,South Africa,1967,1,28,43,1,1,222,502,6,194,459,5,37.0,>30,SA,Away,Upto 2014
IM Chappell,AUS,Spin,1967-12-23,Adelaide,Australia,1967,2,65,120,0,1,620,1381,10,555,1261,10,62.0,>30,AUS,Home,Upto 2014
IM Chappell,AUS,Spin,1967-12-30,Melbourne,Australia,1967,2,21,40,0,1,312,712,11,291,672,11,28.363636363636363,<=30,AUS,Home,Upto 2014
IM Chappell,AUS,Spin,1968-01-19,Brisbane,Australia,1968,2,86,184,1,1,711,2018,22,625,1834,21,32.31818181818182,>30,AUS,Home,Upto 2014
IM Chappell,AUS,Spin,1968-01-26,Sydney,Australia,1968,1,3,8,0,1,552,1735,27,549,1727,27,20.444444444444443,<=30,AUS,Home,Upto 2014
IM Chappell,AUS,Spin,1968-06-06,Manchester,England,1968,2,18,18,0,1,456,1101,19,438,1083,19,24.0,<=30,ENG,Away,Upto 2014
IM Chappell,AUS,Spin,1968-07-25,Leeds,England,1968,2,12,54,0,1,396,1367,16,384,1313,16,24.75,<=30,ENG,Away,Upto 2014
IM Chappell,AUS,Spin,1968-08-22,The Oval,England,1968,1,54,126,1,1,604,1754,22,550,1628,21,27.454545454545453,<=30,ENG,Away,Upto 2014
IM Chappell,AUS,Spin,1968-12-06,Brisbane,Australia,1968,2,31,80,2,1,799,2162,28,768,2082,26,28.535714285714285,<=30,AUS,Home,Upto 2014
IM Chappell,AUS,Spin,1968-12-26,Melbourne,Australia,1968,1,36,72,0,1,459,1287,15,423,1215,15,30.6,>30,AUS,Home,Upto 2014
IM Chappell,AUS,Spin,1969-01-24,Adelaide,Australia,1969,1,50,112,0,1,1020,2021,15,970,1909,15,68.0,>30,AUS,Home,Upto 2014
IM Chappell,AUS,Spin,1969-02-14,Sydney,Australia,1969,2,35,96,1,1,776,1562,17,741,1466,16,45.64705882352941,>30,AUS,Home,Upto 2014
IM Chappell,AUS,Spin,1969-11-04,Brabourne,India,1969,1,7,6,0,1,483,1714,20,476,1708,20,24.15,<=30,IND,Away,Upto 2014
IM Chappell,AUS,Spin,1969-11-28,Delhi,India,1969,1,17,12,0,1,604,1737,30,587,1725,30,20.133333333333333,<=30,IND,Away,Upto 2014
IM Chappell,AUS,Spin,1971-01-21,Melbourne,Australia,1971,1,10,24,1,1,448,1245,9,438,1221,8,49.77777777777778,>30,AUS,Home,Upto 2014
IM Chappell,AUS,Spin,1972-07-13,Nottingham,England,1972,1,26,72,1,1,374,904,5,348,832,4,74.8,>30,ENG,Away,Upto 2014
IM Chappell,AUS,Spin,1972-07-27,Leeds,England,1972,1,1,18,0,1,321,1171,22,320,1153,22,14.590909090909092,<=30,ENG,Away,Upto 2014
IM Chappell,AUS,Spin,1972-12-29,Melbourne,Australia,1972,2,37,64,0,1,666,1379,10,629,1315,10,66.6,>30,AUS,Home,Upto 2014
IM Chappell,AUS,Spin,1973-01-06,Sydney,Australia,1973,1,0,8,0,1,122,273,3,122,265,3,40.666666666666664,>30,AUS,Home,Upto 2014
IM Chappell,AUS,Spin,1973-02-16,Kingston,West Indies,1973,1,30,66,0,1,500,1086,7,470,1020,7,71.42857142857143,>30,WI,Away,Upto 2014
IM Chappell,AUS,Spin,1973-03-09,Bridgetown,West Indies,1973,1,17,48,1,1,470,1314,10,453,1266,9,47.0,>30,WI,Away,Upto 2014
IM Chappell,AUS,Spin,1973-03-23,Port of Spain,West Indies,1973,1,1,12,0,1,758,1913,26,757,1901,26,29.153846153846153,<=30,WI,Away,Upto 2014
IM Chappell,AUS,Spin,1973-04-06,Georgetown,West Indies,1973,1,0,6,0,1,241,564,5,241,558,5,48.2,>30,WI,Away,Upto 2014
IM Chappell,AUS,Spin,1973-12-29,Melbourne,Australia,1973,1,3,8,0,1,322,917,12,319,909,12,26.833333333333332,<=30,AUS,Home,Upto 2014
IM Chappell,AUS,Spin,1974-01-05,Sydney,Australia,1974,1,6,24,1,1,161,344,2,155,320,1,80.5,>30,AUS,Home,Upto 2014
IM Chappell,AUS,Spin,1974-01-26,Adelaide,Australia,1974,1,4,8,1,1,351,1069,16,347,1061,15,21.9375,<=30,AUS,Home,Upto 2014
IM Chappell,AUS,Spin,1974-03-01,Wellington,New Zealand,1974,1,8,32,0,1,424,1008,5,416,976,5,84.8,>30,NZ,Away,Upto 2014
IM Chappell,AUS,Spin,1974-12-13,W.A.C.A,Australia,1974,1,10,16,1,1,230,481,6,220,465,5,38.333333333333336,>30,AUS,Home,Upto 2014
IM Chappell,AUS,Spin,1975-01-04,Sydney,Australia,1975,2,22,56,0,1,427,863,11,405,807,11,38.81818181818182,>30,AUS,Home,Upto 2014
IM Chappell,AUS,Spin,1975-01-25,Adelaide,Australia,1975,1,1,8,0,1,485,1136,17,484,1128,17,28.529411764705884,<=30,AUS,Home,Upto 2014
IM Chappell,AUS,Spin,1975-02-08,Melbourne,Australia,1975,1,50,96,0,1,308,798,5,258,702,5,61.6,>30,AUS,Home,Upto 2014
IM Chappell,AUS,Spin,1975-07-31,Lord's,England,1975,1,26,60,1,1,451,980,12,425,920,11,37.583333333333336,>30,ENG,Away,Upto 2014
IM Chappell,AUS,Spin,1975-08-14,Leeds,England,1975,1,4,12,0,1,242,624,11,238,612,11,22.0,<=30,ENG,Away,Upto 2014
IM Chappell,AUS,Spin,1975-08-28,The Oval,England,1975,1,52,102,0,1,533,1243,6,481,1141,6,88.83333333333333,>30,ENG,Away,Upto 2014
IM Chappell,AUS,Spin,1975-12-12,W.A.C.A,Australia,1975,1,0,12,0,1,157,364,1,157,352,1,157.0,>30,AUS,Home,Upto 2014
IM Chappell,AUS,Spin,1975-12-26,Melbourne,Australia,1975,1,7,42,1,1,182,449,4,175,407,3,45.5,>30,AUS,Home,Upto 2014
IM Chappell,AUS,Spin,1976-01-03,Sydney,Australia,1976,1,10,8,0,1,129,289,2,119,281,2,64.5,>30,AUS,Home,Upto 2014
IM Chappell,AUS,Spin,1976-01-23,Adelaide,Australia,1976,2,27,24,1,1,343,701,9,316,677,8,38.111111111111114,>30,AUS,Home,Upto 2014
IM Chappell,AUS,Spin,1976-01-31,Melbourne,Australia,1976,1,10,16,0,1,294,648,6,284,632,6,49.0,>30,AUS,Home,Upto 2014
IM Sinclair,NZ,Spin,1956-02-18,Christchurch,New Zealand,1956,1,79,185,1,1,464,1136,24,385,951,23,19.333333333333332,<=30,NZ,Home,Upto 2014
IM Sinclair,NZ,Spin,1956-03-03,Wellington,New Zealand,1956,1,41,48,0,1,421,1506,19,380,1458,19,22.157894736842106,<=30,NZ,Home,Upto 2014
IP Butchart,ZIM,Pace,1995-02-15,Harare,Zimbabwe,1995,1,11,18,0,1,795,1808,39,784,1790,39,20.384615384615383,<=30,ZIM,Home,Upto 2014
IR Bell,ENG,Pace,2005-07-21,Lord's,England,2005,1,8,6,0,1,726,1256,32,718,1250,32,22.6875,<=30,ENG,Home,Upto 2014
IR Bell,ENG,Pace,2005-08-25,Nottingham,England,2005,1,12,36,0,1,944,1543,26,932,1507,26,36.30769230769231,>30,ENG,Home,Upto 2014
IR Bell,ENG,Pace,2005-11-20,Faisalabad,Pakistan,2005,1,33,42,1,1,802,1439,26,769,1397,25,30.846153846153847,>30,PAK,Away,Upto 2014
IR Bell,ENG,Pace,2005-11-29,Lahore,Pakistan,2005,1,9,12,0,1,870,1496,17,861,1484,17,51.1764705882353,>30,PAK,Away,Upto 2014
IR Bell,ENG,Pace,2006-03-01,Nagpur,India,2006,1,2,6,0,1,629,1284,22,627,1278,22,28.59090909090909,<=30,IND,Away,Upto 2014
IR Bell,ENG,Pace,2006-11-23,Brisbane,Australia,2006,1,12,6,0,1,985,1659,24,973,1653,24,41.041666666666664,>30,AUS,Away,Upto 2014
IR Bishop,WI,Pace,1989-03-25,Georgetown,West Indies,1989,1,15,54,0,1,194,462,4,179,408,4,48.5,>30,WI,Home,Upto 2014
IR Bishop,WI,Pace,1989-04-07,Bridgetown,West Indies,1989,2,142,294,7,1,726,1450,23,584,1156,16,31.565217391304348,>30,WI,Home,Upto 2014
IR Bishop,WI,Pace,1989-04-15,Port of Spain,West Indies,1989,2,97,216,3,1,469,1127,29,372,911,26,16.17241379310345,<=30,WI,Home,Upto 2014
IR Bishop,WI,Pace,1989-04-28,Kingston,West Indies,1989,2,116,258,6,1,590,1241,28,474,983,22,21.071428571428573,<=30,WI,Home,Upto 2014
IR Bishop,WI,Pace,1990-02-24,Kingston,West Indies,1990,2,89,207,4,1,668,1460,29,579,1253,25,23.03448275862069,<=30,WI,Home,Upto 2014
IR Bishop,WI,Pace,1990-03-23,Port of Spain,West Indies,1990,2,100,246,4,1,773,1811,34,673,1565,30,22.735294117647058,<=30,WI,Home,Upto 2014
IR Bishop,WI,Pace,1990-04-05,Bridgetown,West Indies,1990,2,110,267,5,1,1177,2232,37,1067,1965,32,31.81081081081081,>30,WI,Home,Upto 2014
IR Bishop,WI,Pace,1990-04-12,St John's,West Indies,1990,2,120,253,8,1,830,1554,26,710,1301,18,31.923076923076923,>30,WI,Home,Upto 2014
IR Bishop,WI,Pace,1990-11-15,Karachi,Pakistan,1990,2,102,206,3,1,537,1280,27,435,1074,24,19.88888888888889,<=30,PAK,Away,Upto 2014
IR Bishop,WI,Pace,1990-11-23,Faisalabad,Pakistan,1990,2,100,170,6,1,499,862,28,399,692,22,17.821428571428573,<=30,PAK,Away,Upto 2014
IR Bishop,WI,Pace,1990-12-06,Lahore,Pakistan,1990,2,100,254,7,1,541,1248,30,441,994,23,18.033333333333335,<=30,PAK,Away,Upto 2014
IR Bishop,WI,Pace,1992-11-27,Brisbane,Australia,1992,2,109,300,4,1,859,1899,30,750,1599,26,28.633333333333333,<=30,AUS,Away,Upto 2014
IR Bishop,WI,Pace,1992-12-26,Melbourne,Australia,1992,2,129,294,6,1,743,1849,31,614,1555,25,23.967741935483872,<=30,AUS,Away,Upto 2014
IR Bishop,WI,Pace,1993-01-02,Sydney,Australia,1993,2,96,240,2,1,568,1162,8,472,922,6,71.0,>30,AUS,Away,Upto 2014
IR Bishop,WI,Pace,1993-01-23,Adelaide,Australia,1993,2,89,210,3,1,644,1295,29,555,1085,26,22.20689655172414,<=30,AUS,Away,Upto 2014
IR Bishop,WI,Pace,1993-01-30,W.A.C.A,Australia,1993,2,57,162,8,1,518,1062,27,461,900,19,19.185185185185187,<=30,AUS,Away,Upto 2014
IR Bishop,WI,Pace,1993-04-16,Port of Spain,West Indies,1993,2,71,161,6,1,566,1117,30,495,956,24,18.866666666666667,<=30,WI,Home,Upto 2014
IR Bishop,WI,Pace,1993-04-23,Bridgetown,West Indies,1993,2,56,120,1,1,783,1460,25,727,1340,24,31.32,>30,WI,Home,Upto 2014
IR Bishop,WI,Pace,1995-06-08,Leeds,England,1995,2,113,210,7,1,698,1234,27,585,1024,20,25.85185185185185,<=30,ENG,Away,Upto 2014
IR Bishop,WI,Pace,1995-06-22,Lord's,England,1995,2,89,234,4,1,1000,2102,38,911,1868,34,26.31578947368421,<=30,ENG,Away,Upto 2014
IR Bishop,WI,Pace,1995-07-06,Birmingham,England,1995,2,47,116,7,1,511,986,26,464,870,19,19.653846153846153,<=30,ENG,Away,Upto 2014
IR Bishop,WI,Pace,1995-07-27,Manchester,England,1995,2,121,246,3,1,744,1375,26,623,1129,23,28.615384615384617,<=30,ENG,Away,Upto 2014
IR Bishop,WI,Pace,1995-08-10,Nottingham,England,1995,2,112,307,5,1,678,1465,22,566,1158,17,30.818181818181817,>30,ENG,Away,Upto 2014
IR Bishop,WI,Pace,1995-08-24,The Oval,England,1995,2,167,342,1,1,1059,1992,20,892,1650,19,52.95,>30,ENG,Away,Upto 2014
IR Bishop,WI,Pace,1996-04-19,Bridgetown,West Indies,1996,2,103,174,4,1,918,1755,25,815,1581,21,36.72,>30,WI,Home,Upto 2014
IR Bishop,WI,Pace,1996-04-27,St John's,West Indies,1996,2,115,201,3,1,915,1920,26,800,1719,23,35.19230769230769,>30,WI,Home,Upto 2014
IR Bishop,WI,Pace,1996-11-22,Brisbane,Australia,1996,2,154,258,6,1,925,1944,28,771,1686,22,33.035714285714285,>30,AUS,Away,Upto 2014
IR Bishop,WI,Pace,1996-11-29,Sydney,Australia,1996,2,109,258,5,1,754,1620,23,645,1362,18,32.78260869565217,>30,AUS,Away,Upto 2014
IR Bishop,WI,Pace,1996-12-26,Melbourne,Australia,1996,2,57,126,2,1,553,1299,28,496,1173,26,19.75,<=30,AUS,Away,Upto 2014
IR Bishop,WI,Pace,1997-01-25,Adelaide,Australia,1997,1,92,204,2,1,488,1017,11,396,813,9,44.36363636363637,>30,AUS,Away,Upto 2014
IR Bishop,WI,Pace,1997-02-01,W.A.C.A,Australia,1997,2,98,183,5,1,699,1242,25,601,1059,20,27.96,<=30,AUS,Away,Upto 2014
IR Bishop,WI,Pace,1997-03-06,Kingston,West Indies,1997,1,62,149,3,1,612,1409,17,550,1260,14,36.0,>30,WI,Home,Upto 2014
IR Bishop,WI,Pace,1997-03-27,Bridgetown,West Indies,1997,2,92,239,7,1,738,1569,38,646,1330,31,19.42105263157895,<=30,WI,Home,Upto 2014
IR Bishop,WI,Pace,1997-04-04,St John's,West Indies,1997,1,47,96,0,1,268,546,4,221,450,4,67.0,>30,WI,Home,Upto 2014
IR Bishop,WI,Pace,1997-04-17,Georgetown,West Indies,1997,1,61,186,2,1,344,855,6,283,669,4,57.333333333333336,>30,WI,Home,Upto 2014
IR Bishop,WI,Pace,1997-06-13,St John's,West Indies,1997,2,73,132,4,1,500,775,20,427,643,16,25.0,<=30,WI,Home,Upto 2014
IR Bishop,WI,Pace,1997-06-20,Kingstown,West Indies,1997,2,112,126,1,1,630,1024,21,518,898,20,30.0,<=30,WI,Home,Upto 2014
IR Bishop,WI,Pace,1997-11-17,Peshawar,Pakistan,1997,1,76,174,3,1,444,1004,18,368,830,15,24.666666666666668,<=30,PAK,Away,Upto 2014
IR Bishop,WI,Pace,1997-11-29,Rawalpindi,Pakistan,1997,1,80,144,1,1,728,1434,26,648,1290,25,28.0,<=30,PAK,Away,Upto 2014
IR Bishop,WI,Pace,1997-12-06,Karachi,Pakistan,1997,1,68,90,0,1,528,879,18,460,789,18,29.333333333333332,<=30,PAK,Away,Upto 2014
IR Bishop,WI,Pace,1998-02-27,Georgetown,West Indies,1998,2,38,96,1,1,412,1052,21,374,956,20,19.61904761904762,<=30,WI,Home,Upto 2014
IR Bishop,WI,Pace,1998-03-12,Bridgetown,West Indies,1998,2,125,204,2,1,686,1395,17,561,1191,15,40.35294117647059,>30,WI,Home,Upto 2014
IR Redpath,AUS,Pace,1964-10-02,Chennai,India,1964,1,1,12,0,1,256,741,16,255,729,16,16.0,<=30,IND,Away,Upto 2014
IR Redpath,AUS,Pace,1964-10-24,Karachi,Pakistan,1964,1,14,6,0,1,349,725,11,335,719,11,31.727272727272727,>30,PAK,Away,Upto 2014
IR Redpath,AUS,Pace,1967-01-20,Durban,South Africa,1967,1,13,24,0,1,725,1921,25,712,1897,25,29.0,<=30,SA,Away,Upto 2014
IR Redpath,AUS,Pace,1969-01-24,Adelaide,Australia,1969,1,3,8,0,1,674,1285,19,671,1277,19,35.473684210526315,>30,AUS,Home,Upto 2014
IR Redpath,AUS,Pace,1970-03-05,Gqeberha,South Africa,1970,1,0,6,0,1,887,1974,33,887,1968,33,26.87878787878788,<=30,SA,Away,Upto 2014
IR Redpath,AUS,Pace,1972-12-29,Melbourne,Australia,1972,1,10,8,0,1,925,1467,16,915,1459,16,57.8125,>30,AUS,Home,Upto 2014
IR Siddiqui,IND,Pace,2001-12-03,Mohali,India,2001,2,48,114,1,1,398,794,9,350,680,8,44.22222222222222,>30,IND,Home,Upto 2014
IS Gallage,SL,Pace,1999-11-18,Bulawayo,Zimbabwe,1999,2,77,150,0,1,569,1220,18,492,1070,18,31.61111111111111,>30,ZIM,Away,Upto 2014
IS Madray,WI,Spin,1958-02-05,Port of Spain,West Indies,1958,2,54,114,0,1,477,1223,18,423,1109,18,26.5,<=30,WI,Home,Upto 2014
IS Madray,WI,Spin,1958-03-13,Georgetown,West Indies,1958,2,54,96,0,1,1032,2327,20,978,2231,20,51.6,>30,WI,Home,Upto 2014
IS Sodhi,NZ,Spin,2013-10-09,Chattogram,Bangladesh,2013,2,169,235,3,1,1057,1946,22,888,1711,19,48.04545454545455,>30,BAN,Away,Upto 2014
IS Sodhi,NZ,Spin,2013-10-21,Mirpur,Bangladesh,2013,2,96,197,3,1,460,965,12,364,768,9,38.333333333333336,>30,BAN,Away,Upto 2014
IS Sodhi,NZ,Spin,2013-12-03,Dunedin,New Zealand,2013,2,218,385,4,1,483,925,11,265,540,7,43.90909090909091,>30,NZ,Home,Upto 2014
IS Sodhi,NZ,Spin,2013-12-11,Wellington,New Zealand,2013,1,18,18,0,1,170,312,2,152,294,2,85.0,>30,NZ,Home,Upto 2014
IS Sodhi,NZ,Spin,2013-12-19,Hamilton,New Zealand,2013,1,65,104,1,1,359,765,9,294,661,8,39.888888888888886,>30,NZ,Home,Upto 2014
IS Sodhi,NZ,Spin,2014-02-06,Auckland,New Zealand,2014,2,91,126,0,1,263,390,2,172,264,2,131.5,>30,NZ,Home,After 1965
IS Sodhi,NZ,Spin,2014-06-08,Kingston,West Indies,2014,2,111,162,4,1,767,1332,22,656,1170,18,34.86363636363637,>30,WI,Away,After 1965
IS Sodhi,NZ,Spin,2014-06-16,Port of Spain,West Indies,2014,2,117,127,4,1,468,1009,10,351,882,6,46.8,>30,WI,Away,After 1965
IS Sodhi,NZ,Spin,2014-11-09,Abu Dhabi,UAE,2014,2,228,336,3,1,765,1282,14,537,946,11,54.642857142857146,>30,UAE,Away,After 1965
IS Sodhi,NZ,Spin,2014-11-17,Dubai (DICS),UAE,2014,2,155,360,2,1,778,1523,22,623,1163,20,35.36363636363637,>30,UAE,Away,After 1965
IS Sodhi,NZ,Spin,2014-11-26,Sharjah,UAE,2014,2,158,204,3,1,856,1190,21,698,986,18,40.76190476190476,>30,UAE,Away,After 1965
IS Sodhi,NZ,Spin,2016-07-28,Bulawayo,Zimbabwe,2016,2,120,162,1,1,461,827,6,341,665,5,76.83333333333333,>30,ZIM,Away,After 1965
IS Sodhi,NZ,Spin,2016-08-06,Bulawayo,Zimbabwe,2016,2,79,200,7,1,624,1160,15,545,960,8,41.6,>30,ZIM,Away,After 1965
IS Sodhi,NZ,Spin,2016-09-22,Kanpur,India,2016,2,149,210,3,1,859,1714,26,710,1504,23,33.03846153846154,>30,IND,Away,After 1965
IS Sodhi,NZ,Spin,2018-03-30,Christchurch,New Zealand,2018,2,77,96,0,1,236,508,3,159,412,3,78.66666666666667,>30,NZ,Home,After 1965
IS Sodhi,NZ,Spin,2018-11-16,Abu Dhabi,UAE,2018,2,78,132,3,1,468,1015,21,390,883,18,22.285714285714285,<=30,UAE,Away,After 1965
IS Sodhi,NZ,Spin,2018-11-24,Dubai (DICS),UAE,2018,1,63,132,0,1,473,968,16,410,836,16,29.5625,<=30,UAE,Away,After 1965
IS Sodhi,NZ,Spin,2022-12-26,Karachi,Pakistan,2022,2,173,347,8,1,1086,2053,24,913,1706,16,45.25,>30,PAK,Away,After 1965
IS Sodhi,NZ,Spin,2023-01-02,Karachi,Pakistan,2023,2,154,270,5,1,805,1350,21,651,1080,16,38.333333333333336,>30,PAK,Away,After 1965
IS Sodhi,NZ,Spin,2023-11-28,Sylhet,Bangladesh,2023,2,145,198,3,1,883,1678,32,738,1480,29,27.59375,<=30,BAN,Away,After 1965
IS Sodhi,NZ,Spin,2024-11-01,Wankhede,India,2024,1,36,42,1,1,671,1028,34,635,986,33,19.735294117647058,<=30,IND,Away,After 1965
IT Botham,ENG,Pace,1977-07-28,Nottingham,England,1977,2,134,270,5,1,788,1906,27,654,1636,22,29.185185185185187,<=30,ENG,Home,Upto 2014
IT Botham,ENG,Pace,1977-08-11,Leeds,England,1977,2,68,168,5,1,569,1338,25,501,1170,20,22.76,<=30,ENG,Home,Upto 2014
IT Botham,ENG,Pace,1978-02-10,Wellington,New Zealand,1978,2,40,177,4,1,523,1920,38,483,1743,34,13.763157894736842,<=30,NZ,Away,Upto 2014
IT Botham,ENG,Pace,1978-02-24,Christchurch,New Zealand,1978,2,111,255,8,1,664,1812,24,553,1557,16,27.666666666666668,<=30,NZ,Away,Upto 2014
IT Botham,ENG,Pace,1978-03-04,Auckland,New Zealand,1978,2,160,376,5,1,754,2126,17,594,1750,12,44.35294117647059,>30,NZ,Away,Upto 2014
IT Botham,ENG,Pace,1978-06-01,Birmingham,England,1978,2,99,192,1,1,618,1454,19,519,1262,18,32.526315789473685,>30,ENG,Home,Upto 2014
IT Botham,ENG,Pace,1978-06-15,Lord's,England,1978,2,51,155,8,1,397,739,22,346,584,14,18.045454545454547,<=30,ENG,Home,Upto 2014
IT Botham,ENG,Pace,1978-06-29,Leeds,England,1978,1,59,108,4,1,225,754,16,166,646,12,14.0625,<=30,ENG,Home,Upto 2014
IT Botham,ENG,Pace,1978-07-27,The Oval,England,1978,2,104,246,4,1,503,1390,19,399,1144,15,26.473684210526315,<=30,ENG,Home,Upto 2014
IT Botham,ENG,Pace,1978-08-10,Nottingham,England,1978,2,93,270,9,1,554,1523,20,461,1253,11,27.7,<=30,ENG,Home,Upto 2014
IT Botham,ENG,Pace,1978-08-24,Lord's,England,1978,2,140,337,11,1,614,1515,29,474,1178,18,21.17241379310345,<=30,ENG,Home,Upto 2014
IT Botham,ENG,Pace,1978-12-01,Brisbane,Australia,1978,2,135,304,6,1,633,1750,28,498,1446,22,22.607142857142858,<=30,AUS,Away,Upto 2014
IT Botham,ENG,Pace,1978-12-15,W.A.C.A,Australia,1978,2,100,176,0,1,652,1878,31,552,1702,31,21.032258064516128,<=30,AUS,Away,Upto 2014
IT Botham,ENG,Pace,1978-12-29,Melbourne,Australia,1978,2,109,281,6,1,456,1463,27,347,1182,21,16.88888888888889,<=30,AUS,Away,Upto 2014
IT Botham,ENG,Pace,1979-01-06,Sydney,Australia,1979,1,87,224,2,1,452,1414,19,365,1190,17,23.789473684210527,<=30,AUS,Away,Upto 2014
IT Botham,ENG,Pace,1979-01-27,Adelaide,Australia,1979,2,79,204,5,1,561,1654,30,482,1450,25,18.7,<=30,AUS,Away,Upto 2014
IT Botham,ENG,Pace,1979-02-10,Sydney,Australia,1979,1,57,79,4,1,293,735,11,236,656,7,26.636363636363637,<=30,AUS,Away,Upto 2014
IT Botham,ENG,Pace,1979-07-12,Birmingham,England,1979,2,156,330,7,1,689,1489,22,533,1159,15,31.318181818181817,>30,ENG,Home,Upto 2014
IT Botham,ENG,Pace,1979-08-02,Lord's,England,1979,2,115,324,6,1,523,1253,16,408,929,10,32.6875,>30,ENG,Home,Upto 2014
IT Botham,ENG,Pace,1979-08-16,Leeds,England,1979,1,39,78,0,1,293,690,9,254,612,9,32.55555555555556,>30,ENG,Home,Upto 2014
IT Botham,ENG,Pace,1979-08-30,The Oval,England,1979,2,162,342,7,1,700,1610,24,538,1268,17,29.166666666666668,<=30,ENG,Home,Upto 2014
IT Botham,ENG,Pace,1979-12-14,W.A.C.A,Australia,1979,2,176,485,11,1,716,1874,34,540,1389,23,21.058823529411764,<=30,AUS,Away,Upto 2014
IT Botham,ENG,Pace,1980-01-04,Sydney,Australia,1980,2,72,243,4,1,548,1437,28,476,1194,24,19.571428571428573,<=30,AUS,Away,Upto 2014
IT Botham,ENG,Pace,1980-02-01,Melbourne,Australia,1980,2,123,311,4,1,694,1833,26,571,1522,22,26.692307692307693,<=30,AUS,Away,Upto 2014
IT Botham,ENG,Pace,1980-02-15,Wankhede,India,1980,2,106,293,13,1,555,1195,28,449,902,15,19.821428571428573,<=30,IND,Away,Upto 2014
IT Botham,ENG,Pace,1980-06-05,Nottingham,England,1980,2,98,220,4,1,897,2129,36,799,1909,32,24.916666666666668,<=30,ENG,Home,Upto 2014
IT Botham,ENG,Pace,1980-06-19,Lord's,England,1980,1,145,222,3,1,667,1407,18,522,1185,15,37.05555555555556,>30,ENG,Home,Upto 2014
IT Botham,ENG,Pace,1980-07-10,Manchester,England,1980,1,64,120,3,1,678,1412,23,614,1292,20,29.47826086956522,<=30,ENG,Home,Upto 2014
IT Botham,ENG,Pace,1980-07-24,The Oval,England,1980,1,47,110,2,1,630,1595,25,583,1485,23,25.2,<=30,ENG,Home,Upto 2014
IT Botham,ENG,Pace,1980-08-07,Leeds,England,1980,1,31,114,1,1,526,1199,25,495,1085,24,21.04,<=30,ENG,Home,Upto 2014
IT Botham,ENG,Pace,1980-08-28,Lord's,England,1980,2,132,188,1,1,636,1262,19,504,1074,18,33.473684210526315,>30,ENG,Home,Upto 2014
IT Botham,ENG,Pace,1981-02-13,Port of Spain,West Indies,1981,1,113,168,2,1,521,1338,21,408,1170,19,24.80952380952381,<=30,WI,Away,Upto 2014
IT Botham,ENG,Pace,1981-03-13,Bridgetown,West Indies,1981,2,179,325,7,1,801,1640,34,622,1315,27,23.558823529411764,<=30,WI,Away,Upto 2014
IT Botham,ENG,Pace,1981-03-27,St John's,West Indies,1981,1,127,222,4,1,702,1430,20,575,1208,16,35.1,>30,WI,Away,Upto 2014
IT Botham,ENG,Pace,1981-04-10,Kingston,West Indies,1981,1,73,157,2,1,705,1477,22,632,1320,20,32.04545454545455,>30,WI,Away,Upto 2014
IT Botham,ENG,Pace,1981-06-18,Nottingham,England,1981,2,68,161,3,1,571,1418,36,503,1257,33,15.86111111111111,<=30,ENG,Home,Upto 2014
IT Botham,ENG,Pace,1981-07-02,Lord's,England,1981,2,81,204,3,1,755,1760,25,674,1556,22,30.2,>30,ENG,Home,Upto 2014
IT Botham,ENG,Pace,1981-07-16,Leeds,England,1981,2,109,278,7,1,892,1859,38,783,1581,31,23.473684210526315,<=30,ENG,Home,Upto 2014
IT Botham,ENG,Pace,1981-07-30,Birmingham,England,1981,2,75,204,6,1,525,1321,25,450,1117,19,21.0,<=30,ENG,Home,Upto 2014
IT Botham,ENG,Pace,1981-08-13,Manchester,England,1981,2,114,254,5,1,887,1850,35,773,1596,30,25.34285714285714,<=30,ENG,Home,Upto 2014
IT Botham,ENG,Pace,1981-08-27,The Oval,England,1981,2,253,534,10,1,972,2088,35,719,1554,25,27.771428571428572,<=30,ENG,Home,Upto 2014
IT Botham,ENG,Pace,1981-11-27,Wankhede,India,1981,2,133,303,9,1,460,1013,28,327,710,19,16.428571428571427,<=30,IND,Away,Upto 2014
IT Botham,ENG,Pace,1981-12-09,Bengaluru,India,1981,1,137,282,2,1,557,1122,12,420,840,10,46.416666666666664,>30,IND,Away,Upto 2014
IT Botham,ENG,Pace,1981-12-23,Delhi,India,1981,1,122,246,2,1,608,1217,15,486,971,13,40.53333333333333,>30,IND,Away,Upto 2014
IT Botham,ENG,Pace,1982-01-01,Eden Gardens,India,1982,2,89,228,2,1,453,960,12,364,732,10,37.75,>30,IND,Away,Upto 2014
IT Botham,ENG,Pace,1982-01-13,Chennai,India,1982,2,112,234,1,1,631,1176,8,519,942,7,78.875,>30,IND,Away,Upto 2014
IT Botham,ENG,Pace,1982-01-30,Kanpur,India,1982,1,67,150,1,1,435,720,7,368,570,6,62.142857142857146,>30,IND,Away,Upto 2014
IT Botham,ENG,Pace,1982-02-17,Colombo (PSS),Sri Lanka,1982,2,65,149,3,1,292,600,11,227,451,8,26.545454545454547,<=30,SL,Away,Upto 2014
IT Botham,ENG,Pace,1982-06-10,Lord's,England,1982,2,149,309,6,1,701,1384,31,552,1075,25,22.612903225806452,<=30,ENG,Home,Upto 2014
IT Botham,ENG,Pace,1982-06-24,Manchester,England,1982,1,86,114,1,1,426,732,7,340,618,6,60.857142857142854,>30,ENG,Home,Upto 2014
IT Botham,ENG,Pace,1982-07-08,The Oval,England,1982,2,85,138,2,1,668,1272,12,583,1134,10,55.666666666666664,>30,ENG,Home,Upto 2014
IT Botham,ENG,Pace,1982-07-29,Birmingham,England,1982,2,156,270,6,1,641,1313,30,485,1043,24,21.366666666666667,<=30,ENG,Home,Upto 2014
IT Botham,ENG,Pace,1982-08-12,Lord's,England,1982,2,178,306,3,1,700,1644,21,522,1338,18,33.333333333333336,>30,ENG,Home,Upto 2014
IT Botham,ENG,Pace,1982-08-26,Leeds,England,1982,2,144,329,9,1,717,1887,34,573,1558,25,21.08823529411765,<=30,ENG,Home,Upto 2014
IT Botham,ENG,Pace,1982-11-12,W.A.C.A,Australia,1982,2,138,276,2,1,850,1760,19,712,1484,17,44.73684210526316,>30,AUS,Away,Upto 2014
IT Botham,ENG,Pace,1982-11-26,Brisbane,Australia,1982,2,175,227,3,1,686,1313,27,511,1086,24,25.40740740740741,<=30,AUS,Away,Upto 2014
IT Botham,ENG,Pace,1982-12-10,Adelaide,Australia,1982,2,157,281,5,1,666,1305,27,509,1024,22,24.666666666666668,<=30,AUS,Away,Upto 2014
IT Botham,ENG,Pace,1982-12-26,Melbourne,Australia,1982,2,149,259,3,1,837,1586,32,688,1327,29,26.15625,<=30,AUS,Away,Upto 2014
IT Botham,ENG,Pace,1983-01-02,Sydney,Australia,1983,2,110,240,5,1,595,1175,21,485,935,16,28.333333333333332,<=30,AUS,Away,Upto 2014
IT Botham,ENG,Pace,1983-07-14,The Oval,England,1983,2,79,120,4,1,726,1662,20,647,1542,16,36.3,>30,ENG,Home,Upto 2014
IT Botham,ENG,Pace,1983-07-28,Leeds,England,1983,2,85,157,0,1,786,1782,32,701,1625,32,24.5625,<=30,ENG,Home,Upto 2014
IT Botham,ENG,Pace,1983-08-11,Lord's,England,1983,2,70,166,5,1,667,1618,29,597,1452,24,23.0,<=30,ENG,Home,Upto 2014
IT Botham,ENG,Pace,1983-08-25,Nottingham,England,1983,2,106,234,1,1,763,1600,21,657,1366,20,36.333333333333336,>30,ENG,Home,Upto 2014
IT Botham,ENG,Pace,1984-01-20,Wellington,New Zealand,1984,2,196,382,6,1,1002,2037,24,806,1655,18,41.75,>30,NZ,Away,Upto 2014
IT Botham,ENG,Pace,1984-02-03,Christchurch,New Zealand,1984,1,88,102,1,1,404,927,25,316,825,24,16.16,<=30,NZ,Away,Upto 2014
IT Botham,ENG,Pace,1984-02-10,Auckland,New Zealand,1984,1,70,174,0,1,656,1758,12,586,1584,12,54.666666666666664,>30,NZ,Away,Upto 2014
IT Botham,ENG,Pace,1984-03-02,Karachi,Pakistan,1984,1,90,180,2,1,284,740,10,194,560,8,28.4,<=30,PAK,Away,Upto 2014
IT Botham,ENG,Pace,1984-06-14,Birmingham,England,1984,1,127,204,1,1,672,1256,23,545,1052,22,29.217391304347824,<=30,ENG,Home,Upto 2014
IT Botham,ENG,Pace,1984-06-28,Lord's,England,1984,2,220,287,8,1,986,1843,27,766,1556,19,36.51851851851852,>30,ENG,Home,Upto 2014
IT Botham,ENG,Pace,1984-07-12,Leeds,England,1984,1,45,42,0,1,659,1294,24,614,1252,24,27.458333333333332,<=30,ENG,Home,Upto 2014
IT Botham,ENG,Pace,1984-07-26,Manchester,England,1984,1,100,174,2,1,536,1172,18,436,998,16,29.77777777777778,<=30,ENG,Home,Upto 2014
IT Botham,ENG,Pace,1984-08-09,The Oval,England,1984,2,175,273,8,1,809,1686,40,634,1413,32,20.225,<=30,ENG,Home,Upto 2014
IT Botham,ENG,Pace,1984-08-23,Lord's,England,1984,2,204,336,7,1,850,1633,19,646,1297,12,44.73684210526316,>30,ENG,Home,Upto 2014
IT Botham,ENG,Pace,1985-06-13,Leeds,England,1985,2,193,373,7,1,1140,1931,28,947,1558,21,40.714285714285715,>30,ENG,Home,Upto 2014
IT Botham,ENG,Pace,1985-06-27,Lord's,England,1985,2,158,234,7,1,753,1358,25,595,1124,18,30.12,>30,ENG,Home,Upto 2014
IT Botham,ENG,Pace,1985-07-11,Nottingham,England,1985,1,107,206,3,1,706,1344,15,599,1138,12,47.06666666666667,>30,ENG,Home,Upto 2014
IT Botham,ENG,Pace,1985-08-01,Manchester,England,1985,2,129,228,4,1,622,1074,12,493,846,8,51.833333333333336,>30,ENG,Home,Upto 2014
IT Botham,ENG,Pace,1985-08-15,Birmingham,England,1985,2,160,247,4,1,829,1344,20,669,1097,16,41.45,>30,ENG,Home,Upto 2014
IT Botham,ENG,Pace,1985-08-29,The Oval,England,1985,2,108,222,6,1,567,1067,25,459,845,19,22.68,<=30,ENG,Home,Upto 2014
IT Botham,ENG,Pace,1986-02-21,Kingston,West Indies,1986,1,67,114,2,1,543,1027,29,476,913,27,18.724137931034484,<=30,WI,Away,Upto 2014
IT Botham,ENG,Pace,1986-03-07,Port of Spain,West Indies,1986,1,68,58,1,1,694,1180,22,626,1122,21,31.545454545454547,>30,WI,Away,Upto 2014
IT Botham,ENG,Pace,1986-03-21,Bridgetown,West Indies,1986,1,80,144,1,1,585,983,28,505,839,27,20.892857142857142,<=30,WI,Away,Upto 2014
IT Botham,ENG,Pace,1986-04-03,Port of Spain,West Indies,1986,2,95,163,5,1,614,1036,27,519,873,22,22.74074074074074,<=30,WI,Away,Upto 2014
IT Botham,ENG,Pace,1986-04-11,St John's,West Indies,1986,2,225,330,2,1,906,1622,22,681,1292,20,41.18181818181818,>30,WI,Away,Upto 2014
IT Botham,ENG,Pace,1986-08-21,The Oval,England,1986,2,82,156,3,1,479,811,12,397,655,9,39.916666666666664,>30,ENG,Home,Upto 2014
IT Botham,ENG,Pace,1986-11-14,Brisbane,Australia,1986,2,92,168,3,1,755,1483,27,663,1315,24,27.962962962962962,<=30,AUS,Away,Upto 2014
IT Botham,ENG,Pace,1986-11-28,W.A.C.A,Australia,1986,2,85,176,1,1,963,1802,22,878,1626,21,43.77272727272727,>30,AUS,Away,Upto 2014
IT Botham,ENG,Pace,1986-12-26,Melbourne,Australia,1986,2,60,138,5,1,497,1065,22,437,927,17,22.59090909090909,<=30,AUS,Away,Upto 2014
IT Botham,ENG,Pace,1987-01-10,Sydney,Australia,1987,2,59,156,0,1,483,1157,14,424,1001,14,34.5,>30,AUS,Away,Upto 2014
IT Botham,ENG,Pace,1987-06-04,Manchester,England,1987,1,29,84,1,1,470,978,11,441,894,10,42.72727272727273,>30,ENG,Home,Upto 2014
IT Botham,ENG,Pace,1987-07-23,Birmingham,England,1987,2,187,411,3,1,1037,2130,29,850,1719,26,35.758620689655174,>30,ENG,Home,Upto 2014
IT Botham,ENG,Pace,1987-08-06,The Oval,England,1987,1,217,312,3,1,607,1188,10,390,876,7,60.7,>30,ENG,Home,Upto 2014
IT Botham,ENG,Pace,1989-07-06,Birmingham,England,1989,1,75,156,1,1,670,1413,17,595,1257,16,39.411764705882355,>30,ENG,Home,Upto 2014
IT Botham,ENG,Pace,1989-07-27,Manchester,England,1989,1,63,144,2,1,673,1605,23,610,1461,21,29.26086956521739,<=30,ENG,Home,Upto 2014
IT Botham,ENG,Pace,1989-08-10,Nottingham,England,1989,1,103,180,0,1,695,1373,18,592,1193,18,38.611111111111114,>30,ENG,Home,Upto 2014
IT Botham,ENG,Pace,1991-08-08,The Oval,England,1991,2,67,162,3,1,826,1668,26,759,1506,23,31.76923076923077,>30,ENG,Home,Upto 2014
IT Botham,ENG,Pace,1991-08-22,Lord's,England,1991,2,41,96,1,1,770,1537,23,729,1441,22,33.47826086956522,>30,ENG,Home,Upto 2014
IT Botham,ENG,Pace,1992-02-06,Wellington,New Zealand,1992,2,76,132,3,1,603,1369,15,527,1237,12,40.2,>30,NZ,Away,Upto 2014
IT Botham,ENG,Pace,1992-06-04,Birmingham,England,1992,1,52,114,0,1,641,1086,9,589,972,9,71.22222222222223,>30,ENG,Home,Upto 2014
IT Botham,ENG,Pace,1992-06-18,Lord's,England,1992,1,9,30,0,1,607,1221,26,598,1191,26,23.346153846153847,<=30,ENG,Home,Upto 2014
IVA Richards,WI,Spin,1975-01-23,Wankhede,India,1975,1,10,42,0,1,833,1734,13,823,1692,13,64.07692307692308,>30,IND,Away,Upto 2014
IVA Richards,WI,Spin,1975-03-01,Karachi,Pakistan,1975,1,17,72,1,1,404,1072,11,387,1000,10,36.72727272727273,>30,PAK,Away,Upto 2014
IVA Richards,WI,Spin,1975-12-26,Melbourne,Australia,1975,1,2,8,0,1,182,449,4,180,441,4,45.5,>30,AUS,Away,Upto 2014
IVA Richards,WI,Spin,1976-01-03,Sydney,Australia,1976,1,4,1,0,1,129,289,2,125,288,2,64.5,>30,AUS,Away,Upto 2014
IVA Richards,WI,Spin,1976-01-31,Melbourne,Australia,1976,1,38,56,0,1,294,648,6,256,592,6,49.0,>30,AUS,Away,Upto 2014
IVA Richards,WI,Spin,1976-03-24,Port of Spain,West Indies,1976,1,17,36,0,1,529,1608,16,512,1572,16,33.0625,>30,WI,Home,Upto 2014
IVA Richards,WI,Spin,1976-06-03,Nottingham,England,1976,2,15,36,0,1,293,652,6,278,616,6,48.833333333333336,>30,ENG,Away,Upto 2014
IVA Richards,WI,Spin,1976-08-12,The Oval,England,1976,2,41,150,1,1,635,1217,8,594,1067,7,79.375,>30,ENG,Away,Upto 2014
IVA Richards,WI,Spin,1977-02-18,Bridgetown,West Indies,1977,2,19,30,0,1,180,418,4,161,388,4,45.0,>30,WI,Home,Upto 2014
IVA Richards,WI,Spin,1977-03-04,Port of Spain,West Indies,1977,1,27,72,0,1,450,1050,10,423,978,10,45.0,>30,WI,Home,Upto 2014
IVA Richards,WI,Spin,1977-03-18,Georgetown,West Indies,1977,1,11,30,0,1,174,438,6,163,408,6,29.0,<=30,WI,Home,Upto 2014
IVA Richards,WI,Spin,1977-04-01,Port of Spain,West Indies,1977,1,34,111,2,1,392,967,20,358,856,18,19.6,<=30,WI,Home,Upto 2014
IVA Richards,WI,Spin,1980-01-26,Adelaide,Australia,1980,1,7,12,0,1,228,426,5,221,414,5,45.6,>30,AUS,Away,Upto 2014
IVA Richards,WI,Spin,1980-06-05,Nottingham,England,1980,1,9,6,0,1,25,48,0,16,42,0,inf,>30,ENG,Away,Upto 2014
IVA Richards,WI,Spin,1980-06-19,Lord's,England,1980,2,25,36,0,1,206,362,3,181,326,3,68.66666666666667,>30,ENG,Away,Upto 2014
IVA Richards,WI,Spin,1980-07-10,Manchester,England,1980,1,31,96,0,1,55,171,3,24,75,3,18.333333333333332,<=30,ENG,Away,Upto 2014
IVA Richards,WI,Spin,1980-07-24,The Oval,England,1980,2,20,72,0,1,102,312,2,82,240,2,51.0,>30,ENG,Away,Upto 2014
IVA Richards,WI,Spin,1980-08-07,Leeds,England,1980,1,0,6,0,1,25,42,1,25,36,1,25.0,<=30,ENG,Away,Upto 2014
IVA Richards,WI,Spin,1980-11-24,Lahore,Pakistan,1980,2,51,108,3,1,274,622,12,223,514,9,22.833333333333332,<=30,PAK,Away,Upto 2014
IVA Richards,WI,Spin,1980-12-08,Faisalabad,Pakistan,1980,1,0,2,1,1,460,1075,25,460,1073,24,18.4,<=30,PAK,Away,Upto 2014
IVA Richards,WI,Spin,1980-12-22,Karachi,Pakistan,1980,1,10,48,0,1,122,421,6,112,373,6,20.333333333333332,<=30,PAK,Away,Upto 2014
IVA Richards,WI,Spin,1981-02-13,Port of Spain,West Indies,1981,2,25,102,1,1,213,606,8,188,504,7,26.625,<=30,WI,Home,Upto 2014
IVA Richards,WI,Spin,1981-03-13,Bridgetown,West Indies,1981,1,24,102,2,1,149,390,2,125,288,0,74.5,>30,WI,Home,Upto 2014
IVA Richards,WI,Spin,1981-03-27,St John's,West Indies,1981,2,80,186,1,1,220,600,1,140,414,0,220.0,>30,WI,Home,Upto 2014
IVA Richards,WI,Spin,1981-04-10,Kingston,West Indies,1981,2,77,210,1,1,271,768,4,194,558,3,67.75,>30,WI,Home,Upto 2014
IVA Richards,WI,Spin,1981-12-26,Melbourne,Australia,1981,1,17,30,0,1,78,198,5,61,168,5,15.6,<=30,AUS,Away,Upto 2014
IVA Richards,WI,Spin,1982-01-02,Sydney,Australia,1982,2,54,156,0,1,278,654,13,224,498,13,21.384615384615383,<=30,AUS,Away,Upto 2014
IVA Richards,WI,Spin,1982-01-30,Adelaide,Australia,1982,1,38,108,0,1,305,605,5,267,497,5,61.0,>30,AUS,Away,Upto 2014
IVA Richards,WI,Spin,1983-02-23,Kingston,West Indies,1983,1,0,6,0,1,239,624,5,239,618,5,47.8,>30,WI,Home,Upto 2014
IVA Richards,WI,Spin,1983-03-11,Port of Spain,West Indies,1983,1,14,42,1,1,280,699,7,266,657,6,40.0,>30,WI,Home,Upto 2014
IVA Richards,WI,Spin,1983-03-31,Georgetown,West Indies,1983,1,24,24,0,1,357,630,4,333,606,4,89.25,>30,WI,Home,Upto 2014
IVA Richards,WI,Spin,1983-04-28,St John's,West Indies,1983,2,49,144,0,1,460,934,5,411,790,5,92.0,>30,WI,Home,Upto 2014
IVA Richards,WI,Spin,1983-10-29,Delhi,India,1983,1,8,18,0,1,373,864,8,365,846,8,46.625,>30,IND,Away,Upto 2014
IVA Richards,WI,Spin,1984-03-02,Georgetown,West Indies,1984,2,11,66,0,1,284,720,8,273,654,8,35.5,>30,WI,Home,Upto 2014
IVA Richards,WI,Spin,1984-03-16,Port of Spain,West Indies,1984,2,80,210,3,1,293,601,6,213,391,3,48.833333333333336,>30,WI,Home,Upto 2014
IVA Richards,WI,Spin,1984-04-07,St John's,West Indies,1984,1,7,30,0,1,154,360,2,147,330,2,77.0,>30,WI,Home,Upto 2014
IVA Richards,WI,Spin,1984-04-28,Kingston,West Indies,1984,1,4,12,0,1,133,378,4,129,366,4,33.25,>30,WI,Home,Upto 2014
IVA Richards,WI,Spin,1984-07-26,Manchester,England,1984,1,2,6,0,1,327,823,11,325,817,11,29.727272727272727,<=30,ENG,Away,Upto 2014
IVA Richards,WI,Spin,1984-11-09,W.A.C.A,Australia,1984,1,4,6,0,1,5,12,0,1,6,0,inf,>30,AUS,Away,Upto 2014
IVA Richards,WI,Spin,1984-11-23,Brisbane,Australia,1984,1,1,6,0,1,123,198,2,122,192,2,61.5,>30,AUS,Away,Upto 2014
IVA Richards,WI,Spin,1984-12-22,Melbourne,Australia,1984,2,16,42,1,1,287,501,7,271,459,6,41.0,>30,AUS,Away,Upto 2014
IVA Richards,WI,Spin,1984-12-30,Sydney,Australia,1984,1,11,42,0,1,308,779,16,297,737,16,19.25,<=30,AUS,Away,Upto 2014
IVA Richards,WI,Spin,1985-03-29,Port of Spain,West Indies,1985,2,8,24,0,1,167,462,3,159,438,3,55.666666666666664,>30,WI,Home,Upto 2014
IVA Richards,WI,Spin,1985-04-06,Georgetown,West Indies,1985,1,22,48,0,1,331,798,0,309,750,0,inf,>30,WI,Home,Upto 2014
IVA Richards,WI,Spin,1985-04-26,Bridgetown,West Indies,1985,1,25,78,0,1,111,198,1,86,120,1,111.0,>30,WI,Home,Upto 2014
IVA Richards,WI,Spin,1985-05-04,Kingston,West Indies,1985,1,34,84,1,1,118,270,2,84,186,1,59.0,>30,WI,Home,Upto 2014
IVA Richards,WI,Spin,1986-02-21,Kingston,West Indies,1986,1,0,6,0,1,68,156,1,68,150,1,68.0,>30,WI,Home,Upto 2014
IVA Richards,WI,Spin,1986-03-07,Port of Spain,West Indies,1986,1,7,42,0,1,243,525,10,236,483,10,24.3,<=30,WI,Home,Upto 2014
IVA Richards,WI,Spin,1986-03-21,Bridgetown,West Indies,1986,2,16,42,0,1,197,444,1,181,402,1,197.0,>30,WI,Home,Upto 2014
IVA Richards,WI,Spin,1986-04-11,St John's,West Indies,1986,2,6,30,0,1,237,564,7,231,534,7,33.857142857142854,>30,WI,Home,Upto 2014
IVA Richards,WI,Spin,1986-11-07,Lahore,Pakistan,1986,1,9,30,1,1,133,342,6,124,312,5,22.166666666666668,<=30,PAK,Away,Upto 2014
IVA Richards,WI,Spin,1987-02-20,Wellington,New Zealand,1987,2,118,348,2,1,313,876,9,195,528,7,34.77777777777778,>30,NZ,Away,Upto 2014
IVA Richards,WI,Spin,1987-03-12,Christchurch,New Zealand,1987,1,29,54,0,1,79,120,0,50,66,0,inf,>30,NZ,Away,Upto 2014
IVA Richards,WI,Spin,1987-12-26,Eden Gardens,India,1987,1,39,144,1,1,615,1451,5,576,1307,4,123.0,>30,IND,Away,Upto 2014
IVA Richards,WI,Spin,1988-01-11,Chennai,India,1988,2,64,156,2,1,536,1127,23,472,971,21,23.304347826086957,<=30,IND,Away,Upto 2014
IVA Richards,WI,Spin,1988-04-14,Port of Spain,West Indies,1988,1,17,24,2,1,344,563,11,327,539,9,31.272727272727273,>30,WI,Home,Upto 2014
IVA Richards,WI,Spin,1988-04-22,Bridgetown,West Indies,1988,2,27,78,1,1,257,510,4,230,432,3,64.25,>30,WI,Home,Upto 2014
IVA Richards,WI,Spin,1988-06-02,Nottingham,England,1988,2,28,60,0,1,176,288,2,148,228,2,88.0,>30,ENG,Away,Upto 2014
IVA Richards,WI,Spin,1988-11-18,Brisbane,Australia,1988,2,27,72,0,1,172,348,4,145,276,4,43.0,>30,AUS,Away,Upto 2014
IVA Richards,WI,Spin,1988-12-02,W.A.C.A,Australia,1988,1,43,84,0,1,185,288,3,142,204,3,61.666666666666664,>30,AUS,Away,Upto 2014
IVA Richards,WI,Spin,1988-12-24,Melbourne,Australia,1988,1,12,24,0,1,69,126,0,57,102,0,inf,>30,AUS,Away,Upto 2014
IVA Richards,WI,Spin,1989-01-26,Sydney,Australia,1989,2,80,228,2,1,632,1677,20,552,1449,18,31.6,>30,AUS,Away,Upto 2014
IVA Richards,WI,Spin,1989-02-03,Adelaide,Australia,1989,2,137,294,1,1,439,1030,5,302,736,4,87.8,>30,AUS,Away,Upto 2014
IVA Richards,WI,Spin,1989-03-25,Georgetown,West Indies,1989,1,17,42,0,1,322,618,6,305,576,6,53.666666666666664,>30,WI,Home,Upto 2014
IVA Richards,WI,Spin,1989-04-07,Bridgetown,West Indies,1989,2,34,90,0,1,380,726,8,346,636,8,47.5,>30,WI,Home,Upto 2014
IVA Richards,WI,Spin,1989-04-15,Port of Spain,West Indies,1989,2,41,120,1,1,406,1089,11,365,969,10,36.90909090909091,>30,WI,Home,Upto 2014
IVA Richards,WI,Spin,1989-04-28,Kingston,West Indies,1989,1,36,54,0,1,262,519,4,226,465,4,65.5,>30,WI,Home,Upto 2014
IVA Richards,WI,Spin,1990-02-24,Kingston,West Indies,1990,1,22,54,0,1,69,114,0,47,60,0,inf,>30,WI,Home,Upto 2014
IVA Richards,WI,Spin,1990-04-05,Bridgetown,West Indies,1990,2,25,114,0,1,25,114,0,0,0,0,inf,>30,WI,Home,Upto 2014
IVA Richards,WI,Spin,1991-03-23,Georgetown,West Indies,1991,2,18,30,0,1,331,635,8,313,605,8,41.375,>30,WI,Home,Upto 2014
IVA Richards,WI,Spin,1991-04-19,Bridgetown,West Indies,1991,1,8,18,0,1,121,318,6,113,300,6,20.166666666666668,<=30,WI,Home,Upto 2014
IVA Richards,WI,Spin,1991-04-27,St John's,West Indies,1991,2,75,90,0,1,399,618,7,324,528,7,57.0,>30,WI,Home,Upto 2014
IVA Richards,WI,Spin,1991-06-06,Leeds,England,1991,1,5,24,0,1,16,48,0,11,24,0,inf,>30,ENG,Away,Upto 2014
IVA Richards,WI,Spin,1991-07-04,Nottingham,England,1991,1,1,6,0,1,144,282,3,143,276,3,48.0,>30,ENG,Away,Upto 2014
IW Callen,AUS,Pace,1978-01-28,Adelaide,Australia,1978,2,191,440,6,1,564,1391,22,373,951,16,25.636363636363637,<=30,AUS,Home,Upto 2014
IWG Johnson,AUS,Spin,1946-12-13,Sydney,Australia,1946,2,134,473,8,1,831,1933,19,697,1460,11,43.73684210526316,>30,AUS,Home,Upto 2014
IWG Johnson,AUS,Spin,1947-01-01,Melbourne,Australia,1947,2,52,149,1,1,582,1365,14,530,1216,13,41.57142857142857,>30,AUS,Home,Upto 2014
IWG Johnson,AUS,Spin,1947-01-31,Adelaide,Australia,1947,2,120,376,1,1,672,1532,8,552,1156,7,84.0,>30,AUS,Home,Upto 2014
IWG Johnson,AUS,Spin,1947-11-28,Brisbane,Australia,1947,1,5,24,0,1,180,496,7,175,472,7,25.714285714285715,<=30,AUS,Home,Upto 2014
IWG Johnson,AUS,Spin,1947-12-12,Sydney,Australia,1947,2,44,216,4,1,208,752,16,164,536,12,13.0,<=30,AUS,Home,Upto 2014
IWG Johnson,AUS,Spin,1948-01-01,Melbourne,Australia,1948,2,94,159,8,1,660,1199,23,566,1040,15,28.695652173913043,<=30,AUS,Home,Upto 2014
IWG Johnson,AUS,Spin,1948-01-23,Adelaide,Australia,1948,2,118,345,4,1,689,1465,10,571,1120,6,68.9,>30,AUS,Home,Upto 2014
IWG Johnson,AUS,Spin,1948-06-10,Nottingham,England,1948,2,85,282,1,1,552,1614,15,467,1332,14,36.8,>30,ENG,Away,Upto 2014
IWG Johnson,AUS,Spin,1948-06-24,Lord's,England,1948,2,75,222,3,1,442,1043,11,367,821,8,40.18181818181818,>30,ENG,Away,Upto 2014
IWG Johnson,AUS,Spin,1948-07-08,Manchester,England,1948,2,93,270,0,1,279,893,5,186,623,5,55.8,>30,ENG,Away,Upto 2014
IWG Johnson,AUS,Spin,1948-07-22,Leeds,England,1948,2,174,324,3,1,708,1260,12,534,936,9,59.0,>30,ENG,Away,Upto 2014
IWG Johnson,AUS,Spin,1949-12-24,Johannesburg,South Africa,1949,2,91,258,6,1,426,1143,20,335,885,14,21.3,<=30,SA,Away,Upto 2014
IWG Johnson,AUS,Spin,1949-12-31,Cape Town,South Africa,1949,2,152,288,2,1,803,1732,19,651,1444,17,42.26315789473684,>30,SA,Away,Upto 2014
IWG Johnson,AUS,Spin,1950-01-20,Durban,South Africa,1950,2,72,264,6,1,552,1758,29,480,1494,23,19.03448275862069,<=30,SA,Away,Upto 2014
IWG Johnson,AUS,Spin,1950-02-10,Johannesburg,South Africa,1950,1,52,144,0,1,517,1176,4,465,1032,4,129.25,>30,SA,Away,Upto 2014
IWG Johnson,AUS,Spin,1950-03-03,Gqeberha,South Africa,1950,2,69,144,4,1,463,890,16,394,746,12,28.9375,<=30,SA,Away,Upto 2014
IWG Johnson,AUS,Spin,1950-12-22,Melbourne,Australia,1950,2,43,144,1,1,357,991,20,314,847,19,17.85,<=30,AUS,Home,Upto 2014
IWG Johnson,AUS,Spin,1951-01-05,Sydney,Australia,1951,2,126,328,4,1,426,1236,15,300,908,11,28.4,<=30,AUS,Home,Upto 2014
IWG Johnson,AUS,Spin,1951-02-02,Adelaide,Australia,1951,2,101,326,2,1,793,1857,24,692,1531,22,33.041666666666664,>30,AUS,Home,Upto 2014
IWG Johnson,AUS,Spin,1951-02-23,Melbourne,Australia,1951,2,41,96,0,1,462,1120,13,421,1024,13,35.53846153846154,>30,AUS,Home,Upto 2014
IWG Johnson,AUS,Spin,1951-11-09,Brisbane,Australia,1951,2,68,184,3,1,714,1815,27,646,1631,24,26.444444444444443,<=30,AUS,Home,Upto 2014
IWG Johnson,AUS,Spin,1951-11-30,Sydney,Australia,1951,2,126,296,4,1,842,1964,19,716,1668,15,44.31578947368421,>30,AUS,Home,Upto 2014
IWG Johnson,AUS,Spin,1951-12-22,Adelaide,Australia,1951,1,27,56,0,1,501,1145,26,474,1089,26,19.26923076923077,<=30,AUS,Home,Upto 2014
IWG Johnson,AUS,Spin,1951-12-31,Melbourne,Australia,1951,2,41,96,1,1,557,1523,18,516,1427,17,30.944444444444443,>30,AUS,Home,Upto 2014
IWG Johnson,AUS,Spin,1952-12-05,Brisbane,Australia,1952,2,83,336,4,1,592,1609,17,509,1273,13,34.8235294117647,>30,AUS,Home,Upto 2014
IWG Johnson,AUS,Spin,1954-11-26,Brisbane,Australia,1954,2,84,288,5,1,261,746,11,177,458,6,23.727272727272727,<=30,AUS,Home,Upto 2014
IWG Johnson,AUS,Spin,1954-12-31,Melbourne,Australia,1954,2,45,152,2,1,232,621,10,187,469,8,23.2,<=30,AUS,Home,Upto 2014
IWG Johnson,AUS,Spin,1955-01-28,Adelaide,Australia,1955,1,46,288,2,1,330,1112,11,284,824,9,30.0,<=30,AUS,Home,Upto 2014
IWG Johnson,AUS,Spin,1955-02-25,Sydney,Australia,1955,1,68,160,3,1,313,666,14,245,506,11,22.357142857142858,<=30,AUS,Home,Upto 2014
IWG Johnson,AUS,Spin,1955-04-11,Port of Spain,West Indies,1955,2,98,156,1,1,545,1044,8,447,888,7,68.125,>30,WI,Away,Upto 2014
IWG Johnson,AUS,Spin,1955-04-26,Georgetown,West Indies,1955,2,86,188,8,1,484,1365,24,398,1177,16,20.166666666666668,<=30,WI,Away,Upto 2014
IWG Johnson,AUS,Spin,1955-05-14,Bridgetown,West Indies,1955,2,107,294,3,1,1042,2444,22,935,2150,19,47.36363636363637,>30,WI,Away,Upto 2014
IWG Johnson,AUS,Spin,1955-06-11,Kingston,West Indies,1955,2,115,270,2,1,758,1737,11,643,1467,9,68.9090909090909,>30,WI,Away,Upto 2014
IWG Johnson,AUS,Spin,1956-06-07,Nottingham,England,1956,2,55,156,1,1,279,1027,11,224,871,10,25.363636363636363,<=30,ENG,Away,Upto 2014
IWG Johnson,AUS,Spin,1956-06-21,Lord's,England,1956,1,3,24,0,1,172,625,7,169,601,7,24.571428571428573,<=30,ENG,Away,Upto 2014
IWG Johnson,AUS,Spin,1956-07-12,Leeds,England,1956,1,59,174,1,1,342,1252,22,283,1078,21,15.545454545454545,<=30,ENG,Away,Upto 2014
IWG Johnson,AUS,Spin,1956-07-26,Manchester,England,1956,1,151,282,4,1,491,1434,26,340,1152,22,18.884615384615383,<=30,ENG,Away,Upto 2014
IWG Johnson,AUS,Spin,1956-08-23,The Oval,England,1956,2,35,78,0,1,234,721,10,199,643,10,23.4,<=30,ENG,Away,Upto 2014
IWG Johnson,AUS,Spin,1956-10-11,Karachi,Pakistan,1956,2,66,170,4,1,132,398,5,66,228,1,26.4,<=30,PAK,Away,Upto 2014
IWG Johnson,AUS,Spin,1956-10-19,Chennai,India,1956,2,28,144,1,1,458,1218,19,430,1074,18,24.105263157894736,<=30,IND,Away,Upto 2014
IWG Johnson,AUS,Spin,1956-11-02,Eden Gardens,India,1956,2,50,156,2,1,552,1533,35,502,1377,33,15.771428571428572,<=30,IND,Away,Upto 2014
Ibrahim Zadran,AFG,Pace,2021-03-02,Abu Dhabi,UAE,2021,1,13,12,1,1,239,474,18,226,462,17,13.277777777777779,<=30,UAE,Away,After 1965
Iftikhar Ahmed,PAK,Spin,2016-08-11,The Oval,England,2016,2,13,26,1,1,324,517,8,311,491,7,40.5,>30,ENG,Away,After 1965
Iftikhar Ahmed,PAK,Spin,2019-11-21,Brisbane,Australia,2019,1,53,72,0,1,515,790,8,462,718,8,64.375,>30,AUS,Away,After 1965
Iftikhar Ahmed,PAK,Spin,2019-11-29,Adelaide,Australia,2019,1,75,90,0,1,462,654,5,387,564,5,92.4,>30,AUS,Away,After 1965
Iftikhar Ahmed,PAK,Spin,2022-03-04,Rawalpindi,Pakistan,2022,1,20,18,0,1,676,1285,9,656,1267,9,75.11111111111111,>30,PAK,Home,After 1965
Iftikhar Anjum,PAK,Pace,2006-04-03,Kandy,Sri Lanka,2006,2,62,84,0,1,524,943,20,462,859,20,26.2,<=30,SL,Away,Upto 2014
Ijaz Ahmed,PAK,Pace,1990-02-03,Sydney,Australia,1990,1,3,12,0,1,253,749,11,250,737,11,23.0,<=30,AUS,Away,Upto 2014
Ijaz Ahmed,PAK,Pace,1990-10-10,Karachi,Pakistan,1990,1,9,30,1,1,575,1344,23,566,1314,22,25.0,<=30,PAK,Home,Upto 2014
Ijaz Ahmed,PAK,Pace,1990-10-18,Lahore,Pakistan,1990,1,6,12,0,1,697,1583,26,691,1571,26,26.807692307692307,<=30,PAK,Home,Upto 2014
Ijaz Ahmed,PAK,Pace,1997-04-26,Colombo (SSC),Sri Lanka,1997,1,18,30,0,1,378,693,12,360,663,12,31.5,>30,SL,Away,Upto 2014
Ijaz Ahmed,PAK,Pace,1998-10-15,Peshawar,Pakistan,1998,1,33,84,1,1,690,1183,11,657,1099,10,62.72727272727273,>30,PAK,Home,Upto 2014
Ijaz Ahmed,PAK,Pace,1999-11-05,Brisbane,Australia,1999,1,8,12,0,1,895,1510,23,887,1498,23,38.91304347826087,>30,AUS,Away,Upto 2014
Ijaz Ahmed jnr,PAK,Spin,1995-09-08,Peshawar,Pakistan,1995,1,1,6,0,1,297,708,12,296,702,12,24.75,<=30,PAK,Home,Upto 2014
Ijaz Ahmed jnr,PAK,Spin,1995-09-15,Faisalabad,Pakistan,1995,1,5,18,0,1,624,1381,17,619,1363,17,36.705882352941174,>30,PAK,Home,Upto 2014
Ijaz Faqih,PAK,Spin,1980-12-22,Karachi,Pakistan,1980,1,9,24,0,1,122,421,6,113,397,6,20.333333333333332,<=30,PAK,Home,Upto 2014
Ijaz Faqih,PAK,Spin,1981-11-27,Brisbane,Australia,1981,1,76,132,1,1,312,546,7,236,414,6,44.57142857142857,>30,AUS,Away,Upto 2014
Ijaz Faqih,PAK,Spin,1987-03-04,Ahmedabad,India,1987,1,81,162,1,1,616,1851,11,535,1689,10,56.0,>30,IND,Away,Upto 2014
Ijaz Faqih,PAK,Spin,1988-04-02,Georgetown,West Indies,1988,2,98,174,2,1,306,558,9,208,384,7,34.0,>30,WI,Away,Upto 2014
Ijaz Faqih,PAK,Spin,1988-04-14,Port of Spain,West Indies,1988,2,35,42,0,1,344,563,11,309,521,11,31.272727272727273,>30,WI,Away,Upto 2014
Imam-ul-Haq,PAK,Spin,2022-03-04,Rawalpindi,Pakistan,2022,1,9,12,0,1,676,1285,9,667,1273,9,75.11111111111111,>30,PAK,Home,After 1965
Imran Farhat,PAK,Spin,2004-03-28,Multan,Pakistan,2004,1,31,41,1,1,510,902,13,479,861,12,39.23076923076923,>30,PAK,Home,Upto 2014
Imran Farhat,PAK,Spin,2004-04-13,Rawalpindi,Pakistan,2004,1,69,74,2,1,324,559,10,255,485,8,32.4,>30,PAK,Home,Upto 2014
Imran Farhat,PAK,Spin,2004-12-16,W.A.C.A,Australia,2004,1,53,66,0,1,275,498,5,222,432,5,55.0,>30,AUS,Away,Upto 2014
Imran Farhat,PAK,Spin,2004-12-26,Melbourne,Australia,2004,2,29,48,0,1,412,701,11,383,653,11,37.45454545454545,>30,AUS,Away,Upto 2014
Imran Farhat,PAK,Spin,2006-03-26,Colombo (SSC),Sri Lanka,2006,1,2,6,0,1,538,1125,13,536,1119,13,41.38461538461539,>30,SL,Away,Upto 2014
Imran Farhat,PAK,Spin,2006-07-13,Lord's,England,2006,2,8,12,0,1,515,1101,11,507,1089,11,46.81818181818182,>30,ENG,Away,Upto 2014
Imran Farhat,PAK,Spin,2007-01-11,Centurion,South Africa,2007,1,6,6,0,1,295,739,8,289,733,8,36.875,>30,SA,Away,Upto 2014
Imran Farhat,PAK,Spin,2007-01-19,Gqeberha,South Africa,2007,1,20,42,0,1,226,545,7,206,503,7,32.285714285714285,>30,SA,Away,Upto 2014
Imran Farhat,PAK,Spin,2009-12-26,Melbourne,Australia,2009,1,17,30,0,1,412,721,8,395,691,8,51.5,>30,AUS,Away,Upto 2014
Imran Farhat,PAK,Spin,2010-01-03,Sydney,Australia,2010,1,9,18,0,1,308,485,11,299,467,11,28.0,<=30,AUS,Away,Upto 2014
Imran Farhat,PAK,Spin,2010-07-29,Nottingham,England,2010,1,5,6,0,1,267,351,3,262,345,3,89.0,>30,ENG,Away,Upto 2014
Imran Farhat,PAK,Spin,2010-08-18,The Oval,England,2010,1,9,18,0,1,230,537,12,221,519,12,19.166666666666668,<=30,ENG,Away,Upto 2014
Imran Farhat,PAK,Spin,2010-08-26,Lord's,England,2010,1,26,60,0,1,226,461,11,200,401,11,20.545454545454547,<=30,ENG,Away,Upto 2014
Imran Khan,PAK,Pace,1971-06-03,Birmingham,England,1971,2,55,168,0,1,653,1403,13,598,1235,13,50.23076923076923,>30,ENG,Away,Upto 2014
Imran Khan,PAK,Pace,1974-07-25,Leeds,England,1974,2,110,300,3,1,703,1746,31,593,1446,28,22.677419354838708,<=30,ENG,Away,Upto 2014
Imran Khan,PAK,Pace,1974-08-08,Lord's,England,1974,1,48,108,2,1,356,858,8,308,750,6,44.5,>30,ENG,Away,Upto 2014
Imran Khan,PAK,Pace,1974-08-22,The Oval,England,1974,1,100,264,0,1,675,1389,8,575,1125,8,84.375,>30,ENG,Away,Upto 2014
Imran Khan,PAK,Pace,1976-10-09,Lahore,Pakistan,1976,2,116,288,6,1,496,904,17,380,616,11,29.176470588235293,<=30,PAK,Home,Upto 2014
Imran Khan,PAK,Pace,1976-10-23,Hyderabad (Sind),Pakistan,1976,2,94,248,3,1,398,904,11,304,656,8,36.18181818181818,>30,PAK,Home,Upto 2014
Imran Khan,PAK,Pace,1976-10-30,Karachi,Pakistan,1976,2,211,372,5,1,1003,1506,20,792,1134,15,50.15,>30,PAK,Home,Upto 2014
Imran Khan,PAK,Pace,1976-12-24,Adelaide,Australia,1976,2,117,216,1,1,783,1646,15,666,1430,14,52.2,>30,AUS,Away,Upto 2014
Imran Khan,PAK,Pace,1977-01-01,Melbourne,Australia,1977,2,237,381,5,1,882,1510,22,645,1129,17,40.09090909090909,>30,AUS,Away,Upto 2014
Imran Khan,PAK,Pace,1977-01-14,Sydney,Australia,1977,2,165,367,12,1,681,1364,30,516,997,18,22.7,<=30,AUS,Away,Upto 2014
Imran Khan,PAK,Pace,1977-02-18,Bridgetown,West Indies,1977,2,205,360,5,1,1045,1954,34,840,1594,29,30.735294117647058,>30,WI,Away,Upto 2014
Imran Khan,PAK,Pace,1977-03-04,Port of Spain,West Indies,1977,2,109,270,5,1,520,1242,24,411,972,19,21.666666666666668,<=30,WI,Away,Upto 2014
Imran Khan,PAK,Pace,1977-03-18,Georgetown,West Indies,1977,2,198,263,3,1,1085,2006,25,887,1743,22,43.4,>30,WI,Away,Upto 2014
Imran Khan,PAK,Pace,1977-04-01,Port of Spain,West Indies,1977,2,110,252,4,1,547,1241,19,437,989,15,28.789473684210527,<=30,WI,Away,Upto 2014
Imran Khan,PAK,Pace,1977-04-15,Kingston,West Indies,1977,2,168,272,8,1,849,1372,30,681,1100,22,28.3,<=30,WI,Away,Upto 2014
Imran Khan,PAK,Pace,1978-10-16,Faisalabad,Pakistan,1978,2,126,245,1,1,508,904,5,382,659,4,101.6,>30,PAK,Home,Upto 2014
Imran Khan,PAK,Pace,1978-10-27,Lahore,Pakistan,1978,2,164,368,7,1,667,1298,21,503,930,14,31.761904761904763,>30,PAK,Home,Upto 2014
Imran Khan,PAK,Pace,1978-11-14,Karachi,Pakistan,1978,2,151,360,6,1,801,1525,25,650,1165,19,32.04,>30,PAK,Home,Upto 2014
Imran Khan,PAK,Pace,1979-02-16,Napier,New Zealand,1979,1,106,264,5,1,699,1749,19,593,1485,14,36.78947368421053,>30,NZ,Away,Upto 2014
Imran Khan,PAK,Pace,1979-02-23,Auckland,New Zealand,1979,2,149,399,5,1,754,1863,27,605,1464,22,27.925925925925927,<=30,NZ,Away,Upto 2014
Imran Khan,PAK,Pace,1979-03-10,Melbourne,Australia,1979,2,99,360,4,1,679,1863,29,580,1503,25,23.413793103448278,<=30,AUS,Away,Upto 2014
Imran Khan,PAK,Pace,1979-03-24,W.A.C.A,Australia,1979,2,186,392,3,1,924,2172,25,738,1780,22,36.96,>30,AUS,Away,Upto 2014
Imran Khan,PAK,Pace,1979-11-21,Bengaluru,India,1979,1,53,172,4,1,355,754,9,302,582,5,39.44444444444444,>30,IND,Away,Upto 2014
Imran Khan,PAK,Pace,1979-12-04,Delhi,India,1979,2,13,51,0,1,647,1401,30,634,1350,30,21.566666666666666,<=30,IND,Away,Upto 2014
Imran Khan,PAK,Pace,1979-12-16,Wankhede,India,1979,1,35,90,1,1,330,772,18,295,682,17,18.333333333333332,<=30,IND,Away,Upto 2014
Imran Khan,PAK,Pace,1980-01-15,Chennai,India,1980,2,134,260,5,1,708,1186,22,574,926,17,32.18181818181818,>30,IND,Away,Upto 2014
Imran Khan,PAK,Pace,1980-01-29,Eden Gardens,India,1980,2,130,341,9,1,644,1456,21,514,1115,12,30.666666666666668,>30,IND,Away,Upto 2014
Imran Khan,PAK,Pace,1980-02-27,Karachi,Pakistan,1980,1,28,96,2,1,240,648,5,212,552,3,48.0,>30,PAK,Home,Upto 2014
Imran Khan,PAK,Pace,1980-03-18,Lahore,Pakistan,1980,2,116,240,4,1,489,1014,8,373,774,4,61.125,>30,PAK,Home,Upto 2014
Imran Khan,PAK,Pace,1980-11-24,Lahore,Pakistan,1980,1,39,96,1,1,508,1109,13,469,1013,12,39.07692307692308,>30,PAK,Home,Upto 2014
Imran Khan,PAK,Pace,1980-12-08,Faisalabad,Pakistan,1980,2,42,78,0,1,265,580,15,223,502,15,17.666666666666668,<=30,PAK,Home,Upto 2014
Imran Khan,PAK,Pace,1980-12-22,Karachi,Pakistan,1980,1,66,174,4,1,342,961,23,276,787,19,14.869565217391305,<=30,PAK,Home,Upto 2014
Imran Khan,PAK,Pace,1980-12-30,Multan,Pakistan,1980,2,89,192,5,1,286,658,15,197,466,10,19.066666666666666,<=30,PAK,Home,Upto 2014
Imran Khan,PAK,Pace,1981-11-13,W.A.C.A,Australia,1981,2,156,424,7,1,628,1440,27,472,1016,20,23.25925925925926,<=30,AUS,Away,Upto 2014
Imran Khan,PAK,Pace,1981-11-27,Brisbane,Australia,1981,2,94,248,4,1,651,1292,22,557,1044,18,29.59090909090909,<=30,AUS,Away,Upto 2014
Imran Khan,PAK,Pace,1981-12-11,Melbourne,Australia,1981,2,62,230,5,1,395,1019,11,333,789,6,35.90909090909091,>30,AUS,Away,Upto 2014
Imran Khan,PAK,Pace,1982-03-22,Lahore,Pakistan,1982,2,116,314,14,1,456,794,20,340,480,6,22.8,<=30,PAK,Home,Upto 2014
Imran Khan,PAK,Pace,1982-07-29,Birmingham,England,1982,2,136,345,9,1,641,1313,30,505,968,21,21.366666666666667,<=30,ENG,Away,Upto 2014
Imran Khan,PAK,Pace,1982-08-12,Lord's,England,1982,2,139,390,4,1,700,1644,21,561,1254,17,33.333333333333336,>30,ENG,Away,Upto 2014
Imran Khan,PAK,Pace,1982-08-26,Leeds,England,1982,2,115,334,8,1,717,1887,34,602,1553,26,21.08823529411765,<=30,ENG,Away,Upto 2014
Imran Khan,PAK,Pace,1982-09-22,Karachi,Pakistan,1982,2,55,210,3,1,384,853,11,329,643,8,34.90909090909091,>30,PAK,Home,Upto 2014
Imran Khan,PAK,Pace,1982-09-30,Faisalabad,Pakistan,1982,2,36,144,2,1,292,720,7,256,576,5,41.714285714285715,>30,PAK,Home,Upto 2014
Imran Khan,PAK,Pace,1982-10-14,Lahore,Pakistan,1982,2,80,266,8,1,661,1346,22,581,1080,14,30.045454545454547,>30,PAK,Home,Upto 2014
Imran Khan,PAK,Pace,1982-12-10,Lahore,Pakistan,1982,1,68,162,3,1,700,1379,14,632,1217,11,50.0,>30,PAK,Home,Upto 2014
Imran Khan,PAK,Pace,1982-12-23,Karachi,Pakistan,1982,2,79,194,11,1,510,865,22,431,671,11,23.181818181818183,<=30,PAK,Home,Upto 2014
Imran Khan,PAK,Pace,1983-01-03,Faisalabad,Pakistan,1983,2,180,335,11,1,934,1450,28,754,1115,17,33.357142857142854,>30,PAK,Home,Upto 2014
Imran Khan,PAK,Pace,1983-01-14,Hyderabad (Sind),Pakistan,1983,2,80,252,8,1,503,996,17,423,744,9,29.58823529411765,<=30,PAK,Home,Upto 2014
Imran Khan,PAK,Pace,1983-01-23,Lahore,Pakistan,1983,1,45,108,2,1,359,745,10,314,637,8,35.9,>30,PAK,Home,Upto 2014
Imran Khan,PAK,Pace,1983-01-30,Karachi,Pakistan,1983,2,106,288,5,1,655,1382,13,549,1094,8,50.38461538461539,>30,PAK,Home,Upto 2014
Imran Khan,PAK,Pace,1985-10-16,Faisalabad,Pakistan,1985,1,112,294,3,1,718,1505,9,606,1211,6,79.77777777777777,>30,PAK,Home,Upto 2014
Imran Khan,PAK,Pace,1985-10-27,Sialkot,Pakistan,1985,2,95,225,9,1,662,1204,31,567,979,22,21.35483870967742,<=30,PAK,Home,Upto 2014
Imran Khan,PAK,Pace,1985-11-07,Karachi,Pakistan,1985,2,64,205,5,1,402,787,17,338,582,12,23.647058823529413,<=30,PAK,Home,Upto 2014
Imran Khan,PAK,Pace,1986-02-23,Kandy,Sri Lanka,1986,2,49,150,5,1,238,611,14,189,461,9,17.0,<=30,SL,Away,Upto 2014
Imran Khan,PAK,Pace,1986-03-14,Colombo (CCC),Sri Lanka,1986,2,96,204,4,1,530,1137,31,434,933,27,17.096774193548388,<=30,SL,Away,Upto 2014
Imran Khan,PAK,Pace,1986-03-22,Colombo (PSS),Sri Lanka,1986,2,125,342,6,1,728,1538,20,603,1196,14,36.4,>30,SL,Away,Upto 2014
Imran Khan,PAK,Pace,1986-10-24,Faisalabad,Pakistan,1986,2,62,204,5,1,582,1145,28,520,941,23,20.785714285714285,<=30,PAK,Home,Upto 2014
Imran Khan,PAK,Pace,1986-11-07,Lahore,Pakistan,1986,1,59,185,5,1,247,794,22,188,609,17,11.227272727272727,<=30,PAK,Home,Upto 2014
Imran Khan,PAK,Pace,1986-11-20,Karachi,Pakistan,1986,2,78,249,8,1,343,1168,21,265,919,13,16.333333333333332,<=30,PAK,Home,Upto 2014
Imran Khan,PAK,Pace,1987-02-03,Chennai,India,1987,1,103,162,2,1,341,600,5,238,438,3,68.2,>30,IND,Away,Upto 2014
Imran Khan,PAK,Pace,1987-02-11,Eden Gardens,India,1987,2,121,205,2,1,698,1442,20,577,1237,18,34.9,>30,IND,Away,Upto 2014
Imran Khan,PAK,Pace,1987-02-21,Jaipur,India,1987,2,101,240,2,1,305,699,6,204,459,4,50.833333333333336,>30,IND,Away,Upto 2014
Imran Khan,PAK,Pace,1987-03-04,Ahmedabad,India,1987,1,41,102,2,1,194,539,11,153,437,9,17.636363636363637,<=30,IND,Away,Upto 2014
Imran Khan,PAK,Pace,1987-03-13,Bengaluru,India,1987,1,26,30,0,1,134,282,5,108,252,5,26.8,<=30,IND,Away,Upto 2014
Imran Khan,PAK,Pace,1987-06-18,Lord's,England,1987,1,90,209,2,1,256,527,7,166,318,5,36.57142857142857,>30,ENG,Away,Upto 2014
Imran Khan,PAK,Pace,1987-07-02,Leeds,England,1987,2,77,229,10,1,511,1279,29,434,1050,19,17.620689655172413,<=30,ENG,Away,Upto 2014
Imran Khan,PAK,Pace,1987-07-23,Birmingham,England,1987,2,190,305,8,1,1037,2130,29,847,1825,21,35.758620689655174,>30,ENG,Away,Upto 2014
Imran Khan,PAK,Pace,1987-08-06,The Oval,England,1987,2,98,267,1,1,607,1188,10,509,921,9,60.7,>30,ENG,Away,Upto 2014
Imran Khan,PAK,Pace,1988-04-02,Georgetown,West Indies,1988,2,121,224,11,1,579,1055,22,458,831,11,26.318181818181817,<=30,WI,Away,Upto 2014
Imran Khan,PAK,Pace,1988-04-14,Port of Spain,West Indies,1988,2,153,369,9,1,692,1635,27,539,1266,18,25.62962962962963,<=30,WI,Away,Upto 2014
Imran Khan,PAK,Pace,1988-04-22,Bridgetown,West Indies,1988,2,142,186,3,1,833,1467,30,691,1281,27,27.766666666666666,<=30,WI,Away,Upto 2014
Imran Khan,PAK,Pace,1989-02-10,Wellington,New Zealand,1989,2,109,382,6,1,750,1984,22,641,1602,16,34.09090909090909,>30,NZ,Away,Upto 2014
Imran Khan,PAK,Pace,1989-02-24,Auckland,New Zealand,1989,2,89,238,1,1,397,1018,6,308,780,5,66.16666666666667,>30,NZ,Away,Upto 2014
Imran Khan,PAK,Pace,1989-11-15,Karachi,Pakistan,1989,2,100,258,2,1,875,1711,26,775,1453,24,33.65384615384615,>30,PAK,Home,Upto 2014
Imran Khan,PAK,Pace,1989-11-23,Faisalabad,Pakistan,1989,2,145,319,4,1,850,1756,23,705,1437,19,36.95652173913044,>30,PAK,Home,Upto 2014
Imran Khan,PAK,Pace,1989-12-01,Lahore,Pakistan,1989,1,130,302,2,1,513,1118,6,383,816,4,85.5,>30,PAK,Home,Upto 2014
Imran Khan,PAK,Pace,1989-12-09,Sialkot,Pakistan,1989,2,129,234,5,1,741,1608,26,612,1374,21,28.5,<=30,PAK,Home,Upto 2014
Imran Khan,PAK,Pace,1990-01-12,Melbourne,Australia,1990,2,74,156,2,1,791,2097,34,717,1941,32,23.264705882352942,<=30,AUS,Away,Upto 2014
Imran Khan,PAK,Pace,1990-01-19,Adelaide,Australia,1990,1,61,162,2,1,759,1677,27,698,1515,25,28.11111111111111,<=30,AUS,Away,Upto 2014
Imran Khan,PAK,Pace,1990-02-03,Sydney,Australia,1990,1,32,102,0,1,253,749,11,221,647,11,23.0,<=30,AUS,Away,Upto 2014
Imran Khan,PAK,Pace,1990-12-06,Lahore,Pakistan,1990,2,54,114,4,1,541,1248,30,487,1134,26,18.033333333333335,<=30,PAK,Home,Upto 2014
Imran Khan,PAK,Pace,1991-12-12,Sialkot,Pakistan,1991,1,16,54,0,1,611,1329,14,595,1275,14,43.642857142857146,>30,PAK,Home,Upto 2014
Imran Khan,PAK,Pace,2014-10-22,Dubai (DICS),UAE,2014,2,63,132,2,1,384,954,8,321,822,6,48.0,>30,UAE,Away,After 1965
Imran Khan,PAK,Pace,2014-10-30,Abu Dhabi,UAE,2014,2,89,132,3,1,549,1024,11,460,892,8,49.90909090909091,>30,UAE,Away,After 1965
Imran Khan,PAK,Pace,2014-11-09,Abu Dhabi,UAE,2014,2,66,129,2,1,447,927,10,381,798,8,44.7,>30,UAE,Away,After 1965
Imran Khan,PAK,Pace,2015-05-06,Mirpur,Bangladesh,2015,2,87,108,2,1,464,771,14,377,663,12,33.142857142857146,>30,BAN,Away,After 1965
Imran Khan,PAK,Pace,2015-07-03,Pallekele,Sri Lanka,2015,2,109,220,5,1,740,1384,19,631,1164,14,38.94736842105263,>30,SL,Away,After 1965
Imran Khan,PAK,Pace,2015-10-13,Abu Dhabi,UAE,2015,1,74,162,2,1,582,1249,16,508,1087,14,36.375,>30,UAE,Away,After 1965
Imran Khan,PAK,Pace,2015-10-22,Dubai (DICS),UAE,2015,2,74,164,4,1,554,1207,19,480,1043,15,29.157894736842106,<=30,UAE,Away,After 1965
Imran Khan,PAK,Pace,2016-11-25,Hamilton,New Zealand,2016,2,128,247,6,1,921,1796,32,793,1549,26,28.78125,<=30,NZ,Away,After 1965
Imran Khan,PAK,Pace,2017-01-03,Sydney,Australia,2017,2,154,198,2,1,587,1109,15,433,911,13,39.13333333333333,>30,AUS,Away,After 1965
Imran Khan,PAK,Pace,2019-11-21,Brisbane,Australia,2019,1,73,144,1,1,600,1180,22,527,1036,21,27.272727272727273,<=30,AUS,Away,After 1965
Imran Tahir,SA,Spin,2011-11-09,Cape Town,South Africa,2011,1,35,60,0,1,46,78,0,11,18,0,inf,>30,SA,Home,Upto 2014
Imran Tahir,SA,Spin,2011-11-17,Johannesburg,South Africa,2011,2,118,177,4,1,235,387,10,117,210,6,23.5,<=30,SA,Home,Upto 2014
Imran Tahir,SA,Spin,2011-12-15,Centurion,South Africa,2011,2,37,60,2,1,95,240,3,58,180,1,31.666666666666668,>30,SA,Home,Upto 2014
Imran Tahir,SA,Spin,2011-12-26,Durban,South Africa,2011,2,165,288,3,1,329,669,13,164,381,10,25.307692307692307,<=30,SA,Home,Upto 2014
Imran Tahir,SA,Spin,2012-01-03,Cape Town,South Africa,2012,2,160,318,5,1,307,606,6,147,288,1,51.166666666666664,>30,SA,Home,Upto 2014
Imran Tahir,SA,Spin,2012-03-07,Dunedin,New Zealand,2012,2,88,192,2,1,209,528,4,121,336,2,52.25,>30,NZ,Away,Upto 2014
Imran Tahir,SA,Spin,2012-03-15,Hamilton,New Zealand,2012,2,64,134,2,1,143,280,4,79,146,2,35.75,>30,NZ,Away,Upto 2014
Imran Tahir,SA,Spin,2012-07-19,The Oval,England,2012,2,124,306,4,1,301,684,4,177,378,0,75.25,>30,ENG,Away,Upto 2014
Imran Tahir,SA,Spin,2012-08-02,Leeds,England,2012,2,112,166,3,1,205,280,8,93,114,5,25.625,<=30,ENG,Away,Upto 2014
Imran Tahir,SA,Spin,2012-08-16,Lord's,England,2012,2,142,228,1,1,299,656,5,157,428,4,59.8,>30,ENG,Away,Upto 2014
Imran Tahir,SA,Spin,2012-11-22,Adelaide,Australia,2012,2,260,222,0,1,554,1050,7,294,828,7,79.14285714285714,>30,AUS,Away,Upto 2014
Imran Tahir,SA,Spin,2013-10-23,Dubai (DICS),UAE,2013,2,130,330,8,1,497,1052,19,367,722,11,26.157894736842106,<=30,UAE,Away,Upto 2014
Imran Tahir,SA,Spin,2013-12-18,Johannesburg,South Africa,2013,2,116,142,2,1,344,574,4,228,432,2,86.0,>30,SA,Home,Upto 2014
Imran Tahir,SA,Spin,2014-07-16,Galle,Sri Lanka,2014,2,139,270,1,1,723,1396,15,584,1126,14,48.2,>30,SL,Away,After 1965
Imran Tahir,SA,Spin,2014-07-24,Colombo (SSC),Sri Lanka,2014,2,197,306,3,1,647,1745,22,450,1439,19,29.40909090909091,<=30,SL,Away,After 1965
Imran Tahir,SA,Spin,2014-12-26,Gqeberha,South Africa,2014,1,108,156,3,1,215,336,4,107,180,1,53.75,>30,SA,Home,After 1965
Imran Tahir,SA,Spin,2015-11-05,Mohali,India,2015,2,71,159,6,1,466,1004,34,395,845,28,13.705882352941176,<=30,IND,Away,After 1965
Imran Tahir,SA,Spin,2015-11-14,Bengaluru,India,2015,1,9,12,0,1,138,228,8,129,216,8,17.25,<=30,IND,Away,After 1965
Imran Tahir,SA,Spin,2015-11-25,Nagpur,India,2015,2,79,146,6,1,483,1096,33,404,950,27,14.636363636363637,<=30,IND,Away,After 1965
Imran Tahir,SA,Spin,2015-12-03,Delhi,India,2015,2,140,253,2,1,551,1517,20,411,1264,18,27.55,<=30,IND,Away,After 1965
Imrul Kayes,BAN,Spin,2009-01-03,Chattogram,Bangladesh,2009,1,7,6,0,1,931,1570,27,924,1564,27,34.48148148148148,>30,BAN,Home,Upto 2014
Imrul Kayes,BAN,Spin,2011-08-04,Harare,Zimbabwe,2011,1,1,6,0,1,318,704,9,317,698,9,35.333333333333336,>30,ZIM,Away,Upto 2014
Imrul Kayes,BAN,Spin,2015-05-06,Mirpur,Bangladesh,2015,1,1,6,0,1,692,1014,18,691,1008,18,38.44444444444444,>30,BAN,Home,After 1965
Imrul Kayes,BAN,Spin,2015-06-10,Fatullah,Bangladesh,2015,1,3,6,0,1,528,806,14,525,800,14,37.714285714285715,>30,BAN,Home,After 1965
Imtiaz Ahmed,PAK,Spin,1955-01-01,Dhaka,Bangladesh,1955,1,0,6,0,1,438,1378,15,438,1372,15,29.2,<=30,BAN,Away,Upto 2014
Imtiaz Ali,WI,Spin,1976-04-07,Port of Spain,West Indies,1976,2,89,204,2,1,858,2099,21,769,1895,19,40.857142857142854,>30,WI,Home,Upto 2014
Inshan Ali,WI,Spin,1971-04-01,Bridgetown,West Indies,1971,2,125,228,1,1,692,1614,11,567,1386,10,62.90909090909091,>30,WI,Home,Upto 2014
Inshan Ali,WI,Spin,1972-03-09,Port of Spain,West Indies,1972,2,152,479,3,1,722,2183,14,570,1704,11,51.57142857142857,>30,WI,Home,Upto 2014
Inshan Ali,WI,Spin,1972-03-23,Bridgetown,West Indies,1972,1,81,210,1,1,454,1224,7,373,1014,6,64.85714285714286,>30,WI,Home,Upto 2014
Inshan Ali,WI,Spin,1972-04-20,Port of Spain,West Indies,1972,2,158,466,7,1,509,1648,17,351,1182,10,29.941176470588236,<=30,WI,Home,Upto 2014
Inshan Ali,WI,Spin,1973-02-16,Kingston,West Indies,1973,2,110,174,1,1,500,1086,7,390,912,6,71.42857142857143,>30,WI,Home,Upto 2014
Inshan Ali,WI,Spin,1973-03-23,Port of Spain,West Indies,1973,2,171,373,4,1,758,1913,26,587,1540,22,29.153846153846153,<=30,WI,Home,Upto 2014
Inshan Ali,WI,Spin,1973-04-21,Port of Spain,West Indies,1973,2,192,378,5,1,694,1730,21,502,1352,16,33.04761904761905,>30,WI,Home,Upto 2014
Inshan Ali,WI,Spin,1973-07-26,The Oval,England,1973,2,101,204,1,1,563,1459,15,462,1255,14,37.53333333333333,>30,ENG,Away,Upto 2014
Inshan Ali,WI,Spin,1974-02-02,Port of Spain,West Indies,1974,2,111,264,1,1,671,1657,22,560,1393,21,30.5,>30,WI,Home,Upto 2014
Inshan Ali,WI,Spin,1974-03-30,Port of Spain,West Indies,1974,2,137,414,4,1,805,2406,29,668,1992,25,27.75862068965517,<=30,WI,Home,Upto 2014
Inshan Ali,WI,Spin,1975-11-28,Brisbane,Australia,1975,2,124,216,1,1,448,1067,12,324,851,11,37.333333333333336,>30,AUS,Away,Upto 2014
Inshan Ali,WI,Spin,1977-04-01,Port of Spain,West Indies,1977,2,159,312,5,1,392,967,20,233,655,15,19.6,<=30,WI,Home,Upto 2014
Intikhab Alam,PAK,Spin,1959-12-04,Karachi,Pakistan,1959,2,62,150,3,1,235,677,9,173,527,6,26.11111111111111,<=30,PAK,Home,Upto 2014
Intikhab Alam,PAK,Spin,1960-12-30,Eden Gardens,India,1960,2,68,234,4,1,295,842,11,227,608,7,26.818181818181817,<=30,IND,Away,Upto 2014
Intikhab Alam,PAK,Spin,1961-01-13,Chennai,India,1961,1,40,102,0,1,664,1638,11,624,1536,11,60.36363636363637,>30,IND,Away,Upto 2014
Intikhab Alam,PAK,Spin,1961-02-08,Delhi,India,1961,1,76,204,1,1,386,1389,14,310,1185,13,27.571428571428573,<=30,IND,Away,Upto 2014
Intikhab Alam,PAK,Spin,1961-10-21,Lahore,Pakistan,1961,2,155,384,3,1,702,1631,18,547,1247,15,39.0,>30,PAK,Home,Upto 2014
Intikhab Alam,PAK,Spin,1962-01-19,Dhaka,Bangladesh,1962,2,59,84,0,1,862,2494,25,803,2410,25,34.48,>30,BAN,Away,Upto 2014
Intikhab Alam,PAK,Spin,1962-05-31,Birmingham,England,1962,1,117,150,2,1,664,1386,13,547,1236,11,51.07692307692308,>30,ENG,Away,Upto 2014
Intikhab Alam,PAK,Spin,1962-07-26,Nottingham,England,1962,1,49,84,1,1,232,572,3,183,488,2,77.33333333333333,>30,ENG,Away,Upto 2014
Intikhab Alam,PAK,Spin,1962-08-16,The Oval,England,1962,1,109,228,0,1,452,1071,6,343,843,6,75.33333333333333,>30,ENG,Away,Upto 2014
Intikhab Alam,PAK,Spin,1964-10-24,Karachi,Pakistan,1964,2,131,264,2,1,840,2130,18,709,1866,16,46.666666666666664,>30,PAK,Home,Upto 2014
Intikhab Alam,PAK,Spin,1964-12-04,Melbourne,Australia,1964,1,51,80,0,1,473,1030,6,422,950,6,78.83333333333333,>30,AUS,Away,Upto 2014
Intikhab Alam,PAK,Spin,1965-01-22,Wellington,New Zealand,1965,2,42,132,0,1,356,1080,8,314,948,8,44.5,>30,NZ,Away,Upto 2014
Intikhab Alam,PAK,Spin,1965-01-29,Auckland,New Zealand,1965,2,69,264,0,1,450,1734,24,381,1470,24,18.75,<=30,NZ,Away,Upto 2014
Intikhab Alam,PAK,Spin,1965-02-12,Christchurch,New Zealand,1965,2,77,168,2,1,466,1098,16,389,930,14,29.125,<=30,NZ,Away,Upto 2014
Intikhab Alam,PAK,Spin,1965-03-27,Rawalpindi,Pakistan,1965,2,7,29,1,1,362,890,18,355,861,17,20.11111111111111,<=30,PAK,Home,Upto 2014
Intikhab Alam,PAK,Spin,1965-04-02,Lahore,Pakistan,1965,1,92,198,1,1,697,1836,15,605,1638,14,46.46666666666667,>30,PAK,Home,Upto 2014
Intikhab Alam,PAK,Spin,1965-04-09,Karachi,Pakistan,1965,2,92,304,7,1,606,1528,19,514,1224,12,31.894736842105264,>30,PAK,Home,Upto 2014
Intikhab Alam,PAK,Spin,1967-07-27,Lord's,England,1967,2,156,354,3,1,583,1689,19,427,1335,16,30.68421052631579,>30,ENG,Away,Upto 2014
Intikhab Alam,PAK,Spin,1967-08-10,Nottingham,England,1967,1,19,42,0,1,240,772,12,221,730,12,20.0,<=30,ENG,Away,Upto 2014
Intikhab Alam,PAK,Spin,1967-08-24,The Oval,England,1967,1,93,168,1,1,475,1075,13,382,907,12,36.53846153846154,>30,ENG,Away,Upto 2014
Intikhab Alam,PAK,Spin,1969-02-21,Lahore,Pakistan,1969,2,146,331,4,1,546,1362,17,400,1031,13,32.11764705882353,>30,PAK,Home,Upto 2014
Intikhab Alam,PAK,Spin,1969-02-28,Dhaka,Bangladesh,1969,2,84,180,1,1,397,1246,15,313,1066,14,26.466666666666665,<=30,BAN,Away,Upto 2014
Intikhab Alam,PAK,Spin,1969-03-06,Karachi,Pakistan,1969,1,129,288,3,1,302,679,5,173,391,2,60.4,>30,PAK,Home,Upto 2014
Intikhab Alam,PAK,Spin,1969-10-24,Karachi,Pakistan,1969,2,69,108,0,1,665,1813,26,596,1705,26,25.576923076923077,<=30,PAK,Home,Upto 2014
Intikhab Alam,PAK,Spin,1969-10-30,Lahore,Pakistan,1969,1,31,60,0,1,434,1339,23,403,1279,23,18.869565217391305,<=30,PAK,Home,Upto 2014
Intikhab Alam,PAK,Spin,1969-11-08,Dhaka,Bangladesh,1969,2,182,574,10,1,498,1577,22,316,1003,12,22.636363636363637,<=30,BAN,Away,Upto 2014
Intikhab Alam,PAK,Spin,1971-06-03,Birmingham,England,1971,2,134,306,2,1,451,1037,8,317,731,6,56.375,>30,ENG,Away,Upto 2014
Intikhab Alam,PAK,Spin,1971-06-17,Lord's,England,1971,2,90,174,0,1,197,492,2,107,318,2,98.5,>30,ENG,Away,Upto 2014
Intikhab Alam,PAK,Spin,1971-07-08,Leeds,England,1971,2,142,379,6,1,601,1757,16,459,1378,10,37.5625,>30,ENG,Away,Upto 2014
Intikhab Alam,PAK,Spin,1972-12-22,Adelaide,Australia,1972,1,115,144,0,1,497,880,15,382,736,15,33.13333333333333,>30,AUS,Away,Upto 2014
Intikhab Alam,PAK,Spin,1972-12-29,Melbourne,Australia,1972,2,171,254,3,1,666,1379,10,495,1125,7,66.6,>30,AUS,Away,Upto 2014
Intikhab Alam,PAK,Spin,1973-01-06,Sydney,Australia,1973,2,22,48,1,1,122,273,3,100,225,2,40.666666666666664,>30,AUS,Away,Upto 2014
Intikhab Alam,PAK,Spin,1973-02-02,Wellington,New Zealand,1973,2,66,128,1,1,304,776,6,238,648,5,50.666666666666664,>30,NZ,Away,Upto 2014
Intikhab Alam,PAK,Spin,1973-02-07,Dunedin,New Zealand,1973,2,130,316,11,1,480,1145,19,350,829,8,25.263157894736842,<=30,NZ,Away,Upto 2014
Intikhab Alam,PAK,Spin,1973-02-16,Auckland,New Zealand,1973,1,127,240,6,1,488,1070,18,361,830,12,27.11111111111111,<=30,NZ,Away,Upto 2014
Intikhab Alam,PAK,Spin,1973-03-02,Lahore,Pakistan,1973,2,142,402,4,1,766,1787,23,624,1385,19,33.30434782608695,>30,PAK,Home,Upto 2014
Intikhab Alam,PAK,Spin,1973-03-16,Hyderabad (Sind),Pakistan,1973,2,181,504,7,1,993,2402,21,812,1898,14,47.285714285714285,>30,PAK,Home,Upto 2014
Intikhab Alam,PAK,Spin,1973-03-24,Karachi,Pakistan,1973,1,105,234,4,1,724,1728,23,619,1494,19,31.47826086956522,>30,PAK,Home,Upto 2014
Intikhab Alam,PAK,Spin,1974-07-25,Leeds,England,1974,2,39,120,1,1,110,348,4,71,228,3,27.5,<=30,ENG,Away,Upto 2014
Intikhab Alam,PAK,Spin,1974-08-08,Lord's,England,1974,2,80,162,2,1,263,688,20,183,526,18,13.15,<=30,ENG,Away,Upto 2014
Intikhab Alam,PAK,Spin,1974-08-22,The Oval,England,1974,1,116,310,5,1,476,1138,12,360,828,7,39.666666666666664,>30,ENG,Away,Upto 2014
Intikhab Alam,PAK,Spin,1975-02-15,Lahore,Pakistan,1975,2,78,216,3,1,210,572,5,132,356,2,42.0,>30,PAK,Home,Upto 2014
Intikhab Alam,PAK,Spin,1975-03-01,Karachi,Pakistan,1975,1,122,224,3,1,404,1072,11,282,848,8,36.72727272727273,>30,PAK,Home,Upto 2014
Intikhab Alam,PAK,Spin,1976-10-09,Lahore,Pakistan,1976,2,120,340,5,1,495,1028,17,375,688,12,29.11764705882353,<=30,PAK,Home,Upto 2014
Intikhab Alam,PAK,Spin,1976-10-23,Hyderabad (Sind),Pakistan,1976,2,95,320,6,1,481,1360,16,386,1040,10,30.0625,>30,PAK,Home,Upto 2014
Intikhab Alam,PAK,Spin,1976-10-30,Karachi,Pakistan,1976,2,118,303,4,1,499,1183,10,381,880,6,49.9,>30,PAK,Home,Upto 2014
Intikhab Alam,PAK,Spin,1977-03-04,Port of Spain,West Indies,1977,2,96,186,2,1,450,1050,10,354,864,8,45.0,>30,WI,Away,Upto 2014
Inzamam-ul-Haq,PAK,Spin,1998-03-14,Bulawayo,Zimbabwe,1998,1,8,9,0,1,364,712,5,356,703,5,72.8,>30,ZIM,Away,Upto 2014
Iqbal Qasim,PAK,Spin,1976-12-24,Adelaide,Australia,1976,2,140,352,4,1,612,1524,18,472,1172,14,34.0,>30,AUS,Away,Upto 2014
Iqbal Qasim,PAK,Spin,1977-01-01,Melbourne,Australia,1977,2,230,368,7,1,386,751,13,156,383,6,29.692307692307693,<=30,AUS,Away,Upto 2014
Iqbal Qasim,PAK,Spin,1977-01-14,Sydney,Australia,1977,2,4,48,0,1,67,202,1,63,154,1,67.0,>30,AUS,Away,Upto 2014
Iqbal Qasim,PAK,Spin,1977-03-04,Port of Spain,West Indies,1977,2,56,138,0,1,450,1050,10,394,912,10,45.0,>30,WI,Away,Upto 2014
Iqbal Qasim,PAK,Spin,1977-04-01,Port of Spain,West Indies,1977,2,76,198,2,1,392,967,20,316,769,18,19.6,<=30,WI,Away,Upto 2014
Iqbal Qasim,PAK,Spin,1977-12-14,Lahore,Pakistan,1977,1,57,256,3,1,395,1311,10,338,1055,7,39.5,>30,PAK,Home,Upto 2014
Iqbal Qasim,PAK,Spin,1978-01-02,Hyderabad (Sind),Pakistan,1978,2,96,468,2,1,585,1882,17,489,1414,15,34.411764705882355,>30,PAK,Home,Upto 2014
Iqbal Qasim,PAK,Spin,1978-01-18,Karachi,Pakistan,1978,2,107,552,5,1,466,1665,20,359,1113,15,23.3,<=30,PAK,Home,Upto 2014
Iqbal Qasim,PAK,Spin,1978-06-01,Birmingham,England,1978,1,56,84,1,1,153,396,7,97,312,6,21.857142857142858,<=30,ENG,Away,Upto 2014
Iqbal Qasim,PAK,Spin,1978-06-15,Lord's,England,1978,1,101,180,3,1,186,426,8,85,246,5,23.25,<=30,ENG,Away,Upto 2014
Iqbal Qasim,PAK,Spin,1978-06-29,Leeds,England,1978,1,11,66,0,1,69,204,1,58,138,1,69.0,>30,ENG,Away,Upto 2014
Iqbal Qasim,PAK,Spin,1978-10-16,Faisalabad,Pakistan,1978,2,65,144,1,1,700,1410,15,635,1266,14,46.666666666666664,>30,PAK,Home,Upto 2014
Iqbal Qasim,PAK,Spin,1978-10-27,Lahore,Pakistan,1978,1,68,198,0,1,591,988,6,523,790,6,98.5,>30,PAK,Home,Upto 2014
Iqbal Qasim,PAK,Spin,1978-11-14,Karachi,Pakistan,1978,2,94,180,1,1,383,654,5,289,474,4,76.6,>30,PAK,Home,Upto 2014
Iqbal Qasim,PAK,Spin,1979-11-21,Bengaluru,India,1979,1,75,246,0,1,552,1383,11,477,1137,11,50.18181818181818,>30,IND,Away,Upto 2014
Iqbal Qasim,PAK,Spin,1979-12-04,Delhi,India,1979,2,94,198,1,1,303,672,3,209,474,2,101.0,>30,IND,Away,Upto 2014
Iqbal Qasim,PAK,Spin,1979-12-16,Wankhede,India,1979,2,175,437,10,1,435,1053,22,260,616,12,19.772727272727273,<=30,IND,Away,Upto 2014
Iqbal Qasim,PAK,Spin,1979-12-25,Kanpur,India,1979,1,28,96,0,1,100,282,2,72,186,2,50.0,>30,IND,Away,Upto 2014
Iqbal Qasim,PAK,Spin,1980-01-15,Chennai,India,1980,2,93,246,3,1,236,570,6,143,324,3,39.333333333333336,>30,IND,Away,Upto 2014
Iqbal Qasim,PAK,Spin,1980-01-29,Eden Gardens,India,1980,2,103,228,3,1,248,600,5,145,372,2,49.6,>30,IND,Away,Upto 2014
Iqbal Qasim,PAK,Spin,1980-02-27,Karachi,Pakistan,1980,2,118,432,11,1,432,1328,28,314,896,17,15.428571428571429,<=30,PAK,Home,Upto 2014
Iqbal Qasim,PAK,Spin,1980-03-06,Faisalabad,Pakistan,1980,1,156,336,0,1,592,1272,6,436,936,6,98.66666666666667,>30,PAK,Home,Upto 2014
Iqbal Qasim,PAK,Spin,1980-03-18,Lahore,Pakistan,1980,2,201,438,5,1,686,1374,15,485,936,10,45.733333333333334,>30,PAK,Home,Upto 2014
Iqbal Qasim,PAK,Spin,1980-11-24,Lahore,Pakistan,1980,1,18,72,1,1,274,622,12,256,550,11,22.833333333333332,<=30,PAK,Home,Upto 2014
Iqbal Qasim,PAK,Spin,1980-12-08,Faisalabad,Pakistan,1980,2,143,308,8,1,460,1075,25,317,767,17,18.4,<=30,PAK,Home,Upto 2014
Iqbal Qasim,PAK,Spin,1980-12-22,Karachi,Pakistan,1980,1,48,205,4,1,122,421,6,74,216,2,20.333333333333332,<=30,PAK,Home,Upto 2014
Iqbal Qasim,PAK,Spin,1980-12-30,Multan,Pakistan,1980,2,96,240,4,1,206,498,8,110,258,4,25.75,<=30,PAK,Home,Upto 2014
Iqbal Qasim,PAK,Spin,1981-11-13,W.A.C.A,Australia,1981,2,87,174,3,1,231,461,11,144,287,8,21.0,<=30,AUS,Away,Upto 2014
Iqbal Qasim,PAK,Spin,1981-12-11,Melbourne,Australia,1981,2,148,474,7,1,491,1248,15,343,774,8,32.733333333333334,>30,AUS,Away,Upto 2014
Iqbal Qasim,PAK,Spin,1982-03-05,Karachi,Pakistan,1982,2,115,259,6,1,669,1411,22,554,1152,16,30.40909090909091,>30,PAK,Home,Upto 2014
Iqbal Qasim,PAK,Spin,1982-03-14,Faisalabad,Pakistan,1982,2,192,570,8,1,699,1740,27,507,1170,19,25.88888888888889,<=30,PAK,Home,Upto 2014
Iqbal Qasim,PAK,Spin,1982-03-22,Lahore,Pakistan,1982,2,22,78,1,1,386,750,7,364,672,6,55.142857142857146,>30,PAK,Home,Upto 2014
Iqbal Qasim,PAK,Spin,1982-09-22,Karachi,Pakistan,1982,2,103,287,4,1,480,981,15,377,694,11,32.0,>30,PAK,Home,Upto 2014
Iqbal Qasim,PAK,Spin,1982-09-30,Faisalabad,Pakistan,1982,2,125,425,4,1,662,1534,17,537,1109,13,38.94117647058823,>30,PAK,Home,Upto 2014
Iqbal Qasim,PAK,Spin,1983-01-14,Hyderabad (Sind),Pakistan,1983,2,106,240,3,1,496,1008,6,390,768,3,82.66666666666667,>30,PAK,Home,Upto 2014
Iqbal Qasim,PAK,Spin,1983-01-23,Lahore,Pakistan,1983,1,19,72,0,1,176,366,3,157,294,3,58.666666666666664,>30,PAK,Home,Upto 2014
Iqbal Qasim,PAK,Spin,1983-09-14,Bengaluru,India,1983,2,47,150,0,1,224,589,2,177,439,2,112.0,>30,IND,Away,Upto 2014
Iqbal Qasim,PAK,Spin,1984-11-16,Lahore,Pakistan,1984,2,106,316,8,1,445,1036,19,339,720,11,23.42105263157895,<=30,PAK,Home,Upto 2014
Iqbal Qasim,PAK,Spin,1984-11-25,Hyderabad (Sind),Pakistan,1984,2,158,343,6,1,706,1491,27,548,1148,21,26.14814814814815,<=30,PAK,Home,Upto 2014
Iqbal Qasim,PAK,Spin,1984-12-10,Karachi,Pakistan,1984,1,133,342,4,1,562,1340,12,429,998,8,46.833333333333336,>30,PAK,Home,Upto 2014
Iqbal Qasim,PAK,Spin,1985-01-18,Wellington,New Zealand,1985,2,124,342,4,1,422,1002,10,298,660,6,42.2,>30,NZ,Away,Upto 2014
Iqbal Qasim,PAK,Spin,1987-02-21,Jaipur,India,1987,2,183,342,2,1,591,1283,13,408,941,11,45.46153846153846,>30,IND,Away,Upto 2014
Iqbal Qasim,PAK,Spin,1987-03-04,Ahmedabad,India,1987,1,63,180,1,1,616,1851,11,553,1671,10,56.0,>30,IND,Away,Upto 2014
Iqbal Qasim,PAK,Spin,1987-03-13,Bengaluru,India,1987,2,121,402,9,1,527,1530,35,406,1128,26,15.057142857142857,<=30,IND,Away,Upto 2014
Iqbal Qasim,PAK,Spin,1987-11-25,Lahore,Pakistan,1987,2,61,144,3,1,424,1316,26,363,1172,23,16.307692307692307,<=30,PAK,Home,Upto 2014
Iqbal Qasim,PAK,Spin,1987-12-07,Faisalabad,Pakistan,1987,2,112,272,7,1,479,1253,22,367,981,15,21.772727272727273,<=30,PAK,Home,Upto 2014
Iqbal Qasim,PAK,Spin,1987-12-16,Karachi,Pakistan,1987,2,95,270,0,1,450,1486,13,355,1216,13,34.61538461538461,>30,PAK,Home,Upto 2014
Iqbal Qasim,PAK,Spin,1988-09-15,Karachi,Pakistan,1988,2,84,384,9,1,427,1461,22,343,1077,13,19.40909090909091,<=30,PAK,Home,Upto 2014
Iqbal Qasim,PAK,Spin,1988-09-23,Faisalabad,Pakistan,1988,1,37,89,1,1,520,1112,15,483,1023,14,34.666666666666664,>30,PAK,Home,Upto 2014
Iqbal Qasim,PAK,Spin,1988-10-07,Lahore,Pakistan,1988,2,57,150,2,1,510,1394,19,453,1244,17,26.842105263157894,<=30,PAK,Home,Upto 2014
Irfan Fazil,PAK,Pace,2000-03-12,Karachi,Pakistan,2000,2,65,48,2,1,750,1272,22,685,1224,20,34.09090909090909,>30,PAK,Home,Upto 2014
Ismat Alam,AFG,Spin,2025-01-02,Bulawayo,Zimbabwe,2025,1,7,18,0,1,588,1149,23,581,1131,23,25.565217391304348,<=30,ZIM,Away,After 1965
Israr Ali,PAK,Pace,1952-11-13,Brabourne,India,1952,1,11,18,0,1,405,896,8,394,878,8,50.625,>30,IND,Away,Upto 2014
Israr Ali,PAK,Pace,1959-11-13,Dhaka,Bangladesh,1959,2,105,192,3,1,428,1301,20,323,1109,17,21.4,<=30,BAN,Away,Upto 2014
Israr Ali,PAK,Pace,1959-11-21,Lahore,Pakistan,1959,2,49,108,3,1,401,960,14,352,852,11,28.642857142857142,<=30,PAK,Home,Upto 2014
J Angel,AUS,Pace,1993-01-30,W.A.C.A,Australia,1993,1,72,114,1,1,518,1062,27,446,948,26,19.185185185185187,<=30,AUS,Home,Upto 2014
J Angel,AUS,Pace,1994-09-28,Karachi,Pakistan,1994,2,146,247,5,1,553,1041,23,407,794,18,24.043478260869566,<=30,PAK,Away,Upto 2014
J Angel,AUS,Pace,1994-10-05,Rawalpindi,Pakistan,1994,2,160,234,1,1,838,1506,23,678,1272,22,36.43478260869565,>30,PAK,Away,Upto 2014
J Angel,AUS,Pace,1995-02-03,W.A.C.A,Australia,1995,2,85,153,3,1,946,1817,29,861,1664,26,32.62068965517241,>30,AUS,Home,Upto 2014
J Arun Lal,IND,Pace,1983-01-03,Faisalabad,Pakistan,1983,1,6,7,0,1,934,1450,28,928,1443,28,33.357142857142854,>30,PAK,Away,Upto 2014
J Arun Lal,IND,Pace,1987-11-25,Delhi,India,1987,1,1,3,0,1,549,1170,28,548,1167,28,19.607142857142858,<=30,IND,Home,Upto 2014
J Arun Lal,IND,Pace,1987-12-26,Eden Gardens,India,1987,1,0,6,0,1,580,866,11,580,860,11,52.72727272727273,>30,IND,Home,Upto 2014
J Benaud,AUS,Pace,1973-04-21,Port of Spain,West Indies,1973,1,12,24,2,1,343,870,9,331,846,7,38.111111111111114,>30,WI,Away,Upto 2014
J Birkenshaw,ENG,Spin,1973-01-25,Kanpur,India,1973,2,108,270,3,1,638,1919,18,530,1649,15,35.44444444444444,>30,IND,Away,Upto 2014
J Birkenshaw,ENG,Spin,1973-02-06,Brabourne,India,1973,2,119,210,2,1,967,2173,20,848,1963,18,48.35,>30,IND,Away,Upto 2014
J Birkenshaw,ENG,Spin,1973-03-24,Karachi,Pakistan,1973,2,146,297,6,1,724,1728,23,578,1431,17,31.47826086956522,>30,PAK,Away,Upto 2014
J Birkenshaw,ENG,Spin,1974-03-22,Georgetown,West Indies,1974,1,41,132,1,1,367,917,8,326,785,7,45.875,>30,WI,Away,Upto 2014
J Birkenshaw,ENG,Spin,1974-03-30,Port of Spain,West Indies,1974,2,55,108,1,1,805,2406,29,750,2298,28,27.75862068965517,<=30,WI,Away,Upto 2014
J Blackwood,WI,Spin,2014-09-05,Kingstown,West Indies,2014,2,65,108,2,1,510,1180,16,445,1072,14,31.875,>30,WI,Home,After 1965
J Blackwood,WI,Spin,2014-09-13,Gros Islet,West Indies,2014,1,4,12,0,1,411,807,13,407,795,13,31.615384615384617,>30,WI,Home,After 1965
J Blackwood,WI,Spin,2014-12-17,Centurion,South Africa,2014,1,15,21,0,1,274,453,3,259,432,3,91.33333333333333,>30,SA,Away,After 1965
J Blackwood,WI,Spin,2015-04-21,St George's,West Indies,2015,1,14,6,0,1,451,913,9,437,907,9,50.111111111111114,>30,WI,Home,After 1965
J Blackwood,WI,Spin,2015-06-03,Roseau,West Indies,2015,1,15,18,0,1,294,570,11,279,552,11,26.727272727272727,<=30,WI,Home,After 1965
J Blackwood,WI,Spin,2015-06-11,Kingston,West Indies,2015,2,19,30,0,1,355,671,7,336,641,7,50.714285714285715,>30,WI,Home,After 1965
J Blackwood,WI,Spin,2015-12-10,Hobart,Australia,2015,1,25,36,0,1,295,420,6,270,384,6,49.166666666666664,>30,AUS,Away,After 1965
J Blackwood,WI,Spin,2016-10-13,Dubai (DICS),UAE,2016,1,8,9,0,1,657,1312,22,649,1303,22,29.863636363636363,<=30,UAE,Away,After 1965
J Blackwood,WI,Spin,2017-10-29,Bulawayo,Zimbabwe,2017,2,29,84,0,1,706,1640,15,677,1556,15,47.06666666666667,>30,ZIM,Away,After 1965
J Blackwood,WI,Spin,2021-03-21,North Sound,West Indies,2021,1,3,6,0,1,363,863,7,360,857,7,51.857142857142854,>30,WI,Home,After 1965
J Blackwood,WI,Spin,2021-03-29,North Sound,West Indies,2021,2,33,60,1,1,313,706,3,280,646,2,104.33333333333333,>30,WI,Home,After 1965
J Blackwood,WI,Spin,2021-11-21,Galle,Sri Lanka,2021,1,6,6,0,1,748,1629,31,742,1623,31,24.129032258064516,<=30,SL,Away,After 1965
J Blackwood,WI,Spin,2022-03-24,St George's,West Indies,2022,2,6,22,1,1,75,217,2,69,195,1,37.5,>30,WI,Home,After 1965
J Blackwood,WI,Spin,2023-02-04,Bulawayo,Zimbabwe,2023,1,11,12,0,1,573,1170,18,562,1158,18,31.833333333333332,>30,ZIM,Away,After 1965
J Blackwood,WI,Spin,2023-02-28,Centurion,South Africa,2023,1,4,6,0,1,47,138,0,43,132,0,inf,>30,SA,Away,After 1965
J Blackwood,WI,Spin,2023-03-08,Johannesburg,South Africa,2023,1,3,6,0,1,406,700,11,403,694,11,36.90909090909091,>30,SA,Away,After 1965
J Blackwood,WI,Spin,2023-07-12,Roseau,West Indies,2023,1,4,12,0,1,411,1014,20,407,1002,20,20.55,<=30,WI,Home,After 1965
J Botha,SA,Spin,2006-01-02,Sydney,Australia,2006,2,103,117,2,1,507,813,9,404,696,7,56.333333333333336,>30,AUS,Away,Upto 2014
J Botha,SA,Spin,2008-02-22,Mirpur,Bangladesh,2008,2,75,108,2,1,350,752,16,275,644,14,21.875,<=30,BAN,Away,Upto 2014
J Botha,SA,Spin,2010-06-26,Bridgetown,West Indies,2010,2,102,239,7,1,347,891,14,245,652,7,24.785714285714285,<=30,WI,Away,Upto 2014
J Botha,SA,Spin,2010-11-12,Dubai (DICS),UAE,2010,2,199,366,4,1,753,1614,13,554,1248,9,57.92307692307692,>30,UAE,Away,Upto 2014
J Botha,SA,Spin,2010-11-20,Abu Dhabi,UAE,2010,2,94,187,2,1,553,1225,14,459,1038,12,39.5,>30,UAE,Away,Upto 2014
J Briggs,ENG,Spin,1885-01-01,Melbourne,Australia,1885,1,13,32,0,1,372,1209,9,359,1177,9,41.333333333333336,>30,AUS,Away,After 1965
J Briggs,ENG,Spin,1886-07-19,Lord's,England,1886,2,74,289,11,1,231,789,16,157,500,5,14.4375,<=30,ENG,Home,After 1965
J Briggs,ENG,Spin,1886-08-12,The Oval,England,1886,2,58,248,6,1,247,704,10,189,456,4,24.7,<=30,ENG,Home,After 1965
J Briggs,ENG,Spin,1887-01-28,Sydney,Australia,1887,2,32,84,2,1,172,567,12,140,483,10,14.333333333333334,<=30,AUS,Away,After 1965
J Briggs,ENG,Spin,1887-02-25,Sydney,Australia,1887,2,65,168,3,1,268,812,19,203,644,16,14.105263157894736,<=30,AUS,Away,After 1965
J Briggs,ENG,Spin,1888-07-16,Lord's,England,1888,2,35,100,4,1,134,420,21,99,320,17,6.380952380952381,<=30,ENG,Home,After 1965
J Briggs,ENG,Spin,1888-08-13,The Oval,England,1888,2,32,172,5,1,208,504,11,176,332,6,18.90909090909091,<=30,ENG,Home,After 1965
J Briggs,ENG,Spin,1888-08-30,Manchester,England,1888,2,27,65,3,1,144,395,16,117,330,13,9.0,<=30,ENG,Home,After 1965
J Briggs,ENG,Spin,1889-03-12,Gqeberha,South Africa,1889,2,73,256,6,1,137,346,12,64,90,6,11.416666666666666,<=30,SA,Away,After 1965
J Briggs,ENG,Spin,1889-03-25,Cape Town,South Africa,1889,2,28,135,15,1,74,207,15,46,72,0,4.933333333333334,<=30,SA,Away,After 1965
J Briggs,ENG,Spin,1892-01-01,Melbourne,Australia,1892,2,39,144,1,1,195,677,9,156,533,8,21.666666666666668,<=30,AUS,Away,After 1965
J Briggs,ENG,Spin,1892-01-29,Sydney,Australia,1892,2,93,256,4,1,229,676,7,136,420,3,32.714285714285715,>30,AUS,Away,After 1965
J Briggs,ENG,Spin,1892-03-24,Adelaide,Australia,1892,2,136,299,12,1,216,371,13,80,72,1,16.615384615384617,<=30,AUS,Away,After 1965
J Briggs,ENG,Spin,1893-08-14,The Oval,England,1893,2,148,248,10,1,282,513,11,134,265,1,25.636363636363637,<=30,ENG,Home,After 1965
J Briggs,ENG,Spin,1893-08-24,Manchester,England,1893,2,145,353,6,1,203,495,10,58,142,4,20.3,<=30,ENG,Home,After 1965
J Briggs,ENG,Spin,1894-12-14,Sydney,Australia,1894,2,121,216,3,1,459,958,15,338,742,12,30.6,>30,AUS,Away,After 1965
J Briggs,ENG,Spin,1894-12-29,Melbourne,Australia,1894,2,75,155,2,1,327,823,10,252,668,8,32.7,>30,AUS,Away,After 1965
J Briggs,ENG,Spin,1895-01-11,Adelaide,Australia,1895,2,92,162,3,1,335,726,15,243,564,12,22.333333333333332,<=30,AUS,Away,After 1965
J Briggs,ENG,Spin,1895-02-01,Sydney,Australia,1895,1,65,132,4,1,174,372,10,109,240,6,17.4,<=30,AUS,Away,After 1965
J Briggs,ENG,Spin,1895-03-01,Melbourne,Australia,1895,2,83,238,3,1,689,1631,19,606,1393,16,36.26315789473684,>30,AUS,Away,After 1965
J Briggs,ENG,Spin,1896-07-16,Manchester,England,1896,2,123,290,3,1,461,941,15,338,651,12,30.733333333333334,>30,ENG,Home,After 1965
J Briggs,ENG,Spin,1897-12-13,Sydney,Australia,1897,2,128,252,3,1,519,948,7,391,696,4,74.14285714285714,>30,AUS,Away,After 1965
J Briggs,ENG,Spin,1898-01-01,Melbourne,Australia,1898,1,96,240,3,1,483,1191,22,387,951,19,21.954545454545453,<=30,AUS,Away,After 1965
J Briggs,ENG,Spin,1898-01-14,Adelaide,Australia,1898,1,128,378,1,1,414,1001,10,286,623,9,41.4,>30,AUS,Away,After 1965
J Briggs,ENG,Spin,1898-01-29,Melbourne,Australia,1898,2,69,138,1,1,328,761,11,259,623,10,29.818181818181817,<=30,AUS,Away,After 1965
J Briggs,ENG,Spin,1898-02-26,Sydney,Australia,1898,2,64,132,1,1,340,888,10,276,756,9,34.0,>30,AUS,Away,After 1965
J Briggs,ENG,Spin,1899-06-29,Leeds,England,1899,1,53,150,3,1,225,608,11,172,458,8,20.454545454545453,<=30,ENG,Home,After 1965
J Cameron-Dow,IRE,Spin,2019-03-15,Dehradun,India,2019,2,118,143,3,1,656,1295,22,538,1152,19,29.818181818181817,<=30,IND,Away,After 1965
J Cowie,NZ,Pace,1937-06-26,Lord's,England,1937,2,167,336,6,1,544,1216,20,377,880,14,27.2,<=30,ENG,Away,Upto 2014
J Cowie,NZ,Pace,1937-07-24,Manchester,England,1937,2,140,335,10,1,359,941,19,219,606,9,18.894736842105264,<=30,ENG,Away,Upto 2014
J Cowie,NZ,Pace,1937-08-14,The Oval,England,1937,2,88,168,3,1,359,810,13,271,642,10,27.615384615384617,<=30,ENG,Away,Upto 2014
J Cowie,NZ,Pace,1946-03-29,Wellington,New Zealand,1946,1,40,126,6,1,212,690,16,172,564,10,13.25,<=30,NZ,Home,Upto 2014
J Cowie,NZ,Pace,1947-03-21,Christchurch,New Zealand,1947,1,83,180,6,1,372,820,16,289,640,10,23.25,<=30,NZ,Home,Upto 2014
J Cowie,NZ,Pace,1949-06-11,Leeds,England,1949,1,127,258,5,1,597,1077,16,470,819,11,37.3125,>30,ENG,Away,Upto 2014
J Cowie,NZ,Pace,1949-06-25,Lord's,England,1949,2,103,241,2,1,435,853,4,332,612,2,108.75,>30,ENG,Away,Upto 2014
J Cowie,NZ,Pace,1949-07-23,Manchester,England,1949,1,98,216,3,1,464,974,13,366,758,10,35.69230769230769,>30,ENG,Away,Upto 2014
J Cowie,NZ,Pace,1949-08-13,The Oval,England,1949,1,123,168,4,1,489,877,14,366,709,10,34.92857142857143,>30,ENG,Away,Upto 2014
J Garner,WI,Pace,1977-02-18,Bridgetown,West Indies,1977,2,190,324,6,1,1045,1954,34,855,1630,28,30.735294117647058,>30,WI,Home,Upto 2014
J Garner,WI,Pace,1977-03-04,Port of Spain,West Indies,1977,2,95,217,4,1,520,1242,24,425,1025,20,21.666666666666668,<=30,WI,Home,Upto 2014
J Garner,WI,Pace,1977-03-18,Georgetown,West Indies,1977,2,148,330,8,1,1085,2006,25,937,1676,17,43.4,>30,WI,Home,Upto 2014
J Garner,WI,Pace,1977-04-01,Port of Spain,West Indies,1977,2,126,282,3,1,547,1241,19,421,959,16,28.789473684210527,<=30,WI,Home,Upto 2014
J Garner,WI,Pace,1977-04-15,Kingston,West Indies,1977,2,129,164,4,1,849,1372,30,720,1208,26,28.3,<=30,WI,Home,Upto 2014
J Garner,WI,Pace,1978-03-03,Port of Spain,West Indies,1978,2,74,186,5,1,396,789,19,322,603,14,20.842105263157894,<=30,WI,Home,Upto 2014
J Garner,WI,Pace,1978-03-17,Bridgetown,West Indies,1978,2,121,187,8,1,577,955,26,456,768,18,22.192307692307693,<=30,WI,Home,Upto 2014
J Garner,WI,Pace,1979-12-01,Brisbane,Australia,1979,2,130,378,6,1,937,2006,27,807,1628,21,34.7037037037037,>30,AUS,Away,Upto 2014
J Garner,WI,Pace,1979-12-29,Melbourne,Australia,1979,2,89,214,5,1,659,1369,27,570,1155,22,24.40740740740741,<=30,AUS,Away,Upto 2014
J Garner,WI,Pace,1980-01-26,Adelaide,Australia,1980,2,82,174,3,1,844,1627,35,762,1453,32,24.114285714285714,<=30,AUS,Away,Upto 2014
J Garner,WI,Pace,1980-02-08,Dunedin,New Zealand,1980,2,87,293,5,1,533,1670,35,446,1377,30,15.228571428571428,<=30,NZ,Away,Upto 2014
J Garner,WI,Pace,1980-02-22,Christchurch,New Zealand,1980,1,75,168,2,1,946,1857,20,871,1689,18,47.3,>30,NZ,Away,Upto 2014
J Garner,WI,Pace,1980-02-29,Auckland,New Zealand,1980,2,73,272,7,1,786,1985,29,713,1713,22,27.103448275862068,<=30,NZ,Away,Upto 2014
J Garner,WI,Pace,1980-06-05,Nottingham,England,1980,2,74,343,7,1,897,2129,36,823,1786,29,24.916666666666668,<=30,ENG,Away,Upto 2014
J Garner,WI,Pace,1980-06-19,Lord's,England,1980,2,57,237,6,1,667,1407,18,610,1170,12,37.05555555555556,>30,ENG,Away,Upto 2014
J Garner,WI,Pace,1980-07-10,Manchester,England,1980,2,107,306,5,1,678,1412,23,571,1106,18,29.47826086956522,<=30,ENG,Away,Upto 2014
J Garner,WI,Pace,1980-07-24,The Oval,England,1980,2,91,300,5,1,630,1595,25,539,1295,20,25.2,<=30,ENG,Away,Upto 2014
J Garner,WI,Pace,1980-08-07,Leeds,England,1980,2,42,90,3,1,526,1199,25,484,1109,22,21.04,<=30,ENG,Away,Upto 2014
J Garner,WI,Pace,1980-11-24,Lahore,Pakistan,1980,2,88,216,2,1,508,1109,13,420,893,11,39.07692307692308,>30,PAK,Away,Upto 2014
J Garner,WI,Pace,1980-12-22,Karachi,Pakistan,1980,2,66,223,4,1,342,961,23,276,738,19,14.869565217391305,<=30,PAK,Away,Upto 2014
J Garner,WI,Pace,1980-12-30,Multan,Pakistan,1980,1,38,104,4,1,286,658,15,248,554,11,19.066666666666666,<=30,PAK,Away,Upto 2014
J Garner,WI,Pace,1981-02-13,Port of Spain,West Indies,1981,2,68,288,4,1,521,1338,21,453,1050,17,24.80952380952381,<=30,WI,Home,Upto 2014
J Garner,WI,Pace,1981-03-13,Bridgetown,West Indies,1981,2,69,170,3,1,801,1640,34,732,1470,31,23.558823529411764,<=30,WI,Home,Upto 2014
J Garner,WI,Pace,1981-03-27,St John's,West Indies,1981,2,77,186,1,1,702,1430,20,625,1244,19,35.1,>30,WI,Home,Upto 2014
J Garner,WI,Pace,1981-04-10,Kingston,West Indies,1981,2,89,264,2,1,705,1477,22,616,1213,20,32.04545454545455,>30,WI,Home,Upto 2014
J Garner,WI,Pace,1981-12-26,Melbourne,Australia,1981,2,96,228,5,1,642,1526,35,546,1298,30,18.34285714285714,<=30,AUS,Away,Upto 2014
J Garner,WI,Pace,1982-01-02,Sydney,Australia,1982,2,79,192,2,1,792,1770,20,713,1578,18,39.6,>30,AUS,Away,Upto 2014
J Garner,WI,Pace,1982-01-30,Adelaide,Australia,1982,2,100,312,5,1,872,1878,30,772,1566,25,29.066666666666666,<=30,AUS,Away,Upto 2014
J Garner,WI,Pace,1983-02-23,Kingston,West Indies,1983,2,57,172,2,1,545,1266,30,488,1094,28,18.166666666666668,<=30,WI,Home,Upto 2014
J Garner,WI,Pace,1983-03-11,Port of Spain,West Indies,1983,2,98,240,1,1,669,1364,18,571,1124,17,37.166666666666664,>30,WI,Home,Upto 2014
J Garner,WI,Pace,1983-03-31,Georgetown,West Indies,1983,1,57,102,1,1,361,700,8,304,598,7,45.125,>30,WI,Home,Upto 2014
J Garner,WI,Pace,1983-04-15,Bridgetown,West Indies,1983,2,89,164,3,1,618,1146,24,529,982,21,25.75,<=30,WI,Home,Upto 2014
J Garner,WI,Pace,1984-03-02,Georgetown,West Indies,1984,2,142,308,9,1,692,1314,20,550,1006,11,34.6,>30,WI,Home,Upto 2014
J Garner,WI,Pace,1984-03-16,Port of Spain,West Indies,1984,2,95,259,7,1,693,1381,19,598,1122,12,36.473684210526315,>30,WI,Home,Upto 2014
J Garner,WI,Pace,1984-03-30,Bridgetown,West Indies,1984,2,119,251,4,1,810,1566,27,691,1315,23,30.0,<=30,WI,Home,Upto 2014
J Garner,WI,Pace,1984-04-07,St John's,West Indies,1984,2,97,233,6,1,745,1490,28,648,1257,22,26.607142857142858,<=30,WI,Home,Upto 2014
J Garner,WI,Pace,1984-04-28,Kingston,West Indies,1984,2,70,202,5,1,537,1132,24,467,930,19,22.375,<=30,WI,Home,Upto 2014
J Garner,WI,Pace,1984-06-14,Birmingham,England,1984,2,108,230,9,1,672,1256,23,564,1026,14,29.217391304347824,<=30,ENG,Away,Upto 2014
J Garner,WI,Pace,1984-06-28,Lord's,England,1984,2,158,375,4,1,986,1843,27,828,1468,23,36.51851851851852,>30,ENG,Away,Upto 2014
J Garner,WI,Pace,1984-07-12,Leeds,England,1984,2,110,276,4,1,659,1294,24,549,1018,20,27.458333333333332,<=30,ENG,Away,Upto 2014
J Garner,WI,Pace,1984-07-26,Manchester,England,1984,2,76,206,6,1,536,1172,18,460,966,12,29.77777777777778,<=30,ENG,Away,Upto 2014
J Garner,WI,Pace,1984-08-09,The Oval,England,1984,2,88,220,6,1,809,1686,40,721,1466,34,20.225,<=30,ENG,Away,Upto 2014
J Garner,WI,Pace,1984-11-09,W.A.C.A,Australia,1984,2,76,138,5,1,700,1337,30,624,1199,25,23.333333333333332,<=30,AUS,Away,Upto 2014
J Garner,WI,Pace,1984-11-23,Brisbane,Australia,1984,2,147,232,4,1,749,1407,30,602,1175,26,24.966666666666665,<=30,AUS,Away,Upto 2014
J Garner,WI,Pace,1984-12-07,Adelaide,Australia,1984,2,119,252,3,1,771,1535,30,652,1283,27,25.7,<=30,AUS,Away,Upto 2014
J Garner,WI,Pace,1984-12-22,Melbourne,Australia,1984,2,123,258,5,1,827,1673,26,704,1415,21,31.807692307692307,>30,AUS,Away,Upto 2014
J Garner,WI,Pace,1984-12-30,Sydney,Australia,1984,1,101,186,2,1,535,1040,12,434,854,10,44.583333333333336,>30,AUS,Away,Upto 2014
J Garner,WI,Pace,1985-03-29,Port of Spain,West Indies,1985,2,82,237,2,1,784,1698,30,702,1461,28,26.133333333333333,<=30,WI,Home,Upto 2014
J Garner,WI,Pace,1985-04-06,Georgetown,West Indies,1985,1,72,167,2,1,825,1600,20,753,1433,18,41.25,>30,WI,Home,Upto 2014
J Garner,WI,Pace,1985-04-26,Bridgetown,West Indies,1985,2,70,204,2,1,558,1140,29,488,936,27,19.24137931034483,<=30,WI,Home,Upto 2014
J Garner,WI,Pace,1985-05-04,Kingston,West Indies,1985,2,78,210,4,1,691,1483,26,613,1273,22,26.576923076923077,<=30,WI,Home,Upto 2014
J Garner,WI,Pace,1986-02-21,Kingston,West Indies,1986,2,80,141,5,1,543,1027,29,463,886,24,18.724137931034484,<=30,WI,Home,Upto 2014
J Garner,WI,Pace,1986-03-07,Port of Spain,West Indies,1986,2,89,216,4,1,694,1180,22,605,964,18,31.545454545454547,>30,WI,Home,Upto 2014
J Garner,WI,Pace,1986-03-21,Bridgetown,West Indies,1986,2,104,186,5,1,585,983,28,481,797,23,20.892857142857142,<=30,WI,Home,Upto 2014
J Garner,WI,Pace,1986-04-03,Port of Spain,West Indies,1986,2,58,162,7,1,614,1036,27,556,874,20,22.74074074074074,<=30,WI,Home,Upto 2014
J Garner,WI,Pace,1986-04-11,St John's,West Indies,1986,2,105,232,6,1,906,1622,22,801,1390,16,41.18181818181818,>30,WI,Home,Upto 2014
J Garner,WI,Pace,1987-02-20,Wellington,New Zealand,1987,2,123,342,7,1,656,1620,18,533,1278,11,36.44444444444444,>30,NZ,Away,Upto 2014
J Garner,WI,Pace,1987-03-12,Christchurch,New Zealand,1987,2,82,120,5,1,630,1188,33,548,1068,28,19.09090909090909,<=30,NZ,Away,Upto 2014
J Hull,ENG,Pace,2024-09-06,The Oval,England,2024,2,91,102,3,1,809,1069,28,718,967,25,28.892857142857142,<=30,ENG,Home,After 1965
J Iddon,ENG,Spin,1935-03-14,Kingston,West Indies,1935,1,24,42,0,1,453,1026,10,429,984,10,45.3,>30,WI,Away,Upto 2014
J Iddon,ENG,Spin,1935-06-15,Nottingham,England,1935,1,3,24,0,1,343,876,8,340,852,8,42.875,>30,ENG,Home,Upto 2014
J Lewis,ENG,Pace,2006-06-02,Nottingham,England,2006,2,122,246,3,1,634,1203,19,512,957,16,33.36842105263158,>30,ENG,Home,Upto 2014
J Middleton,SA,Spin,1896-02-13,Gqeberha,South Africa,1896,2,130,309,9,1,134,318,10,4,9,1,13.4,<=30,SA,Home,After 1965
J Middleton,SA,Spin,1896-03-21,Cape Town,South Africa,1896,1,50,119,3,1,223,529,14,173,410,11,15.928571428571429,<=30,SA,Home,After 1965
J Middleton,SA,Spin,1899-02-14,Johannesburg,South Africa,1899,2,99,245,7,1,466,1319,30,367,1074,23,15.533333333333333,<=30,SA,Home,After 1965
J Middleton,SA,Spin,1899-04-01,Cape Town,South Africa,1899,2,92,235,4,1,347,777,19,255,542,15,18.263157894736842,<=30,SA,Home,After 1965
J Middleton,SA,Spin,1902-10-18,Johannesburg,South Africa,1902,2,42,102,1,1,315,623,23,273,521,22,13.695652173913043,<=30,SA,Home,Upto 2014
J Middleton,SA,Spin,1902-11-08,Cape Town,South Africa,1902,2,29,54,0,1,284,500,12,255,446,12,23.666666666666668,<=30,SA,Home,Upto 2014
J Mubarak,SL,Spin,2002-11-15,Centurion,South Africa,2002,1,6,12,0,1,191,489,4,185,477,4,47.75,>30,SA,Away,Upto 2014
J Mubarak,SL,Spin,2004-10-20,Faisalabad,Pakistan,2004,1,1,6,0,1,395,875,14,394,869,14,28.214285714285715,<=30,PAK,Away,Upto 2014
J Mubarak,SL,Spin,2004-10-28,Karachi,Pakistan,2004,1,33,54,0,1,509,1056,15,476,1002,15,33.93333333333333,>30,PAK,Away,Upto 2014
J Mubarak,SL,Spin,2005-12-18,Ahmedabad,India,2005,1,2,6,0,1,765,1419,29,763,1413,29,26.379310344827587,<=30,IND,Away,Upto 2014
J Mubarak,SL,Spin,2007-12-09,Colombo (SSC),Sri Lanka,2007,1,8,6,0,1,447,920,9,439,914,9,49.666666666666664,>30,SL,Home,Upto 2014
J Mubarak,SL,Spin,2015-07-03,Pallekele,Sri Lanka,2015,1,16,19,0,1,413,744,13,397,725,13,31.76923076923077,>30,SL,Home,After 1965
J Newman,NZ,Pace,1932-02-27,Christchurch,New Zealand,1932,1,76,173,2,1,481,1211,11,405,1038,9,43.72727272727273,>30,NZ,Home,Upto 2014
J Newman,NZ,Pace,1933-03-24,Christchurch,New Zealand,1933,1,91,150,0,1,467,920,9,376,770,9,51.888888888888886,>30,NZ,Home,Upto 2014
J Newman,NZ,Pace,1933-03-31,Auckland,New Zealand,1933,1,87,102,0,1,344,794,12,257,692,12,28.666666666666668,<=30,NZ,Home,Upto 2014
J Nyumbu,ZIM,Spin,2014-08-09,Harare,Zimbabwe,2014,2,181,321,5,1,495,865,15,314,544,10,33.0,>30,ZIM,Home,After 1965
J Nyumbu,ZIM,Spin,2014-10-25,Mirpur,Bangladesh,2014,2,69,96,0,1,460,898,22,391,802,22,20.90909090909091,<=30,BAN,Away,After 1965
J Nyumbu,ZIM,Spin,2016-08-06,Bulawayo,Zimbabwe,2016,2,129,246,0,1,624,1160,15,495,914,15,41.6,>30,ZIM,Home,After 1965
J O'Connor,ENG,Spin,1930-01-11,Bridgetown,West Indies,1930,1,31,60,1,1,542,1217,16,511,1157,15,33.875,>30,WI,Away,Upto 2014
J O'Connor,ENG,Spin,1930-02-01,Port of Spain,West Indies,1930,1,9,24,0,1,356,890,8,347,866,8,44.5,>30,WI,Away,Upto 2014
J O'Connor,ENG,Spin,1930-04-03,Kingston,West Indies,1930,2,32,78,0,1,1040,2209,18,1008,2131,18,57.77777777777778,>30,WI,Away,Upto 2014
J Ormond,ENG,Spin,2001-08-23,The Oval,England,2001,1,115,204,1,1,630,1004,15,515,800,14,42.0,>30,ENG,Home,Upto 2014
J Ormond,ENG,Spin,2001-12-03,Mohali,India,2001,1,70,168,1,1,507,1147,21,437,979,20,24.142857142857142,<=30,IND,Away,Upto 2014
J Overton,ENG,Pace,2022-06-23,Leeds,England,2022,2,146,222,2,1,862,1428,19,716,1206,17,45.36842105263158,>30,ENG,Home,After 1965
J Ryder,AUS,Pace,1920-12-17,Sydney,Australia,1920,2,44,138,2,1,483,1134,15,439,996,13,32.2,>30,AUS,Home,Upto 2014
J Ryder,AUS,Pace,1920-12-31,Melbourne,Australia,1920,2,48,144,1,1,456,894,15,408,750,14,30.4,>30,AUS,Home,Upto 2014
J Ryder,AUS,Pace,1921-01-14,Adelaide,Australia,1921,2,48,90,0,1,770,1488,14,722,1398,14,55.0,>30,AUS,Home,Upto 2014
J Ryder,AUS,Pace,1921-02-11,Melbourne,Australia,1921,2,35,120,0,1,517,1056,6,482,936,6,86.16666666666667,>30,AUS,Home,Upto 2014
J Ryder,AUS,Pace,1921-02-25,Sydney,Australia,1921,1,0,12,0,1,315,721,13,315,709,13,24.23076923076923,<=30,AUS,Home,Upto 2014
J Ryder,AUS,Pace,1921-11-05,Durban,South Africa,1921,1,7,48,0,1,645,1385,24,638,1337,24,26.875,<=30,SA,Away,Upto 2014
J Ryder,AUS,Pace,1921-11-12,Johannesburg,South Africa,1921,1,66,180,2,1,791,1453,15,725,1273,13,52.733333333333334,>30,SA,Away,Upto 2014
J Ryder,AUS,Pace,1921-11-26,Cape Town,South Africa,1921,2,40,138,2,1,368,882,11,328,744,9,33.45454545454545,>30,SA,Away,Upto 2014
J Ryder,AUS,Pace,1925-01-16,Adelaide,Australia,1925,2,26,64,1,1,326,857,11,300,793,10,29.636363636363637,<=30,AUS,Home,Upto 2014
J Ryder,AUS,Pace,1925-02-13,Melbourne,Australia,1925,1,83,200,2,1,305,712,6,222,512,4,50.833333333333336,>30,AUS,Home,Upto 2014
J Ryder,AUS,Pace,1925-02-27,Sydney,Australia,1925,1,24,56,1,1,265,608,9,241,552,8,29.444444444444443,<=30,AUS,Home,Upto 2014
J Ryder,AUS,Pace,1926-06-26,Lord's,England,1926,1,70,150,1,1,441,942,8,371,792,7,55.125,>30,ENG,Away,Upto 2014
J Ryder,AUS,Pace,1926-07-10,Leeds,England,1926,1,26,54,0,1,205,438,2,179,384,2,102.5,>30,ENG,Away,Upto 2014
J Ryder,AUS,Pace,1926-07-24,Manchester,England,1926,1,46,90,0,1,147,468,4,101,378,4,36.75,>30,ENG,Away,Upto 2014
J Ryder,AUS,Pace,1928-11-30,Brisbane,Australia,1928,2,66,120,0,1,486,1018,12,420,898,12,40.5,>30,AUS,Home,Upto 2014
J Ryder,AUS,Pace,1928-12-14,Sydney,Australia,1928,1,22,66,0,1,483,1249,14,461,1183,14,34.5,>30,AUS,Home,Upto 2014
J Ryder,AUS,Pace,1928-12-29,Melbourne,Australia,1928,2,30,59,1,1,730,1882,14,700,1823,13,52.142857142857146,>30,AUS,Home,Upto 2014
J Ryder,AUS,Pace,1929-02-01,Adelaide,Australia,1929,2,33,60,2,1,620,1906,12,587,1846,10,51.666666666666664,>30,AUS,Home,Upto 2014
J Ryder,AUS,Pace,1929-03-08,Melbourne,Australia,1929,1,29,108,2,1,826,2351,25,797,2243,23,33.04,>30,AUS,Home,Upto 2014
J Sharp,ENG,Pace,1909-07-01,Leeds,England,1909,1,7,6,0,1,393,1142,20,386,1136,20,19.65,<=30,ENG,Home,Upto 2014
J Sharp,ENG,Pace,1909-07-26,Manchester,England,1909,1,3,6,0,1,310,803,19,307,797,19,16.31578947368421,<=30,ENG,Home,Upto 2014
J Sharp,ENG,Pace,1909-08-09,The Oval,England,1909,2,101,171,3,1,457,871,15,356,700,12,30.466666666666665,>30,ENG,Home,Upto 2014
J Southerton,ENG,Spin,1877-03-15,Melbourne,Australia,1877,1,61,148,3,1,437,1296,31,376,1148,28,14.096774193548388,<=30,AUS,Away,After 1965
J Southerton,ENG,Spin,1877-03-31,Melbourne,Australia,1877,1,46,115,4,1,437,1222,21,391,1107,17,20.80952380952381,<=30,AUS,Away,After 1965
J Srinath,IND,Pace,1991-11-29,Brisbane,Australia,1991,2,65,202,3,1,581,1459,29,516,1257,26,20.03448275862069,<=30,AUS,Away,Upto 2014
J Srinath,IND,Pace,1991-12-26,Melbourne,Australia,1991,2,99,198,0,1,732,1688,29,633,1490,29,25.24137931034483,<=30,AUS,Away,Upto 2014
J Srinath,IND,Pace,1992-01-02,Sydney,Australia,1992,2,97,198,1,1,641,1594,19,544,1396,18,33.73684210526316,>30,AUS,Away,Upto 2014
J Srinath,IND,Pace,1992-01-25,Adelaide,Australia,1992,2,102,282,2,1,796,1827,30,694,1545,28,26.533333333333335,<=30,AUS,Away,Upto 2014
J Srinath,IND,Pace,1992-02-01,W.A.C.A,Australia,1992,2,190,327,4,1,946,1994,34,756,1667,30,27.823529411764707,<=30,AUS,Away,Upto 2014
J Srinath,IND,Pace,1992-10-18,Harare,Zimbabwe,1992,2,104,264,3,1,480,1630,15,376,1366,12,32.0,>30,ZIM,Away,Upto 2014
J Srinath,IND,Pace,1992-11-13,Durban,South Africa,1992,2,111,204,3,1,480,1371,14,369,1167,11,34.285714285714285,>30,SA,Away,Upto 2014
J Srinath,IND,Pace,1992-11-26,Johannesburg,South Africa,1992,2,118,317,3,1,741,2035,23,623,1718,20,32.21739130434783,>30,SA,Away,Upto 2014
J Srinath,IND,Pace,1993-01-02,Cape Town,South Africa,1993,2,84,312,6,1,434,1582,19,350,1270,13,22.842105263157894,<=30,SA,Away,Upto 2014
J Srinath,IND,Pace,1993-07-17,Kandy,Sri Lanka,1993,1,0,6,0,1,23,72,3,23,66,3,7.666666666666667,<=30,SL,Away,Upto 2014
J Srinath,IND,Pace,1993-07-27,Colombo (SSC),Sri Lanka,1993,2,78,192,3,1,627,1409,18,549,1217,15,34.833333333333336,>30,SL,Away,Upto 2014
J Srinath,IND,Pace,1994-03-19,Hamilton,New Zealand,1994,2,164,384,5,1,466,1167,15,302,783,10,31.066666666666666,>30,NZ,Away,Upto 2014
J Srinath,IND,Pace,1994-11-18,Wankhede,India,1994,2,85,198,5,1,502,993,23,417,795,18,21.82608695652174,<=30,IND,Home,Upto 2014
J Srinath,IND,Pace,1994-12-01,Nagpur,India,1994,2,51,126,1,1,503,867,8,452,741,7,62.875,>30,IND,Home,Upto 2014
J Srinath,IND,Pace,1994-12-10,Mohali,India,1994,2,201,312,2,1,720,1337,21,519,1025,19,34.285714285714285,>30,IND,Home,Upto 2014
J Srinath,IND,Pace,1995-10-18,Bengaluru,India,1995,2,65,174,5,1,331,688,17,266,514,12,19.470588235294116,<=30,IND,Home,Upto 2014
J Srinath,IND,Pace,1995-11-08,Cuttack,India,1995,1,16,48,0,1,240,497,7,224,449,7,34.285714285714285,>30,IND,Home,Upto 2014
J Srinath,IND,Pace,1996-06-06,Birmingham,England,1996,2,150,259,4,1,677,1326,30,527,1067,26,22.566666666666666,<=30,ENG,Away,Upto 2014
J Srinath,IND,Pace,1996-06-20,Lord's,England,1996,2,152,372,5,1,826,2028,26,674,1656,21,31.76923076923077,>30,ENG,Away,Upto 2014
J Srinath,IND,Pace,1996-07-04,Nottingham,England,1996,1,131,282,2,1,859,1781,24,728,1499,22,35.791666666666664,>30,ENG,Away,Upto 2014
J Srinath,IND,Pace,1996-11-20,Ahmedabad,India,1996,2,68,186,8,1,335,936,19,267,750,11,17.63157894736842,<=30,IND,Home,Upto 2014
J Srinath,IND,Pace,1996-11-27,Eden Gardens,India,1996,2,208,368,3,1,704,1315,23,496,947,20,30.608695652173914,>30,IND,Home,Upto 2014
J Srinath,IND,Pace,1996-12-08,Kanpur,India,1996,2,80,211,6,1,443,1201,16,363,990,10,27.6875,<=30,IND,Home,Upto 2014
J Srinath,IND,Pace,1996-12-26,Durban,South Africa,1996,2,116,258,5,1,537,1172,37,421,914,32,14.513513513513514,<=30,SA,Away,Upto 2014
J Srinath,IND,Pace,1997-01-02,Cape Town,South Africa,1997,2,208,336,6,1,897,1609,22,689,1273,16,40.77272727272727,>30,SA,Away,Upto 2014
J Srinath,IND,Pace,1997-01-16,Johannesburg,South Africa,1997,2,193,295,7,1,895,1774,26,702,1479,19,34.42307692307692,>30,SA,Away,Upto 2014
J Srinath,IND,Pace,1997-11-19,Mohali,India,1997,2,167,296,7,1,565,1196,16,398,900,9,35.3125,>30,IND,Home,Upto 2014
J Srinath,IND,Pace,1997-12-03,Wankhede,India,1997,2,132,260,2,1,639,1269,12,507,1009,10,53.25,>30,IND,Home,Upto 2014
J Srinath,IND,Pace,1998-03-06,Chennai,India,1998,2,55,141,2,1,310,705,5,255,564,3,62.0,>30,IND,Home,Upto 2014
J Srinath,IND,Pace,1998-03-18,Eden Gardens,India,1998,2,124,216,6,1,398,718,11,274,502,5,36.18181818181818,>30,IND,Home,Upto 2014
J Srinath,IND,Pace,1998-10-07,Harare,Zimbabwe,1998,2,102,267,5,1,643,1431,26,541,1164,21,24.73076923076923,<=30,ZIM,Away,Upto 2014
J Srinath,IND,Pace,1998-12-26,Wellington,New Zealand,1998,2,171,333,4,1,632,1417,22,461,1084,18,28.727272727272727,<=30,NZ,Away,Upto 2014
J Srinath,IND,Pace,1999-01-02,Hamilton,New Zealand,1999,2,185,356,6,1,1002,1896,23,817,1540,17,43.56521739130435,>30,NZ,Away,Upto 2014
J Srinath,IND,Pace,1999-01-28,Chennai,India,1999,2,131,186,3,1,432,740,16,301,554,13,27.0,<=30,IND,Home,Upto 2014
J Srinath,IND,Pace,1999-02-04,Delhi,India,1999,2,88,144,1,1,268,588,7,180,444,6,38.285714285714285,>30,IND,Home,Upto 2014
J Srinath,IND,Pace,1999-02-16,Eden Gardens,India,1999,2,132,276,13,1,539,1227,30,407,951,17,17.966666666666665,<=30,IND,Home,Upto 2014
J Srinath,IND,Pace,1999-10-10,Mohali,India,1999,2,108,318,8,1,577,1368,20,469,1050,12,28.85,<=30,IND,Home,Upto 2014
J Srinath,IND,Pace,1999-10-22,Kanpur,India,1999,2,74,186,3,1,214,642,8,140,456,5,26.75,<=30,IND,Home,Upto 2014
J Srinath,IND,Pace,1999-10-29,Ahmedabad,India,1999,2,131,300,2,1,649,1266,11,518,966,9,59.0,>30,IND,Home,Upto 2014
J Srinath,IND,Pace,1999-12-10,Adelaide,Australia,1999,2,181,305,4,1,755,1459,27,574,1154,23,27.962962962962962,<=30,AUS,Away,Upto 2014
J Srinath,IND,Pace,1999-12-26,Melbourne,Australia,1999,2,175,283,4,1,715,1451,26,540,1168,22,27.5,<=30,AUS,Away,Upto 2014
J Srinath,IND,Pace,2000-01-02,Sydney,Australia,2000,1,105,168,2,1,643,1127,22,538,959,20,29.227272727272727,<=30,AUS,Away,Upto 2014
J Srinath,IND,Pace,2000-02-24,Wankhede,India,2000,2,71,138,3,1,367,874,21,296,736,18,17.476190476190474,<=30,IND,Home,Upto 2014
J Srinath,IND,Pace,2000-03-02,Bengaluru,India,2000,1,53,180,1,1,357,999,12,304,819,11,29.75,<=30,IND,Home,Upto 2014
J Srinath,IND,Pace,2000-11-10,Dhaka,Bangladesh,2000,2,66,198,3,1,382,888,12,316,690,9,31.833333333333332,>30,BAN,Away,Upto 2014
J Srinath,IND,Pace,2000-11-18,Delhi,India,2000,2,141,355,9,1,620,1261,15,479,906,6,41.333333333333336,>30,IND,Home,Upto 2014
J Srinath,IND,Pace,2000-11-25,Nagpur,India,2000,2,134,259,3,1,629,1195,8,495,936,5,78.625,>30,IND,Home,Upto 2014
J Srinath,IND,Pace,2001-02-27,Wankhede,India,2001,2,77,108,2,1,373,790,15,296,682,13,24.866666666666667,<=30,IND,Home,Upto 2014
J Srinath,IND,Pace,2001-06-07,Bulawayo,Zimbabwe,2001,2,118,284,4,1,658,1325,23,540,1041,19,28.608695652173914,<=30,ZIM,Away,Upto 2014
J Srinath,IND,Pace,2001-06-15,Harare,Zimbabwe,2001,2,128,255,3,1,726,1580,27,598,1325,24,26.88888888888889,<=30,ZIM,Away,Upto 2014
J Srinath,IND,Pace,2001-08-14,Galle,Sri Lanka,2001,2,114,155,5,1,532,1132,18,418,977,13,29.555555555555557,<=30,SL,Away,Upto 2014
J Srinath,IND,Pace,2001-11-03,Bloemfontein,South Africa,2001,2,153,228,5,1,966,1509,27,813,1281,22,35.77777777777778,>30,SA,Away,Upto 2014
J Srinath,IND,Pace,2001-11-16,Gqeberha,South Africa,2001,2,104,282,8,1,644,1436,22,540,1154,14,29.272727272727273,<=30,SA,Away,Upto 2014
J Srinath,IND,Pace,2001-12-11,Ahmedabad,India,2001,2,129,228,2,1,368,804,6,239,576,4,61.333333333333336,>30,IND,Home,Upto 2014
J Srinath,IND,Pace,2001-12-19,Bengaluru,India,2001,2,92,198,4,1,273,609,12,181,411,8,22.75,<=30,IND,Home,Upto 2014
J Srinath,IND,Pace,2002-02-21,Nagpur,India,2002,2,85,168,1,1,439,839,7,354,671,6,62.714285714285715,>30,IND,Home,Upto 2014
J Srinath,IND,Pace,2002-02-28,Delhi,India,2002,2,49,132,2,1,446,889,10,397,757,8,44.6,>30,IND,Home,Upto 2014
J Srinath,IND,Pace,2002-04-11,Georgetown,West Indies,2002,1,91,198,3,1,506,1071,12,415,873,9,42.166666666666664,>30,WI,Away,Upto 2014
J Srinath,IND,Pace,2002-04-19,Port of Spain,West Indies,2002,2,140,324,6,1,849,1915,33,709,1591,27,25.727272727272727,<=30,WI,Away,Upto 2014
J Srinath,IND,Pace,2002-05-02,Bridgetown,West Indies,2002,1,85,192,0,1,655,1356,22,570,1164,22,29.772727272727273,<=30,WI,Away,Upto 2014
J Srinath,IND,Pace,2002-05-10,St John's,West Indies,2002,1,82,270,0,1,856,1992,11,774,1722,11,77.81818181818181,>30,WI,Away,Upto 2014
J Srinath,IND,Pace,2002-05-18,Kingston,West Indies,2002,2,160,288,4,1,844,1737,30,684,1449,26,28.133333333333333,<=30,WI,Away,Upto 2014
J Srinath,IND,Pace,2002-10-09,Wankhede,India,2002,2,35,90,1,1,351,798,10,316,708,9,35.1,>30,IND,Home,Upto 2014
J Srinath,IND,Pace,2002-10-17,Chennai,India,2002,2,30,114,3,1,288,754,13,258,640,10,22.153846153846153,<=30,IND,Home,Upto 2014
J Srinath,IND,Pace,2002-10-30,Eden Gardens,India,2002,1,62,114,0,1,701,1322,15,639,1208,15,46.733333333333334,>30,IND,Home,Upto 2014
J Trim,WI,Pace,1948-03-03,Georgetown,West Indies,1948,2,44,138,3,1,265,632,11,221,494,8,24.09090909090909,<=30,WI,Home,Upto 2014
J Trim,WI,Pace,1949-01-27,Chennai,India,1949,2,76,258,7,1,442,1095,18,366,837,11,24.555555555555557,<=30,IND,Away,Upto 2014
J Trim,WI,Pace,1949-02-04,Brabourne,India,1949,2,112,222,3,1,462,1177,18,350,955,15,25.666666666666668,<=30,IND,Away,Upto 2014
J Trim,WI,Pace,1951-12-31,Melbourne,Australia,1951,2,59,176,5,1,342,918,16,283,742,11,21.375,<=30,AUS,Away,Upto 2014
J Worrall,AUS,Spin,1885-01-01,Melbourne,Australia,1885,1,97,224,1,1,372,1209,9,275,985,8,41.333333333333336,>30,AUS,Home,After 1965
J Worrall,AUS,Spin,1888-08-13,The Oval,England,1888,1,15,16,0,1,208,504,11,193,488,11,18.90909090909091,<=30,ENG,Away,After 1965
J Worrall,AUS,Spin,1899-08-14,The Oval,England,1899,1,15,15,0,1,465,899,10,450,884,10,46.5,>30,ENG,Away,After 1965
J Yadav,IND,Spin,2016-11-17,Visakhapatnam,India,2016,2,68,141,4,1,632,1483,25,564,1342,21,25.28,<=30,IND,Home,After 1965
J Yadav,IND,Spin,2016-11-26,Mohali,India,2016,2,70,162,4,1,572,1216,17,502,1054,13,33.64705882352941,>30,IND,Home,After 1965
J Yadav,IND,Spin,2016-12-08,Wankhede,India,2016,2,128,186,1,1,864,1639,27,736,1453,26,32.0,>30,IND,Home,After 1965
J Yadav,IND,Spin,2017-02-23,Pune,India,2017,2,101,138,2,1,566,1181,31,465,1043,29,18.258064516129032,<=30,IND,Home,After 1965
J Yadav,IND,Spin,2021-12-03,Wankhede,India,2021,2,62,96,5,1,600,1113,33,538,1017,28,18.181818181818183,<=30,IND,Home,After 1965
J Yadav,IND,Spin,2022-03-04,Mohali,India,2022,2,36,102,0,1,500,927,18,464,825,18,27.77777777777778,<=30,IND,Home,After 1965
JA Dunning,NZ,Spin,1933-03-31,Auckland,New Zealand,1933,1,156,258,2,1,345,534,4,189,276,2,86.25,>30,NZ,Home,Upto 2014
JA Dunning,NZ,Spin,1937-06-26,Lord's,England,1937,2,124,174,0,1,512,1098,11,388,924,11,46.54545454545455,>30,ENG,Away,Upto 2014
JA Dunning,NZ,Spin,1937-07-24,Manchester,England,1937,2,119,240,2,1,559,1166,19,440,926,17,29.42105263157895,<=30,ENG,Away,Upto 2014
JA Dunning,NZ,Spin,1937-08-14,The Oval,England,1937,2,94,158,1,1,331,715,12,237,557,11,27.583333333333332,<=30,ENG,Away,Upto 2014
JA Flavell,ENG,Pace,1961-07-27,Manchester,England,1961,2,126,310,3,1,869,2028,25,743,1718,22,34.76,>30,ENG,Home,Upto 2014
JA Flavell,ENG,Pace,1961-08-17,The Oval,England,1961,1,105,186,2,1,680,1860,19,575,1674,17,35.78947368421053,>30,ENG,Home,Upto 2014
JA Flavell,ENG,Pace,1964-06-04,Nottingham,England,1964,2,39,122,2,1,492,1276,20,453,1154,18,24.6,<=30,ENG,Home,Upto 2014
JA Flavell,ENG,Pace,1964-07-02,Leeds,England,1964,1,97,174,0,1,604,1337,21,507,1163,21,28.761904761904763,<=30,ENG,Home,Upto 2014
JA Hayes,NZ,Pace,1951-03-17,Christchurch,New Zealand,1951,1,85,258,1,1,365,1014,6,280,756,5,60.833333333333336,>30,NZ,Home,Upto 2014
JA Hayes,NZ,Pace,1951-03-24,Wellington,New Zealand,1951,1,44,120,2,1,192,572,8,148,452,6,24.0,<=30,NZ,Home,Upto 2014
JA Hayes,NZ,Pace,1952-02-08,Christchurch,New Zealand,1952,2,80,144,4,1,219,588,9,139,444,5,24.333333333333332,<=30,NZ,Home,Upto 2014
JA Hayes,NZ,Pace,1952-02-15,Auckland,New Zealand,1952,1,106,180,1,1,254,466,5,148,286,4,50.8,>30,NZ,Home,Upto 2014
JA Hayes,NZ,Pace,1955-03-25,Auckland,New Zealand,1955,1,71,138,3,1,296,880,23,225,742,20,12.869565217391305,<=30,NZ,Home,Upto 2014
JA Hayes,NZ,Pace,1955-10-26,Lahore,Pakistan,1955,2,132,275,3,1,619,1402,11,487,1127,8,56.27272727272727,>30,PAK,Away,Upto 2014
JA Hayes,NZ,Pace,1955-11-19,Hyderabad (Deccan),India,1955,1,91,156,3,1,344,973,5,253,817,2,68.8,>30,IND,Away,Upto 2014
JA Hayes,NZ,Pace,1955-12-02,Brabourne,India,1955,1,79,156,1,1,320,942,10,241,786,9,32.0,>30,IND,Away,Upto 2014
JA Hayes,NZ,Pace,1955-12-16,Delhi,India,1955,1,105,264,2,1,511,1457,6,406,1193,4,85.16666666666667,>30,IND,Away,Upto 2014
JA Hayes,NZ,Pace,1955-12-28,Eden Gardens,India,1955,2,105,264,4,1,465,1398,12,360,1134,8,38.75,>30,IND,Away,Upto 2014
JA Hayes,NZ,Pace,1956-01-06,Chennai,India,1956,1,94,186,0,1,296,750,1,202,564,1,296.0,>30,IND,Away,Upto 2014
JA Hayes,NZ,Pace,1958-06-05,Birmingham,England,1958,2,108,210,2,1,493,1493,26,385,1283,24,18.96153846153846,<=30,ENG,Away,Upto 2014
JA Hayes,NZ,Pace,1958-06-19,Lord's,England,1958,1,36,132,4,1,233,706,14,197,574,10,16.642857142857142,<=30,ENG,Away,Upto 2014
JA Hayes,NZ,Pace,1958-07-03,Leeds,England,1958,1,30,78,0,1,193,612,2,163,534,2,96.5,>30,ENG,Away,Upto 2014
JA Hayes,NZ,Pace,1958-07-24,Manchester,England,1958,1,51,114,0,1,389,953,12,338,839,12,32.416666666666664,>30,ENG,Away,Upto 2014
JA Jameson,ENG,Spin,1974-02-16,Kingston,West Indies,1974,1,17,42,1,1,880,2436,16,863,2394,15,55.0,>30,WI,Away,Upto 2014
JA Morkel,SA,Pace,2009-03-19,Cape Town,South Africa,2009,2,132,192,1,1,890,1587,18,758,1395,17,49.44444444444444,>30,SA,Home,Upto 2014
JA Raval,NZ,Spin,2018-12-15,Wellington,New Zealand,2018,1,1,6,0,1,274,534,4,273,528,4,68.5,>30,NZ,Home,After 1965
JA Raval,NZ,Spin,2019-12-12,Perth,Australia,2019,1,33,78,1,1,325,635,8,292,557,7,40.625,>30,AUS,Away,After 1965
JA Rennie,ZIM,Pace,1993-12-01,Karachi,Pakistan,1993,2,114,210,1,1,605,1326,22,491,1116,21,27.5,<=30,PAK,Away,Upto 2014
JA Rennie,ZIM,Pace,1993-12-16,Lahore,Pakistan,1993,2,57,148,2,1,467,1213,21,410,1065,19,22.238095238095237,<=30,PAK,Away,Upto 2014
JA Rennie,ZIM,Pace,1994-10-20,Bulawayo,Zimbabwe,1994,2,85,300,0,1,524,1630,17,439,1330,17,30.823529411764707,>30,ZIM,Home,Upto 2014
JA Rennie,ZIM,Pace,1997-09-18,Harare,Zimbabwe,1997,2,37,66,0,1,808,1794,25,771,1728,25,32.32,>30,ZIM,Home,Upto 2014
JA Richardson,AUS,Pace,2019-01-24,Brisbane,Australia,2019,2,45,162,5,1,398,892,24,353,730,19,16.583333333333332,<=30,AUS,Home,After 1965
JA Richardson,AUS,Pace,2019-02-01,Canberra,Australia,2019,2,78,144,1,1,709,1113,23,631,969,22,30.82608695652174,>30,AUS,Home,After 1965
JA Richardson,AUS,Pace,2021-12-16,Adelaide,Australia,2021,2,120,229,5,1,845,1824,27,725,1595,22,31.296296296296298,>30,AUS,Home,After 1965
JA Rudolph,SA,Spin,2003-08-21,Leeds,England,2003,1,1,12,1,1,14,42,1,13,30,0,14.0,<=30,ENG,Away,Upto 2014
JA Rudolph,SA,Spin,2003-09-04,The Oval,England,2003,1,28,36,0,1,289,420,3,261,384,3,96.33333333333333,>30,ENG,Away,Upto 2014
JA Rudolph,SA,Spin,2003-12-26,Durban,South Africa,2003,2,100,150,1,1,190,312,3,90,162,2,63.333333333333336,>30,SA,Home,Upto 2014
JA Rudolph,SA,Spin,2004-01-02,Cape Town,South Africa,2004,1,0,6,0,1,458,726,4,458,720,4,114.5,>30,SA,Home,Upto 2014
JA Rudolph,SA,Spin,2004-01-16,Centurion,South Africa,2004,2,41,48,0,1,187,304,2,146,256,2,93.5,>30,SA,Home,Upto 2014
JA Rudolph,SA,Spin,2004-03-10,Hamilton,New Zealand,2004,1,20,30,0,1,513,956,8,493,926,8,64.125,>30,NZ,Away,Upto 2014
JA Rudolph,SA,Spin,2004-03-18,Auckland,New Zealand,2004,1,26,36,0,1,247,374,2,221,338,2,123.5,>30,NZ,Away,Upto 2014
JA Rudolph,SA,Spin,2004-08-04,Galle,Sri Lanka,2004,1,16,54,0,1,688,1462,17,672,1408,17,40.470588235294116,>30,SL,Away,Upto 2014
JA Rudolph,SA,Spin,2004-08-11,Colombo (SSC),Sri Lanka,2004,2,38,66,1,1,470,988,13,432,922,12,36.15384615384615,>30,SL,Away,Upto 2014
JA Rudolph,SA,Spin,2004-11-28,Eden Gardens,India,2004,1,24,48,1,1,470,978,15,446,930,14,31.333333333333332,>30,IND,Away,Upto 2014
JA Rudolph,SA,Spin,2005-03-04,Cape Town,South Africa,2005,1,1,6,0,1,206,230,7,205,224,7,29.428571428571427,<=30,SA,Home,Upto 2014
JA Rudolph,SA,Spin,2005-03-11,Centurion,South Africa,2005,2,14,24,0,1,252,431,4,238,407,4,63.0,>30,SA,Home,Upto 2014
JA Rudolph,SA,Spin,2005-12-16,W.A.C.A,Australia,2005,1,29,40,0,1,218,526,6,189,486,6,36.333333333333336,>30,AUS,Away,Upto 2014
JA Rudolph,SA,Spin,2006-01-02,Sydney,Australia,2006,1,49,66,0,1,507,813,9,458,747,9,56.333333333333336,>30,AUS,Away,Upto 2014
JA Rudolph,SA,Spin,2006-07-27,Colombo (SSC),Sri Lanka,2006,1,45,42,0,1,531,1166,11,486,1124,11,48.27272727272727,>30,SL,Away,Upto 2014
JA Small,WI,Pace,1928-06-23,Lord's,England,1928,1,67,90,2,1,399,886,12,332,796,10,33.25,>30,ENG,Away,Upto 2014
JA Small,WI,Pace,1928-08-11,The Oval,England,1928,1,39,90,0,1,476,809,16,437,719,16,29.75,<=30,ENG,Away,Upto 2014
JA Small,WI,Pace,1930-02-01,Port of Spain,West Indies,1930,2,78,186,1,1,688,1491,29,610,1305,28,23.724137931034484,<=30,WI,Home,Upto 2014
JA Snow,ENG,Pace,1965-06-17,Lord's,England,1965,2,80,210,4,1,637,1471,22,557,1261,18,28.954545454545453,<=30,ENG,Home,Upto 2014
JA Snow,ENG,Pace,1965-08-05,Nottingham,England,1965,2,146,330,4,1,718,1736,30,572,1406,26,23.933333333333334,<=30,ENG,Home,Upto 2014
JA Snow,ENG,Pace,1966-06-30,Nottingham,England,1966,2,199,378,4,1,760,1648,27,561,1270,23,28.14814814814815,<=30,ENG,Home,Upto 2014
JA Snow,ENG,Pace,1966-08-04,Leeds,England,1966,1,146,252,3,1,453,936,13,307,684,10,34.84615384615385,>30,ENG,Home,Upto 2014
JA Snow,ENG,Pace,1966-08-18,The Oval,England,1966,2,106,203,5,1,459,1079,13,353,876,8,35.30769230769231,>30,ENG,Home,Upto 2014
JA Snow,ENG,Pace,1967-06-08,Leeds,England,1967,2,142,348,4,1,436,1074,7,294,726,3,62.285714285714285,>30,ENG,Home,Upto 2014
JA Snow,ENG,Pace,1967-06-22,Lord's,England,1967,2,61,172,4,1,257,628,10,196,456,6,25.7,<=30,ENG,Home,Upto 2014
JA Snow,ENG,Pace,1967-07-13,Birmingham,England,1967,2,61,156,2,1,150,354,6,89,198,4,25.0,<=30,ENG,Home,Upto 2014
JA Snow,ENG,Pace,1967-07-27,Lord's,England,1967,2,126,295,3,1,434,1150,13,308,855,10,33.38461538461539,>30,ENG,Home,Upto 2014
JA Snow,ENG,Pace,1968-02-08,Kingston,West Indies,1968,2,140,288,8,1,570,1419,25,430,1131,17,22.8,<=30,WI,Away,Upto 2014
JA Snow,ENG,Pace,1968-02-29,Bridgetown,West Indies,1968,2,125,270,8,1,595,1213,17,470,943,9,35.0,>30,WI,Away,Upto 2014
JA Snow,ENG,Pace,1968-03-14,Port of Spain,West Indies,1968,2,97,174,1,1,441,768,6,344,594,5,73.5,>30,WI,Away,Upto 2014
JA Snow,ENG,Pace,1968-03-28,Georgetown,West Indies,1968,2,142,258,10,1,579,1118,16,437,860,6,36.1875,>30,WI,Away,Upto 2014
JA Snow,ENG,Pace,1968-06-06,Manchester,England,1968,2,148,306,5,1,493,1497,18,345,1191,13,27.38888888888889,<=30,ENG,Home,Upto 2014
JA Snow,ENG,Pace,1968-06-20,Lord's,England,1968,2,44,126,2,1,427,1141,15,383,1015,13,28.466666666666665,<=30,ENG,Home,Upto 2014
JA Snow,ENG,Pace,1968-07-11,Birmingham,England,1968,2,78,156,2,1,595,1325,15,517,1169,13,39.666666666666664,>30,ENG,Home,Upto 2014
JA Snow,ENG,Pace,1968-07-25,Leeds,England,1968,2,149,354,5,1,706,1746,18,557,1392,13,39.22222222222222,>30,ENG,Home,Upto 2014
JA Snow,ENG,Pace,1968-08-22,The Oval,England,1968,2,89,276,3,1,485,1288,15,396,1012,12,32.333333333333336,>30,ENG,Home,Upto 2014
JA Snow,ENG,Pace,1969-02-28,Dhaka,Bangladesh,1969,2,85,222,4,1,300,937,11,215,715,7,27.272727272727273,<=30,BAN,Away,Upto 2014
JA Snow,ENG,Pace,1969-06-12,Manchester,England,1969,2,130,225,6,1,490,1177,22,360,952,16,22.272727272727273,<=30,ENG,Home,Upto 2014
JA Snow,ENG,Pace,1969-06-26,Lord's,England,1969,2,183,366,6,1,864,2111,25,681,1745,19,34.56,>30,ENG,Home,Upto 2014
JA Snow,ENG,Pace,1969-07-10,Leeds,England,1969,2,93,246,3,1,581,1581,25,488,1335,22,23.24,<=30,ENG,Home,Upto 2014
JA Snow,ENG,Pace,1969-08-07,Nottingham,England,1969,2,80,180,0,1,534,1193,14,454,1013,14,38.142857142857146,>30,ENG,Home,Upto 2014
JA Snow,ENG,Pace,1969-08-21,The Oval,England,1969,2,74,186,3,1,397,1023,15,323,837,12,26.466666666666665,<=30,ENG,Home,Upto 2014
JA Snow,ENG,Pace,1970-11-27,Brisbane,Australia,1970,2,162,419,8,1,624,1629,19,462,1210,11,32.8421052631579,>30,AUS,Away,Upto 2014
JA Snow,ENG,Pace,1970-12-11,W.A.C.A,Australia,1970,2,160,341,6,1,852,2129,21,692,1788,15,40.57142857142857,>30,AUS,Away,Upto 2014
JA Snow,ENG,Pace,1971-01-09,Sydney,Australia,1971,2,63,253,8,1,480,1339,18,417,1086,10,26.666666666666668,<=30,AUS,Away,Upto 2014
JA Snow,ENG,Pace,1971-01-21,Melbourne,Australia,1971,2,115,328,4,1,660,1712,13,545,1384,9,50.76923076923077,>30,AUS,Away,Upto 2014
JA Snow,ENG,Pace,1971-01-29,Adelaide,Australia,1971,2,133,304,3,1,768,1851,22,635,1547,19,34.90909090909091,>30,AUS,Away,Upto 2014
JA Snow,ENG,Pace,1971-02-12,Sydney,Australia,1971,2,75,160,2,1,479,1333,21,404,1173,19,22.80952380952381,<=30,AUS,Away,Upto 2014
JA Snow,ENG,Pace,1971-07-22,Lord's,England,1971,2,87,234,3,1,287,804,9,200,570,6,31.88888888888889,>30,ENG,Home,Upto 2014
JA Snow,ENG,Pace,1971-08-19,The Oval,England,1971,2,82,210,3,1,247,588,5,165,378,2,49.4,>30,ENG,Home,Upto 2014
JA Snow,ENG,Pace,1972-06-08,Manchester,England,1972,2,128,282,8,1,656,1682,30,528,1400,22,21.866666666666667,<=30,ENG,Home,Upto 2014
JA Snow,ENG,Pace,1972-06-22,Lord's,England,1972,2,72,240,5,1,594,1418,30,522,1178,25,19.8,<=30,ENG,Home,Upto 2014
JA Snow,ENG,Pace,1972-07-13,Nottingham,England,1972,2,186,330,8,1,670,1779,23,484,1449,15,29.130434782608695,<=30,ENG,Home,Upto 2014
JA Snow,ENG,Pace,1972-07-27,Leeds,England,1972,2,37,138,2,1,173,528,9,136,390,7,19.22222222222222,<=30,ENG,Home,Upto 2014
JA Snow,ENG,Pace,1972-08-10,The Oval,England,1972,2,132,245,1,1,662,1491,19,530,1246,18,34.8421052631579,>30,ENG,Home,Upto 2014
JA Snow,ENG,Pace,1973-06-07,Nottingham,England,1973,2,125,336,5,1,817,1990,27,692,1654,22,30.25925925925926,>30,ENG,Home,Upto 2014
JA Snow,ENG,Pace,1973-06-21,Lord's,England,1973,1,109,228,3,1,777,1763,19,668,1535,16,40.89473684210526,>30,ENG,Home,Upto 2014
JA Snow,ENG,Pace,1973-07-05,Leeds,England,1973,2,86,247,5,1,624,1466,29,538,1219,24,21.517241379310345,<=30,ENG,Home,Upto 2014
JA Snow,ENG,Pace,1973-07-26,The Oval,England,1973,2,133,294,3,1,552,1154,24,419,860,21,23.0,<=30,ENG,Home,Upto 2014
JA Snow,ENG,Pace,1975-07-10,Birmingham,England,1975,1,86,198,3,1,502,1221,27,416,1023,24,18.59259259259259,<=30,ENG,Home,Upto 2014
JA Snow,ENG,Pace,1975-07-31,Lord's,England,1975,2,148,240,4,1,808,1552,18,660,1312,14,44.888888888888886,>30,ENG,Home,Upto 2014
JA Snow,ENG,Pace,1975-08-14,Leeds,England,1975,2,43,203,3,1,612,1447,21,569,1244,18,29.142857142857142,<=30,ENG,Home,Upto 2014
JA Snow,ENG,Pace,1975-08-28,The Oval,England,1975,2,78,174,1,1,686,1764,24,608,1590,23,28.583333333333332,<=30,ENG,Home,Upto 2014
JA Snow,ENG,Pace,1976-06-03,Nottingham,England,1976,2,176,252,5,1,773,1761,21,597,1509,16,36.80952380952381,>30,ENG,Home,Upto 2014
JA Snow,ENG,Pace,1976-06-17,Lord's,England,1976,2,90,156,4,1,584,1335,24,494,1179,20,24.333333333333332,<=30,ENG,Home,Upto 2014
JA Snow,ENG,Pace,1976-07-22,Leeds,England,1976,2,157,232,6,1,969,1786,39,812,1554,33,24.846153846153847,<=30,ENG,Home,Upto 2014
JA Warrican,WI,Spin,2015-10-22,Colombo (PSS),Sri Lanka,2015,2,129,270,6,1,448,1072,27,319,802,21,16.59259259259259,<=30,SL,Away,After 1965
JA Warrican,WI,Spin,2015-12-10,Hobart,Australia,2015,1,158,168,3,1,295,420,6,137,252,3,49.166666666666664,>30,AUS,Away,After 1965
JA Warrican,WI,Spin,2015-12-26,Melbourne,Australia,2015,2,160,204,0,1,415,654,8,255,450,8,51.875,>30,AUS,Away,After 1965
JA Warrican,WI,Spin,2016-01-03,Sydney,Australia,2016,1,62,90,2,1,265,547,8,203,457,6,33.125,>30,AUS,Away,After 1965
JA Warrican,WI,Spin,2018-10-12,Hyderabad,India,2018,2,101,210,2,1,524,1095,12,423,885,10,43.666666666666664,>30,IND,Away,After 1965
JA Warrican,WI,Spin,2018-11-22,Chattogram,Bangladesh,2018,2,105,226,6,1,618,1097,34,513,871,28,18.176470588235293,<=30,BAN,Away,After 1965
JA Warrican,WI,Spin,2018-11-30,Mirpur,Bangladesh,2018,1,91,228,2,1,676,1230,27,585,1002,25,25.037037037037038,<=30,BAN,Away,After 1965
JA Warrican,WI,Spin,2019-11-27,Lucknow,India,2019,2,66,150,1,1,473,932,25,407,782,24,18.92,<=30,IND,Away,After 1965
JA Warrican,WI,Spin,2021-02-03,Chattogram,Bangladesh,2021,2,190,395,7,1,955,2045,28,765,1650,21,34.107142857142854,>30,BAN,Away,After 1965
JA Warrican,WI,Spin,2021-02-11,Mirpur,Bangladesh,2021,2,95,177,3,1,665,1522,28,570,1345,25,23.75,<=30,BAN,Away,After 1965
JA Warrican,WI,Spin,2021-08-12,Kingston,West Indies,2021,2,32,48,0,1,139,246,0,107,198,0,inf,>30,WI,Home,After 1965
JA Warrican,WI,Spin,2021-11-21,Galle,Sri Lanka,2021,2,129,246,5,1,748,1629,31,619,1383,26,24.129032258064516,<=30,SL,Away,After 1965
JA Warrican,WI,Spin,2021-11-29,Galle,Sri Lanka,2021,2,126,285,4,1,790,1806,36,664,1521,32,21.944444444444443,<=30,SL,Away,After 1965
JA Warrican,WI,Spin,2023-07-12,Roseau,West Indies,2023,1,106,270,1,1,411,1014,20,305,744,19,20.55,<=30,WI,Home,After 1965
JA Warrican,WI,Spin,2023-07-20,Port of Spain,West Indies,2023,2,125,270,4,1,279,750,9,154,480,5,31.0,>30,WI,Home,After 1965
JA Warrican,WI,Spin,2024-08-07,Port of Spain,West Indies,2024,2,126,186,6,1,492,926,15,366,740,9,32.8,>30,WI,Home,After 1965
JA Warrican,WI,Spin,2024-08-15,Providence,West Indies,2024,2,40,102,2,1,233,450,12,193,348,10,19.416666666666668,<=30,WI,Home,After 1965
JA Warrican,WI,Spin,2025-01-17,Multan,Pakistan,2025,2,101,233,10,1,519,896,34,418,663,24,15.264705882352942,<=30,PAK,Away,After 1965
JA Warrican,WI,Spin,2025-01-25,Multan,Pakistan,2025,2,70,198,9,1,637,1154,37,567,956,28,17.216216216216218,<=30,PAK,Away,After 1965
JA Young,ENG,Spin,1947-07-26,Leeds,England,1947,2,85,216,2,1,420,1282,10,335,1066,8,42.0,>30,ENG,Home,Upto 2014
JA Young,ENG,Spin,1948-06-10,Nottingham,England,1948,2,107,420,1,1,552,1614,15,445,1194,14,36.8,>30,ENG,Home,Upto 2014
JA Young,ENG,Spin,1948-07-08,Manchester,England,1948,2,67,210,2,1,279,893,5,212,683,3,55.8,>30,ENG,Home,Upto 2014
JA Young,ENG,Spin,1948-08-14,The Oval,England,1948,1,118,306,2,1,359,1083,14,241,777,12,25.642857142857142,<=30,ENG,Home,Upto 2014
JA Young,ENG,Spin,1949-02-12,Johannesburg,South Africa,1949,2,66,272,2,1,470,1288,10,404,1016,8,47.0,>30,SA,Away,Upto 2014
JA Young,ENG,Spin,1949-03-05,Gqeberha,South Africa,1949,2,156,568,2,1,750,1935,20,594,1367,18,37.5,>30,SA,Away,Upto 2014
JA Young,ENG,Spin,1949-06-11,Leeds,England,1949,2,93,216,3,1,545,1101,10,452,885,7,54.5,>30,ENG,Home,Upto 2014
JA Young,ENG,Spin,1949-06-25,Lord's,England,1949,1,65,160,3,1,624,1342,19,559,1182,16,32.8421052631579,>30,ENG,Home,Upto 2014
JAJ Christy,SA,Pace,1929-06-15,Birmingham,England,1929,1,15,30,0,1,506,1355,18,491,1325,18,28.11111111111111,<=30,ENG,Away,Upto 2014
JAJ Christy,SA,Pace,1929-06-29,Lord's,England,1929,2,35,54,1,1,601,1182,21,566,1128,20,28.61904761904762,<=30,ENG,Away,Upto 2014
JAJ Christy,SA,Pace,1931-02-21,Durban,South Africa,1931,1,17,24,1,1,308,822,11,291,798,10,28.0,<=30,SA,Home,Upto 2014
JAJ Christy,SA,Pace,1931-12-31,Melbourne,Australia,1931,1,14,18,0,1,596,1454,16,582,1436,16,37.25,>30,AUS,Away,Upto 2014
JAJ Christy,SA,Pace,1932-03-04,Wellington,New Zealand,1932,1,11,12,0,1,449,1052,12,438,1040,12,37.416666666666664,>30,NZ,Away,Upto 2014
JAK Cochran,SA,Pace,1931-02-21,Durban,South Africa,1931,1,47,138,0,1,308,822,11,261,684,11,28.0,<=30,SA,Home,Upto 2014
JB Bolus,ENG,Pace,1964-02-15,Kanpur,India,1964,1,16,18,0,1,118,235,3,102,217,3,39.333333333333336,>30,IND,Away,Upto 2014
JB Gannon,AUS,Pace,1977-12-16,W.A.C.A,Australia,1977,2,161,278,7,1,682,1283,21,521,1005,14,32.476190476190474,>30,AUS,Home,Upto 2014
JB Gannon,AUS,Pace,1977-12-30,Melbourne,Australia,1977,2,135,288,4,1,588,1273,19,453,985,15,30.94736842105263,>30,AUS,Home,Upto 2014
JB Gannon,AUS,Pace,1978-01-07,Sydney,Australia,1978,1,65,160,0,1,322,871,11,257,711,11,29.272727272727273,<=30,AUS,Home,Upto 2014
JB Hobbs,ENG,Pace,1908-02-21,Sydney,Australia,1908,1,13,42,0,1,203,454,8,190,412,8,25.375,<=30,AUS,Away,Upto 2014
JB Hobbs,ENG,Pace,1910-01-01,Johannesburg,South Africa,1910,2,36,72,0,1,440,846,11,404,774,11,40.0,>30,SA,Away,Upto 2014
JB Hobbs,ENG,Pace,1910-01-21,Durban,South Africa,1910,2,10,42,0,1,379,1058,15,369,1016,15,25.266666666666666,<=30,SA,Away,Upto 2014
JB Hobbs,ENG,Pace,1910-03-11,Cape Town,South Africa,1910,2,30,72,1,1,301,570,12,271,498,11,25.083333333333332,<=30,SA,Away,Upto 2014
JB Hobbs,ENG,Pace,1912-06-10,Lord's,England,1912,1,36,66,0,1,280,781,22,244,715,22,12.727272727272727,<=30,ENG,Home,Upto 2014
JB Hobbs,ENG,Pace,1921-01-14,Adelaide,Australia,1921,1,16,42,0,1,770,1488,14,754,1446,14,55.0,>30,AUS,Away,Upto 2014
JB Hobbs,ENG,Pace,1924-12-19,Sydney,Australia,1924,1,13,16,0,1,590,1278,15,577,1262,15,39.333333333333336,>30,AUS,Away,Upto 2014
JB Hobbs,ENG,Pace,1925-01-16,Adelaide,Australia,1925,1,11,24,0,1,326,857,11,315,833,11,29.636363636363637,<=30,AUS,Away,Upto 2014
JB Iverson,AUS,Spin,1950-12-01,Brisbane,Australia,1950,1,43,104,4,1,252,496,14,209,392,10,18.0,<=30,AUS,Home,Upto 2014
JB Iverson,AUS,Spin,1950-12-22,Melbourne,Australia,1950,2,73,304,6,1,357,991,20,284,687,14,17.85,<=30,AUS,Home,Upto 2014
JB Iverson,AUS,Spin,1951-01-05,Sydney,Australia,1951,2,52,236,6,1,426,1236,15,374,1000,9,28.4,<=30,AUS,Home,Upto 2014
JB Iverson,AUS,Spin,1951-02-02,Adelaide,Australia,1951,1,68,208,3,1,793,1857,24,725,1649,21,33.041666666666664,>30,AUS,Home,Upto 2014
JB Iverson,AUS,Spin,1951-02-23,Melbourne,Australia,1951,2,84,256,2,1,462,1120,13,378,864,11,35.53846153846154,>30,AUS,Home,Upto 2014
JB Mortimore,ENG,Spin,1959-02-13,Melbourne,Australia,1959,1,41,88,1,1,191,517,10,150,429,9,19.1,<=30,AUS,Away,Upto 2014
JB Mortimore,ENG,Spin,1959-02-27,Christchurch,New Zealand,1959,2,67,258,2,1,315,1017,18,248,759,16,17.5,<=30,NZ,Away,Upto 2014
JB Mortimore,ENG,Spin,1959-03-14,Auckland,New Zealand,1959,1,24,24,0,1,206,465,5,182,441,5,41.2,>30,NZ,Away,Upto 2014
JB Mortimore,ENG,Spin,1959-07-02,Leeds,England,1959,2,60,160,3,1,383,883,14,323,723,11,27.357142857142858,<=30,ENG,Home,Upto 2014
JB Mortimore,ENG,Spin,1959-07-23,Manchester,England,1959,2,75,174,1,1,721,1722,21,646,1548,20,34.333333333333336,>30,ENG,Home,Upto 2014
JB Mortimore,ENG,Spin,1964-01-10,Chennai,India,1964,2,151,318,2,1,876,2493,27,725,2175,25,32.44444444444444,>30,IND,Away,Upto 2014
JB Mortimore,ENG,Spin,1964-02-08,Delhi,India,1964,2,126,420,3,1,1001,2631,20,875,2211,17,50.05,>30,IND,Away,Upto 2014
JB Mortimore,ENG,Spin,1964-02-15,Kanpur,India,1964,2,67,426,1,1,987,2874,18,920,2448,17,54.833333333333336,>30,IND,Away,Upto 2014
JB Mortimore,ENG,Spin,1964-07-23,Manchester,England,1964,1,122,294,0,1,477,1315,3,355,1021,3,159.0,>30,ENG,Home,Upto 2014
JB Plimsoll,SA,Pace,1947-07-05,Manchester,England,1947,2,143,237,3,1,744,1735,22,601,1498,19,33.81818181818182,>30,ENG,Away,Upto 2014
JB Robertson,SA,Spin,1935-12-14,Durban,South Africa,1935,2,167,408,3,1,684,1775,22,517,1367,19,31.09090909090909,>30,SA,Home,Upto 2014
JB Robertson,SA,Spin,1935-12-24,Johannesburg,South Africa,1935,2,79,156,1,1,577,1226,18,498,1070,17,32.05555555555556,>30,SA,Home,Upto 2014
JB Robertson,SA,Spin,1936-01-01,Cape Town,South Africa,1936,1,75,174,2,1,468,1146,24,393,972,22,19.5,<=30,SA,Home,Upto 2014
JB Statham,ENG,Pace,1951-03-17,Christchurch,New Zealand,1951,1,47,144,1,1,365,1014,6,318,870,5,60.833333333333336,>30,NZ,Away,Upto 2014
JB Statham,ENG,Pace,1951-06-21,Lord's,England,1951,2,40,144,2,1,253,682,13,213,538,11,19.46153846153846,<=30,ENG,Home,Upto 2014
JB Statham,ENG,Pace,1951-07-05,Manchester,England,1951,2,38,144,2,1,355,980,20,317,836,18,17.75,<=30,ENG,Home,Upto 2014
JB Statham,ENG,Pace,1951-11-02,Delhi,India,1951,1,49,126,1,1,354,1056,2,305,930,1,177.0,>30,IND,Away,Upto 2014
JB Statham,ENG,Pace,1951-12-14,Brabourne,India,1951,2,126,294,5,1,609,1495,17,483,1201,12,35.8235294117647,>30,IND,Away,Upto 2014
JB Statham,ENG,Pace,1951-12-30,Eden Gardens,India,1951,2,54,186,1,1,283,907,5,229,721,4,56.6,>30,IND,Away,Upto 2014
JB Statham,ENG,Pace,1952-01-12,Kanpur,India,1952,1,10,36,0,1,37,120,0,27,84,0,inf,>30,IND,Away,Upto 2014
JB Statham,ENG,Pace,1952-02-06,Chennai,India,1952,1,54,114,1,1,228,540,4,174,426,3,57.0,>30,IND,Away,Upto 2014
JB Statham,ENG,Pace,1953-06-25,Lord's,England,1953,2,88,258,2,1,553,1514,19,465,1256,17,29.105263157894736,<=30,ENG,Home,Upto 2014
JB Statham,ENG,Pace,1954-01-15,Kingston,West Indies,1954,2,140,318,6,1,630,1500,20,490,1182,14,31.5,>30,WI,Away,Upto 2014
JB Statham,ENG,Pace,1954-02-06,Bridgetown,West Indies,1954,2,139,252,4,1,376,820,10,237,568,6,37.6,>30,WI,Away,Upto 2014
JB Statham,ENG,Pace,1954-02-24,Georgetown,West Indies,1954,2,150,294,6,1,302,702,8,152,408,2,37.75,>30,WI,Away,Upto 2014
JB Statham,ENG,Pace,1954-03-17,Port of Spain,West Indies,1954,1,31,54,0,1,458,1100,10,427,1046,10,45.8,>30,WI,Away,Upto 2014
JB Statham,ENG,Pace,1954-06-10,Lord's,England,1954,2,35,108,4,1,164,348,14,129,240,10,11.714285714285714,<=30,ENG,Home,Upto 2014
JB Statham,ENG,Pace,1954-07-01,Nottingham,England,1954,2,104,228,5,1,686,1378,19,582,1150,14,36.10526315789474,>30,ENG,Home,Upto 2014
JB Statham,ENG,Pace,1954-07-22,Manchester,England,1954,1,11,24,0,1,265,605,10,254,581,10,26.5,<=30,ENG,Home,Upto 2014
JB Statham,ENG,Pace,1954-08-12,The Oval,England,1954,2,63,174,2,1,370,1087,27,307,913,25,13.703703703703704,<=30,ENG,Home,Upto 2014
JB Statham,ENG,Pace,1954-11-26,Brisbane,Australia,1954,1,123,272,2,1,750,1616,15,627,1344,13,50.0,>30,AUS,Away,Upto 2014
JB Statham,ENG,Pace,1954-12-17,Sydney,Australia,1954,2,128,296,5,1,649,1696,33,521,1400,28,19.666666666666668,<=30,AUS,Away,Upto 2014
JB Statham,ENG,Pace,1954-12-31,Melbourne,Australia,1954,2,98,219,7,1,538,1484,30,440,1265,23,17.933333333333334,<=30,AUS,Away,Upto 2014
JB Statham,ENG,Pace,1955-01-28,Adelaide,Australia,1955,2,108,248,3,1,511,1397,23,403,1149,20,22.217391304347824,<=30,AUS,Away,Upto 2014
JB Statham,ENG,Pace,1955-02-25,Sydney,Australia,1955,2,42,112,1,1,382,806,7,340,694,6,54.57142857142857,>30,AUS,Away,Upto 2014
JB Statham,ENG,Pace,1955-03-11,Dunedin,New Zealand,1955,2,54,192,5,1,287,993,22,233,801,17,13.045454545454545,<=30,NZ,Away,Upto 2014
JB Statham,ENG,Pace,1955-03-25,Auckland,New Zealand,1955,2,37,160,7,1,296,880,23,259,720,16,12.869565217391305,<=30,NZ,Away,Upto 2014
JB Statham,ENG,Pace,1955-06-09,Nottingham,England,1955,2,63,210,1,1,443,1507,20,380,1297,19,22.15,<=30,ENG,Home,Upto 2014
JB Statham,ENG,Pace,1955-06-23,Lord's,England,1955,2,88,336,9,1,632,1622,27,544,1286,18,23.40740740740741,<=30,ENG,Home,Upto 2014
JB Statham,ENG,Pace,1955-07-21,Leeds,England,1955,2,164,362,5,1,618,1800,24,454,1438,19,25.75,<=30,ENG,Home,Upto 2014
JB Statham,ENG,Pace,1955-08-13,The Oval,England,1955,2,48,156,2,1,283,1030,15,235,874,13,18.866666666666667,<=30,ENG,Home,Upto 2014
JB Statham,ENG,Pace,1956-06-21,Lord's,England,1956,2,129,366,3,1,698,1897,33,569,1531,30,21.151515151515152,<=30,ENG,Home,Upto 2014
JB Statham,ENG,Pace,1956-07-26,Manchester,England,1956,2,21,132,0,1,233,663,3,212,531,3,77.66666666666667,>30,ENG,Home,Upto 2014
JB Statham,ENG,Pace,1956-08-23,The Oval,England,1956,2,34,138,4,1,409,1082,18,375,944,14,22.72222222222222,<=30,ENG,Home,Upto 2014
JB Statham,ENG,Pace,1956-12-24,Johannesburg,South Africa,1956,2,93,297,5,1,465,1730,29,372,1433,24,16.03448275862069,<=30,SA,Away,Upto 2014
JB Statham,ENG,Pace,1957-01-01,Cape Town,South Africa,1957,2,50,192,1,1,496,1551,13,446,1359,12,38.15384615384615,>30,SA,Away,Upto 2014
JB Statham,ENG,Pace,1957-01-25,Durban,South Africa,1957,2,88,264,3,1,495,1563,15,407,1299,12,33.0,>30,SA,Away,Upto 2014
JB Statham,ENG,Pace,1957-02-15,Johannesburg,South Africa,1957,2,118,288,5,1,520,1730,17,402,1442,12,30.58823529411765,>30,SA,Away,Upto 2014
JB Statham,ENG,Pace,1957-05-30,Birmingham,England,1957,2,120,246,3,1,447,978,10,327,732,7,44.7,>30,ENG,Home,Upto 2014
JB Statham,ENG,Pace,1957-06-20,Lord's,England,1957,2,117,283,4,1,433,973,23,316,690,19,18.82608695652174,<=30,ENG,Home,Upto 2014
JB Statham,ENG,Pace,1957-07-04,Nottingham,England,1957,2,196,420,6,1,642,1416,17,446,996,11,37.76470588235294,>30,ENG,Home,Upto 2014
JB Statham,ENG,Pace,1958-07-24,Manchester,England,1958,2,83,252,5,1,389,953,12,306,701,7,32.416666666666664,>30,ENG,Home,Upto 2014
JB Statham,ENG,Pace,1958-08-21,The Oval,England,1958,2,47,150,2,1,285,708,12,238,558,10,23.75,<=30,ENG,Home,Upto 2014
JB Statham,ENG,Pace,1958-12-05,Brisbane,Australia,1958,2,70,208,1,1,361,1352,20,291,1144,19,18.05,<=30,AUS,Away,Upto 2014
JB Statham,ENG,Pace,1958-12-31,Melbourne,Australia,1958,2,68,264,8,1,456,1361,29,388,1097,21,15.724137931034482,<=30,AUS,Away,Upto 2014
JB Statham,ENG,Pace,1959-01-09,Sydney,Australia,1959,2,54,144,0,1,297,1016,5,243,872,5,59.4,>30,AUS,Away,Upto 2014
JB Statham,ENG,Pace,1959-01-30,Adelaide,Australia,1959,2,94,216,3,1,681,1789,20,587,1573,17,34.05,>30,AUS,Away,Upto 2014
JB Statham,ENG,Pace,1959-06-04,Nottingham,England,1959,2,77,269,7,1,398,1106,18,321,837,11,22.11111111111111,<=30,ENG,Home,Upto 2014
JB Statham,ENG,Pace,1959-06-18,Lord's,England,1959,2,72,198,5,1,428,1122,20,356,924,15,21.4,<=30,ENG,Home,Upto 2014
JB Statham,ENG,Pace,1959-08-20,The Oval,England,1959,2,74,207,5,1,341,1038,21,267,831,16,16.238095238095237,<=30,ENG,Home,Upto 2014
JB Statham,ENG,Pace,1960-01-28,Port of Spain,West Indies,1960,2,86,267,5,1,471,1183,24,385,916,19,19.625,<=30,WI,Away,Upto 2014
JB Statham,ENG,Pace,1960-02-17,Kingston,West Indies,1960,2,121,301,4,1,593,1359,23,472,1058,19,25.782608695652176,<=30,WI,Away,Upto 2014
JB Statham,ENG,Pace,1960-03-09,Georgetown,West Indies,1960,1,79,216,1,1,483,950,12,404,734,11,40.25,>30,WI,Away,Upto 2014
JB Statham,ENG,Pace,1960-06-09,Birmingham,England,1960,2,108,276,5,1,549,1558,25,441,1282,20,21.96,<=30,ENG,Home,Upto 2014
JB Statham,ENG,Pace,1960-06-23,Lord's,England,1960,2,97,246,11,1,549,1209,28,452,963,17,19.607142857142858,<=30,ENG,Home,Upto 2014
JB Statham,ENG,Pace,1960-07-07,Nottingham,England,1960,2,98,240,5,1,545,1319,26,447,1079,21,20.96153846153846,<=30,ENG,Home,Upto 2014
JB Statham,ENG,Pace,1960-07-21,Manchester,England,1960,2,35,156,3,1,475,1326,23,440,1170,20,20.652173913043477,<=30,ENG,Home,Upto 2014
JB Statham,ENG,Pace,1960-08-18,The Oval,England,1960,2,153,300,3,1,792,1752,24,639,1452,21,33.0,>30,ENG,Home,Upto 2014
JB Statham,ENG,Pace,1961-06-08,Birmingham,England,1961,1,147,258,3,1,708,1529,14,561,1271,11,50.57142857142857,>30,ENG,Home,Upto 2014
JB Statham,ENG,Pace,1961-06-22,Lord's,England,1961,2,120,329,5,1,687,1676,33,567,1347,28,20.818181818181817,<=30,ENG,Home,Upto 2014
JB Statham,ENG,Pace,1961-07-27,Manchester,England,1961,2,159,390,6,1,869,2028,25,710,1638,19,34.76,>30,ENG,Home,Upto 2014
JB Statham,ENG,Pace,1961-08-17,The Oval,England,1961,1,75,233,3,1,680,1860,19,605,1627,16,35.78947368421053,>30,ENG,Home,Upto 2014
JB Statham,ENG,Pace,1962-05-31,Birmingham,England,1962,2,86,240,6,1,384,834,12,298,594,6,32.0,>30,ENG,Home,Upto 2014
JB Statham,ENG,Pace,1962-07-05,Leeds,England,1962,2,90,240,6,1,501,1157,23,411,917,17,21.782608695652176,<=30,ENG,Home,Upto 2014
JB Statham,ENG,Pace,1962-07-26,Nottingham,England,1962,2,102,241,4,1,602,1369,18,500,1128,14,33.44444444444444,>30,ENG,Home,Upto 2014
JB Statham,ENG,Pace,1962-11-30,Brisbane,Australia,1962,2,142,256,2,1,871,1952,19,729,1696,17,45.8421052631579,>30,AUS,Away,Upto 2014
JB Statham,ENG,Pace,1962-12-29,Melbourne,Australia,1962,2,135,360,3,1,758,2009,23,623,1649,20,32.95652173913044,>30,AUS,Away,Upto 2014
JB Statham,ENG,Pace,1963-01-11,Sydney,Australia,1963,2,82,194,1,1,454,1207,16,372,1013,15,28.375,<=30,AUS,Away,Upto 2014
JB Statham,ENG,Pace,1963-01-25,Adelaide,Australia,1963,2,137,336,6,1,686,1693,27,549,1357,21,25.40740740740741,<=30,AUS,Away,Upto 2014
JB Statham,ENG,Pace,1963-02-15,Sydney,Australia,1963,2,84,176,1,1,466,1318,15,382,1142,14,31.066666666666666,>30,AUS,Away,Upto 2014
JB Statham,ENG,Pace,1963-06-06,Manchester,England,1963,1,121,222,0,1,370,899,6,249,677,6,61.666666666666664,>30,ENG,Home,Upto 2014
JB Statham,ENG,Pace,1963-08-22,The Oval,England,1963,2,122,264,3,1,581,1365,22,459,1101,19,26.40909090909091,<=30,ENG,Home,Upto 2014
JB Statham,ENG,Pace,1965-08-26,The Oval,England,1965,2,145,320,7,1,786,1848,27,641,1528,20,29.11111111111111,<=30,ENG,Home,Upto 2014
JB Stollmeyer,WI,Spin,1948-03-27,Kingston,West Indies,1948,2,47,144,3,1,658,1636,13,611,1492,10,50.61538461538461,>30,WI,Home,Upto 2014
JB Stollmeyer,WI,Spin,1948-11-10,Delhi,India,1948,2,103,150,2,1,804,1710,13,701,1560,11,61.84615384615385,>30,IND,Away,Upto 2014
JB Stollmeyer,WI,Spin,1948-12-09,Brabourne,India,1948,2,30,48,0,1,780,1868,11,750,1820,11,70.9090909090909,>30,IND,Away,Upto 2014
JB Stollmeyer,WI,Spin,1952-02-15,Auckland,New Zealand,1952,1,12,48,2,1,442,1192,12,430,1144,10,36.833333333333336,>30,NZ,Away,Upto 2014
JB Stollmeyer,WI,Spin,1953-01-21,Port of Spain,West Indies,1953,2,103,162,2,1,842,2177,19,739,2015,17,44.31578947368421,>30,WI,Home,Upto 2014
JB Stollmeyer,WI,Spin,1953-02-07,Bridgetown,West Indies,1953,1,10,30,0,1,692,2028,31,682,1998,31,22.322580645161292,<=30,WI,Home,Upto 2014
JB Stollmeyer,WI,Spin,1953-02-19,Port of Spain,West Indies,1953,1,54,90,0,1,777,2186,14,723,2096,14,55.5,>30,WI,Home,Upto 2014
JB Stollmeyer,WI,Spin,1953-03-11,Georgetown,West Indies,1953,2,16,54,1,1,639,1831,18,623,1777,17,35.5,>30,WI,Home,Upto 2014
JB Stollmeyer,WI,Spin,1953-03-28,Kingston,West Indies,1953,2,48,90,0,1,921,2154,20,873,2064,20,46.05,>30,WI,Home,Upto 2014
JB Stollmeyer,WI,Spin,1954-01-15,Kingston,West Indies,1954,1,12,18,1,1,426,1149,15,414,1131,14,28.4,<=30,WI,Home,Upto 2014
JB Stollmeyer,WI,Spin,1954-02-06,Bridgetown,West Indies,1954,2,16,42,2,1,772,2250,20,756,2208,18,38.6,>30,WI,Home,Upto 2014
JB Stollmeyer,WI,Spin,1954-02-24,Georgetown,West Indies,1954,1,3,12,0,1,666,2079,21,663,2067,21,31.714285714285715,>30,WI,Home,Upto 2014
JB Stollmeyer,WI,Spin,1954-03-17,Port of Spain,West Indies,1954,1,19,36,0,1,1025,1930,13,1006,1894,13,78.84615384615384,>30,WI,Home,Upto 2014
JB Stollmeyer,WI,Spin,1954-03-30,Kingston,West Indies,1954,1,22,30,0,1,581,1630,14,559,1600,14,41.5,>30,WI,Home,Upto 2014
JB Stollmeyer,WI,Spin,1955-04-11,Port of Spain,West Indies,1955,1,11,30,0,1,545,1044,8,534,1014,8,68.125,>30,WI,Home,Upto 2014
JB Stollmeyer,WI,Spin,1955-04-26,Georgetown,West Indies,1955,1,1,6,0,1,484,1365,24,483,1359,24,20.166666666666668,<=30,WI,Home,Upto 2014
JC Adams,WI,Spin,1992-04-18,Bridgetown,West Indies,1992,2,59,161,4,1,67,179,4,8,18,0,16.75,<=30,WI,Home,Upto 2014
JC Adams,WI,Spin,1992-12-26,Melbourne,Australia,1992,1,18,24,0,1,262,558,8,244,534,8,32.75,>30,AUS,Away,Upto 2014
JC Adams,WI,Spin,1993-01-02,Sydney,Australia,1993,2,85,138,1,1,617,1258,8,532,1120,7,77.125,>30,AUS,Away,Upto 2014
JC Adams,WI,Spin,1994-02-19,Kingston,West Indies,1994,2,40,72,1,1,97,216,2,57,144,1,48.5,>30,WI,Home,Upto 2014
JC Adams,WI,Spin,1994-03-17,Georgetown,West Indies,1994,2,10,30,0,1,318,558,4,308,528,4,79.5,>30,WI,Home,Upto 2014
JC Adams,WI,Spin,1994-03-25,Port of Spain,West Indies,1994,1,18,24,0,1,162,288,3,144,264,3,54.0,>30,WI,Home,Upto 2014
JC Adams,WI,Spin,1994-04-08,Bridgetown,West Indies,1994,1,31,41,1,1,263,593,6,232,552,5,43.833333333333336,>30,WI,Home,Upto 2014
JC Adams,WI,Spin,1994-04-16,St John's,West Indies,1994,1,74,132,2,1,364,732,3,290,600,1,121.33333333333333,>30,WI,Home,Upto 2014
JC Adams,WI,Spin,1994-12-01,Nagpur,India,1994,2,47,84,0,1,761,1735,22,714,1651,22,34.59090909090909,>30,IND,Away,Upto 2014
JC Adams,WI,Spin,1994-12-10,Mohali,India,1994,1,9,18,0,1,470,841,10,461,823,10,47.0,>30,IND,Away,Upto 2014
JC Adams,WI,Spin,1995-02-03,Christchurch,New Zealand,1995,1,4,18,0,1,170,372,2,166,354,2,85.0,>30,NZ,Away,Upto 2014
JC Adams,WI,Spin,1995-04-08,St John's,West Indies,1995,1,16,24,0,1,167,342,4,151,318,4,41.75,>30,WI,Home,Upto 2014
JC Adams,WI,Spin,1995-04-29,Kingston,West Indies,1995,1,38,66,0,1,303,676,8,265,610,8,37.875,>30,WI,Home,Upto 2014
JC Adams,WI,Spin,1995-06-22,Lord's,England,1995,1,4,12,0,1,98,234,2,94,222,2,49.0,>30,ENG,Away,Upto 2014
JC Adams,WI,Spin,1995-07-27,Manchester,England,1995,2,28,60,0,1,271,569,5,243,509,5,54.2,>30,ENG,Away,Upto 2014
JC Adams,WI,Spin,1996-04-19,Bridgetown,West Indies,1996,2,49,90,5,1,67,120,5,18,30,0,13.4,<=30,WI,Home,Upto 2014
JC Adams,WI,Spin,1996-04-27,St John's,West Indies,1996,2,65,126,0,1,371,702,4,306,576,4,92.75,>30,WI,Home,Upto 2014
JC Adams,WI,Spin,1996-11-29,Sydney,Australia,1996,2,32,59,1,1,372,857,10,340,798,9,37.2,>30,AUS,Away,Upto 2014
JC Adams,WI,Spin,1996-12-26,Melbourne,Australia,1996,1,4,6,0,1,107,223,3,103,217,3,35.666666666666664,>30,AUS,Away,Upto 2014
JC Adams,WI,Spin,1997-01-25,Adelaide,Australia,1997,1,23,48,0,1,334,663,19,311,615,19,17.57894736842105,<=30,AUS,Away,Upto 2014
JC Adams,WI,Spin,1998-02-05,Port of Spain,West Indies,1998,1,8,18,0,1,159,524,3,151,506,3,53.0,>30,WI,Home,Upto 2014
JC Adams,WI,Spin,1998-02-13,Port of Spain,West Indies,1998,2,5,48,1,1,83,378,4,78,330,3,20.75,<=30,WI,Home,Upto 2014
JC Adams,WI,Spin,1998-02-27,Georgetown,West Indies,1998,2,6,24,0,1,391,1045,18,385,1021,18,21.72222222222222,<=30,WI,Home,Upto 2014
JC Adams,WI,Spin,1999-03-05,Port of Spain,West Indies,1999,2,70,132,2,1,146,312,5,76,180,3,29.2,<=30,WI,Home,Upto 2014
JC Adams,WI,Spin,1999-03-13,Kingston,West Indies,1999,1,6,6,0,1,346,591,10,340,585,10,34.6,>30,WI,Home,Upto 2014
JC Adams,WI,Spin,1999-04-03,St John's,West Indies,1999,2,31,86,1,1,396,930,13,365,844,12,30.46153846153846,>30,WI,Home,Upto 2014
JC Adams,WI,Spin,1999-12-16,Hamilton,New Zealand,1999,1,20,42,0,1,276,775,8,256,733,8,34.5,>30,NZ,Away,Upto 2014
JC Adams,WI,Spin,1999-12-26,Wellington,New Zealand,1999,1,45,156,0,1,335,762,4,290,606,4,83.75,>30,NZ,Away,Upto 2014
JC Adams,WI,Spin,2000-03-24,Kingston,West Indies,2000,1,32,54,0,1,234,532,3,202,478,3,78.0,>30,WI,Home,Upto 2014
JC Adams,WI,Spin,2000-05-05,Georgetown,West Indies,2000,1,31,54,0,1,162,360,3,131,306,3,54.0,>30,WI,Home,Upto 2014
JC Adams,WI,Spin,2000-05-18,Bridgetown,West Indies,2000,2,97,258,3,1,391,966,10,294,708,7,39.1,>30,WI,Home,Upto 2014
JC Adams,WI,Spin,2000-05-25,St John's,West Indies,2000,2,58,120,0,1,289,648,4,231,528,4,72.25,>30,WI,Home,Upto 2014
JC Adams,WI,Spin,2000-06-15,Birmingham,England,2000,1,5,18,2,1,62,210,4,57,192,2,15.5,<=30,ENG,Away,Upto 2014
JC Adams,WI,Spin,2000-08-03,Manchester,England,2000,2,42,96,0,1,254,606,4,212,510,4,63.5,>30,ENG,Away,Upto 2014
JC Adams,WI,Spin,2000-08-17,Leeds,England,2000,1,21,36,1,1,78,124,6,57,88,5,13.0,<=30,ENG,Away,Upto 2014
JC Adams,WI,Spin,2000-08-31,The Oval,England,2000,2,24,66,0,1,192,479,8,168,413,8,24.0,<=30,ENG,Away,Upto 2014
JC Adams,WI,Spin,2000-11-23,Brisbane,Australia,2000,1,8,30,0,1,60,156,3,52,126,3,20.0,<=30,AUS,Away,Upto 2014
JC Adams,WI,Spin,2000-12-01,W.A.C.A,Australia,2000,1,15,48,0,1,104,252,4,89,204,4,26.0,<=30,AUS,Away,Upto 2014
JC Adams,WI,Spin,2000-12-15,Adelaide,Australia,2000,2,42,96,0,1,394,779,14,352,683,14,28.142857142857142,<=30,AUS,Away,Upto 2014
JC Adams,WI,Spin,2000-12-26,Melbourne,Australia,2000,2,62,132,2,1,195,381,6,133,249,4,32.5,>30,AUS,Away,Upto 2014
JC Adams,WI,Spin,2001-01-02,Sydney,Australia,2001,1,54,100,0,1,641,1329,18,587,1229,18,35.611111111111114,>30,AUS,Away,Upto 2014
JC Alabaster,NZ,Spin,1955-11-19,Hyderabad (Deccan),India,1955,1,96,186,0,1,665,1888,11,569,1702,11,60.45454545454545,>30,IND,Away,Upto 2014
JC Alabaster,NZ,Spin,1955-12-02,Brabourne,India,1955,1,83,150,0,1,470,1277,17,387,1127,17,27.647058823529413,<=30,IND,Away,Upto 2014
JC Alabaster,NZ,Spin,1955-12-16,Delhi,India,1955,1,90,174,0,1,540,1398,4,450,1224,4,135.0,>30,IND,Away,Upto 2014
JC Alabaster,NZ,Spin,1955-12-28,Eden Gardens,India,1955,2,60,177,2,1,462,1292,19,402,1115,17,24.31578947368421,<=30,IND,Away,Upto 2014
JC Alabaster,NZ,Spin,1956-03-09,Auckland,New Zealand,1956,2,10,48,2,1,420,1482,16,410,1434,14,26.25,<=30,NZ,Home,Upto 2014
JC Alabaster,NZ,Spin,1958-06-05,Birmingham,England,1958,2,79,185,4,1,161,422,9,82,237,5,17.88888888888889,<=30,ENG,Away,Upto 2014
JC Alabaster,NZ,Spin,1958-06-19,Lord's,England,1958,1,48,96,1,1,155,534,16,107,438,15,9.6875,<=30,ENG,Away,Upto 2014
JC Alabaster,NZ,Spin,1961-12-08,Durban,South Africa,1961,2,95,209,7,1,285,733,16,190,524,9,17.8125,<=30,SA,Away,Upto 2014
JC Alabaster,NZ,Spin,1961-12-26,Johannesburg,South Africa,1961,1,40,60,0,1,298,572,6,258,512,6,49.666666666666664,>30,SA,Away,Upto 2014
JC Alabaster,NZ,Spin,1962-01-01,Cape Town,South Africa,1962,2,180,426,8,1,569,1566,23,389,1140,15,24.73913043478261,<=30,SA,Away,Upto 2014
JC Alabaster,NZ,Spin,1962-02-02,Johannesburg,South Africa,1962,1,143,186,3,1,312,504,6,169,318,3,52.0,>30,SA,Away,Upto 2014
JC Alabaster,NZ,Spin,1962-02-16,Gqeberha,South Africa,1962,2,159,466,4,1,338,1102,14,179,636,10,24.142857142857142,<=30,SA,Away,Upto 2014
JC Alabaster,NZ,Spin,1963-02-23,Auckland,New Zealand,1963,1,130,240,1,1,567,1236,14,437,996,13,40.5,>30,NZ,Home,Upto 2014
JC Alabaster,NZ,Spin,1963-03-15,Christchurch,New Zealand,1963,2,104,213,4,1,329,813,12,225,600,8,27.416666666666668,<=30,NZ,Home,Upto 2014
JC Alabaster,NZ,Spin,1968-02-15,Dunedin,New Zealand,1968,2,114,276,6,1,642,1761,17,528,1485,11,37.76470588235294,>30,NZ,Home,Upto 2014
JC Alabaster,NZ,Spin,1968-02-22,Christchurch,New Zealand,1968,2,99,276,2,1,599,1533,16,500,1257,14,37.4375,>30,NZ,Home,Upto 2014
JC Alabaster,NZ,Spin,1968-02-29,Wellington,New Zealand,1968,2,72,114,2,1,408,1093,20,336,979,18,20.4,<=30,NZ,Home,Upto 2014
JC Alabaster,NZ,Spin,1968-03-07,Auckland,New Zealand,1968,2,97,210,2,1,303,1079,19,206,869,17,15.947368421052632,<=30,NZ,Home,Upto 2014
JC Alabaster,NZ,Spin,1972-02-16,Kingston,West Indies,1972,1,110,150,0,1,653,1794,11,543,1644,11,59.36363636363637,>30,WI,Away,Upto 2014
JC Alabaster,NZ,Spin,1972-03-09,Port of Spain,West Indies,1972,2,54,150,1,1,722,2183,14,668,2033,13,51.57142857142857,>30,WI,Away,Upto 2014
JC Archer,ENG,Pace,2019-08-14,Lord's,England,2019,2,91,264,5,1,589,1275,24,498,1011,19,24.541666666666668,<=30,ENG,Home,After 1965
JC Archer,ENG,Pace,2019-08-22,Leeds,England,2019,2,85,187,8,1,629,1344,34,544,1157,26,18.5,<=30,ENG,Home,After 1965
JC Archer,ENG,Pace,2019-09-04,Manchester,England,2019,2,142,246,3,1,783,1519,27,641,1273,24,29.0,<=30,ENG,Home,After 1965
JC Archer,ENG,Pace,2019-09-12,The Oval,England,2019,2,128,239,6,1,856,1530,30,728,1291,24,28.533333333333335,<=30,ENG,Home,After 1965
JC Archer,ENG,Pace,2019-11-21,Mount Maunganui,New Zealand,2019,1,107,252,1,1,805,1856,23,698,1604,22,35.0,>30,NZ,Away,After 1965
JC Archer,ENG,Pace,2019-11-29,Hamilton,New Zealand,2019,2,102,240,1,1,881,1878,20,779,1638,19,44.05,>30,NZ,Away,After 1965
JC Archer,ENG,Pace,2019-12-26,Centurion,South Africa,2019,2,167,216,6,1,888,1593,38,721,1377,32,23.36842105263158,<=30,SA,Away,After 1965
JC Archer,ENG,Pace,2020-07-08,Southampton,England,2020,2,106,234,3,1,825,1729,32,719,1495,29,25.78125,<=30,ENG,Home,After 1965
JC Archer,ENG,Pace,2020-07-24,Manchester,England,2020,2,96,162,1,1,625,1206,27,529,1044,26,23.14814814814815,<=30,ENG,Home,After 1965
JC Archer,ENG,Pace,2020-08-05,Manchester,England,2020,2,86,172,4,1,609,1268,24,523,1096,20,25.375,<=30,ENG,Home,After 1965
JC Archer,ENG,Pace,2020-08-21,Southampton,England,2020,2,72,186,0,1,619,1361,14,547,1175,14,44.214285714285715,>30,ENG,Home,After 1965
JC Archer,ENG,Pace,2021-02-05,Chennai,India,2021,2,98,181,3,1,376,864,16,278,683,13,23.5,<=30,IND,Away,After 1965
JC Archer,ENG,Pace,2021-02-24,Ahmedabad,India,2021,1,24,30,1,1,124,228,2,100,198,1,62.0,>30,IND,Away,After 1965
JC Balderstone,ENG,Spin,1976-08-12,The Oval,England,1976,1,80,96,1,1,635,1217,8,555,1121,7,79.375,>30,ENG,Home,Upto 2014
JC Clay,ENG,Spin,1935-08-17,The Oval,England,1935,2,75,192,0,1,498,864,8,423,672,8,62.25,>30,ENG,Home,Upto 2014
JC Hartley,ENG,Spin,1906-03-10,Johannesburg,South Africa,1906,2,93,156,1,1,622,1254,10,529,1098,9,62.2,>30,SA,Away,Upto 2014
JC Hartley,ENG,Spin,1906-03-30,Cape Town,South Africa,1906,1,22,36,0,1,364,776,15,342,740,15,24.266666666666666,<=30,SA,Away,Upto 2014
JC Hill,AUS,Spin,1953-06-11,Nottingham,England,1953,2,61,186,4,1,277,894,8,216,708,4,34.625,>30,ENG,Away,Upto 2014
JC Hill,AUS,Spin,1953-07-09,Manchester,England,1953,1,97,210,3,1,250,603,14,153,393,11,17.857142857142858,<=30,ENG,Away,Upto 2014
JC Hill,AUS,Spin,1955-05-14,Bridgetown,West Indies,1955,2,115,210,1,1,1042,2444,22,927,2234,21,47.36363636363637,>30,WI,Away,Upto 2014
JC Laker,ENG,Spin,1948-01-21,Bridgetown,West Indies,1948,2,198,402,9,1,610,1348,22,412,946,13,27.727272727272727,<=30,WI,Away,Upto 2014
JC Laker,ENG,Spin,1948-02-11,Port of Spain,West Indies,1948,1,108,216,2,1,644,1409,17,536,1193,15,37.88235294117647,>30,WI,Away,Upto 2014
JC Laker,ENG,Spin,1948-03-03,Georgetown,West Indies,1948,2,128,270,4,1,451,1064,19,323,794,15,23.736842105263158,<=30,WI,Away,Upto 2014
JC Laker,ENG,Spin,1948-03-27,Kingston,West Indies,1948,2,114,232,3,1,658,1636,13,544,1404,10,50.61538461538461,>30,WI,Away,Upto 2014
JC Laker,ENG,Spin,1948-06-10,Nottingham,England,1948,1,138,330,4,1,552,1614,15,414,1284,11,36.8,>30,ENG,Home,Upto 2014
JC Laker,ENG,Spin,1948-06-24,Lord's,England,1948,2,128,230,2,1,442,1043,11,314,813,9,40.18181818181818,>30,ENG,Home,Upto 2014
JC Laker,ENG,Spin,1948-07-22,Leeds,England,1948,2,206,372,3,1,708,1260,12,502,888,9,59.0,>30,ENG,Home,Upto 2014
JC Laker,ENG,Spin,1949-08-13,The Oval,England,1949,2,89,192,4,1,597,1082,15,508,890,11,39.8,>30,ENG,Home,Upto 2014
JC Laker,ENG,Spin,1950-06-08,Manchester,England,1950,2,86,186,1,1,787,2271,35,701,2085,34,22.485714285714284,<=30,ENG,Home,Upto 2014
JC Laker,ENG,Spin,1951-07-05,Manchester,England,1951,2,89,276,4,1,293,819,11,204,543,7,26.636363636363637,<=30,ENG,Home,Upto 2014
JC Laker,ENG,Spin,1951-08-16,The Oval,England,1951,2,119,390,10,1,352,1033,18,233,643,8,19.555555555555557,<=30,ENG,Home,Upto 2014
JC Laker,ENG,Spin,1952-06-05,Leeds,England,1952,2,56,213,4,1,495,1359,19,439,1146,15,26.05263157894737,<=30,ENG,Home,Upto 2014
JC Laker,ENG,Spin,1952-06-19,Lord's,England,1952,2,123,306,4,1,669,1629,14,546,1323,10,47.785714285714285,>30,ENG,Home,Upto 2014
JC Laker,ENG,Spin,1952-07-17,Manchester,England,1952,1,7,12,0,1,285,693,12,278,681,12,23.75,<=30,ENG,Home,Upto 2014
JC Laker,ENG,Spin,1952-08-14,The Oval,England,1952,1,3,12,0,1,267,870,5,264,858,5,53.4,>30,ENG,Home,Upto 2014
JC Laker,ENG,Spin,1953-07-09,Manchester,England,1953,2,53,156,3,1,250,603,14,197,447,11,17.857142857142858,<=30,ENG,Home,Upto 2014
JC Laker,ENG,Spin,1953-07-23,Leeds,England,1953,2,50,66,1,1,195,432,3,145,366,2,65.0,>30,ENG,Home,Upto 2014
JC Laker,ENG,Spin,1953-08-15,The Oval,England,1953,2,109,131,5,1,335,826,14,226,695,9,23.928571428571427,<=30,ENG,Home,Upto 2014
JC Laker,ENG,Spin,1954-02-06,Bridgetown,West Indies,1954,2,143,361,4,1,772,2250,20,629,1889,16,38.6,>30,WI,Away,Upto 2014
JC Laker,ENG,Spin,1954-02-24,Georgetown,West Indies,1954,2,88,342,4,1,666,2079,21,578,1737,17,31.714285714285715,>30,WI,Away,Upto 2014
JC Laker,ENG,Spin,1954-03-17,Port of Spain,West Indies,1954,1,154,300,2,1,1025,1930,13,871,1630,11,78.84615384615384,>30,WI,Away,Upto 2014
JC Laker,ENG,Spin,1954-03-30,Kingston,West Indies,1954,2,84,324,4,1,581,1630,14,497,1306,10,41.5,>30,WI,Away,Upto 2014
JC Laker,ENG,Spin,1954-06-10,Lord's,England,1954,2,39,194,2,1,153,655,8,114,461,6,19.125,<=30,ENG,Home,Upto 2014
JC Laker,ENG,Spin,1955-08-13,The Oval,England,1955,2,84,364,7,1,308,1166,23,224,802,16,13.391304347826088,<=30,ENG,Home,Upto 2014
JC Laker,ENG,Spin,1956-06-07,Nottingham,England,1956,2,87,355,6,1,279,1027,11,192,672,5,25.363636363636363,<=30,ENG,Home,Upto 2014
JC Laker,ENG,Spin,1956-06-21,Lord's,England,1956,2,64,217,3,1,172,625,7,108,408,4,24.571428571428573,<=30,ENG,Home,Upto 2014
JC Laker,ENG,Spin,1956-07-12,Leeds,England,1956,2,113,423,11,1,342,1252,22,229,829,11,15.545454545454545,<=30,ENG,Home,Upto 2014
JC Laker,ENG,Spin,1956-07-26,Manchester,England,1956,2,90,408,19,1,491,1434,26,401,1026,7,18.884615384615383,<=30,ENG,Home,Upto 2014
JC Laker,ENG,Spin,1956-08-23,The Oval,England,1956,2,88,300,7,1,234,721,10,146,421,3,23.4,<=30,ENG,Home,Upto 2014
JC Laker,ENG,Spin,1956-12-24,Johannesburg,South Africa,1956,2,38,184,2,1,201,734,9,163,550,7,22.333333333333332,<=30,SA,Away,Upto 2014
JC Laker,ENG,Spin,1957-01-01,Cape Town,South Africa,1957,2,72,337,3,1,343,1239,21,271,902,18,16.333333333333332,<=30,SA,Away,Upto 2014
JC Laker,ENG,Spin,1957-01-25,Durban,South Africa,1957,2,76,240,2,1,361,1289,21,285,1049,19,17.19047619047619,<=30,SA,Away,Upto 2014
JC Laker,ENG,Spin,1957-02-15,Johannesburg,South Africa,1957,2,75,176,2,1,404,1102,19,329,926,17,21.263157894736842,<=30,SA,Away,Upto 2014
JC Laker,ENG,Spin,1957-03-01,Gqeberha,South Africa,1957,2,63,224,2,1,222,803,10,159,579,8,22.2,<=30,SA,Away,Upto 2014
JC Laker,ENG,Spin,1957-05-30,Birmingham,England,1957,2,132,468,6,1,809,2558,20,677,2090,14,40.45,>30,ENG,Home,Upto 2014
JC Laker,ENG,Spin,1957-07-04,Nottingham,England,1957,2,199,630,4,1,731,1812,9,532,1182,5,81.22222222222223,>30,ENG,Home,Upto 2014
JC Laker,ENG,Spin,1957-07-25,Leeds,England,1957,2,40,140,3,1,269,814,12,229,674,9,22.416666666666668,<=30,ENG,Home,Upto 2014
JC Laker,ENG,Spin,1957-08-22,The Oval,England,1957,2,77,240,5,1,485,1435,24,408,1195,19,20.208333333333332,<=30,ENG,Home,Upto 2014
JC Laker,ENG,Spin,1958-06-05,Birmingham,England,1958,2,23,84,2,1,161,422,9,138,338,7,17.88888888888889,<=30,ENG,Home,Upto 2014
JC Laker,ENG,Spin,1958-06-19,Lord's,England,1958,2,37,150,5,1,155,534,16,118,384,11,9.6875,<=30,ENG,Home,Upto 2014
JC Laker,ENG,Spin,1958-07-03,Leeds,England,1958,2,44,348,8,1,241,963,20,197,615,12,12.05,<=30,ENG,Home,Upto 2014
JC Laker,ENG,Spin,1958-08-21,The Oval,England,1958,2,69,204,2,1,171,485,8,102,281,6,21.375,<=30,ENG,Home,Upto 2014
JC Laker,ENG,Spin,1958-12-05,Brisbane,Australia,1958,2,54,217,3,1,271,1070,11,217,853,8,24.636363636363637,<=30,AUS,Away,Upto 2014
JC Laker,ENG,Spin,1958-12-31,Melbourne,Australia,1958,2,54,128,1,1,227,617,2,173,489,1,113.5,>30,AUS,Away,Upto 2014
JC Laker,ENG,Spin,1959-01-09,Sydney,Australia,1959,2,117,432,7,1,574,1742,24,457,1310,17,23.916666666666668,<=30,AUS,Away,Upto 2014
JC Laker,ENG,Spin,1959-02-13,Melbourne,Australia,1959,1,93,245,4,1,191,517,10,98,272,6,19.1,<=30,AUS,Away,Upto 2014
JC Reedman,AUS,Pace,1894-12-14,Sydney,Australia,1894,2,24,57,1,1,993,2418,24,969,2361,23,41.375,>30,AUS,Home,After 1965
JC Tongue,ENG,Pace,2023-06-01,Lord's,England,2023,2,106,204,5,1,757,1010,16,651,806,11,47.3125,>30,ENG,Home,After 1965
JC Tongue,ENG,Pace,2023-06-28,Lord's,England,2023,2,151,252,5,1,1187,1964,35,1036,1712,30,33.91428571428571,>30,ENG,Home,After 1965
JC Tredwell,ENG,Spin,2010-03-20,Mirpur,Bangladesh,2010,2,181,390,6,1,865,1792,20,684,1402,14,43.25,>30,BAN,Away,Upto 2014
JC Tredwell,ENG,Spin,2015-04-13,North Sound,West Indies,2015,2,140,396,5,1,466,940,10,326,544,5,46.6,>30,WI,Away,After 1965
JC Watkins,SA,Pace,1949-12-24,Johannesburg,South Africa,1949,1,56,152,2,1,273,736,9,217,584,7,30.333333333333332,>30,SA,Home,Upto 2014
JC Watkins,SA,Pace,1949-12-31,Cape Town,South Africa,1949,2,69,112,1,1,378,860,10,309,748,9,37.8,>30,SA,Home,Upto 2014
JC Watkins,SA,Pace,1950-01-20,Durban,South Africa,1950,2,19,80,0,1,229,704,5,210,624,5,45.8,>30,SA,Home,Upto 2014
JC Watkins,SA,Pace,1952-12-05,Brisbane,Australia,1952,2,88,400,6,1,408,1189,22,320,789,16,18.545454545454547,<=30,AUS,Away,Upto 2014
JC Watkins,SA,Pace,1952-12-24,Melbourne,Australia,1952,2,49,128,0,1,390,1037,14,341,909,14,27.857142857142858,<=30,AUS,Away,Upto 2014
JC Watkins,SA,Pace,1953-01-09,Sydney,Australia,1953,1,16,96,1,1,307,834,15,291,738,14,20.466666666666665,<=30,AUS,Away,Upto 2014
JC Watkins,SA,Pace,1953-01-24,Adelaide,Australia,1953,2,92,144,1,1,427,785,5,335,641,4,85.4,>30,AUS,Away,Upto 2014
JC Watkins,SA,Pace,1953-02-06,Melbourne,Australia,1953,2,105,296,0,1,486,1431,11,381,1135,11,44.18181818181818,>30,AUS,Away,Upto 2014
JC Watkins,SA,Pace,1953-03-06,Wellington,New Zealand,1953,2,51,305,5,1,299,1005,14,248,700,9,21.357142857142858,<=30,NZ,Away,Upto 2014
JC Watkins,SA,Pace,1953-03-13,Auckland,New Zealand,1953,2,63,276,3,1,316,1056,6,253,780,3,52.666666666666664,>30,NZ,Away,Upto 2014
JC Watkins,SA,Pace,1953-12-11,Durban,South Africa,1953,2,44,232,3,1,403,1104,13,359,872,10,31.0,>30,SA,Home,Upto 2014
JC Watkins,SA,Pace,1954-01-29,Johannesburg,South Africa,1954,2,30,152,2,1,358,1413,20,328,1261,18,17.9,<=30,SA,Home,Upto 2014
JC Watkins,SA,Pace,1954-02-05,Gqeberha,South Africa,1954,2,55,240,5,1,339,985,18,284,745,13,18.833333333333332,<=30,SA,Home,Upto 2014
JC Watkins,SA,Pace,1956-12-24,Johannesburg,South Africa,1956,2,33,112,0,1,465,1730,29,432,1618,29,16.03448275862069,<=30,SA,Home,Upto 2014
JC Watkins,SA,Pace,1957-01-01,Cape Town,South Africa,1957,1,46,80,0,1,496,1551,13,450,1471,13,38.15384615384615,>30,SA,Home,Upto 2014
JC White,ENG,Spin,1921-07-02,Leeds,England,1921,2,107,216,3,1,678,1167,22,571,951,19,30.818181818181817,>30,ENG,Home,Upto 2014
JC White,ENG,Spin,1928-07-21,Manchester,England,1928,2,53,165,3,1,291,903,19,238,738,16,15.31578947368421,<=30,ENG,Home,Upto 2014
JC White,ENG,Spin,1928-11-30,Brisbane,Australia,1928,1,7,39,4,1,545,1303,22,538,1264,18,24.772727272727273,<=30,AUS,Away,Upto 2014
JC White,ENG,Spin,1928-12-14,Sydney,Australia,1928,2,162,408,0,1,782,1986,12,620,1578,12,65.16666666666667,>30,AUS,Away,Upto 2014
JC White,ENG,Spin,1928-12-29,Melbourne,Australia,1928,2,171,683,6,1,717,2327,21,546,1644,15,34.142857142857146,>30,AUS,Away,Upto 2014
JC White,ENG,Spin,1929-02-01,Adelaide,Australia,1929,2,256,749,13,1,757,2268,26,501,1519,13,29.115384615384617,<=30,AUS,Away,Upto 2014
JC White,ENG,Spin,1929-03-08,Melbourne,Australia,1929,2,164,561,2,1,660,1893,8,496,1332,6,82.5,>30,AUS,Away,Upto 2014
JC White,ENG,Spin,1929-06-15,Birmingham,England,1929,2,51,270,0,1,416,1126,6,365,856,6,69.33333333333333,>30,ENG,Home,Upto 2014
JC White,ENG,Spin,1929-06-29,Lord's,England,1929,2,72,264,2,1,382,1002,11,310,738,9,34.72727272727273,>30,ENG,Home,Upto 2014
JC White,ENG,Spin,1929-07-13,Leeds,England,1929,2,64,240,3,1,624,1466,25,560,1226,22,24.96,<=30,ENG,Home,Upto 2014
JC White,ENG,Spin,1930-06-27,Lord's,England,1930,2,166,318,3,1,960,1932,18,794,1614,15,53.333333333333336,>30,ENG,Home,Upto 2014
JC White,ENG,Spin,1930-12-24,Johannesburg,South Africa,1930,1,53,96,0,1,386,746,13,333,650,13,29.692307692307693,<=30,SA,Away,Upto 2014
JC White,ENG,Spin,1931-01-01,Cape Town,South Africa,1931,1,101,276,2,1,731,1678,19,630,1402,17,38.473684210526315,>30,SA,Away,Upto 2014
JC White,ENG,Spin,1931-01-16,Durban,South Africa,1931,2,54,204,6,1,228,660,10,174,456,4,22.8,<=30,SA,Away,Upto 2014
JC White,ENG,Spin,1931-02-21,Durban,South Africa,1931,2,100,312,2,1,436,1147,20,336,835,18,21.8,<=30,SA,Away,Upto 2014
JD Campbell,WI,Spin,2019-01-23,Bridgetown,West Indies,2019,1,10,25,0,1,371,593,12,361,568,12,30.916666666666668,>30,WI,Home,After 1965
JD Campbell,WI,Spin,2019-08-22,North Sound,West Indies,2019,1,20,36,0,1,347,560,8,327,524,8,43.375,>30,WI,Home,After 1965
JD Higgs,AUS,Spin,1978-03-03,Port of Spain,West Indies,1978,1,91,149,4,1,269,461,9,178,312,5,29.88888888888889,<=30,WI,Away,Upto 2014
JD Higgs,AUS,Spin,1978-03-17,Bridgetown,West Indies,1978,2,80,174,2,1,226,371,4,146,197,2,56.5,>30,WI,Away,Upto 2014
JD Higgs,AUS,Spin,1978-04-15,Port of Spain,West Indies,1978,2,99,227,4,1,493,1205,23,394,978,19,21.434782608695652,<=30,WI,Away,Upto 2014
JD Higgs,AUS,Spin,1978-04-28,Kingston,West Indies,1978,2,114,286,5,1,606,1484,19,492,1198,14,31.894736842105264,>30,WI,Away,Upto 2014
JD Higgs,AUS,Spin,1978-12-01,Brisbane,Australia,1978,2,52,144,0,1,206,680,3,154,536,3,68.66666666666667,>30,AUS,Home,Upto 2014
JD Higgs,AUS,Spin,1978-12-29,Melbourne,Australia,1978,2,61,280,3,1,223,866,11,162,586,8,20.272727272727273,<=30,AUS,Home,Upto 2014
JD Higgs,AUS,Spin,1979-01-06,Sydney,Australia,1979,2,190,622,8,1,399,1440,18,209,818,10,22.166666666666668,<=30,AUS,Home,Upto 2014
JD Higgs,AUS,Spin,1979-01-27,Adelaide,Australia,1979,2,84,248,3,1,239,776,7,155,528,4,34.142857142857146,>30,AUS,Home,Upto 2014
JD Higgs,AUS,Spin,1979-02-10,Sydney,Australia,1979,2,81,280,5,1,364,1147,19,283,867,14,19.157894736842106,<=30,AUS,Home,Upto 2014
JD Higgs,AUS,Spin,1979-09-11,Chennai,India,1979,1,143,249,7,1,518,1389,19,375,1140,12,27.263157894736842,<=30,IND,Away,Upto 2014
JD Higgs,AUS,Spin,1979-09-19,Bengaluru,India,1979,1,95,222,1,1,418,1101,14,323,879,13,29.857142857142858,<=30,IND,Away,Upto 2014
JD Higgs,AUS,Spin,1979-10-02,Kanpur,India,1979,2,91,174,0,1,449,1116,12,358,942,12,37.416666666666664,>30,IND,Away,Upto 2014
JD Higgs,AUS,Spin,1979-10-13,Delhi,India,1979,1,150,282,3,1,604,1308,12,454,1026,9,50.333333333333336,>30,IND,Away,Upto 2014
JD Higgs,AUS,Spin,1979-10-26,Eden Gardens,India,1979,2,107,264,1,1,581,1386,14,474,1122,13,41.5,>30,IND,Away,Upto 2014
JD Higgs,AUS,Spin,1979-11-03,Wankhede,India,1979,1,116,174,2,1,457,1061,17,341,887,15,26.88235294117647,<=30,IND,Away,Upto 2014
JD Higgs,AUS,Spin,1979-12-29,Melbourne,Australia,1979,1,122,208,3,1,126,210,3,4,2,0,42.0,>30,AUS,Home,Upto 2014
JD Higgs,AUS,Spin,1980-01-04,Sydney,Australia,1980,1,3,6,0,1,132,272,5,129,266,5,26.4,<=30,AUS,Home,Upto 2014
JD Higgs,AUS,Spin,1980-11-28,Brisbane,Australia,1980,2,78,127,4,1,141,265,5,63,138,1,28.2,<=30,AUS,Home,Upto 2014
JD Higgs,AUS,Spin,1980-12-12,W.A.C.A,Australia,1980,2,38,78,4,1,69,132,4,31,54,0,17.25,<=30,AUS,Home,Upto 2014
JD Higgs,AUS,Spin,1980-12-26,Melbourne,Australia,1980,2,111,246,3,1,182,426,4,71,180,1,45.5,>30,AUS,Home,Upto 2014
JD Higgs,AUS,Spin,1981-01-02,Sydney,Australia,1981,1,45,108,4,1,158,276,4,113,168,0,39.5,>30,AUS,Home,Upto 2014
JD Higgs,AUS,Spin,1981-02-07,Melbourne,Australia,1981,2,106,204,0,1,474,1128,11,368,924,11,43.09090909090909,>30,AUS,Home,Upto 2014
JD Ryder,NZ,Pace,2008-10-17,Chattogram,Bangladesh,2008,1,10,18,0,1,258,774,7,248,756,7,36.857142857142854,>30,BAN,Away,Upto 2014
JD Ryder,NZ,Pace,2008-11-20,Brisbane,Australia,2008,2,15,36,2,1,700,1373,36,685,1337,34,19.444444444444443,<=30,AUS,Away,Upto 2014
JD Ryder,NZ,Pace,2008-11-28,Adelaide,Australia,2008,1,33,42,0,1,688,1276,20,655,1234,20,34.4,>30,AUS,Away,Upto 2014
JD Ryder,NZ,Pace,2008-12-19,Napier,New Zealand,2008,1,9,18,0,1,774,1324,23,765,1306,23,33.65217391304348,>30,NZ,Home,Upto 2014
JD Ryder,NZ,Pace,2009-03-18,Hamilton,New Zealand,2009,1,24,54,0,1,743,1246,14,719,1192,14,53.07142857142857,>30,NZ,Home,Upto 2014
JD Ryder,NZ,Pace,2009-03-26,Napier,New Zealand,2009,2,41,84,1,1,682,1265,13,641,1181,12,52.46153846153846,>30,NZ,Home,Upto 2014
JD Ryder,NZ,Pace,2009-04-03,Wellington,New Zealand,2009,2,24,60,1,1,869,1366,23,845,1306,22,37.78260869565217,>30,NZ,Home,Upto 2014
JD Ryder,NZ,Pace,2009-08-18,Galle,Sri Lanka,2009,1,24,30,0,1,541,798,16,517,768,16,33.8125,>30,SL,Away,Upto 2014
JD Ryder,NZ,Pace,2009-08-26,Colombo (SSC),Sri Lanka,2009,2,32,36,0,1,574,917,8,542,881,8,71.75,>30,SL,Away,Upto 2014
JD Ryder,NZ,Pace,2010-11-04,Ahmedabad,India,2010,1,56,102,1,1,415,862,12,359,760,11,34.583333333333336,>30,IND,Away,Upto 2014
JD Ryder,NZ,Pace,2011-01-15,Wellington,New Zealand,2011,1,12,12,0,1,781,1511,23,769,1499,23,33.95652173913044,>30,NZ,Home,Upto 2014
JD Unadkat,IND,Pace,2010-12-16,Centurion,South Africa,2010,1,101,156,0,1,795,1278,19,694,1122,19,41.8421052631579,>30,SA,Away,Upto 2014
JD Unadkat,IND,Pace,2022-12-22,Mirpur,Bangladesh,2022,2,67,150,3,1,319,582,11,252,432,8,29.0,<=30,BAN,Away,After 1965
JD Unadkat,IND,Pace,2023-07-12,Roseau,West Indies,2023,2,18,54,0,1,260,590,5,242,536,5,52.0,>30,WI,Away,After 1965
JD Unadkat,IND,Pace,2023-07-20,Port of Spain,West Indies,2023,2,45,114,0,1,656,1048,14,611,934,14,46.857142857142854,>30,WI,Away,After 1965
JDA O'Connor,AUS,Pace,1908-01-10,Adelaide,Australia,1908,2,150,366,8,1,493,1139,20,343,773,12,24.65,<=30,AUS,Home,Upto 2014
JDA O'Connor,AUS,Pace,1908-02-07,Melbourne,Australia,1908,2,98,162,4,1,373,840,14,275,678,10,26.642857142857142,<=30,AUS,Home,Upto 2014
JDA O'Connor,AUS,Pace,1908-02-21,Sydney,Australia,1908,2,52,114,0,1,203,454,8,151,340,8,25.375,<=30,AUS,Home,Upto 2014
JDA O'Connor,AUS,Pace,1909-05-27,Birmingham,England,1909,2,40,50,1,1,206,487,10,166,437,9,20.6,<=30,ENG,Away,Upto 2014
JDB Robertson,ENG,Spin,1951-11-02,Delhi,India,1951,1,12,30,0,1,589,1935,18,577,1905,18,32.72222222222222,>30,IND,Away,Upto 2014
JDB Robertson,ENG,Spin,1951-12-14,Brabourne,India,1951,1,1,6,0,1,561,1297,11,560,1291,11,51.0,>30,IND,Away,Upto 2014
JDB Robertson,ENG,Spin,1951-12-30,Eden Gardens,India,1951,1,10,30,0,1,698,1841,19,688,1811,19,36.73684210526316,>30,IND,Away,Upto 2014
JDB Robertson,ENG,Spin,1952-01-12,Kanpur,India,1952,1,17,42,2,1,484,1339,31,467,1297,29,15.612903225806452,<=30,IND,Away,Upto 2014
JDB Robertson,ENG,Spin,1952-02-06,Chennai,India,1952,1,18,30,0,1,648,1564,25,630,1534,25,25.92,<=30,IND,Away,Upto 2014
JDC Goddard,WI,Spin,1948-01-21,Bridgetown,West Indies,1948,2,67,210,3,1,610,1348,22,543,1138,19,27.727272727272727,<=30,WI,Home,Upto 2014
JDC Goddard,WI,Spin,1948-02-11,Port of Spain,West Indies,1948,2,75,195,1,1,644,1409,17,569,1214,16,37.88235294117647,>30,WI,Home,Upto 2014
JDC Goddard,WI,Spin,1948-03-03,Georgetown,West Indies,1948,2,74,230,6,1,451,1064,19,377,834,13,23.736842105263158,<=30,WI,Home,Upto 2014
JDC Goddard,WI,Spin,1948-03-27,Kingston,West Indies,1948,2,71,264,1,1,658,1636,13,587,1372,12,50.61538461538461,>30,WI,Home,Upto 2014
JDC Goddard,WI,Spin,1948-11-10,Delhi,India,1948,2,101,270,2,1,804,1710,13,703,1440,11,61.84615384615385,>30,IND,Away,Upto 2014
JDC Goddard,WI,Spin,1948-12-09,Brabourne,India,1948,2,25,92,1,1,780,1868,11,755,1776,10,70.9090909090909,>30,IND,Away,Upto 2014
JDC Goddard,WI,Spin,1948-12-31,Eden Gardens,India,1948,2,75,216,4,1,677,1523,19,602,1307,15,35.63157894736842,>30,IND,Away,Upto 2014
JDC Goddard,WI,Spin,1949-01-27,Chennai,India,1949,2,34,84,1,1,495,939,11,461,855,10,45.0,>30,IND,Away,Upto 2014
JDC Goddard,WI,Spin,1949-02-04,Brabourne,India,1949,1,116,162,1,1,580,1268,18,464,1106,17,32.22222222222222,>30,IND,Away,Upto 2014
JDC Goddard,WI,Spin,1950-06-08,Manchester,England,1950,2,58,144,0,1,787,2271,35,729,2127,35,22.485714285714284,<=30,ENG,Away,Upto 2014
JDC Goddard,WI,Spin,1950-06-24,Lord's,England,1950,1,0,36,0,1,844,2771,30,844,2735,30,28.133333333333333,<=30,ENG,Away,Upto 2014
JDC Goddard,WI,Spin,1950-07-20,Nottingham,England,1950,2,28,108,1,1,728,2103,19,700,1995,18,38.31578947368421,>30,ENG,Away,Upto 2014
JDC Goddard,WI,Spin,1950-08-12,The Oval,England,1950,2,36,160,5,1,654,1981,25,618,1821,20,26.16,<=30,ENG,Away,Upto 2014
JDC Goddard,WI,Spin,1951-11-30,Sydney,Australia,1951,1,55,192,1,1,842,1964,19,787,1772,18,44.31578947368421,>30,AUS,Away,Upto 2014
JDC Goddard,WI,Spin,1951-12-22,Adelaide,Australia,1951,2,43,72,3,1,501,1145,26,458,1073,23,19.26923076923077,<=30,AUS,Away,Upto 2014
JDC Goddard,WI,Spin,1951-12-31,Melbourne,Australia,1951,1,28,64,0,1,557,1523,18,529,1459,18,30.944444444444443,>30,AUS,Away,Upto 2014
JDC Goddard,WI,Spin,1952-02-08,Christchurch,New Zealand,1952,2,25,72,1,1,593,1754,25,568,1682,24,23.72,<=30,NZ,Away,Upto 2014
JDC Goddard,WI,Spin,1952-02-15,Auckland,New Zealand,1952,1,11,12,0,1,442,1192,12,431,1180,12,36.833333333333336,>30,NZ,Away,Upto 2014
JDC Goddard,WI,Spin,1957-05-30,Birmingham,England,1957,1,12,36,0,1,809,2558,20,797,2522,20,40.45,>30,ENG,Away,Upto 2014
JDC Goddard,WI,Spin,1957-06-20,Lord's,England,1957,1,45,78,1,1,343,654,7,298,576,6,49.0,>30,ENG,Away,Upto 2014
JDC Goddard,WI,Spin,1957-07-04,Nottingham,England,1957,2,28,96,0,1,731,1812,9,703,1716,9,81.22222222222223,>30,ENG,Away,Upto 2014
JDC Goddard,WI,Spin,1957-08-22,The Oval,England,1957,1,43,138,1,1,485,1435,24,442,1297,23,20.208333333333332,<=30,ENG,Away,Upto 2014
JDF Larter,ENG,Pace,1962-08-16,The Oval,England,1962,2,145,277,9,1,534,1069,17,389,792,8,31.41176470588235,>30,ENG,Home,Upto 2014
JDF Larter,ENG,Pace,1963-02-23,Auckland,New Zealand,1963,2,77,241,7,1,301,863,11,224,622,4,27.363636363636363,<=30,NZ,Away,Upto 2014
JDF Larter,ENG,Pace,1963-03-01,Wellington,New Zealand,1963,2,70,126,0,1,394,894,13,324,768,13,30.307692307692307,>30,NZ,Away,Upto 2014
JDF Larter,ENG,Pace,1963-03-15,Christchurch,New Zealand,1963,2,91,264,3,1,462,1331,21,371,1067,18,22.0,<=30,NZ,Away,Upto 2014
JDF Larter,ENG,Pace,1964-01-10,Chennai,India,1964,2,95,180,0,1,259,498,2,164,318,2,129.5,>30,IND,Away,Upto 2014
JDF Larter,ENG,Pace,1964-01-21,Brabourne,India,1964,2,48,93,2,1,366,747,11,318,654,9,33.27272727272727,>30,IND,Away,Upto 2014
JDF Larter,ENG,Pace,1964-01-29,Eden Gardens,India,1964,2,88,156,3,1,354,661,13,266,505,10,27.23076923076923,<=30,IND,Away,Upto 2014
JDF Larter,ENG,Pace,1965-07-08,Leeds,England,1965,2,120,301,6,1,607,1237,14,487,936,8,43.357142857142854,>30,ENG,Home,Upto 2014
JDF Larter,ENG,Pace,1965-07-22,Lord's,England,1965,2,114,258,1,1,689,1908,25,575,1650,24,27.56,<=30,ENG,Home,Upto 2014
JDF Larter,ENG,Pace,1965-08-05,Nottingham,England,1965,2,93,276,6,1,718,1736,30,625,1460,24,23.933333333333334,<=30,ENG,Home,Upto 2014
JDF Vandersay,SL,Spin,2022-06-29,Galle,Sri Lanka,2022,1,68,60,2,1,491,729,25,423,669,23,19.64,<=30,SL,Home,After 1965
JDF Vandersay,SL,Spin,2025-01-29,Galle,Sri Lanka,2025,1,182,228,3,1,941,1397,23,759,1169,20,40.91304347826087,>30,SL,Home,After 1965
JDP Oram,NZ,Pace,2002-12-12,Wellington,New Zealand,2002,2,67,162,5,1,505,1071,28,438,909,23,18.035714285714285,<=30,NZ,Home,Upto 2014
JDP Oram,NZ,Pace,2002-12-19,Hamilton,New Zealand,2002,2,63,137,6,1,426,959,32,363,822,26,13.3125,<=30,NZ,Home,Upto 2014
JDP Oram,NZ,Pace,2003-04-25,Colombo (PSS),Sri Lanka,2003,1,62,180,1,1,412,858,7,350,678,6,58.857142857142854,>30,SL,Away,Upto 2014
JDP Oram,NZ,Pace,2003-05-03,Kandy,Sri Lanka,2003,1,54,120,3,1,352,866,14,298,746,11,25.142857142857142,<=30,SL,Away,Upto 2014
JDP Oram,NZ,Pace,2003-10-08,Ahmedabad,India,2003,2,134,246,2,1,553,1086,9,419,840,7,61.44444444444444,>30,IND,Away,Upto 2014
JDP Oram,NZ,Pace,2003-12-19,Hamilton,New Zealand,2003,1,55,138,2,1,863,1591,23,808,1453,21,37.52173913043478,>30,NZ,Home,Upto 2014
JDP Oram,NZ,Pace,2003-12-26,Wellington,New Zealand,2003,2,83,186,3,1,696,1646,29,613,1460,26,24.0,<=30,NZ,Home,Upto 2014
JDP Oram,NZ,Pace,2004-03-10,Hamilton,New Zealand,2004,2,105,252,2,1,760,1661,15,655,1409,13,50.666666666666664,>30,NZ,Home,Upto 2014
JDP Oram,NZ,Pace,2004-03-18,Auckland,New Zealand,2004,2,107,333,3,1,1016,1973,29,909,1640,26,35.03448275862069,>30,NZ,Home,Upto 2014
JDP Oram,NZ,Pace,2004-03-26,Wellington,New Zealand,2004,2,44,132,2,1,820,1651,25,776,1519,23,32.8,>30,NZ,Home,Upto 2014
JDP Oram,NZ,Pace,2004-05-20,Lord's,England,2004,2,115,270,2,1,1118,2072,26,1003,1802,24,43.0,>30,ENG,Away,Upto 2014
JDP Oram,NZ,Pace,2004-06-10,Nottingham,England,2004,2,97,177,0,1,1015,1836,30,918,1659,30,33.833333333333336,>30,ENG,Away,Upto 2014
JDP Oram,NZ,Pace,2004-10-19,Dhaka,Bangladesh,2004,2,42,179,3,1,301,659,9,259,480,6,33.44444444444444,>30,BAN,Away,Upto 2014
JDP Oram,NZ,Pace,2004-10-26,Chattogram,Bangladesh,2004,2,53,90,1,1,237,372,3,184,282,2,79.0,>30,BAN,Away,Upto 2014
JDP Oram,NZ,Pace,2004-11-18,Brisbane,Australia,2004,1,116,150,0,1,723,1283,17,607,1133,17,42.529411764705884,>30,AUS,Away,Upto 2014
JDP Oram,NZ,Pace,2004-11-26,Adelaide,Australia,2004,2,72,174,0,1,602,1087,15,530,913,15,40.13333333333333,>30,AUS,Away,Upto 2014
JDP Oram,NZ,Pace,2006-04-15,Centurion,South Africa,2006,2,71,186,2,1,858,1550,38,787,1364,36,22.57894736842105,<=30,SA,Away,Upto 2014
JDP Oram,NZ,Pace,2006-04-27,Cape Town,South Africa,2006,1,24,108,1,1,739,1386,13,715,1278,12,56.84615384615385,>30,SA,Away,Upto 2014
JDP Oram,NZ,Pace,2006-05-05,Johannesburg,South Africa,2006,2,28,36,0,1,757,1280,36,729,1244,36,21.02777777777778,<=30,SA,Away,Upto 2014
JDP Oram,NZ,Pace,2006-12-07,Christchurch,New Zealand,2006,2,49,102,3,1,515,1047,25,466,945,22,20.6,<=30,NZ,Home,Upto 2014
JDP Oram,NZ,Pace,2006-12-15,Wellington,New Zealand,2006,1,10,18,1,1,700,1140,20,690,1122,19,35.0,>30,NZ,Home,Upto 2014
JDP Oram,NZ,Pace,2007-11-08,Johannesburg,South Africa,2007,2,80,172,1,1,740,1372,29,660,1200,28,25.517241379310345,<=30,SA,Away,Upto 2014
JDP Oram,NZ,Pace,2008-01-04,Dunedin,New Zealand,2008,2,44,150,4,1,478,890,22,434,740,18,21.727272727272727,<=30,NZ,Home,Upto 2014
JDP Oram,NZ,Pace,2008-01-12,Wellington,New Zealand,2008,2,23,84,2,1,450,866,22,427,782,20,20.454545454545453,<=30,NZ,Home,Upto 2014
JDP Oram,NZ,Pace,2008-03-05,Hamilton,New Zealand,2008,2,29,150,2,1,672,1450,27,643,1300,25,24.88888888888889,<=30,NZ,Home,Upto 2014
JDP Oram,NZ,Pace,2008-03-13,Wellington,New Zealand,2008,2,90,294,6,1,966,1899,38,876,1605,32,25.42105263157895,<=30,NZ,Home,Upto 2014
JDP Oram,NZ,Pace,2008-05-15,Lord's,England,2008,1,45,114,2,1,640,1330,19,595,1216,17,33.68421052631579,>30,ENG,Away,Upto 2014
JDP Oram,NZ,Pace,2008-05-23,Manchester,England,2008,2,41,126,0,1,614,1172,16,573,1046,16,38.375,>30,ENG,Away,Upto 2014
JDP Oram,NZ,Pace,2008-06-05,Nottingham,England,2008,1,35,132,1,1,579,1236,29,544,1104,28,19.96551724137931,<=30,ENG,Away,Upto 2014
JDP Oram,NZ,Pace,2008-10-17,Chattogram,Bangladesh,2008,2,33,168,0,1,258,774,7,225,606,7,36.857142857142854,>30,BAN,Away,Upto 2014
JDP Oram,NZ,Pace,2009-08-18,Galle,Sri Lanka,2009,2,56,72,0,1,541,798,16,485,726,16,33.8125,>30,SL,Away,Upto 2014
JDP Oram,NZ,Pace,2009-08-26,Colombo (SSC),Sri Lanka,2009,1,56,126,0,1,574,917,8,518,791,8,71.75,>30,SL,Away,Upto 2014
JDS Neesham,NZ,Pace,2014-02-14,Wellington,New Zealand,2014,2,87,138,1,1,1271,2109,30,1184,1971,29,42.36666666666667,>30,NZ,Home,After 1965
JDS Neesham,NZ,Pace,2014-06-08,Kingston,West Indies,2014,2,23,48,0,1,334,854,13,311,806,13,25.692307692307693,<=30,WI,Away,After 1965
JDS Neesham,NZ,Pace,2014-06-16,Port of Spain,West Indies,2014,1,68,90,1,1,611,1256,20,543,1166,19,30.55,>30,WI,Away,After 1965
JDS Neesham,NZ,Pace,2014-06-26,Bridgetown,West Indies,2014,2,21,55,2,1,620,1276,27,599,1221,25,22.962962962962962,<=30,WI,Away,After 1965
JDS Neesham,NZ,Pace,2014-11-09,Abu Dhabi,UAE,2014,1,50,96,0,1,447,927,10,397,831,10,44.7,>30,UAE,Away,After 1965
JDS Neesham,NZ,Pace,2014-11-17,Dubai (DICS),UAE,2014,2,13,78,1,1,426,1086,12,413,1008,11,35.5,>30,UAE,Away,After 1965
JDS Neesham,NZ,Pace,2014-12-26,Christchurch,New Zealand,2014,2,57,88,3,1,757,1417,28,700,1329,25,27.035714285714285,<=30,NZ,Home,After 1965
JDS Neesham,NZ,Pace,2015-01-03,Wellington,New Zealand,2015,1,42,66,3,1,987,1835,28,945,1769,25,35.25,>30,NZ,Home,After 1965
JDS Neesham,NZ,Pace,2015-11-05,Brisbane,Australia,2015,2,111,120,1,1,1023,1505,20,912,1385,19,51.15,>30,AUS,Away,After 1965
JDS Neesham,NZ,Pace,2016-10-08,Indore,India,2016,2,80,132,0,1,519,876,3,439,744,3,173.0,>30,IND,Away,After 1965
JDS Neesham,NZ,Pace,2017-03-08,Dunedin,New Zealand,2017,2,54,78,1,1,518,1198,16,464,1120,15,32.375,>30,NZ,Home,After 1965
JDS Neesham,NZ,Pace,2017-03-16,Wellington,New Zealand,2017,2,69,87,1,1,662,1203,19,593,1116,18,34.8421052631579,>30,NZ,Home,After 1965
JE Benjamin,ENG,Pace,1994-08-18,The Oval,England,1994,2,80,168,4,1,962,1490,30,882,1322,26,32.06666666666667,>30,ENG,Home,Upto 2014
JE Cheetham,SA,Spin,1953-03-13,Auckland,New Zealand,1953,1,2,6,0,1,495,1529,18,493,1523,18,27.5,<=30,NZ,Away,Upto 2014
JE Emburey,ENG,Spin,1978-08-24,Lord's,England,1978,2,40,175,2,1,103,427,3,63,252,1,34.333333333333336,>30,ENG,Home,Upto 2014
JE Emburey,ENG,Spin,1978-12-29,Melbourne,Australia,1978,2,74,282,3,1,223,866,11,149,584,8,20.272727272727273,<=30,AUS,Away,Upto 2014
JE Emburey,ENG,Spin,1979-01-06,Sydney,Australia,1979,2,103,370,5,1,399,1440,18,296,1070,13,22.166666666666668,<=30,AUS,Away,Upto 2014
JE Emburey,ENG,Spin,1979-01-27,Adelaide,Australia,1979,2,29,168,2,1,239,776,7,210,608,5,34.142857142857146,>30,AUS,Away,Upto 2014
JE Emburey,ENG,Spin,1979-02-10,Sydney,Australia,1979,2,100,336,6,1,364,1147,19,264,811,13,19.157894736842106,<=30,AUS,Away,Upto 2014
JE Emburey,ENG,Spin,1980-07-10,Manchester,England,1980,1,20,63,3,1,55,171,3,35,108,0,18.333333333333332,<=30,ENG,Home,Upto 2014
JE Emburey,ENG,Spin,1980-07-24,The Oval,England,1980,1,38,138,2,1,102,312,2,64,174,0,51.0,>30,ENG,Home,Upto 2014
JE Emburey,ENG,Spin,1980-08-07,Leeds,England,1980,1,25,36,1,1,25,42,1,0,6,0,25.0,<=30,ENG,Home,Upto 2014
JE Emburey,ENG,Spin,1980-08-28,Lord's,England,1980,2,139,282,1,1,326,734,3,187,452,2,108.66666666666667,>30,ENG,Home,Upto 2014
JE Emburey,ENG,Spin,1981-02-13,Port of Spain,West Indies,1981,1,124,312,5,1,213,606,8,89,294,3,26.625,<=30,WI,Away,Upto 2014
JE Emburey,ENG,Spin,1981-03-13,Bridgetown,West Indies,1981,2,102,252,0,1,149,390,2,47,138,2,74.5,>30,WI,Away,Upto 2014
JE Emburey,ENG,Spin,1981-03-27,St John's,West Indies,1981,1,85,210,0,1,220,600,1,135,390,1,220.0,>30,WI,Away,Upto 2014
JE Emburey,ENG,Spin,1981-04-10,Kingston,West Indies,1981,1,108,336,2,1,271,768,4,163,432,2,67.75,>30,WI,Away,Upto 2014
JE Emburey,ENG,Spin,1981-07-02,Lord's,England,1981,2,59,276,2,1,157,582,6,98,306,4,26.166666666666668,<=30,ENG,Home,Upto 2014
JE Emburey,ENG,Spin,1981-07-30,Birmingham,England,1981,2,83,293,6,1,171,569,13,88,276,7,13.153846153846153,<=30,ENG,Home,Upto 2014
JE Emburey,ENG,Spin,1981-08-13,Manchester,England,1981,2,123,318,3,1,221,574,4,98,256,1,55.25,>30,ENG,Home,Upto 2014
JE Emburey,ENG,Spin,1981-08-27,The Oval,England,1981,2,134,276,1,1,225,564,1,91,288,0,225.0,>30,ENG,Home,Upto 2014
JE Emburey,ENG,Spin,1981-11-27,Wankhede,India,1981,1,35,78,2,1,162,553,10,127,475,8,16.2,<=30,IND,Away,Upto 2014
JE Emburey,ENG,Spin,1982-01-01,Eden Gardens,India,1982,2,106,324,4,1,396,1328,13,290,1004,9,30.46153846153846,>30,IND,Away,Upto 2014
JE Emburey,ENG,Spin,1982-01-30,Kanpur,India,1982,1,81,192,0,1,274,704,7,193,512,7,39.142857142857146,>30,IND,Away,Upto 2014
JE Emburey,ENG,Spin,1982-02-17,Colombo (PSS),Sri Lanka,1982,2,88,264,6,1,442,1264,21,354,1000,15,21.047619047619047,<=30,SL,Away,Upto 2014
JE Emburey,ENG,Spin,1985-06-13,Leeds,England,1985,2,105,298,7,1,123,334,7,18,36,0,17.571428571428573,<=30,ENG,Home,Upto 2014
JE Emburey,ENG,Spin,1985-06-27,Lord's,England,1985,2,81,162,1,1,311,742,9,230,580,8,34.55555555555556,>30,ENG,Home,Upto 2014
JE Emburey,ENG,Spin,1985-07-11,Nottingham,England,1985,1,129,330,3,1,443,1050,6,314,720,3,73.83333333333333,>30,ENG,Home,Upto 2014
JE Emburey,ENG,Spin,1985-08-01,Manchester,England,1985,2,140,450,6,1,424,1147,11,284,697,5,38.54545454545455,>30,ENG,Home,Upto 2014
JE Emburey,ENG,Spin,1985-08-15,Birmingham,England,1985,2,40,132,1,1,208,528,4,168,396,3,52.0,>30,ENG,Home,Upto 2014
JE Emburey,ENG,Spin,1985-08-29,The Oval,England,1985,2,49,120,1,1,236,426,4,187,306,3,59.0,>30,ENG,Home,Upto 2014
JE Emburey,ENG,Spin,1986-03-07,Port of Spain,West Indies,1986,2,114,222,7,1,243,525,10,129,303,3,24.3,<=30,WI,Away,Upto 2014
JE Emburey,ENG,Spin,1986-03-21,Bridgetown,West Indies,1986,1,96,228,1,1,197,444,1,101,216,0,197.0,>30,WI,Away,Upto 2014
JE Emburey,ENG,Spin,1986-04-03,Port of Spain,West Indies,1986,1,62,162,3,1,62,162,3,0,0,0,20.666666666666668,<=30,WI,Away,Upto 2014
JE Emburey,ENG,Spin,1986-04-11,St John's,West Indies,1986,2,176,306,3,1,237,564,7,61,258,4,33.857142857142854,>30,WI,Away,Upto 2014
JE Emburey,ENG,Spin,1986-06-05,Lord's,England,1986,1,28,162,1,1,225,844,8,197,682,7,28.125,<=30,ENG,Home,Upto 2014
JE Emburey,ENG,Spin,1986-06-19,Leeds,England,1986,2,54,144,1,1,106,321,7,52,177,6,15.142857142857142,<=30,ENG,Home,Upto 2014
JE Emburey,ENG,Spin,1986-07-03,Birmingham,England,1986,2,59,155,2,1,336,971,13,277,816,11,25.846153846153847,<=30,ENG,Home,Upto 2014
JE Emburey,ENG,Spin,1986-08-07,Nottingham,England,1986,2,102,293,3,1,295,797,10,193,504,7,29.5,<=30,ENG,Home,Upto 2014
JE Emburey,ENG,Spin,1986-08-21,The Oval,England,1986,1,39,186,1,1,193,510,3,154,324,2,64.33333333333333,>30,ENG,Home,Upto 2014
JE Emburey,ENG,Spin,1986-11-14,Brisbane,Australia,1986,2,146,461,5,1,263,785,6,117,324,1,43.833333333333336,>30,AUS,Away,Upto 2014
JE Emburey,ENG,Spin,1986-11-28,W.A.C.A,Australia,1986,2,151,426,3,1,361,930,7,210,504,4,51.57142857142857,>30,AUS,Away,Upto 2014
JE Emburey,ENG,Spin,1986-12-12,Adelaide,Australia,1986,2,167,408,1,1,609,1398,9,442,990,8,67.66666666666667,>30,AUS,Away,Upto 2014
JE Emburey,ENG,Spin,1986-12-26,Melbourne,Australia,1986,2,59,144,2,1,169,430,6,110,286,4,28.166666666666668,<=30,AUS,Away,Upto 2014
JE Emburey,ENG,Spin,1987-01-10,Sydney,Australia,1987,2,140,456,7,1,596,1662,26,456,1206,19,22.923076923076923,<=30,AUS,Away,Upto 2014
JE Emburey,ENG,Spin,1987-06-04,Manchester,England,1987,1,28,96,0,1,82,268,3,54,172,3,27.333333333333332,<=30,ENG,Home,Upto 2014
JE Emburey,ENG,Spin,1987-07-23,Birmingham,England,1987,2,51,180,0,1,177,477,2,126,297,2,88.5,>30,ENG,Home,Upto 2014
JE Emburey,ENG,Spin,1987-08-06,The Oval,England,1987,1,143,366,0,1,612,1585,13,469,1219,13,47.07692307692308,>30,ENG,Home,Upto 2014
JE Emburey,ENG,Spin,1987-11-25,Lahore,Pakistan,1987,1,109,288,3,1,424,1316,26,315,1028,23,16.307692307692307,<=30,PAK,Away,Upto 2014
JE Emburey,ENG,Spin,1987-12-07,Faisalabad,Pakistan,1987,2,52,138,3,1,479,1253,22,427,1115,19,21.772727272727273,<=30,PAK,Away,Upto 2014
JE Emburey,ENG,Spin,1987-12-16,Karachi,Pakistan,1987,1,90,318,1,1,450,1486,13,360,1168,12,34.61538461538461,>30,PAK,Away,Upto 2014
JE Emburey,ENG,Spin,1988-01-29,Sydney,Australia,1988,2,155,408,1,1,513,1326,10,358,918,9,51.3,>30,AUS,Away,Upto 2014
JE Emburey,ENG,Spin,1988-02-12,Christchurch,New Zealand,1988,2,18,84,0,1,34,120,0,16,36,0,inf,>30,NZ,Away,Upto 2014
JE Emburey,ENG,Spin,1988-02-25,Auckland,New Zealand,1988,2,119,444,2,1,207,678,5,88,234,3,41.4,>30,NZ,Away,Upto 2014
JE Emburey,ENG,Spin,1988-03-03,Wellington,New Zealand,1988,1,99,275,1,1,303,839,2,204,564,1,151.5,>30,NZ,Away,Upto 2014
JE Emburey,ENG,Spin,1988-06-02,Nottingham,England,1988,1,95,96,2,1,176,288,2,81,192,0,88.0,>30,ENG,Home,Upto 2014
JE Emburey,ENG,Spin,1988-06-16,Lord's,England,1988,2,79,126,1,1,79,126,1,0,0,0,79.0,>30,ENG,Home,Upto 2014
JE Emburey,ENG,Spin,1988-06-30,Manchester,England,1988,1,54,150,0,1,153,408,1,99,258,1,153.0,>30,ENG,Home,Upto 2014
JE Emburey,ENG,Spin,1988-08-25,Lord's,England,1988,2,38,120,1,1,79,216,1,41,96,0,79.0,>30,ENG,Home,Upto 2014
JE Emburey,ENG,Spin,1989-06-22,Lord's,England,1989,2,96,270,4,1,161,444,4,65,174,0,40.25,>30,ENG,Home,Upto 2014
JE Emburey,ENG,Spin,1989-07-06,Birmingham,England,1989,2,98,294,2,1,123,408,3,25,114,1,41.0,>30,ENG,Home,Upto 2014
JE Emburey,ENG,Spin,1989-07-27,Manchester,England,1989,2,148,348,2,1,359,881,8,211,533,6,44.875,>30,ENG,Home,Upto 2014
JE Emburey,ENG,Spin,1993-02-19,Wankhede,India,1993,1,144,354,2,1,804,1796,20,660,1442,18,40.2,>30,IND,Away,Upto 2014
JE Emburey,ENG,Spin,1993-03-13,Colombo (SSC),Sri Lanka,1993,2,165,288,4,1,805,1517,22,640,1229,18,36.59090909090909,>30,SL,Away,Upto 2014
JE Emburey,ENG,Spin,1993-08-05,Birmingham,England,1993,2,150,342,3,1,613,1738,21,463,1396,18,29.19047619047619,<=30,ENG,Home,Upto 2014
JE Emburey,ENG,Spin,1995-07-27,Manchester,England,1995,2,82,180,0,1,271,569,5,189,389,5,54.2,>30,ENG,Home,Upto 2014
JE McConnon,ENG,Spin,1954-07-22,Manchester,England,1954,1,19,78,3,1,192,600,11,173,522,8,17.454545454545453,<=30,ENG,Home,Upto 2014
JE McConnon,ENG,Spin,1954-08-12,The Oval,England,1954,2,55,138,1,1,187,540,10,132,402,9,18.7,<=30,ENG,Home,Upto 2014
JE Pothecary,SA,Pace,1960-07-07,Nottingham,England,1960,2,57,132,0,1,545,1319,26,488,1187,26,20.96153846153846,<=30,ENG,Away,Upto 2014
JE Pothecary,SA,Pace,1960-07-21,Manchester,England,1960,2,146,360,5,1,475,1326,23,329,966,18,20.652173913043477,<=30,ENG,Away,Upto 2014
JE Pothecary,SA,Pace,1960-08-18,The Oval,England,1960,2,151,336,4,1,792,1752,24,641,1416,20,33.0,>30,ENG,Away,Upto 2014
JE Root,ENG,Spin,2012-12-13,Nagpur,India,2012,1,5,6,0,1,722,2045,15,717,2039,15,48.13333333333333,>30,IND,Away,Upto 2014
JE Root,ENG,Spin,2013-03-06,Dunedin,New Zealand,2013,1,8,30,0,1,254,582,6,246,552,6,42.333333333333336,>30,NZ,Away,Upto 2014
JE Root,ENG,Spin,2013-03-14,Wellington,New Zealand,2013,2,18,18,0,1,255,641,7,237,623,7,36.42857142857143,>30,NZ,Away,Upto 2014
JE Root,ENG,Spin,2013-03-22,Auckland,New Zealand,2013,1,5,12,0,1,355,860,7,350,848,7,50.714285714285715,>30,NZ,Away,Upto 2014
JE Root,ENG,Spin,2013-05-24,Leeds,England,2013,1,1,18,0,1,291,492,14,290,474,14,20.785714285714285,<=30,ENG,Home,Upto 2014
JE Root,ENG,Spin,2013-07-10,Nottingham,England,2013,1,6,12,1,1,277,642,7,271,630,6,39.57142857142857,>30,ENG,Home,Upto 2014
JE Root,ENG,Spin,2013-07-18,Lord's,England,2013,1,9,42,2,1,356,726,15,347,684,13,23.733333333333334,<=30,ENG,Home,Upto 2014
JE Root,ENG,Spin,2013-08-01,Manchester,England,2013,1,18,24,0,1,362,618,7,344,594,7,51.714285714285715,>30,ENG,Home,Upto 2014
JE Root,ENG,Spin,2013-08-09,Chester-le-Street,England,2013,1,1,18,0,1,200,493,11,199,475,11,18.181818181818183,<=30,ENG,Home,Upto 2014
JE Root,ENG,Spin,2013-11-21,Brisbane,Australia,2013,2,62,108,0,1,355,624,6,293,516,6,59.166666666666664,>30,AUS,Away,Upto 2014
JE Root,ENG,Spin,2013-12-13,W.A.C.A,Australia,2013,2,28,60,0,1,300,552,7,272,492,7,42.857142857142854,>30,AUS,Away,Upto 2014
JE Root,ENG,Spin,2013-12-26,Melbourne,Australia,2013,1,8,24,0,1,184,361,7,176,337,7,26.285714285714285,<=30,AUS,Away,Upto 2014
JE Root,ENG,Spin,2014-06-12,Lord's,England,2014,2,14,42,0,1,336,573,6,322,531,6,56.0,>30,ENG,Home,After 1965
JE Root,ENG,Spin,2014-06-20,Leeds,England,2014,1,9,6,0,1,219,552,5,210,546,5,43.8,>30,ENG,Home,After 1965
JE Root,ENG,Spin,2014-07-09,Nottingham,England,2014,2,28,78,0,1,324,594,5,296,516,5,64.8,>30,ENG,Home,After 1965
JE Root,ENG,Spin,2014-07-27,Southampton,England,2014,1,5,12,1,1,407,690,15,402,678,14,27.133333333333333,<=30,ENG,Home,After 1965
JE Root,ENG,Spin,2015-04-13,North Sound,West Indies,2015,1,22,78,2,1,466,940,10,444,862,8,46.6,>30,WI,Away,After 1965
JE Root,ENG,Spin,2015-04-21,St George's,West Indies,2015,1,29,96,0,1,451,913,9,422,817,9,50.111111111111114,>30,WI,Away,After 1965
JE Root,ENG,Spin,2015-05-01,Bridgetown,West Indies,2015,2,50,102,1,1,352,610,8,302,508,7,44.0,>30,WI,Away,After 1965
JE Root,ENG,Spin,2015-05-21,Lord's,England,2015,2,13,42,1,1,317,528,7,304,486,6,45.285714285714285,>30,ENG,Home,After 1965
JE Root,ENG,Spin,2015-05-29,Leeds,England,2015,1,23,30,0,1,285,593,9,262,563,9,31.666666666666668,>30,ENG,Home,After 1965
JE Root,ENG,Spin,2015-07-08,Cardiff,England,2015,1,28,36,2,1,311,478,13,283,442,11,23.923076923076923,<=30,ENG,Home,After 1965
JE Root,ENG,Spin,2015-07-16,Lord's,England,2015,2,87,102,2,1,392,582,8,305,480,6,49.0,>30,ENG,Home,After 1965
JE Root,ENG,Spin,2015-07-29,Birmingham,England,2015,1,7,15,0,1,159,256,4,152,241,4,39.75,>30,ENG,Home,After 1965
JE Root,ENG,Spin,2015-08-20,The Oval,England,2015,1,13,18,0,1,215,360,8,202,342,8,26.875,<=30,ENG,Home,After 1965
JE Root,ENG,Spin,2015-10-13,Abu Dhabi,UAE,2015,1,13,30,0,1,740,1307,14,727,1277,14,52.857142857142854,>30,UAE,Away,After 1965
JE Root,ENG,Spin,2015-10-22,Dubai (DICS),UAE,2015,1,26,18,0,1,700,1353,17,674,1335,17,41.1764705882353,>30,UAE,Away,After 1965
JE Root,ENG,Spin,2015-12-26,Durban,South Africa,2015,1,11,18,0,1,402,738,13,391,720,13,30.923076923076923,>30,SA,Away,After 1965
JE Root,ENG,Spin,2016-01-02,Cape Town,South Africa,2016,1,54,120,0,1,386,750,3,332,630,3,128.66666666666666,>30,SA,Away,After 1965
JE Root,ENG,Spin,2016-01-22,Centurion,South Africa,2016,1,12,24,0,1,309,534,4,297,510,4,77.25,>30,SA,Away,After 1965
JE Root,ENG,Spin,2016-05-27,Chester-le-Street,England,2016,1,13,12,0,1,355,530,5,342,518,5,71.0,>30,ENG,Home,After 1965
JE Root,ENG,Spin,2016-06-09,Lord's,England,2016,1,6,2,0,1,192,434,4,186,432,4,48.0,>30,ENG,Home,After 1965
JE Root,ENG,Spin,2016-07-22,Manchester,England,2016,1,0,6,1,1,470,620,7,470,614,6,67.14285714285714,>30,ENG,Home,After 1965
JE Root,ENG,Spin,2016-08-03,Birmingham,England,2016,2,5,12,0,1,391,671,5,386,659,5,78.2,>30,ENG,Home,After 1965
JE Root,ENG,Spin,2016-08-11,The Oval,England,2016,2,22,48,0,1,324,517,8,302,469,8,40.5,>30,ENG,Home,After 1965
JE Root,ENG,Spin,2016-10-20,Chattogram,Bangladesh,2016,1,5,12,0,1,760,1579,30,755,1567,30,25.333333333333332,<=30,BAN,Away,After 1965
JE Root,ENG,Spin,2016-11-09,Rajkot,India,2016,1,5,12,0,1,954,1677,22,949,1665,22,43.36363636363637,>30,IND,Away,After 1965
JE Root,ENG,Spin,2016-11-17,Visakhapatnam,India,2016,1,9,12,0,1,632,1483,25,623,1471,25,25.28,<=30,IND,Away,After 1965
JE Root,ENG,Spin,2016-12-08,Wankhede,India,2016,1,31,60,2,1,864,1639,27,833,1579,25,32.0,>30,IND,Away,After 1965
JE Root,ENG,Spin,2016-12-16,Chennai,India,2016,1,12,12,0,1,966,1770,17,954,1758,17,56.8235294117647,>30,IND,Away,After 1965
JE Root,ENG,Spin,2017-07-27,The Oval,England,2017,1,5,12,0,1,198,330,8,193,318,8,24.75,<=30,ENG,Home,After 1965
JE Root,ENG,Spin,2017-08-04,Manchester,England,2017,1,8,12,0,1,291,609,10,283,597,10,29.1,<=30,ENG,Home,After 1965
JE Root,ENG,Spin,2017-09-07,Lord's,England,2017,1,5,6,0,1,84,138,1,79,132,1,84.0,>30,ENG,Home,After 1965
JE Root,ENG,Spin,2017-11-23,Brisbane,Australia,2017,2,27,63,1,1,277,645,8,250,582,7,34.625,>30,AUS,Away,After 1965
JE Root,ENG,Spin,2017-12-02,Adelaide,Australia,2017,1,16,24,0,1,220,493,6,204,469,6,36.666666666666664,>30,AUS,Away,After 1965
JE Root,ENG,Spin,2017-12-14,W.A.C.A,Australia,2017,1,13,18,0,1,269,492,4,256,474,4,67.25,>30,AUS,Away,After 1965
JE Root,ENG,Spin,2017-12-26,Melbourne,Australia,2017,1,1,18,1,1,251,518,4,250,500,3,62.75,>30,AUS,Away,After 1965
JE Root,ENG,Spin,2018-01-04,Sydney,Australia,2018,1,21,48,0,1,530,1068,7,509,1020,7,75.71428571428571,>30,AUS,Away,After 1965
JE Root,ENG,Spin,2018-03-22,Auckland,New Zealand,2018,1,13,18,1,1,112,223,4,99,205,3,28.0,<=30,NZ,Away,After 1965
JE Root,ENG,Spin,2018-03-30,Christchurch,New Zealand,2018,2,37,82,1,1,236,508,3,199,426,2,78.66666666666667,>30,NZ,Away,After 1965
JE Root,ENG,Spin,2018-08-18,Nottingham,England,2018,1,9,18,0,1,203,377,5,194,359,5,40.6,>30,ENG,Home,After 1965
JE Root,ENG,Spin,2018-09-07,The Oval,England,2018,1,17,36,0,1,513,915,16,496,879,16,32.0625,>30,ENG,Home,After 1965
JE Root,ENG,Spin,2018-11-06,Galle,Sri Lanka,2018,1,1,6,0,1,876,1627,28,875,1621,28,31.285714285714285,>30,SL,Away,After 1965
JE Root,ENG,Spin,2018-11-14,Pallekele,Sri Lanka,2018,2,41,78,1,1,1031,1760,38,990,1682,37,27.13157894736842,<=30,SL,Away,After 1965
JE Root,ENG,Spin,2018-11-23,Colombo (SSC),Sri Lanka,2018,1,4,12,0,1,913,1615,34,909,1603,34,26.852941176470587,<=30,SL,Away,After 1965
JE Root,ENG,Spin,2019-01-23,Bridgetown,West Indies,2019,2,47,90,0,1,371,593,12,324,503,12,30.916666666666668,>30,WI,Away,After 1965
JE Root,ENG,Spin,2019-08-01,Birmingham,England,2019,1,50,72,0,1,478,833,12,428,761,12,39.833333333333336,>30,ENG,Home,After 1965
JE Root,ENG,Spin,2019-08-14,Lord's,England,2019,1,7,6,0,1,239,466,7,232,460,7,34.142857142857146,>30,ENG,Home,After 1965
JE Root,ENG,Spin,2019-09-04,Manchester,England,2019,1,39,36,1,1,337,685,7,298,649,6,48.142857142857146,>30,ENG,Home,After 1965
JE Root,ENG,Spin,2019-09-12,The Oval,England,2019,1,26,54,2,1,205,441,10,179,387,8,20.5,<=30,ENG,Home,After 1965
JE Root,ENG,Spin,2019-11-21,Mount Maunganui,New Zealand,2019,1,67,108,1,1,303,672,6,236,564,5,50.5,>30,NZ,Away,After 1965
JE Root,ENG,Spin,2019-11-29,Hamilton,New Zealand,2019,2,37,42,0,1,165,324,1,128,282,1,165.0,>30,NZ,Away,After 1965
JE Root,ENG,Spin,2019-12-26,Centurion,South Africa,2019,1,26,24,0,1,85,162,2,59,138,2,42.5,>30,SA,Away,After 1965
JE Root,ENG,Spin,2020-01-03,Cape Town,South Africa,2020,2,15,54,0,1,404,942,7,389,888,7,57.714285714285715,>30,SA,Away,After 1965
JE Root,ENG,Spin,2020-01-16,Gqeberha,South Africa,2020,2,112,240,4,1,395,936,15,283,696,11,26.333333333333332,<=30,SA,Away,After 1965
JE Root,ENG,Spin,2020-01-24,Johannesburg,South Africa,2020,1,37,42,0,1,56,60,0,19,18,0,inf,>30,SA,Away,After 1965
JE Root,ENG,Spin,2020-07-16,Manchester,England,2020,2,0,14,0,1,307,518,8,307,504,8,38.375,>30,ENG,Home,After 1965
JE Root,ENG,Spin,2020-08-05,Manchester,England,2020,1,25,36,0,1,351,585,12,326,549,12,29.25,<=30,ENG,Home,After 1965
JE Root,ENG,Spin,2020-08-21,Southampton,England,2020,1,17,36,1,1,389,624,7,372,588,6,55.57142857142857,>30,ENG,Home,After 1965
JE Root,ENG,Spin,2021-01-14,Galle,Sri Lanka,2021,1,19,66,0,1,751,1413,23,732,1347,23,32.65217391304348,>30,SL,Away,After 1965
JE Root,ENG,Spin,2021-01-22,Galle,Sri Lanka,2021,1,0,11,2,1,734,1377,23,734,1366,21,31.91304347826087,>30,SL,Away,After 1965
JE Root,ENG,Spin,2021-02-05,Chennai,India,2021,1,14,12,0,1,867,1480,24,853,1468,24,36.125,>30,IND,Away,After 1965
JE Root,ENG,Spin,2021-02-13,Chennai,India,2021,2,38,90,1,1,686,1393,32,648,1303,31,21.4375,<=30,IND,Away,After 1965
JE Root,ENG,Spin,2021-02-24,Ahmedabad,India,2021,2,33,60,5,1,247,614,28,214,554,23,8.821428571428571,<=30,IND,Away,After 1965
JE Root,ENG,Spin,2021-03-04,Ahmedabad,India,2021,1,56,108,0,1,456,994,20,400,886,20,22.8,<=30,IND,Away,After 1965
JE Root,ENG,Spin,2021-06-02,Lord's,England,2021,2,54,100,1,1,134,256,1,80,156,0,134.0,>30,ENG,Home,After 1965
JE Root,ENG,Spin,2021-06-10,Birmingham,England,2021,1,45,90,0,1,120,246,5,75,156,5,24.0,<=30,ENG,Home,After 1965
JE Root,ENG,Spin,2021-08-12,Lord's,England,2021,1,9,30,0,1,194,462,3,185,432,3,64.66666666666667,>30,ENG,Home,After 1965
JE Root,ENG,Spin,2021-08-25,Leeds,England,2021,1,15,36,0,1,147,324,3,132,288,3,49.0,>30,ENG,Home,After 1965
JE Root,ENG,Spin,2021-09-02,The Oval,England,2021,1,16,42,1,1,220,480,7,204,438,6,31.428571428571427,>30,ENG,Home,After 1965
JE Root,ENG,Spin,2021-12-08,Brisbane,Australia,2021,1,29,36,1,1,257,390,6,228,354,5,42.833333333333336,>30,AUS,Away,After 1965
JE Root,ENG,Spin,2021-12-16,Adelaide,Australia,2021,2,99,156,3,1,255,630,10,156,474,7,25.5,<=30,AUS,Away,After 1965
JE Root,ENG,Spin,2022-01-05,Sydney,Australia,2022,2,71,90,1,1,414,683,10,343,593,9,41.4,>30,AUS,Away,After 1965
JE Root,ENG,Spin,2022-01-14,Hobart,Australia,2022,1,35,60,0,1,35,60,0,0,0,0,inf,>30,AUS,Away,After 1965
JE Root,ENG,Spin,2022-03-08,North Sound,West Indies,2022,2,36,42,0,1,307,730,6,271,688,6,51.166666666666664,>30,WI,Away,After 1965
JE Root,ENG,Spin,2022-03-16,Bridgetown,West Indies,2022,2,32,72,0,1,465,1126,13,433,1054,13,35.76923076923077,>30,WI,Away,After 1965
JE Root,ENG,Spin,2022-03-24,St George's,West Indies,2022,1,1,9,1,1,75,217,2,74,208,1,37.5,>30,WI,Away,After 1965
JE Root,ENG,Spin,2022-06-02,Lord's,England,2022,1,2,6,0,1,71,111,1,69,105,1,71.0,>30,ENG,Home,After 1965
JE Root,ENG,Spin,2022-06-10,Nottingham,England,2022,1,16,24,0,1,364,530,6,348,506,6,60.666666666666664,>30,ENG,Home,After 1965
JE Root,ENG,Spin,2022-06-23,Leeds,England,2022,2,59,78,1,1,388,637,13,329,559,12,29.846153846153847,<=30,ENG,Home,After 1965
JE Root,ENG,Spin,2022-07-01,Birmingham,England,2022,2,40,54,1,1,204,304,2,164,250,1,102.0,>30,ENG,Home,After 1965
JE Root,ENG,Spin,2022-08-25,Manchester,England,2022,1,16,30,0,1,204,480,4,188,450,4,51.0,>30,ENG,Home,After 1965
JE Root,ENG,Spin,2022-12-01,Rawalpindi,Pakistan,2022,2,70,132,0,1,949,1152,16,879,1020,16,59.3125,>30,PAK,Away,After 1965
JE Root,ENG,Spin,2022-12-09,Multan,Pakistan,2022,2,88,186,3,1,774,1107,26,686,921,23,29.76923076923077,<=30,PAK,Away,After 1965
JE Root,ENG,Spin,2022-12-17,Karachi,Pakistan,2022,2,38,60,2,1,895,1264,27,857,1204,25,33.148148148148145,>30,PAK,Away,After 1965
JE Root,ENG,Spin,2023-02-16,Mount Maunganui,New Zealand,2023,2,15,36,0,1,205,347,5,190,311,5,41.0,>30,NZ,Away,After 1965
JE Root,ENG,Spin,2023-02-24,Wellington,New Zealand,2023,1,39,72,1,1,403,711,11,364,639,10,36.63636363636363,>30,NZ,Away,After 1965
JE Root,ENG,Spin,2023-06-01,Lord's,England,2023,1,59,60,1,1,283,346,7,224,286,6,40.42857142857143,>30,ENG,Home,After 1965
JE Root,ENG,Spin,2023-06-16,Birmingham,England,2023,2,58,132,1,1,491,732,12,433,600,11,40.916666666666664,>30,ENG,Home,After 1965
JE Root,ENG,Spin,2023-06-28,Lord's,England,2023,1,19,48,2,1,95,198,5,76,150,3,19.0,<=30,ENG,Home,After 1965
JE Root,ENG,Spin,2023-07-06,Leeds,England,2023,1,4,6,0,1,127,219,3,123,213,3,42.333333333333336,>30,ENG,Home,After 1965
JE Root,ENG,Spin,2023-07-19,Manchester,England,2023,1,32,36,1,1,196,264,2,164,228,1,98.0,>30,ENG,Home,After 1965
JE Root,ENG,Spin,2023-07-27,The Oval,England,2023,2,59,97,2,1,267,408,11,208,311,9,24.272727272727273,<=30,ENG,Home,After 1965
JE Root,ENG,Spin,2024-01-25,Hyderabad,India,2024,2,120,288,5,1,1067,1778,32,947,1490,27,33.34375,>30,IND,Away,After 1965
JE Root,ENG,Spin,2024-02-02,Visakhapatnam,India,2024,2,72,96,0,1,935,1413,24,863,1317,24,38.958333333333336,>30,IND,Away,After 1965
JE Root,ENG,Spin,2024-02-15,Rajkot,India,2024,2,181,258,2,1,805,1288,20,624,1030,18,40.25,>30,IND,Away,After 1965
JE Root,ENG,Spin,2024-02-23,Ranchi,India,2024,2,27,48,1,1,670,1494,28,643,1446,27,23.928571428571427,<=30,IND,Away,After 1965
JE Root,ENG,Spin,2024-03-07,Dharamsala,India,2024,1,8,18,0,1,589,972,25,581,954,25,23.56,<=30,IND,Away,After 1965
JE Root,ENG,Spin,2024-07-18,Nottingham,England,2024,1,19,12,0,1,371,520,12,352,508,12,30.916666666666668,>30,ENG,Home,After 1965
JE Root,ENG,Spin,2024-08-21,Manchester,England,2024,2,23,52,1,1,370,678,9,347,626,8,41.111111111111114,>30,ENG,Home,After 1965
JE Root,ENG,Spin,2024-08-29,Lord's,England,2024,2,13,42,0,1,342,540,5,329,498,5,68.4,>30,ENG,Home,After 1965
JE Root,ENG,Spin,2024-09-06,The Oval,England,2024,1,11,12,0,1,123,161,3,112,149,3,41.0,>30,ENG,Home,After 1965
JE Root,ENG,Spin,2024-10-07,Multan,Pakistan,2024,1,25,42,1,1,918,1193,16,893,1151,15,57.375,>30,PAK,Away,After 1965
JE Root,ENG,Spin,2024-10-15,Multan,Pakistan,2024,2,37,60,0,1,831,1418,37,794,1358,37,22.45945945945946,<=30,PAK,Away,After 1965
JE Root,ENG,Spin,2024-10-24,Rawalpindi,Pakistan,2024,1,8,18,0,1,719,1161,29,711,1143,29,24.79310344827586,<=30,PAK,Away,After 1965
JE Root,ENG,Spin,2024-12-14,Hamilton,New Zealand,2024,1,17,6,1,1,463,592,15,446,586,14,30.866666666666667,>30,NZ,Away,After 1965
JE Taylor,WI,Pace,2003-06-20,Gros Islet,West Indies,2003,2,116,198,0,1,539,1047,9,423,849,9,59.888888888888886,>30,WI,Home,Upto 2014
JE Taylor,WI,Pace,2003-06-27,Kingston,West Indies,2003,2,78,126,2,1,610,1045,26,532,919,24,23.46153846153846,<=30,WI,Home,Upto 2014
JE Taylor,WI,Pace,2003-11-04,Harare,Zimbabwe,2003,1,32,58,1,1,904,1627,24,872,1569,23,37.666666666666664,>30,ZIM,Away,Upto 2014
JE Taylor,WI,Pace,2006-03-09,Auckland,New Zealand,2006,2,45,54,1,1,867,1612,27,822,1558,26,32.111111111111114,>30,NZ,Away,Upto 2014
JE Taylor,WI,Pace,2006-06-10,Gros Islet,West Indies,2006,1,88,146,1,1,597,938,8,509,792,7,74.625,>30,WI,Home,Upto 2014
JE Taylor,WI,Pace,2006-06-22,Basseterre,West Indies,2006,2,158,222,4,1,636,1116,17,478,894,13,37.411764705882355,>30,WI,Home,Upto 2014
JE Taylor,WI,Pace,2006-06-30,Kingston,West Indies,2006,2,95,202,9,1,405,1019,25,310,817,16,16.2,<=30,WI,Home,Upto 2014
JE Taylor,WI,Pace,2006-11-11,Lahore,Pakistan,2006,1,115,198,4,1,669,1208,21,554,1010,17,31.857142857142858,>30,PAK,Away,Upto 2014
JE Taylor,WI,Pace,2006-11-19,Multan,Pakistan,2006,2,166,306,7,1,741,1564,16,575,1258,9,46.3125,>30,PAK,Away,Upto 2014
JE Taylor,WI,Pace,2006-11-27,Karachi,Pakistan,2006,2,136,276,2,1,841,1655,23,705,1379,21,36.56521739130435,>30,PAK,Away,Upto 2014
JE Taylor,WI,Pace,2007-05-17,Lord's,England,2007,2,135,168,1,1,1013,1620,14,878,1452,13,72.35714285714286,>30,ENG,Away,Upto 2014
JE Taylor,WI,Pace,2007-05-25,Leeds,England,2007,1,116,132,1,1,714,1084,23,598,952,22,31.043478260869566,>30,ENG,Away,Upto 2014
JE Taylor,WI,Pace,2007-06-07,Manchester,England,2007,2,109,180,2,1,901,1654,29,792,1474,27,31.06896551724138,>30,ENG,Away,Upto 2014
JE Taylor,WI,Pace,2007-12-26,Gqeberha,South Africa,2007,2,112,186,6,1,900,1655,32,788,1469,26,28.125,<=30,SA,Away,Upto 2014
JE Taylor,WI,Pace,2008-01-02,Cape Town,South Africa,2008,2,82,162,2,1,787,1720,28,705,1558,26,28.107142857142858,<=30,SA,Away,Upto 2014
JE Taylor,WI,Pace,2008-01-10,Durban,South Africa,2008,1,92,150,1,1,883,1304,22,791,1154,21,40.13636363636363,>30,SA,Away,Upto 2014
JE Taylor,WI,Pace,2008-03-22,Providence,West Indies,2008,2,147,246,5,1,635,1249,22,488,1003,17,28.863636363636363,<=30,WI,Home,Upto 2014
JE Taylor,WI,Pace,2008-04-03,Port of Spain,West Indies,2008,2,126,195,6,1,851,1278,24,725,1083,18,35.458333333333336,>30,WI,Home,Upto 2014
JE Taylor,WI,Pace,2008-05-30,North Sound,West Indies,2008,2,128,234,5,1,984,1871,24,856,1637,19,41.0,>30,WI,Home,Upto 2014
JE Taylor,WI,Pace,2008-06-12,Bridgetown,West Indies,2008,2,110,204,3,1,809,1396,25,699,1192,22,32.36,>30,WI,Home,Upto 2014
JE Taylor,WI,Pace,2008-12-11,Dunedin,New Zealand,2008,1,61,138,1,1,619,1080,13,558,942,12,47.61538461538461,>30,NZ,Away,Upto 2014
JE Taylor,WI,Pace,2008-12-19,Napier,New Zealand,2008,2,143,216,4,1,774,1324,23,631,1108,19,33.65217391304348,>30,NZ,Away,Upto 2014
JE Taylor,WI,Pace,2009-02-04,Kingston,West Indies,2009,2,85,174,8,1,444,1066,20,359,892,12,22.2,<=30,WI,Home,Upto 2014
JE Taylor,WI,Pace,2009-02-13,North Sound,West Indies,2009,1,5,6,0,1,7,10,0,2,4,0,inf,>30,WI,Home,Upto 2014
JE Taylor,WI,Pace,2009-02-15,St John's,West Indies,2009,2,107,222,2,1,803,1574,19,696,1352,17,42.26315789473684,>30,WI,Home,Upto 2014
JE Taylor,WI,Pace,2009-02-26,Bridgetown,West Indies,2009,2,122,200,1,1,977,1508,9,855,1308,8,108.55555555555556,>30,WI,Home,Upto 2014
JE Taylor,WI,Pace,2009-05-06,Lord's,England,2009,2,103,162,2,1,625,1023,22,522,861,20,28.40909090909091,<=30,ENG,Away,Upto 2014
JE Taylor,WI,Pace,2009-05-14,Chester-le-Street,England,2009,1,68,120,0,1,746,1203,21,678,1083,21,35.523809523809526,>30,ENG,Away,Upto 2014
JE Taylor,WI,Pace,2009-11-26,Brisbane,Australia,2009,1,43,54,1,1,697,1123,21,654,1069,20,33.19047619047619,>30,AUS,Away,Upto 2014
JE Taylor,WI,Pace,2014-06-08,Kingston,West Indies,2014,2,65,228,4,1,334,854,13,269,626,9,25.692307692307693,<=30,WI,Home,After 1965
JE Taylor,WI,Pace,2014-06-16,Port of Spain,West Indies,2014,2,107,282,6,1,611,1256,20,504,974,14,30.55,>30,WI,Home,After 1965
JE Taylor,WI,Pace,2014-06-26,Bridgetown,West Indies,2014,2,109,162,1,1,620,1276,27,511,1114,26,22.962962962962962,<=30,WI,Home,After 1965
JE Taylor,WI,Pace,2014-09-05,Kingstown,West Indies,2014,2,110,195,2,1,442,907,11,332,712,9,40.18181818181818,>30,WI,Home,After 1965
JE Taylor,WI,Pace,2014-09-13,Gros Islet,West Indies,2014,2,80,192,5,1,563,1240,21,483,1048,16,26.80952380952381,<=30,WI,Home,After 1965
JE Taylor,WI,Pace,2014-12-17,Centurion,South Africa,2014,1,108,157,0,1,587,1007,20,479,850,20,29.35,<=30,SA,Away,After 1965
JE Taylor,WI,Pace,2014-12-26,Gqeberha,South Africa,2014,1,114,180,2,1,464,870,12,350,690,10,38.666666666666664,>30,SA,Away,After 1965
JE Taylor,WI,Pace,2015-01-02,Cape Town,South Africa,2015,2,100,162,1,1,670,1234,16,570,1072,15,41.875,>30,SA,Away,After 1965
JE Taylor,WI,Pace,2015-04-13,North Sound,West Indies,2015,2,132,204,5,1,886,1696,22,754,1492,17,40.27272727272727,>30,WI,Home,After 1965
JE Taylor,WI,Pace,2015-05-01,Bridgetown,West Indies,2015,2,69,178,6,1,388,896,26,319,718,20,14.923076923076923,<=30,WI,Home,After 1965
JE Taylor,WI,Pace,2015-06-03,Roseau,West Indies,2015,2,94,138,2,1,402,941,20,308,803,18,20.1,<=30,WI,Home,After 1965
JE Taylor,WI,Pace,2015-06-11,Kingston,West Indies,2015,2,71,210,6,1,528,1091,25,457,881,19,21.12,<=30,WI,Home,After 1965
JE Taylor,WI,Pace,2015-10-14,Galle,Sri Lanka,2015,1,65,120,2,1,384,801,11,319,681,9,34.90909090909091,>30,SL,Away,After 1965
JE Taylor,WI,Pace,2015-10-22,Colombo (PSS),Sri Lanka,2015,2,76,138,4,1,259,558,12,183,420,8,21.583333333333332,<=30,SL,Away,After 1965
JE Taylor,WI,Pace,2015-12-10,Hobart,Australia,2015,1,108,102,0,1,634,903,16,526,801,16,39.625,>30,AUS,Away,After 1965
JE Taylor,WI,Pace,2015-12-26,Melbourne,Australia,2015,2,122,150,2,1,837,1482,18,715,1332,16,46.5,>30,AUS,Away,After 1965
JE Taylor,WI,Pace,2016-01-03,Sydney,Australia,2016,1,27,24,0,1,234,354,3,207,330,3,78.0,>30,AUS,Away,After 1965
JEC Franklin,NZ,Pace,2001-03-08,Auckland,New Zealand,2001,2,114,234,2,1,702,1474,24,588,1240,22,29.25,<=30,NZ,Home,Upto 2014
JEC Franklin,NZ,Pace,2001-03-27,Hamilton,New Zealand,2001,2,36,95,5,1,506,942,23,470,847,18,22.0,<=30,NZ,Home,Upto 2014
JEC Franklin,NZ,Pace,2004-06-10,Nottingham,England,2004,2,163,259,6,1,1015,1836,30,852,1577,24,33.833333333333336,>30,ENG,Away,Upto 2014
JEC Franklin,NZ,Pace,2004-10-19,Dhaka,Bangladesh,2004,2,42,132,5,1,301,659,9,259,527,4,33.44444444444444,>30,BAN,Away,Upto 2014
JEC Franklin,NZ,Pace,2004-10-26,Chattogram,Bangladesh,2004,2,33,78,2,1,237,372,3,204,294,1,79.0,>30,BAN,Away,Upto 2014
JEC Franklin,NZ,Pace,2004-11-26,Adelaide,Australia,2004,2,120,132,0,1,602,1087,15,482,955,15,40.13333333333333,>30,AUS,Away,Upto 2014
JEC Franklin,NZ,Pace,2005-03-10,Christchurch,New Zealand,2005,2,128,186,2,1,768,1398,17,640,1212,15,45.1764705882353,>30,NZ,Home,Upto 2014
JEC Franklin,NZ,Pace,2005-03-18,Wellington,New Zealand,2005,1,128,168,4,1,569,942,15,441,774,11,37.93333333333333,>30,NZ,Home,Upto 2014
JEC Franklin,NZ,Pace,2005-03-26,Auckland,New Zealand,2005,2,159,199,6,1,759,1379,20,600,1180,14,37.95,>30,NZ,Home,Upto 2014
JEC Franklin,NZ,Pace,2005-04-04,Napier,New Zealand,2005,2,132,196,4,1,832,1538,21,700,1342,17,39.61904761904762,>30,NZ,Home,Upto 2014
JEC Franklin,NZ,Pace,2005-04-11,Wellington,New Zealand,2005,2,122,209,5,1,716,1428,28,594,1219,23,25.571428571428573,<=30,NZ,Home,Upto 2014
JEC Franklin,NZ,Pace,2005-08-07,Harare,Zimbabwe,2005,2,30,90,5,1,432,774,20,402,684,15,21.6,<=30,ZIM,Away,Upto 2014
JEC Franklin,NZ,Pace,2005-08-15,Bulawayo,Zimbabwe,2005,2,67,132,1,1,584,919,19,517,787,18,30.736842105263158,>30,ZIM,Away,Upto 2014
JEC Franklin,NZ,Pace,2006-03-09,Auckland,New Zealand,2006,2,129,210,1,1,867,1612,27,738,1402,26,32.111111111111114,>30,NZ,Home,Upto 2014
JEC Franklin,NZ,Pace,2006-03-17,Wellington,New Zealand,2006,2,117,246,7,1,633,1165,28,516,919,21,22.607142857142858,<=30,NZ,Home,Upto 2014
JEC Franklin,NZ,Pace,2006-03-25,Napier,New Zealand,2006,1,66,90,0,1,242,421,3,176,331,3,80.66666666666667,>30,NZ,Home,Upto 2014
JEC Franklin,NZ,Pace,2006-04-15,Centurion,South Africa,2006,2,135,192,6,1,858,1550,38,723,1358,32,22.57894736842105,<=30,SA,Away,Upto 2014
JEC Franklin,NZ,Pace,2006-04-27,Cape Town,South Africa,2006,1,95,198,3,1,739,1386,13,644,1188,10,56.84615384615385,>30,SA,Away,Upto 2014
JEC Franklin,NZ,Pace,2006-05-05,Johannesburg,South Africa,2006,2,154,159,6,1,757,1280,36,603,1121,30,21.02777777777778,<=30,SA,Away,Upto 2014
JEC Franklin,NZ,Pace,2006-12-07,Christchurch,New Zealand,2006,2,64,150,5,1,515,1047,25,451,897,20,20.6,<=30,NZ,Home,Upto 2014
JEC Franklin,NZ,Pace,2006-12-15,Wellington,New Zealand,2006,2,109,222,1,1,700,1140,20,591,918,19,35.0,>30,NZ,Home,Upto 2014
JEC Franklin,NZ,Pace,2008-12-11,Dunedin,New Zealand,2008,1,61,90,0,1,619,1080,13,558,990,13,47.61538461538461,>30,NZ,Home,Upto 2014
JEC Franklin,NZ,Pace,2008-12-19,Napier,New Zealand,2008,2,118,198,3,1,774,1324,23,656,1126,20,33.65217391304348,>30,NZ,Home,Upto 2014
JEC Franklin,NZ,Pace,2009-03-18,Hamilton,New Zealand,2009,1,98,138,0,1,743,1246,14,645,1108,14,53.07142857142857,>30,NZ,Home,Upto 2014
JEC Franklin,NZ,Pace,2009-03-26,Napier,New Zealand,2009,2,82,216,0,1,682,1265,13,600,1049,13,52.46153846153846,>30,NZ,Home,Upto 2014
JEC Franklin,NZ,Pace,2009-04-03,Wellington,New Zealand,2009,2,110,180,1,1,869,1366,23,759,1186,22,37.78260869565217,>30,NZ,Home,Upto 2014
JEC Franklin,NZ,Pace,2011-01-15,Wellington,New Zealand,2011,2,36,84,0,1,781,1511,23,745,1427,23,33.95652173913044,>30,NZ,Home,Upto 2014
JEC Franklin,NZ,Pace,2012-08-23,Hyderabad,India,2012,1,40,80,0,1,403,771,7,363,691,7,57.57142857142857,>30,IND,Away,Upto 2014
JEC Franklin,NZ,Pace,2012-08-31,Bengaluru,India,2012,1,17,60,0,1,733,1159,18,716,1099,18,40.72222222222222,>30,IND,Away,Upto 2014
JEC Franklin,NZ,Pace,2012-11-17,Galle,Sri Lanka,2012,2,31,60,1,1,371,706,14,340,646,13,26.5,<=30,SL,Away,Upto 2014
JEC Franklin,NZ,Pace,2013-01-02,Cape Town,South Africa,2013,1,50,84,1,1,547,1103,26,497,1019,25,21.03846153846154,<=30,SA,Away,Upto 2014
JED Sealy,WI,Pace,1931-01-16,Brisbane,Australia,1931,1,32,18,0,1,443,984,16,411,966,16,27.6875,<=30,AUS,Away,Upto 2014
JED Sealy,WI,Pace,1935-01-24,Port of Spain,West Indies,1935,2,23,66,2,1,486,1307,22,463,1241,20,22.09090909090909,<=30,WI,Home,Upto 2014
JED Sealy,WI,Pace,1935-02-14,Georgetown,West Indies,1935,1,12,36,0,1,273,866,12,261,830,12,22.75,<=30,WI,Home,Upto 2014
JED Sealy,WI,Pace,1935-03-14,Kingston,West Indies,1935,1,6,12,1,1,412,902,15,406,890,14,27.466666666666665,<=30,WI,Home,Upto 2014
JED Sealy,WI,Pace,1939-06-24,Lord's,England,1939,1,21,24,0,1,652,1327,16,631,1303,16,40.75,>30,ENG,Away,Upto 2014
JER Gallian,ENG,Pace,1995-08-24,The Oval,England,1995,1,56,72,0,1,1059,1992,20,1003,1920,20,52.95,>30,ENG,Home,Upto 2014
JER Gallian,ENG,Pace,1995-12-26,Gqeberha,South Africa,1995,1,6,12,0,1,681,1783,21,675,1771,21,32.42857142857143,>30,SA,Away,Upto 2014
JF Reid,NZ,Spin,1984-12-10,Karachi,Pakistan,1984,1,7,12,0,1,562,1340,12,555,1328,12,46.833333333333336,>30,PAK,Away,Upto 2014
JF Reid,NZ,Spin,1986-02-28,Christchurch,New Zealand,1986,1,0,6,0,1,196,528,6,196,522,6,32.666666666666664,>30,NZ,Home,Upto 2014
JF du Toit,SA,Pace,1892-03-19,Cape Town,South Africa,1892,1,47,85,1,1,379,805,14,332,720,13,27.071428571428573,<=30,SA,Home,After 1965
JFM Morrison,NZ,Spin,1976-10-30,Karachi,Pakistan,1976,2,9,24,0,1,499,1183,10,490,1159,10,49.9,>30,PAK,Away,Upto 2014
JFM Morrison,NZ,Spin,1982-03-12,Auckland,New Zealand,1982,1,52,210,2,1,260,652,9,208,442,7,28.88888888888889,<=30,NZ,Home,Upto 2014
JFM Morrison,NZ,Spin,1982-03-19,Christchurch,New Zealand,1982,2,10,30,0,1,110,255,7,100,225,7,15.714285714285714,<=30,NZ,Home,Upto 2014
JFW Nicolson,SA,Spin,1928-01-21,Durban,South Africa,1928,1,5,12,0,1,719,1581,22,714,1569,22,32.68181818181818,>30,SA,Home,Upto 2014
JFW Nicolson,SA,Spin,1928-02-04,Durban,South Africa,1928,1,12,12,0,1,423,969,13,411,957,13,32.53846153846154,>30,SA,Home,Upto 2014
JG Bethell,ENG,Spin,2024-11-28,Christchurch,New Zealand,2024,1,5,6,0,1,459,659,17,454,653,17,27.0,<=30,NZ,Away,After 1965
JG Bethell,ENG,Spin,2024-12-14,Hamilton,New Zealand,2024,1,72,86,3,1,463,592,15,391,506,12,30.866666666666667,>30,NZ,Away,After 1965
JG Bracewell,NZ,Spin,1980-11-28,Brisbane,Australia,1980,2,63,138,1,1,141,265,5,78,127,4,28.2,<=30,AUS,Away,Upto 2014
JG Bracewell,NZ,Spin,1980-12-12,W.A.C.A,Australia,1980,2,31,54,0,1,69,132,4,38,78,4,17.25,<=30,AUS,Away,Upto 2014
JG Bracewell,NZ,Spin,1980-12-26,Melbourne,Australia,1980,2,60,144,1,1,182,426,4,122,282,3,45.5,>30,AUS,Away,Upto 2014
JG Bracewell,NZ,Spin,1981-03-13,Auckland,New Zealand,1981,2,136,501,9,1,519,1803,22,383,1302,13,23.59090909090909,<=30,NZ,Home,Upto 2014
JG Bracewell,NZ,Spin,1983-07-14,The Oval,England,1983,2,131,372,4,1,330,901,10,199,529,6,33.0,>30,ENG,Away,Upto 2014
JG Bracewell,NZ,Spin,1983-07-28,Leeds,England,1983,1,8,6,0,1,109,276,1,101,270,1,109.0,>30,ENG,Away,Upto 2014
JG Bracewell,NZ,Spin,1983-08-11,Lord's,England,1983,1,29,66,0,1,227,566,11,198,500,11,20.636363636363637,<=30,ENG,Away,Upto 2014
JG Bracewell,NZ,Spin,1983-08-25,Nottingham,England,1983,2,196,294,6,1,432,966,18,236,672,12,24.0,<=30,ENG,Away,Upto 2014
JG Bracewell,NZ,Spin,1984-03-09,Kandy,Sri Lanka,1984,2,90,132,3,1,410,807,17,320,675,14,24.11764705882353,<=30,SL,Away,Upto 2014
JG Bracewell,NZ,Spin,1984-03-24,Colombo (CCC),Sri Lanka,1984,2,66,120,1,1,342,828,8,276,708,7,42.75,>30,SL,Away,Upto 2014
JG Bracewell,NZ,Spin,1984-11-25,Hyderabad (Sind),Pakistan,1984,2,80,181,3,1,706,1491,27,626,1310,24,26.14814814814815,<=30,PAK,Away,Upto 2014
JG Bracewell,NZ,Spin,1984-12-10,Karachi,Pakistan,1984,2,137,318,1,1,562,1340,12,425,1022,11,46.833333333333336,>30,PAK,Away,Upto 2014
JG Bracewell,NZ,Spin,1985-05-04,Kingston,West Indies,1985,2,68,150,1,1,118,270,2,50,120,1,59.0,>30,WI,Away,Upto 2014
JG Bracewell,NZ,Spin,1985-11-22,Sydney,Australia,1985,2,142,330,5,1,694,1882,25,552,1552,20,27.76,<=30,AUS,Away,Upto 2014
JG Bracewell,NZ,Spin,1985-11-30,W.A.C.A,Australia,1985,2,53,209,2,1,164,587,6,111,378,4,27.333333333333332,<=30,AUS,Away,Upto 2014
JG Bracewell,NZ,Spin,1986-02-28,Christchurch,New Zealand,1986,2,123,360,5,1,196,528,6,73,168,1,32.666666666666664,>30,NZ,Home,Upto 2014
JG Bracewell,NZ,Spin,1986-03-13,Auckland,New Zealand,1986,2,106,393,10,1,300,1053,17,194,660,7,17.647058823529413,<=30,NZ,Home,Upto 2014
JG Bracewell,NZ,Spin,1986-07-24,Lord's,England,1986,2,122,298,3,1,350,940,10,228,642,7,35.0,>30,ENG,Away,Upto 2014
JG Bracewell,NZ,Spin,1986-08-07,Nottingham,England,1986,2,40,90,3,1,295,797,10,255,707,7,29.5,<=30,ENG,Away,Upto 2014
JG Bracewell,NZ,Spin,1986-08-21,The Oval,England,1986,1,51,66,0,1,193,510,3,142,444,3,64.33333333333333,>30,ENG,Away,Upto 2014
JG Bracewell,NZ,Spin,1987-02-20,Wellington,New Zealand,1987,2,60,126,1,1,313,876,9,253,750,8,34.77777777777778,>30,NZ,Home,Upto 2014
JG Bracewell,NZ,Spin,1987-02-27,Auckland,New Zealand,1987,1,53,102,0,1,278,540,5,225,438,5,55.6,>30,NZ,Home,Upto 2014
JG Bracewell,NZ,Spin,1987-03-12,Christchurch,New Zealand,1987,1,34,42,0,1,79,120,0,45,78,0,inf,>30,NZ,Home,Upto 2014
JG Bracewell,NZ,Spin,1987-04-16,Colombo (CCC),Sri Lanka,1987,1,98,282,2,1,223,696,4,125,414,2,55.75,>30,SL,Away,Upto 2014
JG Bracewell,NZ,Spin,1987-12-04,Brisbane,Australia,1987,2,90,227,3,1,142,366,3,52,139,0,47.333333333333336,>30,AUS,Away,Upto 2014
JG Bracewell,NZ,Spin,1987-12-11,Adelaide,Australia,1987,1,122,288,2,1,613,1530,11,491,1242,9,55.72727272727273,>30,AUS,Away,Upto 2014
JG Bracewell,NZ,Spin,1987-12-26,Melbourne,Australia,1987,2,127,336,3,1,311,684,6,184,348,3,51.833333333333336,>30,AUS,Away,Upto 2014
JG Bracewell,NZ,Spin,1988-02-12,Christchurch,New Zealand,1988,1,16,36,0,1,34,120,0,18,84,0,inf,>30,NZ,Home,Upto 2014
JG Bracewell,NZ,Spin,1988-02-25,Auckland,New Zealand,1988,1,88,234,3,1,207,678,5,119,444,2,41.4,>30,NZ,Home,Upto 2014
JG Bracewell,NZ,Spin,1988-03-03,Wellington,New Zealand,1988,1,44,138,0,1,303,839,2,259,701,2,151.5,>30,NZ,Home,Upto 2014
JG Bracewell,NZ,Spin,1988-11-12,Bengaluru,India,1988,2,114,192,0,1,620,1702,21,506,1510,21,29.523809523809526,<=30,IND,Away,Upto 2014
JG Bracewell,NZ,Spin,1988-11-24,Wankhede,India,1988,2,132,232,8,1,479,1162,25,347,930,17,19.16,<=30,IND,Away,Upto 2014
JG Bracewell,NZ,Spin,1988-12-02,Hyderabad (Deccan),India,1988,1,86,108,0,1,319,748,13,233,640,13,24.53846153846154,<=30,IND,Away,Upto 2014
JG Bracewell,NZ,Spin,1989-02-10,Wellington,New Zealand,1989,1,123,240,1,1,272,570,2,149,330,1,136.0,>30,NZ,Home,Upto 2014
JG Bracewell,NZ,Spin,1989-02-24,Auckland,New Zealand,1989,1,138,222,1,1,705,1609,10,567,1387,9,70.5,>30,NZ,Home,Upto 2014
JG Bracewell,NZ,Spin,1990-02-02,Christchurch,New Zealand,1990,2,59,138,2,1,205,522,7,146,384,5,29.285714285714285,<=30,NZ,Home,Upto 2014
JG Bracewell,NZ,Spin,1990-02-09,Napier,New Zealand,1990,1,50,132,0,1,117,306,0,67,174,0,inf,>30,NZ,Home,Upto 2014
JG Bracewell,NZ,Spin,1990-03-15,Wellington,New Zealand,1990,2,87,218,6,1,227,624,10,140,406,4,22.7,<=30,NZ,Home,Upto 2014
JG Bracewell,NZ,Spin,1990-06-07,Nottingham,England,1990,1,75,210,2,1,148,408,4,73,198,2,37.0,>30,ENG,Away,Upto 2014
JG Bracewell,NZ,Spin,1990-06-21,Lord's,England,1990,2,157,330,4,1,264,588,7,107,258,3,37.714285714285715,>30,ENG,Away,Upto 2014
JG Bracewell,NZ,Spin,1990-07-05,Birmingham,England,1990,2,168,348,6,1,288,747,13,120,399,7,22.153846153846153,<=30,ENG,Away,Upto 2014
JG Thomas,ENG,Pace,1986-02-21,Kingston,West Indies,1986,2,86,179,2,1,543,1027,29,457,848,27,18.724137931034484,<=30,WI,Away,Upto 2014
JG Thomas,ENG,Pace,1986-03-07,Port of Spain,West Indies,1986,2,107,150,2,1,694,1180,22,587,1030,20,31.545454545454547,>30,WI,Away,Upto 2014
JG Thomas,ENG,Pace,1986-03-21,Bridgetown,West Indies,1986,1,70,97,4,1,585,983,28,515,886,24,20.892857142857142,<=30,WI,Away,Upto 2014
JG Thomas,ENG,Pace,1986-04-03,Port of Spain,West Indies,1986,1,101,90,0,1,614,1036,27,513,946,27,22.74074074074074,<=30,WI,Away,Upto 2014
JG Thomas,ENG,Pace,1986-08-07,Nottingham,England,1986,2,140,258,2,1,656,1476,21,516,1218,19,31.238095238095237,>30,ENG,Home,Upto 2014
JG Wright,NZ,Pace,1982-03-19,Christchurch,New Zealand,1982,1,2,6,0,1,665,1336,24,663,1330,24,27.708333333333332,<=30,NZ,Home,Upto 2014
JG Wright,NZ,Pace,1984-12-10,Karachi,Pakistan,1984,1,1,6,0,1,473,890,12,472,884,12,39.416666666666664,>30,PAK,Away,Upto 2014
JG Wright,NZ,Pace,1985-04-06,Georgetown,West Indies,1985,1,2,18,0,1,825,1600,20,823,1582,20,41.25,>30,WI,Away,Upto 2014
JH Cameron,WI,Spin,1939-06-24,Lord's,England,1939,1,66,208,3,1,311,784,11,245,576,8,28.272727272727273,<=30,ENG,Away,Upto 2014
JH Cameron,WI,Spin,1939-07-22,Manchester,England,1939,1,22,24,0,1,184,368,9,162,344,9,20.444444444444443,<=30,ENG,Away,Upto 2014
JH Childs,ENG,Spin,1988-06-30,Manchester,England,1988,1,91,240,1,1,153,408,1,62,168,0,153.0,>30,ENG,Home,Upto 2014
JH Childs,ENG,Spin,1988-08-04,The Oval,England,1988,2,92,276,2,1,151,444,7,59,168,5,21.571428571428573,<=30,ENG,Home,Upto 2014
JH Edrich,ENG,Pace,1964-02-15,Kanpur,India,1964,1,17,24,0,1,118,235,3,101,211,3,39.333333333333336,>30,IND,Away,Upto 2014
JH Edrich,ENG,Pace,1966-03-04,Dunedin,New Zealand,1966,1,6,6,0,1,364,1194,18,358,1188,18,20.22222222222222,<=30,NZ,Away,Upto 2014
JH Kallis,ICC,Pace,2005-10-14,Sydney,Australia,2005,2,38,60,1,1,422,699,17,384,639,16,24.823529411764707,<=30,AUS,Away,Upto 2014
JH Kallis,SA,Pace,1996-01-02,Cape Town,South Africa,1996,1,2,24,0,1,418,1109,22,416,1085,22,19.0,<=30,SA,Home,Upto 2014
JH Kallis,SA,Pace,1997-02-28,Johannesburg,South Africa,1997,1,54,126,1,1,660,1282,14,606,1156,13,47.142857142857146,>30,SA,Home,Upto 2014
JH Kallis,SA,Pace,1997-03-14,Gqeberha,South Africa,1997,2,47,154,4,1,528,1387,24,481,1233,20,22.0,<=30,SA,Home,Upto 2014
JH Kallis,SA,Pace,1997-03-21,Centurion,South Africa,1997,2,33,72,0,1,500,1229,28,467,1157,28,17.857142857142858,<=30,SA,Home,Upto 2014
JH Kallis,SA,Pace,1997-10-06,Rawalpindi,Pakistan,1997,2,36,88,2,1,556,1227,14,520,1139,12,39.714285714285715,>30,PAK,Away,Upto 2014
JH Kallis,SA,Pace,1997-12-26,Melbourne,Australia,1997,1,5,24,0,1,627,1621,23,622,1597,23,27.26086956521739,<=30,AUS,Away,Upto 2014
JH Kallis,SA,Pace,1998-01-02,Sydney,Australia,1998,1,30,48,0,1,405,1054,13,375,1006,13,31.153846153846153,>30,AUS,Away,Upto 2014
JH Kallis,SA,Pace,1998-01-30,Adelaide,Australia,1998,2,65,204,2,1,879,2002,24,814,1798,22,36.625,>30,AUS,Away,Upto 2014
JH Kallis,SA,Pace,1998-02-14,Johannesburg,South Africa,1998,1,58,108,2,1,551,982,15,493,874,13,36.733333333333334,>30,SA,Home,Upto 2014
JH Kallis,SA,Pace,1998-02-26,Durban,South Africa,1998,1,46,102,0,1,733,1519,29,687,1417,29,25.275862068965516,<=30,SA,Home,Upto 2014
JH Kallis,SA,Pace,1998-03-19,Cape Town,South Africa,1998,2,68,132,1,1,757,1378,22,689,1246,21,34.40909090909091,>30,SA,Home,Upto 2014
JH Kallis,SA,Pace,1998-03-27,Centurion,South Africa,1998,2,54,156,1,1,463,1134,19,409,978,18,24.36842105263158,<=30,SA,Home,Upto 2014
JH Kallis,SA,Pace,1998-06-04,Birmingham,England,1998,1,46,120,0,1,706,1575,23,660,1455,23,30.695652173913043,>30,ENG,Away,Upto 2014
JH Kallis,SA,Pace,1998-06-18,Lord's,England,1998,2,32,144,5,1,618,1463,26,586,1319,21,23.76923076923077,<=30,ENG,Away,Upto 2014
JH Kallis,SA,Pace,1998-07-02,Manchester,England,1998,2,81,295,4,1,671,1668,18,590,1373,14,37.27777777777778,>30,ENG,Away,Upto 2014
JH Kallis,SA,Pace,1998-07-23,Nottingham,England,1998,2,86,246,2,1,995,2152,32,909,1906,30,31.09375,>30,ENG,Away,Upto 2014
JH Kallis,SA,Pace,1998-08-06,Leeds,England,1998,2,61,144,0,1,826,2084,40,765,1940,40,20.65,<=30,ENG,Away,Upto 2014
JH Kallis,SA,Pace,1998-11-26,Johannesburg,South Africa,1998,2,63,174,2,1,642,1519,31,579,1345,29,20.70967741935484,<=30,SA,Home,Upto 2014
JH Kallis,SA,Pace,1998-12-10,Gqeberha,South Africa,1998,2,25,54,1,1,639,1208,36,614,1154,35,17.75,<=30,SA,Home,Upto 2014
JH Kallis,SA,Pace,1998-12-26,Durban,South Africa,1998,2,49,120,4,1,645,1347,28,596,1227,24,23.035714285714285,<=30,SA,Home,Upto 2014
JH Kallis,SA,Pace,1999-01-02,Cape Town,South Africa,1999,2,124,256,7,1,785,1771,27,661,1515,20,29.074074074074073,<=30,SA,Home,Upto 2014
JH Kallis,SA,Pace,1999-01-15,Centurion,South Africa,1999,2,38,91,3,1,776,1416,26,738,1325,23,29.846153846153847,<=30,SA,Home,Upto 2014
JH Kallis,SA,Pace,1999-02-27,Auckland,New Zealand,1999,2,105,208,1,1,841,1949,13,736,1741,12,64.6923076923077,>30,NZ,Away,Upto 2014
JH Kallis,SA,Pace,1999-03-11,Christchurch,New Zealand,1999,2,34,66,1,1,581,1404,8,547,1338,7,72.625,>30,NZ,Away,Upto 2014
JH Kallis,SA,Pace,1999-03-18,Wellington,New Zealand,1999,2,94,234,1,1,742,1762,20,648,1528,19,37.1,>30,NZ,Away,Upto 2014
JH Kallis,SA,Pace,1999-10-29,Bloemfontein,South Africa,1999,2,112,228,7,1,728,1549,24,616,1321,17,30.333333333333332,>30,SA,Home,Upto 2014
JH Kallis,SA,Pace,1999-12-09,Gqeberha,South Africa,1999,1,22,42,2,1,939,2119,25,917,2077,23,37.56,>30,SA,Home,Upto 2014
JH Kallis,SA,Pace,1999-12-26,Durban,South Africa,1999,1,38,138,0,1,784,1865,22,746,1727,22,35.63636363636363,>30,SA,Home,Upto 2014
JH Kallis,SA,Pace,2000-01-02,Cape Town,South Africa,2000,2,80,176,3,1,594,1440,24,514,1264,21,24.75,<=30,SA,Home,Upto 2014
JH Kallis,SA,Pace,2000-01-14,Centurion,South Africa,2000,1,44,78,0,1,437,835,14,393,757,14,31.214285714285715,>30,SA,Home,Upto 2014
JH Kallis,SA,Pace,2000-02-24,Wankhede,India,2000,2,51,126,3,1,367,874,21,316,748,18,17.476190476190474,<=30,IND,Away,Upto 2014
JH Kallis,SA,Pace,2000-03-02,Bengaluru,India,2000,2,28,90,2,1,357,999,12,329,909,10,29.75,<=30,IND,Away,Upto 2014
JH Kallis,SA,Pace,2000-07-20,Galle,Sri Lanka,2000,1,41,102,1,1,282,658,5,241,556,4,56.4,>30,SL,Away,Upto 2014
JH Kallis,SA,Pace,2000-07-30,Kandy,Sri Lanka,2000,2,43,118,3,1,362,832,17,319,714,14,21.294117647058822,<=30,SL,Away,Upto 2014
JH Kallis,SA,Pace,2000-08-06,Colombo (SSC),Sri Lanka,2000,2,52,102,0,1,430,969,14,378,867,14,30.714285714285715,>30,SL,Away,Upto 2014
JH Kallis,SA,Pace,2000-11-17,Bloemfontein,South Africa,2000,2,118,216,2,1,906,1955,31,788,1739,29,29.225806451612904,<=30,SA,Home,Upto 2014
JH Kallis,SA,Pace,2000-11-30,Gqeberha,South Africa,2000,2,61,168,1,1,698,1864,30,637,1696,29,23.266666666666666,<=30,SA,Home,Upto 2014
JH Kallis,SA,Pace,2000-12-08,Johannesburg,South Africa,2000,1,26,95,2,1,417,1127,13,391,1032,11,32.07692307692308,>30,SA,Home,Upto 2014
JH Kallis,SA,Pace,2000-12-26,Durban,South Africa,2000,2,31,90,0,1,618,1336,17,587,1246,17,36.35294117647059,>30,SA,Home,Upto 2014
JH Kallis,SA,Pace,2001-01-02,Cape Town,South Africa,2001,2,48,78,1,1,537,948,18,489,870,17,29.833333333333332,<=30,SA,Home,Upto 2014
JH Kallis,SA,Pace,2001-01-20,Centurion,South Africa,2001,2,54,114,3,1,628,1061,26,574,947,23,24.153846153846153,<=30,SA,Home,Upto 2014
JH Kallis,SA,Pace,2001-03-09,Georgetown,West Indies,2001,2,69,192,2,1,709,1722,18,640,1530,16,39.388888888888886,>30,WI,Away,Upto 2014
JH Kallis,SA,Pace,2001-03-17,Port of Spain,West Indies,2001,2,84,222,4,1,814,1972,34,730,1750,30,23.941176470588236,<=30,WI,Away,Upto 2014
JH Kallis,SA,Pace,2001-03-29,Bridgetown,West Indies,2001,2,101,264,8,1,750,1752,22,649,1488,14,34.09090909090909,>30,WI,Away,Upto 2014
JH Kallis,SA,Pace,2001-04-06,St John's,West Indies,2001,2,47,196,4,1,374,1261,23,327,1065,19,16.26086956521739,<=30,WI,Away,Upto 2014
JH Kallis,SA,Pace,2001-04-19,Kingston,West Indies,2001,2,94,264,2,1,641,1770,33,547,1506,31,19.424242424242426,<=30,WI,Away,Upto 2014
JH Kallis,SA,Pace,2001-09-07,Harare,Zimbabwe,2001,2,91,198,3,1,919,1718,19,828,1520,16,48.36842105263158,>30,ZIM,Away,Upto 2014
JH Kallis,SA,Pace,2001-11-03,Bloemfontein,South Africa,2001,2,143,222,3,1,966,1509,27,823,1287,24,35.77777777777778,>30,SA,Home,Upto 2014
JH Kallis,SA,Pace,2001-11-16,Gqeberha,South Africa,2001,2,65,128,2,1,644,1436,22,579,1308,20,29.272727272727273,<=30,SA,Home,Upto 2014
JH Kallis,SA,Pace,2001-12-14,Adelaide,Australia,2001,2,82,186,3,1,773,1644,20,691,1458,17,38.65,>30,AUS,Away,Upto 2014
JH Kallis,SA,Pace,2001-12-26,Melbourne,Australia,2001,1,55,102,0,1,710,1446,22,655,1344,22,32.27272727272727,>30,AUS,Away,Upto 2014
JH Kallis,SA,Pace,2002-01-02,Sydney,Australia,2002,1,129,132,1,1,596,1002,11,467,870,10,54.18181818181818,>30,AUS,Away,Upto 2014
JH Kallis,SA,Pace,2002-02-22,Johannesburg,South Africa,2002,1,116,144,2,1,698,1059,20,582,915,18,34.9,>30,SA,Home,Upto 2014
JH Kallis,SA,Pace,2002-03-08,Cape Town,South Africa,2002,2,133,198,4,1,927,1517,20,794,1319,16,46.35,>30,SA,Home,Upto 2014
JH Kallis,SA,Pace,2002-03-15,Durban,South Africa,2002,2,124,186,5,1,733,1239,21,609,1053,16,34.904761904761905,>30,SA,Home,Upto 2014
JH Kallis,SA,Pace,2002-10-18,East London,South Africa,2002,2,48,108,0,1,686,1167,21,638,1059,21,32.666666666666664,>30,SA,Home,Upto 2014
JH Kallis,SA,Pace,2002-10-25,Potchefstroom,South Africa,2002,2,47,105,7,1,588,1047,21,541,942,14,28.0,<=30,SA,Home,Upto 2014
JH Kallis,SA,Pace,2002-11-08,Johannesburg,South Africa,2002,2,75,168,3,1,582,1139,26,507,971,23,22.384615384615383,<=30,SA,Home,Upto 2014
JH Kallis,SA,Pace,2002-11-15,Centurion,South Africa,2002,2,110,181,7,1,905,1840,32,795,1659,25,28.28125,<=30,SA,Home,Upto 2014
JH Kallis,SA,Pace,2002-12-26,Durban,South Africa,2002,2,52,138,2,1,631,1153,23,579,1015,21,27.434782608695652,<=30,SA,Home,Upto 2014
JH Kallis,SA,Pace,2003-01-02,Cape Town,South Africa,2003,2,69,108,1,1,694,1175,21,625,1067,20,33.04761904761905,>30,SA,Home,Upto 2014
JH Kallis,SA,Pace,2003-08-14,Nottingham,England,2003,2,128,222,2,1,935,1991,38,807,1769,36,24.605263157894736,<=30,ENG,Away,Upto 2014
JH Kallis,SA,Pace,2003-08-21,Leeds,England,2003,2,92,223,9,1,1130,2145,39,1038,1922,30,28.974358974358974,<=30,ENG,Away,Upto 2014
JH Kallis,SA,Pace,2003-09-04,The Oval,England,2003,2,142,236,3,1,1075,1870,24,933,1634,21,44.791666666666664,>30,ENG,Away,Upto 2014
JH Kallis,SA,Pace,2003-10-17,Lahore,Pakistan,2003,2,67,144,0,1,569,1080,10,502,936,10,56.9,>30,PAK,Away,Upto 2014
JH Kallis,SA,Pace,2003-10-24,Faisalabad,Pakistan,2003,2,108,246,2,1,604,1451,24,496,1205,22,25.166666666666668,<=30,PAK,Away,Upto 2014
JH Kallis,SA,Pace,2003-12-12,Johannesburg,South Africa,2003,2,74,156,1,1,1112,2121,34,1038,1965,33,32.705882352941174,>30,SA,Home,Upto 2014
JH Kallis,SA,Pace,2003-12-26,Durban,South Africa,2003,2,50,90,1,1,1030,1831,26,980,1741,25,39.61538461538461,>30,SA,Home,Upto 2014
JH Kallis,SA,Pace,2004-01-02,Cape Town,South Africa,2004,2,102,222,1,1,1140,1873,23,1038,1651,22,49.56521739130435,>30,SA,Home,Upto 2014
JH Kallis,SA,Pace,2004-01-16,Centurion,South Africa,2004,2,95,168,2,1,1068,1800,24,973,1632,22,44.5,>30,SA,Home,Upto 2014
JH Kallis,SA,Pace,2004-03-10,Hamilton,New Zealand,2004,1,71,156,3,1,760,1661,15,689,1505,12,50.666666666666664,>30,NZ,Away,Upto 2014
JH Kallis,SA,Pace,2004-03-18,Auckland,New Zealand,2004,1,108,138,1,1,1016,1973,29,908,1835,28,35.03448275862069,>30,NZ,Away,Upto 2014
JH Kallis,SA,Pace,2004-03-26,Wellington,New Zealand,2004,1,4,42,1,1,820,1651,25,816,1609,24,32.8,>30,NZ,Away,Upto 2014
JH Kallis,SA,Pace,2004-08-04,Galle,Sri Lanka,2004,2,74,144,0,1,548,1192,14,474,1048,14,39.142857142857146,>30,SL,Away,Upto 2014
JH Kallis,SA,Pace,2004-08-11,Colombo (SSC),Sri Lanka,2004,2,60,138,3,1,548,1014,21,488,876,18,26.095238095238095,<=30,SL,Away,Upto 2014
JH Kallis,SA,Pace,2004-12-26,Durban,South Africa,2004,2,67,192,1,1,968,1978,29,901,1786,28,33.37931034482759,>30,SA,Home,Upto 2014
JH Kallis,SA,Pace,2005-01-02,Cape Town,South Africa,2005,2,55,102,0,1,830,1832,29,775,1730,29,28.620689655172413,<=30,SA,Home,Upto 2014
JH Kallis,SA,Pace,2005-01-13,Johannesburg,South Africa,2005,2,172,258,3,1,1212,2062,34,1040,1804,31,35.64705882352941,>30,SA,Home,Upto 2014
JH Kallis,SA,Pace,2005-01-21,Centurion,South Africa,2005,2,9,24,0,1,788,1589,28,779,1565,28,28.142857142857142,<=30,SA,Home,Upto 2014
JH Kallis,SA,Pace,2005-03-04,Cape Town,South Africa,2005,2,53,149,5,1,443,710,15,390,561,10,29.533333333333335,<=30,SA,Home,Upto 2014
JH Kallis,SA,Pace,2005-03-11,Centurion,South Africa,2005,2,53,150,6,1,611,1095,23,558,945,17,26.565217391304348,<=30,SA,Home,Upto 2014
JH Kallis,SA,Pace,2005-03-31,Georgetown,West Indies,2005,1,70,84,0,1,687,1530,15,617,1446,15,45.8,>30,WI,Away,Upto 2014
JH Kallis,SA,Pace,2005-04-08,Port of Spain,West Indies,2005,2,70,144,0,1,854,1820,25,784,1676,25,34.16,>30,WI,Away,Upto 2014
JH Kallis,SA,Pace,2005-04-21,Bridgetown,West Indies,2005,2,44,120,2,1,712,1449,24,668,1329,22,29.666666666666668,<=30,WI,Away,Upto 2014
JH Kallis,SA,Pace,2005-04-29,St John's,West Indies,2005,1,96,216,0,1,1036,1736,12,940,1520,12,86.33333333333333,>30,WI,Away,Upto 2014
JH Kallis,SA,Pace,2005-12-26,Melbourne,Australia,2005,2,127,197,3,1,712,1466,23,585,1269,20,30.956521739130434,>30,AUS,Away,Upto 2014
JH Kallis,SA,Pace,2006-01-02,Sydney,Australia,2006,2,33,102,2,1,752,1301,17,719,1199,15,44.23529411764706,>30,AUS,Away,Upto 2014
JH Kallis,SA,Pace,2006-03-16,Cape Town,South Africa,2006,1,51,72,3,1,563,1099,28,512,1027,25,20.107142857142858,<=30,SA,Home,Upto 2014
JH Kallis,SA,Pace,2006-03-24,Durban,South Africa,2006,2,92,175,2,1,838,1637,23,746,1462,21,36.43478260869565,>30,SA,Home,Upto 2014
JH Kallis,SA,Pace,2006-03-31,Johannesburg,South Africa,2006,2,87,168,2,1,824,1490,30,737,1322,28,27.466666666666665,<=30,SA,Home,Upto 2014
JH Kallis,SA,Pace,2006-04-15,Centurion,South Africa,2006,1,41,54,1,1,858,1550,38,817,1496,37,22.57894736842105,<=30,SA,Home,Upto 2014
JH Kallis,SA,Pace,2006-04-27,Cape Town,South Africa,2006,2,50,120,1,1,739,1386,13,689,1266,12,56.84615384615385,>30,SA,Home,Upto 2014
JH Kallis,SA,Pace,2006-05-05,Johannesburg,South Africa,2006,1,40,84,2,1,757,1280,36,717,1196,34,21.02777777777778,<=30,SA,Home,Upto 2014
JH Kallis,SA,Pace,2006-12-15,Johannesburg,South Africa,2006,2,97,156,2,1,728,1389,33,631,1233,31,22.060606060606062,<=30,SA,Home,Upto 2014
JH Kallis,SA,Pace,2007-01-02,Cape Town,South Africa,2007,2,67,144,1,1,634,1285,20,567,1141,19,31.7,>30,SA,Home,Upto 2014
JH Kallis,SA,Pace,2007-01-11,Centurion,South Africa,2007,2,99,186,3,1,894,1492,25,795,1306,22,35.76,>30,SA,Home,Upto 2014
JH Kallis,SA,Pace,2007-01-19,Gqeberha,South Africa,2007,2,73,114,1,1,653,1296,27,580,1182,26,24.185185185185187,<=30,SA,Home,Upto 2014
JH Kallis,SA,Pace,2007-01-26,Cape Town,South Africa,2007,2,78,108,6,1,527,865,27,449,757,21,19.51851851851852,<=30,SA,Home,Upto 2014
JH Kallis,SA,Pace,2007-10-01,Karachi,Pakistan,2007,2,25,90,1,1,523,1031,16,498,941,15,32.6875,>30,PAK,Away,Upto 2014
JH Kallis,SA,Pace,2007-10-08,Lahore,Pakistan,2007,2,55,132,2,1,635,1158,14,580,1026,12,45.357142857142854,>30,PAK,Away,Upto 2014
JH Kallis,SA,Pace,2007-11-08,Johannesburg,South Africa,2007,2,26,42,3,1,740,1372,29,714,1330,26,25.517241379310345,<=30,SA,Home,Upto 2014
JH Kallis,SA,Pace,2007-11-16,Centurion,South Africa,2007,2,53,96,2,1,609,994,26,556,898,24,23.423076923076923,<=30,SA,Home,Upto 2014
JH Kallis,SA,Pace,2007-12-26,Gqeberha,South Africa,2007,2,39,144,1,1,900,1655,32,861,1511,31,28.125,<=30,SA,Home,Upto 2014
JH Kallis,SA,Pace,2008-01-02,Cape Town,South Africa,2008,2,45,168,2,1,787,1720,28,742,1552,26,28.107142857142858,<=30,SA,Home,Upto 2014
JH Kallis,SA,Pace,2008-01-10,Durban,South Africa,2008,2,18,60,0,1,883,1304,22,865,1244,22,40.13636363636363,>30,SA,Home,Upto 2014
JH Kallis,SA,Pace,2008-02-22,Mirpur,Bangladesh,2008,2,35,114,5,1,379,784,18,344,670,13,21.055555555555557,<=30,BAN,Away,Upto 2014
JH Kallis,SA,Pace,2008-02-29,Chattogram,Bangladesh,2008,2,28,72,0,1,376,687,12,348,615,12,31.333333333333332,>30,BAN,Away,Upto 2014
JH Kallis,SA,Pace,2008-03-26,Chennai,India,2008,1,71,84,0,1,691,1044,8,620,960,8,86.375,>30,IND,Away,Upto 2014
JH Kallis,SA,Pace,2008-04-03,Ahmedabad,India,2008,1,26,60,1,1,574,946,21,548,886,20,27.333333333333332,<=30,IND,Away,Upto 2014
JH Kallis,SA,Pace,2008-04-11,Kanpur,India,2008,1,23,54,0,1,346,693,14,323,639,14,24.714285714285715,<=30,IND,Away,Upto 2014
JH Kallis,SA,Pace,2008-07-10,Lord's,England,2008,1,70,120,0,1,845,1704,13,775,1584,13,65.0,>30,ENG,Away,Upto 2014
JH Kallis,SA,Pace,2008-07-18,Leeds,England,2008,2,74,150,3,1,905,1732,27,831,1582,24,33.51851851851852,>30,ENG,Away,Upto 2014
JH Kallis,SA,Pace,2008-07-30,Birmingham,England,2008,2,90,210,4,1,903,1618,29,813,1408,25,31.137931034482758,>30,ENG,Away,Upto 2014
JH Kallis,SA,Pace,2008-08-07,The Oval,England,2008,2,61,96,3,1,862,1540,26,801,1444,23,33.15384615384615,>30,ENG,Away,Upto 2014
JH Kallis,SA,Pace,2008-11-19,Bloemfontein,South Africa,2008,2,27,57,4,1,387,770,21,360,713,17,18.428571428571427,<=30,SA,Home,Upto 2014
JH Kallis,SA,Pace,2008-11-26,Centurion,South Africa,2008,2,54,108,1,1,529,990,19,475,882,18,27.842105263157894,<=30,SA,Home,Upto 2014
JH Kallis,SA,Pace,2008-12-17,W.A.C.A,Australia,2008,2,89,174,3,1,940,1782,28,851,1608,25,33.57142857142857,>30,AUS,Away,Upto 2014
JH Kallis,SA,Pace,2008-12-26,Melbourne,Australia,2008,2,112,196,3,1,952,1716,26,840,1520,23,36.61538461538461,>30,AUS,Away,Upto 2014
JH Kallis,SA,Pace,2009-01-03,Sydney,Australia,2009,2,67,180,1,1,952,2011,26,885,1831,25,36.61538461538461,>30,AUS,Away,Upto 2014
JH Kallis,SA,Pace,2009-02-26,Johannesburg,South Africa,2009,2,55,78,3,1,938,1937,36,883,1859,33,26.055555555555557,<=30,SA,Home,Upto 2014
JH Kallis,SA,Pace,2009-03-06,Durban,South Africa,2009,2,70,138,3,1,857,1739,26,787,1601,23,32.96153846153846,>30,SA,Home,Upto 2014
JH Kallis,SA,Pace,2009-03-19,Cape Town,South Africa,2009,2,52,120,0,1,890,1587,18,838,1467,18,49.44444444444444,>30,SA,Home,Upto 2014
JH Kallis,SA,Pace,2009-12-16,Centurion,South Africa,2009,1,5,18,0,1,848,1757,22,843,1739,22,38.54545454545455,>30,SA,Home,Upto 2014
JH Kallis,SA,Pace,2009-12-26,Durban,South Africa,2009,1,43,84,0,1,616,1251,15,573,1167,15,41.06666666666667,>30,SA,Home,Upto 2014
JH Kallis,SA,Pace,2010-01-03,Cape Town,South Africa,2010,2,55,168,1,1,868,1767,26,813,1599,25,33.38461538461539,>30,SA,Home,Upto 2014
JH Kallis,SA,Pace,2010-01-14,Johannesburg,South Africa,2010,1,40,60,1,1,644,1109,23,604,1049,22,28.0,<=30,SA,Home,Upto 2014
JH Kallis,SA,Pace,2010-02-06,Nagpur,India,2010,2,33,108,1,1,534,1007,19,501,899,18,28.105263157894736,<=30,IND,Away,Upto 2014
JH Kallis,SA,Pace,2010-02-14,Eden Gardens,India,2010,1,40,72,0,1,646,954,10,606,882,10,64.6,>30,IND,Away,Upto 2014
JH Kallis,SA,Pace,2010-06-10,Port of Spain,West Indies,2010,2,55,103,2,1,433,932,18,378,829,16,24.055555555555557,<=30,WI,Away,Upto 2014
JH Kallis,SA,Pace,2010-06-18,Basseterre,West Indies,2010,1,65,138,1,1,644,1267,9,579,1129,8,71.55555555555556,>30,WI,Away,Upto 2014
JH Kallis,SA,Pace,2010-06-26,Bridgetown,West Indies,2010,2,46,96,2,1,416,803,18,370,707,16,23.11111111111111,<=30,WI,Away,Upto 2014
JH Kallis,SA,Pace,2010-11-12,Dubai (DICS),UAE,2010,2,26,72,0,1,500,966,12,474,894,12,41.666666666666664,>30,UAE,Away,Upto 2014
JH Kallis,SA,Pace,2010-11-20,Abu Dhabi,UAE,2010,2,90,138,1,1,798,1290,13,708,1152,12,61.38461538461539,>30,UAE,Away,Upto 2014
JH Kallis,SA,Pace,2010-12-16,Centurion,South Africa,2010,2,76,114,2,1,795,1278,19,719,1164,17,41.8421052631579,>30,SA,Home,Upto 2014
JH Kallis,SA,Pace,2010-12-26,Durban,South Africa,2010,2,48,126,1,1,613,1119,31,565,993,30,19.774193548387096,<=30,SA,Home,Upto 2014
JH Kallis,SA,Pace,2011-11-09,Cape Town,South Africa,2011,1,37,36,0,1,597,929,31,560,893,31,19.258064516129032,<=30,SA,Home,Upto 2014
JH Kallis,SA,Pace,2011-11-17,Johannesburg,South Africa,2011,2,84,132,1,1,938,1680,27,854,1548,26,34.74074074074074,>30,SA,Home,Upto 2014
JH Kallis,SA,Pace,2011-12-15,Centurion,South Africa,2011,2,44,78,0,1,635,1013,25,591,935,25,25.4,<=30,SA,Home,Upto 2014
JH Kallis,SA,Pace,2011-12-26,Durban,South Africa,2011,2,67,120,0,1,674,1304,26,607,1184,26,25.923076923076923,<=30,SA,Home,Upto 2014
JH Kallis,SA,Pace,2012-01-03,Cape Town,South Africa,2012,1,35,89,3,1,828,1318,18,793,1229,15,46.0,>30,SA,Home,Upto 2014
JH Kallis,SA,Pace,2012-03-07,Dunedin,New Zealand,2012,2,27,72,1,1,860,1498,21,833,1426,20,40.95238095238095,>30,NZ,Away,Upto 2014
JH Kallis,SA,Pace,2012-03-15,Hamilton,New Zealand,2012,2,20,90,1,1,549,1079,27,529,989,26,20.333333333333332,<=30,NZ,Away,Upto 2014
JH Kallis,SA,Pace,2012-07-19,The Oval,England,2012,2,60,156,2,1,900,1787,18,840,1631,16,50.0,>30,ENG,Away,Upto 2014
JH Kallis,SA,Pace,2012-08-02,Leeds,England,2012,2,41,96,1,1,982,1920,23,941,1824,22,42.69565217391305,>30,ENG,Away,Upto 2014
JH Kallis,SA,Pace,2012-08-16,Lord's,England,2012,2,79,138,1,1,927,1840,33,848,1702,32,28.09090909090909,<=30,ENG,Away,Upto 2014
JH Kallis,SA,Pace,2012-11-09,Brisbane,Australia,2012,1,30,72,0,1,917,1756,14,887,1684,14,65.5,>30,AUS,Away,Upto 2014
JH Kallis,SA,Pace,2012-11-22,Adelaide,Australia,2012,1,19,21,2,1,863,1649,28,844,1628,26,30.821428571428573,>30,AUS,Away,Upto 2014
JH Kallis,SA,Pace,2013-01-02,Cape Town,South Africa,2013,1,31,67,2,1,547,1103,26,516,1036,24,21.03846153846154,<=30,SA,Home,Upto 2014
JH Kallis,SA,Pace,2013-01-11,Gqeberha,South Africa,2013,2,18,60,1,1,619,1262,23,601,1202,22,26.91304347826087,<=30,SA,Home,Upto 2014
JH Kallis,SA,Pace,2013-02-01,Johannesburg,South Africa,2013,2,46,126,3,1,592,1253,26,546,1127,23,22.76923076923077,<=30,SA,Home,Upto 2014
JH Kallis,SA,Pace,2013-02-14,Cape Town,South Africa,2013,2,60,152,0,1,620,1269,20,560,1117,20,31.0,>30,SA,Home,Upto 2014
JH Kallis,SA,Pace,2013-10-14,Abu Dhabi,UAE,2013,1,44,78,0,1,476,1024,18,432,946,18,26.444444444444443,<=30,UAE,Away,Upto 2014
JH Kallis,SA,Pace,2013-10-23,Dubai (DICS),UAE,2013,1,9,42,0,1,404,958,9,395,916,9,44.888888888888886,>30,UAE,Away,Upto 2014
JH Kallis,SA,Pace,2013-12-18,Johannesburg,South Africa,2013,2,105,204,4,1,1012,2037,30,907,1833,26,33.733333333333334,>30,SA,Home,Upto 2014
JH Kallis,SA,Pace,2013-12-26,Durban,South Africa,2013,1,36,66,0,1,714,1389,18,678,1323,18,39.666666666666664,>30,SA,Home,Upto 2014
JH King,ENG,Pace,1909-06-14,Lord's,England,1909,1,99,162,1,1,465,1001,12,366,839,11,38.75,>30,ENG,Home,Upto 2014
JH Parks,ENG,Spin,1937-06-26,Lord's,England,1937,2,36,126,3,1,512,1098,11,476,972,8,46.54545454545455,>30,ENG,Home,Upto 2014
JH Sinclair,SA,Pace,1896-02-13,Gqeberha,South Africa,1896,2,102,180,4,1,376,688,29,274,508,25,12.96551724137931,<=30,SA,Home,After 1965
JH Sinclair,SA,Pace,1896-03-02,Johannesburg,South Africa,1896,1,118,175,4,1,539,922,24,421,747,20,22.458333333333332,<=30,SA,Home,After 1965
JH Sinclair,SA,Pace,1896-03-21,Cape Town,South Africa,1896,1,23,35,0,1,245,540,16,222,505,16,15.3125,<=30,SA,Home,After 1965
JH Sinclair,SA,Pace,1899-04-01,Cape Town,South Africa,1899,2,89,217,9,1,255,526,19,166,309,10,13.421052631578947,<=30,SA,Home,After 1965
JH Sinclair,SA,Pace,1902-10-11,Johannesburg,South Africa,1902,2,244,258,5,1,545,690,15,301,432,10,36.333333333333336,>30,SA,Home,Upto 2014
JH Sinclair,SA,Pace,1902-10-18,Johannesburg,South Africa,1902,2,148,180,3,1,466,648,16,318,468,13,29.125,<=30,SA,Home,Upto 2014
JH Sinclair,SA,Pace,1902-11-08,Cape Town,South Africa,1902,2,77,84,1,1,317,563,15,240,479,14,21.133333333333333,<=30,SA,Home,Upto 2014
JH Sinclair,SA,Pace,1906-01-02,Johannesburg,South Africa,1906,2,61,96,2,1,225,553,14,164,457,12,16.071428571428573,<=30,SA,Home,Upto 2014
JH Sinclair,SA,Pace,1906-03-06,Johannesburg,South Africa,1906,2,71,282,5,1,275,764,15,204,482,10,18.333333333333332,<=30,SA,Home,Upto 2014
JH Sinclair,SA,Pace,1906-03-10,Johannesburg,South Africa,1906,2,113,174,2,1,542,1143,25,429,969,23,21.68,<=30,SA,Home,Upto 2014
JH Sinclair,SA,Pace,1906-03-24,Cape Town,South Africa,1906,2,108,319,7,1,316,931,16,208,612,9,19.75,<=30,SA,Home,Upto 2014
JH Sinclair,SA,Pace,1906-03-30,Cape Town,South Africa,1906,2,65,194,5,1,242,576,14,177,382,9,17.285714285714285,<=30,SA,Home,Upto 2014
JH Sinclair,SA,Pace,1907-07-01,Lord's,England,1907,1,22,36,0,1,214,540,7,192,504,7,30.571428571428573,>30,ENG,Away,Upto 2014
JH Sinclair,SA,Pace,1907-07-29,Leeds,England,1907,2,36,87,3,1,113,315,7,77,228,4,16.142857142857142,<=30,ENG,Away,Upto 2014
JH Sinclair,SA,Pace,1907-08-19,The Oval,England,1907,1,27,84,1,1,261,564,14,234,480,13,18.642857142857142,<=30,ENG,Away,Upto 2014
JH Sinclair,SA,Pace,1910-01-01,Johannesburg,South Africa,1910,1,10,24,0,1,440,846,11,430,822,11,40.0,>30,SA,Home,Upto 2014
JH Sinclair,SA,Pace,1910-01-21,Durban,South Africa,1910,2,50,126,2,1,379,1058,15,329,932,13,25.266666666666666,<=30,SA,Home,Upto 2014
JH Sinclair,SA,Pace,1910-03-07,Cape Town,South Africa,1910,2,57,114,2,1,321,621,18,264,507,16,17.833333333333332,<=30,SA,Home,Upto 2014
JH Sinclair,SA,Pace,1910-03-11,Cape Town,South Africa,1910,1,36,48,0,1,301,570,12,265,522,12,25.083333333333332,<=30,SA,Home,Upto 2014
JH Sinclair,SA,Pace,1910-12-09,Sydney,Australia,1910,1,80,118,1,1,517,899,22,437,781,21,23.5,<=30,AUS,Away,Upto 2014
JH Sinclair,SA,Pace,1910-12-31,Melbourne,Australia,1910,2,85,126,1,1,540,1002,17,455,876,16,31.764705882352942,>30,AUS,Away,Upto 2014
JH Sinclair,SA,Pace,1911-01-07,Adelaide,Australia,1911,2,158,281,4,1,771,1501,18,613,1220,14,42.833333333333336,>30,AUS,Away,Upto 2014
JH Sinclair,SA,Pace,1911-02-17,Melbourne,Australia,1911,2,111,162,0,1,399,623,10,288,461,10,39.9,>30,AUS,Away,Upto 2014
JH Sinclair,SA,Pace,1911-03-03,Sydney,Australia,1911,2,105,198,2,1,447,806,13,342,608,11,34.38461538461539,>30,AUS,Away,Upto 2014
JH Wardle,ENG,Spin,1948-02-11,Port of Spain,West Indies,1948,1,9,18,0,1,644,1409,17,635,1391,17,37.88235294117647,>30,WI,Away,Upto 2014
JH Wardle,ENG,Spin,1950-06-24,Lord's,England,1950,2,104,282,2,1,844,2771,30,740,2489,28,28.133333333333333,<=30,ENG,Home,Upto 2014
JH Wardle,ENG,Spin,1951-06-07,Nottingham,England,1951,2,81,318,1,1,552,1676,17,471,1358,16,32.470588235294116,>30,ENG,Home,Upto 2014
JH Wardle,ENG,Spin,1951-06-21,Lord's,England,1951,2,90,257,4,1,361,954,17,271,697,13,21.235294117647058,<=30,ENG,Home,Upto 2014
JH Wardle,ENG,Spin,1953-06-11,Nottingham,England,1953,2,79,282,1,1,277,894,8,198,612,7,34.625,>30,ENG,Home,Upto 2014
JH Wardle,ENG,Spin,1953-06-25,Lord's,England,1953,2,188,450,5,1,753,1644,18,565,1194,13,41.833333333333336,>30,ENG,Home,Upto 2014
JH Wardle,ENG,Spin,1953-07-09,Manchester,England,1953,2,77,201,7,1,250,603,14,173,402,7,17.857142857142858,<=30,ENG,Home,Upto 2014
JH Wardle,ENG,Spin,1954-02-24,Georgetown,West Indies,1954,2,84,207,3,1,666,2079,21,582,1872,18,31.714285714285715,>30,WI,Away,Upto 2014
JH Wardle,ENG,Spin,1954-03-30,Kingston,West Indies,1954,2,103,294,1,1,581,1630,14,478,1336,13,41.5,>30,WI,Away,Upto 2014
JH Wardle,ENG,Spin,1954-06-10,Lord's,England,1954,2,39,233,4,1,153,655,8,114,422,4,19.125,<=30,ENG,Home,Upto 2014
JH Wardle,ENG,Spin,1954-07-01,Nottingham,England,1954,2,53,228,4,1,279,522,7,226,294,3,39.857142857142854,>30,ENG,Home,Upto 2014
JH Wardle,ENG,Spin,1954-07-22,Manchester,England,1954,2,28,186,5,1,192,600,11,164,414,6,17.454545454545453,<=30,ENG,Home,Upto 2014
JH Wardle,ENG,Spin,1954-08-12,The Oval,England,1954,1,56,210,7,1,187,540,10,131,330,3,18.7,<=30,ENG,Home,Upto 2014
JH Wardle,ENG,Spin,1954-12-17,Sydney,Australia,1954,1,11,32,0,1,179,446,7,168,414,7,25.571428571428573,<=30,AUS,Away,Upto 2014
JH Wardle,ENG,Spin,1954-12-31,Melbourne,Australia,1954,2,21,56,1,1,232,621,10,211,565,9,23.2,<=30,AUS,Away,Upto 2014
JH Wardle,ENG,Spin,1955-01-28,Adelaide,Australia,1955,2,67,186,1,1,330,1112,11,263,926,10,30.0,<=30,AUS,Away,Upto 2014
JH Wardle,ENG,Spin,1955-02-25,Sydney,Australia,1955,2,130,292,8,1,313,666,14,183,374,6,22.357142857142858,<=30,AUS,Away,Upto 2014
JH Wardle,ENG,Spin,1955-03-11,Dunedin,New Zealand,1955,2,72,243,3,1,162,483,7,90,240,4,23.142857142857142,<=30,NZ,Away,Upto 2014
JH Wardle,ENG,Spin,1955-03-25,Auckland,New Zealand,1955,2,44,216,2,1,138,529,7,94,313,5,19.714285714285715,<=30,NZ,Away,Upto 2014
JH Wardle,ENG,Spin,1955-06-09,Nottingham,England,1955,2,57,366,5,1,185,768,8,128,402,3,23.125,<=30,ENG,Home,Upto 2014
JH Wardle,ENG,Spin,1955-06-23,Lord's,England,1955,2,83,232,6,1,220,561,12,137,329,6,18.333333333333332,<=30,ENG,Home,Upto 2014
JH Wardle,ENG,Spin,1955-07-21,Leeds,England,1955,2,133,396,4,1,458,1267,15,325,871,11,30.533333333333335,>30,ENG,Home,Upto 2014
JH Wardle,ENG,Spin,1956-06-21,Lord's,England,1956,2,59,162,1,1,172,625,7,113,463,6,24.571428571428573,<=30,ENG,Home,Upto 2014
JH Wardle,ENG,Spin,1956-12-24,Johannesburg,South Africa,1956,2,70,184,3,1,201,734,9,131,550,6,22.333333333333332,<=30,SA,Away,Upto 2014
JH Wardle,ENG,Spin,1957-01-01,Cape Town,South Africa,1957,2,89,342,12,1,343,1239,21,254,897,9,16.333333333333332,<=30,SA,Away,Upto 2014
JH Wardle,ENG,Spin,1957-01-25,Durban,South Africa,1957,2,103,322,7,1,361,1289,21,258,967,14,17.19047619047619,<=30,SA,Away,Upto 2014
JH Wardle,ENG,Spin,1957-02-15,Johannesburg,South Africa,1957,2,97,270,4,1,404,1102,19,307,832,15,21.263157894736842,<=30,SA,Away,Upto 2014
JH Wardle,ENG,Spin,1957-06-20,Lord's,England,1957,1,53,132,1,1,343,654,7,290,522,6,49.0,>30,ENG,Home,Upto 2014
JH du Preez,SA,Spin,1967-02-03,Johannesburg,South Africa,1967,1,22,84,2,1,91,210,4,69,126,2,22.75,<=30,SA,Home,Upto 2014
JH du Preez,SA,Spin,1967-02-24,Gqeberha,South Africa,1967,2,29,60,1,1,222,502,6,193,442,5,37.0,>30,SA,Home,Upto 2014
JJ Bumrah,IND,Pace,2018-01-05,Cape Town,South Africa,2018,2,112,182,4,1,684,1276,37,572,1094,33,18.486486486486488,<=30,SA,Away,After 1965
JJ Bumrah,IND,Pace,2018-01-13,Centurion,South Africa,2018,2,130,252,3,1,739,1521,29,609,1269,26,25.482758620689655,<=30,SA,Away,After 1965
JJ Bumrah,IND,Pace,2018-01-24,Johannesburg,South Africa,2018,2,111,239,7,1,749,1777,40,638,1538,33,18.725,<=30,SA,Away,After 1965
JJ Bumrah,IND,Pace,2018-08-18,Nottingham,England,2018,2,122,248,7,1,905,1711,32,783,1463,25,28.28125,<=30,ENG,Away,After 1965
JJ Bumrah,IND,Pace,2018-08-30,Southampton,England,2018,2,97,234,4,1,624,1317,26,527,1083,22,24.0,<=30,ENG,Away,After 1965
JJ Bumrah,IND,Pace,2018-09-07,The Oval,England,2018,2,144,318,3,1,781,1629,21,637,1311,18,37.19047619047619,>30,ENG,Away,After 1965
JJ Bumrah,IND,Pace,2018-12-06,Adelaide,Australia,2018,2,115,288,6,1,635,1467,25,520,1179,19,25.4,<=30,AUS,Away,After 1965
JJ Bumrah,IND,Pace,2018-12-14,Perth,Australia,2018,2,92,308,5,1,753,1685,30,661,1377,25,25.1,<=30,AUS,Away,After 1965
JJ Bumrah,IND,Pace,2018-12-26,Melbourne,Australia,2018,2,86,209,9,1,621,1425,29,535,1216,20,21.413793103448278,<=30,AUS,Away,After 1965
JJ Bumrah,IND,Pace,2019-01-03,Sydney,Australia,2019,2,64,138,1,1,459,804,6,395,666,5,76.5,>30,AUS,Away,After 1965
JJ Bumrah,IND,Pace,2019-08-22,North Sound,West Indies,2019,2,62,156,6,1,576,1302,29,514,1146,23,19.862068965517242,<=30,WI,Away,After 1965
JJ Bumrah,IND,Pace,2019-08-30,Kingston,West Indies,2019,2,58,139,7,1,512,1121,25,454,982,18,20.48,<=30,WI,Away,After 1965
JJ Bumrah,IND,Pace,2020-02-21,Wellington,New Zealand,2020,2,89,160,1,1,586,1297,26,497,1137,25,22.53846153846154,<=30,NZ,Away,After 1965
JJ Bumrah,IND,Pace,2020-02-29,Christchurch,New Zealand,2020,2,101,210,5,1,623,1219,30,522,1009,25,20.766666666666666,<=30,NZ,Away,After 1965
JJ Bumrah,IND,Pace,2020-12-17,Adelaide,Australia,2020,2,79,168,2,1,408,970,22,329,802,20,18.545454545454547,<=30,AUS,Away,After 1965
JJ Bumrah,IND,Pace,2020-12-26,Melbourne,Australia,2020,2,110,258,6,1,523,1170,20,413,912,14,26.15,<=30,AUS,Away,After 1965
JJ Bumrah,IND,Pace,2021-01-07,Sydney,Australia,2021,2,134,280,3,1,762,1640,19,628,1360,16,40.10526315789474,>30,AUS,Away,After 1965
JJ Bumrah,IND,Pace,2021-02-05,Chennai,India,2021,2,110,252,4,1,376,864,16,266,612,12,23.5,<=30,IND,Home,After 1965
JJ Bumrah,IND,Pace,2021-02-24,Ahmedabad,India,2021,1,19,36,0,1,124,228,2,105,192,2,62.0,>30,IND,Home,After 1965
JJ Bumrah,IND,Pace,2021-06-18,Southampton,England,2021,2,92,220,0,1,643,1620,27,551,1400,27,23.814814814814813,<=30,ENG,Away,After 1965
JJ Bumrah,IND,Pace,2021-08-04,Nottingham,England,2021,2,110,238,9,1,737,1406,30,627,1168,21,24.566666666666666,<=30,ENG,Away,After 1965
JJ Bumrah,IND,Pace,2021-08-12,Lord's,England,2021,2,112,246,3,1,917,2031,34,805,1785,31,26.970588235294116,<=30,ENG,Away,After 1965
JJ Bumrah,IND,Pace,2021-08-25,Leeds,England,2021,1,59,164,2,1,610,1311,27,551,1147,25,22.59259259259259,<=30,ENG,Away,After 1965
JJ Bumrah,IND,Pace,2021-09-02,The Oval,England,2021,2,94,258,4,1,900,1837,30,806,1579,26,30.0,<=30,ENG,Away,After 1965
JJ Bumrah,IND,Pace,2021-12-26,Centurion,South Africa,2021,2,66,158,5,1,741,1479,38,675,1321,33,19.5,<=30,SA,Away,After 1965
JJ Bumrah,IND,Pace,2022-01-03,Johannesburg,South Africa,2022,2,119,228,1,1,818,1482,32,699,1254,31,25.5625,<=30,SA,Away,After 1965
JJ Bumrah,IND,Pace,2022-01-11,Cape Town,South Africa,2022,2,96,243,6,1,686,1515,32,590,1272,26,21.4375,<=30,SA,Away,After 1965
JJ Bumrah,IND,Pace,2022-03-04,Mohali,India,2022,2,43,108,2,1,395,599,10,352,491,8,39.5,>30,IND,Home,After 1965
JJ Bumrah,IND,Pace,2022-03-12,Bengaluru,India,2022,2,47,114,8,1,203,372,12,156,258,4,16.916666666666668,<=30,IND,Home,After 1965
JJ Bumrah,IND,Pace,2022-07-01,Birmingham,England,2022,2,142,216,5,1,1049,1525,30,907,1309,25,34.96666666666667,>30,ENG,Away,After 1965
JJ Bumrah,IND,Pace,2023-12-26,Centurion,South Africa,2023,1,69,160,4,1,718,1149,27,649,989,23,26.59259259259259,<=30,SA,Away,After 1965
JJ Bumrah,IND,Pace,2024-01-03,Cape Town,South Africa,2024,2,86,131,8,1,441,642,32,355,511,24,13.78125,<=30,SA,Away,After 1965
JJ Bumrah,IND,Pace,2024-01-25,Hyderabad,India,2024,2,69,148,6,1,181,364,6,112,216,0,30.166666666666668,>30,IND,Home,After 1965
JJ Bumrah,IND,Pace,2024-02-02,Visakhapatnam,India,2024,2,91,199,9,1,237,481,15,146,282,6,15.8,<=30,IND,Home,After 1965
JJ Bumrah,IND,Pace,2024-02-15,Rajkot,India,2024,2,72,138,2,1,471,750,11,399,612,9,42.81818181818182,>30,IND,Home,After 1965
JJ Bumrah,IND,Pace,2024-03-07,Dharamsala,India,2024,2,89,138,2,1,287,408,5,198,270,3,57.4,>30,IND,Home,After 1965
JJ Bumrah,IND,Pace,2024-09-19,Chennai,India,2024,2,74,126,5,1,481,825,20,407,699,15,24.05,<=30,IND,Home,After 1965
JJ Bumrah,IND,Pace,2024-09-27,Kanpur,India,2024,2,67,168,6,1,315,492,12,248,324,6,26.25,<=30,IND,Home,After 1965
JJ Bumrah,IND,Pace,2024-10-16,Bengaluru,India,2024,2,70,162,3,1,462,863,22,392,701,19,21.0,<=30,IND,Home,After 1965
JJ Bumrah,IND,Pace,2024-10-24,Pune,India,2024,2,57,84,0,1,141,192,1,84,108,1,141.0,>30,IND,Home,After 1965
JJ Bumrah,IND,Pace,2024-11-22,Perth,Australia,2024,2,72,180,8,1,555,1114,27,483,934,19,20.555555555555557,<=30,AUS,Away,After 1965
JJ Bumrah,IND,Pace,2024-12-06,Adelaide,Australia,2024,2,63,144,4,1,507,779,28,444,635,24,18.107142857142858,<=30,AUS,Away,After 1965
JJ Bumrah,IND,Pace,2024-12-14,Brisbane,Australia,2024,2,94,204,9,1,550,932,24,456,728,15,22.916666666666668,<=30,AUS,Away,After 1965
JJ Bumrah,IND,Pace,2024-12-26,Melbourne,Australia,2024,2,156,320,9,1,849,1700,27,693,1380,18,31.444444444444443,>30,AUS,Away,After 1965
JJ Bumrah,IND,Pace,2025-01-03,Sydney,Australia,2025,1,33,60,2,1,502,925,30,469,865,28,16.733333333333334,<=30,AUS,Away,After 1965
JJ Crowe,NZ,Spin,1984-01-20,Wellington,New Zealand,1984,1,0,6,0,1,205,579,4,205,573,4,51.25,>30,NZ,Home,Upto 2014
JJ Crowe,NZ,Spin,1984-12-10,Karachi,Pakistan,1984,1,9,12,0,1,562,1340,12,553,1328,12,46.833333333333336,>30,PAK,Away,Upto 2014
JJ Ferris,AUS,Spin,1887-01-28,Sydney,Australia,1887,2,103,315,9,1,172,567,12,69,252,3,14.333333333333334,<=30,AUS,Home,After 1965
JJ Ferris,AUS,Spin,1887-02-25,Sydney,Australia,1887,2,140,420,9,1,268,812,19,128,392,10,14.105263157894736,<=30,AUS,Home,After 1965
JJ Ferris,AUS,Spin,1888-02-10,Sydney,Australia,1888,2,103,252,6,1,161,459,15,58,207,9,10.733333333333333,<=30,AUS,Home,After 1965
JJ Ferris,AUS,Spin,1888-07-16,Lord's,England,1888,2,45,176,8,1,134,420,21,89,244,13,6.380952380952381,<=30,ENG,Away,After 1965
JJ Ferris,AUS,Spin,1888-08-13,The Oval,England,1888,1,73,142,1,1,208,504,11,135,362,10,18.90909090909091,<=30,ENG,Away,After 1965
JJ Ferris,AUS,Spin,1888-08-30,Manchester,England,1888,1,49,160,2,1,144,395,16,95,235,14,9.0,<=30,ENG,Away,After 1965
JJ Ferris,AUS,Spin,1890-07-21,Lord's,England,1890,2,97,325,4,1,250,845,14,153,520,10,17.857142857142858,<=30,ENG,Away,After 1965
JJ Ferris,AUS,Spin,1890-08-11,The Oval,England,1890,2,74,240,9,1,81,250,9,7,10,0,9.0,<=30,ENG,Away,After 1965
JJ Ferris,ENG,Spin,1892-03-19,Cape Town,South Africa,1892,2,91,272,13,1,141,332,14,50,60,1,10.071428571428571,<=30,SA,Away,After 1965
JJ Kotze,SA,Pace,1902-10-18,Johannesburg,South Africa,1902,2,135,222,4,1,466,648,16,331,426,12,29.125,<=30,SA,Home,Upto 2014
JJ Kotze,SA,Pace,1902-11-08,Cape Town,South Africa,1902,2,65,119,2,1,317,563,15,252,444,13,21.133333333333333,<=30,SA,Home,Upto 2014
JJ Kotze,SA,Pace,1907-07-01,Lord's,England,1907,1,43,72,0,1,214,540,7,171,468,7,30.571428571428573,>30,ENG,Away,Upto 2014
JJ Krejza,AUS,Spin,2008-11-06,Nagpur,India,2008,2,358,449,12,1,751,1259,24,393,810,12,31.291666666666668,>30,IND,Away,Upto 2014
JJ Krejza,AUS,Spin,2008-12-17,W.A.C.A,Australia,2008,2,204,294,1,1,404,648,6,200,354,5,67.33333333333333,>30,AUS,Home,Upto 2014
JJ Lyons,AUS,Pace,1887-02-25,Sydney,Australia,1887,1,11,8,0,1,222,846,20,211,838,20,11.1,<=30,AUS,Home,After 1965
JJ Lyons,AUS,Pace,1890-07-21,Lord's,England,1890,2,73,201,5,1,361,1213,17,288,1012,12,21.235294117647058,<=30,ENG,Away,After 1965
JJ Lyons,AUS,Pace,1892-03-24,Adelaide,Australia,1892,1,22,30,1,1,529,1333,15,507,1303,14,35.266666666666666,>30,AUS,Home,After 1965
JJ Lyons,AUS,Pace,1893-08-14,The Oval,England,1893,1,26,35,0,1,575,1100,17,549,1065,17,33.8235294117647,>30,ENG,Away,After 1965
JJ Lyons,AUS,Pace,1894-12-14,Sydney,Australia,1894,2,12,24,0,1,993,2418,24,981,2394,24,41.375,>30,AUS,Home,After 1965
JJ Lyons,AUS,Pace,1894-12-29,Melbourne,Australia,1894,1,3,12,0,1,653,1784,28,650,1772,28,23.321428571428573,<=30,AUS,Home,After 1965
JJ Lyons,AUS,Pace,1895-03-01,Melbourne,Australia,1895,1,2,6,0,1,615,1328,15,613,1322,15,41.0,>30,AUS,Home,After 1965
JJ Warr,ENG,Pace,1951-01-05,Sydney,Australia,1951,1,142,288,0,1,385,1007,10,243,719,10,38.5,>30,AUS,Away,Upto 2014
JJ Warr,ENG,Pace,1951-02-02,Adelaide,Australia,1951,2,139,296,1,1,424,1099,11,285,803,10,38.54545454545455,>30,AUS,Away,Upto 2014
JJC Lawson,WI,Pace,2002-10-17,Chennai,India,2002,2,65,132,2,1,288,754,13,223,622,11,22.153846153846153,<=30,IND,Away,Upto 2014
JJC Lawson,WI,Pace,2002-10-30,Eden Gardens,India,2002,2,141,252,2,1,701,1322,15,560,1070,13,46.733333333333334,>30,IND,Away,Upto 2014
JJC Lawson,WI,Pace,2002-12-08,Dhaka,Bangladesh,2002,2,27,95,7,1,465,906,25,438,811,18,18.6,<=30,BAN,Away,Upto 2014
JJC Lawson,WI,Pace,2002-12-16,Chattogram,Bangladesh,2002,2,108,240,4,1,655,1306,30,547,1066,26,21.833333333333332,<=30,BAN,Away,Upto 2014
JJC Lawson,WI,Pace,2003-04-10,Georgetown,West Indies,2003,2,142,180,3,1,811,1248,21,669,1068,18,38.61904761904762,>30,WI,Home,Upto 2014
JJC Lawson,WI,Pace,2003-05-01,Bridgetown,West Indies,2003,2,133,201,4,1,652,1455,15,519,1254,11,43.46666666666667,>30,WI,Home,Upto 2014
JJC Lawson,WI,Pace,2003-05-09,St John's,West Indies,2003,2,95,151,7,1,870,1573,29,775,1422,22,30.0,<=30,WI,Home,Upto 2014
JJC Lawson,WI,Pace,2004-05-28,Gros Islet,West Indies,2004,2,126,192,2,1,821,1459,16,695,1267,14,51.3125,>30,WI,Home,Upto 2014
JJC Lawson,WI,Pace,2004-07-29,Birmingham,England,2004,2,205,264,5,1,971,1389,23,766,1125,18,42.21739130434783,>30,ENG,Away,Upto 2014
JJC Lawson,WI,Pace,2004-08-19,The Oval,England,2004,1,115,144,3,1,794,1252,26,679,1108,23,30.53846153846154,>30,ENG,Away,Upto 2014
JJC Lawson,WI,Pace,2005-07-13,Colombo (SSC),Sri Lanka,2005,2,102,159,8,1,469,856,25,367,697,17,18.76,<=30,SL,Away,Upto 2014
JJC Lawson,WI,Pace,2005-07-22,Kandy,Sri Lanka,2005,2,133,234,3,1,490,931,20,357,697,17,24.5,<=30,SL,Away,Upto 2014
JJC Lawson,WI,Pace,2005-11-03,Brisbane,Australia,2005,2,120,120,1,1,772,1215,25,652,1095,24,30.88,>30,AUS,Away,Upto 2014
JK Lever,ENG,Pace,1976-12-17,Delhi,India,1976,2,70,220,10,1,217,567,13,147,347,3,16.692307692307693,<=30,IND,Away,Upto 2014
JK Lever,ENG,Pace,1977-01-01,Eden Gardens,India,1977,2,69,150,2,1,233,654,15,164,504,13,15.533333333333333,<=30,IND,Away,Upto 2014
JK Lever,ENG,Pace,1977-01-14,Chennai,India,1977,2,77,160,7,1,275,772,15,198,612,8,18.333333333333332,<=30,IND,Away,Upto 2014
JK Lever,ENG,Pace,1977-01-28,Bengaluru,India,1977,2,76,156,2,1,275,606,12,199,450,10,22.916666666666668,<=30,IND,Away,Upto 2014
JK Lever,ENG,Pace,1977-02-11,Wankhede,India,1977,2,88,212,5,1,299,578,10,211,366,5,29.9,<=30,IND,Away,Upto 2014
JK Lever,ENG,Pace,1977-03-12,Melbourne,Australia,1977,2,131,264,4,1,769,1725,30,638,1461,26,25.633333333333333,<=30,AUS,Away,Upto 2014
JK Lever,ENG,Pace,1977-06-16,Lord's,England,1977,2,65,144,1,1,753,1756,32,688,1612,31,23.53125,<=30,ENG,Home,Upto 2014
JK Lever,ENG,Pace,1977-07-07,Manchester,England,1977,2,71,174,3,1,525,1242,14,454,1068,11,37.5,>30,ENG,Home,Upto 2014
JK Lever,ENG,Pace,1977-08-25,The Oval,England,1977,1,61,132,1,1,507,1259,20,446,1127,19,25.35,<=30,ENG,Home,Upto 2014
JK Lever,ENG,Pace,1977-12-14,Lahore,Pakistan,1977,2,60,152,3,1,359,1064,11,299,912,8,32.63636363636363,>30,PAK,Away,Upto 2014
JK Lever,ENG,Pace,1978-01-02,Hyderabad (Sind),Pakistan,1978,2,103,294,1,1,260,806,5,157,512,4,52.0,>30,PAK,Away,Upto 2014
JK Lever,ENG,Pace,1978-01-18,Karachi,Pakistan,1978,1,32,96,0,1,226,792,5,194,696,5,45.2,>30,PAK,Away,Upto 2014
JK Lever,ENG,Pace,1978-03-04,Auckland,New Zealand,1978,2,155,408,5,1,754,2126,17,599,1718,12,44.35294117647059,>30,NZ,Away,Upto 2014
JK Lever,ENG,Pace,1978-12-15,W.A.C.A,Australia,1978,2,48,121,5,1,652,1878,31,604,1757,26,21.032258064516128,<=30,AUS,Away,Upto 2014
JK Lever,ENG,Pace,1979-08-02,Lord's,England,1979,2,98,203,2,1,523,1253,16,425,1050,14,32.6875,>30,ENG,Home,Upto 2014
JK Lever,ENG,Pace,1980-02-01,Melbourne,Australia,1980,2,129,364,4,1,694,1833,26,565,1469,22,26.692307692307693,<=30,AUS,Away,Upto 2014
JK Lever,ENG,Pace,1980-02-15,Wankhede,India,1980,2,147,259,4,1,555,1195,28,408,936,24,19.821428571428573,<=30,IND,Away,Upto 2014
JK Lever,ENG,Pace,1980-06-05,Nottingham,England,1980,2,101,168,1,1,897,2129,36,796,1961,35,24.916666666666668,<=30,ENG,Home,Upto 2014
JK Lever,ENG,Pace,1981-12-09,Bengaluru,India,1981,1,100,216,5,1,557,1122,12,457,906,7,46.416666666666664,>30,IND,Away,Upto 2014
JK Lever,ENG,Pace,1981-12-23,Delhi,India,1981,1,104,222,2,1,608,1217,15,504,995,13,40.53333333333333,>30,IND,Away,Upto 2014
JK Lever,ENG,Pace,1986-06-19,Leeds,England,1986,2,166,318,6,1,608,1416,31,442,1098,25,19.612903225806452,<=30,ENG,Home,Upto 2014
JKC Holt,WI,Spin,1955-03-26,Kingston,West Indies,1955,1,20,18,1,1,550,1394,11,530,1376,10,50.0,>30,WI,Home,Upto 2014
JKC Holt,WI,Spin,1955-04-11,Port of Spain,West Indies,1955,1,0,6,0,1,545,1044,8,545,1038,8,68.125,>30,WI,Home,Upto 2014
JKC Holt,WI,Spin,1959-02-20,Karachi,Pakistan,1959,1,0,6,0,1,375,1262,15,375,1256,15,25.0,<=30,PAK,Away,Upto 2014
JL Cox,SA,Pace,1913-12-13,Durban,South Africa,1913,1,123,258,2,1,479,1054,20,356,796,18,23.95,<=30,SA,Home,Upto 2014
JL Cox,SA,Pace,1913-12-26,Johannesburg,South Africa,1913,1,74,180,2,1,455,1029,24,381,849,22,18.958333333333332,<=30,SA,Home,Upto 2014
JL Cox,SA,Pace,1914-02-14,Durban,South Africa,1914,2,48,138,0,1,410,971,20,362,833,20,20.5,<=30,SA,Home,Upto 2014
JL Denly,ENG,Spin,2019-01-31,North Sound,West Indies,2019,1,1,6,0,1,94,204,3,93,198,3,31.333333333333332,>30,WI,Away,After 1965
JL Denly,ENG,Spin,2019-02-09,Gros Islet,West Indies,2019,1,16,18,0,1,312,576,7,296,558,7,44.57142857142857,>30,WI,Away,After 1965
JL Denly,ENG,Spin,2019-08-01,Birmingham,England,2019,2,79,96,0,1,478,833,12,399,737,12,39.833333333333336,>30,ENG,Home,After 1965
JL Denly,ENG,Spin,2019-08-14,Lord's,England,2019,1,0,12,0,1,239,466,7,239,454,7,34.142857142857146,>30,ENG,Home,After 1965
JL Denly,ENG,Spin,2019-09-04,Manchester,England,2019,1,8,18,0,1,337,685,7,329,667,7,48.142857142857146,>30,ENG,Home,After 1965
JL Denly,ENG,Spin,2019-11-29,Hamilton,New Zealand,2019,2,40,72,0,1,165,324,1,125,252,1,165.0,>30,NZ,Away,After 1965
JL Denly,ENG,Spin,2019-12-26,Centurion,South Africa,2019,1,4,18,0,1,85,162,2,81,144,2,42.5,>30,SA,Away,After 1965
JL Denly,ENG,Spin,2020-01-03,Cape Town,South Africa,2020,1,42,108,2,1,404,942,7,362,834,5,57.714285714285715,>30,SA,Away,After 1965
JL Denly,ENG,Spin,2020-01-16,Gqeberha,South Africa,2020,1,10,24,0,1,395,936,15,385,912,15,26.333333333333332,<=30,SA,Away,After 1965
JL Denly,ENG,Spin,2020-01-24,Johannesburg,South Africa,2020,1,19,18,0,1,56,60,0,37,42,0,inf,>30,SA,Away,After 1965
JL Hopwood,ENG,Pace,1934-07-06,Manchester,England,1934,2,62,282,0,1,754,1551,6,692,1269,6,125.66666666666667,>30,ENG,Home,Upto 2014
JL Hopwood,ENG,Pace,1934-07-20,Leeds,England,1934,1,93,180,0,1,418,900,7,325,720,7,59.714285714285715,>30,ENG,Home,Upto 2014
JL Langer,AUS,Pace,2001-03-11,Eden Gardens,India,2001,1,3,6,0,1,800,1488,16,797,1482,16,50.0,>30,IND,Away,Upto 2014
JL Ontong,SA,Spin,2002-01-02,Sydney,Australia,2002,1,10,12,0,1,581,1150,17,571,1138,17,34.1764705882353,>30,AUS,Away,Upto 2014
JL Ontong,SA,Spin,2004-11-28,Eden Gardens,India,2004,2,123,173,1,1,470,978,15,347,805,14,31.333333333333332,>30,IND,Away,Upto 2014
JL Pattinson,AUS,Pace,2011-12-01,Brisbane,Australia,2011,2,91,156,6,1,653,1114,19,562,958,13,34.36842105263158,>30,AUS,Home,Upto 2014
JL Pattinson,AUS,Pace,2011-12-09,Hobart,Australia,2011,2,105,209,8,1,648,1341,37,543,1132,29,17.513513513513512,<=30,AUS,Home,Upto 2014
JL Pattinson,AUS,Pace,2011-12-26,Melbourne,Australia,2011,2,108,228,6,1,739,1504,35,631,1276,29,21.114285714285714,<=30,AUS,Home,Upto 2014
JL Pattinson,AUS,Pace,2012-01-03,Sydney,Australia,2012,2,149,222,5,1,874,1376,22,725,1154,17,39.72727272727273,>30,AUS,Home,Upto 2014
JL Pattinson,AUS,Pace,2012-04-15,Port of Spain,West Indies,2012,1,40,66,1,1,412,924,17,372,858,16,24.235294117647058,<=30,WI,Away,Upto 2014
JL Pattinson,AUS,Pace,2012-11-09,Brisbane,Australia,2012,2,151,318,5,1,917,1756,14,766,1438,9,65.5,>30,AUS,Home,Upto 2014
JL Pattinson,AUS,Pace,2012-11-22,Adelaide,Australia,2012,1,41,55,0,1,863,1649,28,822,1594,28,30.821428571428573,>30,AUS,Home,Upto 2014
JL Pattinson,AUS,Pace,2013-02-22,Chennai,India,2013,2,109,198,6,1,415,813,8,306,615,2,51.875,>30,IND,Away,Upto 2014
JL Pattinson,AUS,Pace,2013-03-02,Hyderabad,India,2013,1,80,174,2,1,327,744,7,247,570,5,46.714285714285715,>30,IND,Away,Upto 2014
JL Pattinson,AUS,Pace,2013-03-22,Delhi,India,2013,2,61,102,1,1,259,450,5,198,348,4,51.8,>30,IND,Away,Upto 2014
JL Pattinson,AUS,Pace,2013-07-10,Nottingham,England,2013,2,170,306,5,1,827,1665,33,657,1359,28,25.060606060606062,<=30,ENG,Away,Upto 2014
JL Pattinson,AUS,Pace,2013-07-18,Lord's,England,2013,2,137,241,2,1,669,1424,21,532,1183,19,31.857142857142858,>30,ENG,Away,Upto 2014
JL Pattinson,AUS,Pace,2014-03-01,Cape Town,South Africa,2014,2,139,275,4,1,924,1728,25,785,1453,21,36.96,>30,SA,Away,After 1965
JL Pattinson,AUS,Pace,2015-12-10,Hobart,Australia,2015,2,95,138,5,1,634,903,16,539,765,11,39.625,>30,AUS,Home,After 1965
JL Pattinson,AUS,Pace,2015-12-26,Melbourne,Australia,2015,2,121,237,6,1,837,1482,18,716,1245,12,46.5,>30,AUS,Home,After 1965
JL Pattinson,AUS,Pace,2016-01-03,Sydney,Australia,2016,1,76,108,2,1,234,354,3,158,246,1,78.0,>30,AUS,Home,After 1965
JL Pattinson,AUS,Pace,2016-02-20,Christchurch,New Zealand,2016,2,158,246,6,1,1247,2076,29,1089,1830,23,43.0,>30,NZ,Away,After 1965
JL Pattinson,AUS,Pace,2019-08-01,Birmingham,England,2019,2,111,210,2,1,758,1453,25,647,1243,23,30.32,>30,ENG,Away,After 1965
JL Pattinson,AUS,Pace,2019-08-22,Leeds,England,2019,2,56,180,3,1,629,1344,34,573,1164,31,18.5,<=30,ENG,Away,After 1965
JL Pattinson,AUS,Pace,2019-12-26,Melbourne,Australia,2019,2,69,162,6,1,729,1616,26,660,1454,20,28.03846153846154,<=30,AUS,Home,After 1965
JL Pattinson,AUS,Pace,2020-01-03,Sydney,Australia,2020,2,66,132,0,1,593,1249,16,527,1117,16,37.0625,>30,AUS,Home,After 1965
JM Anderson,ENG,Pace,2003-05-22,Lord's,England,2003,2,138,186,5,1,641,1236,26,503,1050,21,24.653846153846153,<=30,ENG,Home,Upto 2014
JM Anderson,ENG,Pace,2003-06-05,Chester-le-Street,England,2003,2,85,198,6,1,554,1098,27,469,900,21,20.51851851851852,<=30,ENG,Home,Upto 2014
JM Anderson,ENG,Pace,2003-07-24,Birmingham,England,2003,2,129,156,1,1,873,1408,14,744,1252,13,62.357142857142854,>30,ENG,Home,Upto 2014
JM Anderson,ENG,Pace,2003-07-31,Lord's,England,2003,1,90,162,2,1,967,1600,24,877,1438,22,40.291666666666664,>30,ENG,Home,Upto 2014
JM Anderson,ENG,Pace,2003-08-14,Nottingham,England,2003,2,119,239,7,1,935,1991,38,816,1752,31,24.605263157894736,<=30,ENG,Home,Upto 2014
JM Anderson,ENG,Pace,2003-08-21,Leeds,England,2003,2,119,204,2,1,1130,2145,39,1011,1941,37,28.974358974358974,<=30,ENG,Home,Upto 2014
JM Anderson,ENG,Pace,2003-09-04,The Oval,England,2003,2,141,210,3,1,1075,1870,24,934,1660,21,44.791666666666664,>30,ENG,Home,Upto 2014
JM Anderson,ENG,Pace,2003-12-18,Colombo (SSC),Sri Lanka,2003,1,85,144,0,1,444,738,12,359,594,12,37.0,>30,SL,Away,Upto 2014
JM Anderson,ENG,Pace,2004-07-29,Birmingham,England,2004,2,60,99,2,1,971,1389,23,911,1290,21,42.21739130434783,>30,ENG,Home,Upto 2014
JM Anderson,ENG,Pace,2004-08-12,Manchester,England,2004,2,71,99,1,1,785,1467,28,714,1368,27,28.035714285714285,<=30,ENG,Home,Upto 2014
JM Anderson,ENG,Pace,2004-08-19,The Oval,England,2004,2,88,133,4,1,794,1252,26,706,1119,22,30.53846153846154,>30,ENG,Home,Upto 2014
JM Anderson,ENG,Pace,2005-01-13,Johannesburg,South Africa,2005,2,149,204,2,1,1212,2062,34,1063,1858,32,35.64705882352941,>30,SA,Away,Upto 2014
JM Anderson,ENG,Pace,2006-03-18,Wankhede,India,2006,2,79,187,6,1,416,973,19,337,786,13,21.894736842105264,<=30,IND,Away,Upto 2014
JM Anderson,ENG,Pace,2006-11-23,Brisbane,Australia,2006,2,195,228,1,1,985,1659,24,790,1431,23,41.041666666666664,>30,AUS,Away,Upto 2014
JM Anderson,ENG,Pace,2006-12-01,Adelaide,Australia,2006,2,108,152,1,1,876,1646,21,768,1494,20,41.714285714285715,>30,AUS,Away,Upto 2014
JM Anderson,ENG,Pace,2007-01-02,Sydney,Australia,2007,2,110,180,3,1,646,1259,24,536,1079,21,26.916666666666668,<=30,AUS,Away,Upto 2014
JM Anderson,ENG,Pace,2007-07-19,Lord's,England,2007,2,125,296,7,1,762,1573,34,637,1277,27,22.41176470588235,<=30,ENG,Home,Upto 2014
JM Anderson,ENG,Pace,2007-07-27,Nottingham,England,2007,2,157,252,1,1,762,1633,23,605,1381,22,33.130434782608695,>30,ENG,Home,Upto 2014
JM Anderson,ENG,Pace,2007-08-09,The Oval,England,2007,2,216,330,6,1,888,1674,23,672,1344,17,38.608695652173914,>30,ENG,Home,Upto 2014
JM Anderson,ENG,Pace,2007-12-01,Kandy,Sri Lanka,2007,2,167,232,2,1,767,1367,21,600,1135,19,36.523809523809526,>30,SL,Away,Upto 2014
JM Anderson,ENG,Pace,2008-03-13,Wellington,New Zealand,2008,2,130,210,7,1,966,1899,38,836,1689,31,25.42105263157895,<=30,NZ,Away,Upto 2014
JM Anderson,ENG,Pace,2008-03-22,Napier,New Zealand,2008,2,153,144,1,1,793,1402,23,640,1258,22,34.47826086956522,>30,NZ,Away,Upto 2014
JM Anderson,ENG,Pace,2008-05-15,Lord's,England,2008,2,130,234,5,1,640,1330,19,510,1096,14,33.68421052631579,>30,ENG,Home,Upto 2014
JM Anderson,ENG,Pace,2008-05-23,Manchester,England,2008,2,139,171,5,1,614,1172,16,475,1001,11,38.375,>30,ENG,Home,Upto 2014
JM Anderson,ENG,Pace,2008-06-05,Nottingham,England,2008,2,98,216,9,1,579,1236,29,481,1020,20,19.96551724137931,<=30,ENG,Home,Upto 2014
JM Anderson,ENG,Pace,2008-07-10,Lord's,England,2008,2,114,318,3,1,845,1704,13,731,1386,10,65.0,>30,ENG,Home,Upto 2014
JM Anderson,ENG,Pace,2008-07-18,Leeds,England,2008,1,136,264,3,1,905,1732,27,769,1468,24,33.51851851851852,>30,ENG,Home,Upto 2014
JM Anderson,ENG,Pace,2008-07-30,Birmingham,England,2008,2,132,236,4,1,903,1618,29,771,1382,25,31.137931034482758,>30,ENG,Home,Upto 2014
JM Anderson,ENG,Pace,2008-08-07,The Oval,England,2008,2,127,222,5,1,862,1540,26,735,1318,21,33.15384615384615,>30,ENG,Home,Upto 2014
JM Anderson,ENG,Pace,2008-12-11,Chennai,India,2008,2,79,132,2,1,452,1045,16,373,913,14,28.25,<=30,IND,Away,Upto 2014
JM Anderson,ENG,Pace,2008-12-19,Mohali,India,2008,2,135,306,2,1,522,1070,12,387,764,10,43.5,>30,IND,Away,Upto 2014
JM Anderson,ENG,Pace,2009-02-15,St John's,West Indies,2009,2,123,264,2,1,803,1574,19,680,1310,17,42.26315789473684,>30,WI,Away,Upto 2014
JM Anderson,ENG,Pace,2009-02-26,Bridgetown,West Indies,2009,1,125,222,3,1,977,1508,9,852,1286,6,108.55555555555556,>30,WI,Away,Upto 2014
JM Anderson,ENG,Pace,2009-03-06,Port of Spain,West Indies,2009,2,94,288,4,1,770,1390,15,676,1102,11,51.333333333333336,>30,WI,Away,Upto 2014
JM Anderson,ENG,Pace,2009-05-06,Lord's,England,2009,2,70,132,2,1,625,1023,22,555,891,20,28.40909090909091,<=30,ENG,Home,Upto 2014
JM Anderson,ENG,Pace,2009-05-14,Chester-le-Street,England,2009,2,125,255,9,1,746,1203,21,621,948,12,35.523809523809526,>30,ENG,Home,Upto 2014
JM Anderson,ENG,Pace,2009-07-08,Cardiff,England,2009,1,110,192,2,1,832,1434,18,722,1242,16,46.22222222222222,>30,ENG,Home,Upto 2014
JM Anderson,ENG,Pace,2009-07-16,Lord's,England,2009,2,141,252,4,1,1009,1590,27,868,1338,23,37.370370370370374,>30,ENG,Home,Upto 2014
JM Anderson,ENG,Pace,2009-07-30,Birmingham,England,2009,2,127,270,6,1,806,1353,22,679,1083,16,36.63636363636363,>30,ENG,Home,Upto 2014
JM Anderson,ENG,Pace,2009-08-07,Leeds,England,2009,1,89,108,0,1,700,1101,30,611,993,30,23.333333333333332,<=30,ENG,Home,Upto 2014
JM Anderson,ENG,Pace,2009-08-20,The Oval,England,2009,2,75,126,0,1,842,1408,23,767,1282,23,36.608695652173914,>30,ENG,Home,Upto 2014
JM Anderson,ENG,Pace,2009-12-16,Centurion,South Africa,2009,2,177,347,5,1,848,1757,22,671,1410,17,38.54545454545455,>30,SA,Away,Upto 2014
JM Anderson,ENG,Pace,2009-12-26,Durban,South Africa,2009,2,99,189,3,1,616,1251,15,517,1062,12,41.06666666666667,>30,SA,Away,Upto 2014
JM Anderson,ENG,Pace,2010-01-03,Cape Town,South Africa,2010,2,161,261,8,1,868,1767,26,707,1506,18,33.38461538461539,>30,SA,Away,Upto 2014
JM Anderson,ENG,Pace,2010-01-14,Johannesburg,South Africa,2010,1,111,180,0,1,644,1109,23,533,929,23,28.0,<=30,SA,Away,Upto 2014
JM Anderson,ENG,Pace,2010-05-27,Lord's,England,2010,2,162,360,5,1,777,1274,20,615,914,15,38.85,>30,ENG,Home,Upto 2014
JM Anderson,ENG,Pace,2010-06-04,Manchester,England,2010,2,61,144,4,1,268,480,16,207,336,12,16.75,<=30,ENG,Home,Upto 2014
JM Anderson,ENG,Pace,2010-07-29,Nottingham,England,2010,2,71,222,11,1,558,1225,33,487,1003,22,16.90909090909091,<=30,ENG,Home,Upto 2014
JM Anderson,ENG,Pace,2010-08-06,Birmingham,England,2010,2,82,255,5,1,468,1160,20,386,905,15,23.4,<=30,ENG,Home,Upto 2014
JM Anderson,ENG,Pace,2010-08-18,The Oval,England,2010,2,118,228,4,1,645,1152,22,527,924,18,29.318181818181817,<=30,ENG,Home,Upto 2014
JM Anderson,ENG,Pace,2010-08-26,Lord's,England,2010,2,45,138,3,1,413,794,18,368,656,15,22.944444444444443,<=30,ENG,Home,Upto 2014
JM Anderson,ENG,Pace,2010-11-25,Brisbane,Australia,2010,2,114,252,2,1,947,1750,17,833,1498,15,55.705882352941174,>30,AUS,Away,Upto 2014
JM Anderson,ENG,Pace,2010-12-03,Adelaide,Australia,2010,2,143,246,6,1,745,1313,14,602,1067,8,53.214285714285715,>30,AUS,Away,Upto 2014
JM Anderson,ENG,Pace,2010-12-16,W.A.C.A,Australia,2010,2,126,276,4,1,755,1419,38,629,1143,34,19.86842105263158,<=30,AUS,Away,Upto 2014
JM Anderson,ENG,Pace,2010-12-26,Melbourne,Australia,2010,2,115,216,5,1,704,1424,26,589,1208,21,27.076923076923077,<=30,AUS,Away,Upto 2014
JM Anderson,ENG,Pace,2011-01-03,Sydney,Australia,2011,2,127,289,7,1,873,1642,26,746,1353,19,33.57692307692308,>30,AUS,Away,Upto 2014
JM Anderson,ENG,Pace,2011-05-26,Cardiff,England,2011,1,66,168,3,1,591,1108,14,525,940,11,42.214285714285715,>30,ENG,Home,Upto 2014
JM Anderson,ENG,Pace,2011-06-16,Southampton,England,2011,2,137,318,4,1,719,1308,21,582,990,17,34.23809523809524,>30,ENG,Home,Upto 2014
JM Anderson,ENG,Pace,2011-07-21,Lord's,England,2011,2,152,311,7,1,813,1712,30,661,1401,23,27.1,<=30,ENG,Home,Upto 2014
JM Anderson,ENG,Pace,2011-07-29,Nottingham,England,2011,2,131,258,5,1,899,1645,37,768,1387,32,24.2972972972973,<=30,ENG,Home,Upto 2014
JM Anderson,ENG,Pace,2011-08-10,Birmingham,England,2011,2,154,236,6,1,731,1272,20,577,1036,14,36.55,>30,ENG,Home,Upto 2014
JM Anderson,ENG,Pace,2011-08-18,The Oval,England,2011,2,103,198,3,1,633,1206,15,530,1008,12,42.2,>30,ENG,Home,Upto 2014
JM Anderson,ENG,Pace,2012-01-17,Dubai (DICS),UAE,2012,2,78,192,2,1,389,864,11,311,672,9,35.36363636363637,>30,UAE,Away,Upto 2014
JM Anderson,ENG,Pace,2012-01-25,Abu Dhabi,UAE,2012,2,85,202,3,1,271,622,9,186,420,6,30.11111111111111,>30,UAE,Away,Upto 2014
JM Anderson,ENG,Pace,2012-02-03,Dubai (DICS),UAE,2012,2,86,253,4,1,298,715,15,212,462,11,19.866666666666667,<=30,UAE,Away,Upto 2014
JM Anderson,ENG,Pace,2012-03-26,Galle,Sri Lanka,2012,2,98,186,5,1,355,636,9,257,450,4,39.44444444444444,>30,SL,Away,Upto 2014
JM Anderson,ENG,Pace,2012-04-03,Colombo (PSS),Sri Lanka,2012,2,98,252,4,1,394,959,10,296,707,6,39.4,>30,SL,Away,Upto 2014
JM Anderson,ENG,Pace,2012-05-17,Lord's,England,2012,2,126,366,3,1,939,1916,29,813,1550,26,32.37931034482759,>30,ENG,Home,Upto 2014
JM Anderson,ENG,Pace,2012-05-25,Nottingham,England,2012,2,116,301,6,1,765,1507,24,649,1206,18,31.875,>30,ENG,Home,Upto 2014
JM Anderson,ENG,Pace,2012-07-19,The Oval,England,2012,1,116,246,1,1,900,1787,18,784,1541,17,50.0,>30,ENG,Home,Upto 2014
JM Anderson,ENG,Pace,2012-08-02,Leeds,England,2012,2,101,314,3,1,982,1920,23,881,1606,20,42.69565217391305,>30,ENG,Home,Upto 2014
JM Anderson,ENG,Pace,2012-08-16,Lord's,England,2012,2,149,326,5,1,927,1840,33,778,1514,28,28.09090909090909,<=30,ENG,Home,Upto 2014
JM Anderson,ENG,Pace,2012-11-15,Ahmedabad,India,2012,2,85,174,1,1,421,867,8,336,693,7,52.625,>30,IND,Away,Upto 2014
JM Anderson,ENG,Pace,2012-11-23,Wankhede,India,2012,2,70,132,1,1,167,294,1,97,162,0,167.0,>30,IND,Away,Upto 2014
JM Anderson,ENG,Pace,2012-12-05,Eden Gardens,India,2012,2,127,262,6,1,417,856,12,290,594,6,34.75,>30,IND,Away,Upto 2014
JM Anderson,ENG,Pace,2012-12-13,Nagpur,India,2012,1,81,192,4,1,243,612,7,162,420,3,34.714285714285715,>30,IND,Away,Upto 2014
JM Anderson,ENG,Pace,2013-03-06,Dunedin,New Zealand,2013,1,137,198,4,1,764,1468,18,627,1270,14,42.44444444444444,>30,NZ,Away,Upto 2014
JM Anderson,ENG,Pace,2013-03-14,Wellington,New Zealand,2013,2,95,222,3,1,612,1184,15,517,962,12,40.8,>30,NZ,Away,Upto 2014
JM Anderson,ENG,Pace,2013-03-22,Auckland,New Zealand,2013,2,138,282,3,1,822,1793,28,684,1511,25,29.357142857142858,<=30,NZ,Away,Upto 2014
JM Anderson,ENG,Pace,2013-05-16,Lord's,England,2013,2,70,213,7,1,569,1283,36,499,1070,29,15.805555555555555,<=30,ENG,Home,Upto 2014
JM Anderson,ENG,Pace,2013-05-24,Leeds,England,2013,2,62,115,2,1,701,1279,21,639,1164,19,33.38095238095238,>30,ENG,Home,Upto 2014
JM Anderson,ENG,Pace,2013-07-10,Nottingham,England,2013,2,158,335,10,1,827,1665,33,669,1330,23,25.060606060606062,<=30,ENG,Home,Upto 2014
JM Anderson,ENG,Pace,2013-07-18,Lord's,England,2013,2,80,192,3,1,669,1424,21,589,1232,18,31.857142857142858,>30,ENG,Home,Upto 2014
JM Anderson,ENG,Pace,2013-08-01,Manchester,England,2013,2,153,246,2,1,710,1434,19,557,1188,17,37.36842105263158,>30,ENG,Home,Upto 2014
JM Anderson,ENG,Pace,2013-08-09,Chester-le-Street,England,2013,2,138,246,2,1,823,1578,29,685,1332,27,28.379310344827587,<=30,ENG,Home,Upto 2014
JM Anderson,ENG,Pace,2013-08-21,The Oval,England,2013,2,122,215,5,1,836,1443,25,714,1228,20,33.44,>30,ENG,Home,Upto 2014
JM Anderson,ENG,Pace,2013-11-21,Brisbane,Australia,2013,2,140,265,2,1,625,1326,30,485,1061,28,20.833333333333332,<=30,AUS,Away,Upto 2014
JM Anderson,ENG,Pace,2013-12-05,Adelaide,Australia,2013,2,104,222,3,1,606,1290,25,502,1068,22,24.24,<=30,AUS,Away,Upto 2014
JM Anderson,ENG,Pace,2013-12-13,W.A.C.A,Australia,2013,2,165,252,2,1,995,1739,27,830,1487,25,36.851851851851855,>30,AUS,Away,Upto 2014
JM Anderson,ENG,Pace,2013-12-26,Melbourne,Australia,2013,2,93,188,4,1,653,1410,24,560,1222,20,27.208333333333332,<=30,AUS,Away,Upto 2014
JM Anderson,ENG,Pace,2014-01-03,Sydney,Australia,2014,2,113,216,3,1,663,1122,33,550,906,30,20.09090909090909,<=30,AUS,Away,After 1965
JM Anderson,ENG,Pace,2014-06-12,Lord's,England,2014,2,118,300,7,1,1099,1996,30,981,1696,23,36.63333333333333,>30,ENG,Home,After 1965
JM Anderson,ENG,Pace,2014-06-20,Leeds,England,2014,2,140,269,5,1,1059,2060,34,919,1791,29,31.147058823529413,>30,ENG,Home,After 1965
JM Anderson,ENG,Pace,2014-07-09,Nottingham,England,2014,2,170,354,4,1,984,1979,23,814,1625,19,42.78260869565217,>30,ENG,Home,After 1965
JM Anderson,ENG,Pace,2014-07-17,Lord's,England,2014,2,137,312,5,1,890,1823,32,753,1511,27,27.8125,<=30,ENG,Home,After 1965
JM Anderson,ENG,Pace,2014-07-27,Southampton,England,2014,2,77,241,7,1,815,1573,15,738,1332,8,54.333333333333336,>30,ENG,Home,After 1965
JM Anderson,ENG,Pace,2014-08-07,Manchester,England,2014,2,64,138,5,1,546,928,23,482,790,18,23.73913043478261,<=30,ENG,Home,After 1965
JM Anderson,ENG,Pace,2014-08-15,The Oval,England,2014,2,67,150,4,1,613,1107,25,546,957,21,24.52,<=30,ENG,Home,After 1965
JM Anderson,ENG,Pace,2015-04-13,North Sound,West Indies,2015,2,139,286,4,1,886,1696,22,747,1410,18,40.27272727272727,>30,WI,Away,After 1965
JM Anderson,ENG,Pace,2015-04-21,St George's,West Indies,2015,2,90,276,6,1,731,1499,18,641,1223,12,40.611111111111114,>30,WI,Away,After 1965
JM Anderson,ENG,Pace,2015-05-01,Bridgetown,West Indies,2015,2,77,154,7,1,388,896,26,311,742,19,14.923076923076923,<=30,WI,Away,After 1965
JM Anderson,ENG,Pace,2015-05-21,Lord's,England,2015,2,119,258,2,1,1185,2044,33,1066,1786,31,35.90909090909091,>30,ENG,Home,After 1965
JM Anderson,ENG,Pace,2015-05-29,Leeds,England,2015,2,139,216,4,1,1058,1587,28,919,1371,24,37.785714285714285,>30,ENG,Home,After 1965
JM Anderson,ENG,Pace,2015-07-08,Cardiff,England,2015,2,76,185,3,1,901,1488,27,825,1303,24,33.370370370370374,>30,ENG,Home,After 1965
JM Anderson,ENG,Pace,2015-07-16,Lord's,England,2015,2,137,198,0,1,791,1369,21,654,1171,21,37.666666666666664,>30,ENG,Home,After 1965
JM Anderson,ENG,Pace,2015-07-29,Birmingham,England,2015,2,62,139,7,1,619,1035,28,557,896,21,22.107142857142858,<=30,ENG,Home,After 1965
JM Anderson,ENG,Pace,2015-10-13,Abu Dhabi,UAE,2015,2,72,192,4,1,582,1249,16,510,1057,12,36.375,>30,UAE,Away,After 1965
JM Anderson,ENG,Pace,2015-10-22,Dubai (DICS),UAE,2015,2,62,210,3,1,554,1207,19,492,997,16,29.157894736842106,<=30,UAE,Away,After 1965
JM Anderson,ENG,Pace,2015-11-01,Sharjah,UAE,2015,2,69,247,6,1,278,841,14,209,594,8,19.857142857142858,<=30,UAE,Away,After 1965
JM Anderson,ENG,Pace,2016-01-02,Cape Town,South Africa,2016,1,77,210,1,1,994,1661,14,917,1451,13,71.0,>30,SA,Away,After 1965
JM Anderson,ENG,Pace,2016-01-14,Johannesburg,South Africa,2016,2,86,212,2,1,692,1271,29,606,1059,27,23.862068965517242,<=30,SA,Away,After 1965
JM Anderson,ENG,Pace,2016-01-22,Centurion,South Africa,2016,2,138,288,4,1,827,1592,31,689,1304,27,26.677419354838708,<=30,SA,Away,After 1965
JM Anderson,ENG,Pace,2016-05-19,Leeds,England,2016,2,45,151,10,1,468,901,27,423,750,17,17.333333333333332,<=30,ENG,Home,After 1965
JM Anderson,ENG,Pace,2016-05-27,Chester-le-Street,England,2016,2,94,237,8,1,773,1433,25,679,1196,17,30.92,>30,ENG,Home,After 1965
JM Anderson,ENG,Pace,2016-06-09,Lord's,England,2016,2,88,192,3,1,770,1481,24,682,1289,21,32.083333333333336,>30,ENG,Home,After 1965
JM Anderson,ENG,Pace,2016-07-22,Manchester,England,2016,2,68,174,4,1,705,1279,22,637,1105,18,32.04545454545455,>30,ENG,Home,After 1965
JM Anderson,ENG,Pace,2016-08-03,Birmingham,England,2016,2,85,253,4,1,912,1860,29,827,1607,25,31.448275862068964,>30,ENG,Home,After 1965
JM Anderson,ENG,Pace,2016-08-11,The Oval,England,2016,1,78,174,1,1,784,1374,21,706,1200,20,37.333333333333336,>30,ENG,Home,After 1965
JM Anderson,ENG,Pace,2016-11-17,Visakhapatnam,India,2016,2,95,210,4,1,406,876,14,311,666,10,29.0,<=30,IND,Away,After 1965
JM Anderson,ENG,Pace,2016-11-26,Mohali,India,2016,2,56,144,0,1,431,841,13,375,697,13,33.15384615384615,>30,IND,Away,After 1965
JM Anderson,ENG,Pace,2016-12-08,Wankhede,India,2016,1,63,120,0,1,329,570,3,266,450,3,109.66666666666667,>30,IND,Away,After 1965
JM Anderson,ENG,Pace,2017-07-06,Lord's,England,2017,2,60,150,3,1,720,1257,22,660,1107,19,32.72727272727273,>30,ENG,Home,After 1965
JM Anderson,ENG,Pace,2017-07-14,Nottingham,England,2017,2,117,260,7,1,739,1395,28,622,1135,21,26.392857142857142,<=30,ENG,Home,After 1965
JM Anderson,ENG,Pace,2017-07-27,The Oval,England,2017,2,51,156,3,1,850,1584,29,799,1428,26,29.310344827586206,<=30,ENG,Home,After 1965
JM Anderson,ENG,Pace,2017-08-04,Manchester,England,2017,2,54,186,7,1,698,1268,30,644,1082,23,23.266666666666666,<=30,ENG,Home,After 1965
JM Anderson,ENG,Pace,2017-08-17,Birmingham,England,2017,2,46,132,5,1,610,1081,19,564,949,14,32.10526315789474,>30,ENG,Home,After 1965
JM Anderson,ENG,Pace,2017-08-25,Leeds,England,2017,2,149,318,5,1,1027,1807,24,878,1489,19,42.791666666666664,>30,ENG,Home,After 1965
JM Anderson,ENG,Pace,2017-09-07,Lord's,England,2017,2,73,217,9,1,490,1083,30,417,866,21,16.333333333333332,<=30,ENG,Home,After 1965
JM Anderson,ENG,Pace,2017-11-23,Brisbane,Australia,2017,2,77,240,2,1,713,1568,21,636,1328,19,33.95238095238095,>30,AUS,Away,After 1965
JM Anderson,ENG,Pace,2017-12-02,Adelaide,Australia,2017,2,117,318,6,1,779,1712,31,662,1394,25,25.129032258064516,<=30,AUS,Away,After 1965
JM Anderson,ENG,Pace,2017-12-14,W.A.C.A,Australia,2017,1,116,225,4,1,965,1713,24,849,1488,20,40.208333333333336,>30,AUS,Away,After 1965
JM Anderson,ENG,Pace,2017-12-26,Melbourne,Australia,2017,2,107,354,4,1,816,1807,20,709,1453,16,40.8,>30,AUS,Away,After 1965
JM Anderson,ENG,Pace,2018-01-04,Sydney,Australia,2018,1,56,204,1,1,630,1294,17,574,1090,16,37.05882352941177,>30,AUS,Away,After 1965
JM Anderson,ENG,Pace,2018-03-22,Auckland,New Zealand,2018,1,87,174,3,1,669,1504,24,582,1330,21,27.875,<=30,NZ,Away,After 1965
JM Anderson,ENG,Pace,2018-03-30,Christchurch,New Zealand,2018,2,113,300,5,1,933,2022,34,820,1722,29,27.441176470588236,<=30,NZ,Away,After 1965
JM Anderson,ENG,Pace,2018-05-24,Lord's,England,2018,2,94,174,4,1,631,1332,28,537,1158,24,22.535714285714285,<=30,ENG,Home,After 1965
JM Anderson,ENG,Pace,2018-06-01,Leeds,England,2018,2,78,150,5,1,552,1035,26,474,885,21,21.23076923076923,<=30,ENG,Home,After 1965
JM Anderson,ENG,Pace,2018-08-01,Birmingham,England,2018,2,91,228,4,1,700,1284,29,609,1056,25,24.137931034482758,<=30,ENG,Home,After 1965
JM Anderson,ENG,Pace,2018-08-09,Lord's,England,2018,2,43,152,9,1,483,867,26,440,715,17,18.576923076923077,<=30,ENG,Home,After 1965
JM Anderson,ENG,Pace,2018-08-18,Nottingham,England,2018,2,119,287,4,1,905,1711,32,786,1424,28,28.28125,<=30,ENG,Home,After 1965
JM Anderson,ENG,Pace,2018-08-30,Southampton,England,2018,2,83,174,2,1,624,1317,26,541,1143,24,24.0,<=30,ENG,Home,After 1965
JM Anderson,ENG,Pace,2018-09-07,The Oval,England,2018,2,99,261,5,1,781,1629,21,682,1368,16,37.19047619047619,>30,ENG,Home,After 1965
JM Anderson,ENG,Pace,2018-11-06,Galle,Sri Lanka,2018,2,53,132,1,1,225,432,6,172,300,5,37.5,>30,SL,Away,After 1965
JM Anderson,ENG,Pace,2018-11-14,Pallekele,Sri Lanka,2018,2,52,114,0,1,138,240,1,86,126,1,138.0,>30,SL,Away,After 1965
JM Anderson,ENG,Pace,2019-01-23,Bridgetown,West Indies,2019,2,104,288,5,1,635,1301,24,531,1013,19,26.458333333333332,<=30,WI,Away,After 1965
JM Anderson,ENG,Pace,2019-01-31,North Sound,West Indies,2019,2,83,181,2,1,523,1214,27,440,1033,25,19.37037037037037,<=30,WI,Away,After 1965
JM Anderson,ENG,Pace,2019-02-09,Gros Islet,West Indies,2019,2,58,120,3,1,684,1370,27,626,1250,24,25.333333333333332,<=30,WI,Away,After 1965
JM Anderson,ENG,Pace,2019-08-01,Birmingham,England,2019,1,1,24,0,1,758,1453,25,757,1429,25,30.32,>30,ENG,Home,After 1965
JM Anderson,ENG,Pace,2019-12-26,Centurion,South Africa,2019,2,116,198,2,1,888,1593,38,772,1395,36,23.36842105263158,<=30,SA,Away,After 1965
JM Anderson,ENG,Pace,2020-01-03,Cape Town,South Africa,2020,2,63,222,7,1,689,1635,31,626,1413,24,22.225806451612904,<=30,SA,Away,After 1965
JM Anderson,ENG,Pace,2020-07-08,Southampton,England,2020,2,104,240,3,1,825,1729,32,721,1489,29,25.78125,<=30,ENG,Home,After 1965
JM Anderson,ENG,Pace,2020-07-24,Manchester,England,2020,2,46,144,2,1,625,1206,27,579,1062,25,23.14814814814815,<=30,ENG,Home,After 1965
JM Anderson,ENG,Pace,2020-08-05,Manchester,England,2020,2,97,168,1,1,609,1268,24,512,1100,23,25.375,<=30,ENG,Home,After 1965
JM Anderson,ENG,Pace,2020-08-13,Southampton,England,2020,1,60,162,3,1,292,740,12,232,578,9,24.333333333333332,<=30,ENG,Home,After 1965
JM Anderson,ENG,Pace,2020-08-21,Southampton,England,2020,2,101,252,7,1,619,1361,14,518,1109,7,44.214285714285715,>30,ENG,Home,After 1965
JM Anderson,ENG,Pace,2021-01-22,Galle,Sri Lanka,2021,2,46,186,6,1,261,633,10,215,447,4,26.1,<=30,SL,Away,After 1965
JM Anderson,ENG,Pace,2021-02-05,Chennai,India,2021,2,63,167,5,1,376,864,16,313,697,11,23.5,<=30,IND,Away,After 1965
JM Anderson,ENG,Pace,2021-02-24,Ahmedabad,India,2021,1,20,78,0,1,124,228,2,104,150,2,62.0,>30,IND,Away,After 1965
JM Anderson,ENG,Pace,2021-03-04,Ahmedabad,India,2021,1,44,150,3,1,213,478,9,169,328,6,23.666666666666668,<=30,IND,Away,After 1965
JM Anderson,ENG,Pace,2021-06-02,Lord's,England,2021,2,127,261,2,1,792,1822,27,665,1561,25,29.333333333333332,<=30,ENG,Home,After 1965
JM Anderson,ENG,Pace,2021-06-10,Birmingham,England,2021,2,79,204,1,1,672,1387,27,593,1183,26,24.88888888888889,<=30,ENG,Home,After 1965
JM Anderson,ENG,Pace,2021-08-04,Nottingham,England,2021,2,66,168,4,1,737,1406,30,671,1238,26,24.566666666666666,<=30,ENG,Home,After 1965
JM Anderson,ENG,Pace,2021-08-12,Lord's,England,2021,2,115,327,5,1,917,2031,34,802,1704,29,26.970588235294116,<=30,ENG,Home,After 1965
JM Anderson,ENG,Pace,2021-08-25,Leeds,England,2021,2,69,204,4,1,610,1311,27,541,1107,23,22.59259259259259,<=30,ENG,Home,After 1965
JM Anderson,ENG,Pace,2021-09-02,The Oval,England,2021,2,120,282,2,1,900,1837,30,780,1555,28,30.0,<=30,ENG,Home,After 1965
JM Anderson,ENG,Pace,2021-12-16,Adelaide,Australia,2021,2,66,234,3,1,845,1824,27,779,1590,24,31.296296296296298,>30,AUS,Away,After 1965
JM Anderson,ENG,Pace,2021-12-26,Melbourne,Australia,2021,1,33,138,4,1,423,909,26,390,771,22,16.26923076923077,<=30,AUS,Away,After 1965
JM Anderson,ENG,Pace,2022-01-05,Sydney,Australia,2022,2,88,252,1,1,798,1621,23,710,1369,22,34.69565217391305,>30,AUS,Away,After 1965
JM Anderson,ENG,Pace,2022-06-02,Lord's,England,2022,2,123,222,6,1,722,1408,33,599,1186,27,21.87878787878788,<=30,ENG,Home,After 1965
JM Anderson,ENG,Pace,2022-06-10,Nottingham,England,2022,2,82,214,5,1,1254,1921,26,1172,1707,21,48.23076923076923,>30,ENG,Home,After 1965
JM Anderson,ENG,Pace,2022-07-01,Birmingham,England,2022,2,106,245,6,1,1049,1525,30,943,1280,24,34.96666666666667,>30,ENG,Home,After 1965
JM Anderson,ENG,Pace,2022-08-17,Lord's,England,2022,1,51,108,1,1,531,875,27,480,767,26,19.666666666666668,<=30,ENG,Home,After 1965
JM Anderson,ENG,Pace,2022-08-25,Manchester,England,2022,2,62,180,6,1,514,991,25,452,811,19,20.56,<=30,ENG,Home,After 1965
JM Anderson,ENG,Pace,2022-09-08,The Oval,England,2022,2,53,140,3,1,547,897,31,494,757,28,17.64516129032258,<=30,ENG,Home,After 1965
JM Anderson,ENG,Pace,2022-12-01,Rawalpindi,Pakistan,2022,2,88,276,5,1,786,1181,21,698,905,16,37.42857142857143,>30,PAK,Away,After 1965
JM Anderson,ENG,Pace,2022-12-09,Multan,Pakistan,2022,2,60,126,3,1,291,582,12,231,456,9,24.25,<=30,PAK,Away,After 1965
JM Anderson,ENG,Pace,2023-02-16,Mount Maunganui,New Zealand,2023,2,54,164,7,1,901,1216,34,847,1052,27,26.5,<=30,NZ,Away,After 1965
JM Anderson,ENG,Pace,2023-02-24,Wellington,New Zealand,2023,2,114,222,3,1,965,1553,25,851,1331,22,38.6,>30,NZ,Away,After 1965
JM Anderson,ENG,Pace,2023-06-16,Birmingham,England,2023,2,109,228,1,1,808,1386,24,699,1158,23,33.666666666666664,>30,ENG,Home,After 1965
JM Anderson,ENG,Pace,2023-06-28,Lord's,England,2023,2,117,234,2,1,1187,1964,35,1070,1730,33,33.91428571428571,>30,ENG,Home,After 1965
JM Anderson,ENG,Pace,2023-07-19,Manchester,England,2023,2,81,222,1,1,889,1350,23,808,1128,22,38.65217391304348,>30,ENG,Home,After 1965
JM Anderson,ENG,Pace,2023-07-27,The Oval,England,2023,2,120,240,1,1,971,1598,29,851,1358,28,33.48275862068966,>30,ENG,Home,After 1965
JM Anderson,ENG,Pace,2024-02-02,Visakhapatnam,India,2024,2,76,210,5,1,237,481,15,161,271,10,15.8,<=30,IND,Away,After 1965
JM Anderson,ENG,Pace,2024-02-15,Rajkot,India,2024,2,139,228,1,1,471,750,11,332,522,10,42.81818181818182,>30,IND,Away,After 1965
JM Anderson,ENG,Pace,2024-02-23,Ranchi,India,2024,2,60,126,2,1,291,444,7,231,318,5,41.57142857142857,>30,IND,Away,After 1965
JM Anderson,ENG,Pace,2024-03-07,Dharamsala,India,2024,1,60,96,2,1,287,408,5,227,312,3,57.4,>30,IND,Away,After 1965
JM Anderson,ENG,Pace,2024-07-10,Lord's,England,2024,2,58,160,4,1,552,962,27,494,802,23,20.444444444444443,<=30,ENG,Home,After 1965
JM Bird,AUS,Pace,2012-12-26,Melbourne,Australia,2012,2,61,132,4,1,518,864,21,457,732,17,24.666666666666668,<=30,AUS,Home,Upto 2014
JM Bird,AUS,Pace,2013-01-03,Sydney,Australia,2013,2,117,246,7,1,729,1200,20,612,954,13,36.45,>30,AUS,Home,Upto 2014
JM Bird,AUS,Pace,2013-08-09,Chester-le-Street,England,2013,2,125,255,2,1,823,1578,29,698,1323,27,28.379310344827587,<=30,ENG,Away,Upto 2014
JM Bird,AUS,Pace,2016-02-12,Wellington,New Zealand,2016,2,103,174,1,1,769,1383,21,666,1209,20,36.61904761904762,>30,NZ,Away,After 1965
JM Bird,AUS,Pace,2016-02-20,Christchurch,New Zealand,2016,2,125,191,7,1,1247,2076,29,1122,1885,22,43.0,>30,NZ,Away,After 1965
JM Bird,AUS,Pace,2016-11-24,Adelaide,Australia,2016,2,111,216,3,1,686,1407,24,575,1191,21,28.583333333333332,<=30,AUS,Home,After 1965
JM Bird,AUS,Pace,2016-12-15,Brisbane,Australia,2016,2,133,270,6,1,820,1566,28,687,1296,22,29.285714285714285,<=30,AUS,Home,After 1965
JM Bird,AUS,Pace,2016-12-26,Melbourne,Australia,2016,2,159,270,4,1,778,1397,19,619,1127,15,40.94736842105263,>30,AUS,Home,After 1965
JM Bird,AUS,Pace,2017-12-26,Melbourne,Australia,2017,1,108,180,0,1,816,1807,20,708,1627,20,40.8,>30,AUS,Home,After 1965
JM Blanckenberg,SA,Pace,1913-12-13,Durban,South Africa,1913,1,46,126,1,1,479,1054,20,433,928,19,23.95,<=30,SA,Home,Upto 2014
JM Blanckenberg,SA,Pace,1913-12-26,Johannesburg,South Africa,1913,1,83,228,5,1,455,1029,24,372,801,19,18.958333333333332,<=30,SA,Home,Upto 2014
JM Blanckenberg,SA,Pace,1914-01-01,Johannesburg,South Africa,1914,2,120,262,6,1,545,1214,22,425,952,16,24.772727272727273,<=30,SA,Home,Upto 2014
JM Blanckenberg,SA,Pace,1914-02-14,Durban,South Africa,1914,2,78,210,5,1,410,971,20,332,761,15,20.5,<=30,SA,Home,Upto 2014
JM Blanckenberg,SA,Pace,1914-02-27,Gqeberha,South Africa,1914,1,101,204,2,1,418,956,19,317,752,17,22.0,<=30,SA,Home,Upto 2014
JM Blanckenberg,SA,Pace,1921-11-05,Durban,South Africa,1921,2,178,328,7,1,645,1385,24,467,1057,17,26.875,<=30,SA,Home,Upto 2014
JM Blanckenberg,SA,Pace,1921-11-12,Johannesburg,South Africa,1921,1,105,126,1,1,791,1453,15,686,1327,14,52.733333333333334,>30,SA,Home,Upto 2014
JM Blanckenberg,SA,Pace,1921-11-26,Cape Town,South Africa,1921,1,82,186,4,1,368,882,11,286,696,7,33.45454545454545,>30,SA,Home,Upto 2014
JM Blanckenberg,SA,Pace,1922-12-23,Johannesburg,South Africa,1922,2,135,281,9,1,634,1476,30,499,1195,21,21.133333333333333,<=30,SA,Home,Upto 2014
JM Blanckenberg,SA,Pace,1923-01-01,Cape Town,South Africa,1923,2,117,289,6,1,417,1260,23,300,971,17,18.130434782608695,<=30,SA,Home,Upto 2014
JM Blanckenberg,SA,Pace,1923-01-18,Durban,South Africa,1923,1,122,288,3,1,496,1373,16,374,1085,13,31.0,>30,SA,Home,Upto 2014
JM Blanckenberg,SA,Pace,1923-02-09,Johannesburg,South Africa,1923,2,124,354,3,1,723,1725,22,599,1371,19,32.86363636363637,>30,SA,Home,Upto 2014
JM Blanckenberg,SA,Pace,1923-02-16,Durban,South Africa,1923,2,115,298,4,1,724,2332,33,609,2034,29,21.939393939393938,<=30,SA,Home,Upto 2014
JM Blanckenberg,SA,Pace,1924-06-14,Birmingham,England,1924,1,95,192,2,1,406,735,19,311,543,17,21.36842105263158,<=30,ENG,Away,Upto 2014
JM Blanckenberg,SA,Pace,1924-06-28,Lord's,England,1924,1,113,168,0,1,434,750,7,321,582,7,62.0,>30,ENG,Away,Upto 2014
JM Blanckenberg,SA,Pace,1924-07-12,Leeds,England,1924,2,81,132,2,1,303,630,5,222,498,3,60.6,>30,ENG,Away,Upto 2014
JM Blanckenberg,SA,Pace,1924-08-16,The Oval,England,1924,1,122,216,0,1,298,576,2,176,360,2,149.0,>30,ENG,Away,Upto 2014
JM Ghorpade,IND,Spin,1953-02-19,Port of Spain,West Indies,1953,2,70,96,0,1,777,2186,14,707,2090,14,55.5,>30,WI,Away,Upto 2014
JM Ghorpade,IND,Spin,1953-03-28,Kingston,West Indies,1953,1,22,36,0,1,921,2154,20,899,2118,20,46.05,>30,WI,Away,Upto 2014
JM Ghorpade,IND,Spin,1955-12-28,Eden Gardens,India,1955,1,17,6,0,1,462,1292,19,445,1286,19,24.31578947368421,<=30,IND,Home,Upto 2014
JM Ghorpade,IND,Spin,1958-12-31,Eden Gardens,India,1958,1,22,12,0,1,513,906,7,491,894,7,73.28571428571429,>30,IND,Home,Upto 2014
JM Gregory,AUS,Pace,1920-12-17,Sydney,Australia,1920,2,126,337,6,1,483,1134,15,357,797,9,32.2,>30,AUS,Home,Upto 2014
JM Gregory,AUS,Pace,1920-12-31,Melbourne,Australia,1920,2,101,192,8,1,456,894,15,355,702,7,30.4,>30,AUS,Home,Upto 2014
JM Gregory,AUS,Pace,1921-01-14,Adelaide,Australia,1921,2,158,336,5,1,770,1488,14,612,1152,9,55.0,>30,AUS,Home,Upto 2014
JM Gregory,AUS,Pace,1921-02-11,Melbourne,Australia,1921,2,92,192,1,1,517,1056,6,425,864,5,86.16666666666667,>30,AUS,Home,Upto 2014
JM Gregory,AUS,Pace,1921-02-25,Sydney,Australia,1921,2,79,193,3,1,315,721,13,236,528,10,24.23076923076923,<=30,AUS,Home,Upto 2014
JM Gregory,AUS,Pace,1921-05-28,Nottingham,England,1921,2,103,246,8,1,251,658,20,148,412,12,12.55,<=30,ENG,Away,Upto 2014
JM Gregory,AUS,Pace,1921-06-11,Lord's,England,1921,2,127,254,5,1,453,764,17,326,510,12,26.647058823529413,<=30,ENG,Away,Upto 2014
JM Gregory,AUS,Pace,1921-07-02,Leeds,England,1921,2,102,210,4,1,408,703,13,306,493,9,31.384615384615383,>30,ENG,Away,Upto 2014
JM Gregory,AUS,Pace,1921-07-23,Manchester,England,1921,1,79,138,1,1,286,546,3,207,408,2,95.33333333333333,>30,ENG,Away,Upto 2014
JM Gregory,AUS,Pace,1921-08-13,The Oval,England,1921,2,141,246,1,1,511,912,11,370,666,10,46.45454545454545,>30,ENG,Away,Upto 2014
JM Gregory,AUS,Pace,1921-11-05,Durban,South Africa,1921,2,105,265,8,1,645,1385,24,540,1120,16,26.875,<=30,SA,Away,Upto 2014
JM Gregory,AUS,Pace,1921-11-12,Johannesburg,South Africa,1921,2,139,285,7,1,791,1453,15,652,1168,8,52.733333333333334,>30,SA,Away,Upto 2014
JM Gregory,AUS,Pace,1921-11-26,Cape Town,South Africa,1921,2,40,144,0,1,368,882,11,328,738,11,33.45454545454545,>30,SA,Away,Upto 2014
JM Gregory,AUS,Pace,1924-12-19,Sydney,Australia,1924,2,226,455,7,1,590,1278,15,364,823,8,39.333333333333336,>30,AUS,Home,Upto 2014
JM Gregory,AUS,Pace,1925-01-01,Melbourne,Australia,1925,2,211,491,7,1,573,1360,13,362,869,6,44.07692307692308,>30,AUS,Home,Upto 2014
JM Gregory,AUS,Pace,1925-01-16,Adelaide,Australia,1925,2,182,394,5,1,326,857,11,144,463,6,29.636363636363637,<=30,AUS,Home,Upto 2014
JM Gregory,AUS,Pace,1925-02-13,Melbourne,Australia,1925,1,102,176,0,1,305,712,6,203,536,6,50.833333333333336,>30,AUS,Home,Upto 2014
JM Gregory,AUS,Pace,1925-02-27,Sydney,Australia,1925,2,95,152,3,1,265,608,9,170,456,6,29.444444444444443,<=30,AUS,Home,Upto 2014
JM Gregory,AUS,Pace,1926-06-12,Nottingham,England,1926,1,18,48,0,1,18,48,0,0,0,0,inf,>30,ENG,Away,Upto 2014
JM Gregory,AUS,Pace,1926-06-26,Lord's,England,1926,1,125,180,0,1,441,942,8,316,762,8,55.125,>30,ENG,Away,Upto 2014
JM Gregory,AUS,Pace,1926-07-10,Leeds,England,1926,2,49,138,0,1,205,438,2,156,300,2,102.5,>30,ENG,Away,Upto 2014
JM Gregory,AUS,Pace,1926-07-24,Manchester,England,1926,1,17,66,0,1,147,468,4,130,402,4,36.75,>30,ENG,Away,Upto 2014
JM Gregory,AUS,Pace,1926-08-14,The Oval,England,1926,2,89,198,3,1,263,687,10,174,489,7,26.3,<=30,ENG,Away,Upto 2014
JM Gregory,AUS,Pace,1928-11-30,Brisbane,Australia,1928,1,142,246,3,1,486,1018,12,344,772,9,40.5,>30,AUS,Home,Upto 2014
JM Holland,AUS,Spin,2016-08-04,Galle,Sri Lanka,2016,2,133,150,2,1,555,873,24,422,723,22,23.125,<=30,SL,Away,After 1965
JM Holland,AUS,Spin,2016-08-13,Colombo (SSC),Sri Lanka,2016,2,141,342,3,1,860,1808,28,719,1466,25,30.714285714285715,>30,SL,Away,After 1965
JM Holland,AUS,Spin,2018-10-07,Dubai (DICS),UAE,2018,2,209,294,4,1,793,1735,21,584,1441,17,37.76190476190476,>30,UAE,Away,After 1965
JM Holland,AUS,Spin,2018-10-16,Abu Dhabi,UAE,2018,2,91,174,0,1,566,1108,20,475,934,20,28.3,<=30,UAE,Away,After 1965
JM How,NZ,Spin,2008-05-23,Manchester,England,2008,1,4,6,0,1,323,648,13,319,642,13,24.846153846153847,<=30,ENG,Away,Upto 2014
JM How,NZ,Spin,2009-03-26,Napier,New Zealand,2009,1,0,6,0,1,685,1306,9,685,1300,9,76.11111111111111,>30,NZ,Home,Upto 2014
JM Kemp,SA,Pace,2001-01-20,Centurion,South Africa,2001,2,52,107,5,1,628,1061,26,576,954,21,24.153846153846153,<=30,SA,Home,Upto 2014
JM Kemp,SA,Pace,2001-04-06,St John's,West Indies,2001,2,24,84,2,1,374,1261,23,350,1177,21,16.26086956521739,<=30,WI,Away,Upto 2014
JM Kemp,SA,Pace,2001-04-19,Kingston,West Indies,2001,2,75,204,1,1,641,1770,33,566,1566,32,19.424242424242426,<=30,WI,Away,Upto 2014
JM Kemp,SA,Pace,2005-12-16,W.A.C.A,Australia,2005,2,71,84,1,1,1099,2050,27,1028,1966,26,40.7037037037037,>30,AUS,Away,Upto 2014
JM Mennie,AUS,Pace,2016-11-12,Hobart,Australia,2016,1,85,168,1,1,477,1007,29,392,839,28,16.448275862068964,<=30,AUS,Home,After 1965
JM Neblett,WI,Spin,1935-02-14,Georgetown,West Indies,1935,2,75,216,1,1,339,996,16,264,780,15,21.1875,<=30,WI,Home,Upto 2014
JM Noreiga,WI,Spin,1971-02-18,Kingston,West Indies,1971,1,69,186,1,1,757,1901,17,688,1715,16,44.529411764705884,>30,WI,Home,Upto 2014
JM Noreiga,WI,Spin,1971-03-06,Port of Spain,West Indies,1971,2,131,406,9,1,708,1890,29,577,1484,20,24.413793103448278,<=30,WI,Home,Upto 2014
JM Noreiga,WI,Spin,1971-03-19,Georgetown,West Indies,1971,2,121,312,1,1,785,2232,14,664,1920,13,56.07142857142857,>30,WI,Home,Upto 2014
JM Noreiga,WI,Spin,1971-04-13,Port of Spain,West Indies,1971,2,172,418,6,1,963,2470,24,791,2052,18,40.125,>30,WI,Home,Upto 2014
JM Parker,NZ,Spin,1976-02-05,Christchurch,New Zealand,1976,1,24,40,1,1,255,744,3,231,704,2,85.0,>30,NZ,Home,Upto 2014
JM Parks,ENG,Spin,1964-02-15,Kanpur,India,1964,1,43,36,1,1,987,2874,18,944,2838,17,54.833333333333336,>30,IND,Away,Upto 2014
JM Parks,ENG,Spin,1966-02-25,Christchurch,New Zealand,1966,1,8,18,0,1,245,648,5,237,630,5,49.0,>30,NZ,Away,Upto 2014
JM Patel,IND,Spin,1955-02-26,Karachi,Pakistan,1955,2,72,240,3,1,327,894,7,255,654,4,46.714285714285715,>30,PAK,Away,Upto 2014
JM Patel,IND,Spin,1956-01-06,Chennai,India,1956,2,91,378,4,1,610,1887,20,519,1509,16,30.5,>30,IND,Home,Upto 2014
JM Patel,IND,Spin,1956-10-19,Chennai,India,1956,1,36,84,1,1,458,1218,19,422,1134,18,24.105263157894736,<=30,IND,Home,Upto 2014
JM Patel,IND,Spin,1956-10-26,Brabourne,India,1956,1,111,234,2,1,685,1650,12,574,1416,10,57.083333333333336,>30,IND,Home,Upto 2014
JM Patel,IND,Spin,1959-12-19,Kanpur,India,1959,2,124,369,14,1,496,1305,26,372,936,12,19.076923076923077,<=30,IND,Home,Upto 2014
JM Patel,IND,Spin,1960-01-13,Chennai,India,1960,1,84,222,2,1,351,1231,17,267,1009,15,20.647058823529413,<=30,IND,Home,Upto 2014
JM Patel,IND,Spin,1960-01-23,Eden Gardens,India,1960,2,119,198,3,1,425,1054,13,306,856,10,32.69230769230769,>30,IND,Home,Upto 2014
JM Sims,ENG,Spin,1935-07-13,Leeds,England,1935,2,68,216,1,1,260,741,11,192,525,10,23.636363636363637,<=30,ENG,Home,Upto 2014
JM Sims,ENG,Spin,1936-08-15,The Oval,England,1936,2,168,263,7,1,349,695,12,181,432,5,29.083333333333332,<=30,ENG,Home,Upto 2014
JM Sims,ENG,Spin,1936-12-18,Sydney,Australia,1936,2,100,152,1,1,468,1160,7,368,1008,6,66.85714285714286,>30,AUS,Away,Upto 2014
JM Sims,ENG,Spin,1937-01-01,Melbourne,Australia,1937,2,144,256,2,1,614,1405,21,470,1149,19,29.238095238095237,<=30,AUS,Away,Upto 2014
JM Taylor,AUS,Spin,1921-07-23,Manchester,England,1921,1,1,6,0,1,239,952,12,238,946,12,19.916666666666668,<=30,ENG,Away,Upto 2014
JM Taylor,AUS,Spin,1921-08-13,The Oval,England,1921,1,25,42,1,1,509,810,8,484,768,7,63.625,>30,ENG,Away,Upto 2014
JM Taylor,AUS,Spin,1921-11-12,Johannesburg,South Africa,1921,1,19,66,0,1,332,785,12,313,719,12,27.666666666666668,<=30,SA,Away,Upto 2014
JM Vince,ENG,Pace,2016-05-19,Leeds,England,2016,1,10,6,0,1,468,901,27,458,895,27,17.333333333333332,<=30,ENG,Home,After 1965
JM Vince,ENG,Pace,2016-05-27,Chester-le-Street,England,2016,1,0,6,0,1,773,1433,25,773,1427,25,30.92,>30,ENG,Home,After 1965
JM Vince,ENG,Pace,2016-07-14,Lord's,England,2016,1,1,6,0,1,760,1521,27,759,1515,27,28.14814814814815,<=30,ENG,Home,After 1965
JM Vince,ENG,Pace,2016-08-03,Birmingham,England,2016,1,2,6,0,1,912,1860,29,910,1854,29,31.448275862068964,>30,ENG,Home,After 1965
JM Wiener,AUS,Spin,1979-12-14,W.A.C.A,Australia,1979,1,22,48,0,1,247,666,5,225,618,5,49.4,>30,AUS,Home,Upto 2014
JM Wiener,AUS,Spin,1980-03-06,Faisalabad,Pakistan,1980,1,19,30,0,1,592,1272,6,573,1242,6,98.66666666666667,>30,PAK,Away,Upto 2014
JN Crawford,ENG,Spin,1906-01-02,Johannesburg,South Africa,1906,2,63,144,2,1,455,1132,23,392,988,21,19.782608695652176,<=30,SA,Away,Upto 2014
JN Crawford,ENG,Spin,1906-03-06,Johannesburg,South Africa,1906,2,48,78,2,1,287,726,15,239,648,13,19.133333333333333,<=30,SA,Away,Upto 2014
JN Crawford,ENG,Spin,1906-03-10,Johannesburg,South Africa,1906,2,68,102,0,1,622,1254,10,554,1152,10,62.2,>30,SA,Away,Upto 2014
JN Crawford,ENG,Spin,1906-03-24,Cape Town,South Africa,1906,2,74,171,2,1,339,907,20,265,736,18,16.95,<=30,SA,Away,Upto 2014
JN Crawford,ENG,Spin,1906-03-30,Cape Town,South Africa,1906,1,69,108,3,1,364,776,15,295,668,12,24.266666666666666,<=30,SA,Away,Upto 2014
JN Crawford,ENG,Spin,1907-07-01,Lord's,England,1907,2,39,72,0,1,478,962,15,439,890,15,31.866666666666667,>30,ENG,Home,Upto 2014
JN Crawford,ENG,Spin,1907-08-19,The Oval,England,1907,2,47,102,0,1,462,1059,21,415,957,21,22.0,<=30,ENG,Home,Upto 2014
JN Crawford,ENG,Spin,1907-12-13,Sydney,Australia,1907,2,47,78,2,1,592,1308,17,545,1230,15,34.8235294117647,>30,AUS,Away,Upto 2014
JN Crawford,ENG,Spin,1908-01-01,Melbourne,Australia,1908,2,204,372,8,1,799,1914,21,595,1542,13,38.04761904761905,>30,AUS,Away,Upto 2014
JN Crawford,ENG,Spin,1908-01-10,Adelaide,Australia,1908,2,178,359,4,1,776,1611,17,598,1252,13,45.64705882352941,>30,AUS,Away,Upto 2014
JN Crawford,ENG,Spin,1908-02-07,Melbourne,Australia,1908,2,120,293,8,1,481,1034,24,361,741,16,20.041666666666668,<=30,AUS,Away,Upto 2014
JN Crawford,ENG,Spin,1908-02-21,Sydney,Australia,1908,2,193,324,8,1,812,1824,30,619,1500,22,27.066666666666666,<=30,AUS,Away,Upto 2014
JN Gillespie,AUS,Pace,1996-11-29,Sydney,Australia,1996,2,89,180,2,1,754,1620,23,665,1440,21,32.78260869565217,>30,AUS,Home,Upto 2014
JN Gillespie,AUS,Pace,1996-12-26,Melbourne,Australia,1996,1,5,18,0,1,553,1299,28,548,1281,28,19.75,<=30,AUS,Home,Upto 2014
JN Gillespie,AUS,Pace,1997-02-28,Johannesburg,South Africa,1997,2,90,168,2,1,660,1282,14,570,1114,12,47.142857142857146,>30,SA,Away,Upto 2014
JN Gillespie,AUS,Pace,1997-03-14,Gqeberha,South Africa,1997,2,103,246,8,1,528,1387,24,425,1141,16,22.0,<=30,SA,Away,Upto 2014
JN Gillespie,AUS,Pace,1997-03-21,Centurion,South Africa,1997,2,94,208,4,1,500,1229,28,406,1021,24,17.857142857142858,<=30,SA,Away,Upto 2014
JN Gillespie,AUS,Pace,1997-06-05,Birmingham,England,1997,1,48,60,1,1,837,1443,24,789,1383,23,34.875,>30,ENG,Away,Upto 2014
JN Gillespie,AUS,Pace,1997-07-03,Manchester,England,1997,2,70,156,3,1,664,1429,26,594,1273,23,25.53846153846154,<=30,ENG,Away,Upto 2014
JN Gillespie,AUS,Pace,1997-07-24,Leeds,England,1997,2,102,220,9,1,800,1403,28,698,1183,19,28.571428571428573,<=30,ENG,Away,Upto 2014
JN Gillespie,AUS,Pace,1997-08-07,Nottingham,England,1997,2,112,114,3,1,974,1617,31,862,1503,28,31.419354838709676,>30,ENG,Away,Upto 2014
JN Gillespie,AUS,Pace,1998-11-28,W.A.C.A,Australia,1998,2,111,134,7,1,564,1246,31,453,1112,24,18.193548387096776,<=30,AUS,Home,Upto 2014
JN Gillespie,AUS,Pace,1999-03-05,Port of Spain,West Indies,1999,2,52,127,4,1,566,1392,32,514,1265,28,17.6875,<=30,WI,Away,Upto 2014
JN Gillespie,AUS,Pace,1999-03-13,Kingston,West Indies,1999,1,79,198,1,1,494,1032,18,415,834,17,27.444444444444443,<=30,WI,Away,Upto 2014
JN Gillespie,AUS,Pace,1999-03-26,Bridgetown,West Indies,1999,2,110,325,6,1,815,1748,29,705,1423,23,28.103448275862068,<=30,WI,Away,Upto 2014
JN Gillespie,AUS,Pace,1999-09-09,Kandy,Sri Lanka,1999,1,43,72,0,1,252,546,11,209,474,11,22.90909090909091,<=30,SL,Away,Upto 2014
JN Gillespie,AUS,Pace,2000-12-01,W.A.C.A,Australia,2000,2,72,144,4,1,637,1158,23,565,1014,19,27.695652173913043,<=30,AUS,Home,Upto 2014
JN Gillespie,AUS,Pace,2000-12-15,Adelaide,Australia,2000,2,107,270,5,1,620,1329,20,513,1059,15,31.0,>30,AUS,Home,Upto 2014
JN Gillespie,AUS,Pace,2000-12-26,Melbourne,Australia,2000,2,88,210,9,1,686,1407,27,598,1197,18,25.40740740740741,<=30,AUS,Home,Upto 2014
JN Gillespie,AUS,Pace,2001-01-02,Sydney,Australia,2001,2,101,222,2,1,570,1068,13,469,846,11,43.84615384615385,>30,AUS,Home,Upto 2014
JN Gillespie,AUS,Pace,2001-02-27,Wankhede,India,2001,2,95,207,5,1,373,790,15,278,583,10,24.866666666666667,<=30,IND,Away,Upto 2014
JN Gillespie,AUS,Pace,2001-03-11,Eden Gardens,India,2001,2,162,252,4,1,800,1488,16,638,1236,12,50.0,>30,IND,Away,Upto 2014
JN Gillespie,AUS,Pace,2001-03-18,Chennai,India,2001,2,137,300,4,1,331,733,10,194,433,6,33.1,>30,IND,Away,Upto 2014
JN Gillespie,AUS,Pace,2001-07-05,Birmingham,England,2001,2,119,168,5,1,685,933,19,566,765,14,36.05263157894737,>30,ENG,Away,Upto 2014
JN Gillespie,AUS,Pace,2001-07-19,Lord's,England,2001,2,109,204,7,1,636,1130,28,527,926,21,22.714285714285715,<=30,ENG,Away,Upto 2014
JN Gillespie,AUS,Pace,2001-08-02,Nottingham,England,2001,2,120,192,5,1,583,930,24,463,738,19,24.291666666666668,<=30,ENG,Away,Upto 2014
JN Gillespie,AUS,Pace,2001-08-16,Leeds,England,2001,2,170,288,2,1,1054,1608,26,884,1320,24,40.53846153846154,>30,ENG,Away,Upto 2014
JN Gillespie,AUS,Pace,2001-08-23,The Oval,England,2001,2,134,192,0,1,586,1029,9,452,837,9,65.11111111111111,>30,ENG,Away,Upto 2014
JN Gillespie,AUS,Pace,2001-11-08,Brisbane,Australia,2001,2,104,160,3,1,871,1428,20,767,1268,17,43.55,>30,AUS,Home,Upto 2014
JN Gillespie,AUS,Pace,2001-11-22,Hobart,Australia,2001,1,45,168,3,1,554,972,8,509,804,5,69.25,>30,AUS,Home,Upto 2014
JN Gillespie,AUS,Pace,2001-11-30,W.A.C.A,Australia,2001,2,167,342,5,1,1026,1787,22,859,1445,17,46.63636363636363,>30,AUS,Home,Upto 2014
JN Gillespie,AUS,Pace,2001-12-14,Adelaide,Australia,2001,2,80,204,2,1,773,1644,20,693,1440,18,38.65,>30,AUS,Home,Upto 2014
JN Gillespie,AUS,Pace,2002-02-22,Johannesburg,South Africa,2002,2,71,114,3,1,698,1059,20,627,945,17,34.9,>30,SA,Away,Upto 2014
JN Gillespie,AUS,Pace,2002-03-08,Cape Town,South Africa,2002,2,133,264,4,1,927,1517,20,794,1253,16,46.35,>30,SA,Away,Upto 2014
JN Gillespie,AUS,Pace,2002-03-15,Durban,South Africa,2002,2,83,174,1,1,733,1239,21,650,1065,20,34.904761904761905,>30,SA,Away,Upto 2014
JN Gillespie,AUS,Pace,2002-10-03,Colombo (PSS),Sri Lanka,2002,2,117,213,3,1,672,1175,21,555,962,18,32.0,>30,SL,Away,Upto 2014
JN Gillespie,AUS,Pace,2002-11-07,Brisbane,Australia,2002,2,64,144,3,1,677,1218,20,613,1074,17,33.85,>30,AUS,Home,Upto 2014
JN Gillespie,AUS,Pace,2002-11-21,Adelaide,Australia,2002,2,122,233,5,1,643,1143,16,521,910,11,40.1875,>30,AUS,Home,Upto 2014
JN Gillespie,AUS,Pace,2002-11-29,W.A.C.A,Australia,2002,2,78,194,3,1,590,1095,16,512,901,13,36.875,>30,AUS,Home,Upto 2014
JN Gillespie,AUS,Pace,2002-12-26,Melbourne,Australia,2002,2,96,247,7,1,740,1406,19,644,1159,12,38.94736842105263,>30,AUS,Home,Upto 2014
JN Gillespie,AUS,Pace,2003-01-02,Sydney,Australia,2003,2,132,273,2,1,1004,1656,32,872,1383,30,31.375,>30,AUS,Home,Upto 2014
JN Gillespie,AUS,Pace,2003-04-10,Georgetown,West Indies,2003,2,79,194,6,1,811,1248,21,732,1054,15,38.61904761904762,>30,WI,Away,Upto 2014
JN Gillespie,AUS,Pace,2003-04-19,Port of Spain,West Indies,2003,2,86,272,6,1,913,1617,20,827,1345,14,45.65,>30,WI,Away,Upto 2014
JN Gillespie,AUS,Pace,2003-05-01,Bridgetown,West Indies,2003,2,68,294,4,1,652,1455,15,584,1161,11,43.46666666666667,>30,WI,Away,Upto 2014
JN Gillespie,AUS,Pace,2003-05-09,St John's,West Indies,2003,2,120,252,1,1,870,1573,29,750,1321,28,30.0,<=30,WI,Away,Upto 2014
JN Gillespie,AUS,Pace,2003-07-18,Darwin,Australia,2003,2,75,144,4,1,496,985,17,421,841,13,29.176470588235293,<=30,AUS,Home,Upto 2014
JN Gillespie,AUS,Pace,2003-07-25,Cairns,Australia,2003,2,95,226,7,1,637,1169,12,542,943,5,53.083333333333336,>30,AUS,Home,Upto 2014
JN Gillespie,AUS,Pace,2003-10-09,W.A.C.A,Australia,2003,2,58,171,5,1,658,1277,15,600,1106,10,43.86666666666667,>30,AUS,Home,Upto 2014
JN Gillespie,AUS,Pace,2003-12-04,Brisbane,Australia,2003,2,82,216,4,1,735,1213,18,653,997,14,40.833333333333336,>30,AUS,Home,Upto 2014
JN Gillespie,AUS,Pace,2003-12-12,Adelaide,Australia,2003,2,128,307,2,1,872,1501,19,744,1194,17,45.89473684210526,>30,AUS,Home,Upto 2014
JN Gillespie,AUS,Pace,2004-01-02,Sydney,Australia,2004,2,167,312,4,1,876,1379,11,709,1067,7,79.63636363636364,>30,AUS,Home,Upto 2014
JN Gillespie,AUS,Pace,2004-03-08,Galle,Sri Lanka,2004,2,81,222,1,1,256,624,5,175,402,4,51.2,>30,SL,Away,Upto 2014
JN Gillespie,AUS,Pace,2004-03-16,Kandy,Sri Lanka,2004,2,101,192,5,1,512,998,21,411,806,16,24.38095238095238,<=30,SL,Away,Upto 2014
JN Gillespie,AUS,Pace,2004-03-24,Colombo (SSC),Sri Lanka,2004,2,134,246,4,1,527,998,13,393,752,9,40.53846153846154,>30,SL,Away,Upto 2014
JN Gillespie,AUS,Pace,2004-07-01,Darwin,Australia,2004,2,55,156,2,1,425,1034,30,370,878,28,14.166666666666666,<=30,AUS,Home,Upto 2014
JN Gillespie,AUS,Pace,2004-07-09,Cairns,Australia,2004,2,155,334,5,1,844,1536,15,689,1202,10,56.266666666666666,>30,AUS,Home,Upto 2014
JN Gillespie,AUS,Pace,2004-10-06,Bengaluru,India,2004,2,96,186,5,1,461,1068,18,365,882,13,25.61111111111111,<=30,IND,Away,Upto 2014
JN Gillespie,AUS,Pace,2004-10-14,Chennai,India,2004,2,71,216,2,1,378,888,4,307,672,2,94.5,>30,IND,Away,Upto 2014
JN Gillespie,AUS,Pace,2004-10-26,Nagpur,India,2004,2,80,233,9,1,596,1196,23,516,963,14,25.91304347826087,<=30,IND,Away,Upto 2014
JN Gillespie,AUS,Pace,2004-11-03,Wankhede,India,2004,2,76,162,4,1,204,507,11,128,345,7,18.545454545454547,<=30,IND,Away,Upto 2014
JN Gillespie,AUS,Pace,2004-11-18,Brisbane,Australia,2004,2,103,234,3,1,723,1283,17,620,1049,14,42.529411764705884,>30,AUS,Home,Upto 2014
JN Gillespie,AUS,Pace,2004-11-26,Adelaide,Australia,2004,2,78,210,5,1,602,1087,15,524,877,10,40.13333333333333,>30,AUS,Home,Upto 2014
JN Gillespie,AUS,Pace,2004-12-16,W.A.C.A,Australia,2004,2,80,156,1,1,677,1213,30,597,1057,29,22.566666666666666,<=30,AUS,Home,Upto 2014
JN Gillespie,AUS,Pace,2004-12-26,Melbourne,Australia,2004,2,92,228,5,1,584,1094,18,492,866,13,32.44444444444444,>30,AUS,Home,Upto 2014
JN Gillespie,AUS,Pace,2005-01-02,Sydney,Australia,2005,2,86,164,1,1,541,846,9,455,682,8,60.111111111111114,>30,AUS,Home,Upto 2014
JN Gillespie,AUS,Pace,2005-03-10,Christchurch,New Zealand,2005,2,125,246,3,1,768,1398,17,643,1152,14,45.1764705882353,>30,NZ,Away,Upto 2014
JN Gillespie,AUS,Pace,2005-03-18,Wellington,New Zealand,2005,2,68,150,1,1,569,942,15,501,792,14,37.93333333333333,>30,NZ,Away,Upto 2014
JN Gillespie,AUS,Pace,2005-03-26,Auckland,New Zealand,2005,2,127,246,3,1,759,1379,20,632,1133,17,37.95,>30,NZ,Away,Upto 2014
JN Gillespie,AUS,Pace,2005-07-21,Lord's,England,2005,2,48,84,0,1,726,1256,32,678,1172,32,22.6875,<=30,ENG,Away,Upto 2014
JN Gillespie,AUS,Pace,2005-08-04,Birmingham,England,2005,2,115,180,2,1,817,1095,24,702,915,22,34.041666666666664,>30,ENG,Away,Upto 2014
JN Gillespie,AUS,Pace,2005-08-11,Manchester,England,2005,2,137,138,1,1,929,1432,27,792,1294,26,34.407407407407405,>30,ENG,Away,Upto 2014
JN Gillespie,AUS,Pace,2006-04-09,Fatullah,Bangladesh,2006,2,65,204,5,1,364,804,10,299,600,5,36.4,>30,BAN,Away,Upto 2014
JN Gillespie,AUS,Pace,2006-04-16,Chattogram,Bangladesh,2006,2,25,54,3,1,238,372,5,213,318,2,47.6,>30,BAN,Away,Upto 2014
JN Maguire,AUS,Pace,1983-12-26,Melbourne,Australia,1983,2,137,246,3,1,818,1728,17,681,1482,14,48.11764705882353,>30,AUS,Home,Upto 2014
JN Maguire,AUS,Pace,1984-04-07,St John's,West Indies,1984,1,121,264,3,1,745,1490,28,624,1226,25,26.607142857142858,<=30,WI,Away,Upto 2014
JN Maguire,AUS,Pace,1984-04-28,Kingston,West Indies,1984,2,65,106,4,1,537,1132,24,472,1026,20,22.375,<=30,WI,Away,Upto 2014
JN Rhodes,SA,Pace,1993-01-02,Cape Town,South Africa,1993,1,5,6,0,1,434,1582,19,429,1576,19,22.842105263157894,<=30,SA,Home,Upto 2014
JN Rhodes,SA,Pace,1994-03-25,Durban,South Africa,1994,1,0,6,0,1,810,2116,20,810,2110,20,40.5,>30,SA,Home,Upto 2014
JN Shepherd,WI,Pace,1969-06-12,Manchester,England,1969,1,104,353,5,1,490,1177,22,386,824,17,22.272727272727273,<=30,ENG,Away,Upto 2014
JN Shepherd,WI,Pace,1969-06-26,Lord's,England,1969,2,119,330,4,1,864,2111,25,745,1781,21,34.56,>30,ENG,Away,Upto 2014
JN Shepherd,WI,Pace,1969-07-10,Leeds,England,1969,1,43,144,3,1,581,1581,25,538,1437,22,23.24,<=30,ENG,Away,Upto 2014
JN Shepherd,WI,Pace,1971-04-01,Bridgetown,West Indies,1971,2,90,264,2,1,478,1042,14,388,778,12,34.142857142857146,>30,WI,Home,Upto 2014
JN Shepherd,WI,Pace,1971-04-13,Port of Spain,West Indies,1971,2,123,354,5,1,448,1056,11,325,702,6,40.72727272727273,>30,WI,Home,Upto 2014
JNT Seales,WI,Pace,2021-06-10,Gros Islet,West Indies,2021,1,75,126,3,1,458,958,27,383,832,24,16.962962962962962,<=30,WI,Home,After 1965
JNT Seales,WI,Pace,2021-06-18,Gros Islet,West Indies,2021,2,78,180,2,1,606,1318,31,528,1138,29,19.548387096774192,<=30,WI,Home,After 1965
JNT Seales,WI,Pace,2021-08-12,Kingston,West Indies,2021,2,125,190,8,1,661,1558,37,536,1368,29,17.864864864864863,<=30,WI,Home,After 1965
JNT Seales,WI,Pace,2021-08-20,Kingston,West Indies,2021,2,63,108,3,1,688,1393,29,625,1285,26,23.724137931034484,<=30,WI,Home,After 1965
JNT Seales,WI,Pace,2022-03-08,North Sound,West Indies,2022,2,136,210,4,1,832,1769,23,696,1559,19,36.17391304347826,>30,WI,Home,After 1965
JNT Seales,WI,Pace,2022-03-16,Bridgetown,West Indies,2022,2,89,180,3,1,744,1535,17,655,1355,14,43.76470588235294,>30,WI,Home,After 1965
JNT Seales,WI,Pace,2022-03-24,St George's,West Indies,2022,2,66,174,4,1,518,1435,27,452,1261,23,19.185185185185187,<=30,WI,Home,After 1965
JNT Seales,WI,Pace,2022-06-16,North Sound,West Indies,2022,2,78,144,3,1,515,1150,28,437,1006,25,18.392857142857142,<=30,WI,Home,After 1965
JNT Seales,WI,Pace,2022-06-24,Gros Islet,West Indies,2022,2,74,134,6,1,658,1090,26,584,956,20,25.307692307692307,<=30,WI,Home,After 1965
JNT Seales,WI,Pace,2022-11-30,Perth,Australia,2022,2,113,144,1,1,842,1610,13,729,1466,12,64.76923076923077,>30,AUS,Away,After 1965
JNT Seales,WI,Pace,2024-07-10,Lord's,England,2024,1,77,120,4,1,552,962,27,475,842,23,20.444444444444443,<=30,ENG,Away,After 1965
JNT Seales,WI,Pace,2024-07-18,Nottingham,England,2024,2,187,224,6,1,1038,1453,27,851,1229,21,38.44444444444444,>30,ENG,Away,After 1965
JNT Seales,WI,Pace,2024-07-26,Birmingham,England,2024,2,90,120,3,1,712,994,27,622,874,24,26.37037037037037,<=30,ENG,Away,After 1965
JNT Seales,WI,Pace,2024-08-07,Port of Spain,West Indies,2024,2,111,190,3,1,444,843,12,333,653,9,37.0,>30,WI,Home,After 1965
JNT Seales,WI,Pace,2024-08-15,Providence,West Indies,2024,2,106,196,9,1,482,1012,28,376,816,19,17.214285714285715,<=30,WI,Home,After 1965
JNT Seales,WI,Pace,2024-11-22,North Sound,West Indies,2024,2,87,180,5,1,670,1327,30,583,1147,25,22.333333333333332,<=30,WI,Home,After 1965
JNT Seales,WI,Pace,2024-11-30,Kingston,West Indies,2024,2,51,173,5,1,598,1162,33,547,989,28,18.12121212121212,<=30,WI,Home,After 1965
JNT Seales,WI,Pace,2025-01-17,Multan,Pakistan,2025,2,64,144,3,1,83,168,3,19,24,0,27.666666666666668,<=30,PAK,Away,After 1965
JO Holder,WI,Pace,2014-06-26,Bridgetown,West Indies,2014,2,50,120,2,1,620,1276,27,570,1156,25,22.962962962962962,<=30,WI,Home,After 1965
JO Holder,WI,Pace,2014-12-26,Gqeberha,South Africa,2014,1,43,132,1,1,464,870,12,421,738,11,38.666666666666664,>30,SA,Away,After 1965
JO Holder,WI,Pace,2015-01-02,Cape Town,South Africa,2015,2,106,174,2,1,670,1234,16,564,1060,14,41.875,>30,SA,Away,After 1965
JO Holder,WI,Pace,2015-04-13,North Sound,West Indies,2015,2,132,252,3,1,886,1696,22,754,1444,19,40.27272727272727,>30,WI,Home,After 1965
JO Holder,WI,Pace,2015-04-21,St George's,West Indies,2015,2,68,137,0,1,731,1499,18,663,1362,18,40.611111111111114,>30,WI,Home,After 1965
JO Holder,WI,Pace,2015-05-01,Bridgetown,West Indies,2015,2,49,150,5,1,388,896,26,339,746,21,14.923076923076923,<=30,WI,Home,After 1965
JO Holder,WI,Pace,2015-06-03,Roseau,West Indies,2015,1,30,84,1,1,402,941,20,372,857,19,20.1,<=30,WI,Home,After 1965
JO Holder,WI,Pace,2015-06-11,Kingston,West Indies,2015,2,88,192,2,1,528,1091,25,440,899,23,21.12,<=30,WI,Home,After 1965
JO Holder,WI,Pace,2015-10-14,Galle,Sri Lanka,2015,1,36,126,1,1,384,801,11,348,675,10,34.90909090909091,>30,SL,Away,After 1965
JO Holder,WI,Pace,2015-10-22,Colombo (PSS),Sri Lanka,2015,2,31,96,2,1,259,558,12,228,462,10,21.583333333333332,<=30,SL,Away,After 1965
JO Holder,WI,Pace,2015-12-10,Hobart,Australia,2015,1,75,144,0,1,634,903,16,559,759,16,39.625,>30,AUS,Away,After 1965
JO Holder,WI,Pace,2015-12-26,Melbourne,Australia,2015,2,96,198,2,1,837,1482,18,741,1284,16,46.5,>30,AUS,Away,After 1965
JO Holder,WI,Pace,2016-01-03,Sydney,Australia,2016,1,15,24,0,1,234,354,3,219,330,3,78.0,>30,AUS,Away,After 1965
JO Holder,WI,Pace,2016-07-21,North Sound,West Indies,2016,1,83,144,0,1,466,972,12,383,828,12,38.833333333333336,>30,WI,Home,After 1965
JO Holder,WI,Pace,2016-07-30,Kingston,West Indies,2016,1,72,206,1,1,509,984,9,437,778,8,56.55555555555556,>30,WI,Home,After 1965
JO Holder,WI,Pace,2016-08-09,Gros Islet,West Indies,2016,2,84,168,0,1,570,1190,26,486,1022,26,21.923076923076923,<=30,WI,Home,After 1965
JO Holder,WI,Pace,2016-10-13,Dubai (DICS),UAE,2016,2,85,174,1,1,642,1209,9,557,1035,8,71.33333333333333,>30,UAE,Away,After 1965
JO Holder,WI,Pace,2016-10-21,Abu Dhabi,UAE,2016,2,69,174,3,1,485,1009,16,416,835,13,30.3125,>30,UAE,Away,After 1965
JO Holder,WI,Pace,2016-10-30,Sharjah,UAE,2016,2,59,177,5,1,508,1019,20,449,842,15,25.4,<=30,UAE,Away,After 1965
JO Holder,WI,Pace,2017-04-21,Kingston,West Indies,2017,2,67,192,1,1,500,1200,21,433,1008,20,23.80952380952381,<=30,WI,Home,After 1965
JO Holder,WI,Pace,2017-04-30,Bridgetown,West Indies,2017,2,65,244,6,1,469,1258,27,404,1014,21,17.37037037037037,<=30,WI,Home,After 1965
JO Holder,WI,Pace,2017-05-10,Roseau,West Indies,2017,2,78,246,3,1,472,1494,20,394,1248,17,23.6,<=30,WI,Home,After 1965
JO Holder,WI,Pace,2017-08-17,Birmingham,England,2017,1,103,177,1,1,610,1081,19,507,904,18,32.10526315789474,>30,ENG,Away,After 1965
JO Holder,WI,Pace,2017-08-25,Leeds,England,2017,2,140,294,3,1,1027,1807,24,887,1513,21,42.791666666666664,>30,ENG,Away,After 1965
JO Holder,WI,Pace,2017-09-07,Lord's,England,2017,2,70,119,4,1,490,1083,30,420,964,26,16.333333333333332,<=30,ENG,Away,After 1965
JO Holder,WI,Pace,2017-10-21,Bulawayo,Zimbabwe,2017,2,55,156,2,1,377,855,10,322,699,8,37.7,>30,ZIM,Away,After 1965
JO Holder,WI,Pace,2017-10-29,Bulawayo,Zimbabwe,2017,2,91,228,1,1,339,949,11,248,721,10,30.818181818181817,>30,ZIM,Away,After 1965
JO Holder,WI,Pace,2017-12-01,Wellington,New Zealand,2017,1,102,204,1,1,782,1474,25,680,1270,24,31.28,>30,NZ,Away,After 1965
JO Holder,WI,Pace,2018-06-06,Port of Spain,West Indies,2018,2,39,126,2,1,624,1324,21,585,1198,19,29.714285714285715,<=30,WI,Home,After 1965
JO Holder,WI,Pace,2018-06-14,Gros Islet,West Indies,2018,2,94,174,1,1,739,1498,33,645,1324,32,22.393939393939394,<=30,WI,Home,After 1965
JO Holder,WI,Pace,2018-06-23,Bridgetown,West Indies,2018,2,60,182,9,1,501,1108,32,441,926,23,15.65625,<=30,WI,Home,After 1965
JO Holder,WI,Pace,2018-07-04,North Sound,West Indies,2018,2,40,118,5,1,363,699,24,323,581,19,15.125,<=30,WI,Home,After 1965
JO Holder,WI,Pace,2018-07-12,Kingston,West Indies,2018,2,103,139,11,1,360,661,22,257,522,11,16.363636363636363,<=30,WI,Home,After 1965
JO Holder,WI,Pace,2018-10-12,Hyderabad,India,2018,2,73,162,5,1,322,529,18,249,367,13,17.88888888888889,<=30,IND,Away,After 1965
JO Holder,WI,Pace,2019-01-23,Bridgetown,West Indies,2019,2,39,120,2,1,635,1301,24,596,1181,22,26.458333333333332,<=30,WI,Home,After 1965
JO Holder,WI,Pace,2019-01-31,North Sound,West Indies,2019,2,86,151,5,1,523,1214,27,437,1063,22,19.37037037037037,<=30,WI,Home,After 1965
JO Holder,WI,Pace,2019-08-22,North Sound,West Indies,2019,2,81,235,2,1,576,1302,29,495,1067,27,19.862068965517242,<=30,WI,Home,After 1965
JO Holder,WI,Pace,2019-08-30,Kingston,West Indies,2019,2,97,263,6,1,512,1121,25,415,858,19,20.48,<=30,WI,Home,After 1965
JO Holder,WI,Pace,2019-11-27,Lucknow,India,2019,2,42,139,5,1,112,277,5,70,138,0,22.4,<=30,IND,Away,After 1965
JO Holder,WI,Pace,2020-07-08,Southampton,England,2020,2,91,252,7,1,825,1729,32,734,1477,25,25.78125,<=30,ENG,Away,After 1965
JO Holder,WI,Pace,2020-07-16,Manchester,England,2020,2,103,216,1,1,747,1583,23,644,1367,22,32.47826086956522,>30,ENG,Away,After 1965
JO Holder,WI,Pace,2020-07-24,Manchester,England,2020,2,107,203,2,1,625,1206,27,518,1003,25,23.14814814814815,<=30,ENG,Away,After 1965
JO Holder,WI,Pace,2020-12-03,Hamilton,New Zealand,2020,1,60,186,0,1,725,1439,25,665,1253,25,29.0,<=30,NZ,Away,After 1965
JO Holder,WI,Pace,2020-12-11,Wellington,New Zealand,2020,1,85,162,0,1,834,1421,28,749,1259,28,29.785714285714285,<=30,NZ,Away,After 1965
JO Holder,WI,Pace,2021-03-21,North Sound,West Indies,2021,2,67,238,5,1,742,1672,25,675,1434,20,29.68,<=30,WI,Home,After 1965
JO Holder,WI,Pace,2021-03-29,North Sound,West Indies,2021,2,63,186,2,1,742,1513,23,679,1327,21,32.26086956521739,>30,WI,Home,After 1965
JO Holder,WI,Pace,2021-06-10,Gros Islet,West Indies,2021,1,75,125,4,1,458,958,27,383,833,23,16.962962962962962,<=30,WI,Home,After 1965
JO Holder,WI,Pace,2021-06-18,Gros Islet,West Indies,2021,2,71,192,2,1,606,1318,31,535,1126,29,19.548387096774192,<=30,WI,Home,After 1965
JO Holder,WI,Pace,2021-08-12,Kingston,West Indies,2021,2,62,201,4,1,661,1558,37,599,1357,33,17.864864864864863,<=30,WI,Home,After 1965
JO Holder,WI,Pace,2021-08-20,Kingston,West Indies,2021,2,73,174,4,1,688,1393,29,615,1219,25,23.724137931034484,<=30,WI,Home,After 1965
JO Holder,WI,Pace,2021-11-21,Galle,Sri Lanka,2021,2,43,144,0,1,180,408,3,137,264,3,60.0,>30,SL,Away,After 1965
JO Holder,WI,Pace,2021-11-29,Galle,Sri Lanka,2021,2,49,106,1,1,123,256,1,74,150,0,123.0,>30,SL,Away,After 1965
JO Holder,WI,Pace,2022-03-08,North Sound,West Indies,2022,2,80,222,3,1,832,1769,23,752,1547,20,36.17391304347826,>30,WI,Home,After 1965
JO Holder,WI,Pace,2022-03-16,Bridgetown,West Indies,2022,2,116,221,1,1,744,1535,17,628,1314,16,43.76470588235294,>30,WI,Home,After 1965
JO Holder,WI,Pace,2022-03-24,St George's,West Indies,2022,2,40,138,0,1,518,1435,27,478,1297,27,19.185185185185187,<=30,WI,Home,After 1965
JO Holder,WI,Pace,2022-11-30,Perth,Australia,2022,2,109,186,0,1,842,1610,13,733,1424,13,64.76923076923077,>30,AUS,Away,After 1965
JO Holder,WI,Pace,2022-12-08,Adelaide,Australia,2022,2,114,204,1,1,712,1214,23,598,1010,22,30.956521739130434,>30,AUS,Away,After 1965
JO Holder,WI,Pace,2023-02-04,Bulawayo,Zimbabwe,2023,2,68,132,2,1,562,1122,8,494,990,6,70.25,>30,ZIM,Away,After 1965
JO Holder,WI,Pace,2023-02-12,Bulawayo,Zimbabwe,2023,2,34,66,3,1,266,519,11,232,453,8,24.181818181818183,<=30,ZIM,Away,After 1965
JO Holder,WI,Pace,2023-02-28,Centurion,South Africa,2023,2,71,126,3,1,738,1209,39,667,1083,36,18.923076923076923,<=30,SA,Away,After 1965
JO Holder,WI,Pace,2023-03-08,Johannesburg,South Africa,2023,2,87,214,4,1,575,1146,28,488,932,24,20.535714285714285,<=30,SA,Away,After 1965
JO Holder,WI,Pace,2023-07-12,Roseau,West Indies,2023,1,40,108,0,1,260,590,5,220,482,5,52.0,>30,WI,Home,After 1965
JO Holder,WI,Pace,2023-07-20,Port of Spain,West Indies,2023,2,83,150,2,1,656,1048,14,573,898,12,46.857142857142854,>30,WI,Home,After 1965
JO Holder,WI,Pace,2024-07-10,Lord's,England,2024,1,58,108,2,1,552,962,27,494,854,25,20.444444444444443,<=30,ENG,Away,After 1965
JO Holder,WI,Pace,2024-07-18,Nottingham,England,2024,2,114,174,1,1,1038,1453,27,924,1279,26,38.44444444444444,>30,ENG,Away,After 1965
JO Holder,WI,Pace,2024-07-26,Birmingham,England,2024,2,62,54,0,1,712,994,27,650,940,27,26.37037037037037,<=30,ENG,Away,After 1965
JO Holder,WI,Pace,2024-08-07,Port of Spain,West Indies,2024,2,53,132,1,1,444,843,12,391,711,11,37.0,>30,WI,Home,After 1965
JO Holder,WI,Pace,2024-08-15,Providence,West Indies,2024,2,50,144,1,1,482,1012,28,432,868,27,17.214285714285715,<=30,WI,Home,After 1965
JO Taylor,WI,Pace,1958-03-26,Port of Spain,West Indies,1958,1,109,221,5,1,413,869,16,304,648,11,25.8125,<=30,WI,Home,Upto 2014
JO Taylor,WI,Pace,1958-12-12,Kanpur,India,1958,2,106,289,5,1,403,1061,19,297,772,14,21.210526315789473,<=30,IND,Away,Upto 2014
JO Taylor,WI,Pace,1959-02-20,Karachi,Pakistan,1959,2,58,162,0,1,346,942,12,288,780,12,28.833333333333332,<=30,PAK,Away,Upto 2014
JP Agnew,ENG,Pace,1984-08-09,The Oval,England,1984,2,97,156,2,1,809,1686,40,712,1530,38,20.225,<=30,ENG,Home,Upto 2014
JP Agnew,ENG,Pace,1984-08-23,Lord's,England,1984,2,177,258,2,1,850,1633,19,673,1375,17,44.73684210526316,>30,ENG,Home,Upto 2014
JP Agnew,ENG,Pace,1985-08-01,Manchester,England,1985,2,99,138,0,1,622,1074,12,523,936,12,51.833333333333336,>30,ENG,Home,Upto 2014
JP Duminy,SA,Spin,1927-12-24,Johannesburg,South Africa,1927,2,30,48,1,1,312,867,11,282,819,10,28.363636363636363,<=30,SA,Home,Upto 2014
JP Duminy,SA,Spin,1928-01-28,Johannesburg,South Africa,1928,1,9,12,0,1,407,779,13,398,767,13,31.307692307692307,>30,SA,Home,Upto 2014
JP Duminy,SA,Spin,2009-01-03,Sydney,Australia,2009,1,14,24,1,1,278,623,6,264,599,5,46.333333333333336,>30,AUS,Away,Upto 2014
JP Duminy,SA,Spin,2009-02-26,Johannesburg,South Africa,2009,1,54,84,0,1,210,342,4,156,258,4,52.5,>30,SA,Home,Upto 2014
JP Duminy,SA,Spin,2009-03-06,Durban,South Africa,2009,2,43,84,1,1,264,614,7,221,530,6,37.714285714285715,>30,SA,Home,Upto 2014
JP Duminy,SA,Spin,2009-03-19,Cape Town,South Africa,2009,1,14,18,0,1,333,503,11,319,485,11,30.272727272727273,>30,SA,Home,Upto 2014
JP Duminy,SA,Spin,2009-12-16,Centurion,South Africa,2009,2,24,66,1,1,399,878,13,375,812,12,30.692307692307693,>30,SA,Home,Upto 2014
JP Duminy,SA,Spin,2009-12-26,Durban,South Africa,2009,1,89,144,3,1,406,720,13,317,576,10,31.23076923076923,>30,SA,Home,Upto 2014
JP Duminy,SA,Spin,2010-01-03,Cape Town,South Africa,2010,2,46,102,2,1,394,792,10,348,690,8,39.4,>30,SA,Home,Upto 2014
JP Duminy,SA,Spin,2010-01-14,Johannesburg,South Africa,2010,1,10,11,2,1,103,149,4,93,138,2,25.75,<=30,SA,Home,Upto 2014
JP Duminy,SA,Spin,2010-02-06,Nagpur,India,2010,2,41,48,0,1,517,1080,7,476,1032,7,73.85714285714286,>30,IND,Away,Upto 2014
JP Duminy,SA,Spin,2010-02-14,Eden Gardens,India,2010,1,73,90,1,1,547,1263,14,474,1173,13,39.07142857142857,>30,IND,Away,Upto 2014
JP Duminy,SA,Spin,2012-03-23,Wellington,New Zealand,2012,2,74,138,0,1,247,510,1,173,372,1,247.0,>30,NZ,Away,Upto 2014
JP Duminy,SA,Spin,2012-07-19,The Oval,England,2012,2,13,48,0,1,301,684,4,288,636,4,75.25,>30,ENG,Away,Upto 2014
JP Duminy,SA,Spin,2012-08-02,Leeds,England,2012,2,15,18,1,1,205,280,8,190,262,7,25.625,<=30,ENG,Away,Upto 2014
JP Duminy,SA,Spin,2013-10-14,Abu Dhabi,UAE,2013,1,68,114,2,1,474,946,13,406,832,11,36.46153846153846,>30,UAE,Away,Upto 2014
JP Duminy,SA,Spin,2013-10-23,Dubai (DICS),UAE,2013,1,67,127,3,1,497,1052,19,430,925,16,26.157894736842106,<=30,UAE,Away,Upto 2014
JP Duminy,SA,Spin,2013-12-18,Johannesburg,South Africa,2013,2,117,174,2,1,344,574,4,227,400,2,86.0,>30,SA,Home,Upto 2014
JP Duminy,SA,Spin,2013-12-26,Durban,South Africa,2013,2,30,72,1,1,373,798,11,343,726,10,33.90909090909091,>30,SA,Home,Upto 2014
JP Duminy,SA,Spin,2014-02-12,Centurion,South Africa,2014,2,56,96,1,1,266,474,6,210,378,5,44.333333333333336,>30,SA,Home,After 1965
JP Duminy,SA,Spin,2014-02-20,Gqeberha,South Africa,2014,2,57,114,2,1,316,654,11,259,540,9,28.727272727272727,<=30,SA,Home,After 1965
JP Duminy,SA,Spin,2014-03-01,Cape Town,South Africa,2014,2,149,216,4,1,386,690,6,237,474,2,64.33333333333333,>30,SA,Home,After 1965
JP Duminy,SA,Spin,2014-07-16,Galle,Sri Lanka,2014,2,85,150,3,1,723,1396,15,638,1246,12,48.2,>30,SL,Away,After 1965
JP Duminy,SA,Spin,2014-07-24,Colombo (SSC),Sri Lanka,2014,2,82,114,2,1,647,1745,22,565,1631,20,29.40909090909091,<=30,SL,Away,After 1965
JP Duminy,SA,Spin,2014-08-09,Harare,Zimbabwe,2014,2,38,66,0,1,495,865,15,457,799,15,33.0,>30,ZIM,Away,After 1965
JP Duminy,SA,Spin,2015-07-21,Chattogram,Bangladesh,2015,1,15,24,0,1,318,607,10,303,583,10,31.8,>30,BAN,Away,After 1965
JP Duminy,SA,Spin,2015-07-30,Mirpur,Bangladesh,2015,1,27,90,3,1,125,270,4,98,180,1,31.25,>30,BAN,Away,After 1965
JP Duminy,SA,Spin,2015-11-14,Bengaluru,India,2015,1,9,12,0,1,138,228,8,129,216,8,17.25,<=30,IND,Away,After 1965
JP Duminy,SA,Spin,2015-11-25,Nagpur,India,2015,2,30,18,1,1,483,1096,33,453,1078,32,14.636363636363637,<=30,IND,Away,After 1965
JP Duminy,SA,Spin,2015-12-03,Delhi,India,2015,1,12,24,0,1,551,1517,20,539,1493,20,27.55,<=30,IND,Away,After 1965
JP Duminy,SA,Spin,2015-12-26,Durban,South Africa,2015,1,5,6,0,1,402,738,13,397,732,13,30.923076923076923,>30,SA,Home,After 1965
JP Duminy,SA,Spin,2016-01-22,Centurion,South Africa,2016,2,23,36,1,1,309,534,4,286,498,3,77.25,>30,SA,Home,After 1965
JP Duminy,SA,Spin,2016-11-03,W.A.C.A,Australia,2016,1,51,102,1,1,396,754,8,345,652,7,49.5,>30,AUS,Away,After 1965
JP Duminy,SA,Spin,2016-11-12,Hobart,Australia,2016,1,8,6,0,1,82,156,0,74,150,0,inf,>30,AUS,Away,After 1965
JP Duminy,SA,Spin,2016-11-24,Adelaide,Australia,2016,1,25,36,0,1,296,533,6,271,497,6,49.333333333333336,>30,AUS,Away,After 1965
JP Duminy,SA,Spin,2016-12-26,Gqeberha,South Africa,2016,1,8,18,0,1,359,638,9,351,620,9,39.888888888888886,>30,SA,Home,After 1965
JP Duminy,SA,Spin,2017-01-12,Johannesburg,South Africa,2017,1,1,6,0,1,90,138,0,89,132,0,inf,>30,SA,Home,After 1965
JP Duminy,SA,Spin,2017-03-08,Dunedin,New Zealand,2017,1,18,30,0,1,338,837,10,320,807,10,33.8,>30,NZ,Away,After 1965
JP Duminy,SA,Spin,2017-03-16,Wellington,New Zealand,2017,2,51,87,4,1,195,389,13,144,302,9,15.0,<=30,NZ,Away,After 1965
JP Duminy,SA,Spin,2017-03-25,Hamilton,New Zealand,2017,1,38,36,0,1,252,528,5,214,492,5,50.4,>30,NZ,Away,After 1965
JP Duminy,SA,Spin,2017-07-06,Lord's,England,2017,1,21,54,0,1,426,749,18,405,695,18,23.666666666666668,<=30,ENG,Away,After 1965
JP Faulkner,AUS,Pace,2013-08-21,The Oval,England,2013,2,98,166,6,1,836,1443,25,738,1277,19,33.44,>30,ENG,Away,Upto 2014
JP Fellows-Smith,SA,Pace,1960-06-09,Birmingham,England,1960,1,14,30,0,1,549,1558,25,535,1528,25,21.96,<=30,ENG,Away,Upto 2014
JP Fellows-Smith,SA,Pace,1960-06-23,Lord's,England,1960,1,13,30,0,1,549,1209,28,536,1179,28,19.607142857142858,<=30,ENG,Away,Upto 2014
JP Fellows-Smith,SA,Pace,1960-07-07,Nottingham,England,1960,1,17,30,0,1,545,1319,26,528,1289,26,20.96153846153846,<=30,ENG,Away,Upto 2014
JP Fellows-Smith,SA,Pace,1960-08-18,The Oval,England,1960,1,17,24,0,1,792,1752,24,775,1728,24,33.0,>30,ENG,Away,Upto 2014
JP Greaves,WI,Pace,2024-01-17,Adelaide,Australia,2024,1,36,90,2,1,512,947,27,476,857,25,18.962962962962962,<=30,AUS,Away,After 1965
JP Greaves,WI,Pace,2024-01-25,Brisbane,Australia,2024,2,77,126,1,1,777,1334,30,700,1208,29,25.9,<=30,AUS,Away,After 1965
JP Greaves,WI,Pace,2024-11-22,North Sound,West Indies,2024,2,46,84,2,1,670,1327,30,624,1243,28,22.333333333333332,<=30,WI,Home,After 1965
JP Greaves,WI,Pace,2024-11-30,Kingston,West Indies,2024,2,34,90,1,1,598,1162,33,564,1072,32,18.12121212121212,<=30,WI,Home,After 1965
JP Greaves,WI,Pace,2025-01-17,Multan,Pakistan,2025,1,12,18,0,1,83,168,3,71,150,3,27.666666666666668,<=30,PAK,Away,After 1965
JP Taylor,ENG,Pace,1993-01-29,Eden Gardens,India,1993,2,74,132,1,1,387,856,9,313,724,8,43.0,>30,IND,Away,Upto 2014
JP Taylor,ENG,Pace,1994-06-16,Lord's,England,1994,2,82,156,2,1,756,1458,24,674,1302,22,31.5,>30,ENG,Home,Upto 2014
JPF Travers,AUS,Spin,1902-02-28,Melbourne,Australia,1902,1,14,48,1,1,602,1354,31,588,1306,30,19.419354838709676,<=30,AUS,Home,Upto 2014
JR Gunn,ENG,Spin,1901-12-13,Sydney,Australia,1901,1,27,30,0,1,360,868,16,333,838,16,22.5,<=30,AUS,Away,Upto 2014
JR Gunn,ENG,Spin,1902-01-01,Melbourne,Australia,1902,1,13,36,0,1,445,1043,26,432,1007,26,17.115384615384617,<=30,AUS,Away,Upto 2014
JR Gunn,ENG,Spin,1902-01-17,Adelaide,Australia,1902,2,164,480,8,1,888,2292,24,724,1812,16,37.0,>30,AUS,Away,Upto 2014
JR Gunn,ENG,Spin,1902-02-14,Sydney,Australia,1902,2,65,147,3,1,685,1842,29,620,1695,26,23.620689655172413,<=30,AUS,Away,Upto 2014
JR Gunn,ENG,Spin,1902-02-28,Melbourne,Australia,1902,2,91,270,6,1,602,1354,31,511,1084,25,19.419354838709676,<=30,AUS,Away,Upto 2014
JR Gunn,ENG,Spin,1905-05-29,Nottingham,England,1905,1,27,36,1,1,379,970,12,352,934,11,31.583333333333332,>30,ENG,Home,Upto 2014
JR Hammond,AUS,Pace,1973-02-16,Kingston,West Indies,1973,2,96,233,5,1,629,1295,15,533,1062,10,41.93333333333333,>30,WI,Away,Upto 2014
JR Hammond,AUS,Pace,1973-03-09,Bridgetown,West Indies,1973,2,124,210,1,1,508,1217,11,384,1007,10,46.18181818181818,>30,WI,Away,Upto 2014
JR Hammond,AUS,Pace,1973-03-23,Port of Spain,West Indies,1973,2,19,78,1,1,317,912,10,298,834,9,31.7,>30,WI,Away,Upto 2014
JR Hammond,AUS,Pace,1973-04-06,Georgetown,West Indies,1973,2,148,294,7,1,667,1551,23,519,1257,16,29.0,<=30,WI,Away,Upto 2014
JR Hammond,AUS,Pace,1973-04-21,Port of Spain,West Indies,1973,2,101,216,1,1,343,870,9,242,654,8,38.111111111111114,>30,WI,Away,Upto 2014
JR Hazlewood,AUS,Pace,2014-12-17,Brisbane,Australia,2014,2,142,236,7,1,959,1402,28,817,1166,21,34.25,>30,AUS,Home,After 1965
JR Hazlewood,AUS,Pace,2014-12-26,Melbourne,Australia,2014,2,115,240,2,1,1069,1880,27,954,1640,25,39.592592592592595,>30,AUS,Home,After 1965
JR Hazlewood,AUS,Pace,2015-01-06,Sydney,Australia,2015,2,95,276,3,1,942,1653,21,847,1377,18,44.857142857142854,>30,AUS,Home,After 1965
JR Hazlewood,AUS,Pace,2015-06-03,Roseau,West Indies,2015,2,50,186,5,1,402,941,20,352,755,15,20.1,<=30,WI,Away,After 1965
JR Hazlewood,AUS,Pace,2015-06-11,Kingston,West Indies,2015,2,56,155,7,1,528,1091,25,472,936,18,21.12,<=30,WI,Away,After 1965
JR Hazlewood,AUS,Pace,2015-07-08,Cardiff,England,2015,2,132,216,5,1,901,1488,27,769,1272,22,33.370370370370374,>30,ENG,Away,After 1965
JR Hazlewood,AUS,Pace,2015-07-16,Lord's,England,2015,2,88,180,5,1,791,1369,21,703,1189,16,37.666666666666664,>30,ENG,Away,After 1965
JR Hazlewood,AUS,Pace,2015-07-29,Birmingham,England,2015,2,95,132,4,1,619,1035,28,524,903,24,22.107142857142858,<=30,ENG,Away,After 1965
JR Hazlewood,AUS,Pace,2015-08-06,Nottingham,England,2015,1,97,144,2,1,542,945,29,445,801,27,18.689655172413794,<=30,ENG,Away,After 1965
JR Hazlewood,AUS,Pace,2015-11-05,Brisbane,Australia,2015,2,138,234,3,1,1023,1505,20,885,1271,17,51.15,>30,AUS,Home,After 1965
JR Hazlewood,AUS,Pace,2015-11-13,W.A.C.A,Australia,2015,2,137,228,1,1,1234,1914,22,1097,1686,21,56.09090909090909,>30,AUS,Home,After 1965
JR Hazlewood,AUS,Pace,2015-11-27,Adelaide,Australia,2015,2,136,253,9,1,584,1142,29,448,889,20,20.137931034482758,<=30,AUS,Home,After 1965
JR Hazlewood,AUS,Pace,2015-12-10,Hobart,Australia,2015,2,78,171,7,1,634,903,16,556,732,9,39.625,>30,AUS,Home,After 1965
JR Hazlewood,AUS,Pace,2015-12-26,Melbourne,Australia,2015,2,89,246,0,1,837,1482,18,748,1236,18,46.5,>30,AUS,Home,After 1965
JR Hazlewood,AUS,Pace,2016-01-03,Sydney,Australia,2016,1,49,108,1,1,234,354,3,185,246,2,78.0,>30,AUS,Home,After 1965
JR Hazlewood,AUS,Pace,2016-02-12,Wellington,New Zealand,2016,2,117,258,6,1,769,1383,21,652,1125,15,36.61904761904762,>30,NZ,Away,After 1965
JR Hazlewood,AUS,Pace,2016-02-20,Christchurch,New Zealand,2016,2,190,312,3,1,1247,2076,29,1057,1764,26,43.0,>30,NZ,Away,After 1965
JR Hazlewood,AUS,Pace,2016-07-26,Pallekele,Sri Lanka,2016,2,80,172,5,1,306,556,14,226,384,9,21.857142857142858,<=30,SL,Away,After 1965
JR Hazlewood,AUS,Pace,2016-08-04,Galle,Sri Lanka,2016,2,64,144,2,1,224,424,15,160,280,13,14.933333333333334,<=30,SL,Away,After 1965
JR Hazlewood,AUS,Pace,2016-08-13,Colombo (SSC),Sri Lanka,2016,2,85,192,0,1,336,652,8,251,460,8,42.0,>30,SL,Away,After 1965
JR Hazlewood,AUS,Pace,2016-11-03,W.A.C.A,Australia,2016,2,177,324,5,1,937,1726,29,760,1402,24,32.310344827586206,>30,AUS,Home,After 1965
JR Hazlewood,AUS,Pace,2016-11-12,Hobart,Australia,2016,1,89,185,6,1,477,1007,29,388,822,23,16.448275862068964,<=30,AUS,Home,After 1965
JR Hazlewood,AUS,Pace,2016-11-24,Adelaide,Australia,2016,2,109,252,6,1,686,1407,24,577,1155,18,28.583333333333332,<=30,AUS,Home,After 1965
JR Hazlewood,AUS,Pace,2016-12-15,Brisbane,Australia,2016,2,121,336,3,1,820,1566,28,699,1230,25,29.285714285714285,<=30,AUS,Home,After 1965
JR Hazlewood,AUS,Pace,2016-12-26,Melbourne,Australia,2016,2,89,273,5,1,778,1397,19,689,1124,14,40.94736842105263,>30,AUS,Home,After 1965
JR Hazlewood,AUS,Pace,2017-01-03,Sydney,Australia,2017,2,84,275,7,1,587,1109,15,503,834,8,39.13333333333333,>30,AUS,Home,After 1965
JR Hazlewood,AUS,Pace,2017-02-23,Pune,India,2017,2,18,54,1,1,160,354,9,142,300,8,17.77777777777778,<=30,IND,Away,After 1965
JR Hazlewood,AUS,Pace,2017-03-04,Bengaluru,India,2017,2,109,210,6,1,391,822,14,282,612,8,27.928571428571427,<=30,IND,Away,After 1965
JR Hazlewood,AUS,Pace,2017-03-16,Ranchi,India,2017,1,103,264,1,1,451,960,9,348,696,8,50.111111111111114,>30,IND,Away,After 1965
JR Hazlewood,AUS,Pace,2017-03-25,Dharamsala,India,2017,2,65,186,1,1,367,681,12,302,495,11,30.583333333333332,>30,IND,Away,After 1965
JR Hazlewood,AUS,Pace,2017-08-27,Mirpur,Bangladesh,2017,2,42,115,0,1,186,391,4,144,276,4,46.5,>30,BAN,Away,After 1965
JR Hazlewood,AUS,Pace,2017-11-23,Brisbane,Australia,2017,2,103,232,4,1,713,1568,21,610,1336,17,33.95238095238095,>30,AUS,Home,After 1965
JR Hazlewood,AUS,Pace,2017-12-02,Adelaide,Australia,2017,2,105,216,3,1,779,1712,31,674,1496,28,25.129032258064516,<=30,AUS,Home,After 1965
JR Hazlewood,AUS,Pace,2017-12-14,W.A.C.A,Australia,2017,2,140,276,8,1,965,1713,24,825,1437,16,40.208333333333336,>30,AUS,Home,After 1965
JR Hazlewood,AUS,Pace,2017-12-26,Melbourne,Australia,2017,1,95,180,3,1,816,1807,20,721,1627,17,40.8,>30,AUS,Home,After 1965
JR Hazlewood,AUS,Pace,2018-01-04,Sydney,Australia,2018,2,101,241,3,1,630,1294,17,529,1053,14,37.05882352941177,>30,AUS,Home,After 1965
JR Hazlewood,AUS,Pace,2018-03-01,Durban,South Africa,2018,2,92,172,4,1,640,1256,26,548,1084,22,24.615384615384617,<=30,SA,Away,After 1965
JR Hazlewood,AUS,Pace,2018-03-09,Gqeberha,South Africa,2018,2,124,216,3,1,673,1296,28,549,1080,25,24.035714285714285,<=30,SA,Away,After 1965
JR Hazlewood,AUS,Pace,2018-03-22,Cape Town,South Africa,2018,2,128,290,5,1,789,1457,31,661,1167,26,25.451612903225808,<=30,SA,Away,After 1965
JR Hazlewood,AUS,Pace,2018-03-30,Johannesburg,South Africa,2018,2,127,282,0,1,666,1427,26,539,1145,26,25.615384615384617,<=30,SA,Away,After 1965
JR Hazlewood,AUS,Pace,2018-12-06,Adelaide,Australia,2018,2,95,258,4,1,635,1467,25,540,1209,21,25.4,<=30,AUS,Home,After 1965
JR Hazlewood,AUS,Pace,2018-12-14,Perth,Australia,2018,2,90,192,4,1,753,1685,30,663,1493,26,25.1,<=30,AUS,Home,After 1965
JR Hazlewood,AUS,Pace,2018-12-26,Melbourne,Australia,2018,2,108,253,3,1,621,1425,29,513,1172,26,21.413793103448278,<=30,AUS,Home,After 1965
JR Hazlewood,AUS,Pace,2019-01-03,Sydney,Australia,2019,1,105,210,2,1,459,804,6,354,594,4,76.5,>30,AUS,Home,After 1965
JR Hazlewood,AUS,Pace,2019-08-14,Lord's,England,2019,2,101,210,3,1,589,1275,24,488,1065,21,24.541666666666668,<=30,ENG,Away,After 1965
JR Hazlewood,AUS,Pace,2019-08-22,Leeds,England,2019,2,115,263,9,1,629,1344,34,514,1081,25,18.5,<=30,ENG,Away,After 1965
JR Hazlewood,AUS,Pace,2019-09-04,Manchester,England,2019,2,88,255,6,1,783,1519,27,695,1264,21,29.0,<=30,ENG,Away,After 1965
JR Hazlewood,AUS,Pace,2019-09-12,The Oval,England,2019,2,133,240,2,1,856,1530,30,723,1290,28,28.533333333333335,<=30,ENG,Away,After 1965
JR Hazlewood,AUS,Pace,2019-11-21,Brisbane,Australia,2019,2,109,246,6,1,600,1180,22,491,934,16,27.272727272727273,<=30,AUS,Home,After 1965
JR Hazlewood,AUS,Pace,2019-11-29,Adelaide,Australia,2019,2,111,222,4,1,654,1168,17,543,946,13,38.470588235294116,>30,AUS,Home,After 1965
JR Hazlewood,AUS,Pace,2019-12-12,Perth,Australia,2019,1,0,8,1,1,626,1383,31,626,1375,30,20.193548387096776,<=30,AUS,Home,After 1965
JR Hazlewood,AUS,Pace,2020-12-17,Adelaide,Australia,2020,2,55,150,6,1,408,970,22,353,820,16,18.545454545454547,<=30,AUS,Home,After 1965
JR Hazlewood,AUS,Pace,2020-12-26,Melbourne,Australia,2020,2,61,156,1,1,523,1170,20,462,1014,19,26.15,<=30,AUS,Home,After 1965
JR Hazlewood,AUS,Pace,2021-01-07,Sydney,Australia,2021,2,82,282,4,1,762,1640,19,680,1358,15,40.10526315789474,>30,AUS,Home,After 1965
JR Hazlewood,AUS,Pace,2021-01-15,Brisbane,Australia,2021,2,131,280,6,1,950,1738,30,819,1458,24,31.666666666666668,>30,AUS,Home,After 1965
JR Hazlewood,AUS,Pace,2021-12-08,Brisbane,Australia,2021,2,74,162,3,1,608,1187,25,534,1025,22,24.32,<=30,AUS,Home,After 1965
JR Hazlewood,AUS,Pace,2022-03-04,Rawalpindi,Pakistan,2022,2,61,186,0,1,479,990,4,418,804,4,119.75,>30,PAK,Away,After 1965
JR Hazlewood,AUS,Pace,2022-11-30,Perth,Australia,2022,2,105,258,2,1,842,1610,13,737,1352,11,64.76923076923077,>30,AUS,Home,After 1965
JR Hazlewood,AUS,Pace,2023-01-04,Sydney,Australia,2023,2,57,168,5,1,386,804,12,329,636,7,32.166666666666664,>30,AUS,Home,After 1965
JR Hazlewood,AUS,Pace,2023-06-16,Birmingham,England,2023,2,109,150,3,1,808,1386,24,699,1236,21,33.666666666666664,>30,ENG,Away,After 1965
JR Hazlewood,AUS,Pace,2023-06-28,Lord's,England,2023,2,151,186,5,1,1187,1964,35,1036,1778,30,33.91428571428571,>30,ENG,Away,After 1965
JR Hazlewood,AUS,Pace,2023-07-19,Manchester,England,2023,1,126,162,5,1,889,1350,23,763,1188,18,38.65217391304348,>30,ENG,Away,After 1965
JR Hazlewood,AUS,Pace,2023-07-27,The Oval,England,2023,2,121,168,3,1,971,1598,29,850,1430,26,33.48275862068966,>30,ENG,Away,After 1965
JR Hazlewood,AUS,Pace,2023-12-14,Perth,Australia,2023,2,62,176,4,1,810,1410,28,748,1234,24,28.928571428571427,<=30,AUS,Home,After 1965
JR Hazlewood,AUS,Pace,2023-12-26,Melbourne,Australia,2023,2,77,186,2,1,818,1640,35,741,1454,33,23.37142857142857,<=30,AUS,Home,After 1965
JR Hazlewood,AUS,Pace,2024-01-03,Sydney,Australia,2024,2,81,144,5,1,504,897,22,423,753,17,22.90909090909091,<=30,AUS,Home,After 1965
JR Hazlewood,AUS,Pace,2024-01-17,Adelaide,Australia,2024,2,79,174,9,1,512,947,27,433,773,18,18.962962962962962,<=30,AUS,Home,After 1965
JR Hazlewood,AUS,Pace,2024-01-25,Brisbane,Australia,2024,2,61,204,5,1,777,1334,30,716,1130,25,25.9,<=30,AUS,Home,After 1965
JR Hazlewood,AUS,Pace,2024-02-29,Wellington,New Zealand,2024,2,75,130,4,1,689,1266,22,614,1136,18,31.318181818181817,>30,NZ,Away,After 1965
JR Hazlewood,AUS,Pace,2024-03-08,Christchurch,New Zealand,2024,2,101,236,6,1,918,1490,33,817,1254,27,27.818181818181817,<=30,NZ,Away,After 1965
JR Hazlewood,AUS,Pace,2024-11-22,Perth,Australia,2024,2,57,204,5,1,555,1114,27,498,910,22,20.555555555555557,<=30,AUS,Home,After 1965
JR Hazlewood,AUS,Pace,2024-12-14,Brisbane,Australia,2024,1,22,36,1,1,550,932,24,528,896,23,22.916666666666668,<=30,AUS,Home,After 1965
JR Hodges,AUS,Spin,1877-03-15,Melbourne,Australia,1877,2,34,64,3,1,437,1296,31,403,1232,28,14.096774193548388,<=30,AUS,Home,After 1965
JR Hodges,AUS,Spin,1877-03-31,Melbourne,Australia,1877,2,50,72,3,1,437,1222,21,387,1150,18,20.80952380952381,<=30,AUS,Home,After 1965
JR Mason,ENG,Pace,1897-12-13,Sydney,Australia,1897,2,18,24,1,1,722,1597,21,704,1573,20,34.38095238095238,>30,AUS,Away,After 1965
JR Mason,ENG,Pace,1898-01-01,Melbourne,Australia,1898,1,33,66,1,1,464,1032,7,431,966,6,66.28571428571429,>30,AUS,Away,After 1965
JR Mason,ENG,Pace,1898-01-14,Adelaide,Australia,1898,1,41,66,0,1,674,1910,19,633,1844,19,35.473684210526315,>30,AUS,Away,After 1965
JR Mason,ENG,Pace,1898-01-29,Melbourne,Australia,1898,1,10,24,0,1,528,1140,21,518,1116,21,25.142857142857142,<=30,AUS,Away,After 1965
JR Mason,ENG,Pace,1898-02-26,Sydney,Australia,1898,2,47,144,0,1,648,1334,24,601,1190,24,27.0,<=30,AUS,Away,After 1965
JR Ratnayeke,SL,Pace,1982-03-05,Karachi,Pakistan,1982,2,69,130,1,1,440,708,10,371,578,9,44.0,>30,PAK,Away,Upto 2014
JR Ratnayeke,SL,Pace,1982-03-22,Lahore,Pakistan,1982,1,121,168,3,1,456,794,20,335,626,17,22.8,<=30,PAK,Away,Upto 2014
JR Ratnayeke,SL,Pace,1982-09-17,Chennai,India,1982,2,111,144,1,1,686,896,18,575,752,17,38.111111111111114,>30,IND,Away,Upto 2014
JR Ratnayeke,SL,Pace,1983-03-04,Christchurch,New Zealand,1983,1,93,186,3,1,557,1256,25,464,1070,22,22.28,<=30,NZ,Away,Upto 2014
JR Ratnayeke,SL,Pace,1983-03-11,Wellington,New Zealand,1983,2,56,133,1,1,592,1490,31,536,1357,30,19.096774193548388,<=30,NZ,Away,Upto 2014
JR Ratnayeke,SL,Pace,1984-03-16,Colombo (SSC),Sri Lanka,1984,2,59,252,5,1,563,1643,28,504,1391,23,20.107142857142858,<=30,SL,Home,Upto 2014
JR Ratnayeke,SL,Pace,1984-03-24,Colombo (CCC),Sri Lanka,1984,1,128,240,3,1,479,1056,21,351,816,18,22.80952380952381,<=30,SL,Home,Upto 2014
JR Ratnayeke,SL,Pace,1984-08-23,Lord's,England,1984,1,50,132,0,1,850,1633,19,800,1501,19,44.73684210526316,>30,ENG,Away,Upto 2014
JR Ratnayeke,SL,Pace,1985-10-16,Faisalabad,Pakistan,1985,1,117,179,1,1,718,1505,9,601,1326,8,79.77777777777777,>30,PAK,Away,Upto 2014
JR Ratnayeke,SL,Pace,1985-10-27,Sialkot,Pakistan,1985,2,108,186,8,1,662,1204,31,554,1018,23,21.35483870967742,<=30,PAK,Away,Upto 2014
JR Ratnayeke,SL,Pace,1985-11-07,Karachi,Pakistan,1985,2,72,126,1,1,402,787,17,330,661,16,23.647058823529413,<=30,PAK,Away,Upto 2014
JR Ratnayeke,SL,Pace,1986-02-23,Kandy,Sri Lanka,1986,1,26,60,0,1,238,611,14,212,551,14,17.0,<=30,SL,Home,Upto 2014
JR Ratnayeke,SL,Pace,1986-03-14,Colombo (CCC),Sri Lanka,1986,2,66,208,7,1,530,1137,31,464,929,24,17.096774193548388,<=30,SL,Home,Upto 2014
JR Ratnayeke,SL,Pace,1986-03-22,Colombo (PSS),Sri Lanka,1986,1,116,180,4,1,728,1538,20,612,1358,16,36.4,>30,SL,Home,Upto 2014
JR Ratnayeke,SL,Pace,1986-12-17,Kanpur,India,1986,1,132,223,4,1,810,1291,13,678,1068,9,62.30769230769231,>30,IND,Away,Upto 2014
JR Ratnayeke,SL,Pace,1986-12-27,Nagpur,India,1986,1,89,168,0,1,372,581,7,283,413,7,53.142857142857146,>30,IND,Away,Upto 2014
JR Ratnayeke,SL,Pace,1987-01-04,Cuttack,India,1987,1,85,165,5,1,333,711,12,248,546,7,27.75,<=30,IND,Away,Upto 2014
JR Ratnayeke,SL,Pace,1987-04-16,Colombo (CCC),Sri Lanka,1987,1,111,222,2,1,574,1325,10,463,1103,8,57.4,>30,SL,Home,Upto 2014
JR Ratnayeke,SL,Pace,1988-02-12,W.A.C.A,Australia,1988,1,98,240,4,1,710,1536,29,612,1296,25,24.482758620689655,<=30,AUS,Away,Upto 2014
JR Ratnayeke,SL,Pace,1988-08-25,Lord's,England,1988,2,123,234,2,1,947,1904,31,824,1670,29,30.548387096774192,>30,ENG,Away,Upto 2014
JR Ratnayeke,SL,Pace,1989-12-08,Brisbane,Australia,1989,1,17,53,0,1,901,1884,23,884,1831,23,39.17391304347826,>30,AUS,Away,Upto 2014
JR Ratnayeke,SL,Pace,1989-12-16,Hobart,Australia,1989,2,125,204,1,1,998,1920,27,873,1716,26,36.96296296296296,>30,AUS,Away,Upto 2014
JR Reid,NZ,Spin,1949-07-23,Manchester,England,1949,1,14,12,0,1,586,1224,13,572,1212,13,45.07692307692308,>30,ENG,Away,Upto 2014
JR Reid,NZ,Spin,1951-03-17,Christchurch,New Zealand,1951,1,29,60,0,1,586,1337,15,557,1277,15,39.06666666666667,>30,NZ,Home,Upto 2014
JR Reid,NZ,Spin,1952-02-08,Christchurch,New Zealand,1952,1,25,54,0,1,593,1754,25,568,1700,25,23.72,<=30,NZ,Home,Upto 2014
JR Reid,NZ,Spin,1952-02-15,Auckland,New Zealand,1952,1,33,84,0,1,442,1192,12,409,1108,12,36.833333333333336,>30,NZ,Home,Upto 2014
JR Reid,NZ,Spin,1953-03-06,Wellington,New Zealand,1953,1,36,144,0,1,540,1494,12,504,1350,12,45.0,>30,NZ,Home,Upto 2014
JR Reid,NZ,Spin,1953-03-13,Auckland,New Zealand,1953,2,76,210,2,1,495,1529,18,419,1319,16,27.5,<=30,NZ,Home,Upto 2014
JR Reid,NZ,Spin,1953-12-11,Durban,South Africa,1953,1,49,128,1,1,371,1319,16,322,1191,15,23.1875,<=30,SA,Away,Upto 2014
JR Reid,NZ,Spin,1953-12-24,Johannesburg,South Africa,1953,2,97,272,6,1,206,522,9,109,250,3,22.88888888888889,<=30,SA,Away,Upto 2014
JR Reid,NZ,Spin,1954-01-01,Cape Town,South Africa,1954,2,56,192,0,1,639,1815,13,583,1623,13,49.15384615384615,>30,SA,Away,Upto 2014
JR Reid,NZ,Spin,1954-01-29,Johannesburg,South Africa,1954,1,67,168,0,1,148,530,8,81,362,8,18.5,<=30,SA,Away,Upto 2014
JR Reid,NZ,Spin,1954-02-05,Gqeberha,South Africa,1954,2,115,376,5,1,529,1620,15,414,1244,10,35.266666666666666,>30,SA,Away,Upto 2014
JR Reid,NZ,Spin,1955-03-11,Dunedin,New Zealand,1955,2,48,186,4,1,162,483,7,114,297,3,23.142857142857142,<=30,NZ,Home,Upto 2014
JR Reid,NZ,Spin,1955-03-25,Auckland,New Zealand,1955,1,28,150,0,1,138,529,7,110,379,7,19.714285714285715,<=30,NZ,Home,Upto 2014
JR Reid,NZ,Spin,1955-10-13,Karachi,Pakistan,1955,1,34,180,0,1,294,1463,19,260,1283,19,15.473684210526315,<=30,PAK,Away,Upto 2014
JR Reid,NZ,Spin,1955-10-26,Lahore,Pakistan,1955,2,120,258,5,1,672,1787,23,552,1529,18,29.217391304347824,<=30,PAK,Away,Upto 2014
JR Reid,NZ,Spin,1955-11-07,Dhaka,Bangladesh,1955,1,67,180,2,1,131,558,6,64,378,4,21.833333333333332,<=30,BAN,Away,Upto 2014
JR Reid,NZ,Spin,1955-11-19,Hyderabad (Deccan),India,1955,1,63,96,0,1,665,1888,11,602,1792,11,60.45454545454545,>30,IND,Away,Upto 2014
JR Reid,NZ,Spin,1955-12-02,Brabourne,India,1955,1,6,18,0,1,470,1277,17,464,1259,17,27.647058823529413,<=30,IND,Away,Upto 2014
JR Reid,NZ,Spin,1955-12-16,Delhi,India,1955,1,86,246,1,1,540,1398,4,454,1152,3,135.0,>30,IND,Away,Upto 2014
JR Reid,NZ,Spin,1955-12-28,Eden Gardens,India,1955,2,106,366,5,1,462,1292,19,356,926,14,24.31578947368421,<=30,IND,Away,Upto 2014
JR Reid,NZ,Spin,1956-01-06,Chennai,India,1956,1,10,42,0,1,610,1887,20,600,1845,20,30.5,>30,IND,Away,Upto 2014
JR Reid,NZ,Spin,1956-02-03,Dunedin,New Zealand,1956,1,43,102,0,1,439,1372,20,396,1270,20,21.95,<=30,NZ,Home,Upto 2014
JR Reid,NZ,Spin,1956-02-18,Christchurch,New Zealand,1956,1,68,144,3,1,464,1136,24,396,992,21,19.333333333333332,<=30,NZ,Home,Upto 2014
JR Reid,NZ,Spin,1956-03-03,Wellington,New Zealand,1956,1,85,197,3,1,421,1506,19,336,1309,16,22.157894736842106,<=30,NZ,Home,Upto 2014
JR Reid,NZ,Spin,1956-03-09,Auckland,New Zealand,1956,2,62,144,1,1,420,1482,16,358,1338,15,26.25,<=30,NZ,Home,Upto 2014
JR Reid,NZ,Spin,1958-06-05,Birmingham,England,1958,2,34,90,0,1,161,422,9,127,332,9,17.88888888888889,<=30,ENG,Away,Upto 2014
JR Reid,NZ,Spin,1958-06-19,Lord's,England,1958,1,41,144,1,1,155,534,16,114,390,15,9.6875,<=30,ENG,Away,Upto 2014
JR Reid,NZ,Spin,1958-07-03,Leeds,England,1958,1,54,156,0,1,241,963,20,187,807,20,12.05,<=30,ENG,Away,Upto 2014
JR Reid,NZ,Spin,1958-07-24,Manchester,England,1958,1,47,69,3,1,295,909,16,248,840,13,18.4375,<=30,ENG,Away,Upto 2014
JR Reid,NZ,Spin,1958-08-21,The Oval,England,1958,1,11,47,2,1,171,485,8,160,438,6,21.375,<=30,ENG,Away,Upto 2014
JR Reid,NZ,Spin,1959-02-27,Christchurch,New Zealand,1959,1,34,109,3,1,315,1017,18,281,908,15,17.5,<=30,NZ,Home,Upto 2014
JR Reid,NZ,Spin,1959-03-14,Auckland,New Zealand,1959,1,19,24,0,1,206,465,5,187,441,5,41.2,>30,NZ,Home,Upto 2014
JR Reid,NZ,Spin,1961-12-08,Durban,South Africa,1961,1,38,66,0,1,285,733,16,247,667,16,17.8125,<=30,SA,Away,Upto 2014
JR Reid,NZ,Spin,1961-12-26,Johannesburg,South Africa,1961,1,33,54,0,1,298,572,6,265,518,6,49.666666666666664,>30,SA,Away,Upto 2014
JR Reid,NZ,Spin,1962-01-01,Cape Town,South Africa,1962,1,21,86,2,1,569,1566,23,548,1480,21,24.73913043478261,<=30,SA,Away,Upto 2014
JR Reid,NZ,Spin,1962-02-02,Johannesburg,South Africa,1962,1,55,96,3,1,312,504,6,257,408,3,52.0,>30,SA,Away,Upto 2014
JR Reid,NZ,Spin,1962-02-16,Gqeberha,South Africa,1962,2,70,354,6,1,338,1102,14,268,748,8,24.142857142857142,<=30,SA,Away,Upto 2014
JR Reid,NZ,Spin,1963-02-23,Auckland,New Zealand,1963,1,67,168,0,1,567,1236,14,500,1068,14,40.5,>30,NZ,Home,Upto 2014
JR Reid,NZ,Spin,1963-03-01,Wellington,New Zealand,1963,1,73,192,1,1,364,1047,13,291,855,12,28.0,<=30,NZ,Home,Upto 2014
JR Reid,NZ,Spin,1963-03-15,Christchurch,New Zealand,1963,1,31,48,1,1,329,813,12,298,765,11,27.416666666666668,<=30,NZ,Home,Upto 2014
JR Reid,NZ,Spin,1964-02-21,Wellington,New Zealand,1964,2,102,305,3,1,335,893,10,233,588,7,33.5,>30,NZ,Home,Upto 2014
JR Reid,NZ,Spin,1964-02-28,Dunedin,New Zealand,1964,1,60,210,6,1,207,662,16,147,452,10,12.9375,<=30,NZ,Home,Upto 2014
JR Reid,NZ,Spin,1964-03-13,Auckland,New Zealand,1964,2,116,257,3,1,351,809,9,235,552,6,39.0,>30,NZ,Home,Upto 2014
JR Reid,NZ,Spin,1965-01-22,Wellington,New Zealand,1965,2,40,126,1,1,356,1080,8,316,954,7,44.5,>30,NZ,Home,Upto 2014
JR Reid,NZ,Spin,1965-01-29,Auckland,New Zealand,1965,2,78,234,2,1,450,1734,24,372,1500,22,18.75,<=30,NZ,Home,Upto 2014
JR Reid,NZ,Spin,1965-02-12,Christchurch,New Zealand,1965,1,24,66,1,1,466,1098,16,442,1032,15,29.125,<=30,NZ,Home,Upto 2014
JR Reid,NZ,Spin,1965-02-27,Chennai,India,1965,1,70,180,1,1,616,1705,17,546,1525,16,36.23529411764706,>30,IND,Away,Upto 2014
JR Reid,NZ,Spin,1965-03-05,Eden Gardens,India,1965,1,5,12,0,1,632,1531,17,627,1519,17,37.1764705882353,>30,IND,Away,Upto 2014
JR Reid,NZ,Spin,1965-03-12,Brabourne,India,1965,1,8,18,0,1,545,1316,11,537,1298,11,49.54545454545455,>30,IND,Away,Upto 2014
JR Reid,NZ,Spin,1965-03-19,Delhi,India,1965,2,92,150,2,1,716,1840,21,624,1690,19,34.095238095238095,>30,IND,Away,Upto 2014
JR Reid,NZ,Spin,1965-03-27,Rawalpindi,Pakistan,1965,1,80,204,3,1,362,890,18,282,686,15,20.11111111111111,<=30,PAK,Away,Upto 2014
JR Reid,NZ,Spin,1965-04-02,Lahore,Pakistan,1965,1,21,54,0,1,697,1836,15,676,1782,15,46.46666666666667,>30,PAK,Away,Upto 2014
JR Reid,NZ,Spin,1965-04-09,Karachi,Pakistan,1965,2,34,66,2,1,606,1528,19,572,1462,17,31.894736842105264,>30,PAK,Away,Upto 2014
JR Reid,NZ,Spin,1965-05-27,Birmingham,England,1965,2,50,126,1,1,528,1355,15,478,1229,14,35.2,>30,ENG,Away,Upto 2014
JR Reid,NZ,Spin,1965-06-17,Lord's,England,1965,1,4,5,0,1,329,839,9,325,834,9,36.55555555555556,>30,ENG,Away,Upto 2014
JR Thomson,AUS,Pace,1972-12-29,Melbourne,Australia,1972,2,110,152,0,1,925,1467,16,815,1315,16,57.8125,>30,AUS,Home,Upto 2014
JR Thomson,AUS,Pace,1974-11-29,Brisbane,Australia,1974,2,105,309,9,1,649,1743,27,544,1434,18,24.037037037037038,<=30,AUS,Home,Upto 2014
JR Thomson,AUS,Pace,1974-12-13,W.A.C.A,Australia,1974,2,138,320,7,1,728,1672,24,590,1352,17,30.333333333333332,>30,AUS,Home,Upto 2014
JR Thomson,AUS,Pace,1974-12-26,Melbourne,Australia,1974,2,143,316,8,1,489,1257,19,346,941,11,25.736842105263158,<=30,AUS,Home,Upto 2014
JR Thomson,AUS,Pace,1975-01-04,Sydney,Australia,1975,2,148,336,6,1,724,1665,23,576,1329,17,31.47826086956522,>30,AUS,Home,Upto 2014
JR Thomson,AUS,Pace,1975-01-25,Adelaide,Australia,1975,1,58,120,3,1,469,911,17,411,791,14,27.58823529411765,<=30,AUS,Home,Upto 2014
JR Thomson,AUS,Pace,1975-07-10,Birmingham,England,1975,2,59,168,5,1,502,1221,27,443,1053,22,18.59259259259259,<=30,ENG,Away,Upto 2014
JR Thomson,AUS,Pace,1975-07-31,Lord's,England,1975,2,165,318,3,1,808,1552,18,643,1234,15,44.888888888888886,>30,ENG,Away,Upto 2014
JR Thomson,AUS,Pace,1975-08-14,Leeds,England,1975,2,120,252,3,1,612,1447,21,492,1195,18,29.142857142857142,<=30,ENG,Away,Upto 2014
JR Thomson,AUS,Pace,1975-08-28,The Oval,England,1975,2,113,313,5,1,686,1764,24,573,1451,19,28.583333333333332,<=30,ENG,Away,Upto 2014
JR Thomson,AUS,Pace,1975-11-28,Brisbane,Australia,1975,2,158,224,1,1,663,1224,17,505,1000,16,39.0,>30,AUS,Home,Upto 2014
JR Thomson,AUS,Pace,1975-12-12,W.A.C.A,Australia,1975,1,128,136,3,1,857,1286,28,729,1150,25,30.607142857142858,>30,AUS,Home,Upto 2014
JR Thomson,AUS,Pace,1975-12-26,Melbourne,Australia,1975,2,113,160,6,1,804,1499,27,691,1339,21,29.77777777777778,<=30,AUS,Home,Upto 2014
JR Thomson,AUS,Pace,1976-01-03,Sydney,Australia,1976,2,167,320,9,1,784,1539,30,617,1219,21,26.133333333333333,<=30,AUS,Home,Upto 2014
JR Thomson,AUS,Pace,1976-01-23,Adelaide,Australia,1976,2,134,192,6,1,939,1486,26,805,1294,20,36.11538461538461,>30,AUS,Home,Upto 2014
JR Thomson,AUS,Pace,1976-01-31,Melbourne,Australia,1976,2,131,173,4,1,775,1378,27,644,1205,23,28.703703703703702,<=30,AUS,Home,Upto 2014
JR Thomson,AUS,Pace,1976-12-24,Adelaide,Australia,1976,1,34,69,2,1,783,1646,15,749,1577,13,52.2,>30,AUS,Home,Upto 2014
JR Thomson,AUS,Pace,1977-06-16,Lord's,England,1977,2,127,273,8,1,753,1756,32,626,1483,24,23.53125,<=30,ENG,Away,Upto 2014
JR Thomson,AUS,Pace,1977-07-07,Manchester,England,1977,2,97,276,3,1,525,1242,14,428,966,11,37.5,>30,ENG,Away,Upto 2014
JR Thomson,AUS,Pace,1977-07-28,Nottingham,England,1977,2,137,282,3,1,788,1906,27,651,1624,24,29.185185185185187,<=30,ENG,Away,Upto 2014
JR Thomson,AUS,Pace,1977-08-11,Leeds,England,1977,1,113,204,4,1,569,1338,25,456,1134,21,22.76,<=30,ENG,Away,Upto 2014
JR Thomson,AUS,Pace,1977-08-25,The Oval,England,1977,2,109,170,5,1,507,1259,20,398,1089,15,25.35,<=30,ENG,Away,Upto 2014
JR Thomson,AUS,Pace,1977-12-02,Brisbane,Australia,1977,2,130,287,7,1,540,1279,27,410,992,20,20.0,<=30,AUS,Home,Upto 2014
JR Thomson,AUS,Pace,1977-12-16,W.A.C.A,Australia,1977,2,166,365,6,1,682,1283,21,516,918,15,32.476190476190474,>30,AUS,Home,Upto 2014
JR Thomson,AUS,Pace,1977-12-30,Melbourne,Australia,1977,2,125,272,3,1,588,1273,19,463,1001,16,30.94736842105263,>30,AUS,Home,Upto 2014
JR Thomson,AUS,Pace,1978-01-07,Sydney,Australia,1978,1,83,216,4,1,322,871,11,239,655,7,29.272727272727273,<=30,AUS,Home,Upto 2014
JR Thomson,AUS,Pace,1978-01-28,Adelaide,Australia,1978,1,12,27,2,1,564,1391,22,552,1364,20,25.636363636363637,<=30,AUS,Home,Upto 2014
JR Thomson,AUS,Pace,1978-03-03,Port of Spain,West Indies,1978,1,84,126,3,1,396,789,19,312,663,16,20.842105263157894,<=30,WI,Away,Upto 2014
JR Thomson,AUS,Pace,1978-03-17,Bridgetown,West Indies,1978,2,99,114,6,1,577,955,26,478,841,20,22.192307692307693,<=30,WI,Away,Upto 2014
JR Thomson,AUS,Pace,1978-03-31,Georgetown,West Indies,1978,2,139,218,5,1,786,1458,28,647,1240,23,28.071428571428573,<=30,WI,Away,Upto 2014
JR Thomson,AUS,Pace,1978-04-15,Port of Spain,West Indies,1978,2,140,228,3,1,408,786,17,268,558,14,24.0,<=30,WI,Away,Upto 2014
JR Thomson,AUS,Pace,1978-04-28,Kingston,West Indies,1978,2,114,222,3,1,520,1042,12,406,820,9,43.333333333333336,>30,WI,Away,Upto 2014
JR Thomson,AUS,Pace,1979-12-01,Brisbane,Australia,1979,2,93,162,4,1,937,2006,27,844,1844,23,34.7037037037037,>30,AUS,Home,Upto 2014
JR Thomson,AUS,Pace,1979-12-14,W.A.C.A,Australia,1979,2,100,192,3,1,716,1874,34,616,1682,31,21.058823529411764,<=30,AUS,Home,Upto 2014
JR Thomson,AUS,Pace,1981-11-13,W.A.C.A,Australia,1981,2,39,84,2,1,628,1440,27,589,1356,25,23.25925925925926,<=30,AUS,Home,Upto 2014
JR Thomson,AUS,Pace,1981-11-27,Brisbane,Australia,1981,2,95,180,3,1,651,1292,22,556,1112,19,29.59090909090909,<=30,AUS,Home,Upto 2014
JR Thomson,AUS,Pace,1981-12-11,Melbourne,Australia,1981,1,85,150,0,1,395,1019,11,310,869,11,35.90909090909091,>30,AUS,Home,Upto 2014
JR Thomson,AUS,Pace,1982-01-02,Sydney,Australia,1982,2,143,210,3,1,792,1770,20,649,1560,17,39.6,>30,AUS,Home,Upto 2014
JR Thomson,AUS,Pace,1982-01-30,Adelaide,Australia,1982,2,174,289,6,1,872,1878,30,698,1589,24,29.066666666666666,<=30,AUS,Home,Upto 2014
JR Thomson,AUS,Pace,1982-02-26,Wellington,New Zealand,1982,1,35,156,2,1,258,786,4,223,630,2,64.5,>30,NZ,Away,Upto 2014
JR Thomson,AUS,Pace,1982-03-12,Auckland,New Zealand,1982,1,52,138,0,1,673,1668,23,621,1530,23,29.26086956521739,<=30,NZ,Away,Upto 2014
JR Thomson,AUS,Pace,1982-03-19,Christchurch,New Zealand,1982,2,105,240,4,1,665,1336,24,560,1096,20,27.708333333333332,<=30,NZ,Away,Upto 2014
JR Thomson,AUS,Pace,1982-09-22,Karachi,Pakistan,1982,2,119,192,2,1,384,853,11,265,661,9,34.90909090909091,>30,PAK,Away,Upto 2014
JR Thomson,AUS,Pace,1982-09-30,Faisalabad,Pakistan,1982,1,79,138,0,1,292,720,7,213,582,7,41.714285714285715,>30,PAK,Away,Upto 2014
JR Thomson,AUS,Pace,1982-10-14,Lahore,Pakistan,1982,2,97,144,1,1,661,1346,22,564,1202,21,30.045454545454547,>30,PAK,Away,Upto 2014
JR Thomson,AUS,Pace,1982-11-26,Brisbane,Australia,1982,2,116,234,5,1,686,1313,27,570,1079,22,25.40740740740741,<=30,AUS,Home,Upto 2014
JR Thomson,AUS,Pace,1982-12-10,Adelaide,Australia,1982,2,92,167,5,1,666,1305,27,574,1138,22,24.666666666666668,<=30,AUS,Home,Upto 2014
JR Thomson,AUS,Pace,1982-12-26,Melbourne,Australia,1982,2,123,204,5,1,837,1586,32,714,1382,27,26.15625,<=30,AUS,Home,Upto 2014
JR Thomson,AUS,Pace,1983-01-02,Sydney,Australia,1983,2,80,161,7,1,595,1175,21,515,1014,14,28.333333333333332,<=30,AUS,Home,Upto 2014
JR Thomson,AUS,Pace,1985-06-13,Leeds,England,1985,2,174,222,2,1,1140,1931,28,966,1709,26,40.714285714285715,>30,ENG,Away,Upto 2014
JR Thomson,AUS,Pace,1985-08-15,Birmingham,England,1985,1,101,114,1,1,829,1344,20,728,1230,19,41.45,>30,ENG,Away,Upto 2014
JR Watkins,AUS,Spin,1973-01-06,Sydney,Australia,1973,1,21,48,0,1,122,273,3,101,225,3,40.666666666666664,>30,AUS,Home,Upto 2014
JRF Duncan,AUS,Pace,1971-01-21,Melbourne,Australia,1971,1,30,112,0,1,660,1712,13,630,1600,13,50.76923076923077,>30,AUS,Home,Upto 2014
JS Patel,NZ,Spin,2006-04-27,Cape Town,South Africa,2006,1,117,252,3,1,434,954,6,317,702,3,72.33333333333333,>30,SA,Away,Upto 2014
JS Patel,NZ,Spin,2008-03-05,Hamilton,New Zealand,2008,2,146,324,4,1,412,1080,12,266,756,8,34.333333333333336,>30,NZ,Home,Upto 2014
JS Patel,NZ,Spin,2008-03-22,Napier,New Zealand,2008,2,141,293,4,1,490,971,14,349,678,10,35.0,>30,NZ,Home,Upto 2014
JS Patel,NZ,Spin,2008-10-17,Chattogram,Bangladesh,2008,2,120,247,4,1,669,1820,29,549,1573,25,23.06896551724138,<=30,BAN,Away,Upto 2014
JS Patel,NZ,Spin,2008-10-25,Mirpur,Bangladesh,2008,1,45,90,1,1,361,720,10,316,630,9,36.1,>30,BAN,Away,Upto 2014
JS Patel,NZ,Spin,2008-12-19,Napier,New Zealand,2008,2,151,426,6,1,472,1254,11,321,828,5,42.90909090909091,>30,NZ,Home,Upto 2014
JS Patel,NZ,Spin,2009-03-26,Napier,New Zealand,2009,2,180,384,4,1,685,1306,9,505,922,5,76.11111111111111,>30,NZ,Home,Upto 2014
JS Patel,NZ,Spin,2009-08-18,Galle,Sri Lanka,2009,2,189,216,1,1,652,1329,16,463,1113,15,40.75,>30,SL,Away,Upto 2014
JS Patel,NZ,Spin,2009-08-26,Colombo (SSC),Sri Lanka,2009,2,200,324,6,1,760,1587,27,560,1263,21,28.14814814814815,<=30,SL,Away,Upto 2014
JS Patel,NZ,Spin,2010-02-15,Hamilton,New Zealand,2010,2,128,162,2,1,711,1173,10,583,1011,8,71.1,>30,NZ,Home,Upto 2014
JS Patel,NZ,Spin,2010-03-27,Hamilton,New Zealand,2010,2,170,306,2,1,478,999,10,308,693,8,47.8,>30,NZ,Home,Upto 2014
JS Patel,NZ,Spin,2010-11-04,Ahmedabad,India,2010,2,207,312,3,1,781,1719,18,574,1407,15,43.388888888888886,>30,IND,Away,Upto 2014
JS Patel,NZ,Spin,2011-11-01,Bulawayo,Zimbabwe,2011,2,142,216,0,1,535,1222,13,393,1006,13,41.15384615384615,>30,ZIM,Away,Upto 2014
JS Patel,NZ,Spin,2012-08-23,Hyderabad,India,2012,1,100,246,4,1,326,884,22,226,638,18,14.818181818181818,<=30,IND,Away,Upto 2014
JS Patel,NZ,Spin,2012-08-31,Bengaluru,India,2012,2,146,206,3,1,445,783,16,299,577,13,27.8125,<=30,IND,Away,Upto 2014
JS Patel,NZ,Spin,2012-11-17,Galle,Sri Lanka,2012,2,77,168,3,1,290,649,16,213,481,13,18.125,<=30,SL,Away,Upto 2014
JS Patel,NZ,Spin,2012-11-25,Colombo (PSS),Sri Lanka,2012,2,67,228,1,1,489,1212,15,422,984,14,32.6,>30,SL,Away,Upto 2014
JS Patel,NZ,Spin,2013-01-02,Cape Town,South Africa,2013,1,60,102,0,1,102,198,1,42,96,1,102.0,>30,SA,Away,Upto 2014
JS Patel,NZ,Spin,2013-01-11,Gqeberha,South Africa,2013,1,134,221,1,1,217,449,5,83,228,4,43.4,>30,SA,Away,Upto 2014
JS Patel,NZ,Spin,2016-09-30,Eden Gardens,India,2016,2,116,174,2,1,455,834,14,339,660,12,32.5,>30,IND,Away,After 1965
JS Patel,NZ,Spin,2016-10-08,Indore,India,2016,2,176,324,4,1,676,1243,22,500,919,18,30.727272727272727,>30,IND,Away,After 1965
JS Patel,NZ,Spin,2017-03-08,Dunedin,New Zealand,2017,2,157,414,4,1,338,837,10,181,423,6,33.8,>30,NZ,Home,After 1965
JS Patel,NZ,Spin,2017-03-16,Wellington,New Zealand,2017,1,57,84,1,1,195,389,13,138,305,12,15.0,<=30,NZ,Home,After 1965
JS Patel,NZ,Spin,2017-03-25,Hamilton,New Zealand,2017,2,52,114,2,1,252,528,5,200,414,3,50.4,>30,NZ,Home,After 1965
JS Solomon,WI,Spin,1958-12-12,Kanpur,India,1958,2,8,30,0,1,669,1431,13,661,1401,13,51.46153846153846,>30,IND,Away,Upto 2014
JS Solomon,WI,Spin,1959-02-06,Delhi,India,1959,2,68,168,0,1,775,1794,11,707,1626,11,70.45454545454545,>30,IND,Away,Upto 2014
JS Solomon,WI,Spin,1959-02-20,Karachi,Pakistan,1959,1,8,24,0,1,375,1262,15,367,1238,15,25.0,<=30,PAK,Away,Upto 2014
JS Solomon,WI,Spin,1960-01-28,Port of Spain,West Indies,1960,1,19,42,0,1,448,1444,13,429,1402,13,34.46153846153846,>30,WI,Home,Upto 2014
JS Solomon,WI,Spin,1960-02-17,Kingston,West Indies,1960,2,32,60,1,1,443,1323,11,411,1263,10,40.27272727272727,>30,WI,Home,Upto 2014
JS Solomon,WI,Spin,1961-01-27,Adelaide,Australia,1961,1,1,24,0,1,1001,2526,24,1000,2502,24,41.708333333333336,>30,AUS,Away,Upto 2014
JS Solomon,WI,Spin,1962-03-07,Kingston,West Indies,1962,1,3,12,0,1,783,1924,16,780,1912,16,48.9375,>30,WI,Home,Upto 2014
JS Solomon,WI,Spin,1962-03-23,Bridgetown,West Indies,1962,1,33,174,0,1,596,2431,22,563,2257,22,27.09090909090909,<=30,WI,Home,Upto 2014
JS Solomon,WI,Spin,1965-03-03,Kingston,West Indies,1965,1,23,30,1,1,482,1161,15,459,1131,14,32.13333333333333,>30,WI,Home,Upto 2014
JS Solomon,WI,Spin,1965-04-14,Georgetown,West Indies,1965,1,31,54,1,1,385,975,21,354,921,20,18.333333333333332,<=30,WI,Home,Upto 2014
JS Solomon,WI,Spin,1965-05-05,Bridgetown,West Indies,1965,1,42,84,1,1,856,1946,10,814,1862,9,85.6,>30,WI,Home,Upto 2014
JSE Price,ENG,Pace,1964-01-21,Brabourne,India,1964,2,113,216,5,1,366,747,11,253,531,6,33.27272727272727,>30,IND,Away,Upto 2014
JSE Price,ENG,Pace,1964-01-29,Eden Gardens,India,1964,2,104,180,5,1,354,661,13,250,481,8,27.23076923076923,<=30,IND,Away,Upto 2014
JSE Price,ENG,Pace,1964-02-08,Delhi,India,1964,2,107,192,2,1,223,360,2,116,168,0,111.5,>30,IND,Away,Upto 2014
JSE Price,ENG,Pace,1964-02-15,Kanpur,India,1964,2,59,157,2,1,118,235,3,59,78,1,39.333333333333336,>30,IND,Away,Upto 2014
JSE Price,ENG,Pace,1964-07-23,Manchester,England,1964,1,183,270,3,1,759,1991,14,576,1721,11,54.214285714285715,>30,ENG,Home,Upto 2014
JSE Price,ENG,Pace,1964-08-13,The Oval,England,1964,1,67,126,1,1,732,1783,22,665,1657,21,33.27272727272727,>30,ENG,Home,Upto 2014
JSE Price,ENG,Pace,1964-12-04,Durban,South Africa,1964,2,26,90,2,1,364,1062,8,338,972,6,45.5,>30,SA,Away,Upto 2014
JSE Price,ENG,Pace,1964-12-23,Johannesburg,South Africa,1964,2,115,282,2,1,619,1341,11,504,1059,9,56.27272727272727,>30,SA,Away,Upto 2014
JSE Price,ENG,Pace,1965-01-01,Cape Town,South Africa,1965,2,152,270,1,1,647,1572,12,495,1302,11,53.916666666666664,>30,SA,Away,Upto 2014
JSE Price,ENG,Pace,1965-01-22,Johannesburg,South Africa,1965,2,124,186,3,1,754,1664,13,630,1478,10,58.0,>30,SA,Away,Upto 2014
JSE Price,ENG,Pace,1971-06-17,Lord's,England,1971,1,29,70,3,1,276,712,9,247,642,6,30.666666666666668,>30,ENG,Home,Upto 2014
JSE Price,ENG,Pace,1971-07-22,Lord's,England,1971,2,72,174,3,1,287,804,9,215,630,6,31.88888888888889,>30,ENG,Home,Upto 2014
JSE Price,ENG,Pace,1971-08-05,Manchester,England,1971,2,74,192,4,1,409,1030,17,335,838,13,24.058823529411764,<=30,ENG,Home,Upto 2014
JSE Price,ENG,Pace,1971-08-19,The Oval,England,1971,2,61,120,1,1,247,588,5,186,468,4,49.4,>30,ENG,Home,Upto 2014
JSE Price,ENG,Pace,1972-06-22,Lord's,England,1972,2,115,199,3,1,594,1418,30,479,1219,27,19.8,<=30,ENG,Home,Upto 2014
JT Ball,ENG,Pace,2016-07-14,Lord's,England,2016,2,88,210,1,1,760,1521,27,672,1311,26,28.14814814814815,<=30,ENG,Home,After 1965
JT Ball,ENG,Pace,2016-12-08,Wankhede,India,2016,1,47,108,1,1,329,570,3,282,462,2,109.66666666666667,>30,IND,Away,After 1965
JT Ball,ENG,Pace,2016-12-16,Chennai,India,2016,1,93,138,0,1,437,846,9,344,708,9,48.55555555555556,>30,IND,Away,After 1965
JT Ball,ENG,Pace,2017-11-23,Brisbane,Australia,2017,2,115,156,1,1,713,1568,21,598,1412,20,33.95238095238095,>30,AUS,Away,After 1965
JT Botten,SA,Pace,1965-07-22,Lord's,England,1965,2,90,270,2,1,689,1908,25,599,1638,23,27.56,<=30,ENG,Away,Upto 2014
JT Botten,SA,Pace,1965-08-05,Nottingham,England,1965,2,118,252,3,1,718,1736,30,600,1484,27,23.933333333333334,<=30,ENG,Away,Upto 2014
JT Botten,SA,Pace,1965-08-26,The Oval,England,1965,2,129,306,3,1,786,1848,27,657,1542,24,29.11111111111111,<=30,ENG,Away,Upto 2014
JT Brown,ENG,Spin,1899-06-29,Leeds,England,1899,1,22,35,0,1,225,608,11,203,573,11,20.454545454545453,<=30,ENG,Home,After 1965
JT Hearne,ENG,Pace,1892-03-19,Cape Town,South Africa,1892,1,12,40,1,1,379,805,14,367,765,13,27.071428571428573,<=30,SA,Away,After 1965
JT Hearne,ENG,Pace,1896-06-22,Lord's,England,1896,1,76,180,5,1,652,1288,29,576,1108,24,22.482758620689655,<=30,ENG,Home,After 1965
JT Hearne,ENG,Pace,1896-07-16,Manchester,England,1896,2,75,260,0,1,587,1233,20,512,973,20,29.35,<=30,ENG,Home,After 1965
JT Hearne,ENG,Pace,1896-08-10,The Oval,England,1896,2,60,196,10,1,180,416,13,120,220,3,13.846153846153847,<=30,ENG,Home,After 1965
JT Hearne,ENG,Pace,1897-12-13,Sydney,Australia,1897,2,141,349,9,1,722,1597,21,581,1248,12,34.38095238095238,>30,AUS,Away,After 1965
JT Hearne,ENG,Pace,1898-01-01,Melbourne,Australia,1898,1,94,216,1,1,464,1032,7,370,816,6,66.28571428571429,>30,AUS,Away,After 1965
JT Hearne,ENG,Pace,1898-01-14,Adelaide,Australia,1898,1,94,265,2,1,674,1910,19,580,1645,17,35.473684210526315,>30,AUS,Away,After 1965
JT Hearne,ENG,Pace,1898-01-29,Melbourne,Australia,1898,2,117,256,6,1,528,1140,21,411,884,15,25.142857142857142,<=30,AUS,Away,After 1965
JT Hearne,ENG,Pace,1898-02-26,Sydney,Australia,1898,2,92,216,2,1,648,1334,24,556,1118,22,27.0,<=30,AUS,Away,After 1965
JT Hearne,ENG,Pace,1899-06-01,Nottingham,England,1899,2,141,440,5,1,533,1449,20,392,1009,15,26.65,<=30,ENG,Home,After 1965
JT Hearne,ENG,Pace,1899-06-29,Leeds,England,1899,2,119,273,5,1,374,834,15,255,561,10,24.933333333333334,<=30,ENG,Home,After 1965
JT Hearne,ENG,Pace,1899-07-17,Manchester,England,1899,2,61,285,3,1,742,1679,23,681,1394,20,32.26086956521739,>30,ENG,Home,After 1965
JT Ikin,ENG,Spin,1946-06-22,Lord's,England,1946,1,43,60,1,1,376,791,8,333,731,7,47.0,>30,ENG,Home,Upto 2014
JT Ikin,ENG,Spin,1946-07-20,Manchester,England,1946,1,11,12,0,1,221,522,7,210,510,7,31.571428571428573,>30,ENG,Home,Upto 2014
JT Ikin,ENG,Spin,1946-11-29,Brisbane,Australia,1946,1,24,16,0,1,284,598,7,260,582,7,40.57142857142857,>30,AUS,Away,Upto 2014
JT Ikin,ENG,Spin,1946-12-13,Sydney,Australia,1946,1,15,24,0,1,831,1933,19,816,1909,19,43.73684210526316,>30,AUS,Away,Upto 2014
JT Ikin,ENG,Spin,1947-01-31,Adelaide,Australia,1947,1,9,16,0,1,672,1532,8,663,1516,8,84.0,>30,AUS,Away,Upto 2014
JT Ikin,ENG,Spin,1948-01-21,Bridgetown,West Indies,1948,2,86,168,1,1,610,1348,22,524,1180,21,27.727272727272727,<=30,WI,Away,Upto 2014
JT Ikin,ENG,Spin,1948-02-11,Port of Spain,West Indies,1948,1,60,120,0,1,644,1409,17,584,1289,17,37.88235294117647,>30,WI,Away,Upto 2014
JT Ikin,ENG,Spin,1948-03-03,Georgetown,West Indies,1948,1,22,30,0,1,451,1064,19,429,1034,19,23.736842105263158,<=30,WI,Away,Upto 2014
JT Ikin,ENG,Spin,1948-03-27,Kingston,West Indies,1948,2,84,126,1,1,658,1636,13,574,1510,12,50.61538461538461,>30,WI,Away,Upto 2014
JT Partridge,SA,Pace,1963-12-06,Brisbane,Australia,1963,2,137,336,1,1,562,1265,13,425,929,12,43.23076923076923,>30,AUS,Away,Upto 2014
JT Partridge,SA,Pace,1964-01-01,Melbourne,Australia,1964,2,157,408,5,1,870,1955,24,713,1547,19,36.25,>30,AUS,Away,Upto 2014
JT Partridge,SA,Pace,1964-01-10,Sydney,Australia,1964,2,211,419,9,1,926,1995,29,715,1576,20,31.93103448275862,>30,AUS,Away,Upto 2014
JT Partridge,SA,Pace,1964-01-24,Adelaide,Australia,1964,2,152,312,1,1,1036,2074,26,884,1762,25,39.84615384615385,>30,AUS,Away,Upto 2014
JT Partridge,SA,Pace,1964-02-07,Sydney,Australia,1964,2,176,505,9,1,694,1880,20,518,1375,11,34.7,>30,AUS,Away,Upto 2014
JT Partridge,SA,Pace,1964-02-21,Wellington,New Zealand,1964,2,60,354,2,1,514,1667,18,454,1313,16,28.555555555555557,<=30,NZ,Away,Upto 2014
JT Partridge,SA,Pace,1964-02-28,Dunedin,New Zealand,1964,2,54,234,4,1,306,1085,13,252,851,9,23.53846153846154,<=30,NZ,Away,Upto 2014
JT Partridge,SA,Pace,1964-03-13,Auckland,New Zealand,1964,2,133,384,7,1,606,1729,24,473,1345,17,25.25,<=30,NZ,Away,Upto 2014
JT Partridge,SA,Pace,1964-12-04,Durban,South Africa,1964,1,85,270,3,1,364,1062,8,279,792,5,45.5,>30,SA,Home,Upto 2014
JT Partridge,SA,Pace,1964-12-23,Johannesburg,South Africa,1964,1,106,240,1,1,619,1341,11,513,1101,10,56.27272727272727,>30,SA,Home,Upto 2014
JT Partridge,SA,Pace,1965-01-22,Johannesburg,South Africa,1965,2,102,222,2,1,754,1664,13,652,1442,11,58.0,>30,SA,Home,Upto 2014
JT Sparling,NZ,Spin,1958-07-03,Leeds,England,1958,1,78,138,1,1,241,963,20,163,825,19,12.05,<=30,ENG,Away,Upto 2014
JT Sparling,NZ,Spin,1958-07-24,Manchester,England,1958,1,46,126,1,1,295,909,16,249,783,15,18.4375,<=30,ENG,Away,Upto 2014
JT Sparling,NZ,Spin,1959-02-27,Christchurch,New Zealand,1959,1,38,96,0,1,315,1017,18,277,921,18,17.5,<=30,NZ,Home,Upto 2014
JT Sparling,NZ,Spin,1959-03-14,Auckland,New Zealand,1959,1,48,120,0,1,206,465,5,158,345,5,41.2,>30,NZ,Home,Upto 2014
JT Sparling,NZ,Spin,1961-12-08,Durban,South Africa,1961,1,0,6,0,1,285,733,16,285,727,16,17.8125,<=30,SA,Away,Upto 2014
JT Sparling,NZ,Spin,1962-01-01,Cape Town,South Africa,1962,2,34,72,1,1,569,1566,23,535,1494,22,24.73913043478261,<=30,SA,Away,Upto 2014
JT Sparling,NZ,Spin,1963-02-23,Auckland,New Zealand,1963,1,52,72,1,1,567,1236,14,515,1164,13,40.5,>30,NZ,Home,Upto 2014
JT Sparling,NZ,Spin,1964-02-21,Wellington,New Zealand,1964,1,22,36,0,1,335,893,10,313,857,10,33.5,>30,NZ,Home,Upto 2014
JT Sparling,NZ,Spin,1964-02-28,Dunedin,New Zealand,1964,1,9,42,1,1,207,662,16,198,620,15,12.9375,<=30,NZ,Home,Upto 2014
JT Willoughby,SA,Pace,1896-02-13,Gqeberha,South Africa,1896,2,122,205,4,1,376,688,29,254,483,25,12.96551724137931,<=30,SA,Home,After 1965
JT Willoughby,SA,Pace,1896-03-21,Cape Town,South Africa,1896,1,37,70,2,1,245,540,16,208,470,14,15.3125,<=30,SA,Home,After 1965
JTC Vaughan,NZ,Pace,1992-11-27,Moratuwa,Sri Lanka,1992,1,56,84,0,1,602,1223,13,546,1139,13,46.30769230769231,>30,SL,Away,Upto 2014
JTC Vaughan,NZ,Pace,1996-04-19,Bridgetown,West Indies,1996,1,81,204,2,1,918,1755,25,837,1551,23,36.72,>30,WI,Away,Upto 2014
JTC Vaughan,NZ,Pace,1996-04-27,St John's,West Indies,1996,2,109,273,3,1,915,1920,26,806,1647,23,35.19230769230769,>30,WI,Away,Upto 2014
JTC Vaughan,NZ,Pace,1996-11-21,Lahore,Pakistan,1996,2,75,161,5,1,507,953,23,432,792,18,22.043478260869566,<=30,PAK,Away,Upto 2014
JTC Vaughan,NZ,Pace,1996-11-28,Rawalpindi,Pakistan,1996,1,72,102,0,1,614,1126,22,542,1024,22,27.90909090909091,<=30,PAK,Away,Upto 2014
JTC Vaughan,NZ,Pace,1997-01-24,Auckland,New Zealand,1997,1,57,216,1,1,815,1797,20,758,1581,19,40.75,>30,NZ,Home,Upto 2014
JV Coney,NZ,Pace,1974-03-01,Wellington,New Zealand,1974,1,13,16,0,1,960,1997,18,947,1981,18,53.333333333333336,>30,NZ,Home,Upto 2014
JV Coney,NZ,Pace,1979-02-02,Christchurch,New Zealand,1979,2,43,152,2,1,652,1680,19,609,1528,17,34.31578947368421,>30,NZ,Home,Upto 2014
JV Coney,NZ,Pace,1979-02-16,Napier,New Zealand,1979,2,59,280,1,1,699,1749,19,640,1469,18,36.78947368421053,>30,NZ,Home,Upto 2014
JV Coney,NZ,Pace,1979-02-23,Auckland,New Zealand,1979,1,51,152,0,1,754,1863,27,703,1711,27,27.925925925925927,<=30,NZ,Home,Upto 2014
JV Coney,NZ,Pace,1980-02-22,Christchurch,New Zealand,1980,2,104,192,1,1,946,1857,20,842,1665,19,47.3,>30,NZ,Home,Upto 2014
JV Coney,NZ,Pace,1980-12-26,Melbourne,Australia,1980,2,29,81,3,1,683,1801,29,654,1720,26,23.551724137931036,<=30,AUS,Away,Upto 2014
JV Coney,NZ,Pace,1981-02-21,Wellington,New Zealand,1981,1,9,24,0,1,725,1705,33,716,1681,33,21.96969696969697,<=30,NZ,Home,Upto 2014
JV Coney,NZ,Pace,1981-03-06,Christchurch,New Zealand,1981,1,12,54,2,1,349,1020,11,337,966,9,31.727272727272727,>30,NZ,Home,Upto 2014
JV Coney,NZ,Pace,1981-03-13,Auckland,New Zealand,1981,2,17,78,0,1,366,1193,11,349,1115,11,33.27272727272727,>30,NZ,Home,Upto 2014
JV Coney,NZ,Pace,1982-03-12,Auckland,New Zealand,1982,1,6,24,0,1,673,1668,23,667,1644,23,29.26086956521739,<=30,NZ,Home,Upto 2014
JV Coney,NZ,Pace,1982-03-19,Christchurch,New Zealand,1982,2,17,54,1,1,665,1336,24,648,1282,23,27.708333333333332,<=30,NZ,Home,Upto 2014
JV Coney,NZ,Pace,1983-03-11,Wellington,New Zealand,1983,1,11,30,0,1,592,1490,31,581,1460,31,19.096774193548388,<=30,NZ,Home,Upto 2014
JV Coney,NZ,Pace,1983-07-14,The Oval,England,1983,1,39,162,0,1,726,1662,20,687,1500,20,36.3,>30,ENG,Away,Upto 2014
JV Coney,NZ,Pace,1983-07-28,Leeds,England,1983,2,51,120,4,1,786,1782,32,735,1662,28,24.5625,<=30,ENG,Away,Upto 2014
JV Coney,NZ,Pace,1983-08-11,Lord's,England,1983,2,15,84,1,1,667,1618,29,652,1534,28,23.0,<=30,ENG,Away,Upto 2014
JV Coney,NZ,Pace,1983-08-25,Nottingham,England,1983,1,10,12,0,1,763,1600,21,753,1588,21,36.333333333333336,>30,ENG,Away,Upto 2014
JV Coney,NZ,Pace,1984-01-20,Wellington,New Zealand,1984,1,10,24,0,1,1002,2037,24,992,2013,24,41.75,>30,NZ,Home,Upto 2014
JV Coney,NZ,Pace,1984-02-10,Auckland,New Zealand,1984,1,13,78,0,1,656,1758,12,643,1680,12,54.666666666666664,>30,NZ,Home,Upto 2014
JV Coney,NZ,Pace,1984-03-16,Colombo (SSC),Sri Lanka,1984,1,4,24,0,1,563,1643,28,559,1619,28,20.107142857142858,<=30,SL,Away,Upto 2014
JV Coney,NZ,Pace,1984-03-24,Colombo (CCC),Sri Lanka,1984,1,7,18,0,1,479,1056,21,472,1038,21,22.80952380952381,<=30,SL,Away,Upto 2014
JV Coney,NZ,Pace,1984-11-16,Lahore,Pakistan,1984,1,4,12,0,1,340,861,14,336,849,14,24.285714285714285,<=30,PAK,Away,Upto 2014
JV Coney,NZ,Pace,1984-11-25,Hyderabad (Sind),Pakistan,1984,2,17,84,0,1,178,432,6,161,348,6,29.666666666666668,<=30,PAK,Away,Upto 2014
JV Coney,NZ,Pace,1984-12-10,Karachi,Pakistan,1984,1,5,30,0,1,473,890,12,468,860,12,39.416666666666664,>30,PAK,Away,Upto 2014
JV Coney,NZ,Pace,1985-01-25,Auckland,New Zealand,1985,1,7,24,0,1,673,1429,25,666,1405,25,26.92,<=30,NZ,Home,Upto 2014
JV Coney,NZ,Pace,1985-02-09,Dunedin,New Zealand,1985,1,16,36,1,1,862,2018,34,846,1982,33,25.352941176470587,<=30,NZ,Home,Upto 2014
JV Coney,NZ,Pace,1985-03-29,Port of Spain,West Indies,1985,1,17,54,1,1,784,1698,30,767,1644,29,26.133333333333333,<=30,WI,Away,Upto 2014
JV Coney,NZ,Pace,1985-04-06,Georgetown,West Indies,1985,2,82,168,2,1,825,1600,20,743,1432,18,41.25,>30,WI,Away,Upto 2014
JV Coney,NZ,Pace,1985-05-04,Kingston,West Indies,1985,1,38,84,2,1,691,1483,26,653,1399,24,26.576923076923077,<=30,WI,Away,Upto 2014
JV Coney,NZ,Pace,1985-11-08,Brisbane,Australia,1985,2,11,60,0,1,699,1580,23,688,1520,23,30.391304347826086,>30,AUS,Away,Upto 2014
JV Coney,NZ,Pace,1985-11-22,Sydney,Australia,1985,2,16,60,0,1,241,652,9,225,592,9,26.77777777777778,<=30,AUS,Away,Upto 2014
JV Coney,NZ,Pace,1985-11-30,W.A.C.A,Australia,1985,2,52,174,3,1,726,2093,28,674,1919,25,25.928571428571427,<=30,AUS,Away,Upto 2014
JV Coney,NZ,Pace,1986-02-21,Wellington,New Zealand,1986,1,47,108,3,1,687,1390,14,640,1282,11,49.07142857142857,>30,NZ,Home,Upto 2014
JV Coney,NZ,Pace,1986-02-28,Christchurch,New Zealand,1986,2,38,72,0,1,712,1681,22,674,1609,22,32.36363636363637,>30,NZ,Home,Upto 2014
JV Coney,NZ,Pace,1986-03-13,Auckland,New Zealand,1986,1,18,30,0,1,481,1210,15,463,1180,15,32.06666666666667,>30,NZ,Home,Upto 2014
JV Coney,NZ,Pace,1986-07-24,Lord's,England,1986,1,12,24,0,1,599,1428,17,587,1404,17,35.23529411764706,>30,ENG,Away,Upto 2014
JV Coney,NZ,Pace,1986-08-07,Nottingham,England,1986,1,18,42,0,1,656,1476,21,638,1434,21,31.238095238095237,>30,ENG,Away,Upto 2014
JV Coney,NZ,Pace,1986-08-21,The Oval,England,1986,1,18,30,0,1,479,811,12,461,781,12,39.916666666666664,>30,ENG,Away,Upto 2014
JV Coney,NZ,Pace,1987-02-20,Wellington,New Zealand,1987,1,8,18,0,1,656,1620,18,648,1602,18,36.44444444444444,>30,NZ,Home,Upto 2014
JV Coney,NZ,Pace,1987-02-27,Auckland,New Zealand,1987,1,22,66,0,1,550,1311,24,528,1245,24,22.916666666666668,<=30,NZ,Home,Upto 2014
JV Saunders,AUS,Spin,1902-02-14,Sydney,Australia,1902,2,162,403,9,1,685,1842,29,523,1439,20,23.620689655172413,<=30,AUS,Home,Upto 2014
JV Saunders,AUS,Spin,1902-06-12,Lord's,England,1902,1,15,18,0,1,20,60,0,5,42,0,inf,>30,ENG,Away,Upto 2014
JV Saunders,AUS,Spin,1902-07-03,Sheffield,England,1902,2,118,165,5,1,486,1005,28,368,840,23,17.357142857142858,<=30,ENG,Away,Upto 2014
JV Saunders,AUS,Spin,1902-07-24,Manchester,England,1902,2,156,322,7,1,549,1292,26,393,970,19,21.115384615384617,<=30,ENG,Away,Upto 2014
JV Saunders,AUS,Spin,1902-08-11,The Oval,England,1902,2,184,282,6,1,548,1222,24,364,940,18,22.833333333333332,<=30,ENG,Away,Upto 2014
JV Saunders,AUS,Spin,1902-10-18,Johannesburg,South Africa,1902,2,66,120,9,1,315,623,23,249,503,14,13.695652173913043,<=30,SA,Away,Upto 2014
JV Saunders,AUS,Spin,1902-11-08,Cape Town,South Africa,1902,2,110,177,6,1,284,500,12,174,323,6,23.666666666666668,<=30,SA,Away,Upto 2014
JV Saunders,AUS,Spin,1903-12-11,Sydney,Australia,1903,2,176,331,4,1,839,1769,19,663,1438,15,44.1578947368421,>30,AUS,Home,Upto 2014
JV Saunders,AUS,Spin,1904-01-01,Melbourne,Australia,1904,2,93,144,2,1,442,925,27,349,781,25,16.37037037037037,<=30,AUS,Home,Upto 2014
JV Saunders,AUS,Spin,1907-12-13,Sydney,Australia,1907,2,110,204,4,1,592,1308,17,482,1104,13,34.8235294117647,>30,AUS,Home,Upto 2014
JV Saunders,AUS,Spin,1908-01-01,Melbourne,Australia,1908,2,158,384,4,1,799,1914,21,641,1530,17,38.04761904761905,>30,AUS,Home,Upto 2014
JV Saunders,AUS,Spin,1908-01-10,Adelaide,Australia,1908,2,148,346,6,1,776,1611,17,628,1265,11,45.64705882352941,>30,AUS,Home,Upto 2014
JV Saunders,AUS,Spin,1908-02-07,Melbourne,Australia,1908,2,104,248,9,1,481,1034,24,377,786,15,20.041666666666668,<=30,AUS,Home,Upto 2014
JV Saunders,AUS,Spin,1908-02-21,Sydney,Australia,1908,2,196,421,8,1,812,1824,30,616,1403,22,27.066666666666666,<=30,AUS,Home,Upto 2014
JW Burke,AUS,Spin,1951-02-02,Adelaide,Australia,1951,1,7,24,0,1,793,1857,24,786,1833,24,33.041666666666664,>30,AUS,Home,Upto 2014
JW Burke,AUS,Spin,1955-01-28,Adelaide,Australia,1955,1,7,16,0,1,330,1112,11,323,1096,11,30.0,<=30,AUS,Home,Upto 2014
JW Burke,AUS,Spin,1956-06-07,Nottingham,England,1956,2,6,24,0,1,279,1027,11,273,1003,11,25.363636363636363,<=30,ENG,Away,Upto 2014
JW Burke,AUS,Spin,1956-08-23,The Oval,England,1956,1,14,24,0,1,234,721,10,220,697,10,23.4,<=30,ENG,Away,Upto 2014
JW Burke,AUS,Spin,1956-10-26,Brabourne,India,1956,2,18,24,0,1,685,1650,12,667,1626,12,57.083333333333336,>30,IND,Away,Upto 2014
JW Burke,AUS,Spin,1956-11-02,Eden Gardens,India,1956,2,52,150,4,1,552,1533,35,500,1383,31,15.771428571428572,<=30,IND,Away,Upto 2014
JW Burke,AUS,Spin,1957-12-23,Johannesburg,South Africa,1957,1,39,112,1,1,467,1272,8,428,1160,7,58.375,>30,SA,Away,Upto 2014
JW Burke,AUS,Spin,1957-12-31,Cape Town,South Africa,1957,2,30,120,1,1,376,1269,21,346,1149,20,17.904761904761905,<=30,SA,Away,Upto 2014
JW Burke,AUS,Spin,1958-02-07,Johannesburg,South Africa,1958,1,8,120,0,1,358,1230,15,350,1110,15,23.866666666666667,<=30,SA,Away,Upto 2014
JW Burke,AUS,Spin,1958-12-05,Brisbane,Australia,1958,1,17,80,0,1,271,1070,11,254,990,11,24.636363636363637,<=30,AUS,Home,Upto 2014
JW Burke,AUS,Spin,1959-01-09,Sydney,Australia,1959,1,26,88,2,1,574,1742,24,548,1654,22,23.916666666666668,<=30,AUS,Home,Upto 2014
JW Burke,AUS,Spin,1959-01-30,Adelaide,Australia,1959,1,6,32,0,1,300,723,9,294,691,9,33.333333333333336,>30,AUS,Home,Upto 2014
JW Gleeson,AUS,Spin,1967-12-23,Adelaide,Australia,1967,2,74,232,4,1,620,1381,10,546,1149,6,62.0,>30,AUS,Home,Upto 2014
JW Gleeson,AUS,Spin,1967-12-30,Melbourne,Australia,1967,2,46,152,0,1,312,712,11,266,560,11,28.363636363636363,<=30,AUS,Home,Upto 2014
JW Gleeson,AUS,Spin,1968-01-19,Brisbane,Australia,1968,2,70,288,3,1,711,2018,22,641,1730,19,32.31818181818182,>30,AUS,Home,Upto 2014
JW Gleeson,AUS,Spin,1968-01-26,Sydney,Australia,1968,2,67,192,2,1,552,1735,27,485,1543,25,20.444444444444443,<=30,AUS,Home,Upto 2014
JW Gleeson,AUS,Spin,1968-06-06,Manchester,England,1968,2,65,219,4,1,456,1101,19,391,882,15,24.0,<=30,ENG,Away,Upto 2014
JW Gleeson,AUS,Spin,1968-06-20,Lord's,England,1968,1,43,162,1,1,103,330,4,60,168,3,25.75,<=30,ENG,Away,Upto 2014
JW Gleeson,AUS,Spin,1968-07-11,Birmingham,England,1968,1,84,276,2,1,212,680,8,128,404,6,26.5,<=30,ENG,Away,Upto 2014
JW Gleeson,AUS,Spin,1968-07-25,Leeds,England,1968,2,94,216,1,1,396,1367,16,302,1151,15,24.75,<=30,ENG,Away,Upto 2014
JW Gleeson,AUS,Spin,1968-08-22,The Oval,England,1968,2,131,290,4,1,604,1754,22,473,1464,18,27.454545454545453,<=30,ENG,Away,Upto 2014
JW Gleeson,AUS,Spin,1968-12-06,Brisbane,Australia,1968,2,194,488,7,1,799,2162,28,605,1674,21,28.535714285714285,<=30,AUS,Home,Upto 2014
JW Gleeson,AUS,Spin,1968-12-26,Melbourne,Australia,1968,2,110,412,6,1,459,1287,15,349,875,9,30.6,>30,AUS,Home,Upto 2014
JW Gleeson,AUS,Spin,1969-01-03,Sydney,Australia,1969,2,136,352,4,1,463,1006,8,327,654,4,57.875,>30,AUS,Home,Upto 2014
JW Gleeson,AUS,Spin,1969-01-24,Adelaide,Australia,1969,2,267,480,4,1,1020,2021,15,753,1541,11,68.0,>30,AUS,Home,Upto 2014
JW Gleeson,AUS,Spin,1969-02-14,Sydney,Australia,1969,2,137,274,5,1,776,1562,17,639,1288,12,45.64705882352941,>30,AUS,Home,Upto 2014
JW Gleeson,AUS,Spin,1969-11-04,Brabourne,India,1969,2,108,406,7,1,483,1714,20,375,1308,13,24.15,<=30,IND,Away,Upto 2014
JW Gleeson,AUS,Spin,1969-11-15,Kanpur,India,1969,2,153,384,1,1,657,2057,13,504,1673,12,50.53846153846154,>30,IND,Away,Upto 2014
JW Gleeson,AUS,Spin,1969-11-28,Delhi,India,1969,2,86,276,2,1,604,1737,30,518,1461,28,20.133333333333333,<=30,IND,Away,Upto 2014
JW Gleeson,AUS,Spin,1970-01-22,Cape Town,South Africa,1970,2,162,450,5,1,547,1442,19,385,992,14,28.789473684210527,<=30,SA,Away,Upto 2014
JW Gleeson,AUS,Spin,1970-02-05,Durban,South Africa,1970,1,160,306,3,1,348,698,8,188,392,5,43.5,>30,SA,Away,Upto 2014
JW Gleeson,AUS,Spin,1970-02-19,Johannesburg,South Africa,1970,2,186,400,8,1,258,538,9,72,138,1,28.666666666666668,<=30,SA,Away,Upto 2014
JW Gleeson,AUS,Spin,1970-03-05,Gqeberha,South Africa,1970,2,232,374,3,1,276,494,3,44,120,0,92.0,>30,SA,Away,Upto 2014
JW Gleeson,AUS,Spin,1970-11-27,Brisbane,Australia,1970,1,97,336,2,1,461,1342,10,364,1006,8,46.1,>30,AUS,Home,Upto 2014
JW Gleeson,AUS,Spin,1970-12-11,W.A.C.A,Australia,1970,2,146,512,4,1,317,920,6,171,408,2,52.833333333333336,>30,AUS,Home,Upto 2014
JW Gleeson,AUS,Spin,1971-01-09,Sydney,Australia,1971,2,137,416,4,1,467,1239,15,330,823,11,31.133333333333333,>30,AUS,Home,Upto 2014
JW Gleeson,AUS,Spin,1971-01-21,Melbourne,Australia,1971,2,78,224,3,1,448,1245,9,370,1021,6,49.77777777777778,>30,AUS,Home,Upto 2014
JW Gleeson,AUS,Spin,1971-01-29,Adelaide,Australia,1971,2,147,280,1,1,449,1176,4,302,896,3,112.25,>30,AUS,Home,Upto 2014
JW Gleeson,AUS,Spin,1972-06-08,Manchester,England,1972,2,61,190,3,1,177,420,8,116,230,5,22.125,<=30,ENG,Away,Upto 2014
JW Gleeson,AUS,Spin,1972-06-22,Lord's,England,1972,1,25,54,0,1,154,359,2,129,305,2,77.0,>30,ENG,Away,Upto 2014
JW Gleeson,AUS,Spin,1972-07-13,Nottingham,England,1972,2,71,216,0,1,374,904,5,303,688,5,74.8,>30,ENG,Away,Upto 2014
JW Hastings,AUS,Pace,2012-11-30,W.A.C.A,Australia,2012,2,153,234,1,1,885,1522,30,732,1288,29,29.5,<=30,AUS,Home,Upto 2014
JW Hearne,ENG,Spin,1911-12-15,Sydney,Australia,1911,2,95,138,1,1,459,926,15,364,788,14,30.6,>30,AUS,Away,Upto 2014
JW Hearne,ENG,Spin,1911-12-30,Melbourne,Australia,1911,2,13,12,0,1,222,429,6,209,417,6,37.0,>30,AUS,Away,Upto 2014
JW Hearne,ENG,Spin,1912-01-12,Adelaide,Australia,1912,2,67,72,0,1,429,843,6,362,771,6,71.5,>30,AUS,Away,Upto 2014
JW Hearne,ENG,Spin,1912-02-09,Melbourne,Australia,1912,2,21,24,0,1,357,761,7,336,737,7,51.0,>30,AUS,Away,Upto 2014
JW Hearne,ENG,Spin,1912-06-24,Lord's,England,1912,1,31,72,0,1,243,530,6,212,458,6,40.5,>30,ENG,Home,Upto 2014
JW Hearne,ENG,Spin,1912-07-08,Leeds,England,1912,1,5,12,1,1,384,746,14,379,734,13,27.428571428571427,<=30,ENG,Home,Upto 2014
JW Hearne,ENG,Spin,1914-01-01,Johannesburg,South Africa,1914,2,107,180,6,1,388,857,18,281,677,12,21.555555555555557,<=30,SA,Away,Upto 2014
JW Hearne,ENG,Spin,1914-02-14,Durban,South Africa,1914,1,46,66,0,1,337,984,14,291,918,14,24.071428571428573,<=30,SA,Away,Upto 2014
JW Hearne,ENG,Spin,1914-02-27,Gqeberha,South Africa,1914,2,64,126,1,1,377,889,10,313,763,9,37.7,>30,SA,Away,Upto 2014
JW Hearne,ENG,Spin,1920-12-17,Sydney,Australia,1920,2,201,456,4,1,783,1682,19,582,1226,15,41.21052631578947,>30,AUS,Away,Upto 2014
JW Hearne,ENG,Spin,1920-12-31,Melbourne,Australia,1920,1,38,84,0,1,436,860,13,398,776,13,33.53846153846154,>30,AUS,Away,Upto 2014
JW Hearne,ENG,Spin,1921-07-02,Leeds,England,1921,1,21,30,0,1,678,1167,22,657,1137,22,30.818181818181817,>30,ENG,Home,Upto 2014
JW Hearne,ENG,Spin,1924-06-28,Lord's,England,1924,2,70,222,2,1,563,1396,14,493,1174,12,40.214285714285715,>30,ENG,Home,Upto 2014
JW Hearne,ENG,Spin,1924-07-12,Leeds,England,1924,1,54,114,1,1,557,1271,20,503,1157,19,27.85,<=30,ENG,Home,Upto 2014
JW Hearne,ENG,Spin,1924-08-16,The Oval,England,1924,1,90,138,3,1,425,954,15,335,816,12,28.333333333333332,<=30,ENG,Home,Upto 2014
JW Hearne,ENG,Spin,1924-12-19,Sydney,Australia,1924,2,116,297,1,1,978,2361,24,862,2064,23,40.75,>30,AUS,Away,Upto 2014
JW Hearne,ENG,Spin,1925-01-01,Melbourne,Australia,1925,2,153,336,4,1,988,2427,24,835,2091,20,41.166666666666664,>30,AUS,Away,Upto 2014
JW Hearne,ENG,Spin,1925-02-13,Melbourne,Australia,1925,2,153,315,4,1,718,1606,23,565,1291,19,31.217391304347824,>30,AUS,Away,Upto 2014
JW Hearne,ENG,Spin,1925-02-27,Sydney,Australia,1925,2,117,232,2,1,638,1899,28,521,1667,26,22.785714285714285,<=30,AUS,Away,Upto 2014
JW Hitch,ENG,Pace,1911-12-30,Melbourne,Australia,1911,2,58,72,1,1,685,1483,24,627,1411,23,28.541666666666668,<=30,AUS,Away,Upto 2014
JW Hitch,ENG,Pace,1912-01-12,Adelaide,Australia,1912,2,71,78,2,1,730,1756,27,659,1678,25,27.037037037037038,<=30,AUS,Away,Upto 2014
JW Hitch,ENG,Pace,1912-02-23,Sydney,Australia,1912,2,54,90,2,1,454,1009,16,400,919,14,28.375,<=30,AUS,Away,Upto 2014
JW Hitch,ENG,Pace,1920-12-17,Sydney,Australia,1920,2,77,108,0,1,483,1134,15,406,1026,15,32.2,>30,AUS,Away,Upto 2014
JW Hitch,ENG,Pace,1921-08-13,The Oval,England,1921,1,65,114,2,1,511,912,11,446,798,9,46.45454545454545,>30,ENG,Home,Upto 2014
JW Martin,AUS,Spin,1960-12-30,Melbourne,Australia,1960,2,88,224,3,1,443,1051,13,355,827,10,34.07692307692308,>30,AUS,Home,Upto 2014
JW Martin,AUS,Spin,1961-01-13,Sydney,Australia,1961,2,102,144,0,1,670,1732,26,568,1588,26,25.76923076923077,<=30,AUS,Home,Upto 2014
JW Martin,AUS,Spin,1961-02-10,Melbourne,Australia,1961,2,65,144,2,1,762,2498,25,697,2354,23,30.48,>30,AUS,Home,Upto 2014
JW Martin,AUS,Spin,1964-01-01,Melbourne,Australia,1964,2,127,344,4,1,262,721,5,135,377,1,52.4,>30,AUS,Home,Upto 2014
JW Martin,AUS,Spin,1964-10-02,Chennai,India,1964,2,106,252,3,1,735,1918,23,629,1666,20,31.956521739130434,>30,IND,Away,Upto 2014
JW Martin,AUS,Spin,1964-10-10,Brabourne,India,1964,2,107,288,2,1,796,2173,26,689,1885,24,30.615384615384617,>30,IND,Away,Upto 2014
JW Martin,AUS,Spin,1964-10-24,Karachi,Pakistan,1964,2,148,318,3,1,840,2130,18,692,1812,15,46.666666666666664,>30,PAK,Away,Upto 2014
JW Martin,AUS,Spin,1967-02-24,Gqeberha,South Africa,1967,2,89,132,0,1,222,502,6,133,370,6,37.0,>30,SA,Away,Upto 2014
JW Martin,ENG,Spin,1947-06-07,Nottingham,England,1947,2,129,270,1,1,885,2189,17,756,1919,16,52.05882352941177,>30,ENG,Home,Upto 2014
JW McLaren,AUS,Pace,1912-02-23,Sydney,Australia,1912,2,70,144,1,1,454,1009,16,384,865,15,28.375,<=30,AUS,Home,Upto 2014
JW Rutherford,AUS,Spin,1956-10-26,Brabourne,India,1956,2,15,36,1,1,685,1650,12,670,1614,11,57.083333333333336,>30,IND,Away,Upto 2014
JW Sharpe,ENG,Pace,1890-08-11,The Oval,England,1890,2,18,75,2,1,285,909,28,267,834,26,10.178571428571429,<=30,ENG,Home,After 1965
JW Sharpe,ENG,Pace,1892-01-01,Melbourne,Australia,1892,2,165,630,8,1,677,2425,30,512,1795,22,22.566666666666666,<=30,AUS,Away,After 1965
JW Sharpe,ENG,Pace,1892-01-29,Sydney,Australia,1892,2,122,270,1,1,735,2292,31,613,2022,30,23.70967741935484,<=30,AUS,Away,After 1965
JW Trumble,AUS,Spin,1885-01-01,Melbourne,Australia,1885,1,41,92,0,1,372,1209,9,331,1117,9,41.333333333333336,>30,AUS,Home,After 1965
JW Trumble,AUS,Spin,1885-02-20,Sydney,Australia,1885,1,26,104,2,1,276,897,19,250,793,17,14.526315789473685,<=30,AUS,Home,After 1965
JW Trumble,AUS,Spin,1885-03-14,Sydney,Australia,1885,1,16,48,0,1,238,508,7,222,460,7,34.0,>30,AUS,Home,After 1965
JW Trumble,AUS,Spin,1885-03-21,Melbourne,Australia,1885,1,29,112,3,1,142,528,10,113,416,7,14.2,<=30,AUS,Home,After 1965
JW Trumble,AUS,Spin,1886-07-19,Lord's,England,1886,1,27,56,2,1,231,789,16,204,733,14,14.4375,<=30,ENG,Away,After 1965
JW Trumble,AUS,Spin,1886-08-12,The Oval,England,1886,1,83,188,3,1,247,704,10,164,516,7,24.7,<=30,ENG,Away,After 1965
JW Wilson,AUS,Spin,1956-10-26,Brabourne,India,1956,2,64,216,1,1,685,1650,12,621,1434,11,57.083333333333336,>30,IND,Away,Upto 2014
JW Zulch,SA,Pace,1911-02-17,Melbourne,Australia,1911,1,26,18,0,1,399,623,10,373,605,10,39.9,>30,AUS,Away,Upto 2014
JW Zulch,SA,Pace,1911-03-03,Sydney,Australia,1911,1,2,6,0,1,447,806,13,445,800,13,34.38461538461539,>30,AUS,Away,Upto 2014
JWHT Douglas,ENG,Pace,1911-12-15,Sydney,Australia,1911,2,112,270,5,1,824,1814,23,712,1544,18,35.82608695652174,>30,AUS,Away,Upto 2014
JWHT Douglas,ENG,Pace,1911-12-30,Melbourne,Australia,1911,2,71,150,1,1,685,1483,24,614,1333,23,28.541666666666668,<=30,AUS,Away,Upto 2014
JWHT Douglas,ENG,Pace,1912-01-12,Adelaide,Australia,1912,2,78,216,3,1,730,1756,27,652,1540,24,27.037037037037038,<=30,AUS,Away,Upto 2014
JWHT Douglas,ENG,Pace,1912-02-09,Melbourne,Australia,1912,1,46,107,5,1,546,1146,23,500,1039,18,23.73913043478261,<=30,AUS,Away,Upto 2014
JWHT Douglas,ENG,Pace,1912-02-23,Sydney,Australia,1912,2,48,96,1,1,454,1009,16,406,913,15,28.375,<=30,AUS,Away,Upto 2014
JWHT Douglas,ENG,Pace,1913-12-13,Durban,South Africa,1913,2,21,60,2,1,479,1054,20,458,994,18,23.95,<=30,SA,Away,Upto 2014
JWHT Douglas,ENG,Pace,1913-12-26,Johannesburg,South Africa,1913,2,38,48,0,1,455,1029,24,417,981,24,18.958333333333332,<=30,SA,Away,Upto 2014
JWHT Douglas,ENG,Pace,1914-01-01,Johannesburg,South Africa,1914,2,50,124,2,1,545,1214,22,495,1090,20,24.772727272727273,<=30,SA,Away,Upto 2014
JWHT Douglas,ENG,Pace,1914-02-14,Durban,South Africa,1914,2,82,126,1,1,410,971,20,328,845,19,20.5,<=30,SA,Away,Upto 2014
JWHT Douglas,ENG,Pace,1914-02-27,Gqeberha,South Africa,1914,2,48,88,5,1,418,956,19,370,868,14,22.0,<=30,SA,Away,Upto 2014
JWHT Douglas,ENG,Pace,1920-12-17,Sydney,Australia,1920,2,93,174,2,1,483,1134,15,390,960,13,32.2,>30,AUS,Away,Upto 2014
JWHT Douglas,ENG,Pace,1920-12-31,Melbourne,Australia,1920,1,83,144,2,1,456,894,15,373,750,13,30.4,>30,AUS,Away,Upto 2014
JWHT Douglas,ENG,Pace,1921-01-14,Adelaide,Australia,1921,2,130,258,2,1,770,1488,14,640,1230,12,55.0,>30,AUS,Away,Upto 2014
JWHT Douglas,ENG,Pace,1921-02-11,Melbourne,Australia,1921,2,30,54,0,1,517,1056,6,487,1002,6,86.16666666666667,>30,AUS,Away,Upto 2014
JWHT Douglas,ENG,Pace,1921-02-25,Sydney,Australia,1921,1,84,96,2,1,315,721,13,231,625,11,24.23076923076923,<=30,AUS,Away,Upto 2014
JWHT Douglas,ENG,Pace,1921-05-28,Nottingham,England,1921,1,34,78,2,1,251,658,20,217,580,18,12.55,<=30,ENG,Home,Upto 2014
JWHT Douglas,ENG,Pace,1921-06-11,Lord's,England,1921,2,76,90,2,1,453,764,17,377,674,15,26.647058823529413,<=30,ENG,Home,Upto 2014
JWHT Douglas,ENG,Pace,1921-07-02,Leeds,England,1921,2,118,186,3,1,408,703,13,290,517,10,31.384615384615383,>30,ENG,Home,Upto 2014
JWHT Douglas,ENG,Pace,1921-07-23,Manchester,England,1921,1,3,30,1,1,286,546,3,283,516,2,95.33333333333333,>30,ENG,Home,Upto 2014
JWHT Douglas,ENG,Pace,1921-08-13,The Oval,England,1921,1,117,180,3,1,511,912,11,394,732,8,46.45454545454545,>30,ENG,Home,Upto 2014
JWHT Douglas,ENG,Pace,1924-07-26,Manchester,England,1924,1,20,48,0,1,41,114,0,21,66,0,inf,>30,ENG,Home,Upto 2014
JWHT Douglas,ENG,Pace,1925-01-01,Melbourne,Australia,1925,2,104,189,1,1,573,1360,13,469,1171,12,44.07692307692308,>30,AUS,Away,Upto 2014
Jalal-ud-Din,PAK,Pace,1982-10-14,Lahore,Pakistan,1982,2,92,210,5,1,661,1346,22,569,1136,17,30.045454545454547,>30,PAK,Home,Upto 2014
Jalal-ud-Din,PAK,Pace,1982-12-10,Lahore,Pakistan,1982,1,93,204,2,1,700,1379,14,607,1175,12,50.0,>30,PAK,Home,Upto 2014
Jalal-ud-Din,PAK,Pace,1982-12-23,Karachi,Pakistan,1982,2,59,102,0,1,510,865,22,451,763,22,23.181818181818183,<=30,PAK,Home,Upto 2014
Jalal-ud-Din,PAK,Pace,1984-10-17,Lahore,Pakistan,1984,2,101,243,3,1,564,1248,16,463,1005,13,35.25,>30,PAK,Home,Upto 2014
Jalal-ud-Din,PAK,Pace,1984-10-24,Faisalabad,Pakistan,1984,1,103,204,0,1,679,1180,8,576,976,8,84.875,>30,PAK,Home,Upto 2014
Jalal-ud-Din,PAK,Pace,1985-10-16,Faisalabad,Pakistan,1985,1,89,234,1,1,718,1505,9,629,1271,8,79.77777777777777,>30,PAK,Home,Upto 2014
James Langridge,ENG,Spin,1933-07-22,Manchester,England,1933,2,79,156,7,1,521,1061,15,442,905,8,34.733333333333334,>30,ENG,Home,Upto 2014
James Langridge,ENG,Spin,1933-08-12,The Oval,England,1933,1,23,42,0,1,194,451,12,171,409,12,16.166666666666668,<=30,ENG,Home,Upto 2014
James Langridge,ENG,Spin,1933-12-15,Mumbai,India,1933,2,74,198,4,1,373,858,11,299,660,7,33.90909090909091,>30,IND,Away,Upto 2014
James Langridge,ENG,Spin,1934-01-05,Eden Gardens,India,1934,2,46,162,0,1,342,922,15,296,760,15,22.8,<=30,IND,Away,Upto 2014
James Langridge,ENG,Spin,1934-02-10,Chennai,India,1934,2,72,180,6,1,484,943,18,412,763,12,26.88888888888889,<=30,IND,Away,Upto 2014
James Langridge,ENG,Spin,1935-06-29,Lord's,England,1935,2,46,138,2,1,484,1320,22,438,1182,20,22.0,<=30,ENG,Home,Upto 2014
James Langridge,ENG,Spin,1936-06-27,Lord's,England,1936,1,9,24,0,1,182,439,11,173,415,11,16.545454545454547,<=30,ENG,Home,Upto 2014
James Langridge,ENG,Spin,1946-08-17,The Oval,England,1946,1,64,174,0,1,184,504,4,120,330,4,46.0,>30,ENG,Home,Upto 2014
James Lillywhite jnr,ENG,Spin,1877-03-15,Melbourne,Australia,1877,2,20,60,2,1,437,1296,31,417,1236,29,14.096774193548388,<=30,AUS,Away,After 1965
James Lillywhite jnr,ENG,Spin,1877-03-31,Melbourne,Australia,1877,2,106,280,6,1,437,1222,21,331,942,15,20.80952380952381,<=30,AUS,Away,After 1965
Javed Ahmadi,AFG,Spin,2019-11-27,Lucknow,India,2019,1,9,6,0,1,473,932,25,464,926,25,18.92,<=30,IND,Away,After 1965
Javed Ahmadi,AFG,Spin,2021-03-10,Abu Dhabi,UAE,2021,2,60,144,1,1,842,1766,20,782,1622,19,42.1,>30,UAE,Away,After 1965
Javed Akhtar,PAK,Spin,1962-07-05,Leeds,England,1962,1,52,96,0,1,208,474,7,156,378,7,29.714285714285715,<=30,ENG,Away,Upto 2014
Javed Burki,PAK,Pace,1960-12-30,Eden Gardens,India,1960,1,3,6,0,1,412,1155,15,409,1149,15,27.466666666666665,<=30,IND,Away,Upto 2014
Javed Burki,PAK,Pace,1962-01-19,Dhaka,Bangladesh,1962,1,3,12,0,1,164,648,2,161,636,2,82.0,>30,BAN,Away,Upto 2014
Javed Burki,PAK,Pace,1962-08-16,The Oval,England,1962,2,14,12,0,1,534,1069,17,520,1057,17,31.41176470588235,>30,ENG,Away,Upto 2014
Javed Burki,PAK,Pace,1964-10-24,Karachi,Pakistan,1964,1,3,12,0,1,349,725,11,346,713,11,31.727272727272727,>30,PAK,Home,Upto 2014
Javed Miandad,PAK,Spin,1976-10-09,Lahore,Pakistan,1976,1,34,60,1,1,495,1028,17,461,968,16,29.11764705882353,<=30,PAK,Home,Upto 2014
Javed Miandad,PAK,Spin,1976-10-23,Hyderabad (Sind),Pakistan,1976,2,94,216,5,1,481,1360,16,387,1144,11,30.0625,>30,PAK,Home,Upto 2014
Javed Miandad,PAK,Spin,1976-10-30,Karachi,Pakistan,1976,2,79,216,2,1,499,1183,10,420,967,8,49.9,>30,PAK,Home,Upto 2014
Javed Miandad,PAK,Spin,1976-12-24,Adelaide,Australia,1976,2,156,368,4,1,612,1524,18,456,1156,14,34.0,>30,AUS,Away,Upto 2014
Javed Miandad,PAK,Spin,1977-01-01,Melbourne,Australia,1977,1,15,16,0,1,386,751,13,371,735,13,29.692307692307693,<=30,AUS,Away,Upto 2014
Javed Miandad,PAK,Spin,1977-01-14,Sydney,Australia,1977,2,29,50,1,1,67,202,1,38,152,0,67.0,>30,AUS,Away,Upto 2014
Javed Miandad,PAK,Spin,1977-02-18,Bridgetown,West Indies,1977,2,53,130,1,1,180,418,4,127,288,3,45.0,>30,WI,Away,Upto 2014
Javed Miandad,PAK,Spin,1978-01-02,Hyderabad (Sind),Pakistan,1978,2,31,72,0,1,585,1882,17,554,1810,17,34.411764705882355,>30,PAK,Home,Upto 2014
Javed Miandad,PAK,Spin,1978-01-18,Karachi,Pakistan,1978,1,5,16,0,1,466,1665,20,461,1649,20,23.3,<=30,PAK,Home,Upto 2014
Javed Miandad,PAK,Spin,1978-06-29,Leeds,England,1978,1,14,18,1,1,69,204,1,55,186,0,69.0,>30,ENG,Away,Upto 2014
Javed Miandad,PAK,Spin,1978-10-16,Faisalabad,Pakistan,1978,1,4,18,0,1,700,1410,15,696,1392,15,46.666666666666664,>30,PAK,Home,Upto 2014
Javed Miandad,PAK,Spin,1978-10-27,Lahore,Pakistan,1978,1,7,30,1,1,591,988,6,584,958,5,98.5,>30,PAK,Home,Upto 2014
Javed Miandad,PAK,Spin,1978-11-14,Karachi,Pakistan,1978,1,15,12,0,1,383,654,5,368,642,5,76.6,>30,PAK,Home,Upto 2014
Javed Miandad,PAK,Spin,1979-03-24,W.A.C.A,Australia,1979,2,20,32,1,1,123,288,2,103,256,1,61.5,>30,AUS,Away,Upto 2014
Javed Miandad,PAK,Spin,1980-03-06,Faisalabad,Pakistan,1980,1,16,18,0,1,592,1272,6,576,1254,6,98.66666666666667,>30,PAK,Home,Upto 2014
Javed Miandad,PAK,Spin,1980-03-18,Lahore,Pakistan,1980,2,19,36,0,1,686,1374,15,667,1338,15,45.733333333333334,>30,PAK,Home,Upto 2014
Javed Miandad,PAK,Spin,1981-11-13,W.A.C.A,Australia,1981,1,2,6,0,1,231,461,11,229,455,11,21.0,<=30,AUS,Away,Upto 2014
Javed Miandad,PAK,Spin,1981-11-27,Brisbane,Australia,1981,1,18,18,0,1,312,546,7,294,528,7,44.57142857142857,>30,AUS,Away,Upto 2014
Javed Miandad,PAK,Spin,1981-12-11,Melbourne,Australia,1981,1,9,12,0,1,491,1248,15,482,1236,15,32.733333333333334,>30,AUS,Away,Upto 2014
Javed Miandad,PAK,Spin,1982-03-14,Faisalabad,Pakistan,1982,1,1,6,0,1,699,1740,27,698,1734,27,25.88888888888889,<=30,PAK,Home,Upto 2014
Javed Miandad,PAK,Spin,1982-09-30,Faisalabad,Pakistan,1982,1,2,6,0,1,662,1534,17,660,1528,17,38.94117647058823,>30,PAK,Home,Upto 2014
Javed Miandad,PAK,Spin,1983-01-30,Karachi,Pakistan,1983,1,11,12,0,1,287,546,2,276,534,2,143.5,>30,PAK,Home,Upto 2014
Javed Miandad,PAK,Spin,1983-10-05,Nagpur,India,1983,1,1,6,0,1,396,1114,18,395,1108,18,22.0,<=30,IND,Away,Upto 2014
Javed Miandad,PAK,Spin,1983-12-09,Adelaide,Australia,1983,1,10,18,0,1,433,870,5,423,852,5,86.6,>30,AUS,Away,Upto 2014
Javed Miandad,PAK,Spin,1983-12-26,Melbourne,Australia,1983,1,16,30,0,1,391,853,9,375,823,9,43.44444444444444,>30,AUS,Away,Upto 2014
Javed Miandad,PAK,Spin,1984-10-17,Lahore,Pakistan,1984,1,4,6,0,1,362,1073,9,358,1067,9,40.22222222222222,>30,PAK,Home,Upto 2014
Javed Miandad,PAK,Spin,1985-01-18,Wellington,New Zealand,1985,1,7,18,0,1,422,1002,10,415,984,10,42.2,>30,NZ,Away,Upto 2014
Javed Miandad,PAK,Spin,1987-08-06,The Oval,England,1987,1,10,24,0,1,612,1585,13,602,1561,13,47.07692307692308,>30,ENG,Away,Upto 2014
Javed Omar,BAN,Spin,2001-08-29,Multan,Pakistan,2001,1,12,6,0,1,304,445,14,292,439,14,21.714285714285715,<=30,PAK,Away,Upto 2014
Jubair Hossain,BAN,Spin,2014-10-25,Mirpur,Bangladesh,2014,2,64,96,2,1,460,898,22,396,802,20,20.90909090909091,<=30,BAN,Home,After 1965
Jubair Hossain,BAN,Spin,2014-11-03,Khulna,Bangladesh,2014,2,106,174,2,1,829,1764,29,723,1590,27,28.586206896551722,<=30,BAN,Home,After 1965
Jubair Hossain,BAN,Spin,2014-11-12,Chattogram,Bangladesh,2014,2,152,234,7,1,952,1674,19,800,1440,12,50.10526315789474,>30,BAN,Home,After 1965
Jubair Hossain,BAN,Spin,2015-06-10,Fatullah,Bangladesh,2015,1,113,114,2,1,528,806,14,415,692,12,37.714285714285715,>30,BAN,Home,After 1965
Jubair Hossain,BAN,Spin,2015-07-21,Chattogram,Bangladesh,2015,2,58,97,3,1,318,607,10,260,510,7,31.8,>30,BAN,Home,After 1965
Junaid Khan,PAK,Pace,2011-09-01,Bulawayo,Zimbabwe,2011,2,64,186,1,1,539,1117,15,475,931,14,35.93333333333333,>30,ZIM,Away,Upto 2014
Junaid Khan,PAK,Pace,2011-10-18,Abu Dhabi,UAE,2011,2,121,271,6,1,689,1303,17,568,1032,11,40.529411764705884,>30,UAE,Away,Upto 2014
Junaid Khan,PAK,Pace,2011-10-26,Dubai (DICS),UAE,2011,2,95,192,4,1,473,936,12,378,744,8,39.416666666666664,>30,UAE,Away,Upto 2014
Junaid Khan,PAK,Pace,2011-11-03,Sharjah,UAE,2011,2,103,192,2,1,418,917,14,315,725,12,29.857142857142858,<=30,UAE,Away,Upto 2014
Junaid Khan,PAK,Pace,2012-01-25,Abu Dhabi,UAE,2012,1,33,48,0,1,271,622,9,238,574,9,30.11111111111111,>30,UAE,Away,Upto 2014
Junaid Khan,PAK,Pace,2012-06-22,Galle,Sri Lanka,2012,2,96,186,3,1,350,768,9,254,582,6,38.888888888888886,>30,SL,Away,Upto 2014
Junaid Khan,PAK,Pace,2012-06-30,Colombo (SSC),Sri Lanka,2012,2,94,192,5,1,504,822,6,410,630,1,84.0,>30,SL,Away,Upto 2014
Junaid Khan,PAK,Pace,2012-07-08,Pallekele,Sri Lanka,2012,2,115,230,6,1,780,1418,19,665,1188,13,41.05263157894737,>30,SL,Away,Upto 2014
Junaid Khan,PAK,Pace,2013-02-01,Johannesburg,South Africa,2013,2,96,186,2,1,592,1253,26,496,1067,24,22.76923076923077,<=30,SA,Away,Upto 2014
Junaid Khan,PAK,Pace,2013-09-03,Harare,Zimbabwe,2013,2,91,210,4,1,657,1465,18,566,1255,14,36.5,>30,ZIM,Away,Upto 2014
Junaid Khan,PAK,Pace,2013-09-10,Harare,Zimbabwe,2013,2,104,312,5,1,558,1504,28,454,1192,23,19.928571428571427,<=30,ZIM,Away,Upto 2014
Junaid Khan,PAK,Pace,2013-10-14,Abu Dhabi,UAE,2013,2,109,220,4,1,476,1024,18,367,804,14,26.444444444444443,<=30,UAE,Away,Upto 2014
Junaid Khan,PAK,Pace,2013-10-23,Dubai (DICS),UAE,2013,1,105,189,0,1,404,958,9,299,769,9,44.888888888888886,>30,UAE,Away,Upto 2014
Junaid Khan,PAK,Pace,2013-12-31,Abu Dhabi,UAE,2013,2,151,336,8,1,807,1581,20,656,1245,12,40.35,>30,UAE,Away,Upto 2014
Junaid Khan,PAK,Pace,2014-01-08,Dubai (DICS),UAE,2014,2,136,276,3,1,719,1539,21,583,1263,18,34.23809523809524,>30,UAE,Away,After 1965
Junaid Khan,PAK,Pace,2014-01-16,Sharjah,UAE,2014,2,115,312,3,1,610,1197,18,495,885,15,33.888888888888886,>30,UAE,Away,After 1965
Junaid Khan,PAK,Pace,2014-08-06,Galle,Sri Lanka,2014,2,159,246,4,1,513,974,10,354,728,6,51.3,>30,SL,Away,After 1965
Junaid Khan,PAK,Pace,2014-08-14,Colombo (SSC),Sri Lanka,2014,1,87,162,5,1,441,792,14,354,630,9,31.5,>30,SL,Away,After 1965
Junaid Khan,PAK,Pace,2015-04-28,Khulna,Bangladesh,2015,2,128,222,2,1,401,750,6,273,528,4,66.83333333333333,>30,BAN,Away,After 1965
Junaid Khan,PAK,Pace,2015-05-06,Mirpur,Bangladesh,2015,2,71,101,3,1,464,771,14,393,670,11,33.142857142857146,>30,BAN,Away,After 1965
Junaid Khan,PAK,Pace,2015-06-17,Galle,Sri Lanka,2015,2,61,138,0,1,383,708,10,322,570,10,38.3,>30,SL,Away,After 1965
Junaid Khan,PAK,Pace,2015-06-25,Colombo (PSS),Sri Lanka,2015,2,119,198,1,1,390,800,14,271,602,13,27.857142857142858,<=30,SL,Away,After 1965
Junaid Siddique,BAN,Spin,2008-10-25,Mirpur,Bangladesh,2008,1,2,12,0,1,361,720,10,359,708,10,36.1,>30,BAN,Home,Upto 2014
Junaid Siddique,BAN,Spin,2010-01-24,Mirpur,Bangladesh,2010,1,9,6,0,1,600,1045,11,591,1039,11,54.54545454545455,>30,BAN,Home,Upto 2014
K Cranston,ENG,Pace,1947-07-05,Manchester,England,1947,1,64,204,2,1,744,1735,22,680,1531,20,33.81818181818182,>30,ENG,Home,Upto 2014
K Cranston,ENG,Pace,1947-07-26,Leeds,England,1947,2,36,109,5,1,268,799,16,232,690,11,16.75,<=30,ENG,Home,Upto 2014
K Cranston,ENG,Pace,1947-08-16,The Oval,England,1947,2,86,180,4,1,526,1254,9,440,1074,5,58.44444444444444,>30,ENG,Home,Upto 2014
K Cranston,ENG,Pace,1948-01-21,Bridgetown,West Indies,1948,2,60,168,1,1,345,968,10,285,800,9,34.5,>30,WI,Away,Upto 2014
K Cranston,ENG,Pace,1948-02-11,Port of Spain,West Indies,1948,2,47,60,1,1,529,1106,15,482,1046,14,35.266666666666666,>30,WI,Away,Upto 2014
K Cranston,ENG,Pace,1948-03-03,Georgetown,West Indies,1948,2,89,162,4,1,265,632,11,176,470,7,24.09090909090909,<=30,WI,Away,Upto 2014
K Cranston,ENG,Pace,1948-07-22,Leeds,England,1948,2,79,127,1,1,942,2038,19,863,1911,18,49.578947368421055,>30,ENG,Home,Upto 2014
K Farnes,ENG,Pace,1934-06-08,Nottingham,England,1934,2,179,392,10,1,503,1268,16,324,876,6,31.4375,>30,ENG,Home,Upto 2014
K Farnes,ENG,Pace,1934-06-22,Lord's,England,1934,2,49,96,0,1,436,1038,10,387,942,10,43.6,>30,ENG,Home,Upto 2014
K Farnes,ENG,Pace,1935-01-08,Bridgetown,West Indies,1935,2,63,144,5,1,205,438,22,142,294,17,9.318181818181818,<=30,WI,Away,Upto 2014
K Farnes,ENG,Pace,1935-03-14,Kingston,West Indies,1935,1,72,144,1,1,412,902,15,340,758,14,27.466666666666665,<=30,WI,Away,Upto 2014
K Farnes,ENG,Pace,1937-01-29,Adelaide,Australia,1937,2,160,358,5,1,675,1448,20,515,1090,15,33.75,>30,AUS,Away,Upto 2014
K Farnes,ENG,Pace,1937-02-26,Melbourne,Australia,1937,1,96,229,6,1,632,1154,16,536,925,10,39.5,>30,AUS,Away,Upto 2014
K Farnes,ENG,Pace,1938-06-10,Nottingham,England,1938,2,184,366,4,1,464,954,6,280,588,2,77.33333333333333,>30,ENG,Home,Upto 2014
K Farnes,ENG,Pace,1938-06-24,Lord's,England,1938,2,186,336,3,1,661,1148,17,475,812,14,38.88235294117647,>30,ENG,Home,Upto 2014
K Farnes,ENG,Pace,1938-07-22,Leeds,England,1938,2,94,225,5,1,285,715,10,191,490,5,28.5,<=30,ENG,Home,Upto 2014
K Farnes,ENG,Pace,1938-08-20,The Oval,England,1938,2,117,151,5,1,391,703,13,274,552,8,30.076923076923077,>30,ENG,Home,Upto 2014
K Farnes,ENG,Pace,1938-12-24,Johannesburg,South Africa,1938,2,104,240,1,1,680,1468,10,576,1228,9,68.0,>30,SA,Away,Upto 2014
K Farnes,ENG,Pace,1938-12-31,Cape Town,South Africa,1938,2,60,168,1,1,456,999,10,396,831,9,45.6,>30,SA,Away,Upto 2014
K Farnes,ENG,Pace,1939-01-20,Durban,South Africa,1939,2,109,330,7,1,487,999,14,378,669,7,34.785714285714285,>30,SA,Away,Upto 2014
K Farnes,ENG,Pace,1939-02-18,Johannesburg,South Africa,1939,1,64,208,2,1,381,1034,15,317,826,13,25.4,<=30,SA,Away,Upto 2014
K Farnes,ENG,Pace,1939-03-03,Durban,South Africa,1939,2,182,545,5,1,1100,3449,18,918,2904,13,61.111111111111114,>30,SA,Away,Upto 2014
K Higgs,ENG,Pace,1965-08-26,The Oval,England,1965,2,143,391,8,1,786,1848,27,643,1457,19,29.11111111111111,<=30,ENG,Home,Upto 2014
K Higgs,ENG,Pace,1965-12-10,Brisbane,Australia,1965,1,102,240,2,1,379,960,11,277,720,9,34.45454545454545,>30,AUS,Away,Upto 2014
K Higgs,ENG,Pace,1966-02-25,Christchurch,New Zealand,1966,2,56,234,7,1,629,1668,27,573,1434,20,23.296296296296298,<=30,NZ,Away,Upto 2014
K Higgs,ENG,Pace,1966-03-04,Dunedin,New Zealand,1966,2,41,198,5,1,364,1194,18,323,996,13,20.22222222222222,<=30,NZ,Away,Upto 2014
K Higgs,ENG,Pace,1966-03-11,Auckland,New Zealand,1966,2,60,336,5,1,459,1620,21,399,1284,16,21.857142857142858,<=30,NZ,Away,Upto 2014
K Higgs,ENG,Pace,1966-06-02,Manchester,England,1966,1,94,186,3,1,402,732,5,308,546,2,80.4,>30,ENG,Home,Upto 2014
K Higgs,ENG,Pace,1966-06-16,Lord's,England,1966,2,173,402,8,1,864,1752,24,691,1350,16,36.0,>30,ENG,Home,Upto 2014
K Higgs,ENG,Pace,1966-06-30,Nottingham,England,1966,2,180,382,7,1,760,1648,27,580,1266,20,28.14814814814815,<=30,ENG,Home,Upto 2014
K Higgs,ENG,Pace,1966-08-04,Leeds,England,1966,1,94,258,4,1,453,936,13,359,678,9,34.84615384615385,>30,ENG,Home,Upto 2014
K Higgs,ENG,Pace,1966-08-18,The Oval,England,1966,2,70,192,2,1,459,1079,13,389,887,11,35.30769230769231,>30,ENG,Home,Upto 2014
K Higgs,ENG,Pace,1967-06-08,Leeds,England,1967,2,90,228,1,1,436,1074,7,346,846,6,62.285714285714285,>30,ENG,Home,Upto 2014
K Higgs,ENG,Pace,1967-07-27,Lord's,England,1967,2,87,270,3,1,434,1150,13,347,880,10,33.38461538461539,>30,ENG,Home,Upto 2014
K Higgs,ENG,Pace,1967-08-10,Nottingham,England,1967,2,43,150,6,1,254,846,14,211,696,8,18.142857142857142,<=30,ENG,Home,Upto 2014
K Higgs,ENG,Pace,1967-08-24,The Oval,England,1967,2,119,294,8,1,449,1200,19,330,906,11,23.63157894736842,<=30,ENG,Home,Upto 2014
K Higgs,ENG,Pace,1968-06-06,Manchester,England,1968,2,121,351,2,1,493,1497,18,372,1146,16,27.38888888888889,<=30,ENG,Home,Upto 2014
K Nitish Kumar Reddy,IND,Spin,2024-11-22,Perth,Australia,2024,2,25,42,1,1,374,651,9,349,609,8,41.55555555555556,>30,AUS,Away,After 1965
K Nitish Kumar Reddy,IND,Spin,2024-12-06,Adelaide,Australia,2024,2,33,42,1,1,178,252,2,145,210,1,89.0,>30,AUS,Away,After 1965
K Nitish Kumar Reddy,IND,Spin,2024-12-14,Brisbane,Australia,2024,1,65,78,1,1,218,365,3,153,287,2,72.66666666666667,>30,AUS,Away,After 1965
K Nitish Kumar Reddy,IND,Spin,2024-12-26,Melbourne,Australia,2024,2,25,48,0,1,350,730,11,325,682,11,31.818181818181817,>30,AUS,Away,After 1965
K Nitish Kumar Reddy,IND,Spin,2025-01-03,Sydney,Australia,2025,2,42,54,2,1,137,216,4,95,162,2,34.25,>30,AUS,Away,After 1965
K Rabada,SA,Pace,2015-11-05,Mohali,India,2015,2,49,132,1,1,185,504,6,136,372,5,30.833333333333332,>30,IND,Away,After 1965
K Rabada,SA,Pace,2015-11-14,Bengaluru,India,2015,1,17,30,0,1,150,258,1,133,228,1,150.0,>30,IND,Away,After 1965
K Rabada,SA,Pace,2015-11-25,Nagpur,India,2015,2,45,132,1,1,123,391,7,78,259,6,17.571428571428573,<=30,IND,Away,After 1965
K Rabada,SA,Pace,2016-01-02,Cape Town,South Africa,2016,2,232,257,4,1,994,1661,14,762,1404,10,71.0,>30,SA,Home,After 1965
K Rabada,SA,Pace,2016-01-14,Johannesburg,South Africa,2016,2,106,163,5,1,692,1271,29,586,1108,24,23.862068965517242,<=30,SA,Home,After 1965
K Rabada,SA,Pace,2016-01-22,Centurion,South Africa,2016,2,144,238,13,1,827,1592,31,683,1354,18,26.677419354838708,<=30,SA,Home,After 1965
K Rabada,SA,Pace,2016-08-27,Centurion,South Africa,2016,2,116,177,5,1,829,1709,31,713,1532,26,26.741935483870968,<=30,SA,Home,After 1965
K Rabada,SA,Pace,2016-11-03,W.A.C.A,Australia,2016,2,170,306,7,1,937,1726,29,767,1420,22,32.310344827586206,>30,AUS,Away,After 1965
K Rabada,SA,Pace,2016-11-12,Hobart,Australia,2016,2,54,138,5,1,477,1007,29,423,869,24,16.448275862068964,<=30,AUS,Away,After 1965
K Rabada,SA,Pace,2016-11-24,Adelaide,Australia,2016,2,112,205,3,1,686,1407,24,574,1202,21,28.583333333333332,<=30,AUS,Away,After 1965
K Rabada,SA,Pace,2016-12-26,Gqeberha,South Africa,2016,2,140,204,4,1,798,1468,25,658,1264,21,31.92,>30,SA,Home,After 1965
K Rabada,SA,Pace,2017-01-02,Cape Town,South Africa,2017,2,92,174,10,1,701,1233,30,609,1059,20,23.366666666666667,<=30,SA,Home,After 1965
K Rabada,SA,Pace,2017-01-12,Johannesburg,South Africa,2017,2,94,144,5,1,621,1136,30,527,992,25,20.7,<=30,SA,Home,After 1965
K Rabada,SA,Pace,2017-03-08,Dunedin,New Zealand,2017,1,92,180,1,1,518,1198,16,426,1018,15,32.375,>30,NZ,Away,After 1965
K Rabada,SA,Pace,2017-03-16,Wellington,New Zealand,2017,2,97,216,3,1,662,1203,19,565,987,16,34.8421052631579,>30,NZ,Away,After 1965
K Rabada,SA,Pace,2017-03-25,Hamilton,New Zealand,2017,1,122,204,4,1,618,1215,19,496,1011,15,32.526315789473685,>30,NZ,Away,After 1965
K Rabada,SA,Pace,2017-07-06,Lord's,England,2017,2,173,288,6,1,720,1257,22,547,969,16,32.72727272727273,>30,ENG,Away,After 1965
K Rabada,SA,Pace,2017-07-27,The Oval,England,2017,2,141,264,4,1,850,1584,29,709,1320,25,29.310344827586206,<=30,ENG,Away,After 1965
K Rabada,SA,Pace,2017-08-04,Manchester,England,2017,2,141,258,6,1,698,1268,30,557,1010,24,23.266666666666666,<=30,ENG,Away,After 1965
K Rabada,SA,Pace,2017-09-28,Potchefstroom,South Africa,2017,2,117,204,5,1,634,1140,16,517,936,11,39.625,>30,SA,Home,After 1965
K Rabada,SA,Pace,2017-10-06,Bloemfontein,South Africa,2017,2,63,149,10,1,638,933,23,575,784,13,27.73913043478261,<=30,SA,Home,After 1965
K Rabada,SA,Pace,2017-12-26,Gqeberha,South Africa,2017,2,24,79,3,1,327,664,21,303,585,18,15.571428571428571,<=30,SA,Home,After 1965
K Rabada,SA,Pace,2018-01-05,Cape Town,South Africa,2018,2,75,172,5,1,684,1276,37,609,1104,32,18.486486486486488,<=30,SA,Home,After 1965
K Rabada,SA,Pace,2018-01-13,Centurion,South Africa,2018,2,121,204,4,1,739,1521,29,618,1317,25,25.482758620689655,<=30,SA,Home,After 1965
K Rabada,SA,Pace,2018-01-24,Johannesburg,South Africa,2018,2,108,250,6,1,749,1777,40,641,1527,34,18.725,<=30,SA,Home,After 1965
K Rabada,SA,Pace,2018-03-01,Durban,South Africa,2018,2,102,228,4,1,640,1256,26,538,1028,22,24.615384615384617,<=30,SA,Home,After 1965
K Rabada,SA,Pace,2018-03-09,Gqeberha,South Africa,2018,2,150,258,11,1,673,1296,28,523,1038,17,24.035714285714285,<=30,SA,Home,After 1965
K Rabada,SA,Pace,2018-03-22,Cape Town,South Africa,2018,2,122,197,5,1,789,1457,31,667,1260,26,25.451612903225808,<=30,SA,Home,After 1965
K Rabada,SA,Pace,2018-03-30,Johannesburg,South Africa,2018,2,69,162,3,1,666,1427,26,597,1265,23,25.615384615384617,<=30,SA,Home,After 1965
K Rabada,SA,Pace,2018-07-12,Galle,Sri Lanka,2018,2,94,156,7,1,242,397,13,148,241,6,18.615384615384617,<=30,SL,Away,After 1965
K Rabada,SA,Pace,2018-07-20,Colombo (SSC),Sri Lanka,2018,2,97,168,1,1,278,518,2,181,350,1,139.0,>30,SL,Away,After 1965
K Rabada,SA,Pace,2018-12-26,Centurion,South Africa,2018,2,106,192,6,1,620,1128,33,514,936,27,18.78787878787879,<=30,SA,Home,After 1965
K Rabada,SA,Pace,2019-01-03,Cape Town,South Africa,2019,2,96,160,6,1,809,1380,31,713,1220,25,26.096774193548388,<=30,SA,Home,After 1965
K Rabada,SA,Pace,2019-01-11,Johannesburg,South Africa,2019,2,116,166,5,1,906,1496,35,790,1330,30,25.885714285714286,<=30,SA,Home,After 1965
K Rabada,SA,Pace,2019-02-13,Durban,South Africa,2019,2,145,209,3,1,725,1312,28,580,1103,25,25.892857142857142,<=30,SA,Home,After 1965
K Rabada,SA,Pace,2019-02-21,Gqeberha,South Africa,2019,2,91,166,5,1,552,954,24,461,788,19,23.0,<=30,SA,Home,After 1965
K Rabada,SA,Pace,2019-10-02,Visakhapatnam,India,2019,2,107,222,1,1,350,737,9,243,515,8,38.888888888888886,>30,IND,Away,After 1965
K Rabada,SA,Pace,2019-10-10,Pune,India,2019,1,93,180,3,1,453,864,13,360,684,10,34.84615384615385,>30,IND,Away,After 1965
K Rabada,SA,Pace,2019-10-19,Ranchi,India,2019,1,85,138,3,1,354,633,14,269,495,11,25.285714285714285,<=30,IND,Away,After 1965
K Rabada,SA,Pace,2019-12-26,Centurion,South Africa,2019,2,171,234,7,1,888,1593,38,717,1359,31,23.36842105263158,<=30,SA,Home,After 1965
K Rabada,SA,Pace,2020-01-03,Cape Town,South Africa,2020,2,137,239,5,1,689,1635,31,552,1396,26,22.225806451612904,<=30,SA,Home,After 1965
K Rabada,SA,Pace,2020-01-16,Gqeberha,South Africa,2020,1,97,168,2,1,517,1029,13,420,861,11,39.76923076923077,>30,SA,Home,After 1965
K Rabada,SA,Pace,2021-01-26,Karachi,Pakistan,2021,2,91,210,3,1,546,968,13,455,758,10,42.0,>30,PAK,Away,After 1965
K Rabada,SA,Pace,2021-02-04,Rawalpindi,Pakistan,2021,2,106,210,2,1,534,1105,24,428,895,22,22.25,<=30,PAK,Away,After 1965
K Rabada,SA,Pace,2021-06-10,Gros Islet,West Indies,2021,2,58,180,6,1,458,958,27,400,778,21,16.962962962962962,<=30,WI,Away,After 1965
K Rabada,SA,Pace,2021-06-18,Gros Islet,West Indies,2021,2,68,174,5,1,606,1318,31,538,1144,26,19.548387096774192,<=30,WI,Away,After 1965
K Rabada,SA,Pace,2021-12-26,Centurion,South Africa,2021,2,114,258,7,1,741,1479,38,627,1221,31,19.5,<=30,SA,Home,After 1965
K Rabada,SA,Pace,2022-01-03,Johannesburg,South Africa,2022,2,141,223,6,1,818,1482,32,677,1259,26,25.5625,<=30,SA,Home,After 1965
K Rabada,SA,Pace,2022-01-11,Cape Town,South Africa,2022,2,126,234,7,1,686,1515,32,560,1281,25,21.4375,<=30,SA,Home,After 1965
K Rabada,SA,Pace,2022-02-17,Christchurch,New Zealand,2022,1,113,180,2,1,630,1205,28,517,1025,26,22.5,<=30,NZ,Away,After 1965
K Rabada,SA,Pace,2022-02-25,Christchurch,New Zealand,2022,2,106,228,8,1,1098,2154,35,992,1926,27,31.37142857142857,>30,NZ,Away,After 1965
K Rabada,SA,Pace,2022-08-17,Lord's,England,2022,2,79,162,7,1,531,875,27,452,713,20,19.666666666666668,<=30,ENG,Away,After 1965
K Rabada,SA,Pace,2022-08-25,Manchester,England,2022,1,110,138,2,1,514,991,25,404,853,23,20.56,<=30,ENG,Away,After 1965
K Rabada,SA,Pace,2022-09-08,The Oval,England,2022,2,138,144,5,1,547,897,31,409,753,26,17.64516129032258,<=30,ENG,Away,After 1965
K Rabada,SA,Pace,2022-12-17,Brisbane,Australia,2022,2,89,129,8,1,432,770,30,343,641,22,14.4,<=30,AUS,Away,After 1965
K Rabada,SA,Pace,2022-12-26,Melbourne,Australia,2022,1,144,168,2,1,684,1223,19,540,1055,17,36.0,>30,AUS,Away,After 1965
K Rabada,SA,Pace,2023-01-04,Sydney,Australia,2023,1,119,168,1,1,386,804,12,267,636,11,32.166666666666664,>30,AUS,Away,After 1965
K Rabada,SA,Pace,2023-02-28,Centurion,South Africa,2023,2,94,186,8,1,738,1209,39,644,1023,31,18.923076923076923,<=30,SA,Home,After 1965
K Rabada,SA,Pace,2023-03-08,Johannesburg,South Africa,2023,2,38,114,4,1,575,1146,28,537,1032,24,20.535714285714285,<=30,SA,Home,After 1965
K Rabada,SA,Pace,2023-12-26,Centurion,South Africa,2023,2,91,192,7,1,718,1149,27,627,957,20,26.59259259259259,<=30,SA,Home,After 1965
K Rabada,SA,Pace,2024-01-03,Cape Town,South Africa,2024,2,71,107,4,1,441,642,32,370,535,28,13.78125,<=30,SA,Home,After 1965
K Rabada,SA,Pace,2024-08-07,Port of Spain,West Indies,2024,2,94,180,4,1,444,843,12,350,663,8,37.0,>30,WI,Away,After 1965
K Rabada,SA,Pace,2024-08-15,Providence,West Indies,2024,2,90,192,4,1,482,1012,28,392,820,24,17.214285714285715,<=30,WI,Away,After 1965
K Rabada,SA,Pace,2024-10-21,Mirpur,Bangladesh,2024,2,72,173,9,1,212,443,16,140,270,7,13.25,<=30,BAN,Away,After 1965
K Rabada,SA,Pace,2024-10-29,Chattogram,Bangladesh,2024,2,54,96,5,1,267,480,9,213,384,4,29.666666666666668,<=30,BAN,Away,After 1965
K Rabada,SA,Pace,2024-11-27,Durban,South Africa,2024,2,75,150,3,1,556,1001,29,481,851,26,19.17241379310345,<=30,SA,Home,After 1965
K Rabada,SA,Pace,2024-12-05,Gqeberha,South Africa,2024,2,119,270,3,1,793,1361,26,674,1091,23,30.5,>30,SA,Home,After 1965
K Rabada,SA,Pace,2024-12-26,Centurion,South Africa,2024,2,103,180,2,1,742,1206,32,639,1026,30,23.1875,<=30,SA,Home,After 1965
K Rabada,SA,Pace,2025-01-03,Cape Town,South Africa,2025,2,170,241,6,1,862,1222,17,692,981,11,50.705882352941174,>30,SA,Home,After 1965
K Shuttleworth,ENG,Pace,1970-11-27,Brisbane,Australia,1970,2,128,357,5,1,624,1629,19,496,1272,14,32.8421052631579,>30,AUS,Away,Upto 2014
K Shuttleworth,ENG,Pace,1970-12-11,W.A.C.A,Australia,1970,2,114,248,2,1,852,2129,21,738,1881,19,40.57142857142857,>30,AUS,Away,Upto 2014
K Shuttleworth,ENG,Pace,1971-02-25,Christchurch,New Zealand,1971,2,41,160,5,1,205,688,11,164,528,6,18.636363636363637,<=30,NZ,Away,Upto 2014
K Shuttleworth,ENG,Pace,1971-03-05,Auckland,New Zealand,1971,2,61,168,0,1,561,1413,20,500,1245,20,28.05,<=30,NZ,Away,Upto 2014
K Shuttleworth,ENG,Pace,1971-06-03,Birmingham,England,1971,1,83,138,0,1,653,1403,13,570,1265,13,50.23076923076923,>30,ENG,Home,Upto 2014
K Sinclair,WI,Spin,2024-01-25,Brisbane,Australia,2024,1,53,48,1,1,191,372,6,138,324,5,31.833333333333332,>30,AUS,Away,After 1965
K Sinclair,WI,Spin,2024-07-18,Nottingham,England,2024,2,151,222,3,1,371,520,12,220,298,9,30.916666666666668,>30,ENG,Away,After 1965
K Sinclair,WI,Spin,2025-01-17,Multan,Pakistan,2025,2,77,120,2,1,519,896,34,442,776,32,15.264705882352942,<=30,PAK,Away,After 1965
K Sinclair,WI,Spin,2025-01-25,Multan,Pakistan,2025,2,103,162,3,1,637,1154,37,534,992,34,17.216216216216218,<=30,PAK,Away,After 1965
K Srikkanth,IND,Spin,1981-12-23,Delhi,India,1981,1,10,36,0,1,331,798,4,321,762,4,82.75,>30,IND,Home,Upto 2014
K Srikkanth,IND,Spin,1985-01-31,Kanpur,India,1985,1,11,12,0,1,695,1644,9,684,1632,9,77.22222222222223,>30,IND,Home,Upto 2014
K Srikkanth,IND,Spin,1986-09-18,Chennai,India,1986,1,6,6,0,1,1032,1788,27,1026,1782,27,38.22222222222222,>30,IND,Home,Upto 2014
K Srikkanth,IND,Spin,1986-10-15,Wankhede,India,1986,2,13,30,0,1,676,1768,13,663,1738,13,52.0,>30,IND,Home,Upto 2014
K Srikkanth,IND,Spin,1986-12-17,Kanpur,India,1986,1,4,6,0,1,263,540,3,259,534,3,87.66666666666667,>30,IND,Home,Upto 2014
K Srikkanth,IND,Spin,1987-02-03,Chennai,India,1987,1,6,18,0,1,827,1860,14,821,1842,14,59.07142857142857,>30,IND,Home,Upto 2014
K Srikkanth,IND,Spin,1987-03-04,Ahmedabad,India,1987,2,11,24,0,1,616,1851,11,605,1827,11,56.0,>30,IND,Home,Upto 2014
K Srikkanth,IND,Spin,1987-12-26,Eden Gardens,India,1987,1,7,18,0,1,615,1451,5,608,1433,5,123.0,>30,IND,Home,Upto 2014
K Srikkanth,IND,Spin,1988-11-12,Bengaluru,India,1988,1,1,18,0,1,620,1702,21,619,1684,21,29.523809523809526,<=30,IND,Home,Upto 2014
K Srikkanth,IND,Spin,1988-12-02,Hyderabad (Deccan),India,1988,1,6,6,0,1,319,748,13,313,742,13,24.53846153846154,<=30,IND,Home,Upto 2014
K Srikkanth,IND,Spin,1989-11-15,Karachi,Pakistan,1989,1,2,6,0,1,349,576,2,347,570,2,174.5,>30,PAK,Away,Upto 2014
K Srikkanth,IND,Spin,1989-11-23,Faisalabad,Pakistan,1989,1,13,12,0,1,216,414,1,203,402,1,216.0,>30,PAK,Away,Upto 2014
K Srikkanth,IND,Spin,1989-12-01,Lahore,Pakistan,1989,1,19,18,0,1,665,1174,7,646,1156,7,95.0,>30,PAK,Away,Upto 2014
K Srikkanth,IND,Spin,1992-01-25,Adelaide,Australia,1992,1,5,6,0,1,316,796,8,311,790,8,39.5,>30,AUS,Away,Upto 2014
K Taylor,ENG,Spin,1964-07-02,Leeds,England,1964,1,6,12,0,1,349,1116,11,343,1104,11,31.727272727272727,>30,ENG,Home,Upto 2014
K Thomson,NZ,Spin,1968-02-29,Wellington,New Zealand,1968,1,9,21,1,1,408,1093,20,399,1072,19,20.4,<=30,NZ,Home,Upto 2014
KA Edwards,WI,Spin,2011-07-06,Roseau,West Indies,2011,1,19,24,0,1,478,1095,12,459,1071,12,39.833333333333336,>30,WI,Home,Upto 2014
KA Jamieson,NZ,Pace,2020-02-21,Wellington,New Zealand,2020,2,84,210,4,1,586,1297,26,502,1087,22,22.53846153846154,<=30,NZ,Home,After 1965
KA Jamieson,NZ,Pace,2020-02-29,Christchurch,New Zealand,2020,2,63,132,5,1,623,1219,30,560,1087,25,20.766666666666666,<=30,NZ,Home,After 1965
KA Jamieson,NZ,Pace,2020-12-03,Hamilton,New Zealand,2020,2,67,150,4,1,725,1439,25,658,1289,21,29.0,<=30,NZ,Home,After 1965
KA Jamieson,NZ,Pace,2020-12-11,Wellington,New Zealand,2020,2,77,168,7,1,834,1421,28,757,1253,21,29.785714285714285,<=30,NZ,Home,After 1965
KA Jamieson,NZ,Pace,2020-12-26,Mount Maunganui,New Zealand,2020,2,70,296,5,1,873,2105,28,803,1809,23,31.178571428571427,>30,NZ,Home,After 1965
KA Jamieson,NZ,Pace,2021-01-03,Christchurch,New Zealand,2021,2,117,246,11,1,918,1730,25,801,1484,14,36.72,>30,NZ,Home,After 1965
KA Jamieson,NZ,Pace,2021-06-02,Lord's,England,2021,2,113,246,3,1,792,1822,27,679,1576,24,29.333333333333332,<=30,ENG,Away,After 1965
KA Jamieson,NZ,Pace,2021-06-18,Southampton,England,2021,2,61,276,7,1,643,1620,27,582,1344,20,23.814814814814813,<=30,ENG,Away,After 1965
KA Jamieson,NZ,Pace,2021-11-25,Kanpur,India,2021,2,131,242,6,1,414,852,16,283,610,10,25.875,<=30,IND,Away,After 1965
KA Jamieson,NZ,Pace,2021-12-03,Wankhede,India,2021,2,51,120,0,1,192,474,3,141,354,3,64.0,>30,IND,Away,After 1965
KA Jamieson,NZ,Pace,2022-01-01,Mount Maunganui,New Zealand,2022,2,90,233,2,1,752,1693,25,662,1460,23,30.08,>30,NZ,Home,After 1965
KA Jamieson,NZ,Pace,2022-01-09,Christchurch,New Zealand,2022,2,114,162,6,1,738,1267,23,624,1105,17,32.08695652173913,>30,NZ,Home,After 1965
KA Jamieson,NZ,Pace,2022-02-17,Christchurch,New Zealand,2022,2,43,102,2,1,630,1205,28,587,1103,26,22.5,<=30,NZ,Home,After 1965
KA Jamieson,NZ,Pace,2022-02-25,Christchurch,New Zealand,2022,2,155,288,4,1,1098,2154,35,943,1866,31,31.37142857142857,>30,NZ,Home,After 1965
KA Jamieson,NZ,Pace,2022-06-02,Lord's,England,2022,2,99,192,6,1,722,1408,33,623,1216,27,21.87878787878788,<=30,ENG,Away,After 1965
KA Jamieson,NZ,Pace,2022-06-10,Nottingham,England,2022,1,66,99,0,1,1254,1921,26,1188,1822,26,48.23076923076923,>30,ENG,Away,After 1965
KA Jamieson,NZ,Pace,2023-11-28,Sylhet,Bangladesh,2023,2,77,180,2,1,222,475,6,145,295,4,37.0,>30,BAN,Away,After 1965
KA Jamieson,NZ,Pace,2023-12-06,Mirpur,Bangladesh,2023,1,8,24,0,1,57,146,5,49,122,5,11.4,<=30,BAN,Away,After 1965
KA Jamieson,NZ,Pace,2024-02-04,Mount Maunganui,New Zealand,2024,2,93,192,6,1,753,1368,17,660,1176,11,44.294117647058826,>30,NZ,Home,After 1965
KA Maharaj,SA,Spin,2016-11-03,W.A.C.A,Australia,2016,2,150,351,4,1,396,754,8,246,403,4,49.5,>30,AUS,Away,After 1965
KA Maharaj,SA,Spin,2016-11-12,Hobart,Australia,2016,2,12,42,0,1,82,156,0,70,114,0,inf,>30,AUS,Away,After 1965
KA Maharaj,SA,Spin,2016-12-26,Gqeberha,South Africa,2016,2,116,243,4,1,359,638,9,243,395,5,39.888888888888886,>30,SA,Home,After 1965
KA Maharaj,SA,Spin,2017-01-02,Cape Town,South Africa,2017,2,96,162,3,1,230,404,6,134,242,3,38.333333333333336,>30,SA,Home,After 1965
KA Maharaj,SA,Spin,2017-03-08,Dunedin,New Zealand,2017,1,94,171,5,1,338,837,10,244,666,5,33.8,>30,NZ,Away,After 1965
KA Maharaj,SA,Spin,2017-03-16,Wellington,New Zealand,2017,2,87,218,8,1,195,389,13,108,171,5,15.0,<=30,NZ,Away,After 1965
KA Maharaj,SA,Spin,2017-03-25,Hamilton,New Zealand,2017,1,118,300,2,1,252,528,5,134,228,3,50.4,>30,NZ,Away,After 1965
KA Maharaj,SA,Spin,2017-07-06,Lord's,England,2017,2,192,325,4,1,426,749,18,234,424,14,23.666666666666668,<=30,ENG,Away,After 1965
KA Maharaj,SA,Spin,2017-07-14,Nottingham,England,2017,2,63,132,6,1,230,384,11,167,252,5,20.90909090909091,<=30,ENG,Away,After 1965
KA Maharaj,SA,Spin,2017-07-27,The Oval,England,2017,2,111,173,4,1,198,330,8,87,157,4,24.75,<=30,ENG,Away,After 1965
KA Maharaj,SA,Spin,2017-08-04,Manchester,England,2017,2,150,346,3,1,291,609,10,141,263,7,29.1,<=30,ENG,Away,After 1965
KA Maharaj,SA,Spin,2017-09-28,Potchefstroom,South Africa,2017,2,117,227,7,1,504,803,10,387,576,3,50.4,>30,SA,Home,After 1965
KA Maharaj,SA,Spin,2017-10-06,Bloemfontein,South Africa,2017,2,37,66,1,1,239,300,1,202,234,0,239.0,>30,SA,Home,After 1965
KA Maharaj,SA,Spin,2017-12-26,Gqeberha,South Africa,2017,1,59,105,5,1,150,243,7,91,138,2,21.428571428571427,<=30,SA,Home,After 1965
KA Maharaj,SA,Spin,2018-01-05,Cape Town,South Africa,2018,2,32,60,0,1,56,109,2,24,49,2,28.0,<=30,SA,Home,After 1965
KA Maharaj,SA,Spin,2018-01-13,Centurion,South Africa,2018,2,93,156,1,1,284,566,6,191,410,5,47.333333333333336,>30,SA,Home,After 1965
KA Maharaj,SA,Spin,2018-03-01,Durban,South Africa,2018,2,225,380,9,1,376,722,13,151,342,4,28.923076923076923,<=30,SA,Home,After 1965
KA Maharaj,SA,Spin,2018-03-09,Gqeberha,South Africa,2018,2,141,246,2,1,252,456,5,111,210,3,50.4,>30,SA,Home,After 1965
KA Maharaj,SA,Spin,2018-03-22,Cape Town,South Africa,2018,2,67,144,2,1,218,461,7,151,317,5,31.142857142857142,>30,SA,Home,After 1965
KA Maharaj,SA,Spin,2018-03-30,Johannesburg,South Africa,2018,2,139,198,4,1,456,724,9,317,526,5,50.666666666666664,>30,SA,Home,After 1965
KA Maharaj,SA,Spin,2018-07-12,Galle,Sri Lanka,2018,2,107,222,4,1,416,921,25,309,699,21,16.64,<=30,SL,Away,After 1965
KA Maharaj,SA,Spin,2018-07-20,Colombo (SSC),Sri Lanka,2018,2,283,487,12,1,722,1323,32,439,836,20,22.5625,<=30,SL,Away,After 1965
KA Maharaj,SA,Spin,2018-12-26,Centurion,South Africa,2018,2,44,84,0,1,88,154,1,44,70,1,88.0,>30,SA,Home,After 1965
KA Maharaj,SA,Spin,2019-02-13,Durban,South Africa,2019,2,87,138,3,1,237,390,9,150,252,6,26.333333333333332,<=30,SA,Home,After 1965
KA Maharaj,SA,Spin,2019-02-21,Gqeberha,South Africa,2019,2,54,52,1,1,131,181,6,77,129,5,21.833333333333332,<=30,SA,Home,After 1965
KA Maharaj,SA,Spin,2019-10-02,Visakhapatnam,India,2019,2,318,462,5,1,1062,1652,22,744,1190,17,48.27272727272727,>30,IND,Away,After 1965
KA Maharaj,SA,Spin,2019-10-10,Pune,India,2019,1,196,300,1,1,587,1113,12,391,813,11,48.916666666666664,>30,IND,Away,After 1965
KA Maharaj,SA,Spin,2019-12-26,Centurion,South Africa,2019,2,55,120,2,1,85,162,2,30,42,0,42.5,>30,SA,Home,After 1965
KA Maharaj,SA,Spin,2020-01-03,Cape Town,South Africa,2020,2,228,420,3,1,404,942,7,176,522,4,57.714285714285715,>30,SA,Home,After 1965
KA Maharaj,SA,Spin,2020-01-16,Gqeberha,South Africa,2020,1,180,348,5,1,395,936,15,215,588,10,26.333333333333332,<=30,SA,Home,After 1965
KA Maharaj,SA,Spin,2020-12-26,Centurion,South Africa,2020,2,94,150,0,1,312,480,4,218,330,4,78.0,>30,SA,Home,After 1965
KA Maharaj,SA,Spin,2021-01-26,Karachi,Pakistan,2021,2,102,205,4,1,369,904,18,267,699,14,20.5,<=30,PAK,Away,After 1965
KA Maharaj,SA,Spin,2021-02-04,Rawalpindi,Pakistan,2021,2,208,498,6,1,496,1138,13,288,640,7,38.15384615384615,>30,PAK,Away,After 1965
KA Maharaj,SA,Spin,2021-06-10,Gros Islet,West Indies,2021,2,29,90,2,1,104,252,3,75,162,1,34.666666666666664,>30,WI,Away,After 1965
KA Maharaj,SA,Spin,2021-06-18,Gros Islet,West Indies,2021,2,83,213,7,1,133,351,8,50,138,1,16.625,<=30,WI,Away,After 1965
KA Maharaj,SA,Spin,2021-12-26,Centurion,South Africa,2021,1,58,108,0,1,113,240,2,55,132,2,56.5,>30,SA,Home,After 1965
KA Maharaj,SA,Spin,2022-01-03,Johannesburg,South Africa,2022,2,14,12,0,1,75,142,1,61,130,1,75.0,>30,SA,Home,After 1965
KA Maharaj,SA,Spin,2022-01-11,Cape Town,South Africa,2022,2,47,72,1,1,113,195,1,66,123,0,113.0,>30,SA,Home,After 1965
KA Maharaj,SA,Spin,2022-02-25,Christchurch,New Zealand,2022,2,121,287,4,1,121,287,4,0,0,0,30.25,>30,NZ,Away,After 1965
KA Maharaj,SA,Spin,2022-03-31,Durban,South Africa,2022,2,97,282,7,1,428,1068,20,331,786,13,21.4,<=30,SA,Home,After 1965
KA Maharaj,SA,Spin,2022-04-08,Gqeberha,South Africa,2022,2,97,216,9,1,500,972,27,403,756,18,18.51851851851852,<=30,SA,Home,After 1965
KA Maharaj,SA,Spin,2022-08-17,Lord's,England,2022,1,35,72,2,1,77,156,3,42,84,1,25.666666666666668,<=30,ENG,Away,After 1965
KA Maharaj,SA,Spin,2022-08-25,Manchester,England,2022,1,78,136,2,1,204,480,4,126,344,2,51.0,>30,ENG,Away,After 1965
KA Maharaj,SA,Spin,2022-12-17,Brisbane,Australia,2022,1,17,12,0,1,48,96,4,31,84,4,12.0,<=30,AUS,Away,After 1965
KA Maharaj,SA,Spin,2022-12-26,Melbourne,Australia,2022,1,135,251,0,1,255,472,5,120,221,5,51.0,>30,AUS,Away,After 1965
KA Maharaj,SA,Spin,2023-01-04,Sydney,Australia,2023,1,108,150,1,1,437,881,4,329,731,3,109.25,>30,AUS,Away,After 1965
KA Maharaj,SA,Spin,2023-03-08,Johannesburg,South Africa,2023,2,81,143,3,1,406,700,11,325,557,8,36.90909090909091,>30,SA,Home,After 1965
KA Maharaj,SA,Spin,2024-08-07,Port of Spain,West Indies,2024,2,164,398,8,1,492,926,15,328,528,7,32.8,>30,WI,Away,After 1965
KA Maharaj,SA,Spin,2024-08-15,Providence,West Indies,2024,2,45,102,5,1,233,450,12,188,348,7,19.416666666666668,<=30,WI,Away,After 1965
KA Maharaj,SA,Spin,2024-10-21,Mirpur,Bangladesh,2024,2,139,319,6,1,586,1001,17,447,682,11,34.470588235294116,>30,BAN,Away,After 1965
KA Maharaj,SA,Spin,2024-10-29,Chattogram,Bangladesh,2024,2,116,198,7,1,583,920,17,467,722,10,34.294117647058826,>30,BAN,Away,After 1965
KA Maharaj,SA,Spin,2024-11-27,Durban,South Africa,2024,1,67,144,2,1,277,462,6,210,318,4,46.166666666666664,>30,SA,Home,After 1965
KA Maharaj,SA,Spin,2024-12-05,Gqeberha,South Africa,2024,2,141,296,7,1,411,788,13,270,492,6,31.615384615384617,>30,SA,Home,After 1965
KA Maharaj,SA,Spin,2025-01-03,Cape Town,South Africa,2025,2,151,318,5,1,445,729,11,294,411,6,40.45454545454545,>30,SA,Home,After 1965
KA Walter,SA,Pace,1961-12-08,Durban,South Africa,1961,2,97,249,5,1,481,1242,23,384,993,18,20.91304347826087,<=30,SA,Home,Upto 2014
KA Walter,SA,Pace,1961-12-26,Johannesburg,South Africa,1961,2,100,246,1,1,549,1269,21,449,1023,20,26.142857142857142,<=30,SA,Home,Upto 2014
KADM Fernando,SL,Pace,2003-12-02,Galle,Sri Lanka,2003,2,50,42,1,1,348,780,10,298,738,9,34.8,>30,SL,Home,Upto 2014
KADM Fernando,SL,Pace,2003-12-10,Kandy,Sri Lanka,2003,2,57,84,0,1,489,1010,13,432,926,13,37.61538461538461,>30,SL,Home,Upto 2014
KAJ Roach,WI,Pace,2009-07-09,Kingstown,West Indies,2009,2,113,294,6,1,537,1048,20,424,754,14,26.85,<=30,WI,Home,Upto 2014
KAJ Roach,WI,Pace,2009-07-17,St George's,West Indies,2009,2,116,225,7,1,424,759,14,308,534,7,30.285714285714285,>30,WI,Home,Upto 2014
KAJ Roach,WI,Pace,2009-11-26,Brisbane,Australia,2009,1,76,150,1,1,697,1123,21,621,973,20,33.19047619047619,>30,AUS,Away,Upto 2014
KAJ Roach,WI,Pace,2009-12-04,Adelaide,Australia,2009,2,159,247,3,1,930,1567,26,771,1320,23,35.76923076923077,>30,AUS,Away,Upto 2014
KAJ Roach,WI,Pace,2009-12-16,W.A.C.A,Australia,2009,2,122,168,3,1,927,1486,27,805,1318,24,34.333333333333336,>30,AUS,Away,Upto 2014
KAJ Roach,WI,Pace,2010-06-18,Basseterre,West Indies,2010,2,105,210,1,1,644,1267,9,539,1057,8,71.55555555555556,>30,WI,Home,Upto 2014
KAJ Roach,WI,Pace,2010-06-26,Bridgetown,West Indies,2010,2,81,178,5,1,416,803,18,335,625,13,23.11111111111111,<=30,WI,Home,Upto 2014
KAJ Roach,WI,Pace,2010-11-15,Galle,Sri Lanka,2010,2,130,216,5,1,602,992,8,472,776,3,75.25,>30,SL,Away,Upto 2014
KAJ Roach,WI,Pace,2010-11-23,Colombo (RPS),Sri Lanka,2010,2,115,200,5,1,389,758,12,274,558,7,32.416666666666664,>30,SL,Away,Upto 2014
KAJ Roach,WI,Pace,2011-05-12,Providence,West Indies,2011,2,70,142,2,1,310,796,18,240,654,16,17.22222222222222,<=30,WI,Home,Upto 2014
KAJ Roach,WI,Pace,2011-05-20,Basseterre,West Indies,2011,2,109,264,2,1,547,1106,13,438,842,11,42.07692307692308,>30,WI,Home,Upto 2014
KAJ Roach,WI,Pace,2011-10-29,Mirpur,Bangladesh,2011,2,101,134,1,1,378,650,10,277,516,9,37.8,>30,BAN,Away,Upto 2014
KAJ Roach,WI,Pace,2011-11-14,Eden Gardens,India,2011,1,106,156,2,1,531,767,14,425,611,12,37.92857142857143,>30,IND,Away,Upto 2014
KAJ Roach,WI,Pace,2012-04-07,Bridgetown,West Indies,2012,2,117,246,5,1,725,1642,25,608,1396,20,29.0,<=30,WI,Home,Upto 2014
KAJ Roach,WI,Pace,2012-04-15,Port of Spain,West Indies,2012,2,146,270,10,1,412,924,17,266,654,7,24.235294117647058,<=30,WI,Home,Upto 2014
KAJ Roach,WI,Pace,2012-04-23,Roseau,West Indies,2012,2,112,216,4,1,492,1142,12,380,926,8,41.0,>30,WI,Home,Upto 2014
KAJ Roach,WI,Pace,2012-05-17,Lord's,England,2012,2,168,228,6,1,939,1916,29,771,1688,23,32.37931034482759,>30,ENG,Away,Upto 2014
KAJ Roach,WI,Pace,2012-05-25,Nottingham,England,2012,2,106,180,2,1,765,1507,24,659,1327,22,31.875,>30,ENG,Away,Upto 2014
KAJ Roach,WI,Pace,2012-07-25,North Sound,West Indies,2012,2,115,278,7,1,734,1446,19,619,1168,12,38.63157894736842,>30,WI,Home,Upto 2014
KAJ Roach,WI,Pace,2012-08-02,Kingston,West Indies,2012,2,104,181,5,1,597,1132,23,493,951,18,25.956521739130434,<=30,WI,Home,Upto 2014
KAJ Roach,WI,Pace,2013-03-12,Bridgetown,West Indies,2013,2,43,138,3,1,330,750,17,287,612,14,19.41176470588235,<=30,WI,Home,Upto 2014
KAJ Roach,WI,Pace,2013-03-20,Roseau,West Indies,2013,2,42,60,0,1,341,648,7,299,588,7,48.714285714285715,>30,WI,Home,Upto 2014
KAJ Roach,WI,Pace,2014-06-08,Kingston,West Indies,2014,2,97,246,2,1,334,854,13,237,608,11,25.692307692307693,<=30,WI,Home,After 1965
KAJ Roach,WI,Pace,2014-06-16,Port of Spain,West Indies,2014,2,135,270,5,1,611,1256,20,476,986,15,30.55,>30,WI,Home,After 1965
KAJ Roach,WI,Pace,2014-06-26,Bridgetown,West Indies,2014,2,116,223,8,1,620,1276,27,504,1053,19,22.962962962962962,<=30,WI,Home,After 1965
KAJ Roach,WI,Pace,2014-09-05,Kingstown,West Indies,2014,2,95,210,5,1,442,907,11,347,697,6,40.18181818181818,>30,WI,Home,After 1965
KAJ Roach,WI,Pace,2014-09-13,Gros Islet,West Indies,2014,2,85,214,6,1,563,1240,21,478,1026,15,26.80952380952381,<=30,WI,Home,After 1965
KAJ Roach,WI,Pace,2014-12-17,Centurion,South Africa,2014,1,52,95,2,1,587,1007,20,535,912,18,29.35,<=30,SA,Away,After 1965
KAJ Roach,WI,Pace,2015-04-13,North Sound,West Indies,2015,2,147,258,5,1,886,1696,22,739,1438,17,40.27272727272727,>30,WI,Home,After 1965
KAJ Roach,WI,Pace,2015-04-21,St George's,West Indies,2015,2,118,210,0,1,731,1499,18,613,1289,18,40.611111111111114,>30,WI,Home,After 1965
KAJ Roach,WI,Pace,2015-06-11,Kingston,West Indies,2015,2,139,204,2,1,528,1091,25,389,887,23,21.12,<=30,WI,Home,After 1965
KAJ Roach,WI,Pace,2015-10-14,Galle,Sri Lanka,2015,1,57,114,1,1,384,801,11,327,687,10,34.90909090909091,>30,SL,Away,After 1965
KAJ Roach,WI,Pace,2015-10-22,Colombo (PSS),Sri Lanka,2015,2,45,108,1,1,259,558,12,214,450,11,21.583333333333332,<=30,SL,Away,After 1965
KAJ Roach,WI,Pace,2015-12-10,Hobart,Australia,2015,1,99,96,0,1,634,903,16,535,807,16,39.625,>30,AUS,Away,After 1965
KAJ Roach,WI,Pace,2015-12-26,Melbourne,Australia,2015,2,119,126,0,1,837,1482,18,718,1356,18,46.5,>30,AUS,Away,After 1965
KAJ Roach,WI,Pace,2016-01-03,Sydney,Australia,2016,1,29,24,0,1,234,354,3,205,330,3,78.0,>30,AUS,Away,After 1965
KAJ Roach,WI,Pace,2017-08-17,Birmingham,England,2017,1,86,168,2,1,610,1081,19,524,913,17,32.10526315789474,>30,ENG,Away,After 1965
KAJ Roach,WI,Pace,2017-08-25,Leeds,England,2017,2,166,263,4,1,1027,1807,24,861,1544,20,42.791666666666664,>30,ENG,Away,After 1965
KAJ Roach,WI,Pace,2017-09-07,Lord's,England,2017,2,76,150,5,1,490,1083,30,414,933,25,16.333333333333332,<=30,ENG,Away,After 1965
KAJ Roach,WI,Pace,2017-10-21,Bulawayo,Zimbabwe,2017,2,57,144,3,1,377,855,10,320,711,7,37.7,>30,ZIM,Away,After 1965
KAJ Roach,WI,Pace,2017-10-29,Bulawayo,Zimbabwe,2017,2,81,241,5,1,339,949,11,258,708,6,30.818181818181817,>30,ZIM,Away,After 1965
KAJ Roach,WI,Pace,2017-12-01,Wellington,New Zealand,2017,1,85,132,3,1,782,1474,25,697,1342,22,31.28,>30,NZ,Away,After 1965
KAJ Roach,WI,Pace,2017-12-09,Hamilton,New Zealand,2017,2,86,176,3,1,876,1573,33,790,1397,30,26.545454545454547,<=30,NZ,Away,After 1965
KAJ Roach,WI,Pace,2018-06-06,Port of Spain,West Indies,2018,2,91,150,2,1,624,1324,21,533,1174,19,29.714285714285715,<=30,WI,Home,After 1965
KAJ Roach,WI,Pace,2018-06-14,Gros Islet,West Indies,2018,2,127,234,6,1,739,1498,33,612,1264,27,22.393939393939394,<=30,WI,Home,After 1965
KAJ Roach,WI,Pace,2018-06-23,Bridgetown,West Indies,2018,2,63,132,3,1,501,1108,32,438,976,29,15.65625,<=30,WI,Home,After 1965
KAJ Roach,WI,Pace,2018-07-04,North Sound,West Indies,2018,1,8,30,5,1,363,699,24,355,669,19,15.125,<=30,WI,Home,After 1965
KAJ Roach,WI,Pace,2018-11-22,Chattogram,Bangladesh,2018,2,74,108,1,1,183,270,6,109,162,5,30.5,>30,BAN,Away,After 1965
KAJ Roach,WI,Pace,2018-11-30,Mirpur,Bangladesh,2018,1,61,150,2,1,130,270,3,69,120,1,43.333333333333336,>30,BAN,Away,After 1965
KAJ Roach,WI,Pace,2019-01-23,Bridgetown,West Indies,2019,2,75,150,5,1,635,1301,24,560,1151,19,26.458333333333332,<=30,WI,Home,After 1965
KAJ Roach,WI,Pace,2019-01-31,North Sound,West Indies,2019,2,82,168,8,1,523,1214,27,441,1046,19,19.37037037037037,<=30,WI,Home,After 1965
KAJ Roach,WI,Pace,2019-02-09,Gros Islet,West Indies,2019,2,93,263,5,1,684,1370,27,591,1107,22,25.333333333333332,<=30,WI,Home,After 1965
KAJ Roach,WI,Pace,2019-08-22,North Sound,West Indies,2019,2,95,270,5,1,576,1302,29,481,1032,24,19.862068965517242,<=30,WI,Home,After 1965
KAJ Roach,WI,Pace,2019-08-30,Kingston,West Indies,2019,2,105,240,4,1,512,1121,25,407,881,21,20.48,<=30,WI,Home,After 1965
KAJ Roach,WI,Pace,2019-11-27,Lucknow,India,2019,2,38,72,0,1,112,277,5,74,205,5,22.4,<=30,IND,Away,After 1965
KAJ Roach,WI,Pace,2020-07-08,Southampton,England,2020,2,91,246,0,1,825,1729,32,734,1483,32,25.78125,<=30,ENG,Away,After 1965
KAJ Roach,WI,Pace,2020-07-16,Manchester,England,2020,2,95,234,4,1,747,1583,23,652,1349,19,32.47826086956522,>30,ENG,Away,After 1965
KAJ Roach,WI,Pace,2020-07-24,Manchester,England,2020,2,106,220,4,1,625,1206,27,519,986,23,23.14814814814815,<=30,ENG,Away,After 1965
KAJ Roach,WI,Pace,2020-12-03,Hamilton,New Zealand,2020,1,114,180,3,1,725,1439,25,611,1259,22,29.0,<=30,NZ,Away,After 1965
KAJ Roach,WI,Pace,2021-02-03,Chattogram,Bangladesh,2021,2,77,162,1,1,327,606,6,250,444,5,54.5,>30,BAN,Away,After 1965
KAJ Roach,WI,Pace,2021-03-21,North Sound,West Indies,2021,2,121,258,6,1,742,1672,25,621,1414,19,29.68,<=30,WI,Home,After 1965
KAJ Roach,WI,Pace,2021-03-29,North Sound,West Indies,2021,2,91,180,3,1,742,1513,23,651,1333,20,32.26086956521739,>30,WI,Home,After 1965
KAJ Roach,WI,Pace,2021-06-10,Gros Islet,West Indies,2021,1,64,120,2,1,458,958,27,394,838,25,16.962962962962962,<=30,WI,Home,After 1965
KAJ Roach,WI,Pace,2021-06-18,Gros Islet,West Indies,2021,2,97,208,7,1,606,1318,31,509,1110,24,19.548387096774192,<=30,WI,Home,After 1965
KAJ Roach,WI,Pace,2021-08-12,Kingston,West Indies,2021,2,77,210,5,1,661,1558,37,584,1348,32,17.864864864864863,<=30,WI,Home,After 1965
KAJ Roach,WI,Pace,2021-08-20,Kingston,West Indies,2021,2,79,180,3,1,688,1393,29,609,1213,26,23.724137931034484,<=30,WI,Home,After 1965
KAJ Roach,WI,Pace,2021-11-29,Galle,Sri Lanka,2021,2,39,84,0,1,123,256,1,84,172,1,123.0,>30,SL,Away,After 1965
KAJ Roach,WI,Pace,2022-03-08,North Sound,West Indies,2022,2,139,240,4,1,832,1769,23,693,1529,19,36.17391304347826,>30,WI,Home,After 1965
KAJ Roach,WI,Pace,2022-03-16,Bridgetown,West Indies,2022,2,99,210,3,1,744,1535,17,645,1325,14,43.76470588235294,>30,WI,Home,After 1965
KAJ Roach,WI,Pace,2022-03-24,St George's,West Indies,2022,2,51,164,4,1,518,1435,27,467,1271,23,19.185185185185187,<=30,WI,Home,After 1965
KAJ Roach,WI,Pace,2022-06-16,North Sound,West Indies,2022,2,74,197,7,1,515,1150,28,441,953,21,18.392857142857142,<=30,WI,Home,After 1965
KAJ Roach,WI,Pace,2022-06-24,Gros Islet,West Indies,2022,2,111,168,3,1,658,1090,26,547,922,23,25.307692307692307,<=30,WI,Home,After 1965
KAJ Roach,WI,Pace,2022-11-30,Perth,Australia,2022,2,121,198,1,1,842,1610,13,721,1412,12,64.76923076923077,>30,AUS,Away,After 1965
KAJ Roach,WI,Pace,2023-02-04,Bulawayo,Zimbabwe,2023,2,51,108,1,1,562,1122,8,511,1014,7,70.25,>30,ZIM,Away,After 1965
KAJ Roach,WI,Pace,2023-02-28,Centurion,South Africa,2023,2,118,162,6,1,738,1209,39,620,1047,33,18.923076923076923,<=30,SA,Away,After 1965
KAJ Roach,WI,Pace,2023-03-08,Johannesburg,South Africa,2023,2,109,180,1,1,575,1146,28,466,966,27,20.535714285714285,<=30,SA,Away,After 1965
KAJ Roach,WI,Pace,2023-07-12,Roseau,West Indies,2023,1,50,144,1,1,260,590,5,210,446,4,52.0,>30,WI,Home,After 1965
KAJ Roach,WI,Pace,2023-07-20,Port of Spain,West Indies,2023,2,150,156,3,1,656,1048,14,506,892,11,46.857142857142854,>30,WI,Home,After 1965
KAJ Roach,WI,Pace,2024-01-17,Adelaide,Australia,2024,2,54,109,2,1,512,947,27,458,838,25,18.962962962962962,<=30,AUS,Away,After 1965
KAJ Roach,WI,Pace,2024-01-25,Brisbane,Australia,2024,2,75,126,3,1,777,1334,30,702,1208,27,25.9,<=30,AUS,Away,After 1965
KAJ Roach,WI,Pace,2024-08-07,Port of Spain,West Indies,2024,2,92,156,3,1,444,843,12,352,687,9,37.0,>30,WI,Home,After 1965
KAJ Roach,WI,Pace,2024-11-22,North Sound,West Indies,2024,2,50,138,4,1,670,1327,30,620,1189,26,22.333333333333332,<=30,WI,Home,After 1965
KAJ Roach,WI,Pace,2024-11-30,Kingston,West Indies,2024,2,81,150,5,1,598,1162,33,517,1012,28,18.12121212121212,<=30,WI,Home,After 1965
KAJ Roach,WI,Pace,2025-01-25,Multan,Pakistan,2025,1,15,36,2,1,15,36,2,0,0,0,7.5,<=30,PAK,Away,After 1965
KAR Hodge,WI,Spin,2024-07-18,Nottingham,England,2024,1,44,60,2,1,371,520,12,327,460,10,30.916666666666668,>30,ENG,Away,After 1965
KAR Hodge,WI,Spin,2024-08-15,Providence,West Indies,2024,1,9,6,0,1,233,450,12,224,444,12,19.416666666666668,<=30,WI,Home,After 1965
KAR Hodge,WI,Spin,2024-11-22,North Sound,West Indies,2024,1,21,48,0,1,296,631,6,275,583,6,49.333333333333336,>30,WI,Home,After 1965
KAR Hodge,WI,Spin,2024-11-30,Kingston,West Indies,2024,2,18,30,0,1,139,318,7,121,288,7,19.857142857142858,<=30,WI,Home,After 1965
KAR Hodge,WI,Spin,2025-01-17,Multan,Pakistan,2025,1,13,12,0,1,519,896,34,506,884,34,15.264705882352942,<=30,PAK,Away,After 1965
KBJ Azad,IND,Spin,1981-02-21,Wellington,New Zealand,1981,1,5,6,0,1,68,192,6,63,186,6,11.333333333333334,<=30,NZ,Away,Upto 2014
KBJ Azad,IND,Spin,1981-11-27,Wankhede,India,1981,1,35,90,1,1,162,553,10,127,463,9,16.2,<=30,IND,Home,Upto 2014
KBJ Azad,IND,Spin,1981-12-09,Bengaluru,India,1981,2,83,144,0,1,405,1140,11,322,996,11,36.81818181818182,>30,IND,Home,Upto 2014
KBJ Azad,IND,Spin,1981-12-23,Delhi,India,1981,1,35,54,0,1,331,798,4,296,744,4,82.75,>30,IND,Home,Upto 2014
KBJ Azad,IND,Spin,1983-10-05,Nagpur,India,1983,1,68,150,0,1,396,1114,18,328,964,18,22.0,<=30,IND,Home,Upto 2014
KBJ Azad,IND,Spin,1983-10-29,Delhi,India,1983,2,106,240,2,1,373,864,8,267,624,6,46.625,>30,IND,Home,Upto 2014
KBJ Azad,IND,Spin,1983-11-12,Ahmedabad,India,1983,2,41,66,0,1,250,501,5,209,435,5,50.0,>30,IND,Home,Upto 2014
KC Bland,SA,Pace,1964-01-01,Melbourne,Australia,1964,2,41,104,0,1,870,1955,24,829,1851,24,36.25,>30,AUS,Away,Upto 2014
KC Bland,SA,Pace,1964-01-10,Sydney,Australia,1964,2,14,24,0,1,926,1995,29,912,1971,29,31.93103448275862,>30,AUS,Away,Upto 2014
KC Bland,SA,Pace,1964-01-24,Adelaide,Australia,1964,1,7,8,0,1,1036,2074,26,1029,2066,26,39.84615384615385,>30,AUS,Away,Upto 2014
KC Bland,SA,Pace,1964-02-21,Wellington,New Zealand,1964,2,17,72,2,1,514,1667,18,497,1595,16,28.555555555555557,<=30,NZ,Away,Upto 2014
KC Bland,SA,Pace,1964-02-28,Dunedin,New Zealand,1964,1,9,54,0,1,306,1085,13,297,1031,13,23.53846153846154,<=30,NZ,Away,Upto 2014
KC Bland,SA,Pace,1964-03-13,Auckland,New Zealand,1964,1,13,78,0,1,606,1729,24,593,1651,24,25.25,<=30,NZ,Away,Upto 2014
KC Bland,SA,Pace,1964-12-04,Durban,South Africa,1964,1,10,24,0,1,364,1062,8,354,1038,8,45.5,>30,SA,Home,Upto 2014
KC Bland,SA,Pace,1964-12-23,Johannesburg,South Africa,1964,1,11,18,0,1,619,1341,11,608,1323,11,56.27272727272727,>30,SA,Home,Upto 2014
KC Bland,SA,Pace,1965-01-01,Cape Town,South Africa,1965,1,3,12,0,1,647,1572,12,644,1560,12,53.916666666666664,>30,SA,Home,Upto 2014
KC Brathwaite,WI,Spin,2011-11-06,Delhi,India,2011,1,7,10,0,1,434,957,21,427,947,21,20.666666666666668,<=30,IND,Away,Upto 2014
KC Brathwaite,WI,Spin,2011-11-14,Eden Gardens,India,2011,1,43,36,1,1,689,1188,12,646,1152,11,57.416666666666664,>30,IND,Away,Upto 2014
KC Brathwaite,WI,Spin,2014-12-17,Centurion,South Africa,2014,1,2,6,0,1,274,453,3,272,447,3,91.33333333333333,>30,SA,Away,After 1965
KC Brathwaite,WI,Spin,2015-04-21,St George's,West Indies,2015,1,9,30,0,1,451,913,9,442,883,9,50.111111111111114,>30,WI,Home,After 1965
KC Brathwaite,WI,Spin,2015-06-11,Kingston,West Indies,2015,2,62,180,0,1,355,671,7,293,491,7,50.714285714285715,>30,WI,Home,After 1965
KC Brathwaite,WI,Spin,2015-10-14,Galle,Sri Lanka,2015,1,14,30,0,1,555,1017,18,541,987,18,30.833333333333332,>30,SL,Away,After 1965
KC Brathwaite,WI,Spin,2015-10-22,Colombo (PSS),Sri Lanka,2015,1,29,69,6,1,448,1072,27,419,1003,21,16.59259259259259,<=30,SL,Away,After 1965
KC Brathwaite,WI,Spin,2015-12-10,Hobart,Australia,2015,1,52,78,0,1,295,420,6,243,342,6,49.166666666666664,>30,AUS,Away,After 1965
KC Brathwaite,WI,Spin,2015-12-26,Melbourne,Australia,2015,1,78,108,1,1,415,654,8,337,546,7,51.875,>30,AUS,Away,After 1965
KC Brathwaite,WI,Spin,2016-01-03,Sydney,Australia,2016,1,20,24,0,1,265,547,8,245,523,8,33.125,>30,AUS,Away,After 1965
KC Brathwaite,WI,Spin,2016-07-21,North Sound,West Indies,2016,1,65,89,3,1,560,1009,16,495,920,13,35.0,>30,WI,Home,After 1965
KC Brathwaite,WI,Spin,2016-07-30,Kingston,West Indies,2016,1,40,66,0,1,562,982,15,522,916,15,37.46666666666667,>30,WI,Home,After 1965
KC Brathwaite,WI,Spin,2016-08-09,Gros Islet,West Indies,2016,2,60,114,0,1,298,783,9,238,669,9,33.111111111111114,>30,WI,Home,After 1965
KC Brathwaite,WI,Spin,2016-10-13,Dubai (DICS),UAE,2016,1,56,84,0,1,657,1312,22,601,1228,22,29.863636363636363,<=30,UAE,Away,After 1965
KC Brathwaite,WI,Spin,2016-10-21,Abu Dhabi,UAE,2016,2,69,144,1,1,703,1324,15,634,1180,14,46.86666666666667,>30,UAE,Away,After 1965
KC Brathwaite,WI,Spin,2016-10-30,Sharjah,UAE,2016,1,5,6,0,1,457,972,14,452,966,14,32.642857142857146,>30,UAE,Away,After 1965
KC Brathwaite,WI,Spin,2017-04-21,Kingston,West Indies,2017,1,22,42,0,1,338,583,11,316,541,11,30.727272727272727,>30,WI,Home,After 1965
KC Brathwaite,WI,Spin,2017-08-17,Birmingham,England,2017,1,6,36,0,1,188,290,7,182,254,7,26.857142857142858,<=30,ENG,Away,After 1965
KC Brathwaite,WI,Spin,2017-08-25,Leeds,England,2017,1,4,6,0,1,415,774,7,411,768,7,59.285714285714285,>30,ENG,Away,After 1965
KC Brathwaite,WI,Spin,2017-10-21,Bulawayo,Zimbabwe,2017,1,30,60,1,1,674,1311,28,644,1251,27,24.071428571428573,<=30,ZIM,Away,After 1965
KC Brathwaite,WI,Spin,2017-10-29,Bulawayo,Zimbabwe,2017,2,67,162,1,1,706,1640,15,639,1478,14,47.06666666666667,>30,ZIM,Away,After 1965
KC Brathwaite,WI,Spin,2017-12-01,Wellington,New Zealand,2017,1,46,52,0,1,166,328,3,120,276,3,55.333333333333336,>30,NZ,Away,After 1965
KC Brathwaite,WI,Spin,2017-12-09,Hamilton,New Zealand,2017,2,45,78,0,1,199,291,4,154,213,4,49.75,>30,NZ,Away,After 1965
KC Brathwaite,WI,Spin,2018-06-14,Gros Islet,West Indies,2018,1,4,6,0,1,246,492,2,242,486,2,123.0,>30,WI,Home,After 1965
KC Brathwaite,WI,Spin,2018-10-04,Rajkot,India,2018,1,47,83,1,1,685,1000,22,638,917,21,31.136363636363637,>30,IND,Away,After 1965
KC Brathwaite,WI,Spin,2018-10-12,Hyderabad,India,2018,1,6,12,0,1,524,1095,12,518,1083,12,43.666666666666664,>30,IND,Away,After 1965
KC Brathwaite,WI,Spin,2018-11-22,Chattogram,Bangladesh,2018,1,19,48,0,1,618,1097,34,599,1049,34,18.176470588235293,<=30,BAN,Away,After 1965
KC Brathwaite,WI,Spin,2018-11-30,Mirpur,Bangladesh,2018,1,57,90,2,1,676,1230,27,619,1140,25,25.037037037037038,<=30,BAN,Away,After 1965
KC Brathwaite,WI,Spin,2019-02-09,Gros Islet,West Indies,2019,2,29,96,0,1,312,576,7,283,480,7,44.57142857142857,>30,WI,Home,After 1965
KC Brathwaite,WI,Spin,2019-08-22,North Sound,West Indies,2019,1,24,42,0,1,347,560,8,323,518,8,43.375,>30,WI,Home,After 1965
KC Brathwaite,WI,Spin,2019-08-30,Kingston,West Indies,2019,1,8,12,1,1,328,690,8,320,678,7,41.0,>30,WI,Home,After 1965
KC Brathwaite,WI,Spin,2020-07-08,Southampton,England,2020,1,9,18,0,1,162,342,4,153,324,4,40.5,>30,ENG,Away,After 1965
KC Brathwaite,WI,Spin,2020-07-16,Manchester,England,2020,1,9,23,0,1,307,518,8,298,495,8,38.375,>30,ENG,Away,After 1965
KC Brathwaite,WI,Spin,2020-12-03,Hamilton,New Zealand,2020,1,14,18,0,1,123,168,0,109,150,0,inf,>30,NZ,Away,After 1965
KC Brathwaite,WI,Spin,2021-02-03,Chattogram,Bangladesh,2021,2,20,30,0,1,955,2045,28,935,2015,28,34.107142857142854,>30,BAN,Away,After 1965
KC Brathwaite,WI,Spin,2021-02-11,Mirpur,Bangladesh,2021,2,32,78,3,1,665,1522,28,633,1444,25,23.75,<=30,BAN,Away,After 1965
KC Brathwaite,WI,Spin,2021-03-21,North Sound,West Indies,2021,1,30,54,0,1,363,863,7,333,809,7,51.857142857142854,>30,WI,Home,After 1965
KC Brathwaite,WI,Spin,2021-03-29,North Sound,West Indies,2021,1,7,18,0,1,313,706,3,306,688,3,104.33333333333333,>30,WI,Home,After 1965
KC Brathwaite,WI,Spin,2021-06-18,Gros Islet,West Indies,2021,2,24,48,1,1,133,351,8,109,303,7,16.625,<=30,WI,Home,After 1965
KC Brathwaite,WI,Spin,2021-08-12,Kingston,West Indies,2021,1,3,18,0,1,139,246,0,136,228,0,inf,>30,WI,Home,After 1965
KC Brathwaite,WI,Spin,2021-08-20,Kingston,West Indies,2021,2,28,30,1,1,122,240,4,94,210,3,30.5,>30,WI,Home,After 1965
KC Brathwaite,WI,Spin,2021-11-21,Galle,Sri Lanka,2021,2,15,30,0,1,748,1629,31,733,1599,31,24.129032258064516,<=30,SL,Away,After 1965
KC Brathwaite,WI,Spin,2021-11-29,Galle,Sri Lanka,2021,1,11,30,1,1,790,1806,36,779,1776,35,21.944444444444443,<=30,SL,Away,After 1965
KC Brathwaite,WI,Spin,2022-03-08,North Sound,West Indies,2022,2,21,42,0,1,307,730,6,286,688,6,51.166666666666664,>30,WI,Home,After 1965
KC Brathwaite,WI,Spin,2022-03-16,Bridgetown,West Indies,2022,2,64,78,1,1,465,1126,13,401,1048,12,35.76923076923077,>30,WI,Home,After 1965
KC Brathwaite,WI,Spin,2022-03-24,St George's,West Indies,2022,1,9,30,0,1,75,217,2,66,187,2,37.5,>30,WI,Home,After 1965
KC Brathwaite,WI,Spin,2022-11-30,Perth,Australia,2022,2,85,94,2,1,497,783,13,412,689,11,38.23076923076923,>30,AUS,Away,After 1965
KC Brathwaite,WI,Spin,2022-12-08,Adelaide,Australia,2022,2,67,72,1,1,274,456,7,207,384,6,39.142857142857146,>30,AUS,Away,After 1965
KC Brathwaite,WI,Spin,2023-02-04,Bulawayo,Zimbabwe,2023,2,22,54,1,1,573,1170,18,551,1116,17,31.833333333333332,>30,ZIM,Away,After 1965
KC Brathwaite,WI,Spin,2023-02-12,Bulawayo,Zimbabwe,2023,1,3,6,0,1,284,566,18,281,560,18,15.777777777777779,<=30,ZIM,Away,After 1965
KC Brathwaite,WI,Spin,2023-07-12,Roseau,West Indies,2023,1,21,54,0,1,411,1014,20,390,960,20,20.55,<=30,WI,Home,After 1965
KC Brathwaite,WI,Spin,2023-07-20,Port of Spain,West Indies,2023,1,1,12,0,1,279,750,9,278,738,9,31.0,>30,WI,Home,After 1965
KC Brathwaite,WI,Spin,2024-07-10,Lord's,England,2024,1,6,14,0,1,47,110,2,41,96,2,23.5,<=30,ENG,Away,After 1965
KC Brathwaite,WI,Spin,2024-07-18,Nottingham,England,2024,2,8,9,0,1,371,520,12,363,511,12,30.916666666666668,>30,ENG,Away,After 1965
KC Brathwaite,WI,Spin,2024-07-26,Birmingham,England,2024,1,6,2,0,1,163,267,3,157,265,3,54.333333333333336,>30,ENG,Away,After 1965
KC Brathwaite,WI,Spin,2024-08-07,Port of Spain,West Indies,2024,1,13,30,0,1,492,926,15,479,896,15,32.8,>30,WI,Home,After 1965
KC Brathwaite,WI,Spin,2024-11-30,Kingston,West Indies,2024,1,1,6,0,1,139,318,7,138,312,7,19.857142857142858,<=30,WI,Home,After 1965
KC Brathwaite,WI,Spin,2025-01-17,Multan,Pakistan,2025,1,3,6,0,1,519,896,34,516,890,34,15.264705882352942,<=30,PAK,Away,After 1965
KC Brathwaite,WI,Spin,2025-01-25,Multan,Pakistan,2025,1,1,6,0,1,637,1154,37,636,1148,37,17.216216216216218,<=30,PAK,Away,After 1965
KC Sangakkara,SL,Spin,2004-08-04,Galle,Sri Lanka,2004,1,4,6,0,1,688,1462,17,684,1456,17,40.470588235294116,>30,SL,Home,Upto 2014
KC Sangakkara,SL,Spin,2009-02-21,Karachi,Pakistan,2009,1,34,60,0,1,883,1568,9,849,1508,9,98.11111111111111,>30,PAK,Away,Upto 2014
KC Sangakkara,SL,Spin,2011-09-08,Pallekele,Sri Lanka,2011,1,4,12,0,1,335,684,6,331,672,6,55.833333333333336,>30,SL,Home,Upto 2014
KC Sangakkara,SL,Spin,2014-01-08,Dubai (DICS),UAE,2014,1,7,6,0,1,299,751,9,292,745,9,33.22222222222222,>30,UAE,Away,After 1965
KC Wessels,AUS,Spin,1983-12-26,Melbourne,Australia,1983,1,2,12,0,1,391,853,9,389,841,9,43.44444444444444,>30,AUS,Home,Upto 2014
KC Wessels,AUS,Spin,1984-12-07,Adelaide,Australia,1984,1,13,30,0,1,299,561,7,286,531,7,42.714285714285715,>30,AUS,Home,Upto 2014
KC Wessels,AUS,Spin,1984-12-22,Melbourne,Australia,1984,1,2,6,0,1,287,501,7,285,495,7,41.0,>30,AUS,Home,Upto 2014
KC Wessels,AUS,Spin,1985-06-13,Leeds,England,1985,1,2,18,0,1,123,334,7,121,316,7,17.571428571428573,<=30,ENG,Away,Upto 2014
KC Wessels,AUS,Spin,1985-08-29,The Oval,England,1985,1,16,18,0,1,236,426,4,220,408,4,59.0,>30,ENG,Away,Upto 2014
KC Wessels,AUS,Spin,1985-11-08,Brisbane,Australia,1985,1,7,6,0,1,336,547,4,329,541,4,84.0,>30,AUS,Home,Upto 2014
KCG Benjamin,WI,Pace,1992-04-18,Bridgetown,West Indies,1992,2,108,204,2,1,919,1991,34,811,1787,32,27.029411764705884,<=30,WI,Home,Upto 2014
KCG Benjamin,WI,Pace,1993-01-23,Adelaide,Australia,1993,2,54,108,2,1,644,1295,29,590,1187,27,22.20689655172414,<=30,AUS,Away,Upto 2014
KCG Benjamin,WI,Pace,1994-02-19,Kingston,West Indies,1994,2,126,252,8,1,877,1820,28,751,1568,20,31.321428571428573,>30,WI,Home,Upto 2014
KCG Benjamin,WI,Pace,1994-03-17,Georgetown,West Indies,1994,2,94,257,7,1,724,1622,26,630,1365,19,27.846153846153847,<=30,WI,Home,Upto 2014
KCG Benjamin,WI,Pace,1994-03-25,Port of Spain,West Indies,1994,1,70,120,0,1,673,1600,36,603,1480,36,18.694444444444443,<=30,WI,Home,Upto 2014
KCG Benjamin,WI,Pace,1994-04-08,Bridgetown,West Indies,1994,2,166,240,3,1,996,1767,31,830,1527,28,32.12903225806452,>30,WI,Home,Upto 2014
KCG Benjamin,WI,Pace,1994-04-16,St John's,West Indies,1994,1,110,222,4,1,833,1731,12,723,1509,8,69.41666666666667,>30,WI,Home,Upto 2014
KCG Benjamin,WI,Pace,1994-11-18,Wankhede,India,1994,2,130,273,7,1,502,993,23,372,720,16,21.82608695652174,<=30,IND,Away,Upto 2014
KCG Benjamin,WI,Pace,1994-12-01,Nagpur,India,1994,2,189,238,2,1,503,867,8,314,629,6,62.875,>30,IND,Away,Upto 2014
KCG Benjamin,WI,Pace,1994-12-10,Mohali,India,1994,2,171,315,8,1,720,1337,21,549,1022,13,34.285714285714285,>30,IND,Away,Upto 2014
KCG Benjamin,WI,Pace,1995-02-03,Christchurch,New Zealand,1995,2,103,186,3,1,515,1143,17,412,957,14,30.294117647058822,>30,NZ,Away,Upto 2014
KCG Benjamin,WI,Pace,1995-02-10,Wellington,New Zealand,1995,2,71,120,1,1,598,1142,20,527,1022,19,29.9,<=30,NZ,Away,Upto 2014
KCG Benjamin,WI,Pace,1995-03-31,Bridgetown,West Indies,1995,2,98,137,2,1,554,1046,24,456,909,22,23.083333333333332,<=30,WI,Home,Upto 2014
KCG Benjamin,WI,Pace,1995-04-08,St John's,West Indies,1995,2,109,186,1,1,658,1384,24,549,1198,23,27.416666666666668,<=30,WI,Home,Upto 2014
KCG Benjamin,WI,Pace,1995-04-21,Port of Spain,West Indies,1995,2,46,96,4,1,399,876,29,353,780,25,13.758620689655173,<=30,WI,Home,Upto 2014
KCG Benjamin,WI,Pace,1995-04-29,Kingston,West Indies,1995,1,106,143,3,1,658,1221,21,552,1078,18,31.333333333333332,>30,WI,Home,Upto 2014
KCG Benjamin,WI,Pace,1995-06-08,Leeds,England,1995,2,79,119,5,1,698,1234,27,619,1115,22,25.85185185185185,<=30,ENG,Away,Upto 2014
KCG Benjamin,WI,Pace,1995-07-06,Birmingham,England,1995,2,60,90,2,1,511,986,26,451,896,24,19.653846153846153,<=30,ENG,Away,Upto 2014
KCG Benjamin,WI,Pace,1995-07-27,Manchester,England,1995,2,112,222,3,1,744,1375,26,632,1153,23,28.615384615384617,<=30,ENG,Away,Upto 2014
KCG Benjamin,WI,Pace,1995-08-10,Nottingham,England,1995,2,174,357,10,1,678,1465,22,504,1108,12,30.818181818181817,>30,ENG,Away,Upto 2014
KCG Benjamin,WI,Pace,1995-08-24,The Oval,England,1995,1,81,162,3,1,1059,1992,20,978,1830,17,52.95,>30,ENG,Away,Upto 2014
KCG Benjamin,WI,Pace,1996-11-22,Brisbane,Australia,1996,2,149,288,3,1,925,1944,28,776,1656,25,33.035714285714285,>30,AUS,Away,Upto 2014
KCG Benjamin,WI,Pace,1996-11-29,Sydney,Australia,1996,2,115,228,2,1,754,1620,23,639,1392,21,32.78260869565217,>30,AUS,Away,Upto 2014
KCG Benjamin,WI,Pace,1996-12-26,Melbourne,Australia,1996,2,98,191,4,1,553,1299,28,455,1108,24,19.75,<=30,AUS,Away,Upto 2014
KCG Benjamin,WI,Pace,1998-02-05,Port of Spain,West Indies,1998,2,108,234,3,1,715,1728,33,607,1494,30,21.666666666666668,<=30,WI,Home,Upto 2014
KCG Benjamin,WI,Pace,1998-02-13,Port of Spain,West Indies,1998,2,58,144,0,1,618,1619,31,560,1475,31,19.93548387096774,<=30,WI,Home,Upto 2014
KD Boyce,WI,Pace,1971-03-19,Georgetown,West Indies,1971,2,59,136,2,1,313,504,3,254,368,1,104.33333333333333,>30,WI,Home,Upto 2014
KD Boyce,WI,Pace,1973-03-09,Bridgetown,West Indies,1973,2,122,240,3,1,508,1217,11,386,977,8,46.18181818181818,>30,WI,Home,Upto 2014
KD Boyce,WI,Pace,1973-03-23,Port of Spain,West Indies,1973,2,95,168,3,1,317,912,10,222,744,7,31.7,>30,WI,Home,Upto 2014
KD Boyce,WI,Pace,1973-04-06,Georgetown,West Indies,1973,2,102,196,3,1,667,1551,23,565,1355,20,29.0,<=30,WI,Home,Upto 2014
KD Boyce,WI,Pace,1973-04-21,Port of Spain,West Indies,1973,1,21,60,0,1,343,870,9,322,810,9,38.111111111111114,>30,WI,Home,Upto 2014
KD Boyce,WI,Pace,1973-07-26,The Oval,England,1973,2,147,259,11,1,552,1154,24,405,895,13,23.0,<=30,ENG,Away,Upto 2014
KD Boyce,WI,Pace,1973-08-09,Birmingham,England,1973,1,48,114,0,1,555,1416,18,507,1302,18,30.833333333333332,>30,ENG,Away,Upto 2014
KD Boyce,WI,Pace,1973-08-23,Lord's,England,1973,2,99,216,8,1,497,984,19,398,768,11,26.157894736842106,<=30,ENG,Away,Upto 2014
KD Boyce,WI,Pace,1974-02-02,Port of Spain,West Indies,1974,2,78,174,4,1,308,634,10,230,460,6,30.8,>30,WI,Home,Upto 2014
KD Boyce,WI,Pace,1974-02-16,Kingston,West Indies,1974,2,122,240,3,1,383,780,10,261,540,7,38.3,>30,WI,Home,Upto 2014
KD Boyce,WI,Pace,1974-03-22,Georgetown,West Indies,1974,1,70,166,3,1,242,634,5,172,468,2,48.4,>30,WI,Home,Upto 2014
KD Boyce,WI,Pace,1974-03-30,Port of Spain,West Indies,1974,2,54,132,1,1,172,537,8,118,405,7,21.5,<=30,WI,Home,Upto 2014
KD Boyce,WI,Pace,1974-11-22,Bengaluru,India,1974,2,94,150,3,1,351,694,15,257,544,12,23.4,<=30,IND,Away,Upto 2014
KD Boyce,WI,Pace,1974-12-11,Delhi,India,1974,2,51,84,1,1,263,477,8,212,393,7,32.875,>30,IND,Away,Upto 2014
KD Boyce,WI,Pace,1975-01-11,Chennai,India,1975,2,101,156,2,1,381,795,19,280,639,17,20.05263157894737,<=30,IND,Away,Upto 2014
KD Boyce,WI,Pace,1975-02-15,Lahore,Pakistan,1975,2,102,232,3,1,757,1707,25,655,1475,22,30.28,>30,PAK,Away,Upto 2014
KD Boyce,WI,Pace,1975-03-01,Karachi,Pakistan,1975,2,75,120,1,1,655,1306,12,580,1186,11,54.583333333333336,>30,PAK,Away,Upto 2014
KD Boyce,WI,Pace,1975-12-12,W.A.C.A,Australia,1975,2,61,112,1,1,857,1286,28,796,1174,27,30.607142857142858,>30,AUS,Away,Upto 2014
KD Boyce,WI,Pace,1976-01-03,Sydney,Australia,1976,2,89,160,2,1,784,1539,30,695,1379,28,26.133333333333333,<=30,AUS,Away,Upto 2014
KD Boyce,WI,Pace,1976-01-23,Adelaide,Australia,1976,2,62,96,1,1,939,1486,26,877,1390,25,36.11538461538461,>30,AUS,Away,Upto 2014
KD Boyce,WI,Pace,1976-01-31,Melbourne,Australia,1976,2,149,290,5,1,775,1378,27,626,1088,22,28.703703703703702,<=30,AUS,Away,Upto 2014
KD Ghavri,IND,Pace,1974-12-27,Eden Gardens,India,1974,2,46,84,2,1,424,954,21,378,870,19,20.19047619047619,<=30,IND,Home,Upto 2014
KD Ghavri,IND,Pace,1975-01-11,Chennai,India,1975,2,38,48,1,1,381,795,19,343,747,18,20.05263157894737,<=30,IND,Home,Upto 2014
KD Ghavri,IND,Pace,1975-01-23,Wankhede,India,1975,2,232,312,6,1,510,1022,16,278,710,10,31.875,>30,IND,Home,Upto 2014
KD Ghavri,IND,Pace,1976-11-18,Kanpur,India,1976,2,51,108,1,1,425,720,6,374,612,5,70.83333333333333,>30,IND,Home,Upto 2014
KD Ghavri,IND,Pace,1976-11-26,Chennai,India,1976,2,46,126,3,1,298,829,13,252,703,10,22.923076923076923,<=30,IND,Home,Upto 2014
KD Ghavri,IND,Pace,1976-12-17,Delhi,India,1976,1,50,84,0,1,217,567,13,167,483,13,16.692307692307693,<=30,IND,Home,Upto 2014
KD Ghavri,IND,Pace,1977-01-28,Bengaluru,India,1977,2,35,102,1,1,275,606,12,240,504,11,22.916666666666668,<=30,IND,Home,Upto 2014
KD Ghavri,IND,Pace,1977-02-11,Wankhede,India,1977,2,64,162,5,1,299,578,10,235,416,5,29.9,<=30,IND,Home,Upto 2014
KD Ghavri,IND,Pace,1977-12-30,Melbourne,Australia,1977,2,66,104,2,1,588,1273,19,522,1169,17,30.94736842105263,>30,AUS,Away,Upto 2014
KD Ghavri,IND,Pace,1978-01-07,Sydney,Australia,1978,2,67,159,2,1,322,871,11,255,712,9,29.272727272727273,<=30,AUS,Away,Upto 2014
KD Ghavri,IND,Pace,1978-01-28,Adelaide,Australia,1978,2,138,261,7,1,564,1391,22,426,1130,15,25.636363636363637,<=30,AUS,Away,Upto 2014
KD Ghavri,IND,Pace,1978-11-14,Karachi,Pakistan,1978,2,102,180,2,1,801,1525,25,699,1345,23,32.04,>30,PAK,Away,Upto 2014
KD Ghavri,IND,Pace,1978-12-01,Wankhede,India,1978,1,71,150,2,1,499,1002,13,428,852,11,38.38461538461539,>30,IND,Home,Upto 2014
KD Ghavri,IND,Pace,1978-12-15,Bengaluru,India,1978,2,128,240,7,1,557,1034,19,429,794,12,29.31578947368421,<=30,IND,Home,Upto 2014
KD Ghavri,IND,Pace,1978-12-29,Eden Gardens,India,1978,2,120,312,7,1,744,1474,17,624,1162,10,43.76470588235294,>30,IND,Home,Upto 2014
KD Ghavri,IND,Pace,1979-01-12,Chennai,India,1979,2,93,174,4,1,433,993,27,340,819,23,16.037037037037038,<=30,IND,Home,Upto 2014
KD Ghavri,IND,Pace,1979-01-24,Delhi,India,1979,2,104,162,3,1,605,998,12,501,836,9,50.416666666666664,>30,IND,Home,Upto 2014
KD Ghavri,IND,Pace,1979-02-02,Kanpur,India,1979,1,118,186,4,1,581,990,8,463,804,4,72.625,>30,IND,Home,Upto 2014
KD Ghavri,IND,Pace,1979-07-12,Birmingham,England,1979,1,129,228,0,1,689,1489,22,560,1261,22,31.318181818181817,>30,ENG,Away,Upto 2014
KD Ghavri,IND,Pace,1979-08-02,Lord's,England,1979,1,122,186,2,1,523,1253,16,401,1067,14,32.6875,>30,ENG,Away,Upto 2014
KD Ghavri,IND,Pace,1979-08-16,Leeds,England,1979,1,60,108,1,1,293,690,9,233,582,8,32.55555555555556,>30,ENG,Away,Upto 2014
KD Ghavri,IND,Pace,1979-08-30,The Oval,England,1979,2,137,360,5,1,700,1610,24,563,1250,19,29.166666666666668,<=30,ENG,Away,Upto 2014
KD Ghavri,IND,Pace,1979-09-11,Chennai,India,1979,2,72,226,0,1,448,938,6,376,712,6,74.66666666666667,>30,IND,Home,Upto 2014
KD Ghavri,IND,Pace,1979-09-19,Bengaluru,India,1979,2,77,132,2,1,384,678,4,307,546,2,96.0,>30,IND,Home,Upto 2014
KD Ghavri,IND,Pace,1979-10-02,Kanpur,India,1979,2,93,207,4,1,482,1119,27,389,912,23,17.85185185185185,<=30,IND,Home,Upto 2014
KD Ghavri,IND,Pace,1979-10-13,Delhi,India,1979,2,132,312,3,1,509,1106,14,377,794,11,36.357142857142854,>30,IND,Home,Upto 2014
KD Ghavri,IND,Pace,1979-10-26,Eden Gardens,India,1979,2,124,225,1,1,481,1011,15,357,786,14,32.06666666666667,>30,IND,Home,Upto 2014
KD Ghavri,IND,Pace,1979-11-03,Wankhede,India,1979,2,58,108,1,1,295,643,9,237,535,8,32.77777777777778,>30,IND,Home,Upto 2014
KD Ghavri,IND,Pace,1979-11-21,Bengaluru,India,1979,2,113,192,1,1,355,754,9,242,562,8,39.44444444444444,>30,IND,Home,Upto 2014
KD Ghavri,IND,Pace,1979-12-04,Delhi,India,1979,2,117,228,3,1,647,1401,30,530,1173,27,21.566666666666666,<=30,IND,Home,Upto 2014
KD Ghavri,IND,Pace,1979-12-16,Wankhede,India,1979,2,80,150,4,1,330,772,18,250,622,14,18.333333333333332,<=30,IND,Home,Upto 2014
KD Ghavri,IND,Pace,1979-12-25,Kanpur,India,1979,1,42,126,1,1,450,1133,20,408,1007,19,22.5,<=30,IND,Home,Upto 2014
KD Ghavri,IND,Pace,1980-01-15,Chennai,India,1980,2,155,196,4,1,708,1186,22,553,990,18,32.18181818181818,>30,IND,Home,Upto 2014
KD Ghavri,IND,Pace,1980-01-29,Eden Gardens,India,1980,2,109,197,2,1,644,1456,21,535,1259,19,30.666666666666668,>30,IND,Home,Upto 2014
KD Ghavri,IND,Pace,1980-02-15,Wankhede,India,1980,2,64,151,5,1,555,1195,28,491,1044,23,19.821428571428573,<=30,IND,Home,Upto 2014
KD Ghavri,IND,Pace,1981-01-02,Sydney,Australia,1981,1,107,180,5,1,622,1071,25,515,891,20,24.88,<=30,AUS,Away,Upto 2014
KD Ghavri,IND,Pace,1981-01-23,Adelaide,Australia,1981,2,143,228,1,1,673,1308,18,530,1080,17,37.388888888888886,>30,AUS,Away,Upto 2014
KD Ghavri,IND,Pace,1981-02-07,Melbourne,Australia,1981,2,120,282,4,1,509,1262,25,389,980,21,20.36,<=30,AUS,Away,Upto 2014
KD Ghavri,IND,Pace,1981-03-06,Christchurch,New Zealand,1981,1,33,60,1,1,349,1020,11,316,960,10,31.727272727272727,>30,NZ,Away,Upto 2014
KD Mackay,AUS,Pace,1956-06-21,Lord's,England,1956,1,15,66,1,1,698,1897,33,683,1831,32,21.151515151515152,<=30,ENG,Away,Upto 2014
KD Mackay,AUS,Pace,1956-07-12,Leeds,England,1956,1,29,78,0,1,232,778,8,203,700,8,29.0,<=30,ENG,Away,Upto 2014
KD Mackay,AUS,Pace,1956-10-19,Chennai,India,1956,1,25,120,0,1,145,569,11,120,449,11,13.181818181818182,<=30,IND,Away,Upto 2014
KD Mackay,AUS,Pace,1956-10-26,Brabourne,India,1956,2,49,188,3,1,321,854,10,272,666,7,32.1,>30,IND,Away,Upto 2014
KD Mackay,AUS,Pace,1957-12-23,Johannesburg,South Africa,1957,2,83,254,2,1,682,1716,24,599,1462,22,28.416666666666668,<=30,SA,Away,Upto 2014
KD Mackay,AUS,Pace,1957-12-31,Cape Town,South Africa,1957,1,6,40,0,1,357,1102,8,351,1062,8,44.625,>30,SA,Away,Upto 2014
KD Mackay,AUS,Pace,1958-01-24,Durban,South Africa,1958,1,77,280,1,1,460,1804,17,383,1524,16,27.058823529411764,<=30,SA,Away,Upto 2014
KD Mackay,AUS,Pace,1958-02-07,Johannesburg,South Africa,1958,1,11,88,0,1,425,1453,14,414,1365,14,30.357142857142858,>30,SA,Away,Upto 2014
KD Mackay,AUS,Pace,1958-02-28,Gqeberha,South Africa,1958,1,16,88,0,1,429,1409,18,413,1321,18,23.833333333333332,<=30,SA,Away,Upto 2014
KD Mackay,AUS,Pace,1958-12-05,Brisbane,Australia,1958,2,23,136,2,1,361,1352,20,338,1216,18,18.05,<=30,AUS,Home,Upto 2014
KD Mackay,AUS,Pace,1958-12-31,Melbourne,Australia,1958,1,16,72,0,1,456,1361,29,440,1289,29,15.724137931034482,<=30,AUS,Home,Upto 2014
KD Mackay,AUS,Pace,1959-01-09,Sydney,Australia,1959,2,40,152,1,1,297,1016,5,257,864,4,59.4,>30,AUS,Home,Upto 2014
KD Mackay,AUS,Pace,1959-11-13,Dhaka,Bangladesh,1959,2,58,384,7,1,428,1301,20,370,917,13,21.4,<=30,BAN,Away,Upto 2014
KD Mackay,AUS,Pace,1959-11-21,Lahore,Pakistan,1959,1,21,36,0,1,401,960,14,380,924,14,28.642857142857142,<=30,PAK,Away,Upto 2014
KD Mackay,AUS,Pace,1959-12-04,Karachi,Pakistan,1959,2,111,358,3,1,568,1464,19,457,1106,16,29.894736842105264,<=30,PAK,Away,Upto 2014
KD Mackay,AUS,Pace,1959-12-12,Delhi,India,1959,1,1,6,0,1,410,963,10,409,957,10,41.0,>30,IND,Away,Upto 2014
KD Mackay,AUS,Pace,1959-12-19,Kanpur,India,1959,1,14,60,0,1,231,796,13,217,736,13,17.76923076923077,<=30,IND,Away,Upto 2014
KD Mackay,AUS,Pace,1960-01-01,Brabourne,India,1960,2,17,72,0,1,552,1475,15,535,1403,15,36.8,>30,IND,Away,Upto 2014
KD Mackay,AUS,Pace,1960-01-13,Chennai,India,1960,2,18,42,1,1,260,780,12,242,738,11,21.666666666666668,<=30,IND,Away,Upto 2014
KD Mackay,AUS,Pace,1960-01-23,Eden Gardens,India,1960,2,52,192,3,1,523,1340,17,471,1148,14,30.764705882352942,>30,IND,Away,Upto 2014
KD Mackay,AUS,Pace,1960-12-09,Brisbane,Australia,1960,2,67,192,1,1,640,1184,22,573,992,21,29.09090909090909,<=30,AUS,Home,Upto 2014
KD Mackay,AUS,Pace,1961-01-13,Sydney,Australia,1961,2,115,364,3,1,402,914,14,287,550,11,28.714285714285715,<=30,AUS,Home,Upto 2014
KD Mackay,AUS,Pace,1961-01-27,Adelaide,Australia,1961,2,83,112,2,1,414,757,8,331,645,6,51.75,>30,AUS,Home,Upto 2014
KD Mackay,AUS,Pace,1961-02-10,Melbourne,Australia,1961,2,22,88,0,1,407,855,11,385,767,11,37.0,>30,AUS,Home,Upto 2014
KD Mackay,AUS,Pace,1961-06-08,Birmingham,England,1961,2,144,420,5,1,708,1529,14,564,1109,9,50.57142857142857,>30,ENG,Away,Upto 2014
KD Mackay,AUS,Pace,1961-06-22,Lord's,England,1961,2,29,120,2,1,687,1676,33,658,1556,31,20.818181818181817,<=30,ENG,Away,Upto 2014
KD Mackay,AUS,Pace,1961-07-06,Leeds,England,1961,2,42,138,0,1,372,1169,24,330,1031,24,15.5,<=30,ENG,Away,Upto 2014
KD Mackay,AUS,Pace,1961-07-27,Manchester,England,1961,2,114,318,2,1,869,2028,25,755,1710,23,34.76,>30,ENG,Away,Upto 2014
KD Mackay,AUS,Pace,1961-08-17,The Oval,England,1961,2,196,642,7,1,680,1860,19,484,1218,12,35.78947368421053,>30,ENG,Away,Upto 2014
KD Mackay,AUS,Pace,1962-11-30,Brisbane,Australia,1962,2,83,280,0,1,871,1952,19,788,1672,19,45.8421052631579,>30,AUS,Home,Upto 2014
KD Mackay,AUS,Pace,1962-12-29,Melbourne,Australia,1962,2,51,120,0,1,758,2009,23,707,1889,23,32.95652173913044,>30,AUS,Home,Upto 2014
KD Mackay,AUS,Pace,1963-01-25,Adelaide,Australia,1963,2,93,286,4,1,686,1693,27,593,1407,23,25.40740740740741,<=30,AUS,Home,Upto 2014
KD Mills,NZ,Pace,2004-06-10,Nottingham,England,2004,1,31,36,0,1,1015,1836,30,984,1800,30,33.833333333333336,>30,ENG,Away,Upto 2014
KD Mills,NZ,Pace,2004-11-18,Brisbane,Australia,2004,1,99,156,1,1,723,1283,17,624,1127,16,42.529411764705884,>30,AUS,Away,Upto 2014
KD Mills,NZ,Pace,2005-04-04,Napier,New Zealand,2005,1,59,138,0,1,832,1538,21,773,1400,21,39.61904761904762,>30,NZ,Home,Upto 2014
KD Mills,NZ,Pace,2005-04-11,Wellington,New Zealand,2005,2,84,186,2,1,716,1428,28,632,1242,26,25.571428571428573,<=30,NZ,Home,Upto 2014
KD Mills,NZ,Pace,2006-03-17,Wellington,New Zealand,2006,2,82,177,6,1,633,1165,28,551,988,22,22.607142857142858,<=30,NZ,Home,Upto 2014
KD Mills,NZ,Pace,2006-04-15,Centurion,South Africa,2006,2,100,234,5,1,858,1550,38,758,1316,33,22.57894736842105,<=30,SA,Away,Upto 2014
KD Mills,NZ,Pace,2006-05-05,Johannesburg,South Africa,2006,2,79,114,3,1,757,1280,36,678,1166,33,21.02777777777778,<=30,SA,Away,Upto 2014
KD Mills,NZ,Pace,2008-01-04,Dunedin,New Zealand,2008,2,83,115,3,1,478,890,22,395,775,19,21.727272727272727,<=30,NZ,Home,Upto 2014
KD Mills,NZ,Pace,2008-01-12,Wellington,New Zealand,2008,2,48,120,3,1,450,866,22,402,746,19,20.454545454545453,<=30,NZ,Home,Upto 2014
KD Mills,NZ,Pace,2008-03-05,Hamilton,New Zealand,2008,2,77,205,6,1,672,1450,27,595,1245,21,24.88888888888889,<=30,NZ,Home,Upto 2014
KD Mills,NZ,Pace,2008-03-13,Wellington,New Zealand,2008,2,145,318,4,1,966,1899,38,821,1581,34,25.42105263157895,<=30,NZ,Home,Upto 2014
KD Mills,NZ,Pace,2008-05-15,Lord's,England,2008,1,60,132,1,1,640,1330,19,580,1198,18,33.68421052631579,>30,ENG,Away,Upto 2014
KD Mills,NZ,Pace,2008-05-23,Manchester,England,2008,2,55,93,2,1,614,1172,16,559,1079,14,38.375,>30,ENG,Away,Upto 2014
KD Mills,NZ,Pace,2008-06-05,Nottingham,England,2008,1,76,186,3,1,579,1236,29,503,1050,26,19.96551724137931,<=30,ENG,Away,Upto 2014
KD Mills,NZ,Pace,2008-10-17,Chattogram,Bangladesh,2008,2,101,222,1,1,258,774,7,157,552,6,36.857142857142854,>30,BAN,Away,Upto 2014
KD Mills,NZ,Pace,2008-10-25,Mirpur,Bangladesh,2008,1,22,54,0,1,137,265,6,115,211,6,22.833333333333332,<=30,BAN,Away,Upto 2014
KD Mills,NZ,Pace,2008-12-11,Dunedin,New Zealand,2008,1,64,144,3,1,619,1080,13,555,936,10,47.61538461538461,>30,NZ,Home,Upto 2014
KD Mills,NZ,Pace,2008-12-19,Napier,New Zealand,2008,2,69,126,0,1,774,1324,23,705,1198,23,33.65217391304348,>30,NZ,Home,Upto 2014
KD Mills,NZ,Pace,2009-03-18,Hamilton,New Zealand,2009,2,119,146,1,1,743,1246,14,624,1100,13,53.07142857142857,>30,NZ,Home,Upto 2014
KD Walters,AUS,Pace,1965-12-10,Brisbane,Australia,1965,2,47,120,2,1,379,960,11,332,840,9,34.45454545454545,>30,AUS,Home,Upto 2014
KD Walters,AUS,Pace,1965-12-30,Melbourne,Australia,1965,1,32,80,1,1,657,1479,19,625,1399,18,34.578947368421055,>30,AUS,Home,Upto 2014
KD Walters,AUS,Pace,1966-01-07,Sydney,Australia,1966,1,38,80,1,1,445,1015,16,407,935,15,27.8125,<=30,AUS,Home,Upto 2014
KD Walters,AUS,Pace,1966-01-28,Adelaide,Australia,1966,2,97,184,1,1,581,1367,21,484,1183,20,27.666666666666668,<=30,AUS,Home,Upto 2014
KD Walters,AUS,Pace,1966-02-11,Melbourne,Australia,1966,2,69,168,4,1,701,1506,15,632,1338,11,46.733333333333334,>30,AUS,Home,Upto 2014
KD Walters,AUS,Pace,1968-01-19,Brisbane,Australia,1968,2,55,136,1,1,552,1226,17,497,1090,16,32.470588235294116,>30,AUS,Home,Upto 2014
KD Walters,AUS,Pace,1968-01-26,Sydney,Australia,1968,2,31,56,1,1,498,913,9,467,857,8,55.333333333333336,>30,AUS,Home,Upto 2014
KD Walters,AUS,Pace,1968-06-20,Lord's,England,1968,1,2,18,0,1,427,1141,15,425,1123,15,28.466666666666665,<=30,ENG,Away,Upto 2014
KD Walters,AUS,Pace,1968-07-11,Birmingham,England,1968,1,8,42,0,1,595,1325,15,587,1283,15,39.666666666666664,>30,ENG,Away,Upto 2014
KD Walters,AUS,Pace,1968-08-22,The Oval,England,1968,1,17,36,0,1,485,1288,15,468,1252,15,32.333333333333336,>30,ENG,Away,Upto 2014
KD Walters,AUS,Pace,1969-01-03,Sydney,Australia,1969,1,3,16,0,1,677,1377,20,674,1361,20,33.85,>30,AUS,Home,Upto 2014
KD Walters,AUS,Pace,1969-01-24,Adelaide,Australia,1969,1,6,8,0,1,674,1285,19,668,1277,19,35.473684210526315,>30,AUS,Home,Upto 2014
KD Walters,AUS,Pace,1969-11-04,Brabourne,India,1969,1,13,36,0,1,298,821,12,285,785,12,24.833333333333332,<=30,IND,Away,Upto 2014
KD Walters,AUS,Pace,1969-11-15,Kanpur,India,1969,2,14,30,0,1,379,992,12,365,962,12,31.583333333333332,>30,IND,Away,Upto 2014
KD Walters,AUS,Pace,1970-01-22,Cape Town,South Africa,1970,1,19,48,2,1,471,1312,21,452,1264,19,22.428571428571427,<=30,SA,Away,Upto 2014
KD Walters,AUS,Pace,1970-02-05,Durban,South Africa,1970,1,44,54,0,1,686,1387,21,642,1333,21,32.666666666666664,>30,SA,Away,Upto 2014
KD Walters,AUS,Pace,1970-02-19,Johannesburg,South Africa,1970,2,49,72,2,1,766,1822,28,717,1750,26,27.357142857142858,<=30,SA,Away,Upto 2014
KD Walters,AUS,Pace,1970-03-05,Gqeberha,South Africa,1970,2,33,84,1,1,887,1974,33,854,1890,32,26.87878787878788,<=30,SA,Away,Upto 2014
KD Walters,AUS,Pace,1970-11-27,Brisbane,Australia,1970,1,12,45,3,1,624,1629,19,612,1584,16,32.8421052631579,>30,AUS,Home,Upto 2014
KD Walters,AUS,Pace,1970-12-11,W.A.C.A,Australia,1970,2,61,144,2,1,852,2129,21,791,1985,19,40.57142857142857,>30,AUS,Home,Upto 2014
KD Walters,AUS,Pace,1971-01-09,Sydney,Australia,1971,2,25,40,0,1,480,1339,18,455,1299,18,26.666666666666668,<=30,AUS,Home,Upto 2014
KD Walters,AUS,Pace,1971-01-21,Melbourne,Australia,1971,2,21,96,1,1,660,1712,13,639,1616,12,50.76923076923077,>30,AUS,Home,Upto 2014
KD Walters,AUS,Pace,1971-01-29,Adelaide,Australia,1971,2,34,96,0,1,768,1851,22,734,1755,22,34.90909090909091,>30,AUS,Home,Upto 2014
KD Walters,AUS,Pace,1971-02-12,Sydney,Australia,1971,2,28,72,1,1,479,1333,21,451,1261,20,22.80952380952381,<=30,AUS,Home,Upto 2014
KD Walters,AUS,Pace,1972-06-08,Manchester,England,1972,1,7,30,0,1,656,1682,30,649,1652,30,21.866666666666667,<=30,ENG,Away,Upto 2014
KD Walters,AUS,Pace,1973-01-06,Sydney,Australia,1973,1,25,72,0,1,767,1875,36,742,1803,36,21.305555555555557,<=30,AUS,Home,Upto 2014
KD Walters,AUS,Pace,1973-02-16,Kingston,West Indies,1973,1,0,6,0,1,629,1295,15,629,1289,15,41.93333333333333,>30,WI,Away,Upto 2014
KD Walters,AUS,Pace,1973-03-09,Bridgetown,West Indies,1973,1,7,12,0,1,508,1217,11,501,1205,11,46.18181818181818,>30,WI,Away,Upto 2014
KD Walters,AUS,Pace,1973-04-06,Georgetown,West Indies,1973,2,89,188,7,1,667,1551,23,578,1363,16,29.0,<=30,WI,Away,Upto 2014
KD Walters,AUS,Pace,1973-04-21,Port of Spain,West Indies,1973,1,5,18,0,1,343,870,9,338,852,9,38.111111111111114,>30,WI,Away,Upto 2014
KD Walters,AUS,Pace,1973-12-29,Melbourne,Australia,1973,1,26,104,3,1,539,1189,14,513,1085,11,38.5,>30,AUS,Home,Upto 2014
KD Walters,AUS,Pace,1974-01-05,Sydney,Australia,1974,2,93,176,5,1,618,1375,28,525,1199,23,22.071428571428573,<=30,AUS,Home,Upto 2014
KD Walters,AUS,Pace,1974-01-26,Adelaide,Australia,1974,2,19,32,0,1,505,1312,13,486,1280,13,38.84615384615385,>30,AUS,Home,Upto 2014
KD Walters,AUS,Pace,1974-03-01,Wellington,New Zealand,1974,1,39,64,0,1,960,1997,18,921,1933,18,53.333333333333336,>30,NZ,Away,Upto 2014
KD Walters,AUS,Pace,1974-03-08,Christchurch,New Zealand,1974,1,34,56,0,1,814,2050,32,780,1994,32,25.4375,<=30,NZ,Away,Upto 2014
KD Walters,AUS,Pace,1974-11-29,Brisbane,Australia,1974,2,18,64,1,1,649,1743,27,631,1679,26,24.037037037037038,<=30,AUS,Home,Upto 2014
KD Walters,AUS,Pace,1974-12-13,W.A.C.A,Australia,1974,2,30,91,2,1,728,1672,24,698,1581,22,30.333333333333332,>30,AUS,Home,Upto 2014
KD Walters,AUS,Pace,1974-12-26,Melbourne,Australia,1974,1,15,56,0,1,489,1257,19,474,1201,19,25.736842105263158,<=30,AUS,Home,Upto 2014
KD Walters,AUS,Pace,1975-01-04,Sydney,Australia,1975,1,26,56,2,1,724,1665,23,698,1609,21,31.47826086956522,>30,AUS,Home,Upto 2014
KD Walters,AUS,Pace,1975-02-08,Melbourne,Australia,1975,1,86,184,0,1,711,1562,25,625,1378,25,28.44,<=30,AUS,Home,Upto 2014
KD Walters,AUS,Pace,1975-07-31,Lord's,England,1975,1,6,12,1,1,808,1552,18,802,1540,17,44.888888888888886,>30,ENG,Away,Upto 2014
KD Walters,AUS,Pace,1975-08-28,The Oval,England,1975,1,34,65,4,1,686,1764,24,652,1699,20,28.583333333333332,<=30,ENG,Away,Upto 2014
KD Walters,AUS,Pace,1976-12-24,Adelaide,Australia,1976,2,17,40,0,1,783,1646,15,766,1606,15,52.2,>30,AUS,Home,Upto 2014
KD Walters,AUS,Pace,1977-01-14,Sydney,Australia,1977,1,7,32,0,1,681,1364,30,674,1332,30,22.7,<=30,AUS,Home,Upto 2014
KD Walters,AUS,Pace,1977-02-25,Auckland,New Zealand,1977,1,20,32,1,1,733,1600,29,713,1568,28,25.275862068965516,<=30,NZ,Away,Upto 2014
KD Walters,AUS,Pace,1977-03-12,Melbourne,Australia,1977,1,7,24,0,1,769,1725,30,762,1701,30,25.633333333333333,<=30,AUS,Home,Upto 2014
KD Walters,AUS,Pace,1977-07-28,Nottingham,England,1977,1,5,18,0,1,788,1906,27,783,1888,27,29.185185185185187,<=30,ENG,Away,Upto 2014
KD Walters,AUS,Pace,1977-08-11,Leeds,England,1977,1,5,18,0,1,569,1338,25,564,1320,25,22.76,<=30,ENG,Away,Upto 2014
KD Walters,AUS,Pace,1980-11-28,Brisbane,Australia,1980,1,2,6,0,1,530,1227,24,528,1221,24,22.083333333333332,<=30,AUS,Home,Upto 2014
KD Walters,AUS,Pace,1980-12-12,W.A.C.A,Australia,1980,2,12,24,0,1,516,1220,27,504,1196,27,19.11111111111111,<=30,AUS,Home,Upto 2014
KD Walters,AUS,Pace,1981-01-02,Sydney,Australia,1981,1,12,36,0,1,622,1071,25,610,1035,25,24.88,<=30,AUS,Home,Upto 2014
KD Walters,AUS,Pace,1981-01-23,Adelaide,Australia,1981,1,21,18,0,1,673,1308,18,652,1290,18,37.388888888888886,>30,AUS,Home,Upto 2014
KDK Vithanage,SL,Spin,2014-02-04,Chattogram,Bangladesh,2014,1,73,96,1,1,1153,1976,25,1080,1880,24,46.12,>30,BAN,Away,After 1965
KDK Vithanage,SL,Spin,2014-07-24,Colombo (SSC),Sri Lanka,2014,2,29,54,0,1,647,1745,22,618,1691,22,29.40909090909091,<=30,SL,Home,After 1965
KDK Vithanage,SL,Spin,2014-08-06,Galle,Sri Lanka,2014,1,10,6,0,1,717,1430,22,707,1424,22,32.59090909090909,>30,SL,Home,After 1965
KDK Vithanage,SL,Spin,2015-06-17,Galle,Sri Lanka,2015,1,21,18,0,1,617,1159,20,596,1141,20,30.85,>30,SL,Home,After 1965
KE Palmer,ENG,Pace,1965-02-12,Gqeberha,South Africa,1965,2,189,378,1,1,624,1549,12,435,1171,11,52.0,>30,SA,Away,Upto 2014
KEA Upashantha,SL,Pace,1999-02-24,Colombo (SSC),Sri Lanka,1999,2,135,258,3,1,790,1434,9,655,1176,6,87.77777777777777,>30,SL,Home,Upto 2014
KEA Upashantha,SL,Pace,2002-06-13,Manchester,England,2002,1,65,48,1,1,775,1409,20,710,1361,19,38.75,>30,ENG,Away,Upto 2014
KF Barrington,ENG,Spin,1959-07-23,Manchester,England,1959,2,111,246,5,1,721,1722,21,610,1476,16,34.333333333333336,>30,ENG,Home,Upto 2014
KF Barrington,ENG,Spin,1959-08-20,The Oval,England,1959,1,24,36,0,1,323,930,8,299,894,8,40.375,>30,ENG,Home,Upto 2014
KF Barrington,ENG,Spin,1960-01-06,Bridgetown,West Indies,1960,1,60,108,1,1,518,1446,6,458,1338,5,86.33333333333333,>30,WI,Away,Upto 2014
KF Barrington,ENG,Spin,1960-01-28,Port of Spain,West Indies,1960,2,49,251,2,1,448,1444,13,399,1193,11,34.46153846153846,>30,WI,Away,Upto 2014
KF Barrington,ENG,Spin,1960-02-17,Kingston,West Indies,1960,2,38,150,1,1,443,1323,11,405,1173,10,40.27272727272727,>30,WI,Away,Upto 2014
KF Barrington,ENG,Spin,1960-03-09,Georgetown,West Indies,1960,1,22,36,0,1,501,1694,13,479,1658,13,38.53846153846154,>30,WI,Away,Upto 2014
KF Barrington,ENG,Spin,1960-03-25,Port of Spain,West Indies,1960,2,48,96,1,1,649,1404,16,601,1308,15,40.5625,>30,WI,Away,Upto 2014
KF Barrington,ENG,Spin,1960-07-07,Nottingham,England,1960,1,5,18,0,1,109,321,3,104,303,3,36.333333333333336,>30,ENG,Home,Upto 2014
KF Barrington,ENG,Spin,1961-10-21,Lahore,Pakistan,1961,1,25,36,0,1,702,1631,18,677,1595,18,39.0,>30,PAK,Away,Upto 2014
KF Barrington,ENG,Spin,1961-11-11,Brabourne,India,1961,1,18,18,0,1,727,1890,18,709,1872,18,40.388888888888886,>30,IND,Away,Upto 2014
KF Barrington,ENG,Spin,1961-12-13,Delhi,India,1961,1,39,54,0,1,505,1242,8,466,1188,8,63.125,>30,IND,Away,Upto 2014
KF Barrington,ENG,Spin,1962-01-19,Dhaka,Bangladesh,1962,2,56,192,0,1,862,2494,25,806,2302,25,34.48,>30,BAN,Away,Upto 2014
KF Barrington,ENG,Spin,1962-05-31,Birmingham,England,1962,1,0,12,0,1,664,1386,13,664,1374,13,51.07692307692308,>30,ENG,Home,Upto 2014
KF Barrington,ENG,Spin,1962-06-21,Lord's,England,1962,1,8,6,0,1,359,496,6,351,490,6,59.833333333333336,>30,ENG,Home,Upto 2014
KF Barrington,ENG,Spin,1962-07-05,Leeds,England,1962,1,4,6,0,1,208,474,7,204,468,7,29.714285714285715,<=30,ENG,Home,Upto 2014
KF Barrington,ENG,Spin,1962-08-16,The Oval,England,1962,1,10,12,0,1,452,1071,6,442,1059,6,75.33333333333333,>30,ENG,Home,Upto 2014
KF Barrington,ENG,Spin,1962-11-30,Brisbane,Australia,1962,1,44,96,1,1,507,1344,11,463,1248,10,46.09090909090909,>30,AUS,Away,Upto 2014
KF Barrington,ENG,Spin,1962-12-29,Melbourne,Australia,1962,2,45,88,0,1,341,714,6,296,626,6,56.833333333333336,>30,AUS,Away,Upto 2014
KF Barrington,ENG,Spin,1963-01-11,Sydney,Australia,1963,1,43,64,0,1,280,848,15,237,784,15,18.666666666666668,<=30,AUS,Away,Upto 2014
KF Barrington,ENG,Spin,1963-02-15,Sydney,Australia,1963,1,22,64,0,1,588,2042,17,566,1978,17,34.588235294117645,>30,AUS,Away,Upto 2014
KF Barrington,ENG,Spin,1963-02-23,Auckland,New Zealand,1963,1,38,72,0,1,567,1236,14,529,1164,14,40.5,>30,NZ,Away,Upto 2014
KF Barrington,ENG,Spin,1963-03-01,Wellington,New Zealand,1963,2,33,81,4,1,364,1047,13,331,966,9,28.0,<=30,NZ,Away,Upto 2014
KF Barrington,ENG,Spin,1963-03-15,Christchurch,New Zealand,1963,1,18,30,0,1,329,813,12,311,783,12,27.416666666666668,<=30,NZ,Away,Upto 2014
KF Barrington,ENG,Spin,1964-01-10,Chennai,India,1964,2,29,36,0,1,876,2493,27,847,2457,27,32.44444444444444,>30,IND,Away,Upto 2014
KF Barrington,ENG,Spin,1964-07-23,Manchester,England,1964,1,4,6,0,1,477,1315,3,473,1309,3,159.0,>30,ENG,Home,Upto 2014
KF Barrington,ENG,Spin,1964-12-23,Johannesburg,South Africa,1964,1,29,24,0,1,545,1457,14,516,1433,14,38.92857142857143,>30,SA,Away,Upto 2014
KF Barrington,ENG,Spin,1965-01-01,Cape Town,South Africa,1965,1,4,19,3,1,605,1499,14,601,1480,11,43.214285714285715,>30,SA,Away,Upto 2014
KF Barrington,ENG,Spin,1965-05-27,Birmingham,England,1965,1,25,30,0,1,528,1355,15,503,1325,15,35.2,>30,ENG,Home,Upto 2014
KF Barrington,ENG,Spin,1965-12-30,Melbourne,Australia,1965,1,47,60,2,1,661,1476,9,614,1416,7,73.44444444444444,>30,AUS,Away,Upto 2014
KF Barrington,ENG,Spin,1967-06-08,Leeds,England,1967,1,38,54,0,1,861,2089,19,823,2035,19,45.31578947368421,>30,ENG,Home,Upto 2014
KF Barrington,ENG,Spin,1967-07-27,Lord's,England,1967,2,52,144,3,1,583,1689,19,531,1545,16,30.68421052631579,>30,ENG,Home,Upto 2014
KF Barrington,ENG,Spin,1967-08-24,The Oval,England,1967,1,29,48,0,1,475,1075,13,446,1027,13,36.53846153846154,>30,ENG,Home,Upto 2014
KF Barrington,ENG,Spin,1968-01-19,Port of Spain,West Indies,1968,2,113,198,2,1,688,1548,12,575,1350,10,57.333333333333336,>30,WI,Away,Upto 2014
KF Barrington,ENG,Spin,1968-02-08,Kingston,West Indies,1968,1,14,36,0,1,308,929,12,294,893,12,25.666666666666668,<=30,WI,Away,Upto 2014
KF Barrington,ENG,Spin,1968-02-29,Bridgetown,West Indies,1968,2,46,72,1,1,405,1049,8,359,977,7,50.625,>30,WI,Away,Upto 2014
KF Barrington,ENG,Spin,1968-03-14,Port of Spain,West Indies,1968,1,41,60,1,1,721,1580,15,680,1520,14,48.06666666666667,>30,WI,Away,Upto 2014
KF Barrington,ENG,Spin,1968-03-28,Georgetown,West Indies,1968,1,43,108,1,1,621,1884,22,578,1776,21,28.227272727272727,<=30,WI,Away,Upto 2014
KF Barrington,ENG,Spin,1968-06-20,Lord's,England,1968,1,12,12,1,1,103,330,4,91,318,3,25.75,<=30,ENG,Home,Upto 2014
KF Barrington,ENG,Spin,1968-07-25,Leeds,England,1968,1,14,36,0,1,396,1367,16,382,1331,16,24.75,<=30,ENG,Home,Upto 2014
KG Viljoen,SA,Spin,1930-12-24,Johannesburg,South Africa,1930,1,10,24,0,1,386,746,13,376,722,13,29.692307692307693,<=30,SA,Home,Upto 2014
KG Viljoen,SA,Spin,1931-02-13,Johannesburg,South Africa,1931,1,13,24,0,1,443,1089,15,430,1065,15,29.533333333333335,<=30,SA,Home,Upto 2014
KH Eastwood,AUS,Spin,1971-02-12,Sydney,Australia,1971,1,21,40,1,1,385,1254,19,364,1214,18,20.263157894736842,<=30,AUS,Home,Upto 2014
KHRK Fernando,SL,Pace,2002-11-08,Johannesburg,South Africa,2002,1,63,126,3,1,582,1139,26,519,1013,23,22.384615384615383,<=30,SA,Away,Upto 2014
KHRK Fernando,SL,Pace,2002-11-15,Centurion,South Africa,2002,1,45,108,1,1,905,1840,32,860,1732,31,28.28125,<=30,SA,Away,Upto 2014
KIC Asalanka,SL,Spin,2021-11-29,Galle,Sri Lanka,2021,1,2,6,0,1,790,1806,36,788,1800,36,21.944444444444443,<=30,SL,Home,After 1965
KIC Asalanka,SL,Spin,2022-03-04,Mohali,India,2022,1,14,19,0,1,500,927,18,486,908,18,27.77777777777778,<=30,IND,Away,After 1965
KIW Wijegunawardene,SL,Pace,1991-08-22,Lord's,England,1991,2,49,72,0,1,770,1537,23,721,1465,23,33.47826086956522,>30,ENG,Away,Upto 2014
KIW Wijegunawardene,SL,Pace,1992-01-02,Faisalabad,Pakistan,1992,2,98,292,7,1,743,1706,36,645,1414,29,20.63888888888889,<=30,PAK,Away,Upto 2014
KJ Abbott,SA,Pace,2013-02-22,Centurion,South Africa,2013,2,68,172,9,1,578,1050,26,510,878,17,22.23076923076923,<=30,SA,Home,Upto 2014
KJ Abbott,SA,Pace,2014-03-01,Cape Town,South Africa,2014,2,129,252,3,1,924,1728,25,795,1476,22,36.96,>30,SA,Home,After 1965
KJ Abbott,SA,Pace,2014-12-17,Centurion,South Africa,2014,2,61,102,1,1,587,1007,20,526,905,19,29.35,<=30,SA,Home,After 1965
KJ Abbott,SA,Pace,2015-11-14,Bengaluru,India,2015,1,18,36,0,1,150,258,1,132,222,1,150.0,>30,IND,Away,After 1965
KJ Abbott,SA,Pace,2015-12-03,Delhi,India,2015,2,87,281,6,1,288,947,15,201,666,9,19.2,<=30,IND,Away,After 1965
KJ Abbott,SA,Pace,2015-12-26,Durban,South Africa,2015,2,128,274,2,1,593,1392,27,465,1118,25,21.962962962962962,<=30,SA,Home,After 1965
KJ Abbott,SA,Pace,2016-01-22,Centurion,South Africa,2016,2,46,126,0,1,827,1592,31,781,1466,31,26.677419354838708,<=30,SA,Home,After 1965
KJ Abbott,SA,Pace,2016-11-12,Hobart,Australia,2016,2,118,215,9,1,477,1007,29,359,792,20,16.448275862068964,<=30,AUS,Away,After 1965
KJ Abbott,SA,Pace,2016-11-24,Adelaide,Australia,2016,2,75,234,4,1,686,1407,24,611,1173,20,28.583333333333332,<=30,AUS,Away,After 1965
KJ Abbott,SA,Pace,2016-12-26,Gqeberha,South Africa,2016,2,101,251,5,1,798,1468,25,697,1217,20,31.92,>30,SA,Home,After 1965
KJ Abbott,SA,Pace,2017-01-02,Cape Town,South Africa,2017,2,55,138,0,1,701,1233,30,646,1095,30,23.366666666666667,<=30,SA,Home,After 1965
KJ Barnett,ENG,Spin,1989-06-08,Leeds,England,1989,1,32,36,0,1,41,78,0,9,42,0,inf,>30,ENG,Home,Upto 2014
KJ Hughes,AUS,Pace,1979-12-29,Melbourne,Australia,1979,1,0,6,0,1,659,1369,27,659,1363,27,24.40740740740741,<=30,AUS,Home,Upto 2014
KJ Hughes,AUS,Pace,1980-03-06,Faisalabad,Pakistan,1980,1,19,48,0,1,357,750,4,338,702,4,89.25,>30,PAK,Away,Upto 2014
KJ Hughes,AUS,Pace,1980-12-26,Melbourne,Australia,1980,1,0,6,0,1,683,1801,29,683,1795,29,23.551724137931036,<=30,AUS,Home,Upto 2014
KJ Hughes,AUS,Pace,1981-01-23,Adelaide,Australia,1981,1,1,6,0,1,673,1308,18,672,1302,18,37.388888888888886,>30,AUS,Home,Upto 2014
KJ Hughes,AUS,Pace,1981-12-11,Melbourne,Australia,1981,1,2,18,0,1,395,1019,11,393,1001,11,35.90909090909091,>30,AUS,Home,Upto 2014
KJ Hughes,AUS,Pace,1982-09-22,Karachi,Pakistan,1982,1,6,1,0,1,384,853,11,378,852,11,34.90909090909091,>30,PAK,Away,Upto 2014
KJ O'Brien,IRE,Pace,2018-05-11,Dublin (Malahide),Ireland,2018,1,20,36,0,1,792,1625,28,772,1589,28,28.285714285714285,<=30,IRE,Home,After 1965
KJ O'Brien,IRE,Pace,2019-03-15,Dehradun,India,2019,1,11,24,0,1,244,549,10,233,525,10,24.4,<=30,IND,Away,After 1965
KJ O'Keeffe,AUS,Spin,1971-01-21,Melbourne,Australia,1971,2,116,400,0,1,448,1245,9,332,845,9,49.77777777777778,>30,AUS,Home,Upto 2014
KJ O'Keeffe,AUS,Spin,1971-02-12,Sydney,Australia,1971,2,144,400,6,1,385,1254,19,241,854,13,20.263157894736842,<=30,AUS,Home,Upto 2014
KJ O'Keeffe,AUS,Spin,1972-12-22,Adelaide,Australia,1972,2,88,176,1,1,497,880,15,409,704,14,33.13333333333333,>30,AUS,Home,Upto 2014
KJ O'Keeffe,AUS,Spin,1972-12-29,Melbourne,Australia,1972,2,104,256,2,1,666,1379,10,562,1123,8,66.6,>30,AUS,Home,Upto 2014
KJ O'Keeffe,AUS,Spin,1973-02-16,Kingston,West Indies,1973,1,71,108,0,1,500,1086,7,429,978,7,71.42857142857143,>30,WI,Away,Upto 2014
KJ O'Keeffe,AUS,Spin,1973-03-09,Bridgetown,West Indies,1973,2,33,96,0,1,470,1314,10,437,1218,10,47.0,>30,WI,Away,Upto 2014
KJ O'Keeffe,AUS,Spin,1973-03-23,Port of Spain,West Indies,1973,2,119,313,6,1,758,1913,26,639,1600,20,29.153846153846153,<=30,WI,Away,Upto 2014
KJ O'Keeffe,AUS,Spin,1973-04-06,Georgetown,West Indies,1973,1,27,48,0,1,241,564,5,214,516,5,48.2,>30,WI,Away,Upto 2014
KJ O'Keeffe,AUS,Spin,1973-04-21,Port of Spain,West Indies,1973,2,53,126,0,1,694,1730,21,641,1604,21,33.04761904761905,>30,WI,Away,Upto 2014
KJ O'Keeffe,AUS,Spin,1973-12-29,Melbourne,Australia,1973,2,91,350,4,1,322,917,12,231,567,8,26.833333333333332,<=30,AUS,Home,Upto 2014
KJ O'Keeffe,AUS,Spin,1974-01-05,Sydney,Australia,1974,2,60,144,1,1,161,344,2,101,200,1,80.5,>30,AUS,Home,Upto 2014
KJ O'Keeffe,AUS,Spin,1974-01-26,Adelaide,Australia,1974,2,106,419,6,1,351,1069,16,245,650,10,21.9375,<=30,AUS,Home,Upto 2014
KJ O'Keeffe,AUS,Spin,1974-03-01,Wellington,New Zealand,1974,1,83,264,2,1,424,1008,5,341,744,3,84.8,>30,NZ,Away,Upto 2014
KJ O'Keeffe,AUS,Spin,1974-03-22,Auckland,New Zealand,1974,1,8,40,2,1,164,410,11,156,370,9,14.909090909090908,<=30,NZ,Away,Upto 2014
KJ O'Keeffe,AUS,Spin,1976-12-24,Adelaide,Australia,1976,2,208,576,6,1,612,1524,18,404,948,12,34.0,>30,AUS,Home,Upto 2014
KJ O'Keeffe,AUS,Spin,1977-01-01,Melbourne,Australia,1977,2,101,313,5,1,386,751,13,285,438,8,29.692307692307693,<=30,AUS,Home,Upto 2014
KJ O'Keeffe,AUS,Spin,1977-01-14,Sydney,Australia,1977,1,32,88,0,1,67,202,1,35,114,1,67.0,>30,AUS,Home,Upto 2014
KJ O'Keeffe,AUS,Spin,1977-02-18,Christchurch,New Zealand,1977,2,157,384,6,1,288,616,8,131,232,2,36.0,>30,NZ,Away,Upto 2014
KJ O'Keeffe,AUS,Spin,1977-02-25,Auckland,New Zealand,1977,1,0,8,0,1,30,80,0,30,72,0,inf,>30,NZ,Away,Upto 2014
KJ O'Keeffe,AUS,Spin,1977-03-12,Melbourne,Australia,1977,2,112,272,3,1,232,574,9,120,302,6,25.77777777777778,<=30,AUS,Home,Upto 2014
KJ O'Keeffe,AUS,Spin,1977-06-16,Lord's,England,1977,2,58,150,1,1,116,360,3,58,210,2,38.666666666666664,>30,ENG,Away,Upto 2014
KJ O'Keeffe,AUS,Spin,1977-07-07,Manchester,England,1977,2,139,271,2,1,431,1095,17,292,824,15,25.352941176470587,<=30,ENG,Away,Upto 2014
KJ O'Keeffe,AUS,Spin,1977-07-28,Nottingham,England,1977,2,108,182,0,1,239,584,5,131,402,5,47.8,>30,ENG,Away,Upto 2014
KJ Silva,SL,Spin,1995-12-26,Melbourne,Australia,1995,1,120,210,1,1,439,892,9,319,682,8,48.77777777777778,>30,AUS,Away,Upto 2014
KJ Silva,SL,Spin,1996-09-11,Colombo (RPS),Sri Lanka,1996,2,35,202,7,1,302,952,21,267,750,14,14.380952380952381,<=30,SL,Home,Upto 2014
KJ Silva,SL,Spin,1996-09-18,Colombo (SSC),Sri Lanka,1996,2,65,217,6,1,399,1111,19,334,894,13,21.0,<=30,SL,Home,Upto 2014
KJ Silva,SL,Spin,1997-04-26,Colombo (SSC),Sri Lanka,1997,2,162,318,3,1,882,1775,14,720,1457,11,63.0,>30,SL,Home,Upto 2014
KJ Silva,SL,Spin,1997-08-02,Colombo (RPS),Sri Lanka,1997,1,122,234,0,1,1044,2082,8,922,1848,8,130.5,>30,SL,Home,Upto 2014
KJ Silva,SL,Spin,1997-11-26,Nagpur,India,1997,1,81,168,0,1,254,546,2,173,378,2,127.0,>30,IND,Away,Upto 2014
KJ Silva,SL,Spin,1998-01-07,Kandy,Sri Lanka,1998,2,62,184,3,1,546,1374,23,484,1190,20,23.73913043478261,<=30,SL,Home,Upto 2014
KK Jennings,ENG,Pace,2016-12-16,Chennai,India,2016,1,20,30,0,1,437,846,9,417,816,9,48.55555555555556,>30,IND,Away,After 1965
KK Jennings,ENG,Pace,2017-07-14,Nottingham,England,2017,1,2,6,0,1,739,1395,28,737,1389,28,26.392857142857142,<=30,ENG,Home,After 1965
KK Jennings,ENG,Pace,2018-08-30,Southampton,England,2018,1,4,12,0,1,624,1317,26,620,1305,26,24.0,<=30,ENG,Home,After 1965
KK Jennings,ENG,Pace,2019-01-23,Bridgetown,West Indies,2019,1,29,25,0,1,635,1301,24,606,1276,24,26.458333333333332,<=30,WI,Away,After 1965
KK Nair,IND,Spin,2016-12-16,Chennai,India,2016,1,4,6,0,1,966,1770,17,962,1764,17,56.8235294117647,>30,IND,Home,After 1965
KK Nair,IND,Spin,2017-03-04,Bengaluru,India,2017,1,7,6,0,1,406,1139,26,399,1133,26,15.615384615384615,<=30,IND,Home,After 1965
KK Peters,WI,Pace,2014-12-26,Gqeberha,South Africa,2014,1,69,120,2,1,464,870,12,395,750,10,38.666666666666664,>30,SA,Away,After 1965
KK Tarapore,IND,Spin,1948-11-10,Delhi,India,1948,1,72,114,0,1,804,1710,13,732,1596,13,61.84615384615385,>30,IND,Home,Upto 2014
KL Hutchings,ENG,Pace,1908-01-10,Adelaide,Australia,1908,2,39,54,1,1,493,1139,20,454,1085,19,24.65,<=30,AUS,Away,Upto 2014
KL Hutchings,ENG,Pace,1908-02-07,Melbourne,Australia,1908,1,24,12,0,1,373,840,14,349,828,14,26.642857142857142,<=30,AUS,Away,Upto 2014
KL Hutchings,ENG,Pace,1909-08-09,The Oval,England,1909,1,18,24,0,1,457,871,15,439,847,15,30.466666666666665,>30,ENG,Home,Upto 2014
KLT Arthurton,WI,Spin,1989-03-25,Georgetown,West Indies,1989,1,8,18,0,1,322,618,6,314,600,6,53.666666666666664,>30,WI,Home,Upto 2014
KLT Arthurton,WI,Spin,1989-04-07,Bridgetown,West Indies,1989,1,0,6,0,1,380,726,8,380,720,8,47.5,>30,WI,Home,Upto 2014
KLT Arthurton,WI,Spin,1989-04-15,Port of Spain,West Indies,1989,1,4,24,0,1,406,1089,11,402,1065,11,36.90909090909091,>30,WI,Home,Upto 2014
KLT Arthurton,WI,Spin,1989-04-28,Kingston,West Indies,1989,1,26,36,0,1,262,519,4,236,483,4,65.5,>30,WI,Home,Upto 2014
KLT Arthurton,WI,Spin,1992-04-18,Bridgetown,West Indies,1992,1,8,18,0,1,67,179,4,59,161,4,16.75,<=30,WI,Home,Upto 2014
KLT Arthurton,WI,Spin,1992-11-27,Brisbane,Australia,1992,2,8,24,0,1,220,633,7,212,609,7,31.428571428571427,>30,AUS,Away,Upto 2014
KLT Arthurton,WI,Spin,1993-01-02,Sydney,Australia,1993,1,14,30,0,1,617,1258,8,603,1228,8,77.125,>30,AUS,Away,Upto 2014
KLT Arthurton,WI,Spin,1993-12-08,Moratuwa,Sri Lanka,1993,1,0,6,0,1,241,659,12,241,653,12,20.083333333333332,<=30,SL,Away,Upto 2014
KLT Arthurton,WI,Spin,1994-03-25,Port of Spain,West Indies,1994,1,5,18,0,1,162,288,3,157,270,3,54.0,>30,WI,Home,Upto 2014
KLT Arthurton,WI,Spin,1994-04-16,St John's,West Indies,1994,1,4,12,0,1,364,732,3,360,720,3,121.33333333333333,>30,WI,Home,Upto 2014
KLT Arthurton,WI,Spin,1995-02-03,Christchurch,New Zealand,1995,2,12,42,0,1,170,372,2,158,330,2,85.0,>30,NZ,Away,Upto 2014
KLT Arthurton,WI,Spin,1995-04-08,St John's,West Indies,1995,1,1,6,0,1,167,342,4,166,336,4,41.75,>30,WI,Home,Upto 2014
KLT Arthurton,WI,Spin,1995-04-29,Kingston,West Indies,1995,1,17,30,1,1,303,676,8,286,646,7,37.875,>30,WI,Home,Upto 2014
KLT Arthurton,WI,Spin,1995-07-27,Manchester,England,1995,2,23,71,0,1,271,569,5,248,498,5,54.2,>30,ENG,Away,Upto 2014
KLT Arthurton,WI,Spin,1995-08-10,Nottingham,England,1995,2,53,132,0,1,465,1032,7,412,900,7,66.42857142857143,>30,ENG,Away,Upto 2014
KM Dabengwa,ZIM,Spin,2005-08-15,Bulawayo,Zimbabwe,2005,1,87,150,2,1,320,589,7,233,439,5,45.714285714285715,>30,ZIM,Home,Upto 2014
KM Dabengwa,ZIM,Spin,2005-09-13,Bulawayo,Zimbabwe,2005,1,127,234,3,1,509,995,11,382,761,8,46.27272727272727,>30,ZIM,Home,Upto 2014
KM Dabengwa,ZIM,Spin,2005-09-20,Harare,Zimbabwe,2005,1,35,54,0,1,178,258,3,143,204,3,59.333333333333336,>30,ZIM,Home,Upto 2014
KM Jarvis,ZIM,Pace,2011-08-04,Harare,Zimbabwe,2011,2,128,195,5,1,850,1557,26,722,1362,21,32.69230769230769,>30,ZIM,Home,Upto 2014
KM Jarvis,ZIM,Pace,2011-09-01,Bulawayo,Zimbabwe,2011,2,96,174,2,1,539,1117,15,443,943,13,35.93333333333333,>30,ZIM,Home,Upto 2014
KM Jarvis,ZIM,Pace,2011-11-01,Bulawayo,Zimbabwe,2011,2,162,276,6,1,759,1445,23,597,1169,17,33.0,>30,ZIM,Home,Upto 2014
KM Jarvis,ZIM,Pace,2012-01-26,Napier,New Zealand,2012,1,120,196,1,1,497,972,21,377,776,20,23.666666666666668,<=30,NZ,Away,Upto 2014
KM Jarvis,ZIM,Pace,2013-03-12,Bridgetown,West Indies,2013,2,64,122,5,1,330,750,17,266,628,12,19.41176470588235,<=30,WI,Away,Upto 2014
KM Jarvis,ZIM,Pace,2013-03-20,Roseau,West Indies,2013,1,82,126,2,1,341,648,7,259,522,5,48.714285714285715,>30,WI,Away,Upto 2014
KM Jarvis,ZIM,Pace,2013-04-17,Harare,Zimbabwe,2013,2,115,198,7,1,550,1165,26,435,967,19,21.153846153846153,<=30,ZIM,Home,Upto 2014
KM Jarvis,ZIM,Pace,2013-04-25,Harare,Zimbabwe,2013,2,185,282,2,1,755,1568,25,570,1286,23,30.2,>30,ZIM,Home,Upto 2014
KM Jarvis,ZIM,Pace,2017-10-21,Bulawayo,Zimbabwe,2017,2,106,228,3,1,377,855,10,271,627,7,37.7,>30,ZIM,Home,After 1965
KM Jarvis,ZIM,Pace,2017-12-26,Gqeberha,South Africa,2017,1,57,108,3,1,327,664,21,270,556,18,15.571428571428571,<=30,SA,Away,After 1965
KM Jarvis,ZIM,Pace,2018-11-03,Sylhet,Bangladesh,2018,2,57,150,3,1,201,456,7,144,306,4,28.714285714285715,<=30,BAN,Away,After 1965
KM Jarvis,ZIM,Pace,2018-11-11,Mirpur,Bangladesh,2018,2,98,234,7,1,422,1002,13,324,768,6,32.46153846153846,>30,BAN,Away,After 1965
KM Jarvis,ZIM,Pace,2020-01-19,Harare,Zimbabwe,2020,1,84,222,0,1,521,1458,17,437,1236,17,30.647058823529413,>30,ZIM,Home,After 1965
KMA Paul,WI,Pace,2018-07-12,Kingston,West Indies,2018,2,59,96,3,1,360,661,22,301,565,19,16.363636363636363,<=30,WI,Home,After 1965
KMA Paul,WI,Pace,2018-10-04,Rajkot,India,2018,1,61,90,0,1,307,492,6,246,402,6,51.166666666666664,>30,IND,Away,After 1965
KMA Paul,WI,Pace,2019-02-09,Gros Islet,West Indies,2019,2,69,156,3,1,684,1370,27,615,1214,24,25.333333333333332,<=30,WI,Home,After 1965
KMDN Kulasekara,SL,Pace,2005-04-04,Napier,New Zealand,2005,2,89,216,1,1,832,1538,21,743,1322,20,39.61904761904762,>30,NZ,Away,Upto 2014
KMDN Kulasekara,SL,Pace,2006-04-03,Kandy,Sri Lanka,2006,2,79,168,3,1,524,943,20,445,775,17,26.2,<=30,SL,Home,Upto 2014
KMDN Kulasekara,SL,Pace,2006-05-11,Lord's,England,2006,1,89,150,0,1,982,1899,19,893,1749,19,51.68421052631579,>30,ENG,Away,Upto 2014
KMDN Kulasekara,SL,Pace,2006-05-25,Birmingham,England,2006,1,45,78,0,1,504,1093,20,459,1015,20,25.2,<=30,ENG,Away,Upto 2014
KMDN Kulasekara,SL,Pace,2008-07-23,Colombo (SSC),Sri Lanka,2008,2,67,120,1,1,421,648,5,354,528,4,84.2,>30,SL,Home,Upto 2014
KMDN Kulasekara,SL,Pace,2008-07-31,Galle,Sri Lanka,2008,2,71,78,0,1,302,510,9,231,432,9,33.55555555555556,>30,SL,Home,Upto 2014
KMDN Kulasekara,SL,Pace,2009-07-04,Galle,Sri Lanka,2009,2,96,186,4,1,560,942,21,464,756,17,26.666666666666668,<=30,SL,Home,Upto 2014
KMDN Kulasekara,SL,Pace,2009-07-12,Colombo (PSS),Sri Lanka,2009,2,58,172,8,1,365,700,17,307,528,9,21.470588235294116,<=30,SL,Home,Upto 2014
KMDN Kulasekara,SL,Pace,2009-07-20,Colombo (SSC),Sri Lanka,2009,2,102,216,5,1,669,1180,14,567,964,9,47.785714285714285,>30,SL,Home,Upto 2014
KMDN Kulasekara,SL,Pace,2009-08-18,Galle,Sri Lanka,2009,2,61,108,2,1,541,798,16,480,690,14,33.8125,>30,SL,Home,Upto 2014
KMDN Kulasekara,SL,Pace,2009-12-02,Brabourne,India,2009,1,105,120,1,1,532,750,10,427,630,9,53.2,>30,IND,Away,Upto 2014
KMDN Kulasekara,SL,Pace,2010-11-23,Colombo (RPS),Sri Lanka,2010,1,17,66,1,1,389,758,12,372,692,11,32.416666666666664,>30,SL,Home,Upto 2014
KMDN Kulasekara,SL,Pace,2012-06-22,Galle,Sri Lanka,2012,2,75,216,5,1,350,768,9,275,552,4,38.888888888888886,>30,SL,Home,Upto 2014
KMDN Kulasekara,SL,Pace,2012-06-30,Colombo (SSC),Sri Lanka,2012,2,107,192,0,1,504,822,6,397,630,6,84.0,>30,SL,Home,Upto 2014
KMDN Kulasekara,SL,Pace,2012-07-08,Pallekele,Sri Lanka,2012,2,109,264,3,1,780,1418,19,671,1154,16,41.05263157894737,>30,SL,Home,Upto 2014
KMDN Kulasekara,SL,Pace,2012-11-17,Galle,Sri Lanka,2012,2,59,149,4,1,371,706,14,312,557,10,26.5,<=30,SL,Home,Upto 2014
KMDN Kulasekara,SL,Pace,2012-11-25,Colombo (PSS),Sri Lanka,2012,2,123,216,3,1,530,1109,22,407,893,19,24.09090909090909,<=30,SL,Home,Upto 2014
KMDN Kulasekara,SL,Pace,2012-12-14,Hobart,Australia,2012,2,104,264,0,1,927,1883,26,823,1619,26,35.65384615384615,>30,AUS,Away,Upto 2014
KMDN Kulasekara,SL,Pace,2013-03-08,Galle,Sri Lanka,2013,2,100,186,2,1,420,696,6,320,510,4,70.0,>30,SL,Home,Upto 2014
KMDN Kulasekara,SL,Pace,2013-03-16,Colombo (RPS),Sri Lanka,2013,2,90,180,3,1,510,982,14,420,802,11,36.42857142857143,>30,SL,Home,Upto 2014
KMDN Kulasekara,SL,Pace,2014-06-12,Lord's,England,2014,2,148,222,2,1,1099,1996,30,951,1774,28,36.63333333333333,>30,ENG,Away,After 1965
KN Amalean,SL,Pace,1986-03-22,Colombo (PSS),Sri Lanka,1986,1,59,110,3,1,728,1538,20,669,1428,17,36.4,>30,SL,Home,Upto 2014
KN Amalean,SL,Pace,1988-02-12,W.A.C.A,Australia,1988,1,97,134,4,1,710,1536,29,613,1402,25,24.482758620689655,<=30,AUS,Away,Upto 2014
KN Peiris,SL,Spin,2024-09-26,Galle,Sri Lanka,2024,2,203,309,9,1,824,1411,22,621,1102,13,37.45454545454545,>30,SL,Home,After 1965
KN Peiris,SL,Spin,2025-01-29,Galle,Sri Lanka,2025,1,189,246,0,1,941,1397,23,752,1151,23,40.91304347826087,>30,SL,Home,After 1965
KN Slater,AUS,Spin,1959-01-09,Sydney,Australia,1959,2,101,256,2,1,574,1742,24,473,1486,22,23.916666666666668,<=30,AUS,Home,Upto 2014
KO Meth,ZIM,Pace,2013-04-17,Harare,Zimbabwe,2013,2,57,192,2,1,550,1165,26,493,973,24,21.153846153846153,<=30,ZIM,Home,Upto 2014
KO Meth,ZIM,Pace,2013-04-25,Harare,Zimbabwe,2013,1,41,132,2,1,755,1568,25,714,1436,23,30.2,>30,ZIM,Home,Upto 2014
KOA Powell,WI,Spin,2017-10-29,Bulawayo,Zimbabwe,2017,1,0,6,0,1,706,1640,15,706,1634,15,47.06666666666667,>30,ZIM,Away,After 1965
KP Pietersen,ENG,Spin,2006-06-02,Nottingham,England,2006,1,12,12,0,1,298,834,19,286,822,19,15.68421052631579,<=30,ENG,Home,Upto 2014
KP Pietersen,ENG,Spin,2006-07-13,Lord's,England,2006,2,30,42,1,1,515,1101,11,485,1059,10,46.81818181818182,>30,ENG,Home,Upto 2014
KP Pietersen,ENG,Spin,2006-07-27,Manchester,England,2006,1,11,12,0,1,286,568,10,275,556,10,28.6,<=30,ENG,Home,Upto 2014
KP Pietersen,ENG,Spin,2006-08-04,Leeds,England,2006,1,14,6,0,1,443,837,10,429,831,10,44.3,>30,ENG,Home,Upto 2014
KP Pietersen,ENG,Spin,2006-08-17,The Oval,England,2006,1,9,12,0,1,237,438,3,228,426,3,79.0,>30,ENG,Home,Upto 2014
KP Pietersen,ENG,Spin,2006-11-23,Brisbane,Australia,2006,2,42,72,0,1,304,510,5,262,438,5,60.8,>30,AUS,Away,Upto 2014
KP Pietersen,ENG,Spin,2006-12-01,Adelaide,Australia,2006,2,39,66,0,1,457,990,7,418,924,7,65.28571428571429,>30,AUS,Away,Upto 2014
KP Pietersen,ENG,Spin,2006-12-14,W.A.C.A,Australia,2006,1,31,30,0,1,460,746,15,429,716,15,30.666666666666668,>30,AUS,Away,Upto 2014
KP Pietersen,ENG,Spin,2006-12-26,Melbourne,Australia,2006,1,13,6,0,1,167,338,7,154,332,7,23.857142857142858,<=30,AUS,Away,Upto 2014
KP Pietersen,ENG,Spin,2007-06-07,Manchester,England,2007,1,17,30,0,1,304,603,11,287,573,11,27.636363636363637,<=30,ENG,Home,Upto 2014
KP Pietersen,ENG,Spin,2007-06-15,Chester-le-Street,England,2007,1,3,12,0,1,166,317,7,163,305,7,23.714285714285715,<=30,ENG,Home,Upto 2014
KP Pietersen,ENG,Spin,2007-08-09,The Oval,England,2007,1,41,36,1,1,584,973,9,543,937,8,64.88888888888889,>30,ENG,Home,Upto 2014
KP Pietersen,ENG,Spin,2007-12-09,Colombo (SSC),Sri Lanka,2007,1,57,90,0,1,447,920,9,390,830,9,49.666666666666664,>30,SL,Away,Upto 2014
KP Pietersen,ENG,Spin,2007-12-18,Galle,Sri Lanka,2007,1,11,18,0,1,195,456,4,184,438,4,48.75,>30,SL,Away,Upto 2014
KP Pietersen,ENG,Spin,2008-03-05,Hamilton,New Zealand,2008,1,11,18,1,1,412,1080,12,401,1062,11,34.333333333333336,>30,NZ,Away,Upto 2014
KP Pietersen,ENG,Spin,2008-03-13,Wellington,New Zealand,2008,1,3,6,0,1,128,279,1,125,273,1,128.0,>30,NZ,Away,Upto 2014
KP Pietersen,ENG,Spin,2008-03-22,Napier,New Zealand,2008,1,14,12,0,1,490,971,14,476,959,14,35.0,>30,NZ,Away,Upto 2014
KP Pietersen,ENG,Spin,2008-05-15,Lord's,England,2008,1,21,30,0,1,176,375,7,155,345,7,25.142857142857142,<=30,ENG,Home,Upto 2014
KP Pietersen,ENG,Spin,2008-07-10,Lord's,England,2008,2,21,45,1,1,341,797,8,320,752,7,42.625,>30,ENG,Home,Upto 2014
KP Pietersen,ENG,Spin,2008-07-18,Leeds,England,2008,1,14,24,0,1,114,290,3,100,266,3,38.0,>30,ENG,Home,Upto 2014
KP Pietersen,ENG,Spin,2008-07-30,Birmingham,England,2008,1,16,24,0,1,217,456,4,201,432,4,54.25,>30,ENG,Home,Upto 2014
KP Pietersen,ENG,Spin,2008-08-07,The Oval,England,2008,1,1,6,0,1,131,334,7,130,328,7,18.714285714285715,<=30,ENG,Home,Upto 2014
KP Pietersen,ENG,Spin,2009-02-04,Kingston,West Indies,2009,1,15,24,0,1,286,814,10,271,790,10,28.6,<=30,WI,Away,Upto 2014
KP Pietersen,ENG,Spin,2009-02-15,St John's,West Indies,2009,2,29,30,0,1,563,1022,15,534,992,15,37.53333333333333,>30,WI,Away,Upto 2014
KP Pietersen,ENG,Spin,2009-02-26,Bridgetown,West Indies,2009,1,38,54,0,1,611,1066,8,573,1012,8,76.375,>30,WI,Away,Upto 2014
KP Pietersen,ENG,Spin,2009-03-06,Port of Spain,West Indies,2009,1,5,18,0,1,578,1262,14,573,1244,14,41.285714285714285,>30,WI,Away,Upto 2014
KP Pietersen,ENG,Spin,2009-12-26,Durban,South Africa,2009,1,7,12,0,1,406,720,13,399,708,13,31.23076923076923,>30,SA,Away,Upto 2014
KP Pietersen,ENG,Spin,2010-01-03,Cape Town,South Africa,2010,2,23,42,0,1,394,792,10,371,750,10,39.4,>30,SA,Away,Upto 2014
KP Pietersen,ENG,Spin,2010-03-12,Chattogram,Bangladesh,2010,2,18,48,0,1,894,1491,22,876,1443,22,40.63636363636363,>30,BAN,Away,Upto 2014
KP Pietersen,ENG,Spin,2010-08-06,Birmingham,England,2010,1,2,6,0,1,211,502,11,209,496,11,19.181818181818183,<=30,ENG,Home,Upto 2014
KP Pietersen,ENG,Spin,2010-11-25,Brisbane,Australia,2010,1,6,12,0,1,363,731,5,357,719,5,72.6,>30,AUS,Away,Upto 2014
KP Pietersen,ENG,Spin,2010-12-03,Adelaide,Australia,2010,1,10,18,1,1,391,709,9,381,691,8,43.44444444444444,>30,AUS,Away,Upto 2014
KP Pietersen,ENG,Spin,2011-05-26,Cardiff,England,2011,1,3,6,0,1,338,682,10,335,676,10,33.8,>30,ENG,Home,Upto 2014
KP Pietersen,ENG,Spin,2011-06-03,Lord's,England,2011,2,14,30,0,1,315,597,8,301,567,8,39.375,>30,ENG,Home,Upto 2014
KP Pietersen,ENG,Spin,2011-06-16,Southampton,England,2011,1,30,42,0,1,132,258,2,102,216,2,66.0,>30,ENG,Home,Upto 2014
KP Pietersen,ENG,Spin,2011-07-21,Lord's,England,2011,2,15,24,0,1,415,658,4,400,634,4,103.75,>30,ENG,Home,Upto 2014
KP Pietersen,ENG,Spin,2011-07-29,Nottingham,England,2011,2,20,30,0,1,280,322,2,260,292,2,140.0,>30,ENG,Home,Upto 2014
KP Pietersen,ENG,Spin,2011-08-10,Birmingham,England,2011,1,12,12,0,1,372,564,6,360,552,6,62.0,>30,ENG,Home,Upto 2014
KP Pietersen,ENG,Spin,2011-08-18,The Oval,England,2011,2,44,54,0,1,491,822,11,447,768,11,44.63636363636363,>30,ENG,Home,Upto 2014
KP Pietersen,ENG,Spin,2012-02-03,Dubai (DICS),UAE,2012,1,9,18,0,1,528,1381,25,519,1363,25,21.12,<=30,UAE,Away,Upto 2014
KP Pietersen,ENG,Spin,2012-04-03,Colombo (PSS),Sri Lanka,2012,2,22,36,0,1,698,1454,22,676,1418,22,31.727272727272727,>30,SL,Away,Upto 2014
KP Pietersen,ENG,Spin,2012-07-19,The Oval,England,2012,1,13,18,0,1,301,684,4,288,666,4,75.25,>30,ENG,Home,Upto 2014
KP Pietersen,ENG,Spin,2012-08-02,Leeds,England,2012,2,78,96,4,1,205,280,8,127,184,4,25.625,<=30,ENG,Home,Upto 2014
KP Pietersen,ENG,Spin,2012-11-15,Ahmedabad,India,2012,1,25,48,1,1,729,1559,21,704,1511,20,34.714285714285715,>30,IND,Away,Upto 2014
KP Pietersen,ENG,Spin,2014-01-03,Sydney,Australia,2014,1,17,24,0,1,226,246,7,209,222,7,32.285714285714285,>30,AUS,Away,After 1965
KP Walmsley,NZ,Pace,1995-03-11,Napier,New Zealand,1995,2,182,330,4,1,717,1794,34,535,1464,30,21.08823529411765,<=30,NZ,Home,Upto 2014
KP Walmsley,NZ,Pace,1995-03-18,Dunedin,New Zealand,1995,2,162,336,3,1,657,1600,18,495,1264,15,36.5,>30,NZ,Home,Upto 2014
KP Walmsley,NZ,Pace,2000-11-30,Gqeberha,South Africa,2000,2,47,108,2,1,698,1864,30,651,1756,28,23.266666666666666,<=30,SA,Away,Upto 2014
KPJ Warnaweera,SL,Spin,1986-02-23,Kandy,Sri Lanka,1986,1,26,51,1,1,188,445,14,162,394,13,13.428571428571429,<=30,SL,Home,Upto 2014
KPJ Warnaweera,SL,Spin,1990-11-23,Chandigarh,India,1990,1,90,276,3,1,286,1097,16,196,821,13,17.875,<=30,IND,Away,Upto 2014
KPJ Warnaweera,SL,Spin,1991-01-31,Wellington,New Zealand,1991,2,89,240,0,1,378,792,0,289,552,0,inf,>30,NZ,Away,Upto 2014
KPJ Warnaweera,SL,Spin,1992-11-27,Moratuwa,Sri Lanka,1992,2,77,354,3,1,176,750,7,99,396,4,25.142857142857142,<=30,SL,Home,Upto 2014
KPJ Warnaweera,SL,Spin,1992-12-06,Colombo (SSC),Sri Lanka,1992,2,132,288,6,1,505,1022,18,373,734,12,28.055555555555557,<=30,SL,Home,Upto 2014
KPJ Warnaweera,SL,Spin,1993-03-13,Colombo (SSC),Sri Lanka,1993,2,188,391,8,1,805,1517,22,617,1126,14,36.59090909090909,>30,SL,Home,Upto 2014
KPJ Warnaweera,SL,Spin,1993-07-27,Colombo (SSC),Sri Lanka,1993,2,162,241,4,1,544,1136,16,382,895,12,34.0,>30,SL,Home,Upto 2014
KPJ Warnaweera,SL,Spin,1993-08-04,Colombo (PSS),Sri Lanka,1993,1,86,138,2,1,715,1623,16,629,1485,14,44.6875,>30,SL,Home,Upto 2014
KPJ Warnaweera,SL,Spin,1994-08-09,Colombo (PSS),Sri Lanka,1994,2,171,354,5,1,791,1520,23,620,1166,18,34.391304347826086,>30,SL,Home,Upto 2014
KR Mayers,WI,Pace,2021-02-03,Chattogram,Bangladesh,2021,2,27,48,0,1,327,606,6,300,558,6,54.5,>30,BAN,Away,After 1965
KR Mayers,WI,Pace,2021-02-11,Mirpur,Bangladesh,2021,1,15,48,0,1,347,599,12,332,551,12,28.916666666666668,<=30,BAN,Away,After 1965
KR Mayers,WI,Pace,2021-03-21,North Sound,West Indies,2021,2,30,66,2,1,742,1672,25,712,1606,23,29.68,<=30,WI,Home,After 1965
KR Mayers,WI,Pace,2021-03-29,North Sound,West Indies,2021,2,15,102,2,1,742,1513,23,727,1411,21,32.26086956521739,>30,WI,Home,After 1965
KR Mayers,WI,Pace,2021-06-10,Gros Islet,West Indies,2021,1,28,48,0,1,458,958,27,430,910,27,16.962962962962962,<=30,WI,Home,After 1965
KR Mayers,WI,Pace,2021-06-18,Gros Islet,West Indies,2021,2,52,144,6,1,606,1318,31,554,1174,25,19.548387096774192,<=30,WI,Home,After 1965
KR Mayers,WI,Pace,2021-08-12,Kingston,West Indies,2021,2,61,174,2,1,661,1558,37,600,1384,35,17.864864864864863,<=30,WI,Home,After 1965
KR Mayers,WI,Pace,2021-08-20,Kingston,West Indies,2021,2,77,144,1,1,688,1393,29,611,1249,28,23.724137931034484,<=30,WI,Home,After 1965
KR Mayers,WI,Pace,2021-11-21,Galle,Sri Lanka,2021,1,9,18,0,1,180,408,3,171,390,3,60.0,>30,SL,Away,After 1965
KR Mayers,WI,Pace,2021-11-29,Galle,Sri Lanka,2021,1,13,12,0,1,123,256,1,110,244,1,123.0,>30,SL,Away,After 1965
KR Mayers,WI,Pace,2022-03-24,St George's,West Indies,2022,2,31,162,7,1,518,1435,27,487,1273,20,19.185185185185187,<=30,WI,Home,After 1965
KR Mayers,WI,Pace,2022-06-16,North Sound,West Indies,2022,2,40,108,4,1,515,1150,28,475,1042,24,18.392857142857142,<=30,WI,Home,After 1965
KR Mayers,WI,Pace,2022-06-24,Gros Islet,West Indies,2022,2,56,78,2,1,658,1090,26,602,1012,24,25.307692307692307,<=30,WI,Home,After 1965
KR Mayers,WI,Pace,2022-11-30,Perth,Australia,2022,1,39,90,1,1,842,1610,13,803,1520,12,64.76923076923077,>30,AUS,Away,After 1965
KR Mayers,WI,Pace,2023-02-04,Bulawayo,Zimbabwe,2023,2,28,66,0,1,562,1122,8,534,1056,8,70.25,>30,ZIM,Away,After 1965
KR Mayers,WI,Pace,2023-02-28,Centurion,South Africa,2023,1,23,60,1,1,738,1209,39,715,1149,38,18.923076923076923,<=30,SA,Away,After 1965
KR Mayers,WI,Pace,2023-03-08,Johannesburg,South Africa,2023,2,78,156,6,1,575,1146,28,497,990,22,20.535714285714285,<=30,SA,Away,After 1965
KR Miller,AUS,Pace,1946-03-29,Wellington,New Zealand,1946,1,6,36,2,1,212,690,16,206,654,14,13.25,<=30,NZ,Away,Upto 2014
KR Miller,AUS,Pace,1946-11-29,Brisbane,Australia,1946,2,77,264,9,1,604,1516,23,527,1252,14,26.26086956521739,<=30,AUS,Home,Upto 2014
KR Miller,AUS,Pace,1946-12-13,Sydney,Australia,1946,2,61,160,1,1,412,1072,9,351,912,8,45.77777777777778,>30,AUS,Home,Upto 2014
KR Miller,AUS,Pace,1947-01-01,Melbourne,Australia,1947,2,75,168,2,1,922,1990,21,847,1822,19,43.904761904761905,>30,AUS,Home,Upto 2014
KR Miller,AUS,Pace,1947-01-31,Adelaide,Australia,1947,2,79,216,2,1,774,1993,20,695,1777,18,38.7,>30,AUS,Home,Upto 2014
KR Miller,AUS,Pace,1947-02-28,Sydney,Australia,1947,2,42,171,2,1,392,1131,16,350,960,14,24.5,<=30,AUS,Home,Upto 2014
KR Miller,AUS,Pace,1947-11-28,Brisbane,Australia,1947,2,56,128,2,1,345,994,21,289,866,19,16.428571428571427,<=30,AUS,Home,Upto 2014
KR Miller,AUS,Pace,1947-12-12,Sydney,Australia,1947,2,30,120,3,1,133,474,10,103,354,7,13.3,<=30,AUS,Home,Upto 2014
KR Miller,AUS,Pace,1948-01-01,Melbourne,Australia,1948,2,75,160,1,1,380,833,9,305,673,8,42.22222222222222,>30,AUS,Home,Upto 2014
KR Miller,AUS,Pace,1948-01-23,Adelaide,Australia,1948,2,52,144,3,1,583,1360,19,531,1216,16,30.68421052631579,>30,AUS,Home,Upto 2014
KR Miller,AUS,Pace,1948-02-06,Melbourne,Australia,1948,1,10,24,0,1,469,1146,14,459,1122,14,33.5,>30,AUS,Home,Upto 2014
KR Miller,AUS,Pace,1948-06-10,Nottingham,England,1948,2,163,378,7,1,600,1427,17,437,1049,10,35.294117647058826,>30,ENG,Away,Upto 2014
KR Miller,AUS,Pace,1948-07-08,Manchester,England,1948,1,15,84,0,1,513,1476,16,498,1392,16,32.0625,>30,ENG,Away,Upto 2014
KR Miller,AUS,Pace,1948-07-22,Leeds,England,1948,2,96,229,2,1,942,2038,19,846,1809,17,49.578947368421055,>30,ENG,Away,Upto 2014
KR Miller,AUS,Pace,1948-08-14,The Oval,England,1948,2,27,138,4,1,239,753,15,212,615,11,15.933333333333334,<=30,ENG,Away,Upto 2014
KR Miller,AUS,Pace,1949-12-24,Johannesburg,South Africa,1949,2,67,208,5,1,273,736,9,206,528,4,30.333333333333332,>30,SA,Away,Upto 2014
KR Miller,AUS,Pace,1949-12-31,Cape Town,South Africa,1949,2,97,224,3,1,378,860,10,281,636,7,37.8,>30,SA,Away,Upto 2014
KR Miller,AUS,Pace,1950-01-20,Durban,South Africa,1950,2,85,248,1,1,229,704,5,144,456,4,45.8,>30,SA,Away,Upto 2014
KR Miller,AUS,Pace,1950-02-10,Johannesburg,South Africa,1950,1,75,224,3,1,524,1232,15,449,1008,12,34.93333333333333,>30,SA,Away,Upto 2014
KR Miller,AUS,Pace,1950-03-03,Gqeberha,South Africa,1950,2,66,176,5,1,363,833,11,297,657,6,33.0,>30,SA,Away,Upto 2014
KR Miller,AUS,Pace,1950-12-01,Brisbane,Australia,1950,2,50,136,3,1,176,538,19,126,402,16,9.263157894736842,<=30,AUS,Home,Upto 2014
KR Miller,AUS,Pace,1950-12-22,Melbourne,Australia,1950,2,55,144,2,1,311,916,19,256,772,17,16.36842105263158,<=30,AUS,Home,Upto 2014
KR Miller,AUS,Pace,1951-01-05,Sydney,Australia,1951,2,52,175,4,1,385,1007,10,333,832,6,38.5,>30,AUS,Home,Upto 2014
KR Miller,AUS,Pace,1951-02-02,Adelaide,Australia,1951,2,63,208,4,1,424,1099,11,361,891,7,38.54545454545455,>30,AUS,Home,Upto 2014
KR Miller,AUS,Pace,1951-02-23,Melbourne,Australia,1951,2,81,191,4,1,340,912,18,259,721,14,18.88888888888889,<=30,AUS,Home,Upto 2014
KR Miller,AUS,Pace,1951-11-09,Brisbane,Australia,1951,2,59,176,2,1,179,501,9,120,325,7,19.88888888888889,<=30,AUS,Home,Upto 2014
KR Miller,AUS,Pace,1951-11-30,Sydney,Australia,1951,2,122,274,3,1,387,1058,13,265,784,10,29.76923076923077,<=30,AUS,Home,Upto 2014
KR Miller,AUS,Pace,1951-12-22,Adelaide,Australia,1951,2,25,80,1,1,142,445,7,117,365,6,20.285714285714285,<=30,AUS,Home,Upto 2014
KR Miller,AUS,Pace,1951-12-31,Melbourne,Australia,1951,2,109,283,7,1,342,918,16,233,635,9,21.375,<=30,AUS,Home,Upto 2014
KR Miller,AUS,Pace,1952-01-25,Sydney,Australia,1952,2,83,214,7,1,268,736,24,185,522,17,11.166666666666666,<=30,AUS,Home,Upto 2014
KR Miller,AUS,Pace,1952-12-05,Brisbane,Australia,1952,1,46,80,1,1,408,1189,22,362,1109,21,18.545454545454547,<=30,AUS,Home,Upto 2014
KR Miller,AUS,Pace,1952-12-24,Melbourne,Australia,1952,2,113,344,7,1,390,1037,14,277,693,7,27.857142857142858,<=30,AUS,Home,Upto 2014
KR Miller,AUS,Pace,1953-01-09,Sydney,Australia,1953,2,81,280,5,1,307,834,15,226,554,10,20.466666666666665,<=30,AUS,Home,Upto 2014
KR Miller,AUS,Pace,1953-01-24,Adelaide,Australia,1953,1,1,17,0,1,427,785,5,426,768,5,85.4,>30,AUS,Home,Upto 2014
KR Miller,AUS,Pace,1953-06-25,Lord's,England,1953,2,74,252,1,1,553,1514,19,479,1262,18,29.105263157894736,<=30,ENG,Away,Upto 2014
KR Miller,AUS,Pace,1953-07-09,Manchester,England,1953,1,38,144,1,1,352,924,14,314,780,13,25.142857142857142,<=30,ENG,Away,Upto 2014
KR Miller,AUS,Pace,1953-07-23,Leeds,England,1953,2,102,450,6,1,617,1986,30,515,1536,24,20.566666666666666,<=30,ENG,Away,Upto 2014
KR Miller,AUS,Pace,1953-08-15,The Oval,England,1953,2,89,270,2,1,504,1206,15,415,936,13,33.6,>30,ENG,Away,Upto 2014
KR Miller,AUS,Pace,1954-11-26,Brisbane,Australia,1954,2,49,184,2,1,750,1616,15,701,1432,13,50.0,>30,AUS,Home,Upto 2014
KR Miller,AUS,Pace,1954-12-31,Melbourne,Australia,1954,2,49,232,4,1,538,1484,30,489,1252,26,17.933333333333334,<=30,AUS,Home,Upto 2014
KR Miller,AUS,Pace,1955-01-28,Adelaide,Australia,1955,2,74,172,4,1,511,1397,23,437,1225,19,22.217391304347824,<=30,AUS,Home,Upto 2014
KR Miller,AUS,Pace,1955-02-25,Sydney,Australia,1955,1,71,120,0,1,382,806,7,311,686,7,54.57142857142857,>30,AUS,Home,Upto 2014
KR Miller,AUS,Pace,1955-03-26,Kingston,West Indies,1955,2,98,264,5,1,487,1027,18,389,763,13,27.055555555555557,<=30,WI,Away,Upto 2014
KR Miller,AUS,Pace,1955-04-11,Port of Spain,West Indies,1955,2,148,234,1,1,686,1163,14,538,929,13,49.0,>30,WI,Away,Upto 2014
KR Miller,AUS,Pace,1955-04-26,Georgetown,West Indies,1955,2,51,108,3,1,285,510,7,234,402,4,40.714285714285715,>30,WI,Away,Upto 2014
KR Miller,AUS,Pace,1955-05-14,Bridgetown,West Indies,1955,2,179,258,3,1,574,1002,10,395,744,7,57.4,>30,WI,Away,Upto 2014
KR Miller,AUS,Pace,1955-06-11,Kingston,West Indies,1955,2,165,266,8,1,633,1010,16,468,744,8,39.5625,>30,WI,Away,Upto 2014
KR Miller,AUS,Pace,1956-06-07,Nottingham,England,1956,2,127,312,6,1,363,976,12,236,664,6,30.25,>30,ENG,Away,Upto 2014
KR Miller,AUS,Pace,1956-06-21,Lord's,England,1956,2,152,421,10,1,698,1897,33,546,1476,23,21.151515151515152,<=30,ENG,Away,Upto 2014
KR Miller,AUS,Pace,1956-07-26,Manchester,England,1956,1,41,126,0,1,233,663,3,192,537,3,77.66666666666667,>30,ENG,Away,Upto 2014
KR Miller,AUS,Pace,1956-08-23,The Oval,England,1956,2,147,372,5,1,409,1082,18,262,710,13,22.72222222222222,<=30,ENG,Away,Upto 2014
KR Miller,AUS,Pace,1956-10-11,Karachi,Pakistan,1956,2,58,174,2,1,382,1421,26,324,1247,24,14.692307692307692,<=30,PAK,Away,Upto 2014
KR Pushpakumara,SL,Pace,1994-08-26,Kandy,Sri Lanka,1994,1,145,156,4,1,485,782,21,340,626,17,23.095238095238095,<=30,SL,Home,Upto 2014
KR Pushpakumara,SL,Pace,1994-10-11,Harare,Zimbabwe,1994,1,68,120,1,1,445,1241,16,377,1121,15,27.8125,<=30,ZIM,Away,Upto 2014
KR Pushpakumara,SL,Pace,1994-10-26,Harare,Zimbabwe,1994,1,116,214,7,1,659,1576,19,543,1362,12,34.68421052631579,>30,ZIM,Away,Upto 2014
KR Pushpakumara,SL,Pace,1995-03-11,Napier,New Zealand,1995,2,42,84,2,1,717,1794,34,675,1710,32,21.08823529411765,<=30,NZ,Away,Upto 2014
KR Pushpakumara,SL,Pace,1995-03-18,Dunedin,New Zealand,1995,1,42,96,0,1,657,1600,18,615,1504,18,36.5,>30,NZ,Away,Upto 2014
KR Pushpakumara,SL,Pace,1995-09-08,Peshawar,Pakistan,1995,1,89,102,0,1,562,1039,16,473,937,16,35.125,>30,PAK,Away,Upto 2014
KR Pushpakumara,SL,Pace,1996-01-25,Adelaide,Australia,1996,2,189,306,4,1,886,1812,32,697,1506,28,27.6875,<=30,AUS,Away,Upto 2014
KR Pushpakumara,SL,Pace,1996-09-18,Colombo (SSC),Sri Lanka,1996,2,58,114,2,1,332,732,8,274,618,6,41.5,>30,SL,Home,Upto 2014
KR Pushpakumara,SL,Pace,1997-06-13,St John's,West Indies,1997,2,100,138,3,1,500,775,20,400,637,17,25.0,<=30,WI,Away,Upto 2014
KR Pushpakumara,SL,Pace,1997-06-20,Kingstown,West Indies,1997,2,122,190,7,1,630,1024,21,508,834,14,30.0,<=30,WI,Away,Upto 2014
KR Pushpakumara,SL,Pace,1997-08-02,Colombo (RPS),Sri Lanka,1997,1,97,117,2,1,398,549,5,301,432,3,79.6,>30,SL,Home,Upto 2014
KR Pushpakumara,SL,Pace,1997-08-09,Colombo (SSC),Sri Lanka,1997,2,129,198,1,1,927,1577,19,798,1379,18,48.78947368421053,>30,SL,Home,Upto 2014
KR Pushpakumara,SL,Pace,1997-11-26,Nagpur,India,1997,1,122,192,5,1,210,384,7,88,192,2,30.0,<=30,IND,Away,Upto 2014
KR Pushpakumara,SL,Pace,1997-12-03,Wankhede,India,1997,2,136,198,3,1,639,1269,12,503,1071,9,53.25,>30,IND,Away,Upto 2014
KR Pushpakumara,SL,Pace,1998-01-07,Kandy,Sri Lanka,1998,2,98,198,2,1,383,839,8,285,641,6,47.875,>30,SL,Home,Upto 2014
KR Pushpakumara,SL,Pace,1998-01-14,Colombo (SSC),Sri Lanka,1998,2,97,176,3,1,369,728,14,272,552,11,26.357142857142858,<=30,SL,Home,Upto 2014
KR Pushpakumara,SL,Pace,1998-03-19,Cape Town,South Africa,1998,2,105,168,0,1,757,1378,22,652,1210,22,34.40909090909091,>30,SA,Away,Upto 2014
KR Pushpakumara,SL,Pace,1998-03-27,Centurion,South Africa,1998,2,82,138,1,1,463,1134,19,381,996,18,24.36842105263158,<=30,SA,Away,Upto 2014
KR Pushpakumara,SL,Pace,1999-12-04,Harare,Zimbabwe,1999,2,95,276,5,1,525,1358,25,430,1082,20,21.0,<=30,ZIM,Away,Upto 2014
KR Pushpakumara,SL,Pace,2000-03-05,Peshawar,Pakistan,2000,2,67,126,0,1,480,1060,20,413,934,20,24.0,<=30,PAK,Away,Upto 2014
KR Pushpakumara,SL,Pace,2000-03-12,Karachi,Pakistan,2000,2,103,221,5,1,750,1272,22,647,1051,17,34.09090909090909,>30,PAK,Away,Upto 2014
KR Pushpakumara,SL,Pace,2000-06-21,Galle,Sri Lanka,2000,1,116,174,1,1,578,1128,20,462,954,19,28.9,<=30,SL,Home,Upto 2014
KR Pushpakumara,SL,Pace,2001-09-06,Colombo (SSC),Sri Lanka,2001,2,24,90,0,1,535,726,8,511,636,8,66.875,>30,SL,Home,Upto 2014
KR Rutherford,NZ,Pace,1985-04-06,Georgetown,West Indies,1985,1,38,54,1,1,825,1600,20,787,1546,19,41.25,>30,WI,Away,Upto 2014
KR Rutherford,NZ,Pace,1985-04-26,Bridgetown,West Indies,1985,1,10,4,0,1,558,1140,29,548,1136,29,19.24137931034483,<=30,WI,Away,Upto 2014
KR Rutherford,NZ,Pace,1986-07-24,Lord's,England,1986,1,8,18,0,1,599,1428,17,591,1410,17,35.23529411764706,>30,ENG,Away,Upto 2014
KR Rutherford,NZ,Pace,1988-02-25,Auckland,New Zealand,1988,1,8,30,0,1,724,1989,22,716,1959,22,32.90909090909091,>30,NZ,Home,Upto 2014
KR Rutherford,NZ,Pace,1988-03-03,Wellington,New Zealand,1988,1,1,6,0,1,376,817,5,375,811,5,75.2,>30,NZ,Home,Upto 2014
KR Rutherford,NZ,Pace,1990-02-02,Christchurch,New Zealand,1990,1,21,30,0,1,683,1242,22,662,1212,22,31.045454545454547,>30,NZ,Home,Upto 2014
KR Rutherford,NZ,Pace,1990-02-09,Napier,New Zealand,1990,1,28,54,0,1,406,996,10,378,942,10,40.6,>30,NZ,Home,Upto 2014
KR Rutherford,NZ,Pace,1990-02-22,Auckland,New Zealand,1990,1,10,18,0,1,1075,1694,19,1065,1676,19,56.578947368421055,>30,NZ,Home,Upto 2014
KR Rutherford,NZ,Pace,1990-03-15,Wellington,New Zealand,1990,1,8,12,0,1,504,1412,21,496,1400,21,24.0,<=30,NZ,Home,Upto 2014
KR Rutherford,NZ,Pace,1990-06-21,Lord's,England,1990,1,18,18,0,1,748,1364,15,730,1346,15,49.86666666666667,>30,ENG,Away,Upto 2014
KR Rutherford,NZ,Pace,1991-01-31,Wellington,New Zealand,1991,1,11,12,0,1,940,1788,23,929,1776,23,40.869565217391305,>30,NZ,Home,Upto 2014
KR Stackpole,AUS,Spin,1966-01-28,Adelaide,Australia,1966,2,63,152,2,1,423,991,7,360,839,5,60.42857142857143,>30,AUS,Home,Upto 2014
KR Stackpole,AUS,Spin,1966-02-11,Melbourne,Australia,1966,2,53,104,0,1,369,880,3,316,776,3,123.0,>30,AUS,Home,Upto 2014
KR Stackpole,AUS,Spin,1966-12-23,Johannesburg,South Africa,1966,1,75,126,1,1,549,1041,11,474,915,10,49.90909090909091,>30,SA,Away,Upto 2014
KR Stackpole,AUS,Spin,1966-12-31,Cape Town,South Africa,1966,2,47,132,0,1,643,1501,10,596,1369,10,64.3,>30,SA,Away,Upto 2014
KR Stackpole,AUS,Spin,1967-01-20,Durban,South Africa,1967,1,8,12,0,1,209,570,4,201,558,4,52.25,>30,SA,Away,Upto 2014
KR Stackpole,AUS,Spin,1968-12-06,Brisbane,Australia,1968,2,66,128,0,1,799,2162,28,733,2034,28,28.535714285714285,<=30,AUS,Home,Upto 2014
KR Stackpole,AUS,Spin,1968-12-26,Melbourne,Australia,1968,2,31,112,1,1,459,1287,15,428,1175,14,30.6,>30,AUS,Home,Upto 2014
KR Stackpole,AUS,Spin,1969-01-03,Sydney,Australia,1969,2,40,72,1,1,463,1006,8,423,934,7,57.875,>30,AUS,Home,Upto 2014
KR Stackpole,AUS,Spin,1969-01-24,Adelaide,Australia,1969,2,57,120,0,1,1020,2021,15,963,1901,15,68.0,>30,AUS,Home,Upto 2014
KR Stackpole,AUS,Spin,1969-02-14,Sydney,Australia,1969,1,57,56,2,1,776,1562,17,719,1506,15,45.64705882352941,>30,AUS,Home,Upto 2014
KR Stackpole,AUS,Spin,1969-11-04,Brabourne,India,1969,2,8,26,1,1,483,1714,20,475,1688,19,24.15,<=30,IND,Away,Upto 2014
KR Stackpole,AUS,Spin,1969-11-15,Kanpur,India,1969,2,25,54,1,1,657,2057,13,632,2003,12,50.53846153846154,>30,IND,Away,Upto 2014
KR Stackpole,AUS,Spin,1969-11-28,Delhi,India,1969,2,36,108,1,1,604,1737,30,568,1629,29,20.133333333333333,<=30,IND,Away,Upto 2014
KR Stackpole,AUS,Spin,1969-12-12,Eden Gardens,India,1969,1,9,12,0,1,380,1033,12,371,1021,12,31.666666666666668,>30,IND,Away,Upto 2014
KR Stackpole,AUS,Spin,1969-12-24,Chennai,India,1969,1,14,30,0,1,490,1347,28,476,1317,28,17.5,<=30,IND,Away,Upto 2014
KR Stackpole,AUS,Spin,1970-02-05,Durban,South Africa,1970,1,75,126,2,1,348,698,8,273,572,6,43.5,>30,SA,Away,Upto 2014
KR Stackpole,AUS,Spin,1970-11-27,Brisbane,Australia,1970,2,13,64,0,1,461,1342,10,448,1278,10,46.1,>30,AUS,Home,Upto 2014
KR Stackpole,AUS,Spin,1970-12-11,W.A.C.A,Australia,1970,2,76,208,1,1,317,920,6,241,712,5,52.833333333333336,>30,AUS,Home,Upto 2014
KR Stackpole,AUS,Spin,1971-01-09,Sydney,Australia,1971,2,48,104,0,1,467,1239,15,419,1135,15,31.133333333333333,>30,AUS,Home,Upto 2014
KR Stackpole,AUS,Spin,1971-01-21,Melbourne,Australia,1971,2,69,245,1,1,448,1245,9,379,1000,8,49.77777777777778,>30,AUS,Home,Upto 2014
KR Stackpole,AUS,Spin,1971-01-29,Adelaide,Australia,1971,1,47,96,0,1,449,1176,4,402,1080,4,112.25,>30,AUS,Home,Upto 2014
KR Stackpole,AUS,Spin,1971-02-12,Sydney,Australia,1971,1,8,24,0,1,385,1254,19,377,1230,19,20.263157894736842,<=30,AUS,Home,Upto 2014
KR Stackpole,AUS,Spin,1972-07-13,Nottingham,England,1972,1,35,102,0,1,374,904,5,339,802,5,74.8,>30,ENG,Away,Upto 2014
KR Stackpole,AUS,Spin,1973-03-09,Bridgetown,West Indies,1973,1,6,30,0,1,470,1314,10,464,1284,10,47.0,>30,WI,Away,Upto 2014
KR Stackpole,AUS,Spin,1973-03-23,Port of Spain,West Indies,1973,2,35,78,1,1,758,1913,26,723,1835,25,29.153846153846153,<=30,WI,Away,Upto 2014
KS Duleepsinhji,ENG,Spin,1929-06-15,Birmingham,England,1929,1,7,6,0,1,416,1126,6,409,1120,6,69.33333333333333,>30,ENG,Home,Upto 2014
KS Lokuarachchi,SL,Spin,2003-04-25,Colombo (PSS),Sri Lanka,2003,2,130,222,2,1,714,1571,15,584,1349,13,47.6,>30,SL,Home,Upto 2014
KS Lokuarachchi,SL,Spin,2003-05-03,Kandy,Sri Lanka,2003,2,78,180,2,1,468,1155,15,390,975,13,31.2,>30,SL,Home,Upto 2014
KS Lokuarachchi,SL,Spin,2003-06-20,Gros Islet,West Indies,2003,1,54,120,1,1,398,848,9,344,728,8,44.22222222222222,>30,WI,Away,Upto 2014
KS Lokuarachchi,SL,Spin,2004-03-16,Kandy,Sri Lanka,2004,1,33,72,0,1,537,881,19,504,809,19,28.263157894736842,<=30,SL,Home,Upto 2014
KS More,IND,Spin,1989-12-01,Lahore,Pakistan,1989,1,12,12,0,1,665,1174,7,653,1162,7,95.0,>30,PAK,Away,Upto 2014
KS Ranjitsinhji,ENG,Spin,1898-01-29,Melbourne,Australia,1898,1,9,22,0,1,328,761,11,319,739,11,29.818181818181817,<=30,AUS,Away,After 1965
KS Ranjitsinhji,ENG,Spin,1899-06-15,Lord's,England,1899,1,6,10,0,1,387,894,12,381,884,12,32.25,>30,ENG,Home,After 1965
KS Ranjitsinhji,ENG,Spin,1899-07-17,Manchester,England,1899,2,24,65,1,1,220,480,7,196,415,6,31.428571428571427,>30,ENG,Home,After 1965
KS Williamson,NZ,Spin,2010-11-04,Ahmedabad,India,2010,2,67,96,1,1,781,1719,18,714,1623,17,43.388888888888886,>30,IND,Away,Upto 2014
KS Williamson,NZ,Spin,2010-11-12,Hyderabad,India,2010,1,31,42,0,1,691,1414,15,660,1372,15,46.06666666666667,>30,IND,Away,Upto 2014
KS Williamson,NZ,Spin,2010-11-20,Nagpur,India,2010,1,45,66,1,1,493,909,15,448,843,14,32.86666666666667,>30,IND,Away,Upto 2014
KS Williamson,NZ,Spin,2011-01-07,Hamilton,New Zealand,2011,1,33,36,0,1,193,540,7,160,504,7,27.571428571428573,<=30,NZ,Home,Upto 2014
KS Williamson,NZ,Spin,2011-11-01,Bulawayo,Zimbabwe,2011,1,9,12,0,1,535,1222,13,526,1210,13,41.15384615384615,>30,ZIM,Away,Upto 2014
KS Williamson,NZ,Spin,2011-12-01,Brisbane,Australia,2011,1,8,24,0,1,207,471,10,199,447,10,20.7,<=30,AUS,Away,Upto 2014
KS Williamson,NZ,Spin,2012-01-26,Napier,New Zealand,2012,1,12,12,1,1,163,234,4,151,222,3,40.75,>30,NZ,Home,Upto 2014
KS Williamson,NZ,Spin,2012-03-07,Dunedin,New Zealand,2012,1,16,42,1,1,209,528,4,193,486,3,52.25,>30,NZ,Home,Upto 2014
KS Williamson,NZ,Spin,2012-03-15,Hamilton,New Zealand,2012,2,24,15,1,1,143,280,4,119,265,3,35.75,>30,NZ,Home,Upto 2014
KS Williamson,NZ,Spin,2012-03-23,Wellington,New Zealand,2012,1,35,78,0,1,247,510,1,212,432,1,247.0,>30,NZ,Home,Upto 2014
KS Williamson,NZ,Spin,2012-07-25,North Sound,West Indies,2012,2,77,138,2,1,474,1059,11,397,921,9,43.09090909090909,>30,WI,Away,Upto 2014
KS Williamson,NZ,Spin,2012-08-02,Kingston,West Indies,2012,2,25,62,1,1,213,524,11,188,462,10,19.363636363636363,<=30,WI,Away,Upto 2014
KS Williamson,NZ,Spin,2012-08-23,Hyderabad,India,2012,1,31,42,0,1,326,884,22,295,842,22,14.818181818181818,<=30,IND,Away,Upto 2014
KS Williamson,NZ,Spin,2012-11-17,Galle,Sri Lanka,2012,1,6,6,0,1,290,649,16,284,643,16,18.125,<=30,SL,Away,Upto 2014
KS Williamson,NZ,Spin,2012-11-25,Colombo (PSS),Sri Lanka,2012,1,5,18,0,1,489,1212,15,484,1194,15,32.6,>30,SL,Away,Upto 2014
KS Williamson,NZ,Spin,2013-03-06,Dunedin,New Zealand,2013,1,30,72,0,1,254,582,6,224,510,6,42.333333333333336,>30,NZ,Home,Upto 2014
KS Williamson,NZ,Spin,2013-03-14,Wellington,New Zealand,2013,1,16,23,2,1,255,641,7,239,618,5,36.42857142857143,>30,NZ,Home,Upto 2014
KS Williamson,NZ,Spin,2013-03-22,Auckland,New Zealand,2013,1,44,120,4,1,355,860,7,311,740,3,50.714285714285715,>30,NZ,Home,Upto 2014
KS Williamson,NZ,Spin,2013-05-16,Lord's,England,2013,2,28,69,2,1,125,351,3,97,282,1,41.666666666666664,>30,ENG,Away,Upto 2014
KS Williamson,NZ,Spin,2013-05-24,Leeds,England,2013,2,117,198,4,1,291,492,14,174,294,10,20.785714285714285,<=30,ENG,Away,Upto 2014
KS Williamson,NZ,Spin,2013-10-09,Chattogram,Bangladesh,2013,2,107,222,1,1,1057,1946,22,950,1724,21,48.04545454545455,>30,BAN,Away,Upto 2014
KS Williamson,NZ,Spin,2013-10-21,Mirpur,Bangladesh,2013,2,74,132,1,1,460,965,12,386,833,11,38.333333333333336,>30,BAN,Away,Upto 2014
KS Williamson,NZ,Spin,2013-12-11,Wellington,New Zealand,2013,2,21,30,0,1,170,312,2,149,282,2,85.0,>30,NZ,Home,Upto 2014
KS Williamson,NZ,Spin,2013-12-19,Hamilton,New Zealand,2013,1,17,30,0,1,359,765,9,342,735,9,39.888888888888886,>30,NZ,Home,Upto 2014
KS Williamson,NZ,Spin,2014-02-06,Auckland,New Zealand,2014,2,27,30,0,1,263,390,2,236,360,2,131.5,>30,NZ,Home,After 1965
KS Williamson,NZ,Spin,2014-06-08,Kingston,West Indies,2014,1,1,4,1,1,767,1332,22,766,1328,21,34.86363636363637,>30,WI,Away,After 1965
KS Williamson,NZ,Spin,2014-06-16,Port of Spain,West Indies,2014,2,43,92,1,1,468,1009,10,425,917,9,46.8,>30,WI,Away,After 1965
KS Williamson,NZ,Spin,2014-06-26,Bridgetown,West Indies,2014,2,27,30,0,1,522,806,9,495,776,9,58.0,>30,WI,Away,After 1965
KS Williamson,NZ,Spin,2014-12-26,Christchurch,New Zealand,2014,1,1,6,0,1,299,462,3,298,456,3,99.66666666666667,>30,NZ,Home,After 1965
KS Williamson,NZ,Spin,2015-01-03,Wellington,New Zealand,2015,1,6,12,0,1,277,577,6,271,565,6,46.166666666666664,>30,NZ,Home,After 1965
KS Williamson,NZ,Spin,2015-05-21,Lord's,England,2015,1,2,6,0,1,317,528,7,315,522,7,45.285714285714285,>30,ENG,Away,After 1965
KS Williamson,NZ,Spin,2015-05-29,Leeds,England,2015,2,20,54,3,1,285,593,9,265,539,6,31.666666666666668,>30,ENG,Away,After 1965
KS Williamson,NZ,Spin,2015-11-05,Brisbane,Australia,2015,1,39,50,1,1,385,554,8,346,504,7,48.125,>30,AUS,Away,After 1965
KS Williamson,NZ,Spin,2015-11-13,W.A.C.A,Australia,2015,2,19,24,0,1,404,593,6,385,569,6,67.33333333333333,>30,AUS,Away,After 1965
KS Williamson,NZ,Spin,2015-12-10,Dunedin,New Zealand,2015,2,11,12,0,1,310,569,7,299,557,7,44.285714285714285,>30,NZ,Home,After 1965
KS Williamson,NZ,Spin,2015-12-18,Hamilton,New Zealand,2015,1,1,6,0,1,163,255,2,162,249,2,81.5,>30,NZ,Home,After 1965
KS Williamson,NZ,Spin,2016-02-12,Wellington,New Zealand,2016,1,8,24,0,1,284,458,9,276,434,9,31.555555555555557,>30,NZ,Home,After 1965
KS Williamson,NZ,Spin,2016-02-20,Christchurch,New Zealand,2016,1,17,42,1,1,123,228,4,106,186,3,30.75,>30,NZ,Home,After 1965
KS Williamson,NZ,Spin,2016-07-28,Bulawayo,Zimbabwe,2016,1,0,6,0,1,461,827,6,461,821,6,76.83333333333333,>30,ZIM,Away,After 1965
KS Williamson,NZ,Spin,2016-09-22,Kanpur,India,2016,1,7,18,0,1,859,1714,26,852,1696,26,33.03846153846154,>30,IND,Away,After 1965
KS Williamson,NZ,Spin,2016-11-25,Hamilton,New Zealand,2016,1,2,6,0,1,91,174,2,89,168,2,45.5,>30,NZ,Home,After 1965
KS Williamson,NZ,Spin,2017-01-12,Wellington,New Zealand,2017,1,20,18,0,1,423,748,8,403,730,8,52.875,>30,NZ,Home,After 1965
KS Williamson,NZ,Spin,2017-12-01,Wellington,New Zealand,2017,1,0,6,0,1,166,328,3,166,322,3,55.333333333333336,>30,NZ,Home,After 1965
KS Williamson,NZ,Spin,2018-03-22,Auckland,New Zealand,2018,1,1,6,0,1,112,223,4,111,217,4,28.0,<=30,NZ,Home,After 1965
KS Williamson,NZ,Spin,2018-11-24,Dubai (DICS),UAE,2018,1,20,30,0,1,473,968,16,453,938,16,29.5625,<=30,UAE,Away,After 1965
KS Williamson,NZ,Spin,2019-02-28,Hamilton,New Zealand,2019,1,13,12,0,1,362,462,3,349,450,3,120.66666666666667,>30,NZ,Home,After 1965
KS Williamson,NZ,Spin,2019-08-14,Galle,Sri Lanka,2019,1,9,18,0,1,786,1622,23,777,1604,23,34.17391304347826,>30,SL,Away,After 1965
KS Williamson,NZ,Spin,2019-11-21,Mount Maunganui,New Zealand,2019,1,6,6,0,1,303,672,6,297,666,6,50.5,>30,NZ,Home,After 1965
KS Williamson,NZ,Spin,2020-12-26,Mount Maunganui,New Zealand,2020,1,1,12,0,1,211,453,5,210,441,5,42.2,>30,NZ,Home,After 1965
KS Williamson,NZ,Spin,2021-01-03,Christchurch,New Zealand,2021,1,16,18,1,1,177,216,1,161,198,0,177.0,>30,NZ,Home,After 1965
KS Williamson,NZ,Spin,2021-06-02,Lord's,England,2021,2,12,18,0,1,134,256,1,122,238,1,134.0,>30,ENG,Away,After 1965
KSC de Silva,SL,Pace,1997-03-14,Hamilton,New Zealand,1997,2,65,150,0,1,399,988,18,334,838,18,22.166666666666668,<=30,NZ,Away,Upto 2014
KSC de Silva,SL,Pace,1997-04-26,Colombo (SSC),Sri Lanka,1997,2,158,260,5,1,378,693,12,220,433,7,31.5,>30,SL,Home,Upto 2014
KSC de Silva,SL,Pace,1997-06-13,St John's,West Indies,1997,2,91,132,1,1,500,775,20,409,643,19,25.0,<=30,WI,Away,Upto 2014
KSC de Silva,SL,Pace,1997-06-20,Kingstown,West Indies,1997,2,108,180,2,1,630,1024,21,522,844,19,30.0,<=30,WI,Away,Upto 2014
KSC de Silva,SL,Pace,1997-08-09,Colombo (SSC),Sri Lanka,1997,2,133,283,4,1,927,1577,19,794,1294,15,48.78947368421053,>30,SL,Home,Upto 2014
KSC de Silva,SL,Pace,1997-11-19,Mohali,India,1997,1,81,168,1,1,565,1196,16,484,1028,15,35.3125,>30,IND,Away,Upto 2014
KSC de Silva,SL,Pace,1999-03-04,Lahore,Pakistan,1999,2,178,258,2,1,638,1047,15,460,789,13,42.53333333333333,>30,PAK,Away,Upto 2014
KSC de Silva,SL,Pace,1999-03-12,Dhaka,Bangladesh,1999,1,75,154,1,1,404,794,8,329,640,7,50.5,>30,BAN,Away,Upto 2014
KT Maphaka,SA,Spin,2025-01-03,Cape Town,South Africa,2025,2,90,128,3,1,445,729,11,355,601,8,40.45454545454545,>30,SA,Home,After 1965
KTGD Prasad,SL,Pace,2008-08-08,Colombo (PSS),Sri Lanka,2008,2,142,168,5,1,381,610,11,239,442,6,34.63636363636363,>30,SL,Home,Upto 2014
KTGD Prasad,SL,Pace,2008-12-26,Mirpur,Bangladesh,2008,2,166,230,4,1,517,896,12,351,666,8,43.083333333333336,>30,BAN,Away,Upto 2014
KTGD Prasad,SL,Pace,2009-08-26,Colombo (SSC),Sri Lanka,2009,2,97,126,2,1,574,917,8,477,791,6,71.75,>30,SL,Home,Upto 2014
KTGD Prasad,SL,Pace,2009-11-16,Ahmedabad,India,2009,2,162,210,2,1,648,1044,12,486,834,10,54.0,>30,IND,Away,Upto 2014
KTGD Prasad,SL,Pace,2010-07-26,Colombo (SSC),Sri Lanka,2010,1,101,132,0,1,508,710,3,407,578,3,169.33333333333334,>30,SL,Home,Upto 2014
KTGD Prasad,SL,Pace,2010-11-15,Galle,Sri Lanka,2010,1,116,180,0,1,602,992,8,486,812,8,75.25,>30,SL,Home,Upto 2014
KTGD Prasad,SL,Pace,2011-10-26,Dubai (DICS),UAE,2011,2,127,210,3,1,473,936,12,346,726,9,39.416666666666664,>30,UAE,Away,Upto 2014
KTGD Prasad,SL,Pace,2011-11-03,Sharjah,UAE,2011,1,9,24,0,1,418,917,14,409,893,14,29.857142857142858,<=30,UAE,Away,Upto 2014
KTGD Prasad,SL,Pace,2012-01-03,Cape Town,South Africa,2012,1,154,180,2,1,828,1318,18,674,1138,16,46.0,>30,SA,Away,Upto 2014
KTGD Prasad,SL,Pace,2012-04-03,Colombo (PSS),Sri Lanka,2012,1,63,138,1,1,394,959,10,331,821,9,39.4,>30,SL,Home,Upto 2014
KTGD Prasad,SL,Pace,2012-12-26,Melbourne,Australia,2012,1,106,156,3,1,518,864,21,412,708,18,24.666666666666668,<=30,AUS,Away,Upto 2014
KTGD Prasad,SL,Pace,2013-01-03,Sydney,Australia,2013,1,53,66,0,1,729,1200,20,676,1134,20,36.45,>30,AUS,Away,Upto 2014
KTGD Prasad,SL,Pace,2014-06-20,Leeds,England,2014,2,125,252,6,1,1059,2060,34,934,1808,28,31.147058823529413,>30,ENG,Away,After 1965
KTGD Prasad,SL,Pace,2014-08-06,Galle,Sri Lanka,2014,2,91,192,3,1,513,974,10,422,782,7,51.3,>30,SL,Home,After 1965
KTGD Prasad,SL,Pace,2014-08-14,Colombo (SSC),Sri Lanka,2014,2,82,144,2,1,441,792,14,359,648,12,31.5,>30,SL,Home,After 1965
KTGD Prasad,SL,Pace,2014-12-26,Christchurch,New Zealand,2014,2,79,100,1,1,757,1417,28,678,1317,27,27.035714285714285,<=30,NZ,Away,After 1965
KTGD Prasad,SL,Pace,2015-01-03,Wellington,New Zealand,2015,2,152,235,3,1,987,1835,28,835,1600,25,35.25,>30,NZ,Away,After 1965
KTGD Prasad,SL,Pace,2015-06-17,Galle,Sri Lanka,2015,2,101,156,3,1,383,708,10,282,552,7,38.3,>30,SL,Home,After 1965
KTGD Prasad,SL,Pace,2015-06-25,Colombo (PSS),Sri Lanka,2015,2,135,255,7,1,390,800,14,255,545,7,27.857142857142858,<=30,SL,Home,After 1965
KTGD Prasad,SL,Pace,2015-07-03,Pallekele,Sri Lanka,2015,2,143,234,4,1,740,1384,19,597,1150,15,38.94736842105263,>30,SL,Home,After 1965
KTGD Prasad,SL,Pace,2015-08-12,Galle,Sri Lanka,2015,2,58,156,1,1,393,630,9,335,474,8,43.666666666666664,>30,SL,Home,After 1965
KTGD Prasad,SL,Pace,2015-08-20,Colombo (PSS),Sri Lanka,2015,2,127,234,6,1,525,996,16,398,762,10,32.8125,>30,SL,Home,After 1965
KTGD Prasad,SL,Pace,2015-08-28,Colombo (SSC),Sri Lanka,2015,2,169,270,8,1,606,1122,27,437,852,19,22.444444444444443,<=30,SL,Home,After 1965
KTGD Prasad,SL,Pace,2015-10-14,Galle,Sri Lanka,2015,2,66,147,4,1,384,801,11,318,654,7,34.90909090909091,>30,SL,Home,After 1965
KTGD Prasad,SL,Pace,2015-10-22,Colombo (PSS),Sri Lanka,2015,2,72,132,5,1,259,558,12,187,426,7,21.583333333333332,<=30,SL,Home,After 1965
KV Sharma,IND,Spin,2014-12-09,Adelaide,Australia,2014,2,238,294,4,1,652,937,17,414,643,13,38.35294117647059,>30,AUS,Away,After 1965
KW Hough,NZ,Pace,1959-02-27,Christchurch,New Zealand,1959,1,96,234,3,1,293,707,12,197,473,9,24.416666666666668,<=30,NZ,Home,Upto 2014
KW Hough,NZ,Pace,1959-03-14,Auckland,New Zealand,1959,1,79,228,3,1,267,780,10,188,552,7,26.7,<=30,NZ,Home,Upto 2014
KWR Fletcher,ENG,Spin,1969-02-21,Lahore,Pakistan,1969,1,31,48,0,1,546,1362,17,515,1314,17,32.11764705882353,>30,PAK,Away,Upto 2014
KWR Fletcher,ENG,Spin,1969-08-07,Nottingham,England,1969,1,14,18,0,1,236,642,5,222,624,5,47.2,>30,ENG,Home,Upto 2014
KWR Fletcher,ENG,Spin,1970-11-27,Brisbane,Australia,1970,1,48,72,1,1,461,1342,10,413,1270,9,46.1,>30,AUS,Away,Upto 2014
KWR Fletcher,ENG,Spin,1970-12-11,W.A.C.A,Australia,1970,2,22,40,0,1,317,920,6,295,880,6,52.833333333333336,>30,AUS,Away,Upto 2014
KWR Fletcher,ENG,Spin,1971-01-09,Sydney,Australia,1971,1,6,8,0,1,467,1239,15,461,1231,15,31.133333333333333,>30,AUS,Away,Upto 2014
KWR Fletcher,ENG,Spin,1971-01-29,Adelaide,Australia,1971,1,16,32,0,1,449,1176,4,433,1144,4,112.25,>30,AUS,Away,Upto 2014
KWR Fletcher,ENG,Spin,1971-02-12,Sydney,Australia,1971,1,9,8,0,1,385,1254,19,376,1246,19,20.263157894736842,<=30,AUS,Away,Upto 2014
KWR Fletcher,ENG,Spin,1973-03-16,Hyderabad (Sind),Pakistan,1973,1,22,18,0,1,993,2402,21,971,2384,21,47.285714285714285,>30,PAK,Away,Upto 2014
KWR Fletcher,ENG,Spin,1974-02-02,Port of Spain,West Indies,1974,1,5,5,0,1,671,1657,22,666,1652,22,30.5,>30,WI,Away,Upto 2014
KWR Fletcher,ENG,Spin,1982-01-01,Eden Gardens,India,1982,1,6,18,1,1,396,1328,13,390,1310,12,30.46153846153846,>30,IND,Away,Upto 2014
KWR Fletcher,ENG,Spin,1982-01-13,Chennai,India,1982,1,9,6,0,1,285,972,8,276,966,8,35.625,>30,IND,Away,Upto 2014
KWR Fletcher,ENG,Spin,1982-01-30,Kanpur,India,1982,1,5,12,0,1,274,704,7,269,692,7,39.142857142857146,>30,IND,Away,Upto 2014
Kabir Ali,ENG,Pace,2003-08-21,Leeds,England,2003,2,136,216,5,1,1130,2145,39,994,1929,34,28.974358974358974,<=30,ENG,Home,Upto 2014
Kabir Khan,PAK,Pace,1994-08-26,Kandy,Sri Lanka,1994,1,39,60,1,1,485,782,21,446,722,20,23.095238095238095,<=30,SL,Away,Upto 2014
Kabir Khan,PAK,Pace,1995-01-19,Johannesburg,South Africa,1995,2,118,223,3,1,915,1724,33,797,1501,30,27.727272727272727,<=30,SA,Away,Upto 2014
Kabir Khan,PAK,Pace,1995-01-31,Harare,Zimbabwe,1995,1,142,210,1,1,693,1542,23,551,1332,22,30.130434782608695,>30,ZIM,Away,Upto 2014
Kabir Khan,PAK,Pace,1995-02-07,Bulawayo,Zimbabwe,1995,2,71,162,4,1,563,1357,30,492,1195,26,18.766666666666666,<=30,ZIM,Away,Upto 2014
Kamran Ghulam,PAK,Spin,2025-01-03,Cape Town,South Africa,2025,2,16,18,0,1,445,729,11,429,711,11,40.45454545454545,>30,SA,Away,After 1965
Kamrul Islam Rabbi,BAN,Pace,2016-10-20,Chattogram,Bangladesh,2016,2,65,96,1,1,222,543,9,157,447,8,24.666666666666668,<=30,BAN,Home,After 1965
Kamrul Islam Rabbi,BAN,Pace,2016-10-28,Mirpur,Bangladesh,2016,1,16,18,0,1,173,288,8,157,270,8,21.625,<=30,BAN,Home,After 1965
Kamrul Islam Rabbi,BAN,Pace,2017-01-12,Wellington,New Zealand,2017,2,118,198,3,1,1047,1639,21,929,1441,18,49.857142857142854,>30,NZ,Away,After 1965
Kamrul Islam Rabbi,BAN,Pace,2017-01-20,Christchurch,New Zealand,2017,2,99,132,3,1,735,1238,24,636,1106,21,30.625,>30,NZ,Away,After 1965
Kamrul Islam Rabbi,BAN,Pace,2017-02-09,Hyderabad,India,2017,1,100,114,0,1,567,906,10,467,792,10,56.7,>30,IND,Away,After 1965
Kamrul Islam Rabbi,BAN,Pace,2018-07-04,North Sound,West Indies,2018,1,69,120,1,1,363,699,24,294,579,23,15.125,<=30,WI,Away,After 1965
Kamrul Islam Rabbi,BAN,Pace,2018-07-12,Kingston,West Indies,2018,2,37,72,0,1,360,661,22,323,589,22,16.363636363636363,<=30,WI,Away,After 1965
Karim Janat,AFG,Pace,2023-06-14,Mirpur,Bangladesh,2023,2,81,114,0,1,553,731,21,472,617,21,26.333333333333332,<=30,BAN,Away,After 1965
Karim Janat,AFG,Pace,2024-02-28,Tolerance Oval,UAE,2024,1,24,36,0,1,418,850,26,394,814,26,16.076923076923077,<=30,UAE,Away,After 1965
Kashif Ali,PAK,Spin,2025-01-25,Multan,Pakistan,2025,2,39,60,2,1,637,1154,37,598,1094,35,17.216216216216218,<=30,PAK,Home,After 1965
Khaled Ahmed,BAN,Pace,2018-11-11,Mirpur,Bangladesh,2018,2,93,180,0,1,422,1002,13,329,822,13,32.46153846153846,>30,BAN,Home,After 1965
Khaled Ahmed,BAN,Pace,2019-02-28,Hamilton,New Zealand,2019,1,149,180,0,1,1009,1490,23,860,1310,23,43.869565217391305,>30,NZ,Away,After 1965
Khaled Ahmed,BAN,Pace,2021-12-04,Mirpur,Bangladesh,2021,1,49,105,1,1,208,447,7,159,342,6,29.714285714285715,<=30,BAN,Home,After 1965
Khaled Ahmed,BAN,Pace,2022-03-31,Durban,South Africa,2022,2,125,228,4,1,457,911,16,332,683,12,28.5625,<=30,SA,Away,After 1965
Khaled Ahmed,BAN,Pace,2022-04-08,Gqeberha,South Africa,2022,2,138,234,4,1,403,672,9,265,438,5,44.77777777777778,>30,SA,Away,After 1965
Khaled Ahmed,BAN,Pace,2022-05-15,Chattogram,Bangladesh,2022,2,103,138,0,1,332,607,7,229,469,7,47.42857142857143,>30,BAN,Home,After 1965
Khaled Ahmed,BAN,Pace,2022-05-23,Mirpur,Bangladesh,2022,1,85,138,0,1,494,899,21,409,761,21,23.523809523809526,<=30,BAN,Home,After 1965
Khaled Ahmed,BAN,Pace,2022-06-16,North Sound,West Indies,2022,2,86,180,5,1,515,1150,28,429,970,23,18.392857142857142,<=30,WI,Away,After 1965
Khaled Ahmed,BAN,Pace,2022-06-24,Gros Islet,West Indies,2022,2,110,195,5,1,658,1090,26,548,895,21,25.307692307692307,<=30,WI,Away,After 1965
Khaled Ahmed,BAN,Pace,2022-12-14,Chattogram,Bangladesh,2022,2,94,198,2,1,311,654,9,217,456,7,34.55555555555556,>30,BAN,Home,After 1965
Khaled Ahmed,BAN,Pace,2022-12-22,Mirpur,Bangladesh,2022,2,53,72,0,1,319,582,11,266,510,11,29.0,<=30,BAN,Home,After 1965
Khaled Ahmed,BAN,Pace,2023-04-04,Mirpur,Bangladesh,2023,2,67,96,0,1,400,606,10,333,510,10,40.0,>30,BAN,Home,After 1965
Khaled Ahmed,BAN,Pace,2024-03-22,Sylhet,Bangladesh,2024,2,118,210,4,1,733,1127,31,615,917,27,23.64516129032258,<=30,BAN,Home,After 1965
Khaled Ahmed,BAN,Pace,2024-03-30,Chattogram,Bangladesh,2024,2,105,186,3,1,504,886,22,399,700,19,22.90909090909091,<=30,BAN,Home,After 1965
Khaled Ahmed,BAN,Pace,2024-09-27,Kanpur,India,2024,1,43,24,0,1,315,492,12,272,468,12,26.25,<=30,IND,Away,After 1965
Khaled Mahmud,BAN,Pace,2001-11-08,Dhaka,Bangladesh,2001,1,59,90,0,1,386,858,18,327,768,18,21.444444444444443,<=30,BAN,Home,Upto 2014
Khaled Mahmud,BAN,Pace,2001-12-18,Hamilton,New Zealand,2001,1,40,54,1,1,586,928,27,546,874,26,21.703703703703702,<=30,NZ,Away,Upto 2014
Khaled Mahmud,BAN,Pace,2001-12-26,Wellington,New Zealand,2001,1,42,72,0,1,447,846,18,405,774,18,24.833333333333332,<=30,NZ,Away,Upto 2014
Khaled Mahmud,BAN,Pace,2003-04-24,Chattogram,Bangladesh,2003,1,56,102,0,1,514,1056,11,458,954,11,46.72727272727273,>30,BAN,Home,Upto 2014
Khaled Mahmud,BAN,Pace,2003-05-01,Dhaka,Bangladesh,2003,1,36,84,0,1,304,666,13,268,582,13,23.384615384615383,<=30,BAN,Home,Upto 2014
Khaled Mahmud,BAN,Pace,2003-07-18,Darwin,Australia,2003,1,98,168,0,1,496,985,17,398,817,17,29.176470588235293,<=30,AUS,Away,Upto 2014
Khaled Mahmud,BAN,Pace,2003-07-25,Cairns,Australia,2003,1,75,114,0,1,637,1169,12,562,1055,12,53.083333333333336,>30,AUS,Away,Upto 2014
Khaled Mahmud,BAN,Pace,2003-08-20,Karachi,Pakistan,2003,2,82,138,1,1,660,1252,19,578,1114,18,34.73684210526316,>30,PAK,Away,Upto 2014
Khaled Mahmud,BAN,Pace,2003-08-27,Peshawar,Pakistan,2003,2,70,210,3,1,501,1075,20,431,865,17,25.05,<=30,PAK,Away,Upto 2014
Khaled Mahmud,BAN,Pace,2003-09-03,Multan,Pakistan,2003,2,105,246,7,1,593,1160,25,488,914,18,23.72,<=30,PAK,Away,Upto 2014
Khaled Mahmud,BAN,Pace,2003-10-21,Dhaka,Bangladesh,2003,2,59,120,0,1,448,1151,23,389,1031,23,19.47826086956522,<=30,BAN,Home,Upto 2014
Khaled Mahmud,BAN,Pace,2003-10-29,Chattogram,Bangladesh,2003,2,110,222,1,1,551,1109,24,441,887,23,22.958333333333332,<=30,BAN,Home,Upto 2014
Khalid Hasan,PAK,Spin,1954-07-01,Nottingham,England,1954,1,116,126,2,1,279,522,7,163,396,5,39.857142857142854,>30,ENG,Away,Upto 2014
Khalid Ibadulla,PAK,Spin,1964-10-24,Karachi,Pakistan,1964,2,23,54,0,1,840,2130,18,817,2076,18,46.666666666666664,>30,PAK,Home,Upto 2014
Khalid Ibadulla,PAK,Spin,1965-02-12,Christchurch,New Zealand,1965,2,29,72,0,1,466,1098,16,437,1026,16,29.125,<=30,NZ,Away,Upto 2014
Khalid Ibadulla,PAK,Spin,1967-07-27,Lord's,England,1967,1,5,18,0,1,583,1689,19,578,1671,19,30.68421052631579,>30,ENG,Away,Upto 2014
Khalid Ibadulla,PAK,Spin,1967-08-10,Nottingham,England,1967,1,42,192,1,1,240,772,12,198,580,11,20.0,<=30,ENG,Away,Upto 2014
Khan Mohammad,PAK,Pace,1952-10-16,Delhi,India,1952,1,52,120,2,1,227,672,5,175,552,3,45.4,>30,IND,Away,Upto 2014
Khan Mohammad,PAK,Pace,1954-06-10,Lord's,England,1954,1,61,90,5,1,164,348,14,103,258,9,11.714285714285714,<=30,ENG,Away,Upto 2014
Khan Mohammad,PAK,Pace,1954-07-01,Nottingham,England,1954,1,155,240,3,1,686,1378,19,531,1138,16,36.10526315789474,>30,ENG,Away,Upto 2014
Khan Mohammad,PAK,Pace,1955-01-01,Dhaka,Bangladesh,1955,2,60,233,6,1,253,947,14,193,714,8,18.071428571428573,<=30,BAN,Away,Upto 2014
Khan Mohammad,PAK,Pace,1955-01-15,Bahawalpur,Pakistan,1955,2,124,330,7,1,416,1187,15,292,857,8,27.733333333333334,<=30,PAK,Home,Upto 2014
Khan Mohammad,PAK,Pace,1955-02-12,Peshawar,Pakistan,1955,2,89,240,4,1,201,612,7,112,372,3,28.714285714285715,<=30,PAK,Home,Upto 2014
Khan Mohammad,PAK,Pace,1955-02-26,Karachi,Pakistan,1955,2,77,210,5,1,257,771,19,180,561,14,13.526315789473685,<=30,PAK,Home,Upto 2014
Khan Mohammad,PAK,Pace,1955-10-13,Karachi,Pakistan,1955,2,60,216,0,1,260,769,8,200,553,8,32.5,>30,PAK,Home,Upto 2014
Khan Mohammad,PAK,Pace,1955-10-26,Lahore,Pakistan,1955,2,104,312,5,1,619,1402,11,515,1090,6,56.27272727272727,>30,PAK,Home,Upto 2014
Khan Mohammad,PAK,Pace,1955-11-07,Dhaka,Bangladesh,1955,2,41,278,8,1,196,674,16,155,396,8,12.25,<=30,BAN,Away,Upto 2014
Khan Mohammad,PAK,Pace,1956-10-11,Karachi,Pakistan,1956,2,112,402,7,1,382,1421,26,270,1019,19,14.692307692307692,<=30,PAK,Home,Upto 2014
Khan Mohammad,PAK,Pace,1958-02-26,Kingston,West Indies,1958,1,259,324,0,1,916,1594,17,657,1270,17,53.88235294117647,>30,WI,Away,Upto 2014
Khan Mohammad,PAK,Pace,1958-03-26,Port of Spain,West Indies,1958,2,98,162,2,1,413,869,16,315,707,14,25.8125,<=30,WI,Away,Upto 2014
Khurram Shahzad,PAK,Pace,2023-12-14,Perth,Australia,2023,2,128,228,5,1,810,1410,28,682,1182,23,28.928571428571427,<=30,AUS,Away,After 1965
Khurram Shahzad,PAK,Pace,2024-08-21,Rawalpindi,Pakistan,2024,1,90,174,2,1,696,1287,16,606,1113,14,43.5,>30,PAK,Home,After 1965
Khurram Shahzad,PAK,Pace,2024-08-30,Rawalpindi,Pakistan,2024,2,130,168,7,1,585,958,24,455,790,17,24.375,<=30,PAK,Home,After 1965
Khurram Shahzad,PAK,Pace,2024-12-26,Centurion,South Africa,2024,2,122,180,4,1,742,1206,32,620,1026,28,23.1875,<=30,SA,Away,After 1965
Khurram Shahzad,PAK,Pace,2025-01-03,Cape Town,South Africa,2025,1,123,150,2,1,862,1222,17,739,1072,15,50.705882352941174,>30,SA,Away,After 1965
Khurram Shahzad,PAK,Pace,2025-01-17,Multan,Pakistan,2025,1,7,6,0,1,83,168,3,76,162,3,27.666666666666668,<=30,PAK,Home,After 1965
Kuldeep Yadav,IND,Spin,2017-03-25,Dharamsala,India,2017,2,91,168,4,1,468,1025,18,377,857,14,26.0,<=30,IND,Home,After 1965
Kuldeep Yadav,IND,Spin,2017-08-12,Pallekele,Sri Lanka,2017,2,96,180,5,1,436,802,19,340,622,14,22.94736842105263,<=30,SL,Away,After 1965
Kuldeep Yadav,IND,Spin,2018-08-09,Lord's,England,2018,1,44,54,0,1,112,156,0,68,102,0,inf,>30,ENG,Away,After 1965
Kuldeep Yadav,IND,Spin,2018-10-04,Rajkot,India,2018,2,119,144,6,1,685,1000,22,566,856,16,31.136363636363637,>30,IND,Home,After 1965
Kuldeep Yadav,IND,Spin,2018-10-12,Hyderabad,India,2018,2,130,252,4,1,524,1095,12,394,843,8,43.666666666666664,>30,IND,Home,After 1965
Kuldeep Yadav,IND,Spin,2019-01-03,Sydney,Australia,2019,1,99,191,5,1,448,853,11,349,662,6,40.72727272727273,>30,AUS,Away,After 1965
Kuldeep Yadav,IND,Spin,2021-02-13,Chennai,India,2021,2,41,74,2,1,686,1393,32,645,1319,30,21.4375,<=30,IND,Home,After 1965
Kuldeep Yadav,IND,Spin,2022-12-14,Chattogram,Bangladesh,2022,2,113,216,8,1,800,1534,23,687,1318,15,34.78260869565217,>30,BAN,Away,After 1965
Kuldeep Yadav,IND,Spin,2024-02-02,Visakhapatnam,India,2024,2,131,192,4,1,935,1413,24,804,1221,20,38.958333333333336,>30,IND,Home,After 1965
Kuldeep Yadav,IND,Spin,2024-02-15,Rajkot,India,2024,2,96,156,4,1,805,1288,20,709,1132,16,40.25,>30,IND,Home,After 1965
Kuldeep Yadav,IND,Spin,2024-02-23,Ranchi,India,2024,2,44,162,4,1,670,1494,28,626,1332,24,23.928571428571427,<=30,IND,Home,After 1965
Kuldeep Yadav,IND,Spin,2024-03-07,Dharamsala,India,2024,2,112,175,7,1,589,972,25,477,797,18,23.56,<=30,IND,Home,After 1965
Kuldeep Yadav,IND,Spin,2024-10-16,Bengaluru,India,2024,2,125,129,3,1,524,637,10,399,508,7,52.4,>30,IND,Home,After 1965
L Amar Singh,IND,Pace,1932-06-25,Lord's,England,1932,2,159,433,4,1,543,1480,28,384,1047,24,19.392857142857142,<=30,ENG,Away,Upto 2014
L Amar Singh,IND,Pace,1933-12-15,Mumbai,India,1933,2,134,236,2,1,534,1100,19,400,864,17,28.105263157894736,<=30,IND,Home,Upto 2014
L Amar Singh,IND,Pace,1934-01-05,Eden Gardens,India,1934,2,107,341,4,1,492,1256,17,385,915,13,28.941176470588236,<=30,IND,Home,Upto 2014
L Amar Singh,IND,Pace,1934-02-10,Chennai,India,1934,2,141,406,8,1,459,1077,17,318,671,9,27.0,<=30,IND,Home,Upto 2014
L Amar Singh,IND,Pace,1936-06-27,Lord's,England,1936,2,71,250,6,1,273,772,20,202,522,14,13.65,<=30,ENG,Away,Upto 2014
L Amar Singh,IND,Pace,1936-07-25,Manchester,England,1936,1,121,246,2,1,650,1176,8,529,930,6,81.25,>30,ENG,Away,Upto 2014
L Amar Singh,IND,Pace,1936-08-15,The Oval,England,1936,2,125,270,2,1,678,1230,17,553,960,15,39.88235294117647,>30,ENG,Away,Upto 2014
L Amarnath,IND,Pace,1933-12-15,Mumbai,India,1933,1,2,12,0,1,534,1100,19,532,1088,19,28.105263157894736,<=30,IND,Home,Upto 2014
L Amarnath,IND,Pace,1934-01-05,Eden Gardens,India,1934,1,10,12,0,1,492,1256,17,482,1244,17,28.941176470588236,<=30,IND,Home,Upto 2014
L Amarnath,IND,Pace,1934-02-10,Chennai,India,1934,2,101,257,4,1,459,1077,17,358,820,13,27.0,<=30,IND,Home,Upto 2014
L Amarnath,IND,Pace,1946-06-22,Lord's,England,1946,2,133,366,5,1,522,1272,22,389,906,17,23.727272727272727,<=30,ENG,Away,Upto 2014
L Amarnath,IND,Pace,1946-07-20,Manchester,England,1946,2,167,486,8,1,495,1476,27,328,990,19,18.333333333333332,<=30,ENG,Away,Upto 2014
L Amarnath,IND,Pace,1946-08-17,The Oval,England,1946,1,30,90,0,1,220,560,7,190,470,7,31.428571428571427,>30,ENG,Away,Upto 2014
L Amarnath,IND,Pace,1947-11-28,Brisbane,Australia,1947,1,84,312,4,1,345,994,21,261,682,17,16.428571428571427,<=30,AUS,Away,Upto 2014
L Amarnath,IND,Pace,1947-12-12,Sydney,Australia,1947,1,31,112,1,1,133,474,10,102,362,9,13.3,<=30,AUS,Away,Upto 2014
L Amarnath,IND,Pace,1948-01-01,Melbourne,Australia,1948,2,130,328,7,1,380,833,9,250,505,2,42.22222222222222,>30,AUS,Away,Upto 2014
L Amarnath,IND,Pace,1948-01-23,Adelaide,Australia,1948,1,42,72,0,1,583,1360,19,541,1288,19,30.68421052631579,>30,AUS,Away,Upto 2014
L Amarnath,IND,Pace,1948-02-06,Melbourne,Australia,1948,1,79,184,1,1,469,1146,14,390,962,13,33.5,>30,AUS,Away,Upto 2014
L Amarnath,IND,Pace,1948-11-10,Delhi,India,1948,1,73,150,1,1,457,956,11,384,806,10,41.54545454545455,>30,IND,Home,Upto 2014
L Amarnath,IND,Pace,1948-12-09,Brabourne,India,1948,1,33,48,0,1,410,1014,5,377,966,5,82.0,>30,IND,Home,Upto 2014
L Amarnath,IND,Pace,1948-12-31,Eden Gardens,India,1948,2,109,258,2,1,577,1272,12,468,1014,10,48.083333333333336,>30,IND,Home,Upto 2014
L Amarnath,IND,Pace,1949-01-27,Chennai,India,1949,1,39,96,0,1,442,1095,18,403,999,18,24.555555555555557,<=30,IND,Home,Upto 2014
L Amarnath,IND,Pace,1949-02-04,Brabourne,India,1949,1,9,24,0,1,462,1177,18,453,1153,18,25.666666666666668,<=30,IND,Home,Upto 2014
L Amarnath,IND,Pace,1951-12-14,Brabourne,India,1951,2,67,235,3,1,609,1495,17,542,1260,14,35.8235294117647,>30,IND,Home,Upto 2014
L Amarnath,IND,Pace,1951-12-30,Eden Gardens,India,1951,2,78,252,0,1,283,907,5,205,655,5,56.6,>30,IND,Home,Upto 2014
L Amarnath,IND,Pace,1952-02-06,Chennai,India,1952,2,62,180,0,1,228,540,4,166,360,4,57.0,>30,IND,Home,Upto 2014
L Amarnath,IND,Pace,1952-10-16,Delhi,India,1952,2,22,108,1,1,227,672,5,205,564,4,45.4,>30,IND,Home,Upto 2014
L Amarnath,IND,Pace,1952-10-23,Lucknow,India,1952,1,74,240,2,1,415,1291,25,341,1051,23,16.6,<=30,IND,Home,Upto 2014
L Amarnath,IND,Pace,1952-11-13,Brabourne,India,1952,2,65,234,4,1,405,896,8,340,662,4,50.625,>30,IND,Home,Upto 2014
L Amarnath,IND,Pace,1952-11-28,Chennai,India,1952,1,9,41,1,1,235,515,6,226,474,5,39.166666666666664,>30,IND,Home,Upto 2014
L Amarnath,IND,Pace,1952-12-12,Eden Gardens,India,1952,2,32,144,1,1,409,1086,14,377,942,13,29.214285714285715,<=30,IND,Home,Upto 2014
L Balaji,IND,Pace,2003-10-08,Ahmedabad,India,2003,2,105,222,1,1,553,1086,9,448,864,8,61.44444444444444,>30,IND,Home,Upto 2014
L Balaji,IND,Pace,2003-10-16,Mohali,India,2003,1,78,180,0,1,470,1014,9,392,834,9,52.22222222222222,>30,IND,Home,Upto 2014
L Balaji,IND,Pace,2004-03-28,Multan,Pakistan,2004,2,102,186,1,1,716,1290,10,614,1104,9,71.6,>30,PAK,Away,Upto 2014
L Balaji,IND,Pace,2004-04-05,Lahore,Pakistan,2004,2,96,216,4,1,744,1284,22,648,1068,18,33.81818181818182,>30,PAK,Away,Upto 2014
L Balaji,IND,Pace,2004-04-13,Rawalpindi,Pakistan,2004,2,171,234,7,1,687,1266,18,516,1032,11,38.166666666666664,>30,PAK,Away,Upto 2014
L Balaji,IND,Pace,2005-03-08,Mohali,India,2005,2,171,304,9,1,866,1468,17,695,1164,8,50.94117647058823,>30,IND,Home,Upto 2014
L Balaji,IND,Pace,2005-03-16,Eden Gardens,India,2005,2,141,222,3,1,678,1069,14,537,847,11,48.42857142857143,>30,IND,Home,Upto 2014
L Balaji,IND,Pace,2005-03-24,Bengaluru,India,2005,2,140,192,2,1,604,960,8,464,768,6,75.5,>30,IND,Home,Upto 2014
L Embuldeniya,SL,Spin,2019-02-13,Durban,South Africa,2019,2,117,216,6,1,237,390,9,120,174,3,26.333333333333332,<=30,SA,Away,After 1965
L Embuldeniya,SL,Spin,2019-02-21,Gqeberha,South Africa,2019,1,26,33,0,1,131,181,6,105,148,6,21.833333333333332,<=30,SA,Away,After 1965
L Embuldeniya,SL,Spin,2019-08-14,Galle,Sri Lanka,2019,2,180,354,4,1,786,1622,23,606,1268,19,34.17391304347826,>30,SL,Home,After 1965
L Embuldeniya,SL,Spin,2019-08-22,Colombo (PSS),Sri Lanka,2019,1,156,222,2,1,428,846,11,272,624,9,38.90909090909091,>30,SL,Home,After 1965
L Embuldeniya,SL,Spin,2019-12-19,Karachi,Pakistan,2019,2,264,423,5,1,548,873,9,284,450,4,60.888888888888886,>30,PAK,Away,After 1965
L Embuldeniya,SL,Spin,2020-01-19,Harare,Zimbabwe,2020,2,188,408,7,1,523,1058,12,335,650,5,43.583333333333336,>30,ZIM,Away,After 1965
L Embuldeniya,SL,Spin,2020-01-27,Harare,Zimbabwe,2020,2,263,375,6,1,658,1179,17,395,804,11,38.705882352941174,>30,ZIM,Away,After 1965
L Embuldeniya,SL,Spin,2021-01-14,Galle,Sri Lanka,2021,2,205,342,5,1,751,1413,23,546,1071,18,32.65217391304348,>30,SL,Home,After 1965
L Embuldeniya,SL,Spin,2021-01-22,Galle,Sri Lanka,2021,2,210,372,10,1,734,1377,23,524,1005,13,31.91304347826087,>30,SL,Home,After 1965
L Embuldeniya,SL,Spin,2021-03-21,North Sound,West Indies,2021,2,126,336,3,1,363,863,7,237,527,4,51.857142857142854,>30,WI,Away,After 1965
L Embuldeniya,SL,Spin,2021-03-29,North Sound,West Indies,2021,1,88,150,1,1,313,706,3,225,556,2,104.33333333333333,>30,WI,Away,After 1965
L Embuldeniya,SL,Spin,2021-11-21,Galle,Sri Lanka,2021,2,113,366,6,1,748,1629,31,635,1263,25,24.129032258064516,<=30,SL,Home,After 1965
L Embuldeniya,SL,Spin,2021-11-29,Galle,Sri Lanka,2021,2,129,331,7,1,790,1806,36,661,1475,29,21.944444444444443,<=30,SL,Home,After 1965
L Embuldeniya,SL,Spin,2022-03-04,Mohali,India,2022,1,188,276,2,1,500,927,18,312,651,16,27.77777777777778,<=30,IND,Away,After 1965
L Embuldeniya,SL,Spin,2022-03-12,Bengaluru,India,2022,2,181,269,6,1,625,968,26,444,699,20,24.03846153846154,<=30,IND,Away,After 1965
L Embuldeniya,SL,Spin,2022-05-15,Chattogram,Bangladesh,2022,1,104,282,1,1,772,1873,17,668,1591,16,45.411764705882355,>30,BAN,Away,After 1965
L Embuldeniya,SL,Spin,2022-06-29,Galle,Sri Lanka,2022,1,73,90,0,1,491,729,25,418,639,25,19.64,<=30,SL,Home,After 1965
L Hutton,ENG,Spin,1937-06-26,Lord's,England,1937,1,4,12,0,1,512,1098,11,508,1086,11,46.54545454545455,>30,ENG,Home,Upto 2014
L Hutton,ENG,Spin,1937-08-14,The Oval,England,1937,2,11,28,1,1,331,715,12,320,687,11,27.583333333333332,<=30,ENG,Home,Upto 2014
L Hutton,ENG,Spin,1939-03-03,Durban,South Africa,1939,1,10,8,0,1,794,1998,16,784,1990,16,49.625,>30,SA,Away,Upto 2014
L Hutton,ENG,Spin,1939-08-19,The Oval,England,1939,1,45,56,1,1,434,768,4,389,712,3,108.5,>30,ENG,Home,Upto 2014
L Hutton,ENG,Spin,1947-01-01,Melbourne,Australia,1947,1,28,24,0,1,582,1365,14,554,1341,14,41.57142857142857,>30,AUS,Away,Upto 2014
L Hutton,ENG,Spin,1947-06-07,Nottingham,England,1947,1,15,12,0,1,885,2189,17,870,2177,17,52.05882352941177,>30,ENG,Home,Upto 2014
L Hutton,ENG,Spin,1947-08-16,The Oval,England,1947,1,14,12,0,1,893,1980,23,879,1968,23,38.82608695652174,>30,ENG,Home,Upto 2014
L Hutton,ENG,Spin,1948-07-22,Leeds,England,1948,1,30,24,0,1,708,1260,12,678,1236,12,59.0,>30,ENG,Home,Upto 2014
L Hutton,ENG,Spin,1949-06-11,Leeds,England,1949,1,23,18,0,1,545,1101,10,522,1083,10,54.5,>30,ENG,Home,Upto 2014
L Hutton,ENG,Spin,1949-07-23,Manchester,England,1949,1,0,6,0,1,586,1224,13,586,1218,13,45.07692307692308,>30,ENG,Home,Upto 2014
L Hutton,ENG,Spin,1951-03-17,Christchurch,New Zealand,1951,1,7,18,0,1,586,1337,15,579,1319,15,39.06666666666667,>30,NZ,Away,Upto 2014
L Hutton,ENG,Spin,1954-03-17,Port of Spain,West Indies,1954,1,43,36,0,1,1025,1930,13,982,1894,13,78.84615384615384,>30,WI,Away,Upto 2014
L Hutton,ENG,Spin,1955-02-25,Sydney,Australia,1955,1,2,6,1,1,313,666,14,311,660,13,22.357142857142858,<=30,AUS,Away,Upto 2014
L Klusener,SA,Pace,1996-11-27,Eden Gardens,India,1996,2,139,213,8,1,704,1315,23,565,1102,15,30.608695652173914,>30,IND,Away,Upto 2014
L Klusener,SA,Pace,1996-12-08,Kanpur,India,1996,2,119,252,2,1,443,1201,16,324,949,14,27.6875,<=30,IND,Away,Upto 2014
L Klusener,SA,Pace,1996-12-26,Durban,South Africa,1996,2,24,97,3,1,537,1172,37,513,1075,34,14.513513513513514,<=30,SA,Home,Upto 2014
L Klusener,SA,Pace,1997-01-02,Cape Town,South Africa,1997,2,101,126,1,1,897,1609,22,796,1483,21,40.77272727272727,>30,SA,Home,Upto 2014
L Klusener,SA,Pace,1997-01-16,Johannesburg,South Africa,1997,2,116,240,3,1,895,1774,26,779,1534,23,34.42307692307692,>30,SA,Home,Upto 2014
L Klusener,SA,Pace,1997-02-28,Johannesburg,South Africa,1997,1,122,222,1,1,660,1282,14,538,1060,13,47.142857142857146,>30,SA,Home,Upto 2014
L Klusener,SA,Pace,1997-03-21,Centurion,South Africa,1997,2,63,177,3,1,500,1229,28,437,1052,25,17.857142857142858,<=30,SA,Home,Upto 2014
L Klusener,SA,Pace,1997-10-17,Sheikhupura,Pakistan,1997,1,14,36,0,1,127,240,3,113,204,3,42.333333333333336,>30,PAK,Away,Upto 2014
L Klusener,SA,Pace,1997-10-24,Faisalabad,Pakistan,1997,2,43,84,3,1,482,896,25,439,812,22,19.28,<=30,PAK,Away,Upto 2014
L Klusener,SA,Pace,1997-12-26,Melbourne,Australia,1997,2,76,168,1,1,627,1621,23,551,1453,22,27.26086956521739,<=30,AUS,Away,Upto 2014
L Klusener,SA,Pace,1998-01-30,Adelaide,Australia,1998,2,171,342,5,1,879,2002,24,708,1660,19,36.625,>30,AUS,Away,Upto 2014
L Klusener,SA,Pace,1998-02-14,Johannesburg,South Africa,1998,1,93,144,4,1,551,982,15,458,838,11,36.733333333333334,>30,SA,Home,Upto 2014
L Klusener,SA,Pace,1998-02-26,Durban,South Africa,1998,2,99,162,2,1,733,1519,29,634,1357,27,25.275862068965516,<=30,SA,Home,Upto 2014
L Klusener,SA,Pace,1998-06-04,Birmingham,England,1998,2,101,252,4,1,706,1575,23,605,1323,19,30.695652173913043,>30,ENG,Away,Upto 2014
L Klusener,SA,Pace,1998-06-18,Lord's,England,1998,2,64,186,2,1,618,1463,26,554,1277,24,23.76923076923077,<=30,ENG,Away,Upto 2014
L Klusener,SA,Pace,1998-07-02,Manchester,England,1998,2,52,102,0,1,671,1668,18,619,1566,18,37.27777777777778,>30,ENG,Away,Upto 2014
L Klusener,SA,Pace,1999-01-15,Centurion,South Africa,1999,2,77,174,3,1,776,1416,26,699,1242,23,29.846153846153847,<=30,SA,Home,Upto 2014
L Klusener,SA,Pace,1999-02-27,Auckland,New Zealand,1999,2,86,240,3,1,841,1949,13,755,1709,10,64.6923076923077,>30,NZ,Away,Upto 2014
L Klusener,SA,Pace,1999-03-11,Christchurch,New Zealand,1999,2,70,174,0,1,581,1404,8,511,1230,8,72.625,>30,NZ,Away,Upto 2014
L Klusener,SA,Pace,1999-03-18,Wellington,New Zealand,1999,2,48,156,0,1,742,1762,20,694,1606,20,37.1,>30,NZ,Away,Upto 2014
L Klusener,SA,Pace,1999-10-29,Bloemfontein,South Africa,1999,2,62,120,0,1,728,1549,24,666,1429,24,30.333333333333332,>30,SA,Home,Upto 2014
L Klusener,SA,Pace,1999-11-11,Harare,Zimbabwe,1999,2,68,126,4,1,560,1277,25,492,1151,21,22.4,<=30,ZIM,Away,Upto 2014
L Klusener,SA,Pace,1999-11-25,Johannesburg,South Africa,1999,2,85,150,0,1,668,1442,28,583,1292,28,23.857142857142858,<=30,SA,Home,Upto 2014
L Klusener,SA,Pace,1999-12-09,Gqeberha,South Africa,1999,2,65,234,0,1,939,2119,25,874,1885,25,37.56,>30,SA,Home,Upto 2014
L Klusener,SA,Pace,1999-12-26,Durban,South Africa,1999,1,38,102,0,1,784,1865,22,746,1763,22,35.63636363636363,>30,SA,Home,Upto 2014
L Klusener,SA,Pace,2000-01-02,Cape Town,South Africa,2000,2,50,138,4,1,594,1440,24,544,1302,20,24.75,<=30,SA,Home,Upto 2014
L Klusener,SA,Pace,2000-01-14,Centurion,South Africa,2000,1,38,84,1,1,437,835,14,399,751,13,31.214285714285715,>30,SA,Home,Upto 2014
L Klusener,SA,Pace,2000-02-24,Wankhede,India,2000,1,53,60,0,1,367,874,21,314,814,21,17.476190476190474,<=30,IND,Away,Upto 2014
L Klusener,SA,Pace,2000-07-20,Galle,Sri Lanka,2000,1,38,90,0,1,282,658,5,244,568,5,56.4,>30,SL,Away,Upto 2014
L Klusener,SA,Pace,2000-07-30,Kandy,Sri Lanka,2000,2,55,144,2,1,362,832,17,307,688,15,21.294117647058822,<=30,SL,Away,Upto 2014
L Klusener,SA,Pace,2000-08-06,Colombo (SSC),Sri Lanka,2000,2,56,127,1,1,430,969,14,374,842,13,30.714285714285715,>30,SL,Away,Upto 2014
L Klusener,SA,Pace,2000-11-17,Bloemfontein,South Africa,2000,2,27,78,0,1,906,1955,31,879,1877,31,29.225806451612904,<=30,SA,Home,Upto 2014
L Klusener,SA,Pace,2000-11-30,Gqeberha,South Africa,2000,2,16,93,3,1,698,1864,30,682,1771,27,23.266666666666666,<=30,SA,Home,Upto 2014
L Klusener,SA,Pace,2000-12-08,Johannesburg,South Africa,2000,1,43,72,1,1,417,1127,13,374,1055,12,32.07692307692308,>30,SA,Home,Upto 2014
L Klusener,SA,Pace,2000-12-26,Durban,South Africa,2000,2,27,96,1,1,618,1336,17,591,1240,16,36.35294117647059,>30,SA,Home,Upto 2014
L Klusener,SA,Pace,2001-03-09,Georgetown,West Indies,2001,2,83,258,2,1,709,1722,18,626,1464,16,39.388888888888886,>30,WI,Away,Upto 2014
L Klusener,SA,Pace,2001-03-17,Port of Spain,West Indies,2001,2,40,126,0,1,814,1972,34,774,1846,34,23.941176470588236,<=30,WI,Away,Upto 2014
L Klusener,SA,Pace,2001-03-29,Bridgetown,West Indies,2001,2,36,114,1,1,750,1752,22,714,1638,21,34.09090909090909,>30,WI,Away,Upto 2014
L Klusener,SA,Pace,2001-04-06,St John's,West Indies,2001,2,45,150,4,1,374,1261,23,329,1111,19,16.26086956521739,<=30,WI,Away,Upto 2014
L Klusener,SA,Pace,2001-04-19,Kingston,West Indies,2001,2,15,60,1,1,641,1770,33,626,1710,32,19.424242424242426,<=30,WI,Away,Upto 2014
L Klusener,SA,Pace,2001-09-07,Harare,Zimbabwe,2001,2,63,192,2,1,919,1718,19,856,1526,17,48.36842105263158,>30,ZIM,Away,Upto 2014
L Klusener,SA,Pace,2001-09-14,Bulawayo,Zimbabwe,2001,2,108,294,1,1,548,1308,7,440,1014,6,78.28571428571429,>30,ZIM,Away,Upto 2014
L Klusener,SA,Pace,2001-11-03,Bloemfontein,South Africa,2001,1,32,36,0,1,966,1509,27,934,1473,27,35.77777777777778,>30,SA,Home,Upto 2014
L Klusener,SA,Pace,2001-11-16,Gqeberha,South Africa,2001,2,21,48,0,1,644,1436,22,623,1388,22,29.272727272727273,<=30,SA,Home,Upto 2014
L Klusener,SA,Pace,2001-12-14,Adelaide,Australia,2001,2,71,108,2,1,773,1644,20,702,1536,18,38.65,>30,AUS,Away,Upto 2014
L Klusener,SA,Pace,2001-12-26,Melbourne,Australia,2001,1,11,42,0,1,710,1446,22,699,1404,22,32.27272727272727,>30,AUS,Away,Upto 2014
L Klusener,SA,Pace,2004-08-04,Galle,Sri Lanka,2004,2,109,198,2,1,548,1192,14,439,994,12,39.142857142857146,>30,SL,Away,Upto 2014
L Ngidi,SA,Pace,2018-01-13,Centurion,South Africa,2018,2,90,158,7,1,739,1521,29,649,1363,22,25.482758620689655,<=30,SA,Home,After 1965
L Ngidi,SA,Pace,2018-01-24,Johannesburg,South Africa,2018,2,65,162,2,1,749,1777,40,684,1615,38,18.725,<=30,SA,Home,After 1965
L Ngidi,SA,Pace,2018-03-09,Gqeberha,South Africa,2018,2,75,159,5,1,673,1296,28,598,1137,23,24.035714285714285,<=30,SA,Home,After 1965
L Ngidi,SA,Pace,2018-07-20,Colombo (SSC),Sri Lanka,2018,2,63,140,1,1,278,518,2,215,378,1,139.0,>30,SL,Away,After 1965
L Ngidi,SA,Pace,2019-10-19,Ranchi,India,2019,1,83,120,0,1,354,633,14,271,513,14,25.285714285714285,<=30,IND,Away,After 1965
L Ngidi,SA,Pace,2020-12-26,Centurion,South Africa,2020,2,102,174,3,1,827,1226,23,725,1052,20,35.95652173913044,>30,SA,Home,After 1965
L Ngidi,SA,Pace,2021-01-03,Johannesburg,South Africa,2021,2,88,150,4,1,660,1080,30,572,930,26,22.0,<=30,SA,Home,After 1965
L Ngidi,SA,Pace,2021-01-26,Karachi,Pakistan,2021,2,74,120,2,1,546,968,13,472,848,11,42.0,>30,PAK,Away,After 1965
L Ngidi,SA,Pace,2021-06-10,Gros Islet,West Indies,2021,2,50,161,5,1,458,958,27,408,797,22,16.962962962962962,<=30,WI,Away,After 1965
L Ngidi,SA,Pace,2021-06-18,Gros Islet,West Indies,2021,2,56,102,3,1,606,1318,31,550,1216,28,19.548387096774192,<=30,WI,Away,After 1965
L Ngidi,SA,Pace,2021-12-26,Centurion,South Africa,2021,2,102,204,8,1,741,1479,38,639,1275,30,19.5,<=30,SA,Home,After 1965
L Ngidi,SA,Pace,2022-01-03,Johannesburg,South Africa,2022,2,69,127,3,1,818,1482,32,749,1355,29,25.5625,<=30,SA,Home,After 1965
L Ngidi,SA,Pace,2022-01-11,Cape Town,South Africa,2022,2,54,171,4,1,686,1515,32,632,1344,28,21.4375,<=30,SA,Home,After 1965
L Ngidi,SA,Pace,2022-08-17,Lord's,England,2022,2,27,72,1,1,531,875,27,504,803,26,19.666666666666668,<=30,ENG,Away,After 1965
L Ngidi,SA,Pace,2022-08-25,Manchester,England,2022,1,61,108,1,1,514,991,25,453,883,24,20.56,<=30,ENG,Away,After 1965
L Ngidi,SA,Pace,2022-12-17,Brisbane,Australia,2022,1,35,54,1,1,432,770,30,397,716,29,14.4,<=30,AUS,Away,After 1965
L Ngidi,SA,Pace,2022-12-26,Melbourne,Australia,2022,1,98,133,1,1,684,1223,19,586,1090,18,36.0,>30,AUS,Away,After 1965
L Ngidi,SA,Pace,2024-01-03,Cape Town,South Africa,2024,1,30,36,3,1,441,642,32,411,606,29,13.78125,<=30,SA,Home,After 1965
L Ngidi,SA,Pace,2024-08-07,Port of Spain,West Indies,2024,2,51,101,1,1,444,843,12,393,742,11,37.0,>30,WI,Away,After 1965
L Ramji,IND,Pace,1933-12-15,Mumbai,India,1933,1,64,138,0,1,534,1100,19,470,962,19,28.105263157894736,<=30,IND,Home,Upto 2014
L Sipamla,SA,Pace,2020-12-26,Centurion,South Africa,2020,2,100,126,6,1,827,1226,23,727,1100,17,35.95652173913044,>30,SA,Home,After 1965
L Sipamla,SA,Pace,2021-01-03,Johannesburg,South Africa,2021,2,67,113,4,1,660,1080,30,593,967,26,22.0,<=30,SA,Home,After 1965
L Sipamla,SA,Pace,2022-02-25,Christchurch,New Zealand,2022,2,78,180,1,1,1098,2154,35,1020,1974,34,31.37142857142857,>30,NZ,Away,After 1965
L Sivaramakrishnan,IND,Spin,1983-04-28,St John's,West Indies,1983,1,95,150,0,1,460,934,5,365,784,5,92.0,>30,WI,Away,Upto 2014
L Sivaramakrishnan,IND,Spin,1984-11-28,Wankhede,India,1984,2,181,464,12,1,629,1557,23,448,1093,11,27.347826086956523,<=30,IND,Home,Upto 2014
L Sivaramakrishnan,IND,Spin,1984-12-12,Delhi,India,1984,2,140,343,7,1,622,1733,22,482,1390,15,28.272727272727273,<=30,IND,Home,Upto 2014
L Sivaramakrishnan,IND,Spin,1984-12-31,Eden Gardens,India,1984,1,90,168,2,1,444,1182,10,354,1014,8,44.4,>30,IND,Home,Upto 2014
L Sivaramakrishnan,IND,Spin,1985-01-13,Chennai,India,1985,2,157,288,2,1,779,1355,9,622,1067,7,86.55555555555556,>30,IND,Home,Upto 2014
L Sivaramakrishnan,IND,Spin,1985-01-31,Kanpur,India,1985,2,155,384,0,1,695,1644,9,540,1260,9,77.22222222222223,>30,IND,Home,Upto 2014
L Sivaramakrishnan,IND,Spin,1985-09-06,Colombo (PSS),Sri Lanka,1985,2,117,228,0,1,268,693,4,151,465,4,67.0,>30,SL,Away,Upto 2014
L Sivaramakrishnan,IND,Spin,1985-12-26,Melbourne,Australia,1985,2,94,156,3,1,583,1474,19,489,1318,16,30.68421052631579,>30,AUS,Away,Upto 2014
L Sivaramakrishnan,IND,Spin,1986-01-02,Sydney,Australia,1986,2,116,186,0,1,700,1797,15,584,1611,15,46.666666666666664,>30,AUS,Away,Upto 2014
L Tuckett,SA,Pace,1947-06-07,Nottingham,England,1947,2,195,504,6,1,512,1333,14,317,829,8,36.57142857142857,>30,ENG,Away,Upto 2014
L Tuckett,SA,Pace,1947-06-21,Lord's,England,1947,2,119,300,5,1,440,1124,10,321,824,5,44.0,>30,ENG,Away,Upto 2014
L Tuckett,SA,Pace,1947-07-05,Manchester,England,1947,2,174,330,4,1,744,1735,22,570,1405,18,33.81818181818182,>30,ENG,Away,Upto 2014
L Tuckett,SA,Pace,1947-07-26,Leeds,England,1947,2,60,144,0,1,268,799,16,208,655,16,16.75,<=30,ENG,Away,Upto 2014
L Tuckett,SA,Pace,1947-08-16,The Oval,England,1947,2,116,234,0,1,526,1254,9,410,1020,9,58.44444444444444,>30,ENG,Away,Upto 2014
L Tuckett,SA,Pace,1948-12-16,Durban,South Africa,1948,2,74,128,1,1,290,749,16,216,621,15,18.125,<=30,SA,Home,Upto 2014
L Tuckett,SA,Pace,1948-12-27,Johannesburg,South Africa,1948,1,55,96,0,1,428,1173,8,373,1077,8,53.5,>30,SA,Home,Upto 2014
L Tuckett,SA,Pace,1949-02-12,Johannesburg,South Africa,1949,2,152,312,3,1,558,1385,18,406,1073,15,31.0,>30,SA,Home,Upto 2014
L Tuckett,SA,Pace,1949-03-05,Gqeberha,South Africa,1949,2,35,56,0,1,319,1001,10,284,945,10,31.9,>30,SA,Home,Upto 2014
L Vincent,NZ,Pace,2005-04-11,Wellington,New Zealand,2005,1,2,6,0,1,716,1428,28,714,1422,28,25.571428571428573,<=30,NZ,Home,Upto 2014
LA Butterfield,NZ,Pace,1946-03-29,Wellington,New Zealand,1946,1,24,78,0,1,212,690,16,188,612,16,13.25,<=30,NZ,Home,Upto 2014
LA Dawson,ENG,Spin,2016-12-16,Chennai,India,2016,1,129,258,2,1,966,1770,17,837,1512,15,56.8235294117647,>30,IND,Away,After 1965
LA Dawson,ENG,Spin,2017-07-06,Lord's,England,2017,2,101,160,4,1,426,749,18,325,589,14,23.666666666666668,<=30,ENG,Home,After 1965
LA Dawson,ENG,Spin,2017-07-14,Nottingham,England,2017,2,68,108,1,1,230,384,11,162,276,10,20.90909090909091,<=30,ENG,Home,After 1965
LA King,WI,Pace,1962-04-13,Kingston,West Indies,1962,2,64,192,7,1,371,811,20,307,619,13,18.55,<=30,WI,Home,Upto 2014
LA King,WI,Pace,1968-03-28,Georgetown,West Indies,1968,2,90,284,2,1,579,1118,16,489,834,14,36.1875,>30,WI,Home,Upto 2014
LA Markham,SA,Spin,1949-02-12,Johannesburg,South Africa,1949,2,72,104,1,1,470,1288,10,398,1184,9,47.0,>30,SA,Home,Upto 2014
LA Stricker,SA,Spin,1910-01-01,Johannesburg,South Africa,1910,2,14,24,0,1,593,1077,29,579,1053,29,20.448275862068964,<=30,SA,Home,Upto 2014
LA Stricker,SA,Spin,1910-01-21,Durban,South Africa,1910,1,1,6,0,1,565,1312,24,564,1306,24,23.541666666666668,<=30,SA,Home,Upto 2014
LA Stricker,SA,Spin,1910-12-31,Melbourne,Australia,1910,2,46,72,1,1,675,1063,21,629,991,20,32.142857142857146,>30,AUS,Away,Upto 2014
LA Stricker,SA,Spin,1911-01-07,Adelaide,Australia,1911,1,4,6,0,1,814,1502,20,810,1496,20,40.7,>30,AUS,Away,Upto 2014
LA Stricker,SA,Spin,1911-02-17,Melbourne,Australia,1911,2,32,48,0,1,844,1322,23,812,1274,23,36.69565217391305,>30,AUS,Away,Upto 2014
LA Stricker,SA,Spin,1912-07-15,Lord's,England,1912,1,8,18,0,1,501,1026,19,493,1008,19,26.36842105263158,<=30,ENG,Away,Upto 2014
LA Walcott,WI,Spin,1930-01-11,Bridgetown,West Indies,1930,2,32,48,1,1,542,1217,16,510,1169,15,33.875,>30,WI,Home,Upto 2014
LB Taylor,ENG,Pace,1985-08-15,Birmingham,England,1985,2,105,234,1,1,829,1344,20,724,1110,19,41.45,>30,ENG,Home,Upto 2014
LB Taylor,ENG,Pace,1985-08-29,The Oval,England,1985,2,73,147,3,1,567,1067,25,494,920,22,22.68,<=30,ENG,Home,Upto 2014
LB Williams,SA,Pace,2022-03-31,Durban,South Africa,2022,1,54,113,3,1,457,911,16,403,798,13,28.5625,<=30,SA,Home,After 1965
LB Williams,SA,Pace,2022-04-08,Gqeberha,South Africa,2022,1,51,72,0,1,403,672,9,352,600,9,44.77777777777778,>30,SA,Home,After 1965
LC Braund,ENG,Spin,1901-12-13,Sydney,Australia,1901,2,101,262,7,1,360,868,16,259,606,9,22.5,<=30,AUS,Away,Upto 2014
LC Braund,ENG,Spin,1902-01-01,Melbourne,Australia,1902,1,114,320,1,1,445,1043,26,331,723,25,17.115384615384617,<=30,AUS,Away,Upto 2014
LC Braund,ENG,Spin,1902-01-17,Adelaide,Australia,1902,2,222,426,3,1,888,2292,24,666,1866,21,37.0,>30,AUS,Away,Upto 2014
LC Braund,ENG,Spin,1902-02-14,Sydney,Australia,1902,2,173,450,4,1,685,1842,29,512,1392,25,23.620689655172413,<=30,AUS,Away,Upto 2014
LC Braund,ENG,Spin,1902-02-28,Melbourne,Australia,1902,2,128,217,6,1,602,1354,31,474,1137,25,19.419354838709676,<=30,AUS,Away,Upto 2014
LC Braund,ENG,Spin,1902-05-29,Birmingham,England,1902,2,15,36,1,1,217,576,11,202,540,10,19.727272727272727,<=30,ENG,Home,Upto 2014
LC Braund,ENG,Spin,1902-07-03,Sheffield,England,1902,2,92,150,2,1,486,1005,28,394,855,26,17.357142857142858,<=30,ENG,Home,Upto 2014
LC Braund,ENG,Spin,1902-07-24,Manchester,England,1902,2,59,120,0,1,549,1292,26,490,1172,26,21.115384615384617,<=30,ENG,Home,Upto 2014
LC Braund,ENG,Spin,1902-08-11,The Oval,England,1902,2,44,155,4,1,548,1222,24,504,1067,20,22.833333333333332,<=30,ENG,Home,Upto 2014
LC Braund,ENG,Spin,1903-12-11,Sydney,Australia,1903,2,95,228,0,1,839,1769,19,744,1541,19,44.1578947368421,>30,AUS,Away,Upto 2014
LC Braund,ENG,Spin,1904-01-01,Melbourne,Australia,1904,1,20,30,0,1,442,925,27,422,895,27,16.37037037037037,<=30,AUS,Away,Upto 2014
LC Braund,ENG,Spin,1904-01-15,Adelaide,Australia,1904,2,106,204,2,1,537,1176,17,431,972,15,31.58823529411765,>30,AUS,Away,Upto 2014
LC Braund,ENG,Spin,1904-02-26,Sydney,Australia,1904,2,51,162,2,1,399,1183,23,348,1021,21,17.347826086956523,<=30,AUS,Away,Upto 2014
LC Braund,ENG,Spin,1904-03-05,Melbourne,Australia,1904,2,87,199,9,1,273,552,23,186,353,14,11.869565217391305,<=30,AUS,Away,Upto 2014
LC Braund,ENG,Spin,1907-07-01,Lord's,England,1907,2,36,66,1,1,478,962,15,442,896,14,31.866666666666667,>30,ENG,Home,Upto 2014
LC Braund,ENG,Spin,1907-08-19,The Oval,England,1907,1,5,6,0,1,462,1059,21,457,1053,21,22.0,<=30,ENG,Home,Upto 2014
LC Braund,ENG,Spin,1907-12-13,Sydney,Australia,1907,2,88,144,2,1,592,1308,17,504,1164,15,34.8235294117647,>30,AUS,Away,Upto 2014
LC Braund,ENG,Spin,1908-01-01,Melbourne,Australia,1908,2,109,204,0,1,799,1914,21,690,1710,21,38.04761904761905,>30,AUS,Away,Upto 2014
LC Braund,ENG,Spin,1908-01-10,Adelaide,Australia,1908,2,111,192,3,1,776,1611,17,665,1419,14,45.64705882352941,>30,AUS,Away,Upto 2014
LC Braund,ENG,Spin,1908-02-07,Melbourne,Australia,1908,2,90,114,0,1,481,1034,24,391,920,24,20.041666666666668,<=30,AUS,Away,Upto 2014
LC Braund,ENG,Spin,1908-02-21,Sydney,Australia,1908,1,64,120,0,1,812,1824,30,748,1704,30,27.066666666666666,<=30,AUS,Away,Upto 2014
LC Mayne,AUS,Pace,1965-03-03,Kingston,West Indies,1965,2,99,246,8,1,497,1218,24,398,972,16,20.708333333333332,<=30,WI,Away,Upto 2014
LC Mayne,AUS,Pace,1965-03-26,Port of Spain,West Indies,1965,2,102,168,1,1,537,1194,10,435,1026,9,53.7,>30,WI,Away,Upto 2014
LC Mayne,AUS,Pace,1965-04-14,Georgetown,West Indies,1965,2,60,84,0,1,434,874,16,374,790,16,27.125,<=30,WI,Away,Upto 2014
LC Mayne,AUS,Pace,1969-12-24,Chennai,India,1969,2,53,150,3,1,213,718,10,160,568,7,21.3,<=30,IND,Away,Upto 2014
LC Mayne,AUS,Pace,1970-02-19,Johannesburg,South Africa,1970,2,160,267,3,1,766,1822,28,606,1555,25,27.357142857142858,<=30,SA,Away,Upto 2014
LC Mayne,AUS,Pace,1970-03-05,Gqeberha,South Africa,1970,2,154,336,4,1,887,1974,33,733,1638,29,26.87878787878788,<=30,SA,Away,Upto 2014
LE Nagel,AUS,Pace,1932-12-02,Sydney,Australia,1932,1,110,262,2,1,694,1474,26,584,1212,24,26.692307692307693,<=30,AUS,Home,Upto 2014
LE Plunkett,ENG,Pace,2005-11-29,Lahore,Pakistan,2005,1,125,170,2,1,870,1496,17,745,1326,15,51.1764705882353,>30,PAK,Away,Upto 2014
LE Plunkett,ENG,Pace,2006-03-09,Mohali,India,2006,2,59,68,1,1,422,800,12,363,732,11,35.166666666666664,>30,IND,Away,Upto 2014
LE Plunkett,ENG,Pace,2006-05-11,Lord's,England,2006,2,137,252,1,1,982,1899,19,845,1647,18,51.68421052631579,>30,ENG,Home,Upto 2014
LE Plunkett,ENG,Pace,2006-05-25,Birmingham,England,2006,2,60,152,6,1,504,1093,20,444,941,14,25.2,<=30,ENG,Home,Upto 2014
LE Plunkett,ENG,Pace,2006-06-02,Nottingham,England,2006,2,101,164,4,1,634,1203,19,533,1039,15,33.36842105263158,>30,ENG,Home,Upto 2014
LE Plunkett,ENG,Pace,2006-07-13,Lord's,England,2006,2,119,198,2,1,919,1514,18,800,1316,16,51.05555555555556,>30,ENG,Home,Upto 2014
LE Plunkett,ENG,Pace,2007-05-17,Lord's,England,2007,2,155,246,2,1,1013,1620,14,858,1374,12,72.35714285714286,>30,ENG,Home,Upto 2014
LE Plunkett,ENG,Pace,2007-05-25,Leeds,England,2007,2,60,120,4,1,714,1084,23,654,964,19,31.043478260869566,>30,ENG,Home,Upto 2014
LE Plunkett,ENG,Pace,2007-06-07,Manchester,England,2007,2,100,168,1,1,901,1654,29,801,1486,28,31.06896551724138,>30,ENG,Home,Upto 2014
LE Plunkett,ENG,Pace,2014-06-12,Lord's,England,2014,2,155,288,2,1,1099,1996,30,944,1708,28,36.63333333333333,>30,ENG,Home,After 1965
LE Plunkett,ENG,Pace,2014-06-20,Leeds,England,2014,2,176,269,9,1,1059,2060,34,883,1791,25,31.147058823529413,>30,ENG,Home,After 1965
LE Plunkett,ENG,Pace,2014-07-09,Nottingham,England,2014,2,173,342,3,1,984,1979,23,811,1637,20,42.78260869565217,>30,ENG,Home,After 1965
LE Plunkett,ENG,Pace,2014-07-17,Lord's,England,2014,2,116,222,4,1,890,1823,32,774,1601,28,27.8125,<=30,ENG,Home,After 1965
LE Tapscott,SA,Spin,1923-02-16,Durban,South Africa,1923,1,2,12,0,1,141,426,6,139,414,6,23.5,<=30,SA,Home,Upto 2014
LF Kline,AUS,Spin,1957-12-23,Johannesburg,South Africa,1957,2,65,224,0,1,467,1272,8,402,1048,8,58.375,>30,SA,Away,Upto 2014
LF Kline,AUS,Spin,1957-12-31,Cape Town,South Africa,1957,2,47,237,6,1,376,1269,21,329,1032,15,17.904761904761905,<=30,SA,Away,Upto 2014
LF Kline,AUS,Spin,1958-01-24,Durban,South Africa,1958,1,36,136,0,1,339,1343,10,303,1207,10,33.9,>30,SA,Away,Upto 2014
LF Kline,AUS,Spin,1958-02-07,Johannesburg,South Africa,1958,2,64,200,5,1,358,1230,15,294,1030,10,23.866666666666667,<=30,SA,Away,Upto 2014
LF Kline,AUS,Spin,1958-02-28,Gqeberha,South Africa,1958,1,33,110,4,1,259,749,14,226,639,10,18.5,<=30,SA,Away,Upto 2014
LF Kline,AUS,Spin,1958-12-05,Brisbane,Australia,1958,1,34,112,0,1,271,1070,11,237,958,11,24.636363636363637,<=30,AUS,Home,Upto 2014
LF Kline,AUS,Spin,1958-12-31,Melbourne,Australia,1958,1,43,88,0,1,227,617,2,184,529,2,113.5,>30,AUS,Home,Upto 2014
LF Kline,AUS,Spin,1959-11-21,Lahore,Pakistan,1959,2,90,336,8,1,563,1378,18,473,1042,10,31.27777777777778,>30,PAK,Away,Upto 2014
LF Kline,AUS,Spin,1959-12-12,Delhi,India,1959,2,57,198,5,1,348,919,18,291,721,13,19.333333333333332,<=30,IND,Away,Upto 2014
LF Kline,AUS,Spin,1959-12-19,Kanpur,India,1959,2,50,132,1,1,496,1305,26,446,1173,25,19.076923076923077,<=30,IND,Away,Upto 2014
LF Kline,AUS,Spin,1960-01-13,Chennai,India,1960,2,34,162,2,1,351,1231,17,317,1069,15,20.647058823529413,<=30,IND,Away,Upto 2014
LF Kline,AUS,Spin,1960-12-09,Brisbane,Australia,1960,2,66,174,3,1,778,1958,13,712,1784,10,59.84615384615385,>30,AUS,Home,Upto 2014
LF Kline,AUS,Spin,1961-01-27,Adelaide,Australia,1961,2,157,264,0,1,1001,2526,24,844,2262,24,41.708333333333336,>30,AUS,Home,Upto 2014
LF Townsend,ENG,Spin,1930-02-21,Georgetown,West Indies,1930,2,73,141,4,1,461,1269,13,388,1128,9,35.46153846153846,>30,WI,Away,Upto 2014
LF Townsend,ENG,Spin,1933-12-15,Mumbai,India,1933,2,58,126,0,1,373,858,11,315,732,11,33.90909090909091,>30,IND,Away,Upto 2014
LF Townsend,ENG,Spin,1934-01-05,Eden Gardens,India,1934,2,41,96,2,1,342,922,15,301,826,13,22.8,<=30,IND,Away,Upto 2014
LF Townsend,ENG,Spin,1934-02-10,Chennai,India,1934,2,33,36,0,1,484,943,18,451,907,18,26.88888888888889,<=30,IND,Away,Upto 2014
LG Hylton,WI,Pace,1935-01-08,Bridgetown,West Indies,1935,2,56,93,4,1,205,438,22,149,345,18,9.318181818181818,<=30,WI,Home,Upto 2014
LG Hylton,WI,Pace,1935-01-24,Port of Spain,West Indies,1935,2,80,222,5,1,486,1307,22,406,1085,17,22.09090909090909,<=30,WI,Home,Upto 2014
LG Hylton,WI,Pace,1935-02-14,Georgetown,West Indies,1935,2,45,128,4,1,273,866,12,228,738,8,22.75,<=30,WI,Home,Upto 2014
LG Hylton,WI,Pace,1935-03-14,Kingston,West Indies,1935,2,70,138,0,1,412,902,15,342,764,15,27.466666666666665,<=30,WI,Home,Upto 2014
LG Hylton,WI,Pace,1939-06-24,Lord's,England,1939,2,134,248,2,1,652,1327,16,518,1079,14,40.75,>30,ENG,Away,Upto 2014
LG Hylton,WI,Pace,1939-07-22,Manchester,England,1939,2,33,136,1,1,257,788,18,224,652,17,14.277777777777779,<=30,ENG,Away,Upto 2014
LG Rowe,WI,Pace,1972-04-06,Georgetown,West Indies,1972,1,28,30,0,1,457,1170,6,429,1140,6,76.16666666666667,>30,WI,Home,Upto 2014
LG Rowe,WI,Pace,1974-02-16,Kingston,West Indies,1974,1,1,12,0,1,383,780,10,382,768,10,38.3,>30,WI,Home,Upto 2014
LG Rowe,WI,Pace,1974-03-06,Bridgetown,West Indies,1974,1,5,6,0,1,627,1356,14,622,1350,14,44.785714285714285,>30,WI,Home,Upto 2014
LG Rowe,WI,Pace,1975-12-26,Melbourne,Australia,1975,1,6,8,0,1,804,1499,27,798,1491,27,29.77777777777778,<=30,AUS,Away,Upto 2014
LG Rowe,WI,Pace,1980-02-22,Christchurch,New Zealand,1980,1,4,30,0,1,946,1857,20,942,1827,20,47.3,>30,NZ,Away,Upto 2014
LH Ferguson,NZ,Pace,2019-12-12,Perth,Australia,2019,1,47,66,0,1,626,1383,31,579,1317,31,20.193548387096776,<=30,AUS,Away,After 1965
LJ Coldwell,ENG,Pace,1962-06-21,Lord's,England,1962,2,110,330,9,1,524,1195,25,414,865,16,20.96,<=30,ENG,Home,Upto 2014
LJ Coldwell,ENG,Pace,1962-08-16,The Oval,England,1962,2,113,306,4,1,534,1069,17,421,763,13,31.41176470588235,>30,ENG,Home,Upto 2014
LJ Coldwell,ENG,Pace,1962-12-29,Melbourne,Australia,1962,2,118,336,2,1,758,2009,23,640,1673,21,32.95652173913044,>30,AUS,Away,Upto 2014
LJ Coldwell,ENG,Pace,1963-01-11,Sydney,Australia,1963,1,41,120,1,1,454,1207,16,413,1087,15,28.375,<=30,AUS,Away,Upto 2014
LJ Coldwell,ENG,Pace,1963-02-23,Auckland,New Zealand,1963,2,70,192,2,1,301,863,11,231,671,9,27.363636363636363,<=30,NZ,Away,Upto 2014
LJ Coldwell,ENG,Pace,1964-06-04,Nottingham,England,1964,1,48,132,3,1,492,1276,20,444,1144,17,24.6,<=30,ENG,Home,Upto 2014
LJ Coldwell,ENG,Pace,1964-06-18,Lord's,England,1964,2,110,252,1,1,401,987,19,291,735,18,21.105263157894736,<=30,ENG,Home,Upto 2014
LJ Johnson,AUS,Pace,1948-02-06,Melbourne,Australia,1948,2,74,282,6,1,469,1146,14,395,864,8,33.5,>30,AUS,Home,Upto 2014
LJ Nash,AUS,Pace,1932-02-12,Melbourne,Australia,1932,2,22,114,5,1,107,351,12,85,237,7,8.916666666666666,<=30,AUS,Home,Upto 2014
LJ Nash,AUS,Pace,1937-02-26,Melbourne,Australia,1937,2,104,197,5,1,632,1154,16,528,957,11,39.5,>30,AUS,Home,Upto 2014
LL Tsotsobe,SA,Pace,2010-06-10,Port of Spain,West Indies,2010,2,38,126,1,1,433,932,18,395,806,17,24.055555555555557,<=30,WI,Away,Upto 2014
LL Tsotsobe,SA,Pace,2010-06-18,Basseterre,West Indies,2010,1,68,168,1,1,644,1267,9,576,1099,8,71.55555555555556,>30,WI,Away,Upto 2014
LL Tsotsobe,SA,Pace,2010-12-16,Centurion,South Africa,2010,2,148,198,1,1,795,1278,19,647,1080,18,41.8421052631579,>30,SA,Home,Upto 2014
LL Tsotsobe,SA,Pace,2010-12-26,Durban,South Africa,2010,2,83,144,5,1,613,1119,31,530,975,26,19.774193548387096,<=30,SA,Home,Upto 2014
LL Tsotsobe,SA,Pace,2011-01-02,Cape Town,South Africa,2011,2,111,234,1,1,846,1680,22,735,1446,21,38.45454545454545,>30,SA,Home,Upto 2014
LL Wilkinson,ENG,Spin,1938-12-24,Johannesburg,South Africa,1938,2,111,240,2,1,478,1422,15,367,1182,13,31.866666666666667,>30,SA,Away,Upto 2014
LL Wilkinson,ENG,Spin,1939-01-20,Durban,South Africa,1939,2,115,261,4,1,407,989,9,292,728,5,45.22222222222222,>30,SA,Away,Upto 2014
LL Wilkinson,ENG,Spin,1939-02-18,Johannesburg,South Africa,1939,1,45,72,1,1,359,773,7,314,701,6,51.285714285714285,>30,SA,Away,Upto 2014
LM Jongwe,ZIM,Pace,2021-05-07,Harare,Zimbabwe,2021,1,68,102,1,1,481,1050,18,413,948,17,26.72222222222222,<=30,ZIM,Home,After 1965
LMP Simmons,WI,Pace,2009-03-06,Port of Spain,West Indies,2009,2,55,66,0,1,770,1390,15,715,1324,15,51.333333333333336,>30,WI,Home,Upto 2014
LMP Simmons,WI,Pace,2009-05-06,Lord's,England,2009,1,24,30,0,1,625,1023,22,601,993,22,28.40909090909091,<=30,ENG,Away,Upto 2014
LMP Simmons,WI,Pace,2009-05-14,Chester-le-Street,England,2009,1,60,84,1,1,746,1203,21,686,1119,20,35.523809523809526,>30,ENG,Away,Upto 2014
LMP Simmons,WI,Pace,2011-06-20,Kingston,West Indies,2011,1,8,12,0,1,535,1130,25,527,1118,25,21.4,<=30,WI,Home,Upto 2014
LN Constantine,WI,Pace,1928-06-23,Lord's,England,1928,1,82,160,4,1,399,886,12,317,726,8,33.25,>30,ENG,Away,Upto 2014
LN Constantine,WI,Pace,1928-07-21,Manchester,England,1928,1,89,150,1,1,337,660,7,248,510,6,48.142857142857146,>30,ENG,Away,Upto 2014
LN Constantine,WI,Pace,1928-08-11,The Oval,England,1928,1,91,120,0,1,476,809,16,385,689,16,29.75,<=30,ENG,Away,Upto 2014
LN Constantine,WI,Pace,1930-01-11,Bridgetown,West Indies,1930,2,168,306,3,1,797,1692,15,629,1386,12,53.13333333333333,>30,WI,Home,Upto 2014
LN Constantine,WI,Pace,1930-02-01,Port of Spain,West Indies,1930,2,207,337,6,1,688,1491,29,481,1154,23,23.724137931034484,<=30,WI,Home,Upto 2014
LN Constantine,WI,Pace,1930-02-21,Georgetown,West Indies,1930,2,122,339,9,1,688,1706,25,566,1367,16,27.52,<=30,WI,Home,Upto 2014
LN Constantine,WI,Pace,1930-12-12,Adelaide,Australia,1930,2,116,189,1,1,453,957,5,337,768,4,90.6,>30,AUS,Away,Upto 2014
LN Constantine,WI,Pace,1931-01-01,Sydney,Australia,1931,1,56,108,1,1,284,648,9,228,540,8,31.555555555555557,>30,AUS,Away,Upto 2014
LN Constantine,WI,Pace,1931-01-16,Brisbane,Australia,1931,1,74,156,1,1,443,984,16,369,828,15,27.6875,<=30,AUS,Away,Upto 2014
LN Constantine,WI,Pace,1931-02-13,Melbourne,Australia,1931,1,83,150,2,1,238,438,7,155,288,5,34.0,>30,AUS,Away,Upto 2014
LN Constantine,WI,Pace,1931-02-27,Sydney,Australia,1931,2,78,162,3,1,407,995,14,329,833,11,29.071428571428573,<=30,AUS,Away,Upto 2014
LN Constantine,WI,Pace,1933-07-22,Manchester,England,1933,1,55,150,1,1,416,958,13,361,808,12,32.0,>30,ENG,Away,Upto 2014
LN Constantine,WI,Pace,1935-01-24,Port of Spain,West Indies,1935,2,52,203,5,1,486,1307,22,434,1104,17,22.09090909090909,<=30,WI,Home,Upto 2014
LN Constantine,WI,Pace,1935-02-14,Georgetown,West Indies,1935,2,77,288,4,1,273,866,12,196,578,8,22.75,<=30,WI,Home,Upto 2014
LN Constantine,WI,Pace,1935-03-14,Kingston,West Indies,1935,2,68,194,6,1,412,902,15,344,708,9,27.466666666666665,<=30,WI,Home,Upto 2014
LN Constantine,WI,Pace,1939-06-24,Lord's,England,1939,2,78,128,0,1,652,1327,16,574,1199,16,40.75,>30,ENG,Away,Upto 2014
LN Constantine,WI,Pace,1939-07-22,Manchester,England,1939,2,78,144,5,1,257,788,18,179,644,13,14.277777777777779,<=30,ENG,Away,Upto 2014
LN Constantine,WI,Pace,1939-08-19,The Oval,England,1939,2,172,299,6,1,751,1240,17,579,941,11,44.1764705882353,>30,ENG,Away,Upto 2014
LO Fleetwood-Smith,AUS,Spin,1935-12-14,Durban,South Africa,1935,2,165,390,5,1,684,1775,22,519,1385,17,31.09090909090909,>30,SA,Away,Upto 2014
LO Fleetwood-Smith,AUS,Spin,1935-12-24,Johannesburg,South Africa,1935,2,114,162,1,1,577,1226,18,463,1064,17,32.05555555555556,>30,SA,Away,Upto 2014
LO Fleetwood-Smith,AUS,Spin,1936-01-01,Cape Town,South Africa,1936,2,101,182,3,1,468,1146,24,367,964,21,19.5,<=30,SA,Away,Upto 2014
LO Fleetwood-Smith,AUS,Spin,1937-01-01,Melbourne,Australia,1937,2,137,230,5,1,614,1405,21,477,1175,16,29.238095238095237,<=30,AUS,Home,Upto 2014
LO Fleetwood-Smith,AUS,Spin,1937-01-29,Adelaide,Australia,1937,2,239,572,10,1,554,1660,17,315,1088,7,32.588235294117645,>30,AUS,Home,Upto 2014
LO Fleetwood-Smith,AUS,Spin,1937-02-26,Melbourne,Australia,1937,2,87,250,4,1,349,938,13,262,688,9,26.846153846153847,<=30,AUS,Home,Upto 2014
LO Fleetwood-Smith,AUS,Spin,1938-06-10,Nottingham,England,1938,1,153,294,4,1,958,2061,18,805,1767,14,53.22222222222222,>30,ENG,Away,Upto 2014
LO Fleetwood-Smith,AUS,Spin,1938-06-24,Lord's,England,1938,2,169,245,2,1,622,1129,16,453,884,14,38.875,>30,ENG,Away,Upto 2014
LO Fleetwood-Smith,AUS,Spin,1938-07-22,Leeds,England,1938,2,107,246,7,1,387,966,24,280,720,17,16.125,<=30,ENG,Away,Upto 2014
LO Fleetwood-Smith,AUS,Spin,1938-08-20,The Oval,England,1938,1,298,522,1,1,776,1827,9,478,1305,8,86.22222222222223,>30,ENG,Away,Upto 2014
LPC Silva,SL,Spin,2007-12-09,Colombo (SSC),Sri Lanka,2007,1,57,78,1,1,447,920,9,390,842,8,49.666666666666664,>30,SL,Home,Upto 2014
LPC Silva,SL,Spin,2007-12-18,Galle,Sri Lanka,2007,1,3,12,0,1,195,456,4,192,444,4,48.75,>30,SL,Home,Upto 2014
LPC Silva,SL,Spin,2008-04-03,Port of Spain,West Indies,2008,1,5,12,0,1,206,431,7,201,419,7,29.428571428571427,<=30,WI,Away,Upto 2014
LR Gibbs,WI,Spin,1958-02-05,Port of Spain,West Indies,1958,2,70,155,4,1,477,1223,18,407,1068,14,26.5,<=30,WI,Home,Upto 2014
LR Gibbs,WI,Spin,1958-02-26,Kingston,West Indies,1958,2,78,168,2,1,450,846,3,372,678,1,150.0,>30,WI,Home,Upto 2014
LR Gibbs,WI,Spin,1958-03-13,Georgetown,West Indies,1958,2,136,432,7,1,1032,2327,20,896,1895,13,51.6,>30,WI,Home,Upto 2014
LR Gibbs,WI,Spin,1958-03-26,Port of Spain,West Indies,1958,1,108,246,4,1,527,1152,14,419,906,10,37.642857142857146,>30,WI,Home,Upto 2014
LR Gibbs,WI,Spin,1958-12-12,Kanpur,India,1958,2,61,180,0,1,669,1431,13,608,1251,13,51.46153846153846,>30,IND,Away,Upto 2014
LR Gibbs,WI,Spin,1959-02-20,Karachi,Pakistan,1959,2,100,272,3,1,375,1262,15,275,990,12,25.0,<=30,PAK,Away,Upto 2014
LR Gibbs,WI,Spin,1959-03-06,Dhaka,Bangladesh,1959,2,50,162,1,1,170,591,9,120,429,8,18.88888888888889,<=30,BAN,Away,Upto 2014
LR Gibbs,WI,Spin,1959-03-26,Lahore,Pakistan,1959,2,30,131,4,1,360,902,15,330,771,11,24.0,<=30,PAK,Away,Upto 2014
LR Gibbs,WI,Spin,1961-01-13,Sydney,Australia,1961,2,112,392,8,1,670,1732,26,558,1340,18,25.76923076923077,<=30,AUS,Away,Upto 2014
LR Gibbs,WI,Spin,1961-01-27,Adelaide,Australia,1961,2,141,510,5,1,1001,2526,24,860,2016,19,41.708333333333336,>30,AUS,Away,Upto 2014
LR Gibbs,WI,Spin,1961-02-10,Melbourne,Australia,1961,2,142,636,6,1,762,2498,25,620,1862,19,30.48,>30,AUS,Away,Upto 2014
LR Gibbs,WI,Spin,1962-02-16,Port of Spain,West Indies,1962,2,50,131,3,1,339,916,17,289,785,14,19.941176470588236,<=30,WI,Home,Upto 2014
LR Gibbs,WI,Spin,1962-03-07,Kingston,West Indies,1962,2,113,354,5,1,783,1924,16,670,1570,11,48.9375,>30,WI,Home,Upto 2014
LR Gibbs,WI,Spin,1962-03-23,Bridgetown,West Indies,1962,2,63,417,9,1,596,2431,22,533,2014,13,27.09090909090909,<=30,WI,Home,Upto 2014
LR Gibbs,WI,Spin,1962-04-04,Port of Spain,West Indies,1962,2,160,451,4,1,911,2452,24,751,2001,20,37.958333333333336,>30,WI,Home,Upto 2014
LR Gibbs,WI,Spin,1962-04-13,Kingston,West Indies,1962,2,104,236,3,1,527,1208,20,423,972,17,26.35,<=30,WI,Home,Upto 2014
LR Gibbs,WI,Spin,1963-06-06,Manchester,England,1963,2,157,453,11,1,595,1480,19,438,1027,8,31.31578947368421,>30,ENG,Away,Upto 2014
LR Gibbs,WI,Spin,1963-06-20,Lord's,England,1963,2,115,264,2,1,329,816,7,214,552,5,47.0,>30,ENG,Away,Upto 2014
LR Gibbs,WI,Spin,1963-07-04,Birmingham,England,1963,2,77,254,5,1,265,746,12,188,492,7,22.083333333333332,<=30,ENG,Away,Upto 2014
LR Gibbs,WI,Spin,1963-07-25,Leeds,England,1963,2,126,310,7,1,443,1017,19,317,707,12,23.31578947368421,<=30,ENG,Away,Upto 2014
LR Gibbs,WI,Spin,1963-08-22,The Oval,England,1963,2,79,216,1,1,379,930,8,300,714,7,47.375,>30,ENG,Away,Upto 2014
LR Gibbs,WI,Spin,1965-03-03,Kingston,West Indies,1965,2,40,150,1,1,482,1161,15,442,1011,14,32.13333333333333,>30,WI,Home,Upto 2014
LR Gibbs,WI,Spin,1965-03-26,Port of Spain,West Indies,1965,1,129,396,1,1,736,1898,17,607,1502,16,43.294117647058826,>30,WI,Home,Upto 2014
LR Gibbs,WI,Spin,1965-04-14,Georgetown,West Indies,1965,2,80,289,9,1,385,975,21,305,686,12,18.333333333333332,<=30,WI,Home,Upto 2014
LR Gibbs,WI,Spin,1965-05-05,Bridgetown,West Indies,1965,2,229,548,4,1,856,1946,10,627,1398,6,85.6,>30,WI,Home,Upto 2014
LR Gibbs,WI,Spin,1965-05-14,Port of Spain,West Indies,1965,2,78,288,3,1,396,885,11,318,597,8,36.0,>30,WI,Home,Upto 2014
LR Gibbs,WI,Spin,1966-06-02,Manchester,England,1966,2,106,415,10,1,479,1280,24,373,865,14,19.958333333333332,<=30,ENG,Away,Upto 2014
LR Gibbs,WI,Spin,1966-06-16,Lord's,England,1966,2,88,303,2,1,279,801,4,191,498,2,69.75,>30,ENG,Away,Upto 2014
LR Gibbs,WI,Spin,1966-06-30,Nottingham,England,1966,2,123,426,3,1,501,1422,8,378,996,5,62.625,>30,ENG,Away,Upto 2014
LR Gibbs,WI,Spin,1966-08-04,Leeds,England,1966,2,88,234,6,1,445,946,16,357,712,10,27.8125,<=30,ENG,Away,Upto 2014
LR Gibbs,WI,Spin,1966-08-18,The Oval,England,1966,1,115,264,0,1,515,1218,14,400,954,14,36.785714285714285,>30,ENG,Away,Upto 2014
LR Gibbs,WI,Spin,1966-12-13,Brabourne,India,1966,2,127,299,4,1,1023,2319,28,896,2020,24,36.535714285714285,>30,IND,Away,Upto 2014
LR Gibbs,WI,Spin,1966-12-31,Eden Gardens,India,1966,2,87,406,7,1,445,1335,20,358,929,13,22.25,<=30,IND,Away,Upto 2014
LR Gibbs,WI,Spin,1967-01-13,Chennai,India,1967,2,183,520,7,1,841,1944,23,658,1424,16,36.56521739130435,>30,IND,Away,Upto 2014
LR Gibbs,WI,Spin,1968-01-19,Port of Spain,West Indies,1968,1,147,378,3,1,688,1548,12,541,1170,9,57.333333333333336,>30,WI,Home,Upto 2014
LR Gibbs,WI,Spin,1968-02-08,Kingston,West Indies,1968,2,102,366,4,1,308,929,12,206,563,8,25.666666666666668,<=30,WI,Home,Upto 2014
LR Gibbs,WI,Spin,1968-02-29,Bridgetown,West Indies,1968,1,98,287,3,1,405,1049,8,307,762,5,50.625,>30,WI,Home,Upto 2014
LR Gibbs,WI,Spin,1968-03-14,Port of Spain,West Indies,1968,2,144,442,3,1,721,1580,15,577,1138,12,48.06666666666667,>30,WI,Home,Upto 2014
LR Gibbs,WI,Spin,1968-03-28,Georgetown,West Indies,1968,2,119,438,7,1,621,1884,22,502,1446,15,28.227272727272727,<=30,WI,Home,Upto 2014
LR Gibbs,WI,Spin,1968-12-06,Brisbane,Australia,1968,2,170,556,8,1,799,2162,28,629,1606,20,28.535714285714285,<=30,AUS,Away,Upto 2014
LR Gibbs,WI,Spin,1968-12-26,Melbourne,Australia,1968,1,139,344,4,1,459,1287,15,320,943,11,30.6,>30,AUS,Away,Upto 2014
LR Gibbs,WI,Spin,1969-01-03,Sydney,Australia,1969,1,124,302,2,1,463,1006,8,339,704,6,57.875,>30,AUS,Away,Upto 2014
LR Gibbs,WI,Spin,1969-01-24,Adelaide,Australia,1969,2,224,552,6,1,1020,2021,15,796,1469,9,68.0,>30,AUS,Away,Upto 2014
LR Gibbs,WI,Spin,1969-02-14,Sydney,Australia,1969,2,266,584,4,1,776,1562,17,510,978,13,45.64705882352941,>30,AUS,Away,Upto 2014
LR Gibbs,WI,Spin,1969-02-27,Auckland,New Zealand,1969,2,165,484,4,1,637,1524,17,472,1040,13,37.470588235294116,>30,NZ,Away,Upto 2014
LR Gibbs,WI,Spin,1969-03-07,Wellington,New Zealand,1969,2,91,229,1,1,243,621,7,152,392,6,34.714285714285715,>30,NZ,Away,Upto 2014
LR Gibbs,WI,Spin,1969-03-13,Christchurch,New Zealand,1969,2,106,347,3,1,515,1459,16,409,1112,13,32.1875,>30,NZ,Away,Upto 2014
LR Gibbs,WI,Spin,1969-06-12,Manchester,England,1969,1,96,360,2,1,322,1014,6,226,654,4,53.666666666666664,>30,ENG,Away,Upto 2014
LR Gibbs,WI,Spin,1969-06-26,Lord's,England,1969,2,146,412,2,1,394,1024,8,248,612,6,49.25,>30,ENG,Away,Upto 2014
LR Gibbs,WI,Spin,1969-07-10,Leeds,England,1969,2,75,240,2,1,278,822,14,203,582,12,19.857142857142858,<=30,ENG,Away,Upto 2014
LR Gibbs,WI,Spin,1971-03-19,Georgetown,West Indies,1971,2,65,240,0,1,785,2232,14,720,1992,14,56.07142857142857,>30,WI,Home,Upto 2014
LR Gibbs,WI,Spin,1972-02-16,Kingston,West Indies,1972,2,136,396,2,1,653,1794,11,517,1398,9,59.36363636363637,>30,WI,Home,Upto 2014
LR Gibbs,WI,Spin,1972-03-09,Port of Spain,West Indies,1972,2,131,384,1,1,722,2183,14,591,1799,13,51.57142857142857,>30,WI,Home,Upto 2014
LR Gibbs,WI,Spin,1973-02-16,Kingston,West Indies,1973,2,125,336,5,1,500,1086,7,375,750,2,71.42857142857143,>30,WI,Home,Upto 2014
LR Gibbs,WI,Spin,1973-03-09,Bridgetown,West Indies,1973,2,134,366,3,1,470,1314,10,336,948,7,47.0,>30,WI,Home,Upto 2014
LR Gibbs,WI,Spin,1973-03-23,Port of Spain,West Indies,1973,2,181,498,8,1,758,1913,26,577,1415,18,29.153846153846153,<=30,WI,Home,Upto 2014
LR Gibbs,WI,Spin,1973-04-06,Georgetown,West Indies,1973,2,76,246,3,1,241,564,5,165,318,2,48.2,>30,WI,Home,Upto 2014
LR Gibbs,WI,Spin,1973-04-21,Port of Spain,West Indies,1973,2,180,504,7,1,694,1730,21,514,1226,14,33.04761904761905,>30,WI,Home,Upto 2014
LR Gibbs,WI,Spin,1973-07-26,The Oval,England,1973,2,98,336,3,1,563,1459,15,465,1123,12,37.53333333333333,>30,ENG,Away,Upto 2014
LR Gibbs,WI,Spin,1973-08-09,Birmingham,England,1973,2,64,286,1,1,511,1445,13,447,1159,12,39.30769230769231,>30,ENG,Away,Upto 2014
LR Gibbs,WI,Spin,1973-08-23,Lord's,England,1973,2,65,189,5,1,503,859,9,438,670,4,55.888888888888886,>30,ENG,Away,Upto 2014
LR Gibbs,WI,Spin,1974-02-02,Port of Spain,West Indies,1974,2,113,362,7,1,671,1657,22,558,1295,15,30.5,>30,WI,Home,Upto 2014
LR Gibbs,WI,Spin,1974-02-16,Kingston,West Indies,1974,2,160,504,2,1,880,2436,16,720,1932,14,55.0,>30,WI,Home,Upto 2014
LR Gibbs,WI,Spin,1974-03-06,Bridgetown,West Indies,1974,2,131,373,3,1,534,1195,11,403,822,8,48.54545454545455,>30,WI,Home,Upto 2014
LR Gibbs,WI,Spin,1974-03-22,Georgetown,West Indies,1974,1,102,222,2,1,367,917,8,265,695,6,45.875,>30,WI,Home,Upto 2014
LR Gibbs,WI,Spin,1974-03-30,Port of Spain,West Indies,1974,2,155,507,4,1,805,2406,29,650,1899,25,27.75862068965517,<=30,WI,Home,Upto 2014
LR Gibbs,WI,Spin,1974-11-22,Bengaluru,India,1974,2,40,96,1,1,592,1136,16,552,1040,15,37.0,>30,IND,Away,Upto 2014
LR Gibbs,WI,Spin,1974-12-11,Delhi,India,1974,2,116,419,8,1,662,1469,18,546,1050,10,36.77777777777778,>30,IND,Away,Upto 2014
LR Gibbs,WI,Spin,1974-12-27,Eden Gardens,India,1974,2,87,324,2,1,505,1382,15,418,1058,13,33.666666666666664,>30,IND,Away,Upto 2014
LR Gibbs,WI,Spin,1975-01-11,Chennai,India,1975,2,68,228,1,1,340,944,19,272,716,18,17.894736842105264,<=30,IND,Away,Upto 2014
LR Gibbs,WI,Spin,1975-01-23,Wankhede,India,1975,2,143,492,9,1,833,1734,13,690,1242,4,64.07692307692308,>30,IND,Away,Upto 2014
LR Gibbs,WI,Spin,1975-02-15,Lahore,Pakistan,1975,2,72,212,2,1,210,572,5,138,360,3,42.0,>30,PAK,Away,Upto 2014
LR Gibbs,WI,Spin,1975-03-01,Karachi,Pakistan,1975,2,138,505,5,1,404,1072,11,266,567,6,36.72727272727273,>30,PAK,Away,Upto 2014
LR Gibbs,WI,Spin,1975-11-28,Brisbane,Australia,1975,2,150,464,6,1,448,1067,12,298,603,6,37.333333333333336,>30,AUS,Away,Upto 2014
LR Gibbs,WI,Spin,1975-12-12,W.A.C.A,Australia,1975,2,52,136,1,1,157,364,1,105,228,0,157.0,>30,AUS,Away,Upto 2014
LR Gibbs,WI,Spin,1975-12-26,Melbourne,Australia,1975,1,81,240,2,1,182,449,4,101,209,2,45.5,>30,AUS,Away,Upto 2014
LR Gibbs,WI,Spin,1976-01-03,Sydney,Australia,1976,2,56,152,0,1,129,289,2,73,137,2,64.5,>30,AUS,Away,Upto 2014
LR Gibbs,WI,Spin,1976-01-23,Adelaide,Australia,1976,2,183,469,5,1,343,701,9,160,232,4,38.111111111111114,>30,AUS,Away,Upto 2014
LR Gibbs,WI,Spin,1976-01-31,Melbourne,Australia,1976,2,130,400,2,1,294,648,6,164,248,4,49.0,>30,AUS,Away,Upto 2014
LR Johnson,WI,Spin,2014-09-13,Gros Islet,West Indies,2014,1,9,24,0,1,411,807,13,402,783,13,31.615384615384617,>30,WI,Home,After 1965
LR Pierre,WI,Pace,1948-03-03,Georgetown,West Indies,1948,2,28,42,0,1,265,632,11,237,590,11,24.09090909090909,<=30,WI,Home,Upto 2014
LR Tuckett,SA,Pace,1914-01-01,Johannesburg,South Africa,1914,2,69,120,0,1,545,1214,22,476,1094,22,24.772727272727273,<=30,SA,Home,Upto 2014
LRPL Taylor,NZ,Spin,2007-11-08,Johannesburg,South Africa,2007,1,10,20,0,1,163,386,3,153,366,3,54.333333333333336,>30,SA,Away,Upto 2014
LRPL Taylor,NZ,Spin,2009-03-26,Napier,New Zealand,2009,1,4,12,0,1,685,1306,9,681,1294,9,76.11111111111111,>30,NZ,Home,Upto 2014
LRPL Taylor,NZ,Spin,2010-11-04,Ahmedabad,India,2010,1,4,28,2,1,781,1719,18,777,1691,16,43.388888888888886,>30,IND,Away,Upto 2014
LRPL Taylor,NZ,Spin,2010-11-12,Hyderabad,India,2010,2,22,24,0,1,691,1414,15,669,1390,15,46.06666666666667,>30,IND,Away,Upto 2014
LRPL Taylor,NZ,Spin,2010-11-20,Nagpur,India,2010,1,3,6,0,1,493,909,15,490,903,15,32.86666666666667,>30,IND,Away,Upto 2014
LRPL Taylor,NZ,Spin,2013-10-09,Chattogram,Bangladesh,2013,1,5,6,0,1,1057,1946,22,1052,1940,22,48.04545454545455,>30,BAN,Away,Upto 2014
LRPL Taylor,NZ,Spin,2022-01-09,Christchurch,New Zealand,2022,1,0,3,1,1,174,231,2,174,228,1,87.0,>30,NZ,Home,After 1965
LS Baker,WI,Pace,2008-12-11,Dunedin,New Zealand,2008,1,85,150,0,1,619,1080,13,534,930,13,47.61538461538461,>30,NZ,Away,Upto 2014
LS Baker,WI,Pace,2009-03-06,Port of Spain,West Indies,2009,2,116,186,4,1,770,1390,15,654,1204,11,51.333333333333336,>30,WI,Home,Upto 2014
LS Baker,WI,Pace,2009-05-06,Lord's,England,2009,1,75,144,0,1,625,1023,22,550,879,22,28.40909090909091,<=30,ENG,Away,Upto 2014
LS Baker,WI,Pace,2009-05-14,Chester-le-Street,England,2009,1,119,180,1,1,746,1203,21,627,1023,20,35.523809523809526,>30,ENG,Away,Upto 2014
LS Birkett,WI,Pace,1930-12-12,Adelaide,Australia,1930,1,2,12,0,1,453,957,5,451,945,5,90.6,>30,AUS,Away,Upto 2014
LS Birkett,WI,Pace,1931-01-01,Sydney,Australia,1931,1,41,60,0,1,284,648,9,243,588,9,31.555555555555557,>30,AUS,Away,Upto 2014
LS Birkett,WI,Pace,1931-01-16,Brisbane,Australia,1931,1,16,42,1,1,443,984,16,427,942,15,27.6875,<=30,AUS,Away,Upto 2014
LS Birkett,WI,Pace,1931-02-13,Melbourne,Australia,1931,1,12,12,0,1,238,438,7,226,426,7,34.0,>30,AUS,Away,Upto 2014
LS Brown,SA,Spin,1931-12-18,Sydney,Australia,1931,1,100,174,1,1,364,897,16,264,723,15,22.75,<=30,AUS,Away,Upto 2014
LS Brown,SA,Spin,1932-03-04,Wellington,New Zealand,1932,2,89,144,2,1,627,1075,19,538,931,17,33.0,>30,NZ,Away,Upto 2014
LS Butler,WI,Pace,1955-04-11,Port of Spain,West Indies,1955,1,151,240,2,1,686,1163,14,535,923,12,49.0,>30,WI,Home,Upto 2014
LS Darling,AUS,Pace,1933-02-10,Brisbane,Australia,1933,1,4,12,0,1,508,1171,18,504,1159,18,28.22222222222222,<=30,AUS,Home,Upto 2014
LS Darling,AUS,Pace,1933-02-23,Sydney,Australia,1933,2,10,54,0,1,693,1194,12,683,1140,12,57.75,>30,AUS,Home,Upto 2014
LS Darling,AUS,Pace,1934-06-22,Lord's,England,1934,1,19,36,0,1,436,1038,10,417,1002,10,43.6,>30,ENG,Away,Upto 2014
LS Darling,AUS,Pace,1934-07-06,Manchester,England,1934,1,32,60,0,1,754,1551,6,722,1491,6,125.66666666666667,>30,ENG,Away,Upto 2014
LS Pascoe,AUS,Pace,1977-06-16,Lord's,England,1977,2,149,294,5,1,753,1756,32,604,1462,27,23.53125,<=30,ENG,Away,Upto 2014
LS Pascoe,AUS,Pace,1977-07-28,Nottingham,England,1977,2,123,324,4,1,788,1906,27,665,1582,23,29.185185185185187,<=30,ENG,Away,Upto 2014
LS Pascoe,AUS,Pace,1977-08-11,Leeds,England,1977,1,91,208,4,1,569,1338,25,478,1130,21,22.76,<=30,ENG,Away,Upto 2014
LS Pascoe,AUS,Pace,1980-01-04,Sydney,Australia,1980,2,90,192,4,1,548,1437,28,458,1245,24,19.571428571428573,<=30,AUS,Home,Upto 2014
LS Pascoe,AUS,Pace,1980-01-26,Adelaide,Australia,1980,2,183,243,3,1,844,1627,35,661,1384,32,24.114285714285714,<=30,AUS,Home,Upto 2014
LS Pascoe,AUS,Pace,1980-02-01,Melbourne,Australia,1980,2,151,371,6,1,694,1833,26,543,1462,20,26.692307692307693,<=30,AUS,Home,Upto 2014
LS Pascoe,AUS,Pace,1980-08-28,Lord's,England,1980,2,132,210,6,1,636,1262,19,504,1052,13,33.473684210526315,>30,ENG,Away,Upto 2014
LS Pascoe,AUS,Pace,1980-11-28,Brisbane,Australia,1980,2,71,193,5,1,530,1227,24,459,1034,19,22.083333333333332,<=30,AUS,Home,Upto 2014
LS Pascoe,AUS,Pace,1980-12-12,W.A.C.A,Australia,1980,2,91,180,4,1,516,1220,27,425,1040,23,19.11111111111111,<=30,AUS,Home,Upto 2014
LS Pascoe,AUS,Pace,1980-12-26,Melbourne,Australia,1980,2,110,222,3,1,683,1801,29,573,1579,26,23.551724137931036,<=30,AUS,Home,Upto 2014
LS Pascoe,AUS,Pace,1981-01-02,Sydney,Australia,1981,2,96,180,6,1,622,1071,25,526,891,19,24.88,<=30,AUS,Home,Upto 2014
LS Pascoe,AUS,Pace,1981-01-23,Adelaide,Australia,1981,2,94,168,5,1,673,1308,18,579,1140,13,37.388888888888886,>30,AUS,Home,Upto 2014
LS Pascoe,AUS,Pace,1981-02-07,Melbourne,Australia,1981,2,109,306,5,1,509,1262,25,400,956,20,20.36,<=30,AUS,Home,Upto 2014
LS Pascoe,AUS,Pace,1982-01-30,Adelaide,Australia,1982,2,178,312,4,1,872,1878,30,694,1566,26,29.066666666666666,<=30,AUS,Home,Upto 2014
LSM Miller,NZ,Spin,1954-01-29,Johannesburg,South Africa,1954,1,1,2,0,1,148,530,8,147,528,8,18.5,<=30,SA,Away,Upto 2014
LWS Kaluperuma,SL,Spin,1982-02-17,Colombo (PSS),Sri Lanka,1982,2,69,126,0,1,442,1264,21,373,1138,21,21.047619047619047,<=30,SL,Home,Upto 2014
LWS Kaluperuma,SL,Spin,1982-03-14,Faisalabad,Pakistan,1982,1,24,36,0,1,699,1740,27,675,1704,27,25.88888888888889,<=30,PAK,Away,Upto 2014
Liaqat Ali,PAK,Pace,1975-03-01,Karachi,Pakistan,1975,1,90,152,1,1,655,1306,12,565,1154,11,54.583333333333336,>30,PAK,Home,Upto 2014
Liaqat Ali,PAK,Pace,1977-12-14,Lahore,Pakistan,1977,1,43,216,1,1,359,1064,11,316,848,10,32.63636363636363,>30,PAK,Home,Upto 2014
Liaqat Ali,PAK,Pace,1978-01-02,Hyderabad (Sind),Pakistan,1978,2,32,80,0,1,260,806,5,228,726,5,52.0,>30,PAK,Home,Upto 2014
Liaqat Ali,PAK,Pace,1978-06-01,Birmingham,England,1978,1,114,252,1,1,618,1454,19,504,1202,18,32.526315789473685,>30,ENG,Away,Upto 2014
Liaqat Ali,PAK,Pace,1978-06-15,Lord's,England,1978,1,80,108,3,1,397,739,22,317,631,19,18.045454545454547,<=30,ENG,Away,Upto 2014
Litton Das,BAN,Spin,2022-12-14,Chattogram,Bangladesh,2022,1,13,12,0,1,800,1534,23,787,1522,23,34.78260869565217,>30,BAN,Home,After 1965
Lord Harris,ENG,Spin,1879-01-02,Melbourne,Australia,1879,1,14,12,0,1,184,410,8,170,398,8,23.0,<=30,AUS,Away,After 1965
Lord Harris,ENG,Spin,1884-08-11,The Oval,England,1884,1,15,20,0,1,469,1036,14,454,1016,14,33.5,>30,ENG,Home,After 1965
Lord Tennyson,ENG,Pace,1914-02-27,Gqeberha,South Africa,1914,1,1,6,0,1,418,956,19,417,950,19,22.0,<=30,SA,Away,Upto 2014
M Amarnath,IND,Pace,1969-12-24,Chennai,India,1969,2,52,186,2,1,213,718,10,161,532,8,21.3,<=30,IND,Home,Upto 2014
M Amarnath,IND,Pace,1976-01-24,Auckland,New Zealand,1976,2,24,48,0,1,264,671,8,240,623,8,33.0,>30,NZ,Away,Upto 2014
M Amarnath,IND,Pace,1976-02-05,Christchurch,New Zealand,1976,1,63,201,4,1,616,1431,23,553,1230,19,26.782608695652176,<=30,NZ,Away,Upto 2014
M Amarnath,IND,Pace,1976-02-13,Wellington,New Zealand,1976,1,60,146,1,1,457,1252,22,397,1106,21,20.772727272727273,<=30,NZ,Away,Upto 2014
M Amarnath,IND,Pace,1976-03-10,Bridgetown,West Indies,1976,1,53,72,2,1,313,600,12,260,528,10,26.083333333333332,<=30,WI,Away,Upto 2014
M Amarnath,IND,Pace,1976-03-24,Port of Spain,West Indies,1976,2,24,48,1,1,260,654,5,236,606,4,52.0,>30,WI,Away,Upto 2014
M Amarnath,IND,Pace,1976-04-07,Port of Spain,West Indies,1976,2,45,96,0,1,338,682,7,293,586,7,48.285714285714285,>30,WI,Away,Upto 2014
M Amarnath,IND,Pace,1976-04-21,Kingston,West Indies,1976,1,28,48,0,1,382,807,9,354,759,9,42.44444444444444,>30,WI,Away,Upto 2014
M Amarnath,IND,Pace,1976-11-10,Wankhede,India,1976,2,42,96,0,1,455,894,10,413,798,10,45.5,>30,IND,Home,Upto 2014
M Amarnath,IND,Pace,1976-11-18,Kanpur,India,1976,2,28,54,0,1,425,720,6,397,666,6,70.83333333333333,>30,IND,Home,Upto 2014
M Amarnath,IND,Pace,1976-11-26,Chennai,India,1976,2,23,66,0,1,298,829,13,275,763,13,22.923076923076923,<=30,IND,Home,Upto 2014
M Amarnath,IND,Pace,1976-12-17,Delhi,India,1976,1,12,48,0,1,217,567,13,205,519,13,16.692307692307693,<=30,IND,Home,Upto 2014
M Amarnath,IND,Pace,1977-01-14,Chennai,India,1977,2,44,126,0,1,275,772,15,231,646,15,18.333333333333332,<=30,IND,Home,Upto 2014
M Amarnath,IND,Pace,1977-12-02,Brisbane,Australia,1977,2,67,168,4,1,540,1279,27,473,1111,23,20.0,<=30,AUS,Away,Upto 2014
M Amarnath,IND,Pace,1977-12-16,W.A.C.A,Australia,1977,2,79,152,1,1,682,1283,21,603,1131,20,32.476190476190474,>30,AUS,Away,Upto 2014
M Amarnath,IND,Pace,1977-12-30,Melbourne,Australia,1977,1,10,24,0,1,588,1273,19,578,1249,19,30.94736842105263,>30,AUS,Away,Upto 2014
M Amarnath,IND,Pace,1978-01-07,Sydney,Australia,1978,2,15,96,1,1,322,871,11,307,775,10,29.272727272727273,<=30,AUS,Away,Upto 2014
M Amarnath,IND,Pace,1978-01-28,Adelaide,Australia,1978,2,57,128,1,1,564,1391,22,507,1263,21,25.636363636363637,<=30,AUS,Away,Upto 2014
M Amarnath,IND,Pace,1978-10-16,Faisalabad,Pakistan,1978,2,87,102,0,1,508,904,5,421,802,5,101.6,>30,PAK,Away,Upto 2014
M Amarnath,IND,Pace,1978-10-27,Lahore,Pakistan,1978,2,115,162,2,1,667,1298,21,552,1136,19,31.761904761904763,>30,PAK,Away,Upto 2014
M Amarnath,IND,Pace,1978-11-14,Karachi,Pakistan,1978,2,74,119,1,1,801,1525,25,727,1406,24,32.04,>30,PAK,Away,Upto 2014
M Amarnath,IND,Pace,1978-12-01,Wankhede,India,1978,1,12,18,0,1,499,1002,13,487,984,13,38.38461538461539,>30,IND,Home,Upto 2014
M Amarnath,IND,Pace,1979-02-02,Kanpur,India,1979,1,35,60,1,1,581,990,8,546,930,7,72.625,>30,IND,Home,Upto 2014
M Amarnath,IND,Pace,1979-07-12,Birmingham,England,1979,1,47,80,0,1,689,1489,22,642,1409,22,31.318181818181817,>30,ENG,Away,Upto 2014
M Amarnath,IND,Pace,1979-08-16,Leeds,England,1979,1,53,120,2,1,293,690,9,240,570,7,32.55555555555556,>30,ENG,Away,Upto 2014
M Amarnath,IND,Pace,1979-11-03,Wankhede,India,1979,2,12,42,0,1,295,643,9,283,601,9,32.77777777777778,>30,IND,Home,Upto 2014
M Amarnath,IND,Pace,1982-12-10,Lahore,Pakistan,1982,2,65,156,0,1,700,1379,14,635,1223,14,50.0,>30,PAK,Away,Upto 2014
M Amarnath,IND,Pace,1982-12-23,Karachi,Pakistan,1982,1,69,102,1,1,510,865,22,441,763,21,23.181818181818183,<=30,PAK,Away,Upto 2014
M Amarnath,IND,Pace,1983-01-03,Faisalabad,Pakistan,1983,1,68,96,0,1,934,1450,28,866,1354,28,33.357142857142854,>30,PAK,Away,Upto 2014
M Amarnath,IND,Pace,1983-01-14,Hyderabad (Sind),Pakistan,1983,1,64,90,0,1,503,996,17,439,906,17,29.58823529411765,<=30,PAK,Away,Upto 2014
M Amarnath,IND,Pace,1983-01-30,Karachi,Pakistan,1983,1,15,24,0,1,655,1382,13,640,1358,13,50.38461538461539,>30,PAK,Away,Upto 2014
M Amarnath,IND,Pace,1983-02-23,Kingston,West Indies,1983,1,34,14,2,1,545,1266,30,511,1252,28,18.166666666666668,<=30,WI,Away,Upto 2014
M Amarnath,IND,Pace,1983-10-21,Kanpur,India,1983,1,30,42,1,1,584,1065,26,554,1023,25,22.46153846153846,<=30,IND,Home,Upto 2014
M Amarnath,IND,Pace,1983-12-10,Eden Gardens,India,1983,1,19,42,0,1,475,988,25,456,946,25,19.0,<=30,IND,Home,Upto 2014
M Amarnath,IND,Pace,1984-10-17,Lahore,Pakistan,1984,1,19,24,0,1,564,1248,16,545,1224,16,35.25,>30,PAK,Away,Upto 2014
M Amarnath,IND,Pace,1984-10-24,Faisalabad,Pakistan,1984,1,36,53,0,1,679,1180,8,643,1127,8,84.875,>30,PAK,Away,Upto 2014
M Amarnath,IND,Pace,1984-11-28,Wankhede,India,1984,1,1,18,0,1,378,744,6,377,726,6,63.0,>30,IND,Home,Upto 2014
M Amarnath,IND,Pace,1984-12-12,Delhi,India,1984,1,6,12,0,1,406,798,8,400,786,8,50.75,>30,IND,Home,Upto 2014
M Amarnath,IND,Pace,1985-01-13,Chennai,India,1985,1,36,72,2,1,557,887,19,521,815,17,29.31578947368421,<=30,IND,Home,Upto 2014
M Amarnath,IND,Pace,1985-01-31,Kanpur,India,1985,1,6,24,0,1,413,773,9,407,749,9,45.888888888888886,>30,IND,Home,Upto 2014
M Amarnath,IND,Pace,1985-09-06,Colombo (PSS),Sri Lanka,1985,1,31,90,1,1,740,1533,28,709,1443,27,26.428571428571427,<=30,SL,Away,Upto 2014
M Amarnath,IND,Pace,1985-12-13,Adelaide,Australia,1985,1,9,18,0,1,620,1368,17,611,1350,17,36.470588235294116,>30,AUS,Away,Upto 2014
M Amarnath,IND,Pace,1985-12-26,Melbourne,Australia,1985,1,9,18,0,1,429,932,13,420,914,13,33.0,>30,AUS,Away,Upto 2014
M Amarnath,IND,Pace,1986-06-05,Lord's,England,1986,2,18,54,0,1,690,1580,26,672,1526,26,26.53846153846154,<=30,ENG,Away,Upto 2014
M Amarnath,IND,Pace,1986-07-03,Birmingham,England,1986,1,2,12,0,1,804,1599,21,802,1587,21,38.285714285714285,>30,ENG,Away,Upto 2014
M Amarnath,IND,Pace,1987-02-21,Jaipur,India,1987,1,15,48,1,1,305,699,6,290,651,5,50.833333333333336,>30,IND,Home,Upto 2014
M Amarnath,IND,Pace,1987-03-04,Ahmedabad,India,1987,2,20,66,1,1,194,539,11,174,473,10,17.636363636363637,<=30,IND,Home,Upto 2014
M Amarnath,IND,Pace,1987-03-13,Bengaluru,India,1987,1,7,18,0,1,134,282,5,127,264,5,26.8,<=30,IND,Home,Upto 2014
M Amarnath,IND,Pace,1987-12-26,Eden Gardens,India,1987,2,27,47,0,1,580,866,11,553,819,11,52.72727272727273,>30,IND,Home,Upto 2014
M Amarnath,IND,Pace,1988-01-11,Chennai,India,1988,2,15,30,0,1,358,643,15,343,613,15,23.866666666666667,<=30,IND,Home,Upto 2014
M Azharuddin,IND,Pace,1985-01-31,Kanpur,India,1985,1,8,6,0,1,413,773,9,405,767,9,45.888888888888886,>30,IND,Home,Upto 2014
M Azharuddin,IND,Pace,1992-12-26,Gqeberha,South Africa,1992,1,4,1,0,1,485,1194,23,481,1193,23,21.08695652173913,<=30,SA,Away,Upto 2014
M Azharuddin,IND,Pace,1997-11-19,Mohali,India,1997,1,4,6,0,1,565,1196,16,561,1190,16,35.3125,>30,IND,Home,Upto 2014
M Baqa Jilani,IND,Pace,1936-08-15,The Oval,England,1936,1,55,90,0,1,678,1230,17,623,1140,17,39.88235294117647,>30,ENG,Away,Upto 2014
M Dillon,WI,Pace,1997-03-14,Port of Spain,West Indies,1997,1,92,210,3,1,527,1480,12,435,1270,9,43.916666666666664,>30,WI,Home,Upto 2014
M Dillon,WI,Pace,1997-03-27,Bridgetown,West Indies,1997,1,56,114,1,1,738,1569,38,682,1455,37,19.42105263157895,<=30,WI,Home,Upto 2014
M Dillon,WI,Pace,1997-12-06,Karachi,Pakistan,1997,1,111,178,5,1,528,879,18,417,701,13,29.333333333333332,<=30,PAK,Away,Upto 2014
M Dillon,WI,Pace,1998-12-10,Gqeberha,South Africa,1998,2,80,120,1,1,639,1208,36,559,1088,35,17.75,<=30,SA,Away,Upto 2014
M Dillon,WI,Pace,1999-01-02,Cape Town,South Africa,1999,2,136,305,5,1,785,1771,27,649,1466,22,29.074074074074073,<=30,SA,Away,Upto 2014
M Dillon,WI,Pace,1999-01-15,Centurion,South Africa,1999,2,141,240,3,1,776,1416,26,635,1176,23,29.846153846153847,<=30,SA,Away,Upto 2014
M Dillon,WI,Pace,1999-03-05,Port of Spain,West Indies,1999,2,126,243,3,1,566,1392,32,440,1149,29,17.6875,<=30,WI,Home,Upto 2014
M Dillon,WI,Pace,2000-11-23,Brisbane,Australia,2000,1,79,150,3,1,456,1175,24,377,1025,21,19.0,<=30,AUS,Away,Upto 2014
M Dillon,WI,Pace,2000-12-01,W.A.C.A,Australia,2000,1,130,174,2,1,637,1158,23,507,984,21,27.695652173913043,<=30,AUS,Away,Upto 2014
M Dillon,WI,Pace,2000-12-15,Adelaide,Australia,2000,2,126,220,6,1,620,1329,20,494,1109,14,31.0,>30,AUS,Away,Upto 2014
M Dillon,WI,Pace,2000-12-26,Melbourne,Australia,2000,2,144,228,5,1,686,1407,27,542,1179,22,25.40740740740741,<=30,AUS,Away,Upto 2014
M Dillon,WI,Pace,2001-03-09,Georgetown,West Indies,2001,2,85,192,3,1,709,1722,18,624,1530,15,39.388888888888886,>30,WI,Home,Upto 2014
M Dillon,WI,Pace,2001-03-17,Port of Spain,West Indies,2001,2,132,270,3,1,814,1972,34,682,1702,31,23.941176470588236,<=30,WI,Home,Upto 2014
M Dillon,WI,Pace,2001-03-29,Bridgetown,West Indies,2001,2,154,228,4,1,750,1752,22,596,1524,18,34.09090909090909,>30,WI,Home,Upto 2014
M Dillon,WI,Pace,2001-04-06,St John's,West Indies,2001,2,50,113,3,1,374,1261,23,324,1148,20,16.26086956521739,<=30,WI,Home,Upto 2014
M Dillon,WI,Pace,2001-04-19,Kingston,West Indies,2001,2,91,205,7,1,641,1770,33,550,1565,26,19.424242424242426,<=30,WI,Home,Upto 2014
M Dillon,WI,Pace,2001-11-13,Galle,Sri Lanka,2001,1,121,306,2,1,470,944,10,349,638,8,47.0,>30,SL,Away,Upto 2014
M Dillon,WI,Pace,2001-11-21,Kandy,Sri Lanka,2001,2,115,234,5,1,410,847,17,295,613,12,24.11764705882353,<=30,SL,Away,Upto 2014
M Dillon,WI,Pace,2001-11-29,Colombo (SSC),Sri Lanka,2001,2,143,294,2,1,728,1313,22,585,1019,20,33.09090909090909,>30,SL,Away,Upto 2014
M Dillon,WI,Pace,2002-01-31,Sharjah,UAE,2002,2,186,354,5,1,822,1590,24,636,1236,19,34.25,>30,UAE,Away,Upto 2014
M Dillon,WI,Pace,2002-02-07,Sharjah,UAE,2002,2,120,270,5,1,615,1212,24,495,942,19,25.625,<=30,UAE,Away,Upto 2014
M Dillon,WI,Pace,2002-04-11,Georgetown,West Indies,2002,1,115,195,1,1,506,1071,12,391,876,11,42.166666666666664,>30,WI,Home,Upto 2014
M Dillon,WI,Pace,2002-04-19,Port of Spain,West Indies,2002,2,124,295,5,1,849,1915,33,725,1620,28,25.727272727272727,<=30,WI,Home,Upto 2014
M Dillon,WI,Pace,2002-05-02,Bridgetown,West Indies,2002,2,123,254,8,1,655,1356,22,532,1102,14,29.772727272727273,<=30,WI,Home,Upto 2014
M Dillon,WI,Pace,2002-05-10,St John's,West Indies,2002,1,116,306,3,1,856,1992,11,740,1686,8,77.81818181818181,>30,WI,Home,Upto 2014
M Dillon,WI,Pace,2002-05-18,Kingston,West Indies,2002,2,148,279,6,1,844,1737,30,696,1458,24,28.133333333333333,<=30,WI,Home,Upto 2014
M Dillon,WI,Pace,2002-06-21,Bridgetown,West Indies,2002,2,84,204,2,1,787,1616,30,703,1412,28,26.233333333333334,<=30,WI,Home,Upto 2014
M Dillon,WI,Pace,2002-10-09,Wankhede,India,2002,1,54,188,3,1,351,798,10,297,610,7,35.1,>30,IND,Away,Upto 2014
M Dillon,WI,Pace,2002-10-17,Chennai,India,2002,2,54,186,3,1,288,754,13,234,568,10,22.153846153846153,<=30,IND,Away,Upto 2014
M Dillon,WI,Pace,2002-10-30,Eden Gardens,India,2002,2,167,282,5,1,701,1322,15,534,1040,10,46.733333333333334,>30,IND,Away,Upto 2014
M Dillon,WI,Pace,2003-04-10,Georgetown,West Indies,2003,2,137,174,1,1,811,1248,21,674,1074,20,38.61904761904762,>30,WI,Home,Upto 2014
M Dillon,WI,Pace,2003-04-19,Port of Spain,West Indies,2003,2,188,283,4,1,913,1617,20,725,1334,16,45.65,>30,WI,Home,Upto 2014
M Dillon,WI,Pace,2003-05-09,St John's,West Indies,2003,2,165,282,6,1,870,1573,29,705,1291,23,30.0,<=30,WI,Home,Upto 2014
M Dillon,WI,Pace,2003-06-20,Gros Islet,West Indies,2003,2,72,204,0,1,539,1047,9,467,843,9,59.888888888888886,>30,WI,Home,Upto 2014
M Dillon,WI,Pace,2003-11-12,Bulawayo,Zimbabwe,2003,2,74,252,4,1,595,1210,25,521,958,21,23.8,<=30,ZIM,Away,Upto 2014
M Dillon,WI,Pace,2003-12-12,Johannesburg,South Africa,2003,2,122,276,2,1,1112,2121,34,990,1845,32,32.705882352941174,>30,SA,Away,Upto 2014
M Dillon,WI,Pace,2003-12-26,Durban,South Africa,2003,1,111,198,1,1,1030,1831,26,919,1633,25,39.61538461538461,>30,SA,Away,Upto 2014
M Dillon,WI,Pace,2004-01-16,Centurion,South Africa,2004,2,126,198,1,1,1068,1800,24,942,1602,23,44.5,>30,SA,Away,Upto 2014
M Hayward,SA,Pace,1999-12-09,Gqeberha,South Africa,1999,2,130,289,5,1,939,2119,25,809,1830,20,37.56,>30,SA,Home,Upto 2014
M Hayward,SA,Pace,1999-12-26,Durban,South Africa,1999,1,74,120,2,1,784,1865,22,710,1745,20,35.63636363636363,>30,SA,Home,Upto 2014
M Hayward,SA,Pace,2000-01-14,Centurion,South Africa,2000,1,61,103,3,1,437,835,14,376,732,11,31.214285714285715,>30,SA,Home,Upto 2014
M Hayward,SA,Pace,2000-03-02,Bengaluru,India,2000,2,71,186,2,1,357,999,12,286,813,10,29.75,<=30,IND,Away,Upto 2014
M Hayward,SA,Pace,2000-07-30,Kandy,Sri Lanka,2000,2,82,162,4,1,362,832,17,280,670,13,21.294117647058822,<=30,SL,Away,Upto 2014
M Hayward,SA,Pace,2000-08-06,Colombo (SSC),Sri Lanka,2000,2,89,174,3,1,430,969,14,341,795,11,30.714285714285715,>30,SL,Away,Upto 2014
M Hayward,SA,Pace,2001-11-03,Bloemfontein,South Africa,2001,2,144,261,5,1,966,1509,27,822,1248,22,35.77777777777778,>30,SA,Home,Upto 2014
M Hayward,SA,Pace,2001-11-16,Gqeberha,South Africa,2001,2,103,252,3,1,644,1436,22,541,1184,19,29.272727272727273,<=30,SA,Home,Upto 2014
M Hayward,SA,Pace,2001-12-14,Adelaide,Australia,2001,2,140,246,3,1,773,1644,20,633,1398,17,38.65,>30,AUS,Away,Upto 2014
M Hayward,SA,Pace,2001-12-26,Melbourne,Australia,2001,1,109,156,2,1,710,1446,22,601,1290,20,32.27272727272727,>30,AUS,Away,Upto 2014
M Hayward,SA,Pace,2002-10-18,East London,South Africa,2002,2,115,186,4,1,686,1167,21,571,981,17,32.666666666666664,>30,SA,Home,Upto 2014
M Hayward,SA,Pace,2002-10-25,Potchefstroom,South Africa,2002,2,80,132,4,1,588,1047,21,508,915,17,28.0,<=30,SA,Home,Upto 2014
M Hayward,SA,Pace,2002-12-26,Durban,South Africa,2002,2,119,142,7,1,631,1153,23,512,1011,16,27.434782608695652,<=30,SA,Home,Upto 2014
M Hayward,SA,Pace,2003-01-02,Cape Town,South Africa,2003,2,100,156,3,1,694,1175,21,594,1019,18,33.04761904761905,>30,SA,Home,Upto 2014
M Hayward,SA,Pace,2004-08-04,Galle,Sri Lanka,2004,2,102,136,3,1,548,1192,14,446,1056,11,39.142857142857146,>30,SL,Away,Upto 2014
M Hayward,SA,Pace,2004-08-11,Colombo (SSC),Sri Lanka,2004,2,90,120,1,1,548,1014,21,458,894,20,26.095238095238095,<=30,SL,Away,Upto 2014
M Henderson,NZ,Pace,1930-01-10,Christchurch,New Zealand,1930,2,64,90,2,1,310,868,23,246,778,21,13.478260869565217,<=30,NZ,Home,Upto 2014
M Hendrick,ENG,Pace,1974-06-06,Manchester,England,1974,2,96,222,4,1,464,1137,20,368,915,16,23.2,<=30,ENG,Home,Upto 2014
M Hendrick,ENG,Pace,1974-06-20,Lord's,England,1974,2,48,114,3,1,408,797,19,360,683,16,21.473684210526315,<=30,ENG,Home,Upto 2014
M Hendrick,ENG,Pace,1974-07-04,Birmingham,England,1974,2,71,174,7,1,333,648,16,262,474,9,20.8125,<=30,ENG,Home,Upto 2014
M Hendrick,ENG,Pace,1974-07-25,Leeds,England,1974,2,130,264,5,1,703,1746,31,573,1482,26,22.677419354838708,<=30,ENG,Home,Upto 2014
M Hendrick,ENG,Pace,1974-08-08,Lord's,England,1974,2,65,144,1,1,356,858,8,291,714,7,44.5,>30,ENG,Home,Upto 2014
M Hendrick,ENG,Pace,1974-11-29,Brisbane,Australia,1974,2,111,256,2,1,649,1743,27,538,1487,25,24.037037037037038,<=30,AUS,Away,Upto 2014
M Hendrick,ENG,Pace,1974-12-26,Melbourne,Australia,1974,1,8,22,0,1,489,1257,19,481,1235,19,25.736842105263158,<=30,AUS,Away,Upto 2014
M Hendrick,ENG,Pace,1975-02-28,Christchurch,New Zealand,1975,1,89,160,2,1,449,1000,7,360,840,5,64.14285714285714,>30,NZ,Away,Upto 2014
M Hendrick,ENG,Pace,1976-06-03,Nottingham,England,1976,2,81,186,1,1,773,1761,21,692,1575,20,36.80952380952381,>30,ENG,Home,Upto 2014
M Hendrick,ENG,Pace,1976-07-08,Manchester,England,1976,2,111,228,3,1,437,1066,29,326,838,26,15.068965517241379,<=30,ENG,Home,Upto 2014
M Hendrick,ENG,Pace,1977-07-28,Nottingham,England,1977,2,102,320,4,1,788,1906,27,686,1586,23,29.185185185185187,<=30,ENG,Home,Upto 2014
M Hendrick,ENG,Pace,1977-08-11,Leeds,England,1977,2,95,230,8,1,569,1338,25,474,1108,17,22.76,<=30,ENG,Home,Upto 2014
M Hendrick,ENG,Pace,1977-08-25,The Oval,England,1977,1,93,222,2,1,507,1259,20,414,1037,18,25.35,<=30,ENG,Home,Upto 2014
M Hendrick,ENG,Pace,1978-02-10,Wellington,New Zealand,1978,2,62,216,2,1,523,1920,38,461,1704,36,13.763157894736842,<=30,NZ,Away,Upto 2014
M Hendrick,ENG,Pace,1978-08-10,Nottingham,England,1978,2,48,210,2,1,554,1523,20,506,1313,18,27.7,<=30,ENG,Home,Upto 2014
M Hendrick,ENG,Pace,1978-08-24,Lord's,England,1978,1,39,168,1,1,614,1515,29,575,1347,28,21.17241379310345,<=30,ENG,Home,Upto 2014
M Hendrick,ENG,Pace,1978-12-15,W.A.C.A,Australia,1978,2,50,176,4,1,652,1878,31,602,1702,27,21.032258064516128,<=30,AUS,Away,Upto 2014
M Hendrick,ENG,Pace,1978-12-29,Melbourne,Australia,1978,2,75,296,4,1,456,1463,27,381,1167,23,16.88888888888889,<=30,AUS,Away,Upto 2014
M Hendrick,ENG,Pace,1979-01-06,Sydney,Australia,1979,2,67,272,4,1,452,1414,19,385,1142,15,23.789473684210527,<=30,AUS,Away,Upto 2014
M Hendrick,ENG,Pace,1979-01-27,Adelaide,Australia,1979,2,64,264,5,1,561,1654,30,497,1390,25,18.7,<=30,AUS,Away,Upto 2014
M Hendrick,ENG,Pace,1979-02-10,Sydney,Australia,1979,2,43,152,2,1,293,735,11,250,583,9,26.636363636363637,<=30,AUS,Away,Upto 2014
M Hendrick,ENG,Pace,1979-07-12,Birmingham,England,1979,2,81,269,6,1,689,1489,22,608,1220,16,31.318181818181817,>30,ENG,Home,Upto 2014
M Hendrick,ENG,Pace,1979-08-02,Lord's,England,1979,2,71,240,2,1,523,1253,16,452,1013,14,32.6875,>30,ENG,Home,Upto 2014
M Hendrick,ENG,Pace,1979-08-16,Leeds,England,1979,1,13,84,1,1,293,690,9,280,606,8,32.55555555555556,>30,ENG,Home,Upto 2014
M Hendrick,ENG,Pace,1979-08-30,The Oval,England,1979,2,53,183,3,1,700,1610,24,647,1427,21,29.166666666666668,<=30,ENG,Home,Upto 2014
M Hendrick,ENG,Pace,1980-06-05,Nottingham,England,1980,2,109,198,2,1,897,2129,36,788,1931,34,24.916666666666668,<=30,ENG,Home,Upto 2014
M Hendrick,ENG,Pace,1980-06-19,Lord's,England,1980,1,32,66,0,1,667,1407,18,635,1341,18,37.05555555555556,>30,ENG,Home,Upto 2014
M Hendrick,ENG,Pace,1980-08-28,Lord's,England,1980,2,120,270,1,1,636,1262,19,516,992,18,33.473684210526315,>30,ENG,Home,Upto 2014
M Hendrick,ENG,Pace,1981-06-18,Nottingham,England,1981,2,76,240,2,1,571,1418,36,495,1178,34,15.86111111111111,<=30,ENG,Home,Upto 2014
M Hendrick,ENG,Pace,1981-08-27,The Oval,England,1981,2,145,362,4,1,972,2088,35,827,1726,31,27.771428571428572,<=30,ENG,Home,Upto 2014
M Jahangir Khan,IND,Pace,1932-06-25,Lord's,England,1932,2,86,282,4,1,543,1480,28,457,1198,24,19.392857142857142,<=30,ENG,Away,Upto 2014
M Jahangir Khan,IND,Pace,1936-06-27,Lord's,England,1936,2,47,114,0,1,273,772,20,226,658,20,13.65,<=30,ENG,Away,Upto 2014
M Jahangir Khan,IND,Pace,1936-07-25,Manchester,England,1936,1,57,108,0,1,650,1176,8,593,1068,8,81.25,>30,ENG,Away,Upto 2014
M Jahangir Khan,IND,Pace,1936-08-15,The Oval,England,1936,1,65,102,0,1,678,1230,17,613,1128,17,39.88235294117647,>30,ENG,Away,Upto 2014
M Jansen,SA,Pace,2021-12-26,Centurion,South Africa,2021,2,124,192,5,1,741,1479,38,617,1287,33,19.5,<=30,SA,Home,After 1965
M Jansen,SA,Pace,2022-01-03,Johannesburg,South Africa,2022,2,98,204,7,1,818,1482,32,720,1278,25,25.5625,<=30,SA,Home,After 1965
M Jansen,SA,Pace,2022-01-11,Cape Town,South Africa,2022,2,91,225,7,1,686,1515,32,595,1290,25,21.4375,<=30,SA,Home,After 1965
M Jansen,SA,Pace,2022-02-17,Christchurch,New Zealand,2022,1,96,179,2,1,630,1205,28,534,1026,26,22.5,<=30,NZ,Away,After 1965
M Jansen,SA,Pace,2022-02-25,Christchurch,New Zealand,2022,2,161,270,7,1,1098,2154,35,937,1884,28,31.37142857142857,>30,NZ,Away,After 1965
M Jansen,SA,Pace,2022-08-17,Lord's,England,2022,2,43,70,4,1,531,875,27,488,805,23,19.666666666666668,<=30,ENG,Away,After 1965
M Jansen,SA,Pace,2022-09-08,The Oval,England,2022,2,75,119,5,1,547,897,31,472,778,26,17.64516129032258,<=30,ENG,Away,After 1965
M Jansen,SA,Pace,2022-12-17,Brisbane,Australia,2022,1,32,54,3,1,432,770,30,400,716,27,14.4,<=30,AUS,Away,After 1965
M Jansen,SA,Pace,2022-12-26,Melbourne,Australia,2022,1,89,168,1,1,684,1223,19,595,1055,18,36.0,>30,AUS,Away,After 1965
M Jansen,SA,Pace,2023-01-04,Sydney,Australia,2023,1,79,150,0,1,386,804,12,307,654,12,32.166666666666664,>30,AUS,Away,After 1965
M Jansen,SA,Pace,2023-02-28,Centurion,South Africa,2023,2,97,144,3,1,738,1209,39,641,1065,36,18.923076923076923,<=30,SA,Home,After 1965
M Jansen,SA,Pace,2023-12-26,Centurion,South Africa,2023,2,88,139,4,1,718,1149,27,630,1010,23,26.59259259259259,<=30,SA,Home,After 1965
M Jansen,SA,Pace,2024-01-03,Cape Town,South Africa,2024,2,44,66,1,1,441,642,32,397,576,31,13.78125,<=30,SA,Home,After 1965
M Jansen,SA,Pace,2024-11-27,Durban,South Africa,2024,2,86,171,11,1,556,1001,29,470,830,18,19.17241379310345,<=30,SA,Home,After 1965
M Jansen,SA,Pace,2024-12-05,Gqeberha,South Africa,2024,2,154,211,3,1,793,1361,26,639,1150,23,30.5,>30,SA,Home,After 1965
M Jansen,SA,Pace,2024-12-26,Centurion,South Africa,2024,2,95,159,7,1,742,1206,32,647,1047,25,23.1875,<=30,SA,Home,After 1965
M Jansen,SA,Pace,2025-01-03,Cape Town,South Africa,2025,2,137,216,3,1,862,1222,17,725,1006,14,50.705882352941174,>30,SA,Home,After 1965
M Kaif,IND,Spin,2000-03-02,Bengaluru,India,2000,1,4,18,0,1,474,1252,16,470,1234,16,29.625,<=30,IND,Home,Upto 2014
M Kartik,IND,Spin,2000-02-24,Wankhede,India,2000,2,78,222,3,1,274,666,12,196,444,9,22.833333333333332,<=30,IND,Home,Upto 2014
M Kartik,IND,Spin,2000-03-02,Bengaluru,India,2000,1,123,300,3,1,474,1252,16,351,952,13,29.625,<=30,IND,Home,Upto 2014
M Kartik,IND,Spin,2000-11-10,Dhaka,Bangladesh,2000,2,42,153,1,1,558,1251,19,516,1098,18,29.36842105263158,<=30,BAN,Away,Upto 2014
M Kartik,IND,Spin,2000-11-18,Delhi,India,2000,2,66,210,2,1,622,1309,9,556,1099,7,69.11111111111111,>30,IND,Home,Upto 2014
M Kartik,IND,Spin,2004-01-02,Sydney,Australia,2004,2,211,270,1,1,831,1277,14,620,1007,13,59.357142857142854,>30,AUS,Away,Upto 2014
M Kartik,IND,Spin,2004-10-26,Nagpur,India,2004,2,131,276,5,1,469,867,12,338,591,7,39.083333333333336,>30,IND,Home,Upto 2014
M Kartik,IND,Spin,2004-11-03,Wankhede,India,2004,2,76,165,7,1,365,706,29,289,541,22,12.586206896551724,<=30,IND,Home,Upto 2014
M Kartik,IND,Spin,2004-11-20,Kanpur,India,2004,2,93,336,2,1,586,1360,13,493,1024,11,45.07692307692308,>30,IND,Home,Upto 2014
M Labuschagne,AUS,Spin,2018-10-07,Dubai (DICS),UAE,2018,2,38,66,2,1,793,1735,21,755,1669,19,37.76190476190476,>30,UAE,Away,After 1965
M Labuschagne,AUS,Spin,2018-10-16,Abu Dhabi,UAE,2018,2,119,168,5,1,566,1108,20,447,940,15,28.3,<=30,UAE,Away,After 1965
M Labuschagne,AUS,Spin,2019-01-03,Sydney,Australia,2019,1,76,96,0,1,448,853,11,372,757,11,40.72727272727273,>30,AUS,Home,After 1965
M Labuschagne,AUS,Spin,2019-02-01,Canberra,Australia,2019,2,11,30,2,1,375,678,4,364,648,2,93.75,>30,AUS,Home,After 1965
M Labuschagne,AUS,Spin,2019-08-22,Leeds,England,2019,1,16,36,0,1,178,342,3,162,306,3,59.333333333333336,>30,ENG,Away,After 1965
M Labuschagne,AUS,Spin,2019-09-04,Manchester,England,2019,1,9,24,1,1,337,685,7,328,661,6,48.142857142857146,>30,ENG,Away,After 1965
M Labuschagne,AUS,Spin,2019-09-12,The Oval,England,2019,2,31,48,0,1,205,441,10,174,393,10,20.5,<=30,ENG,Away,After 1965
M Labuschagne,AUS,Spin,2019-11-21,Brisbane,Australia,2019,2,62,78,0,1,515,790,8,453,712,8,64.375,>30,AUS,Home,After 1965
M Labuschagne,AUS,Spin,2019-11-29,Adelaide,Australia,2019,2,41,78,0,1,462,654,5,421,576,5,92.4,>30,AUS,Home,After 1965
M Labuschagne,AUS,Spin,2019-12-12,Perth,Australia,2019,2,22,60,1,1,325,635,8,303,575,7,40.625,>30,AUS,Home,After 1965
M Labuschagne,AUS,Spin,2019-12-26,Melbourne,Australia,2019,1,11,18,1,1,244,396,6,233,378,5,40.666666666666664,>30,AUS,Home,After 1965
M Labuschagne,AUS,Spin,2020-01-03,Sydney,Australia,2020,2,28,54,0,1,444,825,14,416,771,14,31.714285714285715,>30,AUS,Home,After 1965
M Labuschagne,AUS,Spin,2020-12-17,Adelaide,Australia,2020,1,3,6,0,1,142,276,6,139,270,6,23.666666666666668,<=30,AUS,Home,After 1965
M Labuschagne,AUS,Spin,2020-12-26,Melbourne,Australia,2020,1,9,6,0,1,235,670,11,226,664,11,21.363636363636363,<=30,AUS,Home,After 1965
M Labuschagne,AUS,Spin,2021-01-07,Sydney,Australia,2021,2,20,42,0,1,452,906,8,432,864,8,56.5,>30,AUS,Home,After 1965
M Labuschagne,AUS,Spin,2021-01-15,Brisbane,Australia,2021,2,4,12,0,1,324,661,7,320,649,7,46.285714285714285,>30,AUS,Home,After 1965
M Labuschagne,AUS,Spin,2021-12-08,Brisbane,Australia,2021,1,14,18,0,1,257,390,6,243,372,6,42.833333333333336,>30,AUS,Home,After 1965
M Labuschagne,AUS,Spin,2021-12-16,Adelaide,Australia,2021,1,10,24,0,1,255,630,10,245,606,10,25.5,<=30,AUS,Home,After 1965
M Labuschagne,AUS,Spin,2022-01-05,Sydney,Australia,2022,2,16,30,0,1,414,683,10,398,653,10,41.4,>30,AUS,Home,After 1965
M Labuschagne,AUS,Spin,2022-03-04,Rawalpindi,Pakistan,2022,2,109,162,1,1,676,1285,9,567,1123,8,75.11111111111111,>30,PAK,Away,After 1965
M Labuschagne,AUS,Spin,2022-03-12,Karachi,Pakistan,2022,2,4,12,0,1,673,1474,11,669,1462,11,61.18181818181818,>30,PAK,Away,After 1965
M Labuschagne,AUS,Spin,2022-03-21,Lahore,Pakistan,2022,1,10,12,0,1,557,1146,9,547,1134,9,61.888888888888886,>30,PAK,Away,After 1965
M Labuschagne,AUS,Spin,2022-07-08,Galle,Sri Lanka,2022,1,16,36,0,1,757,1422,23,741,1386,23,32.91304347826087,>30,SL,Away,After 1965
M Labuschagne,AUS,Spin,2022-11-30,Perth,Australia,2022,2,23,24,0,1,497,783,13,474,759,13,38.23076923076923,>30,AUS,Home,After 1965
M Labuschagne,AUS,Spin,2023-01-04,Sydney,Australia,2023,1,9,17,0,1,437,881,4,428,864,4,109.25,>30,AUS,Home,After 1965
M Labuschagne,AUS,Spin,2023-02-09,Nagpur,India,2023,1,24,30,0,1,475,1061,24,451,1031,24,19.791666666666668,<=30,IND,Away,After 1965
M Labuschagne,AUS,Spin,2023-07-19,Manchester,England,2023,1,3,6,0,1,196,264,2,193,258,2,98.0,>30,ENG,Away,After 1965
M Labuschagne,AUS,Spin,2024-01-03,Sydney,Australia,2024,1,9,18,0,1,332,638,10,323,620,10,33.2,>30,AUS,Home,After 1965
M Labuschagne,AUS,Spin,2024-01-25,Brisbane,Australia,2024,1,1,6,0,1,191,372,6,190,366,6,31.833333333333332,>30,AUS,Home,After 1965
M Labuschagne,AUS,Spin,2024-03-08,Christchurch,New Zealand,2024,1,9,6,0,1,112,230,4,103,224,4,28.0,<=30,NZ,Away,After 1965
M Labuschagne,AUS,Spin,2024-11-22,Perth,Australia,2024,1,38,39,0,1,374,651,9,336,612,9,41.55555555555556,>30,AUS,Home,After 1965
M Labuschagne,AUS,Spin,2024-12-26,Melbourne,Australia,2024,1,0,6,0,1,350,730,11,350,724,11,31.818181818181817,>30,AUS,Home,After 1965
M Leyland,ENG,Spin,1928-08-11,The Oval,England,1928,1,6,18,1,1,308,610,14,302,592,13,22.0,<=30,ENG,Home,Upto 2014
M Leyland,ENG,Spin,1929-03-08,Melbourne,Australia,1929,1,11,18,0,1,660,1893,8,649,1875,8,82.5,>30,AUS,Away,Upto 2014
M Leyland,ENG,Spin,1929-06-29,Lord's,England,1929,1,9,30,0,1,382,1002,11,373,972,11,34.72727272727273,>30,ENG,Home,Upto 2014
M Leyland,ENG,Spin,1929-07-13,Leeds,England,1929,1,19,18,0,1,624,1466,25,605,1448,25,24.96,<=30,ENG,Home,Upto 2014
M Leyland,ENG,Spin,1929-08-17,The Oval,England,1929,1,25,54,0,1,557,1110,10,532,1056,10,55.7,>30,ENG,Home,Upto 2014
M Leyland,ENG,Spin,1930-07-11,Leeds,England,1930,1,44,66,0,1,548,1255,15,504,1189,15,36.53333333333333,>30,ENG,Home,Upto 2014
M Leyland,ENG,Spin,1930-07-25,Manchester,England,1930,1,17,48,0,1,355,1021,7,338,973,7,50.714285714285715,>30,ENG,Home,Upto 2014
M Leyland,ENG,Spin,1930-08-16,The Oval,England,1930,1,34,96,0,1,762,1847,19,728,1751,19,40.10526315789474,>30,ENG,Home,Upto 2014
M Leyland,ENG,Spin,1931-01-01,Cape Town,South Africa,1931,1,91,180,3,1,731,1678,19,640,1498,16,38.473684210526315,>30,SA,Away,Upto 2014
M Leyland,ENG,Spin,1931-01-16,Durban,South Africa,1931,1,32,54,0,1,228,660,10,196,606,10,22.8,<=30,SA,Away,Upto 2014
M Leyland,ENG,Spin,1931-02-13,Johannesburg,South Africa,1931,1,11,24,0,1,443,1089,15,432,1065,15,29.533333333333335,<=30,SA,Away,Upto 2014
M Leyland,ENG,Spin,1934-06-08,Nottingham,England,1934,1,5,6,0,1,499,1663,22,494,1657,22,22.681818181818183,<=30,ENG,Home,Upto 2014
M Leyland,ENG,Spin,1934-06-22,Lord's,England,1934,1,10,24,0,1,377,1128,20,367,1104,20,18.85,<=30,ENG,Home,Upto 2014
M Leyland,ENG,Spin,1934-07-20,Leeds,England,1934,1,20,30,0,1,569,1652,17,549,1622,17,33.470588235294116,>30,ENG,Home,Upto 2014
M Leyland,ENG,Spin,1934-08-18,The Oval,England,1934,1,20,18,0,1,526,1194,12,506,1176,12,43.833333333333336,>30,ENG,Home,Upto 2014
M Leyland,ENG,Spin,1935-01-24,Port of Spain,West Indies,1935,2,72,132,1,1,418,1002,12,346,870,11,34.833333333333336,>30,WI,Away,Upto 2014
M Leyland,ENG,Spin,1935-02-14,Georgetown,West Indies,1935,1,12,12,0,1,339,996,16,327,984,16,21.1875,<=30,WI,Away,Upto 2014
M Leyland,ENG,Spin,1935-06-15,Nottingham,England,1935,1,18,42,0,1,343,876,8,325,834,8,42.875,>30,ENG,Home,Upto 2014
M Leyland,ENG,Spin,1935-07-27,Manchester,England,1935,1,28,72,0,1,449,1029,11,421,957,11,40.81818181818182,>30,ENG,Home,Upto 2014
M Leyland,ENG,Spin,1935-08-17,The Oval,England,1935,1,15,42,0,1,498,864,8,483,822,8,62.25,>30,ENG,Home,Upto 2014
M Leyland,ENG,Spin,1936-08-15,The Oval,England,1936,2,24,30,0,1,349,695,12,325,665,12,29.083333333333332,<=30,ENG,Home,Upto 2014
M Leyland,ENG,Spin,1937-01-29,Adelaide,Australia,1937,1,6,16,0,1,554,1660,17,548,1644,17,32.588235294117645,>30,AUS,Away,Upto 2014
M Leyland,ENG,Spin,1937-02-26,Melbourne,Australia,1937,1,26,24,0,1,349,938,13,323,914,13,26.846153846153847,<=30,AUS,Away,Upto 2014
M Leyland,ENG,Spin,1938-08-20,The Oval,England,1938,2,30,49,1,1,776,1827,9,746,1778,8,86.22222222222223,>30,ENG,Home,Upto 2014
M Mbangwa,ZIM,Pace,1996-10-24,Faisalabad,Pakistan,1996,2,81,144,2,1,475,908,25,394,764,23,19.0,<=30,PAK,Away,Upto 2014
M Mbangwa,ZIM,Pace,1998-01-14,Colombo (SSC),Sri Lanka,1998,2,95,180,3,1,369,728,14,274,548,11,26.357142857142858,<=30,SL,Away,Upto 2014
M Mbangwa,ZIM,Pace,1998-02-19,Wellington,New Zealand,1998,1,42,102,1,1,429,1062,17,387,960,16,25.235294117647058,<=30,NZ,Away,Upto 2014
M Mbangwa,ZIM,Pace,1998-02-26,Auckland,New Zealand,1998,1,78,162,3,1,557,1155,25,479,993,22,22.28,<=30,NZ,Away,Upto 2014
M Mbangwa,ZIM,Pace,1998-03-14,Bulawayo,Zimbabwe,1998,2,54,270,3,1,726,1690,25,672,1420,22,29.04,<=30,ZIM,Home,Upto 2014
M Mbangwa,ZIM,Pace,1998-03-21,Harare,Zimbabwe,1998,2,67,210,3,1,727,1780,29,660,1570,26,25.06896551724138,<=30,ZIM,Home,Upto 2014
M Mbangwa,ZIM,Pace,1998-10-07,Harare,Zimbabwe,1998,2,44,158,3,1,643,1431,26,599,1273,23,24.73076923076923,<=30,ZIM,Home,Upto 2014
M Mbangwa,ZIM,Pace,1998-11-27,Peshawar,Pakistan,1998,2,63,180,6,1,700,1353,31,637,1173,25,22.580645161290324,<=30,PAK,Away,Upto 2014
M Mbangwa,ZIM,Pace,1998-12-10,Lahore,Pakistan,1998,1,66,144,0,1,457,1020,11,391,876,11,41.54545454545455,>30,PAK,Away,Upto 2014
M Mbangwa,ZIM,Pace,1999-10-29,Bloemfontein,South Africa,1999,1,75,210,2,1,728,1549,24,653,1339,22,30.333333333333332,>30,SA,Away,Upto 2014
M Mbangwa,ZIM,Pace,1999-11-11,Harare,Zimbabwe,1999,1,91,168,2,1,560,1277,25,469,1109,23,22.4,<=30,ZIM,Home,Upto 2014
M Mbangwa,ZIM,Pace,2000-03-16,Port of Spain,West Indies,2000,2,36,150,0,1,483,1518,30,447,1368,30,16.1,<=30,WI,Away,Upto 2014
M Mbangwa,ZIM,Pace,2000-05-18,Lord's,England,2000,1,69,126,0,1,527,1078,29,458,952,29,18.17241379310345,<=30,ENG,Away,Upto 2014
M Mbangwa,ZIM,Pace,2000-06-01,Nottingham,England,2000,2,65,198,2,1,655,1521,23,590,1323,21,28.47826086956522,<=30,ENG,Away,Upto 2014
M Mbangwa,ZIM,Pace,2000-09-19,Harare,Zimbabwe,2000,2,80,194,2,1,838,2129,25,758,1935,23,33.52,>30,ZIM,Home,Upto 2014
M Morkel,SA,Pace,2006-12-26,Durban,South Africa,2006,2,111,144,3,1,879,1470,33,768,1326,30,26.636363636363637,<=30,SA,Home,Upto 2014
M Morkel,SA,Pace,2008-02-22,Mirpur,Bangladesh,2008,2,93,180,5,1,379,784,18,286,604,13,21.055555555555557,<=30,BAN,Away,Upto 2014
M Morkel,SA,Pace,2008-02-29,Chattogram,Bangladesh,2008,2,92,107,1,1,376,687,12,284,580,11,31.333333333333332,>30,BAN,Away,Upto 2014
M Morkel,SA,Pace,2008-03-26,Chennai,India,2008,1,76,150,0,1,691,1044,8,615,894,8,86.375,>30,IND,Away,Upto 2014
M Morkel,SA,Pace,2008-04-03,Ahmedabad,India,2008,2,107,156,4,1,574,946,21,467,790,17,27.333333333333332,<=30,IND,Away,Upto 2014
M Morkel,SA,Pace,2008-04-11,Kanpur,India,2008,2,71,120,4,1,346,693,14,275,573,10,24.714285714285715,<=30,IND,Away,Upto 2014
M Morkel,SA,Pace,2008-07-10,Lord's,England,2008,1,121,204,4,1,845,1704,13,724,1500,9,65.0,>30,ENG,Away,Upto 2014
M Morkel,SA,Pace,2008-07-18,Leeds,England,2008,2,113,222,7,1,905,1732,27,792,1510,20,33.51851851851852,>30,ENG,Away,Upto 2014
M Morkel,SA,Pace,2008-07-30,Birmingham,England,2008,2,147,206,4,1,903,1618,29,756,1412,25,31.137931034482758,>30,ENG,Away,Upto 2014
M Morkel,SA,Pace,2008-08-07,The Oval,England,2008,2,121,210,0,1,862,1540,26,741,1330,26,33.15384615384615,>30,ENG,Away,Upto 2014
M Morkel,SA,Pace,2008-11-19,Bloemfontein,South Africa,2008,2,91,126,2,1,387,770,21,296,644,19,18.428571428571427,<=30,SA,Home,Upto 2014
M Morkel,SA,Pace,2008-11-26,Centurion,South Africa,2008,2,94,144,6,1,529,990,19,435,846,13,27.842105263157894,<=30,SA,Home,Upto 2014
M Morkel,SA,Pace,2008-12-17,W.A.C.A,Australia,2008,2,122,216,3,1,940,1782,28,818,1566,25,33.57142857142857,>30,AUS,Away,Upto 2014
M Morkel,SA,Pace,2008-12-26,Melbourne,Australia,2008,2,135,222,3,1,952,1716,26,817,1494,23,36.61538461538461,>30,AUS,Away,Upto 2014
M Morkel,SA,Pace,2009-01-03,Sydney,Australia,2009,2,127,234,3,1,952,2011,26,825,1777,23,36.61538461538461,>30,AUS,Away,Upto 2014
M Morkel,SA,Pace,2009-02-26,Johannesburg,South Africa,2009,2,158,232,4,1,938,1937,36,780,1705,32,26.055555555555557,<=30,SA,Home,Upto 2014
M Morkel,SA,Pace,2009-03-06,Durban,South Africa,2009,2,141,228,2,1,857,1739,26,716,1511,24,32.96153846153846,>30,SA,Home,Upto 2014
M Morkel,SA,Pace,2009-12-16,Centurion,South Africa,2009,2,106,234,3,1,848,1757,22,742,1523,19,38.54545454545455,>30,SA,Home,Upto 2014
M Morkel,SA,Pace,2009-12-26,Durban,South Africa,2009,1,78,186,3,1,616,1251,15,538,1065,12,41.06666666666667,>30,SA,Home,Upto 2014
M Morkel,SA,Pace,2010-01-03,Cape Town,South Africa,2010,2,126,300,6,1,868,1767,26,742,1467,20,33.38461538461539,>30,SA,Home,Upto 2014
M Morkel,SA,Pace,2010-01-14,Johannesburg,South Africa,2010,2,98,162,7,1,644,1109,23,546,947,16,28.0,<=30,SA,Home,Upto 2014
M Morkel,SA,Pace,2010-02-06,Nagpur,India,2010,2,123,216,2,1,534,1007,19,411,791,17,28.105263157894736,<=30,IND,Away,Upto 2014
M Morkel,SA,Pace,2010-02-14,Eden Gardens,India,2010,1,115,156,2,1,646,954,10,531,798,8,64.6,>30,IND,Away,Upto 2014
M Morkel,SA,Pace,2010-06-10,Port of Spain,West Indies,2010,2,68,150,6,1,433,932,18,365,782,12,24.055555555555557,<=30,WI,Away,Upto 2014
M Morkel,SA,Pace,2010-06-18,Basseterre,West Indies,2010,1,116,205,4,1,644,1267,9,528,1062,5,71.55555555555556,>30,WI,Away,Upto 2014
M Morkel,SA,Pace,2010-06-26,Bridgetown,West Indies,2010,2,81,145,4,1,416,803,18,335,658,14,23.11111111111111,<=30,WI,Away,Upto 2014
M Morkel,SA,Pace,2010-11-12,Dubai (DICS),UAE,2010,2,100,258,5,1,500,966,12,400,708,7,41.666666666666664,>30,UAE,Away,Upto 2014
M Morkel,SA,Pace,2010-11-20,Abu Dhabi,UAE,2010,2,123,264,1,1,798,1290,13,675,1026,12,61.38461538461539,>30,UAE,Away,Upto 2014
M Morkel,SA,Pace,2010-12-16,Centurion,South Africa,2010,2,114,262,7,1,795,1278,19,681,1016,12,41.8421052631579,>30,SA,Home,Upto 2014
M Morkel,SA,Pace,2010-12-26,Durban,South Africa,2010,2,115,205,5,1,613,1119,31,498,914,26,19.774193548387096,<=30,SA,Home,Upto 2014
M Morkel,SA,Pace,2011-01-02,Cape Town,South Africa,2011,2,132,265,3,1,846,1680,22,714,1415,19,38.45454545454545,>30,SA,Home,Upto 2014
M Morkel,SA,Pace,2011-11-09,Cape Town,South Africa,2011,2,91,144,6,1,597,929,31,506,785,25,19.258064516129032,<=30,SA,Home,Upto 2014
M Morkel,SA,Pace,2011-11-17,Johannesburg,South Africa,2011,2,105,216,2,1,938,1680,27,833,1464,25,34.74074074074074,>30,SA,Home,Upto 2014
M Morkel,SA,Pace,2011-12-15,Centurion,South Africa,2011,2,84,114,1,1,635,1013,25,551,899,24,25.4,<=30,SA,Home,Upto 2014
M Morkel,SA,Pace,2011-12-26,Durban,South Africa,2011,2,107,236,4,1,674,1304,26,567,1068,22,25.923076923076923,<=30,SA,Home,Upto 2014
M Morkel,SA,Pace,2012-01-03,Cape Town,South Africa,2012,2,142,197,3,1,828,1318,18,686,1121,15,46.0,>30,SA,Home,Upto 2014
M Morkel,SA,Pace,2012-03-07,Dunedin,New Zealand,2012,2,85,162,2,1,860,1498,21,775,1336,19,40.95238095238095,>30,NZ,Away,Upto 2014
M Morkel,SA,Pace,2012-03-15,Hamilton,New Zealand,2012,2,68,162,2,1,549,1079,27,481,917,25,20.333333333333332,<=30,NZ,Away,Upto 2014
M Morkel,SA,Pace,2012-03-23,Wellington,New Zealand,2012,2,77,220,6,1,873,1620,25,796,1400,19,34.92,>30,NZ,Away,Upto 2014
M Morkel,SA,Pace,2012-07-19,The Oval,England,2012,2,113,245,5,1,900,1787,18,787,1542,13,50.0,>30,ENG,Away,Upto 2014
M Morkel,SA,Pace,2012-08-02,Leeds,England,2012,2,129,252,2,1,982,1920,23,853,1668,21,42.69565217391305,>30,ENG,Away,Upto 2014
M Morkel,SA,Pace,2012-08-16,Lord's,England,2012,2,138,273,4,1,927,1840,33,789,1567,29,28.09090909090909,<=30,ENG,Away,Upto 2014
M Morkel,SA,Pace,2012-11-09,Brisbane,Australia,2012,1,127,186,3,1,917,1756,14,790,1570,11,65.5,>30,AUS,Away,Upto 2014
M Morkel,SA,Pace,2012-11-22,Adelaide,Australia,2012,2,196,294,8,1,863,1649,28,667,1355,20,30.821428571428573,>30,AUS,Away,Upto 2014
M Morkel,SA,Pace,2012-11-30,W.A.C.A,Australia,2012,2,76,174,3,1,885,1522,30,809,1348,27,29.5,<=30,AUS,Away,Upto 2014
M Morkel,SA,Pace,2013-01-02,Cape Town,South Africa,2013,2,64,162,4,1,547,1103,26,483,941,22,21.03846153846154,<=30,SA,Home,Upto 2014
M Morkel,SA,Pace,2013-01-11,Gqeberha,South Africa,2013,2,62,172,3,1,619,1262,23,557,1090,20,26.91304347826087,<=30,SA,Home,Upto 2014
M Morkel,SA,Pace,2013-02-01,Johannesburg,South Africa,2013,2,100,186,2,1,592,1253,26,492,1067,24,22.76923076923077,<=30,SA,Home,Upto 2014
M Morkel,SA,Pace,2013-02-14,Cape Town,South Africa,2013,2,67,142,2,1,620,1269,20,553,1127,18,31.0,>30,SA,Home,Upto 2014
M Morkel,SA,Pace,2013-10-14,Abu Dhabi,UAE,2013,2,47,150,1,1,476,1024,18,429,874,17,26.444444444444443,<=30,UAE,Away,Upto 2014
M Morkel,SA,Pace,2013-10-23,Dubai (DICS),UAE,2013,2,59,162,1,1,404,958,9,345,796,8,44.888888888888886,>30,UAE,Away,Upto 2014
M Morkel,SA,Pace,2013-12-18,Johannesburg,South Africa,2013,2,38,150,3,1,1012,2037,30,974,1887,27,33.733333333333334,>30,SA,Home,Upto 2014
M Morkel,SA,Pace,2013-12-26,Durban,South Africa,2013,2,84,237,3,1,714,1389,18,630,1152,15,39.666666666666664,>30,SA,Home,Upto 2014
M Morkel,SA,Pace,2014-02-12,Centurion,South Africa,2014,2,111,210,1,1,767,1417,27,656,1207,26,28.40740740740741,<=30,SA,Home,After 1965
M Morkel,SA,Pace,2014-02-20,Gqeberha,South Africa,2014,2,109,192,4,1,800,1419,22,691,1227,18,36.36363636363637,>30,SA,Home,After 1965
M Morkel,SA,Pace,2014-03-01,Cape Town,South Africa,2014,2,161,221,1,1,924,1728,25,763,1507,24,36.96,>30,SA,Home,After 1965
M Morkel,SA,Pace,2014-07-16,Galle,Sri Lanka,2014,2,78,194,7,1,420,962,20,342,768,13,21.0,<=30,SL,Away,After 1965
M Morkel,SA,Pace,2014-07-24,Colombo (SSC),Sri Lanka,2014,2,114,214,5,1,394,782,12,280,568,7,32.833333333333336,>30,SL,Away,After 1965
M Morkel,SA,Pace,2014-08-09,Harare,Zimbabwe,2014,2,54,204,3,1,362,1164,16,308,960,13,22.625,<=30,ZIM,Away,After 1965
M Morkel,SA,Pace,2014-12-17,Centurion,South Africa,2014,2,98,159,5,1,587,1007,20,489,848,15,29.35,<=30,SA,Home,After 1965
M Morkel,SA,Pace,2014-12-26,Gqeberha,South Africa,2014,1,69,120,4,1,464,870,12,395,750,8,38.666666666666664,>30,SA,Home,After 1965
M Morkel,SA,Pace,2015-01-02,Cape Town,South Africa,2015,2,101,203,4,1,670,1234,16,569,1031,12,41.875,>30,SA,Home,After 1965
M Morkel,SA,Pace,2015-07-21,Chattogram,Bangladesh,2015,1,52,114,0,1,297,719,10,245,605,10,29.7,<=30,BAN,Away,After 1965
M Morkel,SA,Pace,2015-07-30,Mirpur,Bangladesh,2015,1,45,84,1,1,105,259,4,60,175,3,26.25,<=30,BAN,Away,After 1965
M Morkel,SA,Pace,2015-11-14,Bengaluru,India,2015,1,23,42,0,1,150,258,1,127,216,1,150.0,>30,IND,Away,After 1965
M Morkel,SA,Pace,2015-11-25,Nagpur,India,2015,2,54,157,6,1,123,391,7,69,234,1,17.571428571428573,<=30,IND,Away,After 1965
M Morkel,SA,Pace,2015-12-03,Delhi,India,2015,2,109,270,3,1,288,947,15,179,677,12,19.2,<=30,IND,Away,After 1965
M Morkel,SA,Pace,2015-12-26,Durban,South Africa,2015,2,114,279,5,1,593,1392,27,479,1113,22,21.962962962962962,<=30,SA,Home,After 1965
M Morkel,SA,Pace,2016-01-02,Cape Town,South Africa,2016,2,140,270,2,1,994,1661,14,854,1391,12,71.0,>30,SA,Home,After 1965
M Morkel,SA,Pace,2016-01-14,Johannesburg,South Africa,2016,2,83,150,3,1,692,1271,29,609,1121,26,23.862068965517242,<=30,SA,Home,After 1965
M Morkel,SA,Pace,2016-01-22,Centurion,South Africa,2016,2,109,212,5,1,827,1592,31,718,1380,26,26.677419354838708,<=30,SA,Home,After 1965
M Morkel,SA,Pace,2017-03-08,Dunedin,New Zealand,2017,1,62,144,2,1,518,1198,16,456,1054,14,32.375,>30,NZ,Away,After 1965
M Morkel,SA,Pace,2017-03-16,Wellington,New Zealand,2017,2,132,174,5,1,662,1203,19,530,1029,14,34.8421052631579,>30,NZ,Away,After 1965
M Morkel,SA,Pace,2017-03-25,Hamilton,New Zealand,2017,1,100,217,4,1,618,1215,19,518,998,15,32.526315789473685,>30,NZ,Away,After 1965
M Morkel,SA,Pace,2017-07-06,Lord's,England,2017,2,179,279,7,1,720,1257,22,541,978,15,32.72727272727273,>30,ENG,Away,After 1965
M Morkel,SA,Pace,2017-07-14,Nottingham,England,2017,2,75,156,2,1,739,1395,28,664,1239,26,26.392857142857142,<=30,ENG,Away,After 1965
M Morkel,SA,Pace,2017-07-27,The Oval,England,2017,2,114,284,4,1,850,1584,29,736,1300,25,29.310344827586206,<=30,ENG,Away,After 1965
M Morkel,SA,Pace,2017-08-04,Manchester,England,2017,2,133,235,6,1,698,1268,30,565,1033,24,23.266666666666666,<=30,ENG,Away,After 1965
M Morkel,SA,Pace,2017-09-28,Potchefstroom,South Africa,2017,2,70,146,4,1,634,1140,16,564,994,12,39.625,>30,SA,Home,After 1965
M Morkel,SA,Pace,2017-12-26,Gqeberha,South Africa,2017,2,33,90,5,1,327,664,21,294,574,16,15.571428571428571,<=30,SA,Home,After 1965
M Morkel,SA,Pace,2018-01-05,Cape Town,South Africa,2018,2,96,180,4,1,684,1276,37,588,1096,33,18.486486486486488,<=30,SA,Home,After 1965
M Morkel,SA,Pace,2018-01-13,Centurion,South Africa,2018,2,70,181,4,1,739,1521,29,669,1340,25,25.482758620689655,<=30,SA,Home,After 1965
M Morkel,SA,Pace,2018-01-24,Johannesburg,South Africa,2018,2,94,228,5,1,749,1777,40,655,1549,35,18.725,<=30,SA,Home,After 1965
M Morkel,SA,Pace,2018-03-01,Durban,South Africa,2018,2,122,222,3,1,640,1256,26,518,1034,23,24.615384615384617,<=30,SA,Home,After 1965
M Morkel,SA,Pace,2018-03-22,Cape Town,South Africa,2018,2,110,184,9,1,789,1457,31,679,1273,22,25.451612903225808,<=30,SA,Home,After 1965
M Morkel,SA,Pace,2018-03-30,Johannesburg,South Africa,2018,2,62,138,3,1,666,1427,26,604,1289,23,25.615384615384617,<=30,SA,Home,After 1965
M Muralidaran,ICC,Spin,2005-10-14,Sydney,Australia,2005,2,157,324,5,1,421,817,21,264,493,16,20.047619047619047,<=30,AUS,Away,Upto 2014
M Muralidaran,SL,Spin,1992-08-28,Colombo (RPS),Sri Lanka,1992,2,141,306,3,1,357,918,7,216,612,4,51.0,>30,SL,Home,Upto 2014
M Muralidaran,SL,Spin,1992-09-08,Moratuwa,Sri Lanka,1992,2,84,133,1,1,347,775,4,263,642,3,86.75,>30,SL,Home,Upto 2014
M Muralidaran,SL,Spin,1992-12-06,Colombo (SSC),Sri Lanka,1992,2,156,313,7,1,505,1022,18,349,709,11,28.055555555555557,<=30,SL,Home,Upto 2014
M Muralidaran,SL,Spin,1993-03-13,Colombo (SSC),Sri Lanka,1993,2,173,366,5,1,805,1517,22,632,1151,17,36.59090909090909,>30,SL,Home,Upto 2014
M Muralidaran,SL,Spin,1993-08-04,Colombo (PSS),Sri Lanka,1993,1,136,283,4,1,715,1623,16,579,1340,12,44.6875,>30,SL,Home,Upto 2014
M Muralidaran,SL,Spin,1993-08-25,Moratuwa,Sri Lanka,1993,2,152,420,6,1,610,1439,14,458,1019,8,43.57142857142857,>30,SL,Home,Upto 2014
M Muralidaran,SL,Spin,1993-09-06,Colombo (SSC),Sri Lanka,1993,1,101,324,5,1,286,744,8,185,420,3,35.75,>30,SL,Home,Upto 2014
M Muralidaran,SL,Spin,1993-09-14,Colombo (PSS),Sri Lanka,1993,2,103,301,5,1,296,757,9,193,456,4,32.888888888888886,>30,SL,Home,Upto 2014
M Muralidaran,SL,Spin,1993-12-08,Moratuwa,Sri Lanka,1993,1,47,95,4,1,241,659,12,194,564,8,20.083333333333332,<=30,SL,Home,Upto 2014
M Muralidaran,SL,Spin,1994-01-18,Lucknow,India,1994,1,162,251,5,1,633,1538,23,471,1287,18,27.52173913043478,<=30,IND,Away,Upto 2014
M Muralidaran,SL,Spin,1994-01-26,Bengaluru,India,1994,1,179,390,4,1,625,1188,15,446,798,11,41.666666666666664,>30,IND,Away,Upto 2014
M Muralidaran,SL,Spin,1994-02-08,Ahmedabad,India,1994,1,79,219,3,1,473,1433,26,394,1214,23,18.192307692307693,<=30,IND,Away,Upto 2014
M Muralidaran,SL,Spin,1994-08-09,Colombo (PSS),Sri Lanka,1994,2,165,282,1,1,791,1520,23,626,1238,22,34.391304347826086,>30,SL,Home,Upto 2014
M Muralidaran,SL,Spin,1994-10-11,Harare,Zimbabwe,1994,1,60,192,2,1,210,576,2,150,384,0,105.0,>30,ZIM,Away,Upto 2014
M Muralidaran,SL,Spin,1994-10-20,Bulawayo,Zimbabwe,1994,1,108,330,1,1,318,948,5,210,618,4,63.6,>30,ZIM,Away,Upto 2014
M Muralidaran,SL,Spin,1995-03-11,Napier,New Zealand,1995,1,64,216,5,1,74,252,5,10,36,0,14.8,<=30,NZ,Away,Upto 2014
M Muralidaran,SL,Spin,1995-03-18,Dunedin,New Zealand,1995,1,77,300,2,1,246,774,9,169,474,7,27.333333333333332,<=30,NZ,Away,Upto 2014
M Muralidaran,SL,Spin,1995-09-08,Peshawar,Pakistan,1995,1,134,300,4,1,297,708,12,163,408,8,24.75,<=30,PAK,Away,Upto 2014
M Muralidaran,SL,Spin,1995-09-15,Faisalabad,Pakistan,1995,2,151,261,7,1,624,1381,17,473,1120,10,36.705882352941174,>30,PAK,Away,Upto 2014
M Muralidaran,SL,Spin,1995-09-22,Sialkot,Pakistan,1995,2,125,265,4,1,336,832,11,211,567,7,30.545454545454547,>30,PAK,Away,Upto 2014
M Muralidaran,SL,Spin,1995-12-08,W.A.C.A,Australia,1995,1,224,324,2,1,558,1018,9,334,694,7,62.0,>30,AUS,Away,Upto 2014
M Muralidaran,SL,Spin,1995-12-26,Melbourne,Australia,1995,1,124,228,1,1,439,892,9,315,664,8,48.77777777777778,>30,AUS,Away,Upto 2014
M Muralidaran,SL,Spin,1996-09-11,Colombo (RPS),Sri Lanka,1996,2,61,267,7,1,302,952,21,241,685,14,14.380952380952381,<=30,SL,Home,Upto 2014
M Muralidaran,SL,Spin,1996-09-18,Colombo (SSC),Sri Lanka,1996,2,134,366,7,1,399,1111,19,265,745,12,21.0,<=30,SL,Home,Upto 2014
M Muralidaran,SL,Spin,1997-03-07,Dunedin,New Zealand,1997,1,136,198,0,1,364,612,5,228,414,5,72.8,>30,NZ,Away,Upto 2014
M Muralidaran,SL,Spin,1997-03-14,Hamilton,New Zealand,1997,2,105,288,6,1,413,1010,18,308,722,12,22.944444444444443,<=30,NZ,Away,Upto 2014
M Muralidaran,SL,Spin,1997-04-19,Colombo (RPS),Sri Lanka,1997,1,98,318,6,1,757,2006,23,659,1688,17,32.91304347826087,>30,SL,Home,Upto 2014
M Muralidaran,SL,Spin,1997-06-13,St John's,West Indies,1997,2,106,270,8,1,220,504,11,114,234,3,20.0,<=30,WI,Away,Upto 2014
M Muralidaran,SL,Spin,1997-06-20,Kingstown,West Indies,1997,2,141,318,8,1,276,646,16,135,328,8,17.25,<=30,WI,Away,Upto 2014
M Muralidaran,SL,Spin,1997-08-02,Colombo (RPS),Sri Lanka,1997,1,174,390,2,1,1044,2082,8,870,1692,6,130.5,>30,SL,Home,Upto 2014
M Muralidaran,SL,Spin,1997-08-09,Colombo (SSC),Sri Lanka,1997,2,195,498,7,1,450,1036,11,255,538,4,40.90909090909091,>30,SL,Home,Upto 2014
M Muralidaran,SL,Spin,1997-11-19,Mohali,India,1997,1,174,450,3,1,502,1356,8,328,906,5,62.75,>30,IND,Away,Upto 2014
M Muralidaran,SL,Spin,1997-11-26,Nagpur,India,1997,1,137,276,0,1,254,546,2,117,270,2,127.0,>30,IND,Away,Upto 2014
M Muralidaran,SL,Spin,1998-01-07,Kandy,Sri Lanka,1998,2,117,431,12,1,546,1374,23,429,943,11,23.73913043478261,<=30,SL,Home,Upto 2014
M Muralidaran,SL,Spin,1998-01-14,Colombo (SSC),Sri Lanka,1998,2,145,419,5,1,688,1695,18,543,1276,13,38.22222222222222,>30,SL,Home,Upto 2014
M Muralidaran,SL,Spin,1998-03-19,Cape Town,South Africa,1998,2,243,516,8,1,499,1068,16,256,552,8,31.1875,>30,SA,Away,Upto 2014
M Muralidaran,SL,Spin,1998-03-27,Centurion,South Africa,1998,2,157,323,8,1,345,671,12,188,348,4,28.75,<=30,SA,Away,Upto 2014
M Muralidaran,SL,Spin,1998-05-27,Colombo (RPS),Sri Lanka,1998,2,227,446,9,1,939,2077,27,712,1631,18,34.77777777777778,>30,SL,Home,Upto 2014
M Muralidaran,SL,Spin,1998-06-03,Galle,Sri Lanka,1998,2,57,234,3,1,443,1219,25,386,985,22,17.72,<=30,SL,Home,Upto 2014
M Muralidaran,SL,Spin,1998-06-10,Colombo (SSC),Sri Lanka,1998,2,90,250,7,1,526,1430,27,436,1180,20,19.48148148148148,<=30,SL,Home,Upto 2014
M Muralidaran,SL,Spin,1998-08-27,The Oval,England,1998,2,220,683,16,1,481,1390,17,261,707,1,28.294117647058822,<=30,ENG,Away,Upto 2014
M Muralidaran,SL,Spin,1999-09-09,Kandy,Sri Lanka,1999,2,128,307,7,1,373,779,20,245,472,13,18.65,<=30,SL,Home,Upto 2014
M Muralidaran,SL,Spin,1999-09-22,Galle,Sri Lanka,1999,1,71,228,5,1,307,827,13,236,599,8,23.615384615384617,<=30,SL,Home,Upto 2014
M Muralidaran,SL,Spin,1999-09-30,Colombo (SSC),Sri Lanka,1999,1,150,312,3,1,278,654,6,128,342,3,46.333333333333336,>30,SL,Home,Upto 2014
M Muralidaran,SL,Spin,1999-11-18,Bulawayo,Zimbabwe,1999,2,111,204,2,1,248,534,3,137,330,1,82.66666666666667,>30,ZIM,Away,Upto 2014
M Muralidaran,SL,Spin,1999-11-26,Harare,Zimbabwe,1999,2,115,437,5,1,215,630,10,100,193,5,21.5,<=30,ZIM,Away,Upto 2014
M Muralidaran,SL,Spin,1999-12-04,Harare,Zimbabwe,1999,2,103,354,2,1,143,474,2,40,120,0,71.5,>30,ZIM,Away,Upto 2014
M Muralidaran,SL,Spin,2000-02-26,Rawalpindi,Pakistan,2000,2,172,450,8,1,401,1058,12,229,608,4,33.416666666666664,>30,PAK,Away,Upto 2014
M Muralidaran,SL,Spin,2000-03-05,Peshawar,Pakistan,2000,2,148,397,10,1,411,991,20,263,594,10,20.55,<=30,PAK,Away,Upto 2014
M Muralidaran,SL,Spin,2000-03-12,Karachi,Pakistan,2000,2,196,432,8,1,344,671,14,148,239,6,24.571428571428573,<=30,PAK,Away,Upto 2014
M Muralidaran,SL,Spin,2000-06-14,Colombo (SSC),Sri Lanka,2000,2,168,384,8,1,317,840,16,149,456,8,19.8125,<=30,SL,Home,Upto 2014
M Muralidaran,SL,Spin,2000-06-21,Galle,Sri Lanka,2000,1,138,300,4,1,434,852,7,296,552,3,62.0,>30,SL,Home,Upto 2014
M Muralidaran,SL,Spin,2000-07-20,Galle,Sri Lanka,2000,2,171,456,13,1,705,1392,24,534,936,11,29.375,<=30,SL,Home,Upto 2014
M Muralidaran,SL,Spin,2000-07-30,Kandy,Sri Lanka,2000,2,171,401,5,1,551,1139,19,380,738,14,29.0,<=30,SL,Home,Upto 2014
M Muralidaran,SL,Spin,2000-08-06,Colombo (SSC),Sri Lanka,2000,2,138,509,8,1,525,1357,18,387,848,10,29.166666666666668,<=30,SL,Home,Upto 2014
M Muralidaran,SL,Spin,2000-12-26,Durban,South Africa,2000,2,161,411,11,1,274,753,15,113,342,4,18.266666666666666,<=30,SA,Away,Upto 2014
M Muralidaran,SL,Spin,2001-01-02,Cape Town,South Africa,2001,1,99,258,1,1,231,506,8,132,248,7,28.875,<=30,SA,Away,Upto 2014
M Muralidaran,SL,Spin,2001-02-22,Galle,Sri Lanka,2001,2,145,582,7,1,636,1872,18,491,1290,11,35.333333333333336,>30,SL,Home,Upto 2014
M Muralidaran,SL,Spin,2001-03-07,Kandy,Sri Lanka,2001,2,177,540,5,1,679,1658,18,502,1118,13,37.72222222222222,>30,SL,Home,Upto 2014
M Muralidaran,SL,Spin,2001-03-15,Colombo (SSC),Sri Lanka,2001,2,99,294,2,1,375,1120,19,276,826,17,19.736842105263158,<=30,SL,Home,Upto 2014
M Muralidaran,SL,Spin,2001-08-14,Galle,Sri Lanka,2001,2,90,308,8,1,169,548,10,79,240,2,16.9,<=30,SL,Home,Upto 2014
M Muralidaran,SL,Spin,2001-08-22,Kandy,Sri Lanka,2001,2,158,271,4,1,215,370,5,57,99,1,43.0,>30,SL,Home,Upto 2014
M Muralidaran,SL,Spin,2001-08-29,Colombo (SSC),Sri Lanka,2001,2,196,486,11,1,579,1257,16,383,771,5,36.1875,>30,SL,Home,Upto 2014
M Muralidaran,SL,Spin,2001-09-06,Colombo (SSC),Sri Lanka,2001,2,111,271,10,1,422,724,14,311,453,4,30.142857142857142,>30,SL,Home,Upto 2014
M Muralidaran,SL,Spin,2001-11-13,Galle,Sri Lanka,2001,2,170,511,11,1,681,1597,17,511,1086,6,40.05882352941177,>30,SL,Home,Upto 2014
M Muralidaran,SL,Spin,2001-11-21,Kandy,Sri Lanka,2001,2,135,357,10,1,458,1038,19,323,681,9,24.105263157894736,<=30,SL,Home,Upto 2014
M Muralidaran,SL,Spin,2001-11-29,Colombo (SSC),Sri Lanka,2001,2,231,438,3,1,542,1074,5,311,636,2,108.4,>30,SL,Home,Upto 2014
M Muralidaran,SL,Spin,2001-12-27,Colombo (SSC),Sri Lanka,2001,2,88,372,8,1,311,756,12,223,384,4,25.916666666666668,<=30,SL,Home,Upto 2014
M Muralidaran,SL,Spin,2002-01-04,Kandy,Sri Lanka,2002,2,115,400,13,1,367,934,16,252,534,3,22.9375,<=30,SL,Home,Upto 2014
M Muralidaran,SL,Spin,2002-01-12,Galle,Sri Lanka,2002,2,91,447,9,1,515,1423,24,424,976,15,21.458333333333332,<=30,SL,Home,Upto 2014
M Muralidaran,SL,Spin,2002-03-06,Lahore,Pakistan,2002,2,127,354,8,1,240,516,8,113,162,0,30.0,<=30,PAK,Away,Upto 2014
M Muralidaran,SL,Spin,2002-05-30,Birmingham,England,2002,1,143,384,5,1,264,643,6,121,259,1,44.0,>30,ENG,Away,Upto 2014
M Muralidaran,SL,Spin,2002-06-13,Manchester,England,2002,2,154,372,3,1,309,728,8,155,356,5,38.625,>30,ENG,Away,Upto 2014
M Muralidaran,SL,Spin,2002-07-21,Colombo (PSS),Sri Lanka,2002,2,98,268,10,1,331,649,16,233,381,6,20.6875,<=30,SL,Home,Upto 2014
M Muralidaran,SL,Spin,2002-11-08,Johannesburg,South Africa,2002,1,83,188,3,1,83,188,3,0,0,0,27.666666666666668,<=30,SA,Away,Upto 2014
M Muralidaran,SL,Spin,2002-11-15,Centurion,South Africa,2002,2,168,423,4,1,191,489,4,23,66,0,47.75,>30,SA,Away,Upto 2014
M Muralidaran,SL,Spin,2003-04-25,Colombo (PSS),Sri Lanka,2003,2,181,533,5,1,714,1571,15,533,1038,10,47.6,>30,SL,Home,Upto 2014
M Muralidaran,SL,Spin,2003-05-03,Kandy,Sri Lanka,2003,2,139,438,8,1,468,1155,15,329,717,7,31.2,>30,SL,Home,Upto 2014
M Muralidaran,SL,Spin,2003-06-20,Gros Islet,West Indies,2003,1,138,300,5,1,398,848,9,260,548,4,44.22222222222222,>30,WI,Away,Upto 2014
M Muralidaran,SL,Spin,2003-06-27,Kingston,West Indies,2003,2,71,160,4,1,148,370,7,77,210,3,21.142857142857142,<=30,WI,Away,Upto 2014
M Muralidaran,SL,Spin,2003-12-02,Galle,Sri Lanka,2003,2,93,412,11,1,603,1823,28,510,1411,17,21.535714285714285,<=30,SL,Home,Upto 2014
M Muralidaran,SL,Spin,2003-12-10,Kandy,Sri Lanka,2003,2,124,576,8,1,692,1702,20,568,1126,12,34.6,>30,SL,Home,Upto 2014
M Muralidaran,SL,Spin,2003-12-18,Colombo (SSC),Sri Lanka,2003,2,103,402,7,1,552,1368,13,449,966,6,42.46153846153846,>30,SL,Home,Upto 2014
M Muralidaran,SL,Spin,2004-03-08,Galle,Sri Lanka,2004,2,212,465,11,1,953,1791,32,741,1326,21,29.78125,<=30,SL,Home,Upto 2014
M Muralidaran,SL,Spin,2004-03-16,Kandy,Sri Lanka,2004,2,221,393,9,1,537,881,19,316,488,10,28.263157894736842,<=30,SL,Home,Upto 2014
M Muralidaran,SL,Spin,2004-03-24,Colombo (SSC),Sri Lanka,2004,2,216,397,8,1,844,1656,26,628,1259,18,32.46153846153846,>30,SL,Home,Upto 2014
M Muralidaran,SL,Spin,2004-05-06,Harare,Zimbabwe,2004,2,82,201,8,1,203,375,10,121,174,2,20.3,<=30,ZIM,Away,Upto 2014
M Muralidaran,SL,Spin,2004-05-14,Bulawayo,Zimbabwe,2004,2,137,301,6,1,302,532,8,165,231,2,37.75,>30,ZIM,Away,Upto 2014
M Muralidaran,SL,Spin,2004-08-04,Galle,Sri Lanka,2004,2,167,400,5,1,688,1462,17,521,1062,12,40.470588235294116,>30,SL,Home,Upto 2014
M Muralidaran,SL,Spin,2005-07-13,Colombo (SSC),Sri Lanka,2005,2,92,300,7,1,301,612,9,209,312,2,33.44444444444444,>30,SL,Home,Upto 2014
M Muralidaran,SL,Spin,2005-07-22,Kandy,Sri Lanka,2005,2,83,153,10,1,292,585,15,209,432,5,19.466666666666665,<=30,SL,Home,Upto 2014
M Muralidaran,SL,Spin,2005-09-12,Colombo (RPS),Sri Lanka,2005,2,60,148,9,1,396,772,20,336,624,11,19.8,<=30,SL,Home,Upto 2014
M Muralidaran,SL,Spin,2005-09-20,Colombo (PSS),Sri Lanka,2005,2,75,172,5,1,417,656,12,342,484,7,34.75,>30,SL,Home,Upto 2014
M Muralidaran,SL,Spin,2005-12-02,Chennai,India,2005,1,60,150,2,1,150,362,6,90,212,4,25.0,<=30,IND,Away,Upto 2014
M Muralidaran,SL,Spin,2005-12-10,Delhi,India,2005,2,218,460,8,1,668,1353,25,450,893,17,26.72,<=30,IND,Away,Upto 2014
M Muralidaran,SL,Spin,2005-12-18,Ahmedabad,India,2005,2,218,342,6,1,765,1419,29,547,1077,23,26.379310344827587,<=30,IND,Away,Upto 2014
M Muralidaran,SL,Spin,2006-02-28,Chattogram,Bangladesh,2006,2,141,311,9,1,666,1170,22,525,859,13,30.272727272727273,>30,BAN,Away,Upto 2014
M Muralidaran,SL,Spin,2006-03-08,Bogra,Bangladesh,2006,2,141,263,7,1,552,1040,19,411,777,12,29.05263157894737,<=30,BAN,Away,Upto 2014
M Muralidaran,SL,Spin,2006-03-26,Colombo (SSC),Sri Lanka,2006,2,135,358,6,1,538,1125,13,403,767,7,41.38461538461539,>30,SL,Home,Upto 2014
M Muralidaran,SL,Spin,2006-04-03,Kandy,Sri Lanka,2006,2,85,178,5,1,153,330,9,68,152,4,17.0,<=30,SL,Home,Upto 2014
M Muralidaran,SL,Spin,2006-05-11,Lord's,England,2006,1,158,288,3,1,239,486,5,81,198,2,47.8,>30,ENG,Away,Upto 2014
M Muralidaran,SL,Spin,2006-05-25,Birmingham,England,2006,2,115,224,10,1,204,410,13,89,186,3,15.692307692307692,<=30,ENG,Away,Upto 2014
M Muralidaran,SL,Spin,2006-06-02,Nottingham,England,2006,2,132,366,11,1,298,834,19,166,468,8,15.68421052631579,<=30,ENG,Away,Upto 2014
M Muralidaran,SL,Spin,2006-07-27,Colombo (SSC),Sri Lanka,2006,2,172,494,10,1,531,1166,11,359,672,1,48.27272727272727,>30,SL,Home,Upto 2014
M Muralidaran,SL,Spin,2006-08-04,Colombo (PSS),Sri Lanka,2006,2,225,484,12,1,476,925,17,251,441,5,28.0,<=30,SL,Home,Upto 2014
M Muralidaran,SL,Spin,2006-12-07,Christchurch,New Zealand,2006,2,99,288,7,1,109,300,7,10,12,0,15.571428571428571,<=30,NZ,Away,Upto 2014
M Muralidaran,SL,Spin,2006-12-15,Wellington,New Zealand,2006,2,118,278,10,1,311,653,20,193,375,10,15.55,<=30,NZ,Away,Upto 2014
M Muralidaran,SL,Spin,2007-06-25,Colombo (SSC),Sri Lanka,2007,2,102,262,9,1,605,1005,14,503,743,5,43.214285714285715,>30,SL,Home,Upto 2014
M Muralidaran,SL,Spin,2007-07-03,Colombo (PSS),Sri Lanka,2007,2,98,200,5,1,383,661,9,285,461,4,42.55555555555556,>30,SL,Home,Upto 2014
M Muralidaran,SL,Spin,2007-07-11,Kandy,Sri Lanka,2007,2,82,215,12,1,353,551,12,271,336,0,29.416666666666668,<=30,SL,Home,Upto 2014
M Muralidaran,SL,Spin,2007-11-08,Brisbane,Australia,2007,1,170,300,2,1,370,696,6,200,396,4,61.666666666666664,>30,AUS,Away,Upto 2014
M Muralidaran,SL,Spin,2007-11-16,Hobart,Australia,2007,2,230,396,2,1,453,768,6,223,372,4,75.5,>30,AUS,Away,Upto 2014
M Muralidaran,SL,Spin,2007-12-01,Kandy,Sri Lanka,2007,2,140,426,9,1,361,894,16,221,468,7,22.5625,<=30,SL,Home,Upto 2014
M Muralidaran,SL,Spin,2007-12-09,Colombo (SSC),Sri Lanka,2007,2,174,446,6,1,447,920,9,273,474,3,49.666666666666664,>30,SL,Home,Upto 2014
M Muralidaran,SL,Spin,2007-12-18,Galle,Sri Lanka,2007,2,97,252,4,1,195,456,4,98,204,0,48.75,>30,SL,Home,Upto 2014
M Muralidaran,SL,Spin,2008-03-22,Providence,West Indies,2008,2,224,510,6,1,634,1374,12,410,864,6,52.833333333333336,>30,WI,Away,Upto 2014
M Muralidaran,SL,Spin,2008-04-03,Port of Spain,West Indies,2008,2,171,323,6,1,206,431,7,35,108,1,29.428571428571427,<=30,WI,Away,Upto 2014
M Muralidaran,SL,Spin,2008-07-23,Colombo (SSC),Sri Lanka,2008,2,110,252,11,1,529,1031,21,419,779,10,25.19047619047619,<=30,SL,Home,Upto 2014
M Muralidaran,SL,Spin,2008-07-31,Galle,Sri Lanka,2008,2,200,348,5,1,684,1286,30,484,938,25,22.8,<=30,SL,Home,Upto 2014
M Muralidaran,SL,Spin,2008-08-08,Colombo (PSS),Sri Lanka,2008,2,157,365,5,1,613,1402,20,456,1037,15,30.65,>30,SL,Home,Upto 2014
M Muralidaran,SL,Spin,2008-12-26,Mirpur,Bangladesh,2008,2,190,420,10,1,727,1408,21,537,988,11,34.61904761904762,>30,BAN,Away,Upto 2014
M Muralidaran,SL,Spin,2009-01-03,Chattogram,Bangladesh,2009,2,92,182,3,1,931,1570,27,839,1388,24,34.48148148148148,>30,BAN,Away,Upto 2014
M Muralidaran,SL,Spin,2009-02-21,Karachi,Pakistan,2009,1,172,390,1,1,883,1568,9,711,1178,8,98.11111111111111,>30,PAK,Away,Upto 2014
M Muralidaran,SL,Spin,2009-03-01,Lahore,Pakistan,2009,1,23,28,0,1,316,544,0,293,516,0,inf,>30,PAK,Away,Upto 2014
M Muralidaran,SL,Spin,2009-08-18,Galle,Sri Lanka,2009,2,161,414,7,1,652,1329,16,491,915,9,40.75,>30,SL,Home,Upto 2014
M Muralidaran,SL,Spin,2009-08-26,Colombo (SSC),Sri Lanka,2009,2,156,324,6,1,760,1587,27,604,1263,21,28.14814814814815,<=30,SL,Home,Upto 2014
M Muralidaran,SL,Spin,2009-11-16,Ahmedabad,India,2009,2,221,383,3,1,904,1575,9,683,1192,6,100.44444444444444,>30,IND,Away,Upto 2014
M Muralidaran,SL,Spin,2009-11-24,Kanpur,India,2009,1,175,222,2,1,718,1197,20,543,975,18,35.9,>30,IND,Away,Upto 2014
M Muralidaran,SL,Spin,2009-12-02,Brabourne,India,2009,1,195,306,4,1,870,1403,18,675,1097,14,48.333333333333336,>30,IND,Away,Upto 2014
M Muralidaran,SL,Spin,2010-07-18,Galle,Sri Lanka,2010,2,191,370,8,1,643,1145,10,452,775,2,64.3,>30,SL,Home,Upto 2014
M Ngam,SA,Pace,2000-12-08,Johannesburg,South Africa,2000,1,34,114,2,1,417,1127,13,383,1013,11,32.07692307692308,>30,SA,Home,Upto 2014
M Ngam,SA,Pace,2000-12-26,Durban,South Africa,2000,2,93,150,3,1,618,1336,17,525,1186,14,36.35294117647059,>30,SA,Home,Upto 2014
M Ngam,SA,Pace,2001-01-02,Cape Town,South Africa,2001,2,62,128,6,1,537,948,18,475,820,12,29.833333333333332,<=30,SA,Home,Upto 2014
M Nissar,IND,Pace,1932-06-25,Lord's,England,1932,2,135,264,6,1,543,1480,28,408,1216,22,19.392857142857142,<=30,ENG,Away,Upto 2014
M Nissar,IND,Pace,1933-12-15,Mumbai,India,1933,2,115,227,5,1,534,1100,19,419,873,14,28.105263157894736,<=30,IND,Home,Upto 2014
M Nissar,IND,Pace,1934-01-05,Eden Gardens,India,1934,2,114,216,2,1,492,1256,17,378,1040,15,28.941176470588236,<=30,IND,Home,Upto 2014
M Nissar,IND,Pace,1936-06-27,Lord's,England,1936,2,62,138,4,1,273,772,20,211,634,16,13.65,<=30,ENG,Away,Upto 2014
M Nissar,IND,Pace,1936-07-25,Manchester,England,1936,1,125,168,2,1,650,1176,8,525,1008,6,81.25,>30,ENG,Away,Upto 2014
M Nissar,IND,Pace,1936-08-15,The Oval,England,1936,2,156,198,6,1,678,1230,17,522,1032,11,39.88235294117647,>30,ENG,Away,Upto 2014
M Ntini,SA,Pace,1998-03-19,Cape Town,South Africa,1998,2,74,93,2,1,757,1378,22,683,1285,20,34.40909090909091,>30,SA,Home,Upto 2014
M Ntini,SA,Pace,1998-03-27,Centurion,South Africa,1998,2,74,173,2,1,463,1134,19,389,961,17,24.36842105263158,<=30,SA,Home,Upto 2014
M Ntini,SA,Pace,1998-07-02,Manchester,England,1998,2,95,270,2,1,671,1668,18,576,1398,16,37.27777777777778,>30,ENG,Away,Upto 2014
M Ntini,SA,Pace,1998-08-06,Leeds,England,1998,2,115,216,4,1,826,2084,40,711,1868,36,20.65,<=30,ENG,Away,Upto 2014
M Ntini,SA,Pace,2000-07-20,Galle,Sri Lanka,2000,1,73,114,1,1,282,658,5,209,544,4,56.4,>30,SL,Away,Upto 2014
M Ntini,SA,Pace,2000-11-17,Bloemfontein,South Africa,2000,2,114,274,7,1,906,1955,31,792,1681,24,29.225806451612904,<=30,SA,Home,Upto 2014
M Ntini,SA,Pace,2000-11-30,Gqeberha,South Africa,2000,2,83,228,3,1,698,1864,30,615,1636,27,23.266666666666666,<=30,SA,Home,Upto 2014
M Ntini,SA,Pace,2000-12-08,Johannesburg,South Africa,2000,1,29,108,3,1,417,1127,13,388,1019,10,32.07692307692308,>30,SA,Home,Upto 2014
M Ntini,SA,Pace,2000-12-26,Durban,South Africa,2000,2,54,156,2,1,618,1336,17,564,1180,15,36.35294117647059,>30,SA,Home,Upto 2014
M Ntini,SA,Pace,2001-01-02,Cape Town,South Africa,2001,2,72,102,2,1,537,948,18,465,846,16,29.833333333333332,<=30,SA,Home,Upto 2014
M Ntini,SA,Pace,2001-01-20,Centurion,South Africa,2001,2,90,183,6,1,628,1061,26,538,878,20,24.153846153846153,<=30,SA,Home,Upto 2014
M Ntini,SA,Pace,2001-03-09,Georgetown,West Indies,2001,2,98,192,2,1,709,1722,18,611,1530,16,39.388888888888886,>30,WI,Away,Upto 2014
M Ntini,SA,Pace,2001-03-17,Port of Spain,West Indies,2001,2,78,192,3,1,814,1972,34,736,1780,31,23.941176470588236,<=30,WI,Away,Upto 2014
M Ntini,SA,Pace,2001-03-29,Bridgetown,West Indies,2001,1,93,168,2,1,750,1752,22,657,1584,20,34.09090909090909,>30,WI,Away,Upto 2014
M Ntini,SA,Pace,2001-04-06,St John's,West Indies,2001,1,27,36,0,1,374,1261,23,347,1225,23,16.26086956521739,<=30,WI,Away,Upto 2014
M Ntini,SA,Pace,2001-09-07,Harare,Zimbabwe,2001,2,108,216,1,1,919,1718,19,811,1502,18,48.36842105263158,>30,ZIM,Away,Upto 2014
M Ntini,SA,Pace,2001-09-14,Bulawayo,Zimbabwe,2001,2,79,168,0,1,548,1308,7,469,1140,7,78.28571428571429,>30,ZIM,Away,Upto 2014
M Ntini,SA,Pace,2001-11-03,Bloemfontein,South Africa,2001,2,110,148,2,1,966,1509,27,856,1361,25,35.77777777777778,>30,SA,Home,Upto 2014
M Ntini,SA,Pace,2001-11-16,Gqeberha,South Africa,2001,2,74,156,1,1,644,1436,22,570,1280,21,29.272727272727273,<=30,SA,Home,Upto 2014
M Ntini,SA,Pace,2001-12-14,Adelaide,Australia,2001,2,77,162,0,1,773,1644,20,696,1482,20,38.65,>30,AUS,Away,Upto 2014
M Ntini,SA,Pace,2002-02-22,Johannesburg,South Africa,2002,1,124,198,1,1,698,1059,20,574,861,19,34.9,>30,SA,Home,Upto 2014
M Ntini,SA,Pace,2002-03-08,Cape Town,South Africa,2002,2,183,281,5,1,927,1517,20,744,1236,15,46.35,>30,SA,Home,Upto 2014
M Ntini,SA,Pace,2002-03-15,Durban,South Africa,2002,2,152,222,5,1,733,1239,21,581,1017,16,34.904761904761905,>30,SA,Home,Upto 2014
M Ntini,SA,Pace,2002-10-18,East London,South Africa,2002,2,74,203,7,1,686,1167,21,612,964,14,32.666666666666664,>30,SA,Home,Upto 2014
M Ntini,SA,Pace,2002-10-25,Potchefstroom,South Africa,2002,2,106,198,5,1,588,1047,21,482,849,16,28.0,<=30,SA,Home,Upto 2014
M Ntini,SA,Pace,2002-11-08,Johannesburg,South Africa,2002,2,67,144,4,1,582,1139,26,515,995,22,22.384615384615383,<=30,SA,Home,Upto 2014
M Ntini,SA,Pace,2002-11-15,Centurion,South Africa,2002,2,138,306,8,1,905,1840,32,767,1534,24,28.28125,<=30,SA,Home,Upto 2014
M Ntini,SA,Pace,2002-12-26,Durban,South Africa,2002,2,132,234,5,1,631,1153,23,499,919,18,27.434782608695652,<=30,SA,Home,Upto 2014
M Ntini,SA,Pace,2003-01-02,Cape Town,South Africa,2003,2,95,215,8,1,694,1175,21,599,960,13,33.04761904761905,>30,SA,Home,Upto 2014
M Ntini,SA,Pace,2003-04-24,Chattogram,Bangladesh,2003,2,82,198,3,1,514,1056,11,432,858,8,46.72727272727273,>30,BAN,Away,Upto 2014
M Ntini,SA,Pace,2003-05-01,Dhaka,Bangladesh,2003,2,69,138,4,1,304,666,13,235,528,9,23.384615384615383,<=30,BAN,Away,Upto 2014
M Ntini,SA,Pace,2003-07-24,Birmingham,England,2003,2,152,192,4,1,873,1408,14,721,1216,10,62.357142857142854,>30,ENG,Away,Upto 2014
M Ntini,SA,Pace,2003-07-31,Lord's,England,2003,2,220,288,10,1,967,1600,24,747,1312,14,40.291666666666664,>30,ENG,Away,Upto 2014
M Ntini,SA,Pace,2003-08-14,Nottingham,England,2003,2,165,276,3,1,935,1991,38,770,1715,35,24.605263157894736,<=30,ENG,Away,Upto 2014
M Ntini,SA,Pace,2003-08-21,Leeds,England,2003,2,102,188,5,1,1130,2145,39,1028,1957,34,28.974358974358974,<=30,ENG,Away,Upto 2014
M Ntini,SA,Pace,2003-09-04,The Oval,England,2003,2,175,234,1,1,1075,1870,24,900,1636,23,44.791666666666664,>30,ENG,Away,Upto 2014
M Ntini,SA,Pace,2003-10-17,Lahore,Pakistan,2003,2,112,204,0,1,569,1080,10,457,876,10,56.9,>30,PAK,Away,Upto 2014
M Ntini,SA,Pace,2003-10-24,Faisalabad,Pakistan,2003,2,109,294,4,1,604,1451,24,495,1157,20,25.166666666666668,<=30,PAK,Away,Upto 2014
M Ntini,SA,Pace,2003-12-12,Johannesburg,South Africa,2003,2,147,276,9,1,1112,2121,34,965,1845,25,32.705882352941174,>30,SA,Home,Upto 2014
M Ntini,SA,Pace,2003-12-26,Durban,South Africa,2003,2,138,311,8,1,1030,1831,26,892,1520,18,39.61538461538461,>30,SA,Home,Upto 2014
M Ntini,SA,Pace,2004-01-02,Cape Town,South Africa,2004,2,187,246,4,1,1140,1873,23,953,1627,19,49.56521739130435,>30,SA,Home,Upto 2014
M Ntini,SA,Pace,2004-01-16,Centurion,South Africa,2004,2,148,288,8,1,1068,1800,24,920,1512,16,44.5,>30,SA,Home,Upto 2014
M Ntini,SA,Pace,2004-03-10,Hamilton,New Zealand,2004,2,89,198,1,1,760,1661,15,671,1463,14,50.666666666666664,>30,NZ,Away,Upto 2014
M Ntini,SA,Pace,2004-03-18,Auckland,New Zealand,2004,2,141,246,4,1,1016,1973,29,875,1727,25,35.03448275862069,>30,NZ,Away,Upto 2014
M Ntini,SA,Pace,2004-03-26,Wellington,New Zealand,2004,2,113,246,2,1,820,1651,25,707,1405,23,32.8,>30,NZ,Away,Upto 2014
M Ntini,SA,Pace,2004-08-04,Galle,Sri Lanka,2004,2,80,150,1,1,548,1192,14,468,1042,13,39.142857142857146,>30,SL,Away,Upto 2014
M Ntini,SA,Pace,2004-08-11,Colombo (SSC),Sri Lanka,2004,2,127,222,2,1,548,1014,21,421,792,19,26.095238095238095,<=30,SL,Away,Upto 2014
M Ntini,SA,Pace,2004-11-20,Kanpur,India,2004,1,135,234,3,1,487,976,10,352,742,7,48.7,>30,IND,Away,Upto 2014
M Ntini,SA,Pace,2004-11-28,Eden Gardens,India,2004,2,123,288,5,1,537,1338,17,414,1050,12,31.58823529411765,>30,IND,Away,Upto 2014
M Ntini,SA,Pace,2004-12-17,Gqeberha,South Africa,2004,2,99,208,4,1,915,1720,27,816,1512,23,33.888888888888886,>30,SA,Home,Upto 2014
M Ntini,SA,Pace,2004-12-26,Durban,South Africa,2004,2,152,300,5,1,968,1978,29,816,1678,24,33.37931034482759,>30,SA,Home,Upto 2014
M Ntini,SA,Pace,2005-01-02,Cape Town,South Africa,2005,2,99,262,6,1,830,1832,29,731,1570,23,28.620689655172413,<=30,SA,Home,Upto 2014
M Ntini,SA,Pace,2005-01-13,Johannesburg,South Africa,2005,2,173,325,7,1,1212,2062,34,1039,1737,27,35.64705882352941,>30,SA,Home,Upto 2014
M Ntini,SA,Pace,2005-01-21,Centurion,South Africa,2005,2,104,234,3,1,788,1589,28,684,1355,25,28.142857142857142,<=30,SA,Home,Upto 2014
M Ntini,SA,Pace,2005-03-04,Cape Town,South Africa,2005,2,91,156,5,1,443,710,15,352,554,10,29.533333333333335,<=30,SA,Home,Upto 2014
M Ntini,SA,Pace,2005-03-31,Georgetown,West Indies,2005,1,98,138,0,1,687,1530,15,589,1392,15,45.8,>30,WI,Away,Upto 2014
M Ntini,SA,Pace,2005-04-08,Port of Spain,West Indies,2005,2,132,287,13,1,854,1820,25,722,1533,12,34.16,>30,WI,Away,Upto 2014
M Ntini,SA,Pace,2005-04-21,Bridgetown,West Indies,2005,2,101,168,3,1,712,1449,24,611,1281,21,29.666666666666668,<=30,WI,Away,Upto 2014
M Ntini,SA,Pace,2005-04-29,St John's,West Indies,2005,1,106,198,1,1,1036,1736,12,930,1538,11,86.33333333333333,>30,WI,Away,Upto 2014
M Ntini,SA,Pace,2005-12-16,W.A.C.A,Australia,2005,2,177,318,6,1,1099,2050,27,922,1732,21,40.7037037037037,>30,AUS,Away,Upto 2014
M Ntini,SA,Pace,2005-12-26,Melbourne,Australia,2005,2,87,183,3,1,712,1466,23,625,1283,20,30.956521739130434,>30,AUS,Away,Upto 2014
M Ntini,SA,Pace,2006-03-16,Cape Town,South Africa,2006,2,104,186,5,1,563,1099,28,459,913,23,20.107142857142858,<=30,SA,Home,Upto 2014
M Ntini,SA,Pace,2006-03-24,Durban,South Africa,2006,2,143,234,4,1,838,1637,23,695,1403,19,36.43478260869565,>30,SA,Home,Upto 2014
M Ntini,SA,Pace,2006-03-31,Johannesburg,South Africa,2006,2,178,269,10,1,824,1490,30,646,1221,20,27.466666666666665,<=30,SA,Home,Upto 2014
M Ntini,SA,Pace,2006-04-15,Centurion,South Africa,2006,2,145,198,10,1,858,1550,38,713,1352,28,22.57894736842105,<=30,SA,Home,Upto 2014
M Ntini,SA,Pace,2006-04-27,Cape Town,South Africa,2006,2,187,306,5,1,739,1386,13,552,1080,8,56.84615384615385,>30,SA,Home,Upto 2014
M Ntini,SA,Pace,2006-05-05,Johannesburg,South Africa,2006,2,79,198,5,1,757,1280,36,678,1082,31,21.02777777777778,<=30,SA,Home,Upto 2014
M Ntini,SA,Pace,2006-07-27,Colombo (SSC),Sri Lanka,2006,1,97,186,0,1,781,1191,14,684,1005,14,55.785714285714285,>30,SL,Away,Upto 2014
M Ntini,SA,Pace,2006-08-04,Colombo (PSS),Sri Lanka,2006,2,97,170,5,1,843,1453,20,746,1283,15,42.15,>30,SL,Away,Upto 2014
M Ntini,SA,Pace,2006-12-15,Johannesburg,South Africa,2006,2,134,202,6,1,728,1389,33,594,1187,27,22.060606060606062,<=30,SA,Home,Upto 2014
M Ntini,SA,Pace,2006-12-26,Durban,South Africa,2006,2,89,204,8,1,879,1470,33,790,1266,25,26.636363636363637,<=30,SA,Home,Upto 2014
M Ntini,SA,Pace,2007-01-02,Cape Town,South Africa,2007,2,136,204,1,1,634,1285,20,498,1081,19,31.7,>30,SA,Home,Upto 2014
M Ntini,SA,Pace,2007-01-11,Centurion,South Africa,2007,2,161,240,6,1,894,1492,25,733,1252,19,35.76,>30,SA,Home,Upto 2014
M Ntini,SA,Pace,2007-01-19,Gqeberha,South Africa,2007,2,109,240,8,1,653,1296,27,544,1056,19,24.185185185185187,<=30,SA,Home,Upto 2014
M Ntini,SA,Pace,2007-01-26,Cape Town,South Africa,2007,2,85,139,5,1,527,865,27,442,726,22,19.51851851851852,<=30,SA,Home,Upto 2014
M Ntini,SA,Pace,2007-10-01,Karachi,Pakistan,2007,2,82,143,1,1,523,1031,16,441,888,15,32.6875,>30,PAK,Away,Upto 2014
M Ntini,SA,Pace,2007-10-08,Lahore,Pakistan,2007,2,102,150,4,1,635,1158,14,533,1008,10,45.357142857142854,>30,PAK,Away,Upto 2014
M Ntini,SA,Pace,2007-11-08,Johannesburg,South Africa,2007,2,89,162,3,1,740,1372,29,651,1210,26,25.517241379310345,<=30,SA,Home,Upto 2014
M Ntini,SA,Pace,2007-11-16,Centurion,South Africa,2007,2,91,166,3,1,609,994,26,518,828,23,23.423076923076923,<=30,SA,Home,Upto 2014
M Ntini,SA,Pace,2007-12-26,Gqeberha,South Africa,2007,2,135,246,4,1,900,1655,32,765,1409,28,28.125,<=30,SA,Home,Upto 2014
M Ntini,SA,Pace,2008-01-02,Cape Town,South Africa,2008,2,125,288,3,1,787,1720,28,662,1432,25,28.107142857142858,<=30,SA,Home,Upto 2014
M Ntini,SA,Pace,2008-01-10,Durban,South Africa,2008,2,125,162,3,1,883,1304,22,758,1142,19,40.13636363636363,>30,SA,Home,Upto 2014
M Ntini,SA,Pace,2008-02-22,Mirpur,Bangladesh,2008,2,82,174,1,1,379,784,18,297,610,17,21.055555555555557,<=30,BAN,Away,Upto 2014
M Ntini,SA,Pace,2008-02-29,Chattogram,Bangladesh,2008,2,45,112,4,1,376,687,12,331,575,8,31.333333333333332,>30,BAN,Away,Upto 2014
M Ntini,SA,Pace,2008-03-26,Chennai,India,2008,1,128,168,3,1,691,1044,8,563,876,5,86.375,>30,IND,Away,Upto 2014
M Ntini,SA,Pace,2008-04-03,Ahmedabad,India,2008,2,62,134,6,1,574,946,21,512,812,15,27.333333333333332,<=30,IND,Away,Upto 2014
M Ntini,SA,Pace,2008-04-11,Kanpur,India,2008,2,52,132,1,1,346,693,14,294,561,13,24.714285714285715,<=30,IND,Away,Upto 2014
M Ntini,SA,Pace,2008-07-10,Lord's,England,2008,1,130,174,0,1,845,1704,13,715,1530,13,65.0,>30,ENG,Away,Upto 2014
M Ntini,SA,Pace,2008-07-18,Leeds,England,2008,2,114,216,3,1,905,1732,27,791,1516,24,33.51851851851852,>30,ENG,Away,Upto 2014
M Ntini,SA,Pace,2008-07-30,Birmingham,England,2008,2,128,222,4,1,903,1618,29,775,1396,25,31.137931034482758,>30,ENG,Away,Upto 2014
M Ntini,SA,Pace,2008-08-07,The Oval,England,2008,2,149,228,7,1,862,1540,26,713,1312,19,33.15384615384615,>30,ENG,Away,Upto 2014
M Ntini,SA,Pace,2008-11-19,Bloemfontein,South Africa,2008,2,39,144,5,1,387,770,21,348,626,16,18.428571428571427,<=30,SA,Home,Upto 2014
M Ntini,SA,Pace,2008-11-26,Centurion,South Africa,2008,2,76,182,6,1,529,990,19,453,808,13,27.842105263157894,<=30,SA,Home,Upto 2014
M Ntini,SA,Pace,2008-12-17,W.A.C.A,Australia,2008,2,148,245,5,1,940,1782,28,792,1537,23,33.57142857142857,>30,AUS,Away,Upto 2014
M Ntini,SA,Pace,2008-12-26,Melbourne,Australia,2008,2,134,246,3,1,952,1716,26,818,1470,23,36.61538461538461,>30,AUS,Away,Upto 2014
M Ntini,SA,Pace,2009-01-03,Sydney,Australia,2009,2,168,246,1,1,952,2011,26,784,1765,25,36.61538461538461,>30,AUS,Away,Upto 2014
M Ntini,SA,Pace,2009-02-26,Johannesburg,South Africa,2009,2,123,228,5,1,938,1937,36,815,1709,31,26.055555555555557,<=30,SA,Home,Upto 2014
M Ntini,SA,Pace,2009-03-06,Durban,South Africa,2009,2,113,204,3,1,857,1739,26,744,1535,23,32.96153846153846,>30,SA,Home,Upto 2014
M Ntini,SA,Pace,2009-03-19,Cape Town,South Africa,2009,2,104,216,2,1,890,1587,18,786,1371,16,49.44444444444444,>30,SA,Home,Upto 2014
M Ntini,SA,Pace,2009-12-16,Centurion,South Africa,2009,2,119,246,2,1,848,1757,22,729,1511,20,38.54545454545455,>30,SA,Home,Upto 2014
M Ntini,SA,Pace,2009-12-26,Durban,South Africa,2009,1,114,174,0,1,616,1251,15,502,1077,15,41.06666666666667,>30,SA,Home,Upto 2014
M Prabhakar,IND,Pace,1984-12-12,Delhi,India,1984,2,86,144,1,1,406,798,8,320,654,7,50.75,>30,IND,Home,Upto 2014
M Prabhakar,IND,Pace,1984-12-31,Eden Gardens,India,1984,1,16,30,0,1,288,729,8,272,699,8,36.0,>30,IND,Home,Upto 2014
M Prabhakar,IND,Pace,1989-11-15,Karachi,Pakistan,1989,2,211,389,6,1,875,1711,26,664,1322,20,33.65384615384615,>30,PAK,Away,Upto 2014
M Prabhakar,IND,Pace,1989-11-23,Faisalabad,Pakistan,1989,1,132,255,6,1,850,1756,23,718,1501,17,36.95652173913044,>30,PAK,Away,Upto 2014
M Prabhakar,IND,Pace,1989-12-01,Lahore,Pakistan,1989,1,107,204,1,1,513,1118,6,406,914,5,85.5,>30,PAK,Away,Upto 2014
M Prabhakar,IND,Pace,1989-12-09,Sialkot,Pakistan,1989,1,92,240,3,1,741,1608,26,649,1368,23,28.5,<=30,PAK,Away,Upto 2014
M Prabhakar,IND,Pace,1990-02-02,Christchurch,New Zealand,1990,2,116,233,1,1,683,1242,22,567,1009,21,31.045454545454547,>30,NZ,Away,Upto 2014
M Prabhakar,IND,Pace,1990-02-09,Napier,New Zealand,1990,1,25,78,0,1,406,996,10,381,918,10,40.6,>30,NZ,Away,Upto 2014
M Prabhakar,IND,Pace,1990-02-22,Auckland,New Zealand,1990,2,241,404,4,1,1075,1694,19,834,1290,15,56.578947368421055,>30,NZ,Away,Upto 2014
M Prabhakar,IND,Pace,1990-07-26,Lord's,England,1990,2,232,326,2,1,1076,1683,21,844,1357,19,51.23809523809524,>30,ENG,Away,Upto 2014
M Prabhakar,IND,Pace,1990-08-09,Manchester,England,1990,2,192,258,2,1,835,1242,15,643,984,13,55.666666666666664,>30,ENG,Away,Upto 2014
M Prabhakar,IND,Pace,1990-08-23,The Oval,England,1990,2,130,346,4,1,853,1642,16,723,1296,12,53.3125,>30,ENG,Away,Upto 2014
M Prabhakar,IND,Pace,1990-11-23,Chandigarh,India,1990,2,71,144,4,1,244,603,12,173,459,8,20.333333333333332,<=30,IND,Home,Upto 2014
M Prabhakar,IND,Pace,1991-11-29,Brisbane,Australia,1991,2,91,234,2,1,581,1459,29,490,1225,27,20.03448275862069,<=30,AUS,Away,Upto 2014
M Prabhakar,IND,Pace,1991-12-26,Melbourne,Australia,1991,2,122,270,5,1,732,1688,29,610,1418,24,25.24137931034483,<=30,AUS,Away,Upto 2014
M Prabhakar,IND,Pace,1992-01-02,Sydney,Australia,1992,2,135,396,4,1,641,1594,19,506,1198,15,33.73684210526316,>30,AUS,Away,Upto 2014
M Prabhakar,IND,Pace,1992-01-25,Adelaide,Australia,1992,2,115,234,2,1,796,1827,30,681,1593,28,26.533333333333335,<=30,AUS,Away,Upto 2014
M Prabhakar,IND,Pace,1992-02-01,W.A.C.A,Australia,1992,2,217,389,6,1,946,1994,34,729,1605,28,27.823529411764707,<=30,AUS,Away,Upto 2014
M Prabhakar,IND,Pace,1992-10-18,Harare,Zimbabwe,1992,2,88,354,4,1,480,1630,15,392,1276,11,32.0,>30,ZIM,Away,Upto 2014
M Prabhakar,IND,Pace,1992-11-13,Durban,South Africa,1992,2,94,232,2,1,480,1371,14,386,1139,12,34.285714285714285,>30,SA,Away,Upto 2014
M Prabhakar,IND,Pace,1992-11-26,Johannesburg,South Africa,1992,2,164,314,5,1,741,2035,23,577,1721,18,32.21739130434783,>30,SA,Away,Upto 2014
M Prabhakar,IND,Pace,1992-12-26,Gqeberha,South Africa,1992,2,64,120,1,1,485,1194,23,421,1074,22,21.08695652173913,<=30,SA,Away,Upto 2014
M Prabhakar,IND,Pace,1993-01-02,Cape Town,South Africa,1993,2,67,198,1,1,434,1582,19,367,1384,18,22.842105263157894,<=30,SA,Away,Upto 2014
M Prabhakar,IND,Pace,1993-01-29,Eden Gardens,India,1993,2,36,108,1,1,387,856,9,351,748,8,43.0,>30,IND,Home,Upto 2014
M Prabhakar,IND,Pace,1993-02-11,Chennai,India,1993,2,11,36,0,1,257,522,5,246,486,5,51.4,>30,IND,Home,Upto 2014
M Prabhakar,IND,Pace,1993-02-19,Wankhede,India,1993,2,80,144,4,1,325,648,9,245,504,5,36.111111111111114,>30,IND,Home,Upto 2014
M Prabhakar,IND,Pace,1993-03-13,Delhi,India,1993,2,28,108,1,1,351,630,4,323,522,3,87.75,>30,IND,Home,Upto 2014
M Prabhakar,IND,Pace,1993-07-17,Kandy,Sri Lanka,1993,1,13,36,2,1,23,72,3,10,36,1,7.666666666666667,<=30,SL,Away,Upto 2014
M Prabhakar,IND,Pace,1993-07-27,Colombo (SSC),Sri Lanka,1993,2,92,203,6,1,627,1409,18,535,1206,12,34.833333333333336,>30,SL,Away,Upto 2014
M Prabhakar,IND,Pace,1993-08-04,Colombo (PSS),Sri Lanka,1993,2,118,312,4,1,384,1057,10,266,745,6,38.4,>30,SL,Away,Upto 2014
M Prabhakar,IND,Pace,1994-01-18,Lucknow,India,1994,2,74,196,3,1,249,514,6,175,318,3,41.5,>30,IND,Home,Upto 2014
M Prabhakar,IND,Pace,1994-01-26,Bengaluru,India,1994,2,100,138,5,1,326,460,11,226,322,6,29.636363636363637,<=30,IND,Home,Upto 2014
M Prabhakar,IND,Pace,1994-02-08,Ahmedabad,India,1994,2,24,60,0,1,174,408,3,150,348,3,58.0,>30,IND,Home,Upto 2014
M Prabhakar,IND,Pace,1994-11-18,Wankhede,India,1994,2,35,42,2,1,502,993,23,467,951,21,21.82608695652174,<=30,IND,Home,Upto 2014
M Prabhakar,IND,Pace,1994-12-01,Nagpur,India,1994,1,15,24,0,1,503,867,8,488,843,8,62.875,>30,IND,Home,Upto 2014
M Prabhakar,IND,Pace,1994-12-10,Mohali,India,1994,2,99,162,0,1,720,1337,21,621,1175,21,34.285714285714285,>30,IND,Home,Upto 2014
M Prabhakar,IND,Pace,1995-10-18,Bengaluru,India,1995,2,38,84,2,1,331,688,17,293,604,15,19.470588235294116,<=30,IND,Home,Upto 2014
M Prabhakar,IND,Pace,1995-11-08,Cuttack,India,1995,1,10,30,0,1,240,497,7,230,467,7,34.285714285714285,>30,IND,Home,Upto 2014
M Prasidh Krishna,IND,Pace,2023-12-26,Centurion,South Africa,2023,1,93,120,1,1,718,1149,27,625,1029,26,26.59259259259259,<=30,SA,Away,After 1965
M Prasidh Krishna,IND,Pace,2024-01-03,Cape Town,South Africa,2024,2,37,48,1,1,441,642,32,404,594,31,13.78125,<=30,SA,Away,After 1965
M Prasidh Krishna,IND,Pace,2025-01-03,Sydney,Australia,2025,2,107,162,6,1,502,925,30,395,763,24,16.733333333333334,<=30,AUS,Away,After 1965
M Shumba,ZIM,Spin,2021-04-29,Harare,Zimbabwe,2021,1,29,54,0,1,256,510,4,227,456,4,64.0,>30,ZIM,Home,After 1965
M Shumba,ZIM,Spin,2021-05-07,Harare,Zimbabwe,2021,1,73,90,0,1,364,605,9,291,515,9,40.44444444444444,>30,ZIM,Home,After 1965
M Shumba,ZIM,Spin,2021-07-07,Harare,Zimbabwe,2021,2,131,202,1,1,544,1099,15,413,897,14,36.266666666666666,>30,ZIM,Home,After 1965
M Shumba,ZIM,Spin,2023-02-12,Bulawayo,Zimbabwe,2023,1,17,24,0,1,284,566,18,267,542,18,15.777777777777779,<=30,ZIM,Home,After 1965
M Theekshana,SL,Spin,2022-07-08,Galle,Sri Lanka,2022,2,76,126,3,1,757,1422,23,681,1296,20,32.91304347826087,>30,SL,Home,After 1965
M Theekshana,SL,Spin,2022-07-16,Galle,Sri Lanka,2022,2,112,239,2,1,840,1795,26,728,1556,24,32.30769230769231,>30,SL,Home,After 1965
M Venkataramana,IND,Spin,1989-04-28,Kingston,West Indies,1989,2,58,70,1,1,262,519,4,204,449,3,65.5,>30,WI,Away,Upto 2014
M Vijay,IND,Spin,2013-12-18,Johannesburg,South Africa,2013,1,3,6,0,1,344,574,4,341,568,4,86.0,>30,SA,Away,Upto 2014
M Vijay,IND,Spin,2014-07-09,Nottingham,England,2014,1,8,12,0,1,324,594,5,316,582,5,64.8,>30,ENG,Away,After 1965
M Vijay,IND,Spin,2014-07-17,Lord's,England,2014,2,23,42,1,1,190,511,7,167,469,6,27.142857142857142,<=30,ENG,Away,After 1965
M Vijay,IND,Spin,2014-07-27,Southampton,England,2014,1,1,6,0,1,407,690,15,406,684,15,27.133333333333333,<=30,ENG,Away,After 1965
M Vijay,IND,Spin,2014-12-09,Adelaide,Australia,2014,2,56,114,0,1,652,937,17,596,823,17,38.35294117647059,>30,AUS,Away,After 1965
M Vijay,IND,Spin,2014-12-26,Melbourne,Australia,2014,1,14,30,0,1,388,732,7,374,702,7,55.42857142857143,>30,AUS,Away,After 1965
M Vijay,IND,Spin,2015-06-10,Fatullah,Bangladesh,2015,1,0,6,0,1,528,806,14,528,800,14,37.714285714285715,>30,BAN,Away,After 1965
M Vijay,IND,Spin,2015-12-03,Delhi,India,2015,1,2,12,0,1,551,1517,20,549,1505,20,27.55,<=30,IND,Home,After 1965
M Vijay,IND,Spin,2016-09-22,Kanpur,India,2016,2,13,36,0,1,859,1714,26,846,1678,26,33.03846153846154,>30,IND,Home,After 1965
M Vijay,IND,Spin,2016-10-08,Indore,India,2016,1,27,42,0,1,676,1243,22,649,1201,22,30.727272727272727,>30,IND,Home,After 1965
M Vijay,IND,Spin,2017-03-16,Ranchi,India,2017,1,17,18,0,1,755,1725,15,738,1707,15,50.333333333333336,>30,IND,Home,After 1965
M Vijay,IND,Spin,2017-12-02,Delhi,India,2017,1,3,6,0,1,881,1566,17,878,1560,17,51.8235294117647,>30,IND,Home,After 1965
M Vijay,IND,Spin,2018-12-06,Adelaide,Australia,2018,2,21,48,0,1,390,1013,14,369,965,14,27.857142857142858,<=30,AUS,Away,After 1965
M Vijay,IND,Spin,2018-12-14,Perth,Australia,2018,1,10,6,0,1,200,497,10,190,491,10,20.0,<=30,AUS,Away,After 1965
M Watkinson,ENG,Spin,1995-07-27,Manchester,England,1995,2,92,192,5,1,271,569,5,179,377,0,54.2,>30,ENG,Home,Upto 2014
M Watkinson,ENG,Spin,1995-08-10,Nottingham,England,1995,1,84,210,3,1,465,1032,7,381,822,4,66.42857142857143,>30,ENG,Home,Upto 2014
M Watkinson,ENG,Spin,1995-08-24,The Oval,England,1995,1,113,156,0,1,255,528,1,142,372,1,255.0,>30,ENG,Home,Upto 2014
M Watkinson,ENG,Spin,1996-01-02,Cape Town,South Africa,1996,2,59,114,2,1,171,377,6,112,263,4,28.5,<=30,SA,Away,Upto 2014
M Zondeki,SA,Pace,2003-08-21,Leeds,England,2003,2,25,29,0,1,1130,2145,39,1105,2116,39,28.974358974358974,<=30,ENG,Away,Upto 2014
M Zondeki,SA,Pace,2005-03-11,Centurion,South Africa,2005,2,105,213,9,1,611,1095,23,506,882,14,26.565217391304348,<=30,SA,Home,Upto 2014
M Zondeki,SA,Pace,2005-04-08,Port of Spain,West Indies,2005,2,95,156,0,1,854,1820,25,759,1664,25,34.16,>30,WI,Away,Upto 2014
M Zondeki,SA,Pace,2005-04-21,Bridgetown,West Indies,2005,2,93,144,4,1,712,1449,24,619,1305,20,29.666666666666668,<=30,WI,Away,Upto 2014
M Zondeki,SA,Pace,2005-04-29,St John's,West Indies,2005,1,120,150,3,1,1036,1736,12,916,1586,9,86.33333333333333,>30,WI,Away,Upto 2014
M Zondeki,SA,Pace,2008-11-26,Centurion,South Africa,2008,2,42,88,3,1,529,990,19,487,902,16,27.842105263157894,<=30,SA,Home,Upto 2014
M de Lange,SA,Pace,2011-12-26,Durban,South Africa,2011,2,126,218,8,1,674,1304,26,548,1086,18,25.923076923076923,<=30,SA,Home,Upto 2014
M de Lange,SA,Pace,2012-03-23,Wellington,New Zealand,2012,2,151,230,1,1,873,1620,25,722,1390,24,34.92,>30,NZ,Away,Upto 2014
M van Jaarsveld,SA,Spin,2004-08-11,Colombo (SSC),Sri Lanka,2004,1,28,42,0,1,470,988,13,442,946,13,36.15384615384615,>30,SL,Away,Upto 2014
MA Atherton,ENG,Spin,1989-08-10,Nottingham,England,1989,1,24,42,0,1,273,660,7,249,618,7,39.0,>30,ENG,Home,Upto 2014
MA Atherton,ENG,Spin,1989-08-24,The Oval,England,1989,1,10,6,0,1,165,312,2,155,306,2,82.5,>30,ENG,Home,Upto 2014
MA Atherton,ENG,Spin,1990-06-21,Lord's,England,1990,1,0,6,0,1,264,588,7,264,582,7,37.714285714285715,>30,ENG,Home,Upto 2014
MA Atherton,ENG,Spin,1990-07-05,Birmingham,England,1990,1,17,54,0,1,288,747,13,271,693,13,22.153846153846153,<=30,ENG,Home,Upto 2014
MA Atherton,ENG,Spin,1990-07-26,Lord's,England,1990,1,11,6,0,1,488,672,6,477,666,6,81.33333333333333,>30,ENG,Home,Upto 2014
MA Atherton,ENG,Spin,1990-08-09,Manchester,England,1990,2,90,120,0,1,724,1465,14,634,1345,14,51.714285714285715,>30,ENG,Home,Upto 2014
MA Atherton,ENG,Spin,1990-08-23,The Oval,England,1990,1,60,42,1,1,500,1062,6,440,1020,5,83.33333333333333,>30,ENG,Home,Upto 2014
MA Atherton,ENG,Spin,1990-11-23,Brisbane,Australia,1990,1,16,12,0,1,46,114,1,30,102,1,46.0,>30,AUS,Away,Upto 2014
MA Atherton,ENG,Spin,1990-12-26,Melbourne,Australia,1990,2,17,30,0,1,220,612,3,203,582,3,73.33333333333333,>30,AUS,Away,Upto 2014
MA Atherton,ENG,Spin,1991-01-04,Sydney,Australia,1991,2,37,48,0,1,645,1458,16,608,1410,16,40.3125,>30,AUS,Away,Upto 2014
MA Atherton,ENG,Spin,1996-08-08,Leeds,England,1996,1,20,42,1,1,168,414,4,148,372,3,42.0,>30,ENG,Home,Upto 2014
MA Beer,AUS,Spin,2011-01-03,Sydney,Australia,2011,1,112,228,1,1,291,570,3,179,342,2,97.0,>30,AUS,Home,Upto 2014
MA Beer,AUS,Spin,2012-04-15,Port of Spain,West Indies,2012,2,66,178,2,1,339,951,13,273,773,11,26.076923076923077,<=30,WI,Away,Upto 2014
MA Butcher,ENG,Pace,1997-07-24,Leeds,England,1997,1,14,12,0,1,800,1403,28,786,1391,28,28.571428571428573,<=30,ENG,Home,Upto 2014
MA Butcher,ENG,Pace,1998-02-13,Port of Spain,West Indies,1998,1,1,12,0,1,618,1619,31,617,1607,31,19.93548387096774,<=30,WI,Away,Upto 2014
MA Butcher,ENG,Pace,1998-02-27,Georgetown,West Indies,1998,1,15,18,0,1,412,1052,21,397,1034,21,19.61904761904762,<=30,WI,Away,Upto 2014
MA Butcher,ENG,Pace,1998-06-04,Birmingham,England,1998,1,2,6,0,1,706,1575,23,704,1569,23,30.695652173913043,>30,ENG,Home,Upto 2014
MA Butcher,ENG,Pace,1998-07-23,Nottingham,England,1998,1,12,24,0,1,995,2152,32,983,2128,32,31.09375,>30,ENG,Home,Upto 2014
MA Butcher,ENG,Pace,1998-08-06,Leeds,England,1998,1,23,54,0,1,826,2084,40,803,2030,40,20.65,<=30,ENG,Home,Upto 2014
MA Butcher,ENG,Pace,1998-08-27,The Oval,England,1998,1,16,66,0,1,707,1308,12,691,1242,12,58.916666666666664,>30,ENG,Home,Upto 2014
MA Butcher,ENG,Pace,1999-07-01,Birmingham,England,1999,1,25,42,1,1,580,1146,27,555,1104,26,21.48148148148148,<=30,ENG,Home,Upto 2014
MA Butcher,ENG,Pace,1999-07-22,Lord's,England,1999,1,7,18,0,1,642,1427,25,635,1409,25,25.68,<=30,ENG,Home,Upto 2014
MA Butcher,ENG,Pace,1999-08-05,Manchester,England,1999,1,13,12,0,1,505,1189,11,492,1177,11,45.90909090909091,>30,ENG,Home,Upto 2014
MA Butcher,ENG,Pace,1999-12-26,Durban,South Africa,1999,1,32,50,2,1,784,1865,22,752,1815,20,35.63636363636363,>30,SA,Away,Upto 2014
MA Butcher,ENG,Pace,2000-01-02,Cape Town,South Africa,2000,1,9,18,0,1,594,1440,24,585,1422,24,24.75,<=30,SA,Away,Upto 2014
MA Butcher,ENG,Pace,2001-07-05,Birmingham,England,2001,1,42,54,4,1,685,933,19,643,879,15,36.05263157894737,>30,ENG,Home,Upto 2014
MA Butcher,ENG,Pace,2001-07-19,Lord's,England,2001,1,12,18,0,1,636,1130,28,624,1112,28,22.714285714285715,<=30,ENG,Home,Upto 2014
MA Butcher,ENG,Pace,2001-08-16,Leeds,England,2001,1,7,6,0,1,1054,1608,26,1047,1602,26,40.53846153846154,>30,ENG,Home,Upto 2014
MA Butcher,ENG,Pace,2001-08-23,The Oval,England,2001,1,2,6,0,1,586,1029,9,584,1023,9,65.11111111111111,>30,ENG,Home,Upto 2014
MA Butcher,ENG,Pace,2001-12-03,Mohali,India,2001,1,19,42,1,1,398,794,9,379,752,8,44.22222222222222,>30,IND,Away,Upto 2014
MA Butcher,ENG,Pace,2002-03-30,Auckland,New Zealand,2002,2,40,84,2,1,809,1459,39,769,1375,37,20.743589743589745,<=30,NZ,Away,Upto 2014
MA Butcher,ENG,Pace,2002-05-16,Lord's,England,2002,1,17,18,0,1,1188,2251,20,1171,2233,20,59.4,>30,ENG,Home,Upto 2014
MA Butcher,ENG,Pace,2002-08-22,Leeds,England,2002,1,0,6,0,1,769,1387,15,769,1381,15,51.266666666666666,>30,ENG,Home,Upto 2014
MA Butcher,ENG,Pace,2002-11-07,Brisbane,Australia,2002,1,12,12,0,1,677,1218,20,665,1206,20,33.85,>30,AUS,Away,Upto 2014
MA Butcher,ENG,Pace,2002-11-29,W.A.C.A,Australia,2002,1,40,60,0,1,590,1095,16,550,1035,16,36.875,>30,AUS,Away,Upto 2014
MA Butcher,ENG,Pace,2002-12-26,Melbourne,Australia,2002,1,52,78,0,1,740,1406,19,688,1328,19,38.94736842105263,>30,AUS,Away,Upto 2014
MA Butcher,ENG,Pace,2003-05-22,Lord's,England,2003,2,68,107,5,1,641,1236,26,573,1129,21,24.653846153846153,<=30,ENG,Home,Upto 2014
MA Butcher,ENG,Pace,2003-06-05,Chester-le-Street,England,2003,1,9,12,0,1,554,1098,27,545,1086,27,20.51851851851852,<=30,ENG,Home,Upto 2014
MA Butcher,ENG,Pace,2003-07-24,Birmingham,England,2003,1,15,12,0,1,873,1408,14,858,1396,14,62.357142857142854,>30,ENG,Home,Upto 2014
MA Butcher,ENG,Pace,2003-07-31,Lord's,England,2003,1,19,36,0,1,967,1600,24,948,1564,24,40.291666666666664,>30,ENG,Home,Upto 2014
MA Butcher,ENG,Pace,2003-09-04,The Oval,England,2003,1,18,18,0,1,1075,1870,24,1057,1852,24,44.791666666666664,>30,ENG,Home,Upto 2014
MA Ealham,ENG,Pace,1996-07-04,Nottingham,England,1996,2,111,258,6,1,859,1781,24,748,1523,18,35.791666666666664,>30,ENG,Home,Upto 2014
MA Ealham,ENG,Pace,1996-07-25,Lord's,England,1996,2,81,222,1,1,850,1771,26,769,1549,25,32.69230769230769,>30,ENG,Home,Upto 2014
MA Ealham,ENG,Pace,1997-06-05,Birmingham,England,1997,1,60,94,3,1,837,1443,24,777,1349,21,34.875,>30,ENG,Home,Upto 2014
MA Ealham,ENG,Pace,1997-07-03,Manchester,England,1997,2,75,144,3,1,664,1429,26,589,1285,23,25.53846153846154,<=30,ENG,Home,Upto 2014
MA Ealham,ENG,Pace,1997-07-24,Leeds,England,1997,1,56,114,2,1,800,1403,28,744,1289,26,28.571428571428573,<=30,ENG,Home,Upto 2014
MA Ealham,ENG,Pace,1998-06-04,Birmingham,England,1998,1,55,138,1,1,706,1575,23,651,1437,22,30.695652173913043,>30,ENG,Home,Upto 2014
MA Ealham,ENG,Pace,1998-06-18,Lord's,England,1998,1,50,90,1,1,618,1463,26,568,1373,25,23.76923076923077,<=30,ENG,Home,Upto 2014
MA Hanley,SA,Spin,1949-01-01,Cape Town,South Africa,1949,2,88,232,1,1,568,1444,18,480,1212,17,31.555555555555557,>30,SA,Home,Upto 2014
MA Holding,WI,Pace,1975-11-28,Brisbane,Australia,1975,2,127,240,0,1,663,1224,17,536,984,17,39.0,>30,AUS,Away,Upto 2014
MA Holding,WI,Pace,1975-12-12,W.A.C.A,Australia,1975,2,141,237,4,1,857,1286,28,716,1049,24,30.607142857142858,>30,AUS,Away,Upto 2014
MA Holding,WI,Pace,1976-01-03,Sydney,Australia,1976,2,112,224,4,1,784,1539,30,672,1315,26,26.133333333333333,<=30,AUS,Away,Upto 2014
MA Holding,WI,Pace,1976-01-23,Adelaide,Australia,1976,2,181,288,1,1,939,1486,26,758,1198,25,36.11538461538461,>30,AUS,Away,Upto 2014
MA Holding,WI,Pace,1976-01-31,Melbourne,Australia,1976,2,53,136,1,1,775,1378,27,722,1242,26,28.703703703703702,<=30,AUS,Away,Upto 2014
MA Holding,WI,Pace,1976-03-10,Bridgetown,West Indies,1976,2,46,168,4,1,313,600,12,267,432,8,26.083333333333332,<=30,WI,Home,Upto 2014
MA Holding,WI,Pace,1976-03-24,Port of Spain,West Indies,1976,1,68,162,2,1,260,654,5,192,492,3,52.0,>30,WI,Home,Upto 2014
MA Holding,WI,Pace,1976-04-07,Port of Spain,West Indies,1976,2,147,286,6,1,338,682,7,191,396,1,48.285714285714285,>30,WI,Home,Upto 2014
MA Holding,WI,Pace,1976-04-21,Kingston,West Indies,1976,2,117,212,7,1,382,807,9,265,595,2,42.44444444444444,>30,WI,Home,Upto 2014
MA Holding,WI,Pace,1976-06-17,Lord's,England,1976,2,108,276,3,1,584,1335,24,476,1059,21,24.333333333333332,<=30,ENG,Away,Upto 2014
MA Holding,WI,Pace,1976-07-08,Manchester,England,1976,2,41,227,7,1,437,1066,29,396,839,22,15.068965517241379,<=30,ENG,Away,Upto 2014
MA Holding,WI,Pace,1976-07-22,Leeds,England,1976,2,58,132,4,1,969,1786,39,911,1654,35,24.846153846153847,<=30,ENG,Away,Upto 2014
MA Holding,WI,Pace,1976-08-12,The Oval,England,1976,2,149,322,14,1,768,1323,20,619,1001,6,38.4,>30,ENG,Away,Upto 2014
MA Holding,WI,Pace,1979-12-01,Brisbane,Australia,1979,2,147,276,2,1,937,2006,27,790,1730,25,34.7037037037037,>30,AUS,Away,Upto 2014
MA Holding,WI,Pace,1979-12-29,Melbourne,Australia,1979,2,101,222,6,1,659,1369,27,558,1147,21,24.40740740740741,<=30,AUS,Away,Upto 2014
MA Holding,WI,Pace,1980-01-26,Adelaide,Australia,1980,2,71,168,6,1,844,1627,35,773,1459,29,24.114285714285714,<=30,AUS,Away,Upto 2014
MA Holding,WI,Pace,1980-02-08,Dunedin,New Zealand,1980,2,74,228,5,1,533,1670,35,459,1442,30,15.228571428571428,<=30,NZ,Away,Upto 2014
MA Holding,WI,Pace,1980-02-22,Christchurch,New Zealand,1980,1,97,174,2,1,946,1857,20,849,1683,18,47.3,>30,NZ,Away,Upto 2014
MA Holding,WI,Pace,1980-02-29,Auckland,New Zealand,1980,2,65,162,0,1,786,1985,29,721,1823,29,27.103448275862068,<=30,NZ,Away,Upto 2014
MA Holding,WI,Pace,1980-06-05,Nottingham,England,1980,2,126,299,1,1,897,2129,36,771,1830,35,24.916666666666668,<=30,ENG,Away,Upto 2014
MA Holding,WI,Pace,1980-06-19,Lord's,England,1980,2,118,258,6,1,667,1407,18,549,1149,12,37.05555555555556,>30,ENG,Away,Upto 2014
MA Holding,WI,Pace,1980-07-10,Manchester,England,1980,2,146,288,3,1,678,1412,23,532,1124,20,29.47826086956522,<=30,ENG,Away,Upto 2014
MA Holding,WI,Pace,1980-07-24,The Oval,England,1980,2,146,342,6,1,630,1595,25,484,1253,19,25.2,<=30,ENG,Away,Upto 2014
MA Holding,WI,Pace,1980-08-07,Leeds,England,1980,2,96,198,4,1,526,1199,25,430,1001,21,21.04,<=30,ENG,Away,Upto 2014
MA Holding,WI,Pace,1981-02-13,Port of Spain,West Indies,1981,2,67,174,3,1,521,1338,21,454,1164,18,24.80952380952381,<=30,WI,Home,Upto 2014
MA Holding,WI,Pace,1981-03-13,Bridgetown,West Indies,1981,2,62,180,5,1,801,1640,34,739,1460,29,23.558823529411764,<=30,WI,Home,Upto 2014
MA Holding,WI,Pace,1981-03-27,St John's,West Indies,1981,2,72,164,2,1,702,1430,20,630,1266,18,35.1,>30,WI,Home,Upto 2014
MA Holding,WI,Pace,1981-04-10,Kingston,West Indies,1981,2,114,276,7,1,705,1477,22,591,1201,15,32.04545454545455,>30,WI,Home,Upto 2014
MA Holding,WI,Pace,1981-12-26,Melbourne,Australia,1981,2,107,231,11,1,642,1526,35,535,1295,24,18.34285714285714,<=30,AUS,Away,Upto 2014
MA Holding,WI,Pace,1982-01-02,Sydney,Australia,1982,2,95,288,5,1,792,1770,20,697,1482,15,39.6,>30,AUS,Away,Upto 2014
MA Holding,WI,Pace,1982-01-30,Adelaide,Australia,1982,2,142,324,8,1,872,1878,30,730,1554,22,29.066666666666666,<=30,AUS,Away,Upto 2014
MA Holding,WI,Pace,1983-02-23,Kingston,West Indies,1983,2,93,246,4,1,545,1266,30,452,1020,26,18.166666666666668,<=30,WI,Home,Upto 2014
MA Holding,WI,Pace,1983-03-11,Port of Spain,West Indies,1983,2,130,264,2,1,669,1364,18,539,1100,16,37.166666666666664,>30,WI,Home,Upto 2014
MA Holding,WI,Pace,1983-03-31,Georgetown,West Indies,1983,1,72,96,1,1,361,700,8,289,604,7,45.125,>30,WI,Home,Upto 2014
MA Holding,WI,Pace,1983-04-15,Bridgetown,West Indies,1983,2,121,210,4,1,618,1146,24,497,936,20,25.75,<=30,WI,Home,Upto 2014
MA Holding,WI,Pace,1983-04-28,St John's,West Indies,1983,1,86,156,1,1,719,1355,18,633,1199,17,39.94444444444444,>30,WI,Home,Upto 2014
MA Holding,WI,Pace,1983-10-21,Kanpur,India,1983,2,96,202,6,1,584,1065,26,488,863,20,22.46153846153846,<=30,IND,Away,Upto 2014
MA Holding,WI,Pace,1983-10-29,Delhi,India,1983,2,143,241,6,1,784,1399,23,641,1158,17,34.08695652173913,>30,IND,Away,Upto 2014
MA Holding,WI,Pace,1983-11-12,Ahmedabad,India,1983,2,110,258,6,1,524,1257,33,414,999,27,15.878787878787879,<=30,IND,Away,Upto 2014
MA Holding,WI,Pace,1983-11-24,Wankhede,India,1983,2,141,311,6,1,698,1403,16,557,1092,10,43.625,>30,IND,Away,Upto 2014
MA Holding,WI,Pace,1983-12-10,Eden Gardens,India,1983,2,88,174,6,1,475,988,25,387,814,19,19.0,<=30,IND,Away,Upto 2014
MA Holding,WI,Pace,1983-12-24,Chennai,India,1983,1,85,156,0,1,443,882,12,358,726,12,36.916666666666664,>30,IND,Away,Upto 2014
MA Holding,WI,Pace,1984-03-30,Bridgetown,West Indies,1984,2,118,270,6,1,810,1566,27,692,1296,21,30.0,<=30,WI,Home,Upto 2014
MA Holding,WI,Pace,1984-04-07,St John's,West Indies,1984,2,64,203,4,1,745,1490,28,681,1287,24,26.607142857142858,<=30,WI,Home,Upto 2014
MA Holding,WI,Pace,1984-04-28,Kingston,West Indies,1984,2,63,138,3,1,537,1132,24,474,994,21,22.375,<=30,WI,Home,Upto 2014
MA Holding,WI,Pace,1984-06-14,Birmingham,England,1984,2,73,168,2,1,672,1256,23,599,1088,21,29.217391304347824,<=30,ENG,Away,Upto 2014
MA Holding,WI,Pace,1984-07-12,Leeds,England,1984,2,101,218,4,1,659,1294,24,558,1076,20,27.458333333333332,<=30,ENG,Away,Upto 2014
MA Holding,WI,Pace,1984-07-26,Manchester,England,1984,2,71,192,2,1,536,1172,18,465,980,16,29.77777777777778,<=30,ENG,Away,Upto 2014
MA Holding,WI,Pace,1984-08-09,The Oval,England,1984,2,98,156,7,1,809,1686,40,711,1530,33,20.225,<=30,ENG,Away,Upto 2014
MA Holding,WI,Pace,1984-11-09,W.A.C.A,Australia,1984,2,74,125,7,1,700,1337,30,626,1212,23,23.333333333333332,<=30,AUS,Away,Upto 2014
MA Holding,WI,Pace,1984-11-23,Brisbane,Australia,1984,2,101,218,5,1,749,1407,30,648,1189,25,24.966666666666665,<=30,AUS,Away,Upto 2014
MA Holding,WI,Pace,1984-12-30,Sydney,Australia,1984,1,74,186,3,1,535,1040,12,461,854,9,44.583333333333336,>30,AUS,Away,Upto 2014
MA Holding,WI,Pace,1985-03-29,Port of Spain,West Indies,1985,2,115,276,5,1,784,1698,30,669,1422,25,26.133333333333333,<=30,WI,Home,Upto 2014
MA Holding,WI,Pace,1985-04-06,Georgetown,West Indies,1985,1,89,168,3,1,825,1600,20,736,1432,17,41.25,>30,WI,Home,Upto 2014
MA Holding,WI,Pace,1985-04-26,Bridgetown,West Indies,1985,2,14,48,1,1,558,1140,29,544,1092,28,19.24137931034483,<=30,WI,Home,Upto 2014
MA Holding,WI,Pace,1986-02-21,Kingston,West Indies,1986,2,88,114,3,1,543,1027,29,455,913,26,18.724137931034484,<=30,WI,Home,Upto 2014
MA Holding,WI,Pace,1986-03-21,Bridgetown,West Indies,1986,2,84,138,5,1,585,983,28,501,845,23,20.892857142857142,<=30,WI,Home,Upto 2014
MA Holding,WI,Pace,1986-04-03,Port of Spain,West Indies,1986,2,97,148,5,1,614,1036,27,517,888,22,22.74074074074074,<=30,WI,Home,Upto 2014
MA Holding,WI,Pace,1986-04-11,St John's,West Indies,1986,2,116,216,3,1,906,1622,22,790,1406,19,41.18181818181818,>30,WI,Home,Upto 2014
MA Holding,WI,Pace,1987-02-20,Wellington,New Zealand,1987,2,99,222,0,1,656,1620,18,557,1398,18,36.44444444444444,>30,NZ,Away,Upto 2014
MA Noble,AUS,Spin,1898-01-01,Melbourne,Australia,1898,2,80,174,7,1,483,1191,22,403,1017,15,21.954545454545453,<=30,AUS,Home,After 1965
MA Noble,AUS,Spin,1898-01-14,Adelaide,Australia,1898,2,162,347,8,1,414,1001,10,252,654,2,41.4,>30,AUS,Home,After 1965
MA Noble,AUS,Spin,1898-01-29,Melbourne,Australia,1898,2,52,138,2,1,328,761,11,276,623,9,29.818181818181817,<=30,AUS,Home,After 1965
MA Noble,AUS,Spin,1898-02-26,Sydney,Australia,1898,2,91,246,2,1,340,888,10,249,642,8,34.0,>30,AUS,Home,After 1965
MA Noble,AUS,Spin,1899-06-01,Nottingham,England,1899,2,59,135,2,1,270,732,12,211,597,10,22.5,<=30,ENG,Away,After 1965
MA Noble,AUS,Spin,1899-06-15,Lord's,England,1899,2,76,174,3,1,387,894,12,311,720,9,32.25,>30,ENG,Away,After 1965
MA Noble,AUS,Spin,1899-06-29,Leeds,England,1899,2,90,225,3,1,225,608,11,135,383,8,20.454545454545453,<=30,ENG,Away,After 1965
MA Noble,AUS,Spin,1899-07-17,Manchester,England,1899,1,85,190,3,1,220,480,7,135,290,4,31.428571428571427,>30,ENG,Away,After 1965
MA Noble,AUS,Spin,1899-08-14,The Oval,England,1899,1,96,179,2,1,465,899,10,369,720,8,46.5,>30,ENG,Away,After 1965
MA Noble,AUS,Spin,1901-12-13,Sydney,Australia,1901,1,91,198,1,1,360,868,16,269,670,15,22.5,<=30,AUS,Home,Upto 2014
MA Noble,AUS,Spin,1902-01-01,Melbourne,Australia,1902,2,77,202,13,1,445,1043,26,368,841,13,17.115384615384617,<=30,AUS,Home,Upto 2014
MA Noble,AUS,Spin,1902-01-17,Adelaide,Australia,1902,2,130,282,3,1,888,2292,24,758,2010,21,37.0,>30,AUS,Home,Upto 2014
MA Noble,AUS,Spin,1902-02-14,Sydney,Australia,1902,2,132,344,8,1,685,1842,29,553,1498,21,23.620689655172413,<=30,AUS,Home,Upto 2014
MA Noble,AUS,Spin,1902-02-28,Melbourne,Australia,1902,2,178,354,7,1,602,1354,31,424,1000,24,19.419354838709676,<=30,AUS,Home,Upto 2014
MA Noble,AUS,Spin,1902-05-29,Birmingham,England,1902,1,112,264,1,1,217,576,11,105,312,10,19.727272727272727,<=30,ENG,Away,Upto 2014
MA Noble,AUS,Spin,1902-06-12,Lord's,England,1902,1,0,12,0,1,20,60,0,20,48,0,inf,>30,ENG,Away,Upto 2014
MA Noble,AUS,Spin,1902-07-03,Sheffield,England,1902,2,103,240,11,1,486,1005,28,383,765,17,17.357142857142858,<=30,ENG,Away,Upto 2014
MA Noble,AUS,Spin,1902-07-24,Manchester,England,1902,2,57,174,2,1,549,1292,26,492,1118,24,21.115384615384617,<=30,ENG,Away,Upto 2014
MA Noble,AUS,Spin,1902-08-11,The Oval,England,1902,2,35,72,0,1,548,1222,24,513,1150,24,22.833333333333332,<=30,ENG,Away,Upto 2014
MA Noble,AUS,Spin,1902-10-11,Johannesburg,South Africa,1902,2,61,114,3,1,619,846,16,558,732,13,38.6875,>30,SA,Away,Upto 2014
MA Noble,AUS,Spin,1902-10-18,Johannesburg,South Africa,1902,1,75,90,3,1,315,623,23,240,533,20,13.695652173913043,<=30,SA,Away,Upto 2014
MA Noble,AUS,Spin,1902-11-08,Cape Town,South Africa,1902,2,29,60,0,1,284,500,12,255,440,12,23.666666666666668,<=30,SA,Away,Upto 2014
MA Noble,AUS,Spin,1903-12-11,Sydney,Australia,1903,2,136,276,3,1,839,1769,19,703,1493,16,44.1578947368421,>30,AUS,Home,Upto 2014
MA Noble,AUS,Spin,1904-01-01,Melbourne,Australia,1904,1,4,36,0,1,442,925,27,438,889,27,16.37037037037037,<=30,AUS,Home,Upto 2014
MA Noble,AUS,Spin,1904-01-15,Adelaide,Australia,1904,1,10,18,1,1,537,1176,17,527,1158,16,31.58823529411765,>30,AUS,Home,Upto 2014
MA Noble,AUS,Spin,1904-02-26,Sydney,Australia,1904,2,140,361,8,1,399,1183,23,259,822,15,17.347826086956523,<=30,AUS,Home,Upto 2014
MA Noble,AUS,Spin,1904-03-05,Melbourne,Australia,1904,2,38,126,4,1,273,552,23,235,426,19,11.869565217391305,<=30,AUS,Home,Upto 2014
MA Noble,AUS,Spin,1905-05-29,Nottingham,England,1905,2,50,60,0,1,379,970,12,329,910,12,31.583333333333332,>30,ENG,Away,Upto 2014
MA Noble,AUS,Spin,1905-06-15,Lord's,England,1905,2,92,282,1,1,233,619,9,141,337,8,25.88888888888889,<=30,ENG,Away,Upto 2014
MA Noble,AUS,Spin,1905-07-03,Leeds,England,1905,2,127,258,1,1,435,1029,13,308,771,12,33.46153846153846,>30,ENG,Away,Upto 2014
MA Noble,AUS,Spin,1905-07-24,Manchester,England,1905,1,33,95,2,1,187,487,8,154,392,6,23.375,<=30,ENG,Away,Upto 2014
MA Noble,AUS,Spin,1905-08-14,The Oval,England,1905,2,107,195,2,1,332,711,4,225,516,2,83.0,>30,ENG,Away,Upto 2014
MA Noble,AUS,Spin,1907-12-13,Sydney,Australia,1907,2,37,126,2,1,592,1308,17,555,1182,15,34.8235294117647,>30,AUS,Home,Upto 2014
MA Noble,AUS,Spin,1908-01-01,Melbourne,Australia,1908,2,67,186,2,1,799,1914,21,732,1728,19,38.04761904761905,>30,AUS,Home,Upto 2014
MA Noble,AUS,Spin,1908-01-10,Adelaide,Australia,1908,2,52,150,0,1,776,1611,17,724,1461,17,45.64705882352941,>30,AUS,Home,Upto 2014
MA Noble,AUS,Spin,1908-02-07,Melbourne,Australia,1908,2,25,108,4,1,481,1034,24,456,926,20,20.041666666666668,<=30,AUS,Home,Upto 2014
MA Noble,AUS,Spin,1908-02-21,Sydney,Australia,1908,2,118,312,3,1,812,1824,30,694,1512,27,27.066666666666666,<=30,AUS,Home,Upto 2014
MA Noble,AUS,Spin,1909-05-27,Birmingham,England,1909,1,2,6,0,1,222,633,19,220,627,19,11.68421052631579,<=30,ENG,Away,Upto 2014
MA Noble,AUS,Spin,1909-06-14,Lord's,England,1909,2,54,176,4,1,254,821,16,200,645,12,15.875,<=30,ENG,Away,Upto 2014
MA Noble,AUS,Spin,1909-07-01,Leeds,England,1909,1,22,78,0,1,230,608,17,208,530,17,13.529411764705882,<=30,ENG,Away,Upto 2014
MA Noble,AUS,Spin,1909-07-26,Manchester,England,1909,1,11,48,0,1,297,675,13,286,627,13,22.846153846153847,<=30,ENG,Away,Upto 2014
MA Noble,AUS,Spin,1909-08-09,The Oval,England,1909,1,29,48,0,1,627,1104,11,598,1056,11,57.0,>30,ENG,Away,Upto 2014
MA Seymour,SA,Spin,1963-12-06,Brisbane,Australia,1963,1,39,88,0,1,346,1069,8,307,981,8,43.25,>30,AUS,Away,Upto 2014
MA Seymour,SA,Spin,1964-01-01,Melbourne,Australia,1964,1,56,152,1,1,262,721,5,206,569,4,52.4,>30,AUS,Away,Upto 2014
MA Seymour,SA,Spin,1964-01-24,Adelaide,Australia,1964,2,92,248,1,1,269,512,2,177,264,1,134.5,>30,AUS,Away,Upto 2014
MA Seymour,SA,Spin,1964-02-07,Sydney,Australia,1964,1,80,304,3,1,341,1120,10,261,816,7,34.1,>30,AUS,Away,Upto 2014
MA Seymour,SA,Spin,1964-12-04,Durban,South Africa,1964,1,144,276,1,1,464,1264,16,320,988,15,29.0,<=30,SA,Home,Upto 2014
MA Seymour,SA,Spin,1964-12-23,Johannesburg,South Africa,1964,1,109,210,1,1,545,1457,14,436,1247,13,38.92857142857143,>30,SA,Home,Upto 2014
MA Seymour,SA,Spin,1970-01-22,Cape Town,South Africa,1970,2,68,180,2,1,547,1442,19,479,1262,17,28.789473684210527,<=30,SA,Home,Upto 2014
MA Small,WI,Pace,1984-03-16,Port of Spain,West Indies,1984,2,75,144,1,1,693,1381,19,618,1237,18,36.473684210526315,>30,WI,Home,Upto 2014
MA Small,WI,Pace,1984-06-28,Lord's,England,1984,2,78,126,3,1,986,1843,27,908,1717,24,36.51851851851852,>30,ENG,Away,Upto 2014
MA Starc,AUS,Pace,2011-12-01,Brisbane,Australia,2011,2,123,156,2,1,653,1114,19,530,958,17,34.36842105263158,>30,AUS,Home,Upto 2014
MA Starc,AUS,Pace,2011-12-09,Hobart,Australia,2011,2,77,180,2,1,648,1341,37,571,1161,35,17.513513513513512,<=30,AUS,Home,Upto 2014
MA Starc,AUS,Pace,2012-01-13,W.A.C.A,Australia,2012,2,70,146,4,1,668,1156,29,598,1010,25,23.03448275862069,<=30,AUS,Home,Upto 2014
MA Starc,AUS,Pace,2012-04-23,Roseau,West Indies,2012,2,55,128,2,1,492,1142,12,437,1014,10,41.0,>30,WI,Away,Upto 2014
MA Starc,AUS,Pace,2012-11-30,W.A.C.A,Australia,2012,2,209,269,8,1,885,1522,30,676,1253,22,29.5,<=30,AUS,Home,Upto 2014
MA Starc,AUS,Pace,2012-12-14,Hobart,Australia,2012,2,167,314,6,1,927,1883,26,760,1569,20,35.65384615384615,>30,AUS,Home,Upto 2014
MA Starc,AUS,Pace,2013-01-03,Sydney,Australia,2013,2,120,186,4,1,729,1200,20,609,1014,16,36.45,>30,AUS,Home,Upto 2014
MA Starc,AUS,Pace,2013-02-22,Chennai,India,2013,1,75,150,0,1,415,813,8,340,663,8,51.875,>30,IND,Away,Upto 2014
MA Starc,AUS,Pace,2013-03-14,Mohali,India,2013,2,125,201,2,1,473,880,15,348,679,13,31.533333333333335,>30,IND,Away,Upto 2014
MA Starc,AUS,Pace,2013-07-10,Nottingham,England,2013,2,135,294,5,1,827,1665,33,692,1371,28,25.060606060606062,<=30,ENG,Away,Upto 2014
MA Starc,AUS,Pace,2013-08-01,Manchester,England,2013,2,82,186,3,1,710,1434,19,628,1248,16,37.36842105263158,>30,ENG,Away,Upto 2014
MA Starc,AUS,Pace,2013-08-21,The Oval,England,2013,2,140,240,3,1,836,1443,25,696,1203,22,33.44,>30,ENG,Away,Upto 2014
MA Starc,AUS,Pace,2014-10-30,Abu Dhabi,UAE,2014,2,142,232,2,1,549,1024,11,407,792,9,49.90909090909091,>30,UAE,Away,After 1965
MA Starc,AUS,Pace,2014-12-17,Brisbane,Australia,2014,2,110,150,2,1,959,1402,28,849,1252,26,34.25,>30,AUS,Home,After 1965
MA Starc,AUS,Pace,2015-01-06,Sydney,Australia,2015,2,142,306,5,1,942,1653,21,800,1347,16,44.857142857142854,>30,AUS,Home,After 1965
MA Starc,AUS,Pace,2015-06-03,Roseau,West Indies,2015,2,76,198,6,1,402,941,20,326,743,14,20.1,<=30,WI,Away,After 1965
MA Starc,AUS,Pace,2015-06-11,Kingston,West Indies,2015,2,84,162,4,1,528,1091,25,444,929,21,21.12,<=30,WI,Away,After 1965
MA Starc,AUS,Pace,2015-07-08,Cardiff,England,2015,2,174,241,7,1,901,1488,27,727,1247,20,33.370370370370374,>30,ENG,Away,After 1965
MA Starc,AUS,Pace,2015-07-16,Lord's,England,2015,2,102,174,2,1,791,1369,21,689,1195,19,37.666666666666664,>30,ENG,Away,After 1965
MA Starc,AUS,Pace,2015-07-29,Birmingham,England,2015,2,104,133,3,1,619,1035,28,515,902,25,22.107142857142858,<=30,ENG,Away,After 1965
MA Starc,AUS,Pace,2015-08-06,Nottingham,England,2015,1,111,162,6,1,542,945,29,431,783,23,18.689655172413794,<=30,ENG,Away,After 1965
MA Starc,AUS,Pace,2015-08-20,The Oval,England,2015,2,58,144,0,1,638,1293,22,580,1149,22,29.0,<=30,ENG,Away,After 1965
MA Starc,AUS,Pace,2015-11-05,Brisbane,Australia,2015,2,126,227,6,1,1023,1505,20,897,1278,14,51.15,>30,AUS,Home,After 1965
MA Starc,AUS,Pace,2015-11-13,W.A.C.A,Australia,2015,2,152,258,4,1,1234,1914,22,1082,1656,18,56.09090909090909,>30,AUS,Home,After 1965
MA Starc,AUS,Pace,2015-11-27,Adelaide,Australia,2015,1,24,54,3,1,584,1142,29,560,1088,26,20.137931034482758,<=30,AUS,Home,After 1965
MA Starc,AUS,Pace,2016-07-26,Pallekele,Sri Lanka,2016,2,135,180,6,1,306,556,14,171,376,8,21.857142857142858,<=30,SL,Away,After 1965
MA Starc,AUS,Pace,2016-08-04,Galle,Sri Lanka,2016,2,94,172,11,1,224,424,15,130,252,4,14.933333333333334,<=30,SL,Away,After 1965
MA Starc,AUS,Pace,2016-08-13,Colombo (SSC),Sri Lanka,2016,2,135,268,7,1,336,652,8,201,384,1,42.0,>30,SL,Away,After 1965
MA Starc,AUS,Pace,2016-11-03,W.A.C.A,Australia,2016,2,185,298,5,1,937,1726,29,752,1428,24,32.310344827586206,>30,AUS,Home,After 1965
MA Starc,AUS,Pace,2016-11-12,Hobart,Australia,2016,1,79,144,3,1,477,1007,29,398,863,26,16.448275862068964,<=30,AUS,Home,After 1965
MA Starc,AUS,Pace,2016-11-24,Adelaide,Australia,2016,2,158,278,6,1,686,1407,24,528,1129,18,28.583333333333332,<=30,AUS,Home,After 1965
MA Starc,AUS,Pace,2016-12-15,Brisbane,Australia,2016,2,182,336,7,1,820,1566,28,638,1230,21,29.285714285714285,<=30,AUS,Home,After 1965
MA Starc,AUS,Pace,2016-12-26,Melbourne,Australia,2016,2,161,278,5,1,778,1397,19,617,1119,14,40.94736842105263,>30,AUS,Home,After 1965
MA Starc,AUS,Pace,2017-01-03,Sydney,Australia,2017,2,134,258,2,1,587,1109,15,453,851,13,39.13333333333333,>30,AUS,Home,After 1965
MA Starc,AUS,Pace,2017-02-23,Pune,India,2017,2,38,66,2,1,160,354,9,122,288,7,17.77777777777778,<=30,IND,Away,After 1965
MA Starc,AUS,Pace,2017-03-04,Bengaluru,India,2017,2,113,186,3,1,391,822,14,278,636,11,27.928571428571427,<=30,IND,Away,After 1965
MA Starc,AUS,Pace,2017-11-23,Brisbane,Australia,2017,2,128,264,6,1,713,1568,21,585,1304,15,33.95238095238095,>30,AUS,Home,After 1965
MA Starc,AUS,Pace,2017-12-02,Adelaide,Australia,2017,2,137,236,8,1,779,1712,31,642,1476,23,25.129032258064516,<=30,AUS,Home,After 1965
MA Starc,AUS,Pace,2017-12-14,W.A.C.A,Australia,2017,2,135,253,5,1,965,1713,24,830,1460,19,40.208333333333336,>30,AUS,Home,After 1965
MA Starc,AUS,Pace,2018-01-04,Sydney,Australia,2018,2,118,222,3,1,630,1294,17,512,1072,14,37.05882352941177,>30,AUS,Home,After 1965
MA Starc,AUS,Pace,2018-03-01,Durban,South Africa,2018,2,109,172,9,1,640,1256,26,531,1084,17,24.615384615384617,<=30,SA,Away,After 1965
MA Starc,AUS,Pace,2018-03-09,Gqeberha,South Africa,2018,2,125,220,1,1,673,1296,28,548,1076,27,24.035714285714285,<=30,SA,Away,After 1965
MA Starc,AUS,Pace,2018-03-22,Cape Town,South Africa,2018,2,179,264,2,1,789,1457,31,610,1193,29,25.451612903225808,<=30,SA,Away,After 1965
MA Starc,AUS,Pace,2018-10-07,Dubai (DICS),UAE,2018,2,108,254,1,1,373,938,11,265,684,10,33.90909090909091,>30,UAE,Away,After 1965
MA Starc,AUS,Pace,2018-10-16,Abu Dhabi,UAE,2018,2,69,114,3,1,398,700,16,329,586,13,24.875,<=30,UAE,Away,After 1965
MA Starc,AUS,Pace,2018-12-06,Adelaide,Australia,2018,2,103,245,5,1,635,1467,25,532,1222,20,25.4,<=30,AUS,Home,After 1965
MA Starc,AUS,Pace,2018-12-14,Perth,Australia,2018,2,125,246,5,1,753,1685,30,628,1439,25,25.1,<=30,AUS,Home,After 1965
MA Starc,AUS,Pace,2018-12-26,Melbourne,Australia,2018,2,98,186,2,1,621,1425,29,523,1239,27,21.413793103448278,<=30,AUS,Home,After 1965
MA Starc,AUS,Pace,2019-01-03,Sydney,Australia,2019,1,123,156,1,1,459,804,6,336,648,5,76.5,>30,AUS,Home,After 1965
MA Starc,AUS,Pace,2019-01-24,Brisbane,Australia,2019,2,97,156,2,1,398,892,24,301,736,22,16.583333333333332,<=30,AUS,Home,After 1965
MA Starc,AUS,Pace,2019-02-01,Canberra,Australia,2019,2,100,189,10,1,709,1113,23,609,924,13,30.82608695652174,>30,AUS,Home,After 1965
MA Starc,AUS,Pace,2019-09-04,Manchester,England,2019,2,126,228,4,1,783,1519,27,657,1291,23,29.0,<=30,ENG,Away,After 1965
MA Starc,AUS,Pace,2019-11-21,Brisbane,Australia,2019,2,125,208,7,1,600,1180,22,475,972,15,27.272727272727273,<=30,AUS,Home,After 1965
MA Starc,AUS,Pace,2019-11-29,Adelaide,Australia,2019,2,113,246,7,1,654,1168,17,541,922,10,38.470588235294116,>30,AUS,Home,After 1965
MA Starc,AUS,Pace,2019-12-12,Perth,Australia,2019,2,97,192,9,1,626,1383,31,529,1191,22,20.193548387096776,<=30,AUS,Home,After 1965
MA Starc,AUS,Pace,2019-12-26,Melbourne,Australia,2019,2,89,167,2,1,729,1616,26,640,1449,24,28.03846153846154,<=30,AUS,Home,After 1965
MA Starc,AUS,Pace,2020-01-03,Sydney,Australia,2020,2,82,180,4,1,593,1249,16,511,1069,12,37.0625,>30,AUS,Home,After 1965
MA Starc,AUS,Pace,2020-12-17,Adelaide,Australia,2020,2,60,162,4,1,408,970,22,348,808,18,18.545454545454547,<=30,AUS,Home,After 1965
MA Starc,AUS,Pace,2020-12-26,Melbourne,Australia,2020,2,98,180,4,1,523,1170,20,425,990,16,26.15,<=30,AUS,Home,After 1965
MA Starc,AUS,Pace,2021-01-07,Sydney,Australia,2021,2,127,246,1,1,762,1640,19,635,1394,18,40.10526315789474,>30,AUS,Home,After 1965
MA Starc,AUS,Pace,2021-01-15,Brisbane,Australia,2021,2,163,234,2,1,950,1738,30,787,1504,28,31.666666666666668,>30,AUS,Home,After 1965
MA Starc,AUS,Pace,2021-12-08,Brisbane,Australia,2021,2,112,192,3,1,608,1187,25,496,995,22,24.32,<=30,AUS,Home,After 1965
MA Starc,AUS,Pace,2021-12-16,Adelaide,Australia,2021,2,80,259,6,1,845,1824,27,765,1565,21,31.296296296296298,>30,AUS,Home,After 1965
MA Starc,AUS,Pace,2021-12-26,Melbourne,Australia,2021,2,83,150,5,1,423,909,26,340,759,21,16.26923076923077,<=30,AUS,Home,After 1965
MA Starc,AUS,Pace,2022-01-05,Sydney,Australia,2022,2,124,204,1,1,798,1621,23,674,1417,22,34.69565217391305,>30,AUS,Home,After 1965
MA Starc,AUS,Pace,2022-01-14,Hobart,Australia,2022,2,83,108,4,1,700,1252,39,617,1144,35,17.94871794871795,<=30,AUS,Home,After 1965
MA Starc,AUS,Pace,2022-03-04,Rawalpindi,Pakistan,2022,2,100,186,0,1,479,990,4,379,804,4,119.75,>30,PAK,Away,After 1965
MA Starc,AUS,Pace,2022-03-12,Karachi,Pakistan,2022,2,87,204,3,1,534,1143,14,447,939,11,38.142857142857146,>30,PAK,Away,After 1965
MA Starc,AUS,Pace,2022-03-21,Lahore,Pakistan,2022,2,86,226,5,1,523,1268,24,437,1042,19,21.791666666666668,<=30,PAK,Away,After 1965
MA Starc,AUS,Pace,2022-06-29,Galle,Sri Lanka,2022,2,54,66,1,1,116,191,4,62,125,3,29.0,<=30,SL,Away,After 1965
MA Starc,AUS,Pace,2022-07-08,Galle,Sri Lanka,2022,1,89,174,4,1,290,570,7,201,396,3,41.42857142857143,>30,SL,Away,After 1965
MA Starc,AUS,Pace,2022-11-30,Perth,Australia,2022,2,116,270,4,1,842,1610,13,726,1340,9,64.76923076923077,>30,AUS,Home,After 1965
MA Starc,AUS,Pace,2022-12-08,Adelaide,Australia,2022,2,77,153,5,1,712,1214,23,635,1061,18,30.956521739130434,>30,AUS,Home,After 1965
MA Starc,AUS,Pace,2022-12-17,Brisbane,Australia,2022,2,67,150,5,1,432,770,30,365,620,25,14.4,<=30,AUS,Home,After 1965
MA Starc,AUS,Pace,2022-12-26,Melbourne,Australia,2022,2,101,186,3,1,684,1223,19,583,1037,16,36.0,>30,AUS,Home,After 1965
MA Starc,AUS,Pace,2023-03-01,Indore,India,2023,2,35,72,1,1,84,162,4,49,90,3,21.0,<=30,IND,Away,After 1965
MA Starc,AUS,Pace,2023-03-09,Ahmedabad,India,2023,1,97,132,1,1,466,654,3,369,522,2,155.33333333333334,>30,IND,Away,After 1965
MA Starc,AUS,Pace,2023-06-07,The Oval,England,2023,2,148,166,4,1,1032,1672,28,884,1506,24,36.857142857142854,>30,ENG,Away,After 1965
MA Starc,AUS,Pace,2023-06-28,Lord's,England,2023,2,167,231,6,1,1187,1964,35,1020,1733,29,33.91428571428571,>30,ENG,Away,After 1965
MA Starc,AUS,Pace,2023-07-06,Leeds,England,2023,2,137,180,7,1,803,1163,34,666,983,27,23.61764705882353,<=30,ENG,Away,After 1965
MA Starc,AUS,Pace,2023-07-19,Manchester,England,2023,1,137,150,2,1,889,1350,23,752,1200,21,38.65217391304348,>30,ENG,Away,After 1965
MA Starc,AUS,Pace,2023-07-27,The Oval,England,2023,2,182,208,8,1,971,1598,29,789,1390,21,33.48275862068966,>30,ENG,Away,After 1965
MA Starc,AUS,Pace,2023-12-14,Perth,Australia,2023,2,99,204,5,1,810,1410,28,711,1206,23,28.928571428571427,<=30,AUS,Home,After 1965
MA Starc,AUS,Pace,2023-12-26,Melbourne,Australia,2023,2,124,176,4,1,818,1640,35,694,1464,31,23.37142857142857,<=30,AUS,Home,After 1965
MA Starc,AUS,Pace,2024-01-03,Sydney,Australia,2024,2,90,120,3,1,504,897,22,414,777,19,22.90909090909091,<=30,AUS,Home,After 1965
MA Starc,AUS,Pace,2024-01-17,Adelaide,Australia,2024,2,83,132,3,1,512,947,27,429,815,24,18.962962962962962,<=30,AUS,Home,After 1965
MA Starc,AUS,Pace,2024-01-25,Brisbane,Australia,2024,2,127,231,5,1,777,1334,30,650,1103,25,25.9,<=30,AUS,Home,After 1965
MA Starc,AUS,Pace,2024-02-29,Wellington,New Zealand,2024,2,63,108,1,1,689,1266,22,626,1158,21,31.318181818181817,>30,NZ,Away,After 1965
MA Starc,AUS,Pace,2024-03-08,Christchurch,New Zealand,2024,2,153,204,4,1,918,1490,33,765,1286,29,27.818181818181817,<=30,NZ,Away,After 1965
MA Starc,AUS,Pace,2024-11-22,Perth,Australia,2024,2,125,222,3,1,555,1114,27,430,892,24,20.555555555555557,<=30,AUS,Home,After 1965
MA Starc,AUS,Pace,2024-12-06,Adelaide,Australia,2024,2,108,169,8,1,507,779,28,399,610,20,18.107142857142858,<=30,AUS,Home,After 1965
MA Starc,AUS,Pace,2024-12-14,Brisbane,Australia,2024,2,87,151,3,1,550,932,24,463,781,21,22.916666666666668,<=30,AUS,Home,After 1965
MA Starc,AUS,Pace,2024-12-26,Melbourne,Australia,2024,2,111,246,1,1,849,1700,27,738,1454,26,31.444444444444443,>30,AUS,Home,After 1965
MA Starc,AUS,Pace,2025-01-03,Sydney,Australia,2025,2,85,132,3,1,502,925,30,417,793,27,16.733333333333334,<=30,AUS,Home,After 1965
MA Starc,AUS,Pace,2025-01-29,Galle,Sri Lanka,2025,2,27,78,3,1,104,168,3,77,90,0,34.666666666666664,>30,SL,Away,After 1965
MA Taylor,AUS,Pace,1993-03-04,Wellington,New Zealand,1993,1,15,24,0,1,647,1552,21,632,1528,21,30.80952380952381,>30,NZ,Away,Upto 2014
MA Taylor,AUS,Pace,1994-10-05,Rawalpindi,Pakistan,1994,1,11,18,1,1,838,1506,23,827,1488,22,36.43478260869565,>30,PAK,Away,Upto 2014
MA Vermeulen,ZIM,Spin,2004-05-14,Bulawayo,Zimbabwe,2004,1,5,6,0,1,302,532,8,297,526,8,37.75,>30,ZIM,Home,Upto 2014
MA Wood,ENG,Pace,2015-05-21,Lord's,England,2015,2,140,240,4,1,1185,2044,33,1045,1804,29,35.90909090909091,>30,ENG,Home,After 1965
MA Wood,ENG,Pace,2015-05-29,Leeds,England,2015,2,159,198,5,1,1058,1587,28,899,1389,23,37.785714285714285,>30,ENG,Home,After 1965
MA Wood,ENG,Pace,2015-07-08,Cardiff,England,2015,2,119,204,4,1,901,1488,27,782,1284,23,33.370370370370374,>30,ENG,Home,After 1965
MA Wood,ENG,Pace,2015-07-16,Lord's,England,2015,2,131,228,1,1,791,1369,21,660,1141,20,37.666666666666664,>30,ENG,Home,After 1965
MA Wood,ENG,Pace,2015-08-06,Nottingham,England,2015,2,82,124,4,1,542,945,29,460,821,25,18.689655172413794,<=30,ENG,Home,After 1965
MA Wood,ENG,Pace,2015-08-20,The Oval,England,2015,1,59,156,1,1,638,1293,22,579,1137,21,29.0,<=30,ENG,Home,After 1965
MA Wood,ENG,Pace,2015-10-13,Abu Dhabi,UAE,2015,2,87,174,1,1,582,1249,16,495,1075,15,36.375,>30,UAE,Away,After 1965
MA Wood,ENG,Pace,2015-10-22,Dubai (DICS),UAE,2015,2,83,203,5,1,554,1207,19,471,1004,14,29.157894736842106,<=30,UAE,Away,After 1965
MA Wood,ENG,Pace,2017-07-06,Lord's,England,2017,2,68,126,1,1,720,1257,22,652,1131,21,32.72727272727273,>30,ENG,Home,After 1965
MA Wood,ENG,Pace,2017-07-14,Nottingham,England,2017,2,129,210,0,1,739,1395,28,610,1185,28,26.392857142857142,<=30,ENG,Home,After 1965
MA Wood,ENG,Pace,2018-03-30,Christchurch,New Zealand,2018,2,114,258,2,1,933,2022,34,819,1764,32,27.441176470588236,<=30,NZ,Away,After 1965
MA Wood,ENG,Pace,2018-05-24,Lord's,England,2018,2,81,165,2,1,631,1332,28,550,1167,26,22.535714285714285,<=30,ENG,Home,After 1965
MA Wood,ENG,Pace,2019-02-09,Gros Islet,West Indies,2019,2,93,122,6,1,684,1370,27,591,1248,21,25.333333333333332,<=30,WI,Away,After 1965
MA Wood,ENG,Pace,2020-01-16,Gqeberha,South Africa,2020,2,63,167,3,1,517,1029,13,454,862,10,39.76923076923077,>30,SA,Away,After 1965
MA Wood,ENG,Pace,2020-01-24,Johannesburg,South Africa,2020,2,100,184,9,1,1022,1773,39,922,1589,30,26.205128205128204,<=30,SA,Away,After 1965
MA Wood,ENG,Pace,2020-07-08,Southampton,England,2020,2,110,204,2,1,825,1729,32,715,1525,30,25.78125,<=30,ENG,Home,After 1965
MA Wood,ENG,Pace,2021-01-14,Galle,Sri Lanka,2021,2,70,162,0,1,215,534,7,145,372,7,30.714285714285715,>30,SL,Away,After 1965
MA Wood,ENG,Pace,2021-01-22,Galle,Sri Lanka,2021,1,84,168,3,1,261,633,10,177,465,7,26.1,<=30,SL,Away,After 1965
MA Wood,ENG,Pace,2021-06-02,Lord's,England,2021,2,112,204,4,1,792,1822,27,680,1618,23,29.333333333333332,<=30,ENG,Home,After 1965
MA Wood,ENG,Pace,2021-06-10,Birmingham,England,2021,2,93,155,2,1,672,1387,27,579,1232,25,24.88888888888889,<=30,ENG,Home,After 1965
MA Wood,ENG,Pace,2021-08-12,Lord's,England,2021,2,142,253,5,1,917,2031,34,775,1778,29,26.970588235294116,<=30,ENG,Home,After 1965
MA Wood,ENG,Pace,2021-12-08,Brisbane,Australia,2021,2,89,154,3,1,608,1187,25,519,1033,22,24.32,<=30,AUS,Away,After 1965
MA Wood,ENG,Pace,2021-12-26,Melbourne,Australia,2021,1,71,119,2,1,423,909,26,352,790,24,16.26923076923077,<=30,AUS,Away,After 1965
MA Wood,ENG,Pace,2022-01-05,Sydney,Australia,2022,2,141,247,3,1,798,1621,23,657,1374,20,34.69565217391305,>30,AUS,Away,After 1965
MA Wood,ENG,Pace,2022-01-14,Hobart,Australia,2022,2,152,207,9,1,700,1252,39,548,1045,30,17.94871794871795,<=30,AUS,Away,After 1965
MA Wood,ENG,Pace,2022-03-08,North Sound,West Indies,2022,1,45,102,1,1,832,1769,23,787,1667,22,36.17391304347826,>30,WI,Away,After 1965
MA Wood,ENG,Pace,2022-12-09,Multan,Pakistan,2022,2,105,197,6,1,291,582,12,186,385,6,24.25,<=30,PAK,Away,After 1965
MA Wood,ENG,Pace,2022-12-17,Karachi,Pakistan,2022,2,58,162,2,1,137,318,3,79,156,1,45.666666666666664,>30,PAK,Away,After 1965
MA Wood,ENG,Pace,2023-07-06,Leeds,England,2023,2,100,172,7,1,803,1163,34,703,991,27,23.61764705882353,<=30,ENG,Home,After 1965
MA Wood,ENG,Pace,2023-07-19,Manchester,England,2023,2,87,168,4,1,889,1350,23,802,1182,19,38.65217391304348,>30,ENG,Home,After 1965
MA Wood,ENG,Pace,2023-07-27,The Oval,England,2023,2,96,186,3,1,971,1598,29,875,1412,26,33.48275862068966,>30,ENG,Home,After 1965
MA Wood,ENG,Pace,2024-01-25,Hyderabad,India,2024,2,62,150,0,1,181,364,6,119,214,6,30.166666666666668,>30,IND,Away,After 1965
MA Wood,ENG,Pace,2024-02-15,Rajkot,India,2024,2,160,227,4,1,471,750,11,311,523,7,42.81818181818182,>30,IND,Away,After 1965
MA Wood,ENG,Pace,2024-03-07,Dharamsala,India,2024,1,89,90,0,1,287,408,5,198,318,5,57.4,>30,IND,Away,After 1965
MA Wood,ENG,Pace,2024-07-18,Nottingham,England,2024,2,88,168,2,1,1038,1453,27,950,1285,25,38.44444444444444,>30,ENG,Home,After 1965
MA Wood,ENG,Pace,2024-07-26,Birmingham,England,2024,2,92,180,7,1,712,994,27,620,814,20,26.37037037037037,<=30,ENG,Home,After 1965
MA Wood,ENG,Pace,2024-08-21,Manchester,England,2024,2,67,110,2,1,733,1160,25,666,1050,23,29.32,<=30,ENG,Home,After 1965
MAK Pataudi,IND,Pace,1964-01-10,Chennai,India,1964,1,9,6,0,1,259,498,2,250,492,2,129.5,>30,IND,Home,Upto 2014
MAK Pataudi,IND,Pace,1964-01-21,Brabourne,India,1964,1,23,18,0,1,366,747,11,343,729,11,33.27272727272727,>30,IND,Home,Upto 2014
MAK Pataudi,IND,Pace,1964-01-29,Eden Gardens,India,1964,1,8,18,0,1,354,661,13,346,643,13,27.23076923076923,<=30,IND,Home,Upto 2014
MAK Pataudi,IND,Pace,1964-02-15,Kanpur,India,1964,1,10,18,1,1,118,235,3,108,217,2,39.333333333333336,>30,IND,Home,Upto 2014
MAK Pataudi,IND,Pace,1965-02-27,Chennai,India,1965,1,9,18,0,1,302,707,5,293,689,5,60.4,>30,IND,Home,Upto 2014
MAK Pataudi,IND,Pace,1967-06-08,Leeds,England,1967,1,13,24,0,1,436,1074,7,423,1050,7,62.285714285714285,>30,ENG,Away,Upto 2014
MAK Pataudi,IND,Pace,1967-07-13,Birmingham,England,1967,1,8,12,0,1,150,354,6,142,342,6,25.0,<=30,ENG,Away,Upto 2014
MAK Pataudi,IND,Pace,1969-11-15,Kanpur,India,1969,1,4,6,0,1,379,992,12,375,986,12,31.583333333333332,>30,IND,Home,Upto 2014
MAK Pataudi,IND,Pace,1973-01-12,Chennai,India,1973,1,4,6,0,1,119,343,5,115,337,5,23.8,<=30,IND,Home,Upto 2014
MAK Pataudi,IND,Pace,1973-02-06,Brabourne,India,1973,1,0,6,0,1,226,386,7,226,380,7,32.285714285714285,>30,IND,Home,Upto 2014
MAR Samarasekera,SL,Pace,1988-08-25,Lord's,England,1988,2,104,192,3,1,947,1904,31,843,1712,28,30.548387096774192,>30,ENG,Away,Upto 2014
MAWR Madurasinghe,SL,Spin,1988-08-25,Lord's,England,1988,1,41,96,0,1,79,216,1,38,120,1,79.0,>30,ENG,Away,Upto 2014
MAWR Madurasinghe,SL,Spin,1990-11-23,Chandigarh,India,1990,1,60,156,3,1,286,1097,16,226,941,13,17.875,<=30,IND,Away,Upto 2014
MAWR Madurasinghe,SL,Spin,1992-08-17,Colombo (SSC),Sri Lanka,1992,2,71,144,0,1,598,1075,17,527,931,17,35.1764705882353,>30,SL,Home,Upto 2014
MB Owens,NZ,Pace,1992-11-27,Moratuwa,Sri Lanka,1992,1,63,102,2,1,602,1223,13,539,1121,11,46.30769230769231,>30,SL,Away,Upto 2014
MB Owens,NZ,Pace,1992-12-06,Colombo (SSC),Sri Lanka,1992,2,137,216,5,1,402,864,12,265,648,7,33.5,>30,SL,Away,Upto 2014
MB Owens,NZ,Pace,1993-01-02,Hamilton,New Zealand,1993,2,67,114,1,1,500,1200,33,433,1086,32,15.151515151515152,<=30,NZ,Home,Upto 2014
MB Owens,NZ,Pace,1993-02-25,Christchurch,New Zealand,1993,1,58,156,3,1,651,1526,21,593,1370,18,31.0,>30,NZ,Home,Upto 2014
MB Owens,NZ,Pace,1993-03-04,Wellington,New Zealand,1993,1,54,126,1,1,647,1552,21,593,1426,20,30.80952380952381,>30,NZ,Home,Upto 2014
MB Owens,NZ,Pace,1994-02-10,Auckland,New Zealand,1994,2,38,54,0,1,582,1070,31,544,1016,31,18.774193548387096,<=30,NZ,Home,Upto 2014
MB Owens,NZ,Pace,1994-06-16,Lord's,England,1994,2,69,102,1,1,756,1458,24,687,1356,23,31.5,>30,ENG,Away,Upto 2014
MB Owens,NZ,Pace,1994-06-30,Manchester,England,1994,1,99,204,4,1,638,1439,22,539,1235,18,29.0,<=30,ENG,Away,Upto 2014
MB Poore,NZ,Spin,1953-03-13,Auckland,New Zealand,1953,2,71,162,4,1,495,1529,18,424,1367,14,27.5,<=30,NZ,Home,Upto 2014
MB Poore,NZ,Spin,1953-12-11,Durban,South Africa,1953,1,30,40,0,1,371,1319,16,341,1279,16,23.1875,<=30,SA,Away,Upto 2014
MB Poore,NZ,Spin,1954-01-01,Cape Town,South Africa,1954,2,45,112,1,1,639,1815,13,594,1703,12,49.15384615384615,>30,SA,Away,Upto 2014
MB Poore,NZ,Spin,1955-10-13,Karachi,Pakistan,1955,1,2,12,0,1,294,1463,19,292,1451,19,15.473684210526315,<=30,PAK,Away,Upto 2014
MB Poore,NZ,Spin,1955-10-26,Lahore,Pakistan,1955,1,13,18,0,1,672,1787,23,659,1769,23,29.217391304347824,<=30,PAK,Away,Upto 2014
MB Poore,NZ,Spin,1955-11-19,Hyderabad (Deccan),India,1955,1,36,54,0,1,665,1888,11,629,1834,11,60.45454545454545,>30,IND,Away,Upto 2014
MB Poore,NZ,Spin,1955-12-02,Brabourne,India,1955,1,49,114,2,1,470,1277,17,421,1163,15,27.647058823529413,<=30,IND,Away,Upto 2014
MB Poore,NZ,Spin,1955-12-16,Delhi,India,1955,1,26,90,1,1,540,1398,4,514,1308,3,135.0,>30,IND,Away,Upto 2014
MB Poore,NZ,Spin,1956-01-06,Chennai,India,1956,1,95,186,1,1,610,1887,20,515,1701,19,30.5,>30,IND,Away,Upto 2014
MC Bird,ENG,Pace,1910-01-01,Johannesburg,South Africa,1910,2,11,30,3,1,440,846,11,429,816,8,40.0,>30,SA,Away,Upto 2014
MC Bird,ENG,Pace,1910-01-21,Durban,South Africa,1910,2,13,60,1,1,379,1058,15,366,998,14,25.266666666666666,<=30,SA,Away,Upto 2014
MC Bird,ENG,Pace,1910-02-26,Johannesburg,South Africa,1910,1,0,1,0,1,366,667,10,366,666,10,36.6,>30,SA,Away,Upto 2014
MC Bird,ENG,Pace,1910-03-07,Cape Town,South Africa,1910,2,8,12,1,1,321,621,18,313,609,17,17.833333333333332,<=30,SA,Away,Upto 2014
MC Bird,ENG,Pace,1910-03-11,Cape Town,South Africa,1910,1,12,18,0,1,301,570,12,289,552,12,25.083333333333332,<=30,SA,Away,Upto 2014
MC Bird,ENG,Pace,1913-12-26,Johannesburg,South Africa,1913,1,15,24,0,1,455,1029,24,440,1005,24,18.958333333333332,<=30,SA,Away,Upto 2014
MC Bird,ENG,Pace,1914-01-01,Johannesburg,South Africa,1914,1,2,12,0,1,545,1214,22,543,1202,22,24.772727272727273,<=30,SA,Away,Upto 2014
MC Bird,ENG,Pace,1914-02-14,Durban,South Africa,1914,1,21,36,0,1,410,971,20,389,935,20,20.5,<=30,SA,Away,Upto 2014
MC Bird,ENG,Pace,1914-02-27,Gqeberha,South Africa,1914,1,38,66,3,1,418,956,19,380,890,16,22.0,<=30,SA,Away,Upto 2014
MC Carew,WI,Spin,1966-06-16,Lord's,England,1966,1,11,18,1,1,279,801,4,268,783,3,69.75,>30,ENG,Away,Upto 2014
MC Carew,WI,Spin,1968-03-14,Port of Spain,West Indies,1968,2,42,192,1,1,721,1580,15,679,1388,14,48.06666666666667,>30,WI,Home,Upto 2014
MC Carew,WI,Spin,1968-12-06,Brisbane,Australia,1968,1,30,72,1,1,799,2162,28,769,2090,27,28.535714285714285,<=30,AUS,Away,Upto 2014
MC Carew,WI,Spin,1968-12-26,Melbourne,Australia,1968,1,46,80,0,1,459,1287,15,413,1207,15,30.6,>30,AUS,Away,Upto 2014
MC Carew,WI,Spin,1969-01-03,Sydney,Australia,1969,2,54,112,1,1,463,1006,8,409,894,7,57.875,>30,AUS,Away,Upto 2014
MC Carew,WI,Spin,1969-01-24,Adelaide,Australia,1969,2,38,88,1,1,1020,2021,15,982,1933,14,68.0,>30,AUS,Away,Upto 2014
MC Carew,WI,Spin,1969-02-14,Sydney,Australia,1969,2,70,120,0,1,776,1562,17,706,1442,17,45.64705882352941,>30,AUS,Away,Upto 2014
MC Carew,WI,Spin,1969-03-07,Wellington,New Zealand,1969,1,18,80,1,1,243,621,7,225,541,6,34.714285714285715,>30,NZ,Away,Upto 2014
MC Carew,WI,Spin,1969-03-13,Christchurch,New Zealand,1969,2,36,136,2,1,515,1459,16,479,1323,14,32.1875,>30,NZ,Away,Upto 2014
MC Carew,WI,Spin,1969-06-12,Manchester,England,1969,1,19,66,0,1,322,1014,6,303,948,6,53.666666666666664,>30,ENG,Away,Upto 2014
MC Carew,WI,Spin,1971-02-18,Kingston,West Indies,1971,1,3,30,0,1,757,1901,17,754,1871,17,44.529411764705884,>30,WI,Home,Upto 2014
MC Carew,WI,Spin,1971-03-19,Georgetown,West Indies,1971,1,2,12,0,1,785,2232,14,783,2220,14,56.07142857142857,>30,WI,Home,Upto 2014
MC Carew,WI,Spin,1971-04-13,Port of Spain,West Indies,1971,1,15,42,0,1,963,2470,24,948,2428,24,40.125,>30,WI,Home,Upto 2014
MC Carew,WI,Spin,1972-02-16,Kingston,West Indies,1972,2,35,78,0,1,653,1794,11,618,1716,11,59.36363636363637,>30,WI,Home,Upto 2014
MC Carew,WI,Spin,1972-03-09,Port of Spain,West Indies,1972,2,18,48,0,1,722,2183,14,704,2135,14,51.57142857142857,>30,WI,Home,Upto 2014
MC Cowdrey,ENG,Spin,1959-01-30,Adelaide,Australia,1959,1,9,11,0,1,300,723,9,291,712,9,33.333333333333336,>30,AUS,Away,Upto 2014
MC Cowdrey,ENG,Spin,1960-02-17,Kingston,West Indies,1960,1,4,6,0,1,443,1323,11,439,1317,11,40.27272727272727,>30,WI,Away,Upto 2014
MC Cowdrey,ENG,Spin,1960-03-25,Port of Spain,West Indies,1960,1,15,6,0,1,649,1404,16,634,1398,16,40.5625,>30,WI,Away,Upto 2014
MC Cowdrey,ENG,Spin,1960-07-21,Manchester,England,1960,1,4,6,0,1,183,377,4,179,371,4,45.75,>30,ENG,Home,Upto 2014
MC Cowdrey,ENG,Spin,1962-05-31,Birmingham,England,1962,1,1,6,0,1,664,1386,13,663,1380,13,51.07692307692308,>30,ENG,Home,Upto 2014
MC Cowdrey,ENG,Spin,1964-02-15,Kanpur,India,1964,1,34,30,0,1,987,2874,18,953,2844,18,54.833333333333336,>30,IND,Away,Upto 2014
MC Cowdrey,ENG,Spin,1968-01-19,Port of Spain,West Indies,1968,1,1,6,0,1,688,1548,12,687,1542,12,57.333333333333336,>30,WI,Away,Upto 2014
MC Cowdrey,ENG,Spin,1970-11-27,Brisbane,Australia,1970,2,18,24,0,1,461,1342,10,443,1318,10,46.1,>30,AUS,Away,Upto 2014
MC Cowdrey,ENG,Spin,1970-12-11,W.A.C.A,Australia,1970,1,18,24,0,1,317,920,6,299,896,6,52.833333333333336,>30,AUS,Away,Upto 2014
MC Henriques,AUS,Pace,2013-02-22,Chennai,India,2013,1,48,102,1,1,415,813,8,367,711,7,51.875,>30,IND,Away,Upto 2014
MC Henriques,AUS,Pace,2013-03-02,Hyderabad,India,2013,1,45,126,0,1,327,744,7,282,618,7,46.714285714285715,>30,IND,Away,Upto 2014
MC Henriques,AUS,Pace,2013-03-14,Mohali,India,2013,1,62,90,1,1,473,880,15,411,790,14,31.533333333333335,>30,IND,Away,Upto 2014
MC Henriques,AUS,Pace,2016-08-13,Colombo (SSC),Sri Lanka,2016,1,9,12,0,1,336,652,8,327,640,8,42.0,>30,SL,Away,After 1965
MC Ilott,ENG,Pace,1993-07-01,Nottingham,England,1993,2,152,312,4,1,786,1563,21,634,1251,17,37.42857142857143,>30,ENG,Home,Upto 2014
MC Ilott,ENG,Pace,1993-07-22,Leeds,England,1993,1,161,306,3,1,901,1757,18,740,1451,15,50.05555555555556,>30,ENG,Home,Upto 2014
MC Ilott,ENG,Pace,1993-08-05,Birmingham,England,1993,2,99,156,1,1,389,833,10,290,677,9,38.9,>30,ENG,Home,Upto 2014
MC Ilott,ENG,Pace,1995-12-14,Durban,South Africa,1995,1,48,90,3,1,320,703,12,272,613,9,26.666666666666668,<=30,SA,Away,Upto 2014
MC Ilott,ENG,Pace,1995-12-26,Gqeberha,South Africa,1995,1,82,178,1,1,681,1783,21,599,1605,20,32.42857142857143,>30,SA,Away,Upto 2014
MC Snedden,NZ,Pace,1981-02-21,Wellington,New Zealand,1981,2,95,222,3,1,725,1705,33,630,1483,30,21.96969696969697,<=30,NZ,Home,Upto 2014
MC Snedden,NZ,Pace,1981-03-06,Christchurch,New Zealand,1981,1,63,138,2,1,349,1020,11,286,882,9,31.727272727272727,>30,NZ,Home,Upto 2014
MC Snedden,NZ,Pace,1981-03-13,Auckland,New Zealand,1981,2,92,210,2,1,366,1193,11,274,983,9,33.27272727272727,>30,NZ,Home,Upto 2014
MC Snedden,NZ,Pace,1982-02-26,Wellington,New Zealand,1982,1,24,48,0,1,258,786,4,234,738,4,64.5,>30,NZ,Home,Upto 2014
MC Snedden,NZ,Pace,1982-03-12,Auckland,New Zealand,1982,2,48,120,1,1,673,1668,23,625,1548,22,29.26086956521739,<=30,NZ,Home,Upto 2014
MC Snedden,NZ,Pace,1982-03-19,Christchurch,New Zealand,1982,2,104,132,3,1,665,1336,24,561,1204,21,27.708333333333332,<=30,NZ,Home,Upto 2014
MC Snedden,NZ,Pace,1983-03-04,Christchurch,New Zealand,1983,2,78,198,3,1,557,1256,25,479,1058,22,22.28,<=30,NZ,Home,Upto 2014
MC Snedden,NZ,Pace,1983-03-11,Wellington,New Zealand,1983,2,77,246,5,1,592,1490,31,515,1244,26,19.096774193548388,<=30,NZ,Home,Upto 2014
MC Snedden,NZ,Pace,1983-08-25,Nottingham,England,1983,2,109,216,4,1,763,1600,21,654,1384,17,36.333333333333336,>30,ENG,Away,Upto 2014
MC Snedden,NZ,Pace,1984-01-20,Wellington,New Zealand,1984,2,129,168,0,1,1002,2037,24,873,1869,24,41.75,>30,NZ,Home,Upto 2014
MC Snedden,NZ,Pace,1985-11-08,Brisbane,Australia,1985,2,111,180,1,1,699,1580,23,588,1400,22,30.391304347826086,>30,AUS,Away,Upto 2014
MC Snedden,NZ,Pace,1987-03-12,Christchurch,New Zealand,1987,2,82,147,5,1,630,1188,33,548,1041,28,19.09090909090909,<=30,NZ,Home,Upto 2014
MC Snedden,NZ,Pace,1987-04-16,Colombo (CCC),Sri Lanka,1987,1,41,96,0,1,574,1325,10,533,1229,10,57.4,>30,SL,Away,Upto 2014
MC Snedden,NZ,Pace,1987-12-11,Adelaide,Australia,1987,1,89,192,1,1,519,1199,13,430,1007,12,39.92307692307692,>30,AUS,Away,Upto 2014
MC Snedden,NZ,Pace,1988-02-12,Christchurch,New Zealand,1988,2,131,336,5,1,693,1999,33,562,1663,28,21.0,<=30,NZ,Home,Upto 2014
MC Snedden,NZ,Pace,1988-02-25,Auckland,New Zealand,1988,1,71,204,1,1,724,1989,22,653,1785,21,32.90909090909091,>30,NZ,Home,Upto 2014
MC Snedden,NZ,Pace,1988-12-02,Hyderabad (Deccan),India,1988,2,82,117,4,1,410,867,17,328,750,13,24.11764705882353,<=30,IND,Away,Upto 2014
MC Snedden,NZ,Pace,1989-11-24,W.A.C.A,Australia,1989,1,108,252,4,1,939,2255,25,831,2003,21,37.56,>30,AUS,Away,Upto 2014
MC Snedden,NZ,Pace,1990-02-02,Christchurch,New Zealand,1990,2,79,227,4,1,683,1242,22,604,1015,18,31.045454545454547,>30,NZ,Home,Upto 2014
MC Snedden,NZ,Pace,1990-02-09,Napier,New Zealand,1990,1,104,252,1,1,406,996,10,302,744,9,40.6,>30,NZ,Home,Upto 2014
MC Snedden,NZ,Pace,1990-02-22,Auckland,New Zealand,1990,2,139,228,1,1,1075,1694,19,936,1466,18,56.578947368421055,>30,NZ,Home,Upto 2014
MC Snedden,NZ,Pace,1990-03-15,Wellington,New Zealand,1990,2,79,240,2,1,504,1412,21,425,1172,19,24.0,<=30,NZ,Home,Upto 2014
MC Snedden,NZ,Pace,1990-06-07,Nottingham,England,1990,1,54,216,1,1,425,1056,17,371,840,16,25.0,<=30,ENG,Away,Upto 2014
MC Snedden,NZ,Pace,1990-06-21,Lord's,England,1990,1,72,126,1,1,748,1364,15,676,1238,14,49.86666666666667,>30,ENG,Away,Upto 2014
MC Snedden,NZ,Pace,1990-07-05,Birmingham,England,1990,2,138,264,4,1,730,1539,27,592,1275,23,27.037037037037038,<=30,ENG,Away,Upto 2014
MD Craig,NZ,Spin,2014-06-08,Kingston,West Indies,2014,2,188,234,8,1,767,1332,22,579,1098,14,34.86363636363637,>30,WI,Away,After 1965
MD Craig,NZ,Spin,2014-06-16,Port of Spain,West Indies,2014,2,128,192,0,1,468,1009,10,340,817,10,46.8,>30,WI,Away,After 1965
MD Craig,NZ,Spin,2014-06-26,Bridgetown,West Indies,2014,2,174,276,4,1,522,806,9,348,530,5,58.0,>30,WI,Away,After 1965
MD Craig,NZ,Spin,2014-11-09,Abu Dhabi,UAE,2014,2,155,228,0,1,765,1282,14,610,1054,14,54.642857142857146,>30,UAE,Away,After 1965
MD Craig,NZ,Spin,2014-11-17,Dubai (DICS),UAE,2014,2,183,270,3,1,778,1523,22,595,1253,19,35.36363636363637,>30,UAE,Away,After 1965
MD Craig,NZ,Spin,2014-11-26,Sharjah,UAE,2014,2,203,289,10,1,856,1190,21,653,901,11,40.76190476190476,>30,UAE,Away,After 1965
MD Craig,NZ,Spin,2014-12-26,Christchurch,New Zealand,2014,2,88,240,1,1,299,462,3,211,222,2,99.66666666666667,>30,NZ,Home,After 1965
MD Craig,NZ,Spin,2015-01-03,Wellington,New Zealand,2015,2,108,211,5,1,277,577,6,169,366,1,46.166666666666664,>30,NZ,Home,After 1965
MD Craig,NZ,Spin,2015-05-21,Lord's,England,2015,2,173,276,2,1,317,528,7,144,252,5,45.285714285714285,>30,ENG,Away,After 1965
MD Craig,NZ,Spin,2015-05-29,Leeds,England,2015,2,121,347,5,1,285,593,9,164,246,4,31.666666666666668,>30,ENG,Away,After 1965
MD Craig,NZ,Spin,2015-11-05,Brisbane,Australia,2015,2,234,270,3,1,385,554,8,151,284,5,48.125,>30,AUS,Away,After 1965
MD Craig,NZ,Spin,2015-11-13,W.A.C.A,Australia,2015,2,204,246,3,1,404,593,6,200,347,3,67.33333333333333,>30,AUS,Away,After 1965
MD Craig,NZ,Spin,2015-11-27,Adelaide,Australia,2015,2,75,96,2,1,218,366,7,143,270,5,31.142857142857142,>30,AUS,Away,After 1965
MD Craig,NZ,Spin,2016-02-12,Wellington,New Zealand,2016,1,153,212,2,1,284,458,9,131,246,7,31.555555555555557,>30,NZ,Home,After 1965
MD Craig,NZ,Spin,2016-09-22,Kanpur,India,2016,2,139,282,2,1,859,1714,26,720,1432,24,33.03846153846154,>30,IND,Away,After 1965
MD Crowe,NZ,Pace,1982-02-26,Wellington,New Zealand,1982,1,14,24,0,1,258,786,4,244,762,4,64.5,>30,NZ,Home,Upto 2014
MD Crowe,NZ,Pace,1982-03-19,Christchurch,New Zealand,1982,1,0,3,0,1,665,1336,24,665,1333,24,27.708333333333332,<=30,NZ,Home,Upto 2014
MD Crowe,NZ,Pace,1983-07-14,The Oval,England,1983,2,23,48,0,1,726,1662,20,703,1614,20,36.3,>30,ENG,Away,Upto 2014
MD Crowe,NZ,Pace,1983-08-11,Lord's,England,1983,1,35,78,2,1,667,1618,29,632,1540,27,23.0,<=30,ENG,Away,Upto 2014
MD Crowe,NZ,Pace,1984-01-20,Wellington,New Zealand,1984,2,31,54,0,1,1002,2037,24,971,1983,24,41.75,>30,NZ,Home,Upto 2014
MD Crowe,NZ,Pace,1984-02-10,Auckland,New Zealand,1984,1,62,102,0,1,656,1758,12,594,1656,12,54.666666666666664,>30,NZ,Home,Upto 2014
MD Crowe,NZ,Pace,1984-03-09,Kandy,Sri Lanka,1984,1,4,18,0,1,359,767,20,355,749,20,17.95,<=30,SL,Away,Upto 2014
MD Crowe,NZ,Pace,1984-03-16,Colombo (SSC),Sri Lanka,1984,1,21,78,1,1,563,1643,28,542,1565,27,20.107142857142858,<=30,SL,Away,Upto 2014
MD Crowe,NZ,Pace,1984-03-24,Colombo (CCC),Sri Lanka,1984,2,35,66,0,1,479,1056,21,444,990,21,22.80952380952381,<=30,SL,Away,Upto 2014
MD Crowe,NZ,Pace,1984-11-16,Lahore,Pakistan,1984,1,21,42,1,1,340,861,14,319,819,13,24.285714285714285,<=30,PAK,Away,Upto 2014
MD Crowe,NZ,Pace,1984-11-25,Hyderabad (Sind),Pakistan,1984,2,37,66,2,1,178,432,6,141,366,4,29.666666666666668,<=30,PAK,Away,Upto 2014
MD Crowe,NZ,Pace,1984-12-10,Karachi,Pakistan,1984,2,107,186,3,1,473,890,12,366,704,9,39.416666666666664,>30,PAK,Away,Upto 2014
MD Crowe,NZ,Pace,1985-04-26,Bridgetown,West Indies,1985,1,25,60,2,1,558,1140,29,533,1080,27,19.24137931034483,<=30,WI,Away,Upto 2014
MD Crowe,NZ,Pace,1985-05-04,Kingston,West Indies,1985,1,30,60,1,1,691,1483,26,661,1423,25,26.576923076923077,<=30,WI,Away,Upto 2014
MD Crowe,NZ,Pace,1985-11-08,Brisbane,Australia,1985,2,33,84,0,1,699,1580,23,666,1496,23,30.391304347826086,>30,AUS,Away,Upto 2014
MD Crowe,NZ,Pace,1985-11-22,Sydney,Australia,1985,2,22,42,0,1,241,652,9,219,610,9,26.77777777777778,<=30,AUS,Away,Upto 2014
MD Crowe,NZ,Pace,1986-02-28,Christchurch,New Zealand,1986,1,4,12,0,1,712,1681,22,708,1669,22,32.36363636363637,>30,NZ,Home,Upto 2014
MD Crowe,NZ,Pace,1986-03-13,Auckland,New Zealand,1986,1,4,18,0,1,481,1210,15,477,1192,15,32.06666666666667,>30,NZ,Home,Upto 2014
MD Crowe,NZ,Pace,1986-07-24,Lord's,England,1986,2,51,72,0,1,599,1428,17,548,1356,17,35.23529411764706,>30,ENG,Away,Upto 2014
MD Crowe,NZ,Pace,1987-02-20,Wellington,New Zealand,1987,1,13,18,0,1,656,1620,18,643,1602,18,36.44444444444444,>30,NZ,Home,Upto 2014
MD Crowe,NZ,Pace,1987-02-27,Auckland,New Zealand,1987,1,9,30,0,1,550,1311,24,541,1281,24,22.916666666666668,<=30,NZ,Home,Upto 2014
MD Crowe,NZ,Pace,1987-03-12,Christchurch,New Zealand,1987,1,13,36,1,1,630,1188,33,617,1152,32,19.09090909090909,<=30,NZ,Home,Upto 2014
MD Crowe,NZ,Pace,1987-04-16,Colombo (CCC),Sri Lanka,1987,1,13,42,0,1,574,1325,10,561,1283,10,57.4,>30,SL,Away,Upto 2014
MD Crowe,NZ,Pace,1990-10-10,Karachi,Pakistan,1990,1,22,36,0,1,575,1344,23,553,1308,23,25.0,<=30,PAK,Away,Upto 2014
MD Crowe,NZ,Pace,1990-10-26,Faisalabad,Pakistan,1990,1,22,66,1,1,725,1761,39,703,1695,38,18.58974358974359,<=30,PAK,Away,Upto 2014
MD Crowe,NZ,Pace,1992-11-01,Bulawayo,Zimbabwe,1992,1,15,24,0,1,481,878,7,466,854,7,68.71428571428571,>30,ZIM,Away,Upto 2014
MD Crowe,NZ,Pace,1992-11-27,Moratuwa,Sri Lanka,1992,1,10,12,0,1,602,1223,13,592,1211,13,46.30769230769231,>30,SL,Away,Upto 2014
MD Fisher,ENG,Pace,2022-03-16,Bridgetown,West Indies,2022,2,71,162,1,1,744,1535,17,673,1373,16,43.76470588235294,>30,WI,Away,After 1965
MD Gunathilaka,SL,Spin,2017-07-26,Galle,Sri Lanka,2017,2,57,72,1,1,734,1244,13,677,1172,12,56.46153846153846,>30,SL,Home,After 1965
MD Gunathilaka,SL,Spin,2018-07-20,Colombo (SSC),Sri Lanka,2018,1,1,6,0,1,722,1323,32,721,1317,32,22.5625,<=30,SL,Home,After 1965
MD Gunathilaka,SL,Spin,2018-11-23,Colombo (SSC),Sri Lanka,2018,1,5,12,0,1,913,1615,34,908,1603,34,26.852941176470587,<=30,SL,Home,After 1965
MD Gunathilaka,SL,Spin,2018-12-15,Wellington,New Zealand,2018,1,3,12,0,1,274,534,4,271,522,4,68.5,>30,NZ,Away,After 1965
MD Gunathilaka,SL,Spin,2018-12-26,Christchurch,New Zealand,2018,1,45,96,0,1,228,444,2,183,348,2,114.0,>30,NZ,Away,After 1965
MD Marshall,WI,Pace,1978-12-15,Bengaluru,India,1978,1,53,108,1,1,557,1034,19,504,926,18,29.31578947368421,<=30,IND,Away,Upto 2014
MD Marshall,WI,Pace,1978-12-29,Eden Gardens,India,1978,2,89,156,1,1,744,1474,17,655,1318,16,43.76470588235294,>30,IND,Away,Upto 2014
MD Marshall,WI,Pace,1979-02-02,Kanpur,India,1979,1,123,204,1,1,581,990,8,458,786,7,72.625,>30,IND,Away,Upto 2014
MD Marshall,WI,Pace,1980-06-05,Nottingham,England,1980,2,96,258,3,1,897,2129,36,801,1871,33,24.916666666666668,<=30,ENG,Away,Upto 2014
MD Marshall,WI,Pace,1980-07-10,Manchester,England,1980,2,152,282,5,1,678,1412,23,526,1130,18,29.47826086956522,<=30,ENG,Away,Upto 2014
MD Marshall,WI,Pace,1980-07-24,The Oval,England,1980,2,124,315,2,1,630,1595,25,506,1280,23,25.2,<=30,ENG,Away,Upto 2014
MD Marshall,WI,Pace,1980-08-07,Leeds,England,1980,2,64,180,5,1,526,1199,25,462,1019,20,21.04,<=30,ENG,Away,Upto 2014
MD Marshall,WI,Pace,1980-11-24,Lahore,Pakistan,1980,2,118,221,3,1,508,1109,13,390,888,10,39.07692307692308,>30,PAK,Away,Upto 2014
MD Marshall,WI,Pace,1980-12-08,Faisalabad,Pakistan,1980,2,64,112,6,1,265,580,15,201,468,9,17.666666666666668,<=30,PAK,Away,Upto 2014
MD Marshall,WI,Pace,1980-12-22,Karachi,Pakistan,1980,2,92,186,3,1,342,961,23,250,775,20,14.869565217391305,<=30,PAK,Away,Upto 2014
MD Marshall,WI,Pace,1980-12-30,Multan,Pakistan,1980,1,45,72,1,1,286,658,15,241,586,14,19.066666666666666,<=30,PAK,Away,Upto 2014
MD Marshall,WI,Pace,1981-04-10,Kingston,West Indies,1981,2,64,126,3,1,705,1477,22,641,1351,19,32.04545454545455,>30,WI,Home,Upto 2014
MD Marshall,WI,Pace,1983-02-23,Kingston,West Indies,1983,2,91,240,5,1,545,1266,30,454,1026,25,18.166666666666668,<=30,WI,Home,Upto 2014
MD Marshall,WI,Pace,1983-03-11,Port of Spain,West Indies,1983,2,109,278,5,1,669,1364,18,560,1086,13,37.166666666666664,>30,WI,Home,Upto 2014
MD Marshall,WI,Pace,1983-03-31,Georgetown,West Indies,1983,1,39,78,1,1,361,700,8,322,622,7,45.125,>30,WI,Home,Upto 2014
MD Marshall,WI,Pace,1983-04-15,Bridgetown,West Indies,1983,2,136,174,4,1,618,1146,24,482,972,20,25.75,<=30,WI,Home,Upto 2014
MD Marshall,WI,Pace,1983-04-28,St John's,West Indies,1983,2,120,275,6,1,719,1355,18,599,1080,12,39.94444444444444,>30,WI,Home,Upto 2014
MD Marshall,WI,Pace,1983-10-21,Kanpur,India,1983,2,66,192,8,1,584,1065,26,518,873,18,22.46153846153846,<=30,IND,Away,Upto 2014
MD Marshall,WI,Pace,1983-10-29,Delhi,India,1983,2,157,252,4,1,784,1399,23,627,1147,19,34.08695652173913,>30,IND,Away,Upto 2014
MD Marshall,WI,Pace,1983-11-12,Ahmedabad,India,1983,2,89,234,3,1,524,1257,33,435,1023,30,15.878787878787879,<=30,IND,Away,Upto 2014
MD Marshall,WI,Pace,1983-11-24,Wankhede,India,1983,2,135,270,4,1,698,1403,16,563,1133,12,43.625,>30,IND,Away,Upto 2014
MD Marshall,WI,Pace,1983-12-10,Eden Gardens,India,1983,2,102,222,9,1,475,988,25,373,766,16,19.0,<=30,IND,Away,Upto 2014
MD Marshall,WI,Pace,1983-12-24,Chennai,India,1983,1,72,156,5,1,443,882,12,371,726,7,36.916666666666664,>30,IND,Away,Upto 2014
MD Marshall,WI,Pace,1984-03-16,Port of Spain,West Indies,1984,2,146,246,2,1,693,1381,19,547,1135,17,36.473684210526315,>30,WI,Home,Upto 2014
MD Marshall,WI,Pace,1984-03-30,Bridgetown,West Indies,1984,2,125,251,7,1,810,1566,27,685,1315,20,30.0,<=30,WI,Home,Upto 2014
MD Marshall,WI,Pace,1984-04-07,St John's,West Indies,1984,2,121,210,4,1,745,1490,28,624,1280,24,26.607142857142858,<=30,WI,Home,Upto 2014
MD Marshall,WI,Pace,1984-04-28,Kingston,West Indies,1984,2,88,246,8,1,537,1132,24,449,886,16,22.375,<=30,WI,Home,Upto 2014
MD Marshall,WI,Pace,1984-06-14,Birmingham,England,1984,2,102,222,3,1,672,1256,23,570,1034,20,29.217391304347824,<=30,ENG,Away,Upto 2014
MD Marshall,WI,Pace,1984-06-28,Lord's,England,1984,2,170,353,8,1,986,1843,27,816,1490,19,36.51851851851852,>30,ENG,Away,Upto 2014
MD Marshall,WI,Pace,1984-07-12,Leeds,England,1984,2,59,192,7,1,659,1294,24,600,1102,17,27.458333333333332,<=30,ENG,Away,Upto 2014
MD Marshall,WI,Pace,1984-08-09,The Oval,England,1984,2,106,239,6,1,809,1686,40,703,1447,34,20.225,<=30,ENG,Away,Upto 2014
MD Marshall,WI,Pace,1984-11-09,W.A.C.A,Australia,1984,2,93,216,6,1,700,1337,30,607,1121,24,23.333333333333332,<=30,AUS,Away,Upto 2014
MD Marshall,WI,Pace,1984-11-23,Brisbane,Australia,1984,2,121,292,7,1,749,1407,30,628,1115,23,24.966666666666665,<=30,AUS,Away,Upto 2014
MD Marshall,WI,Pace,1984-12-07,Adelaide,Australia,1984,2,107,251,10,1,771,1535,30,664,1284,20,25.7,<=30,AUS,Away,Upto 2014
MD Marshall,WI,Pace,1984-12-22,Melbourne,Australia,1984,2,122,311,5,1,827,1673,26,705,1362,21,31.807692307692307,>30,AUS,Away,Upto 2014
MD Marshall,WI,Pace,1984-12-30,Sydney,Australia,1984,1,111,222,0,1,535,1040,12,424,818,12,44.583333333333336,>30,AUS,Away,Upto 2014
MD Marshall,WI,Pace,1985-03-29,Port of Spain,West Indies,1985,2,143,306,6,1,784,1698,30,641,1392,24,26.133333333333333,<=30,WI,Home,Upto 2014
MD Marshall,WI,Pace,1985-04-06,Georgetown,West Indies,1985,1,110,198,4,1,825,1600,20,715,1402,16,41.25,>30,WI,Home,Upto 2014
MD Marshall,WI,Pace,1985-04-26,Bridgetown,West Indies,1985,2,120,243,11,1,558,1140,29,438,897,18,19.24137931034483,<=30,WI,Home,Upto 2014
MD Marshall,WI,Pace,1985-05-04,Kingston,West Indies,1985,2,113,274,6,1,691,1483,26,578,1209,20,26.576923076923077,<=30,WI,Home,Upto 2014
MD Marshall,WI,Pace,1986-02-21,Kingston,West Indies,1986,2,59,132,5,1,543,1027,29,484,895,24,18.724137931034484,<=30,WI,Home,Upto 2014
MD Marshall,WI,Pace,1986-03-07,Port of Spain,West Indies,1986,2,132,284,8,1,694,1180,22,562,896,14,31.545454545454547,>30,WI,Home,Upto 2014
MD Marshall,WI,Pace,1986-03-21,Bridgetown,West Indies,1986,2,89,162,4,1,585,983,28,496,821,24,20.892857142857142,<=30,WI,Home,Upto 2014
MD Marshall,WI,Pace,1986-04-03,Port of Spain,West Indies,1986,2,113,198,5,1,614,1036,27,501,838,22,22.74074074074074,<=30,WI,Home,Upto 2014
MD Marshall,WI,Pace,1986-04-11,St John's,West Indies,1986,2,89,241,5,1,906,1622,22,817,1381,17,41.18181818181818,>30,WI,Home,Upto 2014
MD Marshall,WI,Pace,1986-10-24,Faisalabad,Pakistan,1986,2,131,216,5,1,582,1145,28,451,929,23,20.785714285714285,<=30,PAK,Away,Upto 2014
MD Marshall,WI,Pace,1986-11-07,Lahore,Pakistan,1986,2,47,156,6,1,247,794,22,200,638,16,11.227272727272727,<=30,PAK,Away,Upto 2014
MD Marshall,WI,Pace,1986-11-20,Karachi,Pakistan,1986,2,88,312,5,1,343,1168,21,255,856,16,16.333333333333332,<=30,PAK,Away,Upto 2014
MD Marshall,WI,Pace,1987-02-20,Wellington,New Zealand,1987,2,100,252,2,1,656,1620,18,556,1368,16,36.44444444444444,>30,NZ,Away,Upto 2014
MD Marshall,WI,Pace,1987-02-27,Auckland,New Zealand,1987,2,114,300,6,1,550,1311,24,436,1011,18,22.916666666666668,<=30,NZ,Away,Upto 2014
MD Marshall,WI,Pace,1987-03-12,Christchurch,New Zealand,1987,1,75,162,1,1,630,1188,33,555,1026,32,19.09090909090909,<=30,NZ,Away,Upto 2014
MD Marshall,WI,Pace,1988-04-14,Port of Spain,West Indies,1988,2,140,300,6,1,692,1635,27,552,1335,21,25.62962962962963,<=30,WI,Home,Upto 2014
MD Marshall,WI,Pace,1988-04-22,Bridgetown,West Indies,1988,2,144,250,9,1,833,1467,30,689,1217,21,27.766666666666666,<=30,WI,Home,Upto 2014
MD Marshall,WI,Pace,1988-06-02,Nottingham,England,1988,2,92,258,7,1,781,1741,19,689,1483,12,41.10526315789474,>30,ENG,Away,Upto 2014
MD Marshall,WI,Pace,1988-06-16,Lord's,England,1988,2,92,258,10,1,943,1804,37,851,1546,27,25.486486486486488,<=30,ENG,Away,Upto 2014
MD Marshall,WI,Pace,1988-06-30,Manchester,England,1988,2,41,166,9,1,423,1051,26,382,885,17,16.26923076923077,<=30,ENG,Away,Upto 2014
MD Marshall,WI,Pace,1988-07-21,Leeds,England,1988,2,102,240,5,1,613,1328,28,511,1088,23,21.892857142857142,<=30,ENG,Away,Upto 2014
MD Marshall,WI,Pace,1988-08-04,The Oval,England,1988,2,116,297,4,1,629,1534,24,513,1237,20,26.208333333333332,<=30,ENG,Away,Upto 2014
MD Marshall,WI,Pace,1988-11-18,Brisbane,Australia,1988,2,131,264,6,1,708,1383,27,577,1119,21,26.22222222222222,<=30,AUS,Away,Upto 2014
MD Marshall,WI,Pace,1988-12-02,W.A.C.A,Australia,1988,2,134,210,3,1,1183,2020,32,1049,1810,29,36.96875,>30,AUS,Away,Upto 2014
MD Marshall,WI,Pace,1988-12-24,Melbourne,Australia,1988,2,80,234,1,1,897,2063,38,817,1829,37,23.605263157894736,<=30,AUS,Away,Upto 2014
MD Marshall,WI,Pace,1989-01-26,Sydney,Australia,1989,2,46,234,6,1,305,911,11,259,677,5,27.727272727272727,<=30,AUS,Away,Upto 2014
MD Marshall,WI,Pace,1989-02-03,Adelaide,Australia,1989,2,97,210,1,1,834,1481,18,737,1271,17,46.333333333333336,>30,AUS,Away,Upto 2014
MD Marshall,WI,Pace,1989-04-07,Bridgetown,West Indies,1989,2,116,288,6,1,726,1450,23,610,1162,17,31.565217391304348,>30,WI,Home,Upto 2014
MD Marshall,WI,Pace,1989-04-15,Port of Spain,West Indies,1989,2,89,221,11,1,469,1127,29,380,906,18,16.17241379310345,<=30,WI,Home,Upto 2014
MD Marshall,WI,Pace,1989-04-28,Kingston,West Indies,1989,2,85,159,2,1,590,1241,28,505,1082,26,21.071428571428573,<=30,WI,Home,Upto 2014
MD Marshall,WI,Pace,1990-02-24,Kingston,West Indies,1990,1,46,108,1,1,668,1460,29,622,1352,28,23.03448275862069,<=30,WI,Home,Upto 2014
MD Marshall,WI,Pace,1990-04-05,Bridgetown,West Indies,1990,2,86,246,2,1,1177,2232,37,1091,1986,35,31.81081081081081,>30,WI,Home,Upto 2014
MD Marshall,WI,Pace,1990-11-15,Karachi,Pakistan,1990,2,56,174,2,1,537,1280,27,481,1106,25,19.88888888888889,<=30,PAK,Away,Upto 2014
MD Marshall,WI,Pace,1990-11-23,Faisalabad,Pakistan,1990,2,54,74,4,1,499,862,28,445,788,24,17.821428571428573,<=30,PAK,Away,Upto 2014
MD Marshall,WI,Pace,1990-12-06,Lahore,Pakistan,1990,2,56,144,0,1,541,1248,30,485,1104,30,18.033333333333335,<=30,PAK,Away,Upto 2014
MD Marshall,WI,Pace,1991-03-01,Kingston,West Indies,1991,1,57,132,1,1,694,1365,21,637,1233,20,33.04761904761905,>30,WI,Home,Upto 2014
MD Marshall,WI,Pace,1991-03-23,Georgetown,West Indies,1991,2,98,228,6,1,808,1623,19,710,1395,13,42.526315789473685,>30,WI,Home,Upto 2014
MD Marshall,WI,Pace,1991-04-05,Port of Spain,West Indies,1991,2,79,169,4,1,449,1209,20,370,1040,16,22.45,<=30,WI,Home,Upto 2014
MD Marshall,WI,Pace,1991-04-19,Bridgetown,West Indies,1991,2,95,198,6,1,874,1849,33,779,1651,27,26.484848484848484,<=30,WI,Home,Upto 2014
MD Marshall,WI,Pace,1991-04-27,St John's,West Indies,1991,2,108,211,4,1,735,1397,30,627,1186,26,24.5,<=30,WI,Home,Upto 2014
MD Marshall,WI,Pace,1991-06-06,Leeds,England,1991,2,104,228,6,1,749,1729,37,645,1501,31,20.243243243243242,<=30,ENG,Away,Upto 2014
MD Marshall,WI,Pace,1991-06-20,Lord's,England,1991,1,78,180,2,1,685,1326,19,607,1146,17,36.05263157894737,>30,ENG,Away,Upto 2014
MD Marshall,WI,Pace,1991-07-04,Nottingham,England,1991,2,103,257,4,1,833,1718,28,730,1461,24,29.75,<=30,ENG,Away,Upto 2014
MD Marshall,WI,Pace,1991-07-25,Birmingham,England,1991,2,86,194,6,1,722,1721,32,636,1527,26,22.5625,<=30,ENG,Away,Upto 2014
MD Marshall,WI,Pace,1991-08-08,The Oval,England,1991,2,71,174,2,1,826,1668,26,755,1494,24,31.76923076923077,>30,ENG,Away,Upto 2014
MD Moxon,ENG,Pace,1987-08-06,The Oval,England,1987,1,27,36,0,1,607,1188,10,580,1152,10,60.7,>30,ENG,Home,Upto 2014
MD Moxon,ENG,Pace,1988-02-25,Auckland,New Zealand,1988,1,3,12,0,1,724,1989,22,721,1977,22,32.90909090909091,>30,NZ,Away,Upto 2014
MD Shanaka,SL,Pace,2016-05-19,Leeds,England,2016,1,46,78,3,1,468,901,27,422,823,24,17.333333333333332,<=30,ENG,Away,After 1965
MD Shanaka,SL,Pace,2017-11-16,Eden Gardens,India,2017,2,112,204,5,1,743,1322,32,631,1118,27,23.21875,<=30,IND,Away,After 1965
MD Shanaka,SL,Pace,2017-11-24,Nagpur,India,2017,1,103,157,1,1,472,859,9,369,702,8,52.44444444444444,>30,IND,Away,After 1965
MD Shanaka,SL,Pace,2020-12-26,Centurion,South Africa,2020,1,98,173,2,1,827,1226,23,729,1053,21,35.95652173913044,>30,SA,Away,After 1965
MD Shanaka,SL,Pace,2021-01-03,Johannesburg,South Africa,2021,2,50,108,2,1,660,1080,30,610,972,28,22.0,<=30,SA,Away,After 1965
MD Shanaka,SL,Pace,2021-01-14,Galle,Sri Lanka,2021,1,22,42,0,1,215,534,7,193,492,7,30.714285714285715,>30,SL,Home,After 1965
MDK Perera,SL,Spin,2014-01-16,Sharjah,UAE,2014,1,71,102,1,1,637,1445,16,566,1343,15,39.8125,>30,UAE,Away,After 1965
MDK Perera,SL,Spin,2014-01-27,Mirpur,Bangladesh,2014,2,154,185,5,1,658,946,13,504,761,8,50.61538461538461,>30,BAN,Away,After 1965
MDK Perera,SL,Spin,2014-02-04,Chattogram,Bangladesh,2014,2,174,402,5,1,1153,1976,25,979,1574,20,46.12,>30,BAN,Away,After 1965
MDK Perera,SL,Spin,2014-07-16,Galle,Sri Lanka,2014,2,241,436,8,1,723,1396,15,482,960,7,48.2,>30,SL,Home,After 1965
MDK Perera,SL,Spin,2014-07-24,Colombo (SSC),Sri Lanka,2014,2,129,515,8,1,647,1745,22,518,1230,14,29.40909090909091,<=30,SL,Home,After 1965
MDK Perera,SL,Spin,2014-08-06,Galle,Sri Lanka,2014,2,205,359,7,1,717,1430,22,512,1071,15,32.59090909090909,>30,SL,Home,After 1965
MDK Perera,SL,Spin,2014-08-14,Colombo (SSC),Sri Lanka,2014,2,109,180,2,1,617,1331,23,508,1151,21,26.82608695652174,<=30,SL,Home,After 1965
MDK Perera,SL,Spin,2015-06-17,Galle,Sri Lanka,2015,2,153,205,4,1,617,1159,20,464,954,16,30.85,>30,SL,Home,After 1965
MDK Perera,SL,Spin,2015-10-22,Colombo (PSS),Sri Lanka,2015,2,65,188,4,1,448,1072,27,383,884,23,16.59259259259259,<=30,SL,Home,After 1965
MDK Perera,SL,Spin,2016-07-26,Pallekele,Sri Lanka,2016,2,73,162,1,1,503,1219,26,430,1057,25,19.346153846153847,<=30,SL,Home,After 1965
MDK Perera,SL,Spin,2016-08-04,Galle,Sri Lanka,2016,2,99,228,10,1,555,873,24,456,645,14,23.125,<=30,SL,Home,After 1965
MDK Perera,SL,Spin,2016-08-13,Colombo (SSC),Sri Lanka,2016,2,200,396,4,1,860,1808,28,660,1412,24,30.714285714285715,>30,SL,Home,After 1965
MDK Perera,SL,Spin,2016-10-29,Harare,Zimbabwe,2016,2,100,201,5,1,573,1161,19,473,960,14,30.157894736842106,>30,ZIM,Away,After 1965
MDK Perera,SL,Spin,2016-11-06,Harare,Zimbabwe,2016,2,93,156,3,1,564,968,25,471,812,22,22.56,<=30,ZIM,Away,After 1965
MDK Perera,SL,Spin,2017-03-07,Galle,Sri Lanka,2017,2,119,204,5,1,752,1277,25,633,1073,20,30.08,>30,SL,Home,After 1965
MDK Perera,SL,Spin,2017-03-15,Colombo (PSS),Sri Lanka,2017,2,159,330,3,1,916,1838,26,757,1508,23,35.23076923076923,>30,SL,Home,After 1965
MDK Perera,SL,Spin,2017-07-14,Colombo (RPS),Sri Lanka,2017,2,181,324,4,1,1059,1917,28,878,1593,24,37.82142857142857,>30,SL,Home,After 1965
MDK Perera,SL,Spin,2017-07-26,Galle,Sri Lanka,2017,2,197,270,1,1,734,1244,13,537,974,12,56.46153846153846,>30,SL,Home,After 1965
MDK Perera,SL,Spin,2017-08-03,Colombo (SSC),Sri Lanka,2017,1,147,240,1,1,953,1487,21,806,1247,20,45.38095238095238,>30,SL,Home,After 1965
MDK Perera,SL,Spin,2017-08-12,Pallekele,Sri Lanka,2017,1,36,48,0,1,436,802,19,400,754,19,22.94736842105263,<=30,SL,Home,After 1965
MDK Perera,SL,Spin,2017-09-28,Abu Dhabi,UAE,2017,2,138,330,4,1,623,1568,26,485,1238,22,23.96153846153846,<=30,UAE,Away,After 1965
MDK Perera,SL,Spin,2017-10-06,Dubai (DICS),UAE,2017,2,170,312,8,1,608,1153,24,438,841,16,25.333333333333332,<=30,UAE,Away,After 1965
MDK Perera,SL,Spin,2017-11-16,Eden Gardens,India,2017,2,68,120,3,1,123,228,3,55,108,0,41.0,>30,IND,Away,After 1965
MDK Perera,SL,Spin,2017-11-24,Nagpur,India,2017,1,202,270,3,1,497,970,17,295,700,14,29.235294117647058,<=30,IND,Away,After 1965
MDK Perera,SL,Spin,2017-12-02,Delhi,India,2017,2,199,253,2,1,881,1566,17,682,1313,15,51.8235294117647,>30,IND,Away,After 1965
MDK Perera,SL,Spin,2018-01-31,Chattogram,Bangladesh,2018,2,186,318,2,1,1210,2061,19,1024,1743,17,63.68421052631579,>30,BAN,Away,After 1965
MDK Perera,SL,Spin,2018-02-08,Mirpur,Bangladesh,2018,2,64,130,3,1,561,1029,30,497,899,27,18.7,<=30,BAN,Away,After 1965
MDK Perera,SL,Spin,2018-06-06,Port of Spain,West Indies,2018,2,134,282,1,1,353,866,12,219,584,11,29.416666666666668,<=30,WI,Away,After 1965
MDK Perera,SL,Spin,2018-06-23,Bridgetown,West Indies,2018,2,29,81,2,1,34,93,2,5,12,0,17.0,<=30,WI,Away,After 1965
MDK Perera,SL,Spin,2018-07-12,Galle,Sri Lanka,2018,2,78,222,10,1,416,921,25,338,699,15,16.64,<=30,SL,Home,After 1965
MDK Perera,SL,Spin,2018-07-20,Colombo (SSC),Sri Lanka,2018,2,130,257,6,1,722,1323,32,592,1066,26,22.5625,<=30,SL,Home,After 1965
MDK Perera,SL,Spin,2018-11-06,Galle,Sri Lanka,2018,2,169,366,7,1,876,1627,28,707,1261,21,31.285714285714285,>30,SL,Home,After 1965
MDK Perera,SL,Spin,2018-11-14,Pallekele,Sri Lanka,2018,2,157,272,7,1,1031,1760,38,874,1488,31,27.13157894736842,<=30,SL,Home,After 1965
MDK Perera,SL,Spin,2018-11-23,Colombo (SSC),Sri Lanka,2018,2,201,376,8,1,913,1615,34,712,1239,26,26.852941176470587,<=30,SL,Home,After 1965
MDK Perera,SL,Spin,2018-12-15,Wellington,New Zealand,2018,1,156,240,2,1,274,534,4,118,294,2,68.5,>30,NZ,Away,After 1965
MDK Perera,SL,Spin,2018-12-26,Christchurch,New Zealand,2018,2,162,276,2,1,228,444,2,66,168,0,114.0,>30,NZ,Away,After 1965
MDK Perera,SL,Spin,2019-01-24,Brisbane,Australia,2019,1,84,194,2,1,161,391,5,77,197,3,32.2,>30,AUS,Away,After 1965
MDK Perera,SL,Spin,2019-02-01,Canberra,Australia,2019,2,164,282,0,1,375,678,4,211,396,4,93.75,>30,AUS,Away,After 1965
MDK Perera,SL,Spin,2019-08-22,Colombo (PSS),Sri Lanka,2019,1,114,222,3,1,428,846,11,314,624,8,38.90909090909091,>30,SL,Home,After 1965
MDK Perera,SL,Spin,2019-12-11,Rawalpindi,Pakistan,2019,1,85,144,0,1,170,252,0,85,108,0,inf,>30,PAK,Away,After 1965
MDK Perera,SL,Spin,2019-12-19,Karachi,Pakistan,2019,2,117,168,0,1,548,873,9,431,705,9,60.888888888888886,>30,PAK,Away,After 1965
MDK Perera,SL,Spin,2021-01-14,Galle,Sri Lanka,2021,2,143,285,4,1,751,1413,23,608,1128,19,32.65217391304348,>30,SL,Home,After 1965
MDK Perera,SL,Spin,2021-01-22,Galle,Sri Lanka,2021,2,125,274,1,1,734,1377,23,609,1103,22,31.91304347826087,>30,SL,Home,After 1965
MDUS Jayasundera,SL,Spin,2015-12-10,Dunedin,New Zealand,2015,2,45,42,0,1,310,569,7,265,527,7,44.285714285714285,>30,NZ,Away,After 1965
ME Chapple,NZ,Pace,1954-01-01,Cape Town,South Africa,1954,1,1,8,0,1,315,963,9,314,955,9,35.0,>30,SA,Away,Upto 2014
ME Chapple,NZ,Pace,1962-01-01,Cape Town,South Africa,1962,1,3,6,0,1,494,1176,15,491,1170,15,32.93333333333333,>30,SA,Away,Upto 2014
ME Chapple,NZ,Pace,1962-02-02,Johannesburg,South Africa,1962,1,15,18,0,1,533,1091,23,518,1073,23,23.17391304347826,<=30,SA,Away,Upto 2014
ME Chapple,NZ,Pace,1964-02-28,Dunedin,New Zealand,1964,1,41,162,0,1,306,1085,13,265,923,13,23.53846153846154,<=30,NZ,Home,Upto 2014
ME Chapple,NZ,Pace,1966-02-25,Christchurch,New Zealand,1966,1,24,54,1,1,629,1668,27,605,1614,26,23.296296296296298,<=30,NZ,Home,Upto 2014
ME Trescothick,ENG,Pace,2000-08-03,Manchester,England,2000,1,2,6,0,1,672,1537,23,670,1531,23,29.217391304347824,<=30,ENG,Home,Upto 2014
ME Trescothick,ENG,Pace,2000-12-07,Karachi,Pakistan,2000,1,34,84,1,1,458,1000,15,424,916,14,30.533333333333335,>30,PAK,Away,Upto 2014
ME Trescothick,ENG,Pace,2001-05-17,Lord's,England,2001,1,2,12,0,1,714,1443,30,712,1431,30,23.8,<=30,ENG,Home,Upto 2014
ME Trescothick,ENG,Pace,2001-05-31,Manchester,England,2001,1,14,18,0,1,1134,1996,31,1120,1978,31,36.58064516129032,>30,ENG,Home,Upto 2014
ME Trescothick,ENG,Pace,2003-12-18,Colombo (SSC),Sri Lanka,2003,1,10,12,0,1,444,738,12,434,726,12,37.0,>30,SL,Away,Upto 2014
ME Trescothick,ENG,Pace,2004-03-19,Port of Spain,West Indies,2004,1,4,6,0,1,720,1489,29,716,1483,29,24.82758620689655,<=30,WI,Away,Upto 2014
ME Trescothick,ENG,Pace,2004-04-10,St John's,West Indies,2004,1,68,108,0,1,955,1635,13,887,1527,13,73.46153846153847,>30,WI,Away,Upto 2014
ME Trescothick,ENG,Pace,2004-06-03,Leeds,England,2004,1,3,12,0,1,915,1695,27,912,1683,27,33.888888888888886,>30,ENG,Home,Upto 2014
ME Trescothick,ENG,Pace,2004-07-29,Birmingham,England,2004,1,7,12,0,1,971,1389,23,964,1377,23,42.21739130434783,>30,ENG,Home,Upto 2014
ME Trescothick,ENG,Pace,2005-01-13,Johannesburg,South Africa,2005,1,11,30,0,1,1212,2062,34,1201,2032,34,35.64705882352941,>30,SA,Away,Upto 2014
ME Waugh,AUS,Spin,1991-01-25,Adelaide,Australia,1991,2,17,30,0,1,183,342,1,166,312,1,183.0,>30,AUS,Home,Upto 2014
ME Waugh,AUS,Spin,1991-02-01,W.A.C.A,Australia,1991,1,9,6,0,1,50,60,2,41,54,2,25.0,<=30,AUS,Home,Upto 2014
ME Waugh,AUS,Spin,1991-03-01,Kingston,West Indies,1991,2,45,114,1,1,221,516,2,176,402,1,110.5,>30,WI,Away,Upto 2014
ME Waugh,AUS,Spin,1991-03-23,Georgetown,West Indies,1991,1,18,12,0,1,331,635,8,313,623,8,41.375,>30,WI,Away,Upto 2014
ME Waugh,AUS,Spin,1991-04-05,Port of Spain,West Indies,1991,1,9,36,1,1,152,384,2,143,348,1,76.0,>30,WI,Away,Upto 2014
ME Waugh,AUS,Spin,1991-04-19,Bridgetown,West Indies,1991,1,80,168,4,1,121,318,6,41,150,2,20.166666666666668,<=30,WI,Away,Upto 2014
ME Waugh,AUS,Spin,1991-04-27,St John's,West Indies,1991,2,31,60,2,1,399,618,7,368,558,5,57.0,>30,WI,Away,Upto 2014
ME Waugh,AUS,Spin,1991-11-29,Brisbane,Australia,1991,1,6,6,0,1,182,335,1,176,329,1,182.0,>30,AUS,Home,Upto 2014
ME Waugh,AUS,Spin,1991-12-26,Melbourne,Australia,1991,1,16,48,0,1,193,372,3,177,324,3,64.33333333333333,>30,AUS,Home,Upto 2014
ME Waugh,AUS,Spin,1992-01-02,Sydney,Australia,1992,1,28,84,0,1,301,666,6,273,582,6,50.166666666666664,>30,AUS,Home,Upto 2014
ME Waugh,AUS,Spin,1992-01-25,Adelaide,Australia,1992,2,39,84,1,1,316,796,8,277,712,7,39.5,>30,AUS,Home,Upto 2014
ME Waugh,AUS,Spin,1992-08-17,Colombo (SSC),Sri Lanka,1992,2,83,114,2,1,598,1075,17,515,961,15,35.1764705882353,>30,SL,Away,Upto 2014
ME Waugh,AUS,Spin,1992-08-28,Colombo (RPS),Sri Lanka,1992,1,11,24,0,1,357,918,7,346,894,7,51.0,>30,SL,Away,Upto 2014
ME Waugh,AUS,Spin,1992-11-27,Brisbane,Australia,1992,1,8,12,0,1,220,633,7,212,621,7,31.428571428571427,>30,AUS,Home,Upto 2014
ME Waugh,AUS,Spin,1992-12-26,Melbourne,Australia,1992,1,23,18,0,1,262,558,8,239,540,8,32.75,>30,AUS,Home,Upto 2014
ME Waugh,AUS,Spin,1993-01-02,Sydney,Australia,1993,1,29,60,1,1,617,1258,8,588,1198,7,77.125,>30,AUS,Home,Upto 2014
ME Waugh,AUS,Spin,1993-01-23,Adelaide,Australia,1993,1,3,6,1,1,119,287,11,116,281,10,10.818181818181818,<=30,AUS,Home,Upto 2014
ME Waugh,AUS,Spin,1993-01-30,W.A.C.A,Australia,1993,1,21,36,2,1,72,108,2,51,72,0,36.0,>30,AUS,Home,Upto 2014
ME Waugh,AUS,Spin,1993-02-25,Christchurch,New Zealand,1993,1,12,30,0,1,243,504,9,231,474,9,27.0,<=30,NZ,Away,Upto 2014
ME Waugh,AUS,Spin,1993-03-04,Wellington,New Zealand,1993,2,15,60,1,1,142,558,5,127,498,4,28.4,<=30,NZ,Away,Upto 2014
ME Waugh,AUS,Spin,1993-06-17,Lord's,England,1993,2,71,138,0,1,634,1745,17,563,1607,17,37.294117647058826,>30,ENG,Away,Upto 2014
ME Waugh,AUS,Spin,1993-07-01,Nottingham,England,1993,2,15,42,0,1,460,1186,11,445,1144,11,41.81818181818182,>30,ENG,Away,Upto 2014
ME Waugh,AUS,Spin,1993-07-22,Leeds,England,1993,2,10,30,0,1,214,660,6,204,630,6,35.666666666666664,>30,ENG,Away,Upto 2014
ME Waugh,AUS,Spin,1993-08-05,Birmingham,England,1993,2,48,120,1,1,613,1738,21,565,1618,20,29.19047619047619,<=30,ENG,Away,Upto 2014
ME Waugh,AUS,Spin,1993-08-19,The Oval,England,1993,1,17,6,0,1,310,756,7,293,750,7,44.285714285714285,>30,ENG,Away,Upto 2014
ME Waugh,AUS,Spin,1993-11-12,W.A.C.A,Australia,1993,2,35,114,2,1,339,721,5,304,607,3,67.8,>30,AUS,Home,Upto 2014
ME Waugh,AUS,Spin,1993-11-26,Hobart,Australia,1993,2,15,78,2,1,270,782,19,255,704,17,14.210526315789474,<=30,AUS,Home,Upto 2014
ME Waugh,AUS,Spin,1993-12-03,Brisbane,Australia,1993,2,44,96,1,1,392,909,12,348,813,11,32.666666666666664,>30,AUS,Home,Upto 2014
ME Waugh,AUS,Spin,1993-12-26,Melbourne,Australia,1993,1,20,72,1,1,190,527,4,170,455,3,47.5,>30,AUS,Home,Upto 2014
ME Waugh,AUS,Spin,1994-01-28,Adelaide,Australia,1994,2,10,36,0,1,289,1015,8,279,979,8,36.125,>30,AUS,Home,Upto 2014
ME Waugh,AUS,Spin,1994-03-04,Johannesburg,South Africa,1994,1,14,36,0,1,318,779,9,304,743,9,35.333333333333336,>30,SA,Away,Upto 2014
ME Waugh,AUS,Spin,1994-03-17,Cape Town,South Africa,1994,2,34,78,0,1,182,607,6,148,529,6,30.333333333333332,>30,SA,Away,Upto 2014
ME Waugh,AUS,Spin,1994-03-25,Durban,South Africa,1994,1,38,66,0,1,158,468,4,120,402,4,39.5,>30,SA,Away,Upto 2014
ME Waugh,AUS,Spin,1994-09-28,Karachi,Pakistan,1994,1,4,18,0,1,538,1117,15,534,1099,15,35.86666666666667,>30,PAK,Away,Upto 2014
ME Waugh,AUS,Spin,1994-10-05,Rawalpindi,Pakistan,1994,1,63,96,2,1,440,796,6,377,700,4,73.33333333333333,>30,PAK,Away,Upto 2014
ME Waugh,AUS,Spin,1994-11-01,Lahore,Pakistan,1994,2,26,48,0,1,660,1368,20,634,1320,20,33.0,>30,PAK,Away,Upto 2014
ME Waugh,AUS,Spin,1994-11-25,Brisbane,Australia,1994,1,17,42,0,1,405,1216,16,388,1174,16,25.3125,<=30,AUS,Home,Upto 2014
ME Waugh,AUS,Spin,1994-12-24,Melbourne,Australia,1994,1,11,18,0,1,290,880,14,279,862,14,20.714285714285715,<=30,AUS,Home,Upto 2014
ME Waugh,AUS,Spin,1995-01-01,Sydney,Australia,1995,2,14,48,0,1,330,790,1,316,742,1,330.0,>30,AUS,Home,Upto 2014
ME Waugh,AUS,Spin,1995-01-26,Adelaide,Australia,1995,2,73,138,5,1,395,872,12,322,734,7,32.916666666666664,>30,AUS,Home,Upto 2014
ME Waugh,AUS,Spin,1995-02-03,W.A.C.A,Australia,1995,2,42,72,3,1,185,366,5,143,294,2,37.0,>30,AUS,Home,Upto 2014
ME Waugh,AUS,Spin,1995-03-31,Bridgetown,West Indies,1995,1,12,6,0,1,198,315,6,186,309,6,33.0,>30,WI,Away,Upto 2014
ME Waugh,AUS,Spin,1995-04-08,St John's,West Indies,1995,1,15,36,0,1,167,342,4,152,306,4,41.75,>30,WI,Away,Upto 2014
ME Waugh,AUS,Spin,1995-04-21,Port of Spain,West Indies,1995,1,9,12,1,1,51,107,2,42,95,1,25.5,<=30,WI,Away,Upto 2014
ME Waugh,AUS,Spin,1995-04-29,Kingston,West Indies,1995,2,12,30,0,1,303,676,8,291,646,8,37.875,>30,WI,Away,Upto 2014
ME Waugh,AUS,Spin,1995-11-09,Brisbane,Australia,1995,1,6,30,1,1,256,659,16,250,629,15,16.0,<=30,AUS,Home,Upto 2014
ME Waugh,AUS,Spin,1995-11-17,Hobart,Australia,1995,2,47,120,0,1,263,594,9,216,474,9,29.22222222222222,<=30,AUS,Home,Upto 2014
ME Waugh,AUS,Spin,1995-11-30,Sydney,Australia,1995,2,44,144,1,1,467,1214,20,423,1070,19,23.35,<=30,AUS,Home,Upto 2014
ME Waugh,AUS,Spin,1995-12-08,W.A.C.A,Australia,1995,2,28,42,0,1,558,1018,9,530,976,9,62.0,>30,AUS,Home,Upto 2014
ME Waugh,AUS,Spin,1995-12-26,Melbourne,Australia,1995,1,19,54,1,1,439,892,9,420,838,8,48.77777777777778,>30,AUS,Home,Upto 2014
ME Waugh,AUS,Spin,1996-01-25,Adelaide,Australia,1996,2,26,54,1,1,356,732,3,330,678,2,118.66666666666667,>30,AUS,Home,Upto 2014
ME Waugh,AUS,Spin,1996-10-10,Delhi,India,1996,1,62,108,1,1,528,1278,19,466,1170,18,27.789473684210527,<=30,IND,Away,Upto 2014
ME Waugh,AUS,Spin,1996-11-22,Brisbane,Australia,1996,1,16,24,0,1,313,642,7,297,618,7,44.714285714285715,>30,AUS,Home,Upto 2014
ME Waugh,AUS,Spin,1996-11-29,Sydney,Australia,1996,1,15,24,0,1,372,857,10,357,833,10,37.2,>30,AUS,Home,Upto 2014
ME Waugh,AUS,Spin,1997-02-28,Johannesburg,South Africa,1997,1,4,6,0,1,374,844,13,370,838,13,28.76923076923077,<=30,SA,Away,Upto 2014
ME Waugh,AUS,Spin,1997-03-21,Centurion,South Africa,1997,1,34,42,1,1,288,600,4,254,558,3,72.0,>30,SA,Away,Upto 2014
ME Waugh,AUS,Spin,1997-08-21,The Oval,England,1997,1,16,42,1,1,198,586,16,182,544,15,12.375,<=30,ENG,Away,Upto 2014
ME Waugh,AUS,Spin,1997-11-07,Brisbane,Australia,1997,1,18,42,0,1,311,786,10,293,744,10,31.1,>30,AUS,Home,Upto 2014
ME Waugh,AUS,Spin,1997-11-27,Hobart,Australia,1997,2,36,84,0,1,298,570,8,262,486,8,37.25,>30,AUS,Home,Upto 2014
ME Waugh,AUS,Spin,1997-12-26,Melbourne,Australia,1997,2,53,168,2,1,373,1058,13,320,890,11,28.692307692307693,<=30,AUS,Home,Upto 2014
ME Waugh,AUS,Spin,1998-01-02,Sydney,Australia,1998,2,40,78,0,1,392,1015,16,352,937,16,24.5,<=30,AUS,Home,Upto 2014
ME Waugh,AUS,Spin,1998-01-30,Adelaide,Australia,1998,1,21,36,0,1,384,731,9,363,695,9,42.666666666666664,>30,AUS,Home,Upto 2014
ME Waugh,AUS,Spin,1998-03-06,Chennai,India,1998,2,48,60,1,1,809,1753,28,761,1693,27,28.892857142857142,<=30,IND,Away,Upto 2014
ME Waugh,AUS,Spin,1998-03-18,Eden Gardens,India,1998,1,77,108,1,1,634,1306,12,557,1198,11,52.833333333333336,>30,IND,Away,Upto 2014
ME Waugh,AUS,Spin,1998-03-25,Bengaluru,India,1998,1,24,24,0,1,817,1511,22,793,1487,22,37.13636363636363,>30,IND,Away,Upto 2014
ME Waugh,AUS,Spin,1998-10-15,Peshawar,Pakistan,1998,1,32,48,0,1,751,1422,7,719,1374,7,107.28571428571429,>30,PAK,Away,Upto 2014
ME Waugh,AUS,Spin,1998-11-20,Brisbane,Australia,1998,2,73,132,3,1,328,690,9,255,558,6,36.44444444444444,>30,AUS,Home,Upto 2014
ME Waugh,AUS,Spin,1998-12-11,Adelaide,Australia,1998,1,17,18,0,1,473,1152,14,456,1134,14,33.785714285714285,>30,AUS,Home,Upto 2014
ME Waugh,AUS,Spin,1998-12-26,Melbourne,Australia,1998,1,0,6,0,1,148,294,7,148,288,7,21.142857142857142,<=30,AUS,Home,Upto 2014
ME Waugh,AUS,Spin,1999-03-13,Kingston,West Indies,1999,1,13,12,0,1,346,591,10,333,579,10,34.6,>30,WI,Away,Upto 2014
ME Waugh,AUS,Spin,1999-03-26,Bridgetown,West Indies,1999,1,11,18,0,1,408,819,7,397,801,7,58.285714285714285,>30,WI,Away,Upto 2014
ME Waugh,AUS,Spin,1999-09-22,Galle,Sri Lanka,1999,1,9,12,0,1,307,827,13,298,815,13,23.615384615384617,<=30,SL,Away,Upto 2014
ME Waugh,AUS,Spin,1999-11-18,Hobart,Australia,1999,1,6,12,0,1,337,796,16,331,784,16,21.0625,<=30,AUS,Home,Upto 2014
ME Waugh,AUS,Spin,1999-12-10,Adelaide,Australia,1999,1,0,6,0,1,301,744,9,301,738,9,33.44444444444444,>30,AUS,Home,Upto 2014
ME Waugh,AUS,Spin,1999-12-26,Melbourne,Australia,1999,2,17,24,2,1,307,606,6,290,582,4,51.166666666666664,>30,AUS,Home,Upto 2014
ME Waugh,AUS,Spin,2000-12-01,W.A.C.A,Australia,2000,1,5,12,0,1,104,252,4,99,240,4,26.0,<=30,AUS,Home,Upto 2014
ME Waugh,AUS,Spin,2001-01-02,Sydney,Australia,2001,1,10,54,1,1,641,1329,18,631,1275,17,35.611111111111114,>30,AUS,Home,Upto 2014
ME Waugh,AUS,Spin,2001-02-27,Wankhede,India,2001,1,40,90,3,1,392,686,14,352,596,11,28.0,<=30,IND,Away,Upto 2014
ME Waugh,AUS,Spin,2001-03-11,Eden Gardens,India,2001,1,58,108,0,1,625,1131,20,567,1023,20,31.25,>30,IND,Away,Upto 2014
ME Waugh,AUS,Spin,2001-03-18,Chennai,India,2001,1,8,18,0,1,924,1783,26,916,1765,26,35.53846153846154,>30,IND,Away,Upto 2014
ME Waugh,AUS,Spin,2001-07-05,Birmingham,England,2001,1,6,6,0,1,315,491,10,309,485,10,31.5,>30,ENG,Away,Upto 2014
ME Waugh,AUS,Spin,2001-07-19,Lord's,England,2001,1,12,12,0,1,166,273,3,154,261,3,55.333333333333336,>30,ENG,Away,Upto 2014
ME Waugh,AUS,Spin,2001-08-16,Leeds,England,2001,1,7,6,0,1,126,236,1,119,230,1,126.0,>30,ENG,Away,Upto 2014
ME Waugh,AUS,Spin,2001-08-23,The Oval,England,2001,2,44,54,1,1,630,1004,15,586,950,14,42.0,>30,ENG,Away,Upto 2014
ME Waugh,AUS,Spin,2001-11-08,Brisbane,Australia,2001,1,8,6,0,1,231,316,3,223,310,3,77.0,>30,AUS,Home,Upto 2014
ME Waugh,AUS,Spin,2001-11-22,Hobart,Australia,2001,1,30,42,1,1,238,404,7,208,362,6,34.0,>30,AUS,Home,Upto 2014
ME Waugh,AUS,Spin,2001-11-30,W.A.C.A,Australia,2001,1,26,36,0,1,465,898,10,439,862,10,46.5,>30,AUS,Home,Upto 2014
ME Waugh,AUS,Spin,2001-12-14,Adelaide,Australia,2001,1,9,18,0,1,425,803,15,416,785,15,28.333333333333332,<=30,AUS,Home,Upto 2014
ME Waugh,AUS,Spin,2001-12-26,Melbourne,Australia,2001,1,19,48,1,1,251,480,5,232,432,4,50.2,>30,AUS,Home,Upto 2014
ME Waugh,AUS,Spin,2002-01-02,Sydney,Australia,2002,1,14,36,0,1,581,1150,17,567,1114,17,34.1764705882353,>30,AUS,Home,Upto 2014
ME Waugh,AUS,Spin,2002-03-08,Cape Town,South Africa,2002,2,35,60,0,1,472,895,14,437,835,14,33.714285714285715,>30,SA,Away,Upto 2014
ME Waugh,AUS,Spin,2002-03-15,Durban,South Africa,2002,1,43,71,2,1,268,461,12,225,390,10,22.333333333333332,<=30,SA,Away,Upto 2014
ME Waugh,AUS,Spin,2002-10-03,Colombo (PSS),Sri Lanka,2002,2,28,30,0,1,409,724,19,381,694,19,21.526315789473685,<=30,SL,Away,Upto 2014
ME Waugh,AUS,Spin,2002-10-19,Sharjah,UAE,2002,2,43,84,0,1,467,889,13,424,805,13,35.92307692307692,>30,UAE,Away,Upto 2014
MEK Hussey,AUS,Pace,2006-01-02,Sydney,Australia,2006,1,12,12,0,1,752,1301,17,740,1289,17,44.23529411764706,>30,AUS,Home,Upto 2014
MEK Hussey,AUS,Pace,2006-03-24,Durban,South Africa,2006,2,6,12,0,1,838,1637,23,832,1625,23,36.43478260869565,>30,SA,Away,Upto 2014
MEK Hussey,AUS,Pace,2006-11-23,Brisbane,Australia,2006,1,5,6,0,1,985,1659,24,980,1653,24,41.041666666666664,>30,AUS,Home,Upto 2014
MEK Hussey,AUS,Pace,2008-05-30,North Sound,West Indies,2008,1,14,36,0,1,984,1871,24,970,1835,24,41.0,>30,WI,Away,Upto 2014
MEK Hussey,AUS,Pace,2008-10-17,Mohali,India,2008,1,38,48,0,1,846,1398,17,808,1350,17,49.76470588235294,>30,IND,Away,Upto 2014
MEK Hussey,AUS,Pace,2008-11-06,Nagpur,India,2008,1,3,24,0,1,502,1096,12,499,1072,12,41.833333333333336,>30,IND,Away,Upto 2014
MEK Hussey,AUS,Pace,2008-12-26,Melbourne,Australia,2008,1,22,30,1,1,952,1716,26,930,1686,25,36.61538461538461,>30,AUS,Home,Upto 2014
MEK Hussey,AUS,Pace,2009-11-26,Brisbane,Australia,2009,1,3,12,1,1,697,1123,21,694,1111,20,33.19047619047619,>30,AUS,Home,Upto 2014
MEK Hussey,AUS,Pace,2011-01-03,Sydney,Australia,2011,1,2,6,0,1,873,1642,26,871,1636,26,33.57692307692308,>30,AUS,Home,Upto 2014
MEK Hussey,AUS,Pace,2011-09-08,Pallekele,Sri Lanka,2011,2,2,30,2,1,526,1180,17,524,1150,15,30.941176470588236,>30,SL,Away,Upto 2014
MEK Hussey,AUS,Pace,2011-09-16,Colombo (SSC),Sri Lanka,2011,1,5,12,0,1,825,1634,20,820,1622,20,41.25,>30,SL,Away,Upto 2014
MEK Hussey,AUS,Pace,2011-11-17,Johannesburg,South Africa,2011,2,24,54,0,1,938,1680,27,914,1626,27,34.74074074074074,>30,SA,Away,Upto 2014
MEK Hussey,AUS,Pace,2011-12-01,Brisbane,Australia,2011,2,12,36,1,1,653,1114,19,641,1078,18,34.36842105263158,>30,AUS,Home,Upto 2014
MEK Hussey,AUS,Pace,2011-12-09,Hobart,Australia,2011,1,15,30,1,1,648,1341,37,633,1311,36,17.513513513513512,<=30,AUS,Home,Upto 2014
MEK Hussey,AUS,Pace,2011-12-26,Melbourne,Australia,2011,1,15,30,0,1,739,1504,35,724,1474,35,21.114285714285714,<=30,AUS,Home,Upto 2014
MEK Hussey,AUS,Pace,2012-01-03,Sydney,Australia,2012,2,13,24,0,1,874,1376,22,861,1352,22,39.72727272727273,>30,AUS,Home,Upto 2014
MEK Hussey,AUS,Pace,2012-01-13,W.A.C.A,Australia,2012,1,3,12,0,1,668,1156,29,665,1144,29,23.03448275862069,<=30,AUS,Home,Upto 2014
MEK Hussey,AUS,Pace,2012-01-24,Adelaide,Australia,2012,2,21,48,0,1,749,1369,20,728,1321,20,37.45,>30,AUS,Home,Upto 2014
MEK Hussey,AUS,Pace,2012-04-07,Bridgetown,West Indies,2012,1,6,12,0,1,725,1642,25,719,1630,25,29.0,<=30,WI,Away,Upto 2014
MEK Hussey,AUS,Pace,2012-04-15,Port of Spain,West Indies,2012,1,19,36,1,1,412,924,17,393,888,16,24.235294117647058,<=30,WI,Away,Upto 2014
MEK Hussey,AUS,Pace,2012-11-09,Brisbane,Australia,2012,1,21,24,0,1,917,1756,14,896,1732,14,65.5,>30,AUS,Home,Upto 2014
MEK Hussey,AUS,Pace,2012-11-22,Adelaide,Australia,2012,1,7,6,0,1,863,1649,28,856,1643,28,30.821428571428573,>30,AUS,Home,Upto 2014
MEK Hussey,AUS,Pace,2012-11-30,W.A.C.A,Australia,2012,1,26,24,0,1,885,1522,30,859,1498,30,29.5,<=30,AUS,Home,Upto 2014
MEK Hussey,AUS,Pace,2012-12-14,Hobart,Australia,2012,1,5,6,0,1,927,1883,26,922,1877,26,35.65384615384615,>30,AUS,Home,Upto 2014
MEK Hussey,AUS,Pace,2013-01-03,Sydney,Australia,2013,2,7,18,0,1,729,1200,20,722,1182,20,36.45,>30,AUS,Home,Upto 2014
MEZ Ghazali,PAK,Spin,1954-07-22,Manchester,England,1954,1,18,48,0,1,192,600,11,174,552,11,17.454545454545453,<=30,ENG,Away,Upto 2014
MF Maharoof,SL,Pace,2004-05-06,Harare,Zimbabwe,2004,2,63,84,2,1,612,996,20,549,912,18,30.6,>30,ZIM,Away,Upto 2014
MF Maharoof,SL,Pace,2004-05-14,Bulawayo,Zimbabwe,2004,2,94,132,2,1,856,1362,13,762,1230,11,65.84615384615384,>30,ZIM,Away,Upto 2014
MF Maharoof,SL,Pace,2004-08-04,Galle,Sri Lanka,2004,2,46,144,0,1,548,1192,14,502,1048,14,39.142857142857146,>30,SL,Home,Upto 2014
MF Maharoof,SL,Pace,2004-10-28,Karachi,Pakistan,2004,2,75,150,1,1,689,1333,19,614,1183,18,36.26315789473684,>30,PAK,Away,Upto 2014
MF Maharoof,SL,Pace,2005-04-11,Wellington,New Zealand,2005,1,96,168,0,1,716,1428,28,620,1260,28,25.571428571428573,<=30,NZ,Away,Upto 2014
MF Maharoof,SL,Pace,2005-12-18,Ahmedabad,India,2005,2,77,198,3,1,356,678,10,279,480,7,35.6,>30,IND,Away,Upto 2014
MF Maharoof,SL,Pace,2006-02-28,Chattogram,Bangladesh,2006,2,42,78,1,1,293,539,9,251,461,8,32.55555555555556,>30,BAN,Away,Upto 2014
MF Maharoof,SL,Pace,2006-03-08,Bogra,Bangladesh,2006,1,22,24,0,1,292,547,11,270,523,11,26.545454545454547,<=30,BAN,Away,Upto 2014
MF Maharoof,SL,Pace,2006-03-26,Colombo (SSC),Sri Lanka,2006,2,122,228,5,1,568,1044,16,446,816,11,35.5,>30,SL,Home,Upto 2014
MF Maharoof,SL,Pace,2006-04-03,Kandy,Sri Lanka,2006,2,106,144,1,1,524,943,20,418,799,19,26.2,<=30,SL,Home,Upto 2014
MF Maharoof,SL,Pace,2006-05-11,Lord's,England,2006,1,125,168,1,1,982,1899,19,857,1731,18,51.68421052631579,>30,ENG,Away,Upto 2014
MF Maharoof,SL,Pace,2006-05-25,Birmingham,England,2006,1,42,66,0,1,504,1093,20,462,1027,20,25.2,<=30,ENG,Away,Upto 2014
MF Maharoof,SL,Pace,2006-07-27,Colombo (SSC),Sri Lanka,2006,2,80,144,2,1,781,1191,14,701,1047,12,55.785714285714285,>30,SL,Home,Upto 2014
MF Maharoof,SL,Pace,2006-08-04,Colombo (PSS),Sri Lanka,2006,2,105,216,2,1,843,1453,20,738,1237,18,42.15,>30,SL,Home,Upto 2014
MF Maharoof,SL,Pace,2006-12-07,Christchurch,New Zealand,2006,2,59,102,1,1,515,1047,25,456,945,24,20.6,<=30,NZ,Away,Upto 2014
MF Maharoof,SL,Pace,2006-12-15,Wellington,New Zealand,2006,2,57,96,2,1,700,1140,20,643,1044,18,35.0,>30,NZ,Away,Upto 2014
MF Maharoof,SL,Pace,2007-07-11,Kandy,Sri Lanka,2007,2,58,144,1,1,437,738,11,379,594,10,39.72727272727273,>30,SL,Home,Upto 2014
MF Maharoof,SL,Pace,2007-11-08,Brisbane,Australia,2007,1,107,204,0,1,668,1297,18,561,1093,18,37.111111111111114,>30,AUS,Away,Upto 2014
MF Maharoof,SL,Pace,2007-11-16,Hobart,Australia,2007,1,82,138,0,1,932,1457,19,850,1319,19,49.05263157894737,>30,AUS,Away,Upto 2014
MF Maharoof,SL,Pace,2011-05-26,Cardiff,England,2011,1,92,168,1,1,591,1108,14,499,940,13,42.214285714285715,>30,ENG,Away,Upto 2014
MF Maharoof,SL,Pace,2011-06-03,Lord's,England,2011,2,81,144,0,1,1032,1597,21,951,1453,21,49.142857142857146,>30,ENG,Away,Upto 2014
MF Malone,AUS,Pace,1977-08-25,The Oval,England,1977,2,77,342,6,1,507,1259,20,430,917,14,25.35,<=30,ENG,Away,Upto 2014
MF Tremlett,ENG,Pace,1948-01-21,Bridgetown,West Indies,1948,2,89,216,1,1,345,968,10,256,752,9,34.5,>30,WI,Away,Upto 2014
MF Tremlett,ENG,Pace,1948-03-03,Georgetown,West Indies,1948,1,35,84,1,1,265,632,11,230,548,10,24.09090909090909,<=30,WI,Away,Upto 2014
MF Tremlett,ENG,Pace,1948-03-27,Kingston,West Indies,1948,2,102,192,2,1,401,1001,16,299,809,14,25.0625,<=30,WI,Away,Upto 2014
MG Bevan,AUS,Spin,1994-10-05,Rawalpindi,Pakistan,1994,1,27,24,0,1,440,796,6,413,772,6,73.33333333333333,>30,PAK,Away,Upto 2014
MG Bevan,AUS,Spin,1994-11-01,Lahore,Pakistan,1994,1,21,24,1,1,660,1368,20,639,1344,19,33.0,>30,PAK,Away,Upto 2014
MG Bevan,AUS,Spin,1994-11-25,Brisbane,Australia,1994,1,11,18,0,1,405,1216,16,394,1198,16,25.3125,<=30,AUS,Home,Upto 2014
MG Bevan,AUS,Spin,1995-01-01,Sydney,Australia,1995,1,8,24,0,1,330,790,1,322,766,1,330.0,>30,AUS,Home,Upto 2014
MG Bevan,AUS,Spin,1996-11-22,Brisbane,Australia,1996,1,46,84,3,1,313,642,7,267,558,4,44.714285714285715,>30,AUS,Home,Upto 2014
MG Bevan,AUS,Spin,1996-11-29,Sydney,Australia,1996,2,75,150,2,1,372,857,10,297,707,8,37.2,>30,AUS,Home,Upto 2014
MG Bevan,AUS,Spin,1997-01-25,Adelaide,Australia,1997,2,113,195,10,1,334,663,19,221,468,9,17.57894736842105,<=30,AUS,Home,Upto 2014
MG Bevan,AUS,Spin,1997-02-01,W.A.C.A,Australia,1997,1,31,30,0,1,142,252,3,111,222,3,47.333333333333336,>30,AUS,Home,Upto 2014
MG Bevan,AUS,Spin,1997-02-28,Johannesburg,South Africa,1997,2,96,192,6,1,374,844,13,278,652,7,28.76923076923077,<=30,SA,Away,Upto 2014
MG Bevan,AUS,Spin,1997-03-14,Gqeberha,South Africa,1997,2,26,90,3,1,179,488,11,153,398,8,16.272727272727273,<=30,SA,Away,Upto 2014
MG Bevan,AUS,Spin,1997-03-21,Centurion,South Africa,1997,1,54,90,0,1,288,600,4,234,510,4,72.0,>30,SA,Away,Upto 2014
MG Bevan,AUS,Spin,1997-06-05,Birmingham,England,1997,1,44,64,1,1,306,577,5,262,513,4,61.2,>30,ENG,Away,Upto 2014
MG Bevan,AUS,Spin,1997-06-19,Lord's,England,1997,1,29,48,0,1,115,246,3,86,198,3,38.333333333333336,>30,ENG,Away,Upto 2014
MG Bevan,AUS,Spin,1997-07-03,Manchester,England,1997,2,48,96,1,1,277,718,12,229,622,11,23.083333333333332,<=30,ENG,Away,Upto 2014
MG Bevan,AUS,Spin,1998-01-02,Sydney,Australia,1998,2,74,156,2,1,392,1015,16,318,859,14,24.5,<=30,AUS,Home,Upto 2014
MG Bracewell,NZ,Spin,2022-06-10,Nottingham,England,2022,2,122,152,3,1,364,530,6,242,378,3,60.666666666666664,>30,ENG,Away,After 1965
MG Bracewell,NZ,Spin,2022-06-23,Leeds,England,2022,2,163,134,2,1,388,637,13,225,503,11,29.846153846153847,<=30,ENG,Away,After 1965
MG Bracewell,NZ,Spin,2022-12-26,Karachi,Pakistan,2022,2,154,294,4,1,1086,2053,24,932,1759,20,45.25,>30,PAK,Away,After 1965
MG Bracewell,NZ,Spin,2023-01-02,Karachi,Pakistan,2023,2,162,276,4,1,805,1350,21,643,1074,17,38.333333333333336,>30,PAK,Away,After 1965
MG Bracewell,NZ,Spin,2023-02-16,Mount Maunganui,New Zealand,2023,2,81,137,3,1,205,347,5,124,210,2,41.0,>30,NZ,Home,After 1965
MG Bracewell,NZ,Spin,2023-02-24,Wellington,New Zealand,2023,2,127,168,2,1,403,711,11,276,543,9,36.63636363636363,>30,NZ,Home,After 1965
MG Bracewell,NZ,Spin,2023-03-09,Christchurch,New Zealand,2023,2,44,66,1,1,216,294,4,172,228,3,54.0,>30,NZ,Home,After 1965
MG Bracewell,NZ,Spin,2023-03-17,Wellington,New Zealand,2023,2,150,324,5,1,311,564,7,161,240,2,44.42857142857143,>30,NZ,Home,After 1965
MG Burgess,NZ,Spin,1968-02-15,Dunedin,New Zealand,1968,1,0,6,0,1,642,1761,17,642,1755,17,37.76470588235294,>30,NZ,Home,Upto 2014
MG Burgess,NZ,Spin,1968-02-29,Wellington,New Zealand,1968,1,7,12,0,1,408,1093,20,401,1081,20,20.4,<=30,NZ,Home,Upto 2014
MG Burgess,NZ,Spin,1969-07-24,Lord's,England,1969,1,11,18,0,1,319,1131,22,308,1113,22,14.5,<=30,ENG,Away,Upto 2014
MG Burgess,NZ,Spin,1969-08-07,Nottingham,England,1969,1,40,84,0,1,236,642,5,196,558,5,47.2,>30,ENG,Away,Upto 2014
MG Burgess,NZ,Spin,1969-09-25,Brabourne,India,1969,1,30,120,1,1,396,1358,19,366,1238,18,20.842105263157894,<=30,IND,Away,Upto 2014
MG Burgess,NZ,Spin,1969-10-03,Nagpur,India,1969,2,41,84,4,1,677,1910,37,636,1826,33,18.2972972972973,<=30,IND,Away,Upto 2014
MG Burgess,NZ,Spin,1969-10-15,Hyderabad (Deccan),India,1969,2,9,42,0,1,301,978,13,292,936,13,23.153846153846153,<=30,IND,Away,Upto 2014
MG Burgess,NZ,Spin,1969-10-24,Karachi,Pakistan,1969,1,14,36,0,1,665,1813,26,651,1777,26,25.576923076923077,<=30,PAK,Away,Upto 2014
MG Burgess,NZ,Spin,1969-10-30,Lahore,Pakistan,1969,1,11,6,0,1,434,1339,23,423,1333,23,18.869565217391305,<=30,PAK,Away,Upto 2014
MG Burgess,NZ,Spin,1972-02-16,Kingston,West Indies,1972,1,15,12,0,1,653,1794,11,638,1782,11,59.36363636363637,>30,WI,Away,Upto 2014
MG Burgess,NZ,Spin,1972-04-06,Georgetown,West Indies,1972,1,12,30,0,1,489,1488,3,477,1458,3,163.0,>30,WI,Away,Upto 2014
MG Burgess,NZ,Spin,1976-02-05,Christchurch,New Zealand,1976,1,2,16,0,1,255,744,3,253,728,3,85.0,>30,NZ,Home,Upto 2014
MG Burgess,NZ,Spin,1976-10-09,Lahore,Pakistan,1976,1,20,32,1,1,495,1028,17,475,996,16,29.11764705882353,<=30,PAK,Away,Upto 2014
MG Burmester,ZIM,Pace,1992-10-18,Harare,Zimbabwe,1992,1,78,238,3,1,480,1630,15,402,1392,12,32.0,>30,ZIM,Home,Upto 2014
MG Burmester,ZIM,Pace,1992-11-01,Bulawayo,Zimbabwe,1992,1,71,84,0,1,481,878,7,410,794,7,68.71428571428571,>30,ZIM,Home,Upto 2014
MG Burmester,ZIM,Pace,1992-11-07,Harare,Zimbabwe,1992,2,78,114,0,1,623,1378,20,545,1264,20,31.15,>30,ZIM,Home,Upto 2014
MG Grell,WI,Pace,1930-02-01,Port of Spain,West Indies,1930,2,17,30,0,1,688,1491,29,671,1461,29,23.724137931034484,<=30,WI,Home,Upto 2014
MG Hughes,AUS,Pace,1985-12-13,Adelaide,Australia,1985,1,123,228,1,1,620,1368,17,497,1140,16,36.470588235294116,>30,AUS,Home,Upto 2014
MG Hughes,AUS,Pace,1986-11-14,Brisbane,Australia,1986,2,162,249,5,1,755,1483,27,593,1234,22,27.962962962962962,<=30,AUS,Home,Upto 2014
MG Hughes,AUS,Pace,1986-12-12,Adelaide,Australia,1986,2,98,222,2,1,567,1198,11,469,976,9,51.54545454545455,>30,AUS,Home,Upto 2014
MG Hughes,AUS,Pace,1986-12-26,Melbourne,Australia,1986,1,94,180,1,1,497,1065,22,403,885,21,22.59090909090909,<=30,AUS,Home,Upto 2014
MG Hughes,AUS,Pace,1987-01-10,Sydney,Australia,1987,2,90,168,2,1,483,1157,14,393,989,12,34.5,>30,AUS,Home,Upto 2014
MG Hughes,AUS,Pace,1987-12-04,Brisbane,Australia,1987,2,97,210,5,1,634,1568,27,537,1358,22,23.48148148148148,<=30,AUS,Home,Upto 2014
MG Hughes,AUS,Pace,1988-02-12,W.A.C.A,Australia,1988,2,128,234,5,1,710,1536,29,582,1302,24,24.482758620689655,<=30,AUS,Home,Upto 2014
MG Hughes,AUS,Pace,1988-12-02,W.A.C.A,Australia,1988,2,217,439,13,1,1183,2020,32,966,1581,19,36.96875,>30,AUS,Home,Upto 2014
MG Hughes,AUS,Pace,1988-12-24,Melbourne,Australia,1988,2,123,228,0,1,897,2063,38,774,1835,38,23.605263157894736,<=30,AUS,Home,Upto 2014
MG Hughes,AUS,Pace,1989-01-26,Sydney,Australia,1989,2,57,168,1,1,305,911,11,248,743,10,27.727272727272727,<=30,AUS,Home,Upto 2014
MG Hughes,AUS,Pace,1989-02-03,Adelaide,Australia,1989,2,106,144,0,1,834,1481,18,728,1337,18,46.333333333333336,>30,AUS,Home,Upto 2014
MG Hughes,AUS,Pace,1989-06-08,Leeds,England,1989,2,128,224,4,1,1372,2385,30,1244,2161,26,45.733333333333334,>30,ENG,Away,Upto 2014
MG Hughes,AUS,Pace,1989-06-22,Lord's,England,1989,2,115,282,6,1,1092,2047,30,977,1765,24,36.4,>30,ENG,Away,Upto 2014
MG Hughes,AUS,Pace,1989-07-06,Birmingham,England,1989,1,68,132,2,1,670,1413,17,602,1281,15,39.411764705882355,>30,ENG,Away,Upto 2014
MG Hughes,AUS,Pace,1989-07-27,Manchester,England,1989,2,100,190,2,1,673,1605,23,573,1415,21,29.26086956521739,<=30,ENG,Away,Upto 2014
MG Hughes,AUS,Pace,1989-08-10,Nottingham,England,1989,2,86,122,4,1,695,1373,18,609,1251,14,38.611111111111114,>30,ENG,Away,Upto 2014
MG Hughes,AUS,Pace,1989-08-24,The Oval,England,1989,2,118,186,1,1,921,1691,26,803,1505,25,35.42307692307692,>30,ENG,Away,Upto 2014
MG Hughes,AUS,Pace,1989-11-24,W.A.C.A,Australia,1989,2,143,336,7,1,939,2255,25,796,1919,18,37.56,>30,AUS,Home,Upto 2014
MG Hughes,AUS,Pace,1989-12-08,Brisbane,Australia,1989,1,123,234,3,1,901,1884,23,778,1650,20,39.17391304347826,>30,AUS,Home,Upto 2014
MG Hughes,AUS,Pace,1989-12-16,Hobart,Australia,1989,2,156,320,8,1,998,1920,27,842,1600,19,36.96296296296296,>30,AUS,Home,Upto 2014
MG Hughes,AUS,Pace,1990-01-12,Melbourne,Australia,1990,2,113,354,6,1,791,2097,34,678,1743,28,23.264705882352942,<=30,AUS,Home,Upto 2014
MG Hughes,AUS,Pace,1990-01-19,Adelaide,Australia,1990,2,174,300,7,1,759,1677,27,585,1377,20,28.11111111111111,<=30,AUS,Home,Upto 2014
MG Hughes,AUS,Pace,1990-02-03,Sydney,Australia,1990,1,70,186,3,1,253,749,11,183,563,8,23.0,<=30,AUS,Home,Upto 2014
MG Hughes,AUS,Pace,1990-11-23,Brisbane,Australia,1990,2,56,187,5,1,544,1327,29,488,1140,24,18.75862068965517,<=30,AUS,Home,Upto 2014
MG Hughes,AUS,Pace,1990-12-26,Melbourne,Australia,1990,2,109,228,2,1,741,1809,29,632,1581,27,25.551724137931036,<=30,AUS,Home,Upto 2014
MG Hughes,AUS,Pace,1991-01-25,Adelaide,Australia,1991,2,114,216,2,1,1030,2159,28,916,1943,26,36.785714285714285,>30,AUS,Home,Upto 2014
MG Hughes,AUS,Pace,1991-02-01,W.A.C.A,Australia,1991,2,86,222,6,1,771,1442,29,685,1220,23,26.586206896551722,<=30,AUS,Home,Upto 2014
MG Hughes,AUS,Pace,1991-03-01,Kingston,West Indies,1991,2,146,261,4,1,694,1365,21,548,1104,17,33.04761904761905,>30,WI,Away,Upto 2014
MG Hughes,AUS,Pace,1991-03-23,Georgetown,West Indies,1991,2,112,143,0,1,808,1623,19,696,1480,19,42.526315789473685,>30,WI,Away,Upto 2014
MG Hughes,AUS,Pace,1991-04-05,Port of Spain,West Indies,1991,1,48,102,4,1,449,1209,20,401,1107,16,22.45,<=30,WI,Away,Upto 2014
MG Hughes,AUS,Pace,1991-04-19,Bridgetown,West Indies,1991,2,169,313,5,1,874,1849,33,705,1536,28,26.484848484848484,<=30,WI,Away,Upto 2014
MG Hughes,AUS,Pace,1991-04-27,St John's,West Indies,1991,2,114,216,6,1,735,1397,30,621,1181,24,24.5,<=30,WI,Away,Upto 2014
MG Hughes,AUS,Pace,1991-11-29,Brisbane,Australia,1991,2,84,216,7,1,581,1459,29,497,1243,22,20.03448275862069,<=30,AUS,Home,Upto 2014
MG Hughes,AUS,Pace,1991-12-26,Melbourne,Australia,1991,2,95,252,2,1,732,1688,29,637,1436,27,25.24137931034483,<=30,AUS,Home,Upto 2014
MG Hughes,AUS,Pace,1992-01-02,Sydney,Australia,1992,1,104,250,3,1,641,1594,19,537,1344,16,33.73684210526316,>30,AUS,Home,Upto 2014
MG Hughes,AUS,Pace,1992-01-25,Adelaide,Australia,1992,2,121,246,6,1,796,1827,30,675,1581,24,26.533333333333335,<=30,AUS,Home,Upto 2014
MG Hughes,AUS,Pace,1992-02-01,W.A.C.A,Australia,1992,2,107,233,4,1,946,1994,34,839,1761,30,27.823529411764707,<=30,AUS,Home,Upto 2014
MG Hughes,AUS,Pace,1992-11-27,Brisbane,Australia,1992,2,86,189,3,1,859,1899,30,773,1710,27,28.633333333333333,<=30,AUS,Home,Upto 2014
MG Hughes,AUS,Pace,1992-12-26,Melbourne,Australia,1992,2,92,222,4,1,743,1849,31,651,1627,27,23.967741935483872,<=30,AUS,Home,Upto 2014
MG Hughes,AUS,Pace,1993-01-02,Sydney,Australia,1993,1,76,100,3,1,568,1162,8,492,1062,5,71.0,>30,AUS,Home,Upto 2014
MG Hughes,AUS,Pace,1993-01-23,Adelaide,Australia,1993,2,107,207,6,1,644,1295,29,537,1088,23,22.20689655172414,<=30,AUS,Home,Upto 2014
MG Hughes,AUS,Pace,1993-01-30,W.A.C.A,Australia,1993,1,71,154,4,1,518,1062,27,447,908,23,19.185185185185187,<=30,AUS,Home,Upto 2014
MG Hughes,AUS,Pace,1993-02-25,Christchurch,New Zealand,1993,2,106,275,6,1,651,1526,21,545,1251,15,31.0,>30,NZ,Away,Upto 2014
MG Hughes,AUS,Pace,1993-03-04,Wellington,New Zealand,1993,2,122,276,3,1,647,1552,21,525,1276,18,30.80952380952381,>30,NZ,Away,Upto 2014
MG Hughes,AUS,Pace,1993-03-12,Auckland,New Zealand,1993,2,121,243,4,1,620,1465,22,499,1222,18,28.181818181818183,<=30,NZ,Away,Upto 2014
MG Hughes,AUS,Pace,1993-06-03,Manchester,England,1993,2,151,289,8,1,704,1351,14,553,1062,6,50.285714285714285,>30,ENG,Away,Upto 2014
MG Hughes,AUS,Pace,1993-06-17,Lord's,England,1993,2,127,306,4,1,536,1020,6,409,714,2,89.33333333333333,>30,ENG,Away,Upto 2014
MG Hughes,AUS,Pace,1993-07-01,Nottingham,England,1993,2,133,318,7,1,786,1563,21,653,1245,14,37.42857142857143,>30,ENG,Away,Upto 2014
MG Hughes,AUS,Pace,1993-07-22,Leeds,England,1993,2,126,275,6,1,901,1757,18,775,1482,12,50.05555555555556,>30,ENG,Away,Upto 2014
MG Hughes,AUS,Pace,1993-08-05,Birmingham,England,1993,2,77,222,0,1,389,833,10,312,611,10,38.9,>30,ENG,Away,Upto 2014
MG Hughes,AUS,Pace,1993-08-19,The Oval,England,1993,2,231,368,6,1,872,1626,33,641,1258,27,26.424242424242426,<=30,ENG,Away,Upto 2014
MG Hughes,AUS,Pace,1994-03-04,Johannesburg,South Africa,1994,2,145,270,4,1,852,1646,28,707,1376,24,30.428571428571427,>30,SA,Away,Upto 2014
MG Hughes,AUS,Pace,1994-03-17,Cape Town,South Africa,1994,2,92,150,0,1,830,1910,22,738,1760,22,37.72727272727273,>30,SA,Away,Upto 2014
MG Johnson,AUS,Pace,2007-11-08,Brisbane,Australia,2007,2,96,222,4,1,668,1297,18,572,1075,14,37.111111111111114,>30,AUS,Home,Upto 2014
MG Johnson,AUS,Pace,2007-11-16,Hobart,Australia,2007,2,145,270,4,1,932,1457,19,787,1187,15,49.05263157894737,>30,AUS,Home,Upto 2014
MG Johnson,AUS,Pace,2007-12-26,Melbourne,Australia,2007,2,46,168,3,1,517,1047,21,471,879,18,24.61904761904762,<=30,AUS,Home,Upto 2014
MG Johnson,AUS,Pace,2008-01-02,Sydney,Australia,2008,2,181,288,2,1,803,1292,17,622,1004,15,47.23529411764706,>30,AUS,Home,Upto 2014
MG Johnson,AUS,Pace,2008-01-16,W.A.C.A,Australia,2008,2,144,230,5,1,844,1397,31,700,1167,26,27.225806451612904,<=30,AUS,Home,Upto 2014
MG Johnson,AUS,Pace,2008-01-24,Adelaide,Australia,2008,2,159,323,6,1,710,1457,17,551,1134,11,41.76470588235294,>30,AUS,Home,Upto 2014
MG Johnson,AUS,Pace,2008-05-22,Kingston,West Indies,2008,2,92,222,2,1,802,1720,34,710,1498,32,23.58823529411765,<=30,WI,Away,Upto 2014
MG Johnson,AUS,Pace,2008-05-30,North Sound,West Indies,2008,2,142,264,3,1,984,1871,24,842,1607,21,41.0,>30,WI,Away,Upto 2014
MG Johnson,AUS,Pace,2008-06-12,Bridgetown,West Indies,2008,2,113,143,5,1,809,1396,25,696,1253,20,32.36,>30,WI,Away,Upto 2014
MG Johnson,AUS,Pace,2008-10-09,Bengaluru,India,2008,2,93,210,5,1,560,1289,24,467,1079,19,23.333333333333332,<=30,IND,Away,Upto 2014
MG Johnson,AUS,Pace,2008-10-17,Mohali,India,2008,2,157,246,3,1,846,1398,17,689,1152,14,49.76470588235294,>30,IND,Away,Upto 2014
MG Johnson,AUS,Pace,2008-10-29,Delhi,India,2008,2,165,264,4,1,697,1278,10,532,1014,6,69.7,>30,IND,Away,Upto 2014
MG Johnson,AUS,Pace,2008-11-06,Nagpur,India,2008,2,106,276,1,1,502,1096,12,396,820,11,41.833333333333336,>30,IND,Away,Upto 2014
MG Johnson,AUS,Pace,2008-11-20,Brisbane,Australia,2008,2,69,153,9,1,700,1373,36,631,1220,27,19.444444444444443,<=30,AUS,Home,Upto 2014
MG Johnson,AUS,Pace,2008-11-28,Adelaide,Australia,2008,2,85,241,5,1,688,1276,20,603,1035,15,34.4,>30,AUS,Home,Upto 2014
MG Johnson,AUS,Pace,2008-12-17,W.A.C.A,Australia,2008,2,159,350,11,1,940,1782,28,781,1432,17,33.57142857142857,>30,AUS,Home,Upto 2014
MG Johnson,AUS,Pace,2008-12-26,Melbourne,Australia,2008,2,163,300,2,1,952,1716,26,789,1416,24,36.61538461538461,>30,AUS,Home,Upto 2014
MG Johnson,AUS,Pace,2009-01-03,Sydney,Australia,2009,2,118,308,4,1,952,2011,26,834,1703,22,36.61538461538461,>30,AUS,Home,Upto 2014
MG Johnson,AUS,Pace,2009-02-26,Johannesburg,South Africa,2009,2,137,315,8,1,938,1937,36,801,1622,28,26.055555555555557,<=30,SA,Away,Upto 2014
MG Johnson,AUS,Pace,2009-03-06,Durban,South Africa,2009,2,115,294,4,1,857,1739,26,742,1445,22,32.96153846153846,>30,SA,Away,Upto 2014
MG Johnson,AUS,Pace,2009-03-19,Cape Town,South Africa,2009,1,148,225,4,1,890,1587,18,742,1362,14,49.44444444444444,>30,SA,Away,Upto 2014
MG Johnson,AUS,Pace,2009-07-08,Cardiff,England,2009,2,131,264,5,1,832,1434,18,701,1170,13,46.22222222222222,>30,ENG,Away,Upto 2014
MG Johnson,AUS,Pace,2009-07-16,Lord's,England,2009,2,200,232,3,1,1009,1590,27,809,1358,24,37.370370370370374,>30,ENG,Away,Upto 2014
MG Johnson,AUS,Pace,2009-07-30,Birmingham,England,2009,1,92,126,2,1,806,1353,22,714,1227,20,36.63636363636363,>30,ENG,Away,Upto 2014
MG Johnson,AUS,Pace,2009-08-07,Leeds,England,2009,2,99,159,6,1,700,1101,30,601,942,24,23.333333333333332,<=30,ENG,Away,Upto 2014
MG Johnson,AUS,Pace,2009-08-20,The Oval,England,2009,2,129,192,4,1,842,1408,23,713,1216,19,36.608695652173914,>30,ENG,Away,Upto 2014
MG Johnson,AUS,Pace,2009-11-26,Brisbane,Australia,2009,2,110,169,4,1,697,1123,21,587,954,17,33.19047619047619,>30,AUS,Home,Upto 2014
MG Johnson,AUS,Pace,2009-12-04,Adelaide,Australia,2009,2,208,289,8,1,930,1567,26,722,1278,18,35.76923076923077,>30,AUS,Home,Upto 2014
MG Johnson,AUS,Pace,2009-12-16,W.A.C.A,Australia,2009,2,159,204,5,1,927,1486,27,768,1282,22,34.333333333333336,>30,AUS,Home,Upto 2014
MG Johnson,AUS,Pace,2009-12-26,Melbourne,Australia,2009,2,82,240,6,1,736,1512,23,654,1272,17,32.0,>30,AUS,Home,Upto 2014
MG Johnson,AUS,Pace,2010-01-03,Sydney,Australia,2010,2,91,180,5,1,640,1344,29,549,1164,24,22.06896551724138,<=30,AUS,Home,Upto 2014
MG Johnson,AUS,Pace,2010-01-14,Hobart,Australia,2010,2,135,246,1,1,758,1508,15,623,1262,14,50.53333333333333,>30,AUS,Home,Upto 2014
MG Johnson,AUS,Pace,2010-03-19,Wellington,New Zealand,2010,2,145,246,2,1,767,1410,18,622,1164,16,42.611111111111114,>30,NZ,Away,Upto 2014
MG Johnson,AUS,Pace,2010-03-27,Hamilton,New Zealand,2010,2,132,217,10,1,795,1294,27,663,1077,17,29.444444444444443,<=30,NZ,Away,Upto 2014
MG Johnson,AUS,Pace,2010-07-13,Lord's,England,2010,2,105,168,1,1,698,1252,26,593,1084,25,26.846153846153847,<=30,ENG,Away,Upto 2014
MG Johnson,AUS,Pace,2010-07-21,Leeds,England,2010,2,112,154,2,1,714,1273,33,602,1119,31,21.636363636363637,<=30,ENG,Away,Upto 2014
MG Johnson,AUS,Pace,2010-10-01,Mohali,India,2010,2,114,220,5,1,619,1051,25,505,831,20,24.76,<=30,IND,Away,Upto 2014
MG Johnson,AUS,Pace,2010-10-09,Bengaluru,India,2010,2,147,252,3,1,635,1166,15,488,914,12,42.333333333333336,>30,IND,Away,Upto 2014
MG Johnson,AUS,Pace,2010-11-25,Brisbane,Australia,2010,2,170,252,0,1,947,1750,17,777,1498,17,55.705882352941174,>30,AUS,Home,Upto 2014
MG Johnson,AUS,Pace,2010-12-16,W.A.C.A,Australia,2010,2,82,177,9,1,755,1419,38,673,1242,29,19.86842105263158,<=30,AUS,Home,Upto 2014
MG Johnson,AUS,Pace,2010-12-26,Melbourne,Australia,2010,1,134,174,2,1,704,1424,26,570,1250,24,27.076923076923077,<=30,AUS,Home,Upto 2014
MG Johnson,AUS,Pace,2011-01-03,Sydney,Australia,2011,1,168,216,4,1,873,1642,26,705,1426,22,33.57692307692308,>30,AUS,Home,Upto 2014
MG Johnson,AUS,Pace,2011-08-31,Galle,Sri Lanka,2011,2,82,168,2,1,381,906,20,299,738,18,19.05,<=30,SL,Away,Upto 2014
MG Johnson,AUS,Pace,2011-09-08,Pallekele,Sri Lanka,2011,2,109,232,2,1,526,1180,17,417,948,15,30.941176470588236,>30,SL,Away,Upto 2014
MG Johnson,AUS,Pace,2011-09-16,Colombo (SSC),Sri Lanka,2011,1,122,210,2,1,825,1634,20,703,1424,18,41.25,>30,SL,Away,Upto 2014
MG Johnson,AUS,Pace,2011-11-09,Cape Town,South Africa,2011,2,87,96,1,1,597,929,31,510,833,30,19.258064516129032,<=30,SA,Away,Upto 2014
MG Johnson,AUS,Pace,2011-11-17,Johannesburg,South Africa,2011,2,168,277,2,1,938,1680,27,770,1403,25,34.74074074074074,>30,SA,Away,Upto 2014
MG Johnson,AUS,Pace,2012-11-30,W.A.C.A,Australia,2012,2,164,252,6,1,885,1522,30,721,1270,24,29.5,<=30,AUS,Home,Upto 2014
MG Johnson,AUS,Pace,2012-12-26,Melbourne,Australia,2012,2,79,132,6,1,518,864,21,439,732,15,24.666666666666668,<=30,AUS,Home,Upto 2014
MG Johnson,AUS,Pace,2013-01-03,Sydney,Australia,2013,2,92,168,3,1,729,1200,20,637,1032,17,36.45,>30,AUS,Home,Upto 2014
MG Johnson,AUS,Pace,2013-03-22,Delhi,India,2013,2,60,114,0,1,259,450,5,199,336,5,51.8,>30,IND,Away,Upto 2014
MG Johnson,AUS,Pace,2013-11-21,Brisbane,Australia,2013,2,103,229,9,1,625,1326,30,522,1097,21,20.833333333333332,<=30,AUS,Home,Upto 2014
MG Johnson,AUS,Pace,2013-12-05,Adelaide,Australia,2013,2,113,248,8,1,606,1290,25,493,1042,17,24.24,<=30,AUS,Home,Upto 2014
MG Johnson,AUS,Pace,2013-12-13,W.A.C.A,Australia,2013,2,140,284,6,1,995,1739,27,855,1455,21,36.851851851851855,>30,AUS,Home,Upto 2014
MG Johnson,AUS,Pace,2013-12-26,Melbourne,Australia,2013,2,88,234,8,1,653,1410,24,565,1176,16,27.208333333333332,<=30,AUS,Home,Upto 2014
MG Johnson,AUS,Pace,2014-01-03,Sydney,Australia,2014,2,73,137,6,1,663,1122,33,590,985,27,20.09090909090909,<=30,AUS,Home,After 1965
MG Johnson,AUS,Pace,2014-02-12,Centurion,South Africa,2014,2,127,199,12,1,767,1417,27,640,1218,15,28.40740740740741,<=30,SA,Away,After 1965
MG Johnson,AUS,Pace,2014-02-20,Gqeberha,South Africa,2014,2,121,240,3,1,800,1419,22,679,1179,19,36.36363636363637,>30,SA,Away,After 1965
MG Johnson,AUS,Pace,2014-03-01,Cape Town,South Africa,2014,2,134,318,7,1,924,1728,25,790,1410,18,36.96,>30,SA,Away,After 1965
MG Johnson,AUS,Pace,2014-10-22,Dubai (DICS),UAE,2014,2,73,258,3,1,384,954,8,311,696,5,48.0,>30,UAE,Away,After 1965
MG Johnson,AUS,Pace,2014-10-30,Abu Dhabi,UAE,2014,2,104,192,3,1,549,1024,11,445,832,8,49.90909090909091,>30,UAE,Away,After 1965
MG Johnson,AUS,Pace,2014-12-09,Adelaide,Australia,2014,2,146,228,4,1,885,1420,15,739,1192,11,59.0,>30,AUS,Home,After 1965
MG Johnson,AUS,Pace,2014-12-17,Brisbane,Australia,2014,2,142,231,4,1,959,1402,28,817,1171,24,34.25,>30,AUS,Home,After 1965
MG Johnson,AUS,Pace,2014-12-26,Melbourne,Australia,2014,2,173,275,5,1,1069,1880,27,896,1605,22,39.592592592592595,>30,AUS,Home,After 1965
MG Johnson,AUS,Pace,2015-06-03,Roseau,West Indies,2015,2,72,173,5,1,402,941,20,330,768,15,20.1,<=30,WI,Away,After 1965
MG Johnson,AUS,Pace,2015-06-11,Kingston,West Indies,2015,2,77,132,3,1,528,1091,25,451,959,22,21.12,<=30,WI,Away,After 1965
MG Johnson,AUS,Pace,2015-07-08,Cardiff,England,2015,2,180,246,2,1,901,1488,27,721,1242,25,33.370370370370374,>30,ENG,Away,After 1965
MG Johnson,AUS,Pace,2015-07-16,Lord's,England,2015,2,80,181,6,1,791,1369,21,711,1188,15,37.666666666666664,>30,ENG,Away,After 1965
MG Johnson,AUS,Pace,2015-07-29,Birmingham,England,2015,2,76,138,2,1,619,1035,28,543,897,26,22.107142857142858,<=30,ENG,Away,After 1965
MG Johnson,AUS,Pace,2015-08-06,Nottingham,England,2015,1,102,128,1,1,542,945,29,440,817,28,18.689655172413794,<=30,ENG,Away,After 1965
MG Johnson,AUS,Pace,2015-08-20,The Oval,England,2015,2,86,148,4,1,638,1293,22,552,1145,18,29.0,<=30,ENG,Away,After 1965
MG Johnson,AUS,Pace,2015-11-05,Brisbane,Australia,2015,2,163,240,4,1,1023,1505,20,860,1265,16,51.15,>30,AUS,Home,After 1965
MG Johnson,AUS,Pace,2015-11-13,W.A.C.A,Australia,2015,2,177,204,3,1,1234,1914,22,1057,1710,19,56.09090909090909,>30,AUS,Home,After 1965
MG Melle,SA,Pace,1950-02-10,Johannesburg,South Africa,1950,2,171,360,6,1,524,1232,15,353,872,9,34.93333333333333,>30,SA,Home,Upto 2014
MG Melle,SA,Pace,1950-03-03,Gqeberha,South Africa,1950,1,132,184,2,1,363,833,11,231,649,9,33.0,>30,SA,Home,Upto 2014
MG Melle,SA,Pace,1951-08-16,The Oval,England,1951,2,17,78,4,1,309,956,16,292,878,12,19.3125,<=30,ENG,Away,Upto 2014
MG Melle,SA,Pace,1952-12-05,Brisbane,Australia,1952,2,166,373,9,1,408,1189,22,242,816,13,18.545454545454547,<=30,AUS,Away,Upto 2014
MG Melle,SA,Pace,1952-12-24,Melbourne,Australia,1952,2,112,200,2,1,390,1037,14,278,837,12,27.857142857142858,<=30,AUS,Away,Upto 2014
MG Melle,SA,Pace,1953-01-09,Sydney,Australia,1953,1,98,184,1,1,307,834,15,209,650,14,20.466666666666665,<=30,AUS,Away,Upto 2014
MG Melle,SA,Pace,1953-01-24,Adelaide,Australia,1953,2,155,288,2,1,427,785,5,272,497,3,85.4,>30,AUS,Away,Upto 2014
MG Neser,AUS,Pace,2021-12-16,Adelaide,Australia,2021,2,61,144,2,1,845,1824,27,784,1680,25,31.296296296296298,>30,AUS,Home,After 1965
MG Neser,AUS,Pace,2022-12-08,Adelaide,Australia,2022,2,56,137,5,1,712,1214,23,656,1077,18,30.956521739130434,>30,AUS,Home,After 1965
MG Waite,AUS,Spin,1938-07-22,Leeds,England,1938,2,40,120,0,1,387,966,24,347,846,24,16.125,<=30,ENG,Away,Upto 2014
MG Waite,AUS,Spin,1938-08-20,The Oval,England,1938,1,150,432,1,1,776,1827,9,626,1395,8,86.22222222222223,>30,ENG,Away,Upto 2014
MG Webb,NZ,Pace,1971-03-05,Auckland,New Zealand,1971,2,144,232,2,1,561,1413,20,417,1181,18,28.05,<=30,NZ,Home,Upto 2014
MG Webb,NZ,Pace,1972-02-16,Kingston,West Indies,1972,2,120,180,0,1,643,1221,11,523,1041,11,58.45454545454545,>30,WI,Away,Upto 2014
MG Webb,NZ,Pace,1974-03-01,Wellington,New Zealand,1974,2,207,320,2,1,960,1997,18,753,1677,16,53.333333333333336,>30,NZ,Home,Upto 2014
MH Dekker,ZIM,Spin,1994-10-20,Bulawayo,Zimbabwe,1994,1,5,36,0,1,318,948,5,313,912,5,63.6,>30,ZIM,Home,Upto 2014
MH Dekker,ZIM,Spin,1995-01-31,Harare,Zimbabwe,1995,1,10,24,0,1,301,564,1,291,540,1,301.0,>30,ZIM,Home,Upto 2014
MH Mankad,IND,Spin,1946-06-22,Lord's,England,1946,2,118,317,2,1,376,791,8,258,474,6,47.0,>30,ENG,Away,Upto 2014
MH Mankad,IND,Spin,1946-07-20,Manchester,England,1946,2,146,402,7,1,221,522,7,75,120,0,31.571428571428573,>30,ENG,Away,Upto 2014
MH Mankad,IND,Spin,1946-08-17,The Oval,England,1946,1,28,120,2,1,184,504,4,156,384,2,46.0,>30,ENG,Away,Upto 2014
MH Mankad,IND,Spin,1947-11-28,Brisbane,Australia,1947,1,113,272,3,1,180,496,7,67,224,4,25.714285714285715,<=30,AUS,Away,Upto 2014
MH Mankad,IND,Spin,1947-12-12,Sydney,Australia,1947,1,31,72,1,1,208,752,16,177,680,15,13.0,<=30,AUS,Away,Upto 2014
MH Mankad,IND,Spin,1948-01-01,Melbourne,Australia,1948,2,209,440,4,1,660,1199,23,451,759,19,28.695652173913043,<=30,AUS,Away,Upto 2014
MH Mankad,IND,Spin,1948-01-23,Adelaide,Australia,1948,1,170,344,2,1,689,1465,10,519,1121,8,68.9,>30,AUS,Away,Upto 2014
MH Mankad,IND,Spin,1948-02-06,Melbourne,Australia,1948,1,107,264,2,1,478,1056,12,371,792,10,39.833333333333336,>30,AUS,Away,Upto 2014
MH Mankad,IND,Spin,1948-11-10,Delhi,India,1948,1,176,354,2,1,804,1710,13,628,1356,11,61.84615384615385,>30,IND,Home,Upto 2014
MH Mankad,IND,Spin,1948-12-09,Brabourne,India,1948,1,202,450,3,1,780,1868,11,578,1418,8,70.9090909090909,>30,IND,Home,Upto 2014
MH Mankad,IND,Spin,1948-12-31,Eden Gardens,India,1948,2,142,285,5,1,677,1523,19,535,1238,14,35.63157894736842,>30,IND,Home,Upto 2014
MH Mankad,IND,Spin,1949-01-27,Chennai,India,1949,1,93,198,1,1,495,939,11,402,741,10,45.0,>30,IND,Home,Upto 2014
MH Mankad,IND,Spin,1949-02-04,Brabourne,India,1949,2,131,348,6,1,580,1268,18,449,920,12,32.22222222222222,>30,IND,Home,Upto 2014
MH Mankad,IND,Spin,1951-11-02,Delhi,India,1951,2,111,654,7,1,589,1935,18,478,1281,11,32.72222222222222,>30,IND,Home,Upto 2014
MH Mankad,IND,Spin,1951-12-14,Brabourne,India,1951,2,101,372,4,1,561,1297,11,460,925,7,51.0,>30,IND,Home,Upto 2014
MH Mankad,IND,Spin,1951-12-30,Eden Gardens,India,1951,2,153,527,6,1,698,1841,19,545,1314,13,36.73684210526316,>30,IND,Home,Upto 2014
MH Mankad,IND,Spin,1952-01-12,Kanpur,India,1952,2,98,254,5,1,484,1339,31,386,1085,26,15.612903225806452,<=30,IND,Home,Upto 2014
MH Mankad,IND,Spin,1952-02-06,Chennai,India,1952,2,108,418,12,1,648,1564,25,540,1146,13,25.92,<=30,IND,Home,Upto 2014
MH Mankad,IND,Spin,1952-06-19,Lord's,England,1952,2,231,582,5,1,669,1629,14,438,1047,9,47.785714285714285,>30,ENG,Away,Upto 2014
MH Mankad,IND,Spin,1952-07-17,Manchester,England,1952,1,67,168,2,1,285,693,12,218,525,10,23.75,<=30,ENG,Away,Upto 2014
MH Mankad,IND,Spin,1952-08-14,The Oval,England,1952,1,88,288,2,1,267,870,5,179,582,3,53.4,>30,ENG,Away,Upto 2014
MH Mankad,IND,Spin,1952-10-16,Delhi,India,1952,2,131,428,13,1,404,1143,24,273,715,11,16.833333333333332,<=30,IND,Home,Upto 2014
MH Mankad,IND,Spin,1952-11-13,Brabourne,India,1952,2,124,540,8,1,433,1202,15,309,662,7,28.866666666666667,<=30,IND,Home,Upto 2014
MH Mankad,IND,Spin,1952-11-28,Chennai,India,1952,1,113,210,2,1,261,594,8,148,384,6,32.625,>30,IND,Home,Upto 2014
MH Mankad,IND,Spin,1952-12-12,Eden Gardens,India,1952,2,146,414,2,1,455,1230,13,309,816,11,35.0,>30,IND,Home,Upto 2014
MH Mankad,IND,Spin,1953-01-21,Port of Spain,West Indies,1953,2,161,450,1,1,842,2177,19,681,1727,18,44.31578947368421,>30,WI,Away,Upto 2014
MH Mankad,IND,Spin,1953-02-07,Bridgetown,West Indies,1953,2,179,390,5,1,692,2028,31,513,1638,26,22.322580645161292,<=30,WI,Away,Upto 2014
MH Mankad,IND,Spin,1953-02-19,Port of Spain,West Indies,1953,1,47,198,0,1,777,2186,14,730,1988,14,55.5,>30,WI,Away,Upto 2014
MH Mankad,IND,Spin,1953-03-11,Georgetown,West Indies,1953,1,155,408,3,1,639,1831,18,484,1423,15,35.5,>30,WI,Away,Upto 2014
MH Mankad,IND,Spin,1953-03-28,Kingston,West Indies,1953,2,254,624,6,1,921,2154,20,667,1530,14,46.05,>30,WI,Away,Upto 2014
MH Mankad,IND,Spin,1955-01-01,Dhaka,Bangladesh,1955,2,58,182,1,1,438,1378,15,380,1196,14,29.2,<=30,BAN,Away,Upto 2014
MH Mankad,IND,Spin,1955-01-15,Bahawalpur,Pakistan,1955,1,89,240,0,1,306,1050,8,217,810,8,38.25,>30,PAK,Away,Upto 2014
MH Mankad,IND,Spin,1955-01-29,Lahore,Pakistan,1955,2,98,432,5,1,591,2024,18,493,1592,13,32.833333333333336,>30,PAK,Away,Upto 2014
MH Mankad,IND,Spin,1955-02-12,Peshawar,Pakistan,1955,2,135,690,6,1,400,1761,19,265,1071,13,21.05263157894737,<=30,PAK,Away,Upto 2014
MH Mankad,IND,Spin,1955-02-26,Karachi,Pakistan,1955,2,19,36,0,1,327,894,7,308,858,7,46.714285714285715,>30,PAK,Away,Upto 2014
MH Mankad,IND,Spin,1955-11-19,Hyderabad (Deccan),India,1955,2,123,366,2,1,665,1888,11,542,1522,9,60.45454545454545,>30,IND,Home,Upto 2014
MH Mankad,IND,Spin,1955-12-02,Brabourne,India,1955,2,86,205,4,1,470,1277,17,384,1072,13,27.647058823529413,<=30,IND,Home,Upto 2014
MH Mankad,IND,Spin,1955-12-28,Eden Gardens,India,1955,2,23,78,2,1,462,1292,19,439,1214,17,24.31578947368421,<=30,IND,Home,Upto 2014
MH Mankad,IND,Spin,1956-01-06,Chennai,India,1956,2,97,354,4,1,610,1887,20,513,1533,16,30.5,>30,IND,Home,Upto 2014
MH Mankad,IND,Spin,1956-10-19,Chennai,India,1956,1,90,270,4,1,458,1218,19,368,948,15,24.105263157894736,<=30,IND,Home,Upto 2014
MH Mankad,IND,Spin,1956-10-26,Brabourne,India,1956,1,118,276,1,1,685,1650,12,567,1374,11,57.083333333333336,>30,IND,Home,Upto 2014
MH Mankad,IND,Spin,1956-11-02,Eden Gardens,India,1956,2,105,208,6,1,552,1533,35,447,1325,29,15.771428571428572,<=30,IND,Home,Upto 2014
MH Mankad,IND,Spin,1959-01-21,Chennai,India,1959,1,95,228,4,1,586,1441,19,491,1213,15,30.842105263157894,>30,IND,Home,Upto 2014
MH Mankad,IND,Spin,1959-02-06,Delhi,India,1959,1,167,330,0,1,775,1794,11,608,1464,11,70.45454545454545,>30,IND,Home,Upto 2014
MH Richardson,NZ,Spin,2000-09-12,Bulawayo,Zimbabwe,2000,1,1,6,0,1,456,1365,20,455,1359,20,22.8,<=30,ZIM,Away,Upto 2014
MH Richardson,NZ,Spin,2001-03-15,Christchurch,New Zealand,2001,1,16,54,1,1,390,912,6,374,858,5,65.0,>30,NZ,Home,Upto 2014
MH Richardson,NZ,Spin,2004-06-10,Nottingham,England,2004,1,4,6,0,1,125,318,6,121,312,6,20.833333333333332,<=30,ENG,Away,Upto 2014
MHN Walker,AUS,Pace,1972-12-29,Melbourne,Australia,1972,2,151,304,5,1,925,1467,16,774,1163,11,57.8125,>30,AUS,Home,Upto 2014
MHN Walker,AUS,Pace,1973-01-06,Sydney,Australia,1973,2,80,256,7,1,767,1875,36,687,1619,29,21.305555555555557,<=30,AUS,Home,Upto 2014
MHN Walker,AUS,Pace,1973-02-16,Kingston,West Indies,1973,2,122,270,6,1,629,1295,15,507,1025,9,41.93333333333333,>30,WI,Away,Upto 2014
MHN Walker,AUS,Pace,1973-03-09,Bridgetown,West Indies,1973,2,98,334,5,1,508,1217,11,410,883,6,46.18181818181818,>30,WI,Away,Upto 2014
MHN Walker,AUS,Pace,1973-03-23,Port of Spain,West Indies,1973,2,98,330,4,1,317,912,10,219,582,6,31.7,>30,WI,Away,Upto 2014
MHN Walker,AUS,Pace,1973-04-06,Georgetown,West Indies,1973,2,122,369,5,1,667,1551,23,545,1182,18,29.0,<=30,WI,Away,Upto 2014
MHN Walker,AUS,Pace,1973-04-21,Port of Spain,West Indies,1973,2,99,324,6,1,343,870,9,244,546,3,38.111111111111114,>30,WI,Away,Upto 2014
MHN Walker,AUS,Pace,1974-01-05,Sydney,Australia,1974,1,71,176,2,1,618,1375,28,547,1199,26,22.071428571428573,<=30,AUS,Home,Upto 2014
MHN Walker,AUS,Pace,1974-03-01,Wellington,New Zealand,1974,1,107,328,3,1,960,1997,18,853,1669,15,53.333333333333336,>30,NZ,Away,Upto 2014
MHN Walker,AUS,Pace,1974-03-08,Christchurch,New Zealand,1974,2,110,382,6,1,814,2050,32,704,1668,26,25.4375,<=30,NZ,Away,Upto 2014
MHN Walker,AUS,Pace,1974-03-22,Auckland,New Zealand,1974,2,50,232,5,1,628,1262,29,578,1030,24,21.655172413793103,<=30,NZ,Away,Upto 2014
MHN Walker,AUS,Pace,1974-11-29,Brisbane,Australia,1974,2,105,269,4,1,649,1743,27,544,1474,23,24.037037037037038,<=30,AUS,Home,Upto 2014
MHN Walker,AUS,Pace,1974-12-13,W.A.C.A,Australia,1974,2,125,352,3,1,728,1672,24,603,1320,21,30.333333333333332,>30,AUS,Home,Upto 2014
MHN Walker,AUS,Pace,1974-12-26,Melbourne,Australia,1974,2,81,280,1,1,489,1257,19,408,977,18,25.736842105263158,<=30,AUS,Home,Upto 2014
MHN Walker,AUS,Pace,1975-01-04,Sydney,Australia,1975,2,123,312,4,1,724,1665,23,601,1353,19,31.47826086956522,>30,AUS,Home,Upto 2014
MHN Walker,AUS,Pace,1975-01-25,Adelaide,Australia,1975,2,107,200,3,1,469,911,17,362,711,14,27.58823529411765,<=30,AUS,Home,Upto 2014
MHN Walker,AUS,Pace,1975-02-08,Melbourne,Australia,1975,1,143,338,8,1,711,1562,25,568,1224,17,28.44,<=30,AUS,Home,Upto 2014
MHN Walker,AUS,Pace,1975-07-10,Birmingham,England,1975,2,95,249,7,1,502,1221,27,407,972,20,18.59259259259259,<=30,ENG,Away,Upto 2014
MHN Walker,AUS,Pace,1975-07-31,Lord's,England,1975,2,147,352,2,1,808,1552,18,661,1200,16,44.888888888888886,>30,ENG,Away,Upto 2014
MHN Walker,AUS,Pace,1975-08-14,Leeds,England,1975,2,90,198,1,1,612,1447,21,522,1249,20,29.142857142857142,<=30,ENG,Away,Upto 2014
MHN Walker,AUS,Pace,1975-08-28,The Oval,England,1975,2,154,426,4,1,686,1764,24,532,1338,20,28.583333333333332,<=30,ENG,Away,Upto 2014
MHN Walker,AUS,Pace,1975-12-12,W.A.C.A,Australia,1975,1,99,136,2,1,857,1286,28,758,1150,26,30.607142857142858,>30,AUS,Home,Upto 2014
MHN Walker,AUS,Pace,1975-12-26,Melbourne,Australia,1975,2,120,256,3,1,804,1499,27,684,1243,24,29.77777777777778,<=30,AUS,Home,Upto 2014
MHN Walker,AUS,Pace,1976-01-03,Sydney,Australia,1976,2,101,243,6,1,784,1539,30,683,1296,24,26.133333333333333,<=30,AUS,Home,Upto 2014
MHN Walker,AUS,Pace,1977-01-01,Melbourne,Australia,1977,2,127,248,1,1,882,1510,22,755,1262,21,40.09090909090909,>30,AUS,Home,Upto 2014
MHN Walker,AUS,Pace,1977-01-14,Sydney,Australia,1977,2,118,258,4,1,681,1364,30,563,1106,26,22.7,<=30,AUS,Home,Upto 2014
MHN Walker,AUS,Pace,1977-02-18,Christchurch,New Zealand,1977,2,131,408,7,1,990,2047,22,859,1639,15,45.0,>30,NZ,Away,Upto 2014
MHN Walker,AUS,Pace,1977-02-25,Auckland,New Zealand,1977,2,130,328,5,1,733,1600,29,603,1272,24,25.275862068965516,<=30,NZ,Away,Upto 2014
MHN Walker,AUS,Pace,1977-03-12,Melbourne,Australia,1977,2,137,296,5,1,769,1725,30,632,1429,25,25.633333333333333,<=30,AUS,Home,Upto 2014
MHN Walker,AUS,Pace,1977-06-16,Lord's,England,1977,2,122,390,5,1,753,1756,32,631,1366,27,23.53125,<=30,ENG,Away,Upto 2014
MHN Walker,AUS,Pace,1977-07-07,Manchester,England,1977,2,148,366,3,1,525,1242,14,377,876,11,37.5,>30,ENG,Away,Upto 2014
MHN Walker,AUS,Pace,1977-07-28,Nottingham,England,1977,2,119,380,5,1,788,1906,27,669,1526,22,29.185185185185187,<=30,ENG,Away,Upto 2014
MHN Walker,AUS,Pace,1977-08-11,Leeds,England,1977,1,97,288,0,1,569,1338,25,472,1050,25,22.76,<=30,ENG,Away,Upto 2014
MHN Walker,AUS,Pace,1977-08-25,The Oval,England,1977,2,65,216,1,1,507,1259,20,442,1043,19,25.35,<=30,ENG,Away,Upto 2014
MI Black,WI,Pace,2000-11-23,Brisbane,Australia,2000,1,83,168,4,1,456,1175,24,373,1007,20,19.0,<=30,AUS,Away,Upto 2014
MI Black,WI,Pace,2000-12-01,W.A.C.A,Australia,2000,1,87,108,2,1,637,1158,23,550,1050,21,27.695652173913043,<=30,AUS,Away,Upto 2014
MI Black,WI,Pace,2000-12-15,Adelaide,Australia,2000,2,87,126,0,1,620,1329,20,533,1203,20,31.0,>30,AUS,Away,Upto 2014
MI Black,WI,Pace,2001-07-27,Harare,Zimbabwe,2001,2,128,169,2,1,709,1347,18,581,1178,16,39.388888888888886,>30,ZIM,Away,Upto 2014
MI Black,WI,Pace,2001-11-29,Colombo (SSC),Sri Lanka,2001,1,123,192,1,1,728,1313,22,605,1121,21,33.09090909090909,>30,SL,Away,Upto 2014
MI Black,WI,Pace,2002-04-19,Port of Spain,West Indies,2002,2,89,191,3,1,849,1915,33,760,1724,30,25.727272727272727,<=30,WI,Home,Upto 2014
MJ Bennett,AUS,Spin,1984-12-22,Melbourne,Australia,1984,2,90,138,0,1,287,501,7,197,363,7,41.0,>30,AUS,Home,Upto 2014
MJ Bennett,AUS,Spin,1984-12-30,Sydney,Australia,1984,2,124,335,5,1,308,779,16,184,444,11,19.25,<=30,AUS,Home,Upto 2014
MJ Bennett,AUS,Spin,1985-08-29,The Oval,England,1985,1,111,192,1,1,236,426,4,125,234,3,59.0,>30,ENG,Away,Upto 2014
MJ Clarke,AUS,Spin,2004-10-06,Bengaluru,India,2004,1,4,6,0,1,685,1243,20,681,1237,20,34.25,>30,IND,Away,Upto 2014
MJ Clarke,AUS,Spin,2004-11-03,Wankhede,India,2004,1,9,38,6,1,365,706,29,356,668,23,12.586206896551724,<=30,IND,Away,Upto 2014
MJ Clarke,AUS,Spin,2004-12-26,Melbourne,Australia,2004,1,24,18,0,1,412,701,11,388,683,11,37.45454545454545,>30,AUS,Home,Upto 2014
MJ Clarke,AUS,Spin,2005-03-10,Christchurch,New Zealand,2005,1,16,30,1,1,328,677,14,312,647,13,23.428571428571427,<=30,NZ,Away,Upto 2014
MJ Clarke,AUS,Spin,2005-03-18,Wellington,New Zealand,2005,1,8,18,1,1,261,489,6,253,471,5,43.5,>30,NZ,Away,Upto 2014
MJ Clarke,AUS,Spin,2005-09-08,The Oval,England,2005,1,6,12,0,1,342,624,12,336,612,12,28.5,<=30,ENG,Away,Upto 2014
MJ Clarke,AUS,Spin,2005-11-03,Brisbane,Australia,2005,1,1,12,0,1,248,570,7,247,558,7,35.42857142857143,>30,AUS,Home,Upto 2014
MJ Clarke,AUS,Spin,2006-04-09,Fatullah,Bangladesh,2006,2,7,24,0,1,739,1451,25,732,1427,25,29.56,<=30,BAN,Away,Upto 2014
MJ Clarke,AUS,Spin,2006-12-01,Adelaide,Australia,2006,1,53,102,0,1,457,990,7,404,888,7,65.28571428571429,>30,AUS,Home,Upto 2014
MJ Clarke,AUS,Spin,2007-11-16,Hobart,Australia,2007,1,10,36,0,1,453,768,6,443,732,6,75.5,>30,AUS,Home,Upto 2014
MJ Clarke,AUS,Spin,2008-01-02,Sydney,Australia,2008,2,33,53,3,1,764,1280,20,731,1227,17,38.2,>30,AUS,Home,Upto 2014
MJ Clarke,AUS,Spin,2008-01-16,W.A.C.A,Australia,2008,2,52,114,0,1,288,498,9,236,384,9,32.0,>30,AUS,Home,Upto 2014
MJ Clarke,AUS,Spin,2008-01-24,Adelaide,Australia,2008,2,41,66,1,1,579,1086,9,538,1020,8,64.33333333333333,>30,AUS,Home,Upto 2014
MJ Clarke,AUS,Spin,2008-05-30,North Sound,West Indies,2008,2,36,126,2,1,298,516,3,262,390,1,99.33333333333333,>30,WI,Away,Upto 2014
MJ Clarke,AUS,Spin,2008-06-12,Bridgetown,West Indies,2008,2,41,114,2,1,440,864,10,399,750,8,44.0,>30,WI,Away,Upto 2014
MJ Clarke,AUS,Spin,2008-10-09,Bengaluru,India,2008,2,78,222,2,1,536,1200,6,458,978,4,89.33333333333333,>30,IND,Away,Upto 2014
MJ Clarke,AUS,Spin,2008-10-17,Mohali,India,2008,2,34,48,0,1,362,764,15,328,716,15,24.133333333333333,<=30,IND,Away,Upto 2014
MJ Clarke,AUS,Spin,2008-10-29,Delhi,India,2008,2,115,207,0,1,668,1278,12,553,1071,12,55.666666666666664,>30,IND,Away,Upto 2014
MJ Clarke,AUS,Spin,2008-11-06,Nagpur,India,2008,1,29,36,0,1,751,1259,24,722,1223,24,31.291666666666668,>30,IND,Away,Upto 2014
MJ Clarke,AUS,Spin,2008-11-20,Brisbane,Australia,2008,1,6,12,0,1,95,204,3,89,192,3,31.666666666666668,>30,AUS,Home,Upto 2014
MJ Clarke,AUS,Spin,2008-12-17,W.A.C.A,Australia,2008,1,35,48,0,1,404,648,6,369,600,6,67.33333333333333,>30,AUS,Home,Upto 2014
MJ Clarke,AUS,Spin,2008-12-26,Melbourne,Australia,2008,2,40,66,0,1,278,678,5,238,612,5,55.6,>30,AUS,Home,Upto 2014
MJ Clarke,AUS,Spin,2009-01-03,Sydney,Australia,2009,1,2,12,0,1,278,623,6,276,611,6,46.333333333333336,>30,AUS,Home,Upto 2014
MJ Clarke,AUS,Spin,2009-03-06,Durban,South Africa,2009,1,0,6,0,1,264,614,7,264,608,7,37.714285714285715,>30,SA,Away,Upto 2014
MJ Clarke,AUS,Spin,2009-07-08,Cardiff,England,2009,2,28,48,0,1,464,923,7,436,875,7,66.28571428571429,>30,ENG,Away,Upto 2014
MJ Clarke,AUS,Spin,2009-07-16,Lord's,England,2009,2,27,48,1,1,283,468,8,256,420,7,35.375,>30,ENG,Away,Upto 2014
MJ Clarke,AUS,Spin,2009-08-20,The Oval,England,2009,1,20,18,0,1,318,638,12,298,620,12,26.5,<=30,ENG,Away,Upto 2014
MJ Clarke,AUS,Spin,2010-03-27,Hamilton,New Zealand,2010,1,27,96,1,1,478,999,10,451,903,9,47.8,>30,NZ,Away,Upto 2014
MJ Clarke,AUS,Spin,2010-10-09,Bengaluru,India,2010,1,27,48,1,1,696,1271,17,669,1223,16,40.94117647058823,>30,IND,Away,Upto 2014
MJ Clarke,AUS,Spin,2010-12-26,Melbourne,Australia,2010,1,13,20,0,1,144,302,2,131,282,2,72.0,>30,AUS,Home,Upto 2014
MJ Clarke,AUS,Spin,2011-08-31,Galle,Sri Lanka,2011,1,16,36,0,1,441,845,19,425,809,19,23.210526315789473,<=30,SL,Away,Upto 2014
MJ Clarke,AUS,Spin,2011-09-08,Pallekele,Sri Lanka,2011,1,16,18,0,1,335,684,6,319,666,6,55.833333333333336,>30,SL,Away,Upto 2014
MJ Clarke,AUS,Spin,2011-11-17,Johannesburg,South Africa,2011,2,8,36,2,1,235,387,10,227,351,8,23.5,<=30,SA,Away,Upto 2014
MJ Clarke,AUS,Spin,2012-01-03,Sydney,Australia,2012,1,22,54,1,1,343,624,2,321,570,1,171.5,>30,AUS,Home,Upto 2014
MJ Clarke,AUS,Spin,2012-01-24,Adelaide,Australia,2012,2,32,48,0,1,465,838,10,433,790,10,46.5,>30,AUS,Home,Upto 2014
MJ Clarke,AUS,Spin,2012-04-07,Bridgetown,West Indies,2012,2,6,18,0,1,422,828,8,416,810,8,52.75,>30,WI,Away,Upto 2014
MJ Clarke,AUS,Spin,2012-04-15,Port of Spain,West Indies,2012,1,3,12,0,1,339,951,13,336,939,13,26.076923076923077,<=30,WI,Away,Upto 2014
MJ Clarke,AUS,Spin,2012-04-23,Roseau,West Indies,2012,2,104,150,5,1,565,1160,26,461,1010,21,21.73076923076923,<=30,WI,Away,Upto 2014
MJ Clarke,AUS,Spin,2012-11-09,Brisbane,Australia,2012,1,4,6,0,1,246,390,4,242,384,4,61.5,>30,AUS,Home,Upto 2014
MJ Clarke,AUS,Spin,2012-11-22,Adelaide,Australia,2012,2,56,150,1,1,554,1050,7,498,900,6,79.14285714285714,>30,AUS,Home,Upto 2014
MJ Clarke,AUS,Spin,2012-12-14,Hobart,Australia,2012,1,9,12,0,1,352,719,7,343,707,7,50.285714285714285,>30,AUS,Home,Upto 2014
MJ Clarke,AUS,Spin,2013-02-22,Chennai,India,2013,1,25,48,0,1,771,1539,24,746,1491,24,32.125,>30,IND,Away,Upto 2014
MJ Clarke,AUS,Spin,2013-08-01,Manchester,England,2013,1,2,6,0,1,362,618,7,360,612,7,51.714285714285715,>30,ENG,Away,Upto 2014
MJ Clarke,AUS,Spin,2013-08-21,The Oval,England,2013,1,4,12,0,1,310,576,4,306,564,4,77.5,>30,ENG,Away,Upto 2014
MJ Clarke,AUS,Spin,2014-02-20,Gqeberha,South Africa,2014,1,16,47,1,1,316,654,11,300,607,10,28.727272727272727,<=30,SA,Away,After 1965
MJ Clarke,AUS,Spin,2014-03-01,Cape Town,South Africa,2014,1,7,30,0,1,386,690,6,379,660,6,64.33333333333333,>30,SA,Away,After 1965
MJ Clarke,AUS,Spin,2014-10-30,Abu Dhabi,UAE,2014,1,24,36,0,1,756,1259,18,732,1223,18,42.0,>30,UAE,Away,After 1965
MJ Clarke,AUS,Spin,2015-06-03,Roseau,West Indies,2015,1,8,12,0,1,294,570,11,286,558,11,26.727272727272727,<=30,WI,Away,After 1965
MJ Gopalan,IND,Pace,1934-01-05,Eden Gardens,India,1934,1,39,114,1,1,492,1256,17,453,1142,16,28.941176470588236,<=30,IND,Home,Upto 2014
MJ Greatbatch,NZ,Pace,1990-02-22,Auckland,New Zealand,1990,1,0,6,0,1,1075,1694,19,1075,1688,19,56.578947368421055,>30,NZ,Home,Upto 2014
MJ Guptill,NZ,Spin,2009-12-11,Napier,New Zealand,2009,1,37,80,3,1,354,812,12,317,732,9,29.5,<=30,NZ,Home,Upto 2014
MJ Guptill,NZ,Spin,2010-03-19,Wellington,New Zealand,2010,1,10,6,0,1,326,678,4,316,672,4,81.5,>30,NZ,Home,Upto 2014
MJ Guptill,NZ,Spin,2010-11-12,Hyderabad,India,2010,1,33,30,0,1,691,1414,15,658,1384,15,46.06666666666667,>30,IND,Away,Upto 2014
MJ Guptill,NZ,Spin,2010-11-20,Nagpur,India,2010,1,27,42,0,1,493,909,15,466,867,15,32.86666666666667,>30,IND,Away,Upto 2014
MJ Guptill,NZ,Spin,2011-01-07,Hamilton,New Zealand,2011,1,13,12,0,1,193,540,7,180,528,7,27.571428571428573,<=30,NZ,Home,Upto 2014
MJ Guptill,NZ,Spin,2011-01-15,Wellington,New Zealand,2011,2,16,24,0,1,445,1147,12,429,1123,12,37.083333333333336,>30,NZ,Home,Upto 2014
MJ Guptill,NZ,Spin,2011-11-01,Bulawayo,Zimbabwe,2011,2,30,60,1,1,535,1222,13,505,1162,12,41.15384615384615,>30,ZIM,Away,Upto 2014
MJ Guptill,NZ,Spin,2011-12-01,Brisbane,Australia,2011,1,18,18,1,1,207,471,10,189,453,9,20.7,<=30,AUS,Away,Upto 2014
MJ Guptill,NZ,Spin,2012-01-26,Napier,New Zealand,2012,1,12,6,0,1,163,234,4,151,228,4,40.75,>30,NZ,Home,Upto 2014
MJ Guptill,NZ,Spin,2012-08-02,Kingston,West Indies,2012,1,21,24,0,1,213,524,11,192,500,11,19.363636363636363,<=30,WI,Away,Upto 2014
MJ Guptill,NZ,Spin,2013-05-24,Leeds,England,2013,1,41,30,0,1,291,492,14,250,462,14,20.785714285714285,<=30,ENG,Away,Upto 2014
MJ Guptill,NZ,Spin,2015-11-13,W.A.C.A,Australia,2015,1,7,18,0,1,404,593,6,397,575,6,67.33333333333333,>30,AUS,Away,After 1965
MJ Guptill,NZ,Spin,2016-08-06,Bulawayo,Zimbabwe,2016,2,11,48,3,1,624,1160,15,613,1112,12,41.6,>30,ZIM,Away,After 1965
MJ Guptill,NZ,Spin,2016-08-19,Durban,South Africa,2016,1,5,6,0,1,27,72,2,22,66,2,13.5,<=30,SA,Away,After 1965
MJ Guptill,NZ,Spin,2016-09-22,Kanpur,India,2016,1,17,24,0,1,859,1714,26,842,1690,26,33.03846153846154,>30,IND,Away,After 1965
MJ Hartigan,AUS,Spin,1908-01-10,Adelaide,Australia,1908,1,7,12,0,1,776,1611,17,769,1599,17,45.64705882352941,>30,AUS,Home,Upto 2014
MJ Haslam,NZ,Spin,1992-11-01,Bulawayo,Zimbabwe,1992,2,120,240,0,1,469,976,10,349,736,10,46.9,>30,ZIM,Away,Upto 2014
MJ Haslam,NZ,Spin,1992-11-07,Harare,Zimbabwe,1992,1,33,60,1,1,372,723,13,339,663,12,28.615384615384617,<=30,ZIM,Away,Upto 2014
MJ Haslam,NZ,Spin,1995-10-25,Chennai,India,1995,1,50,103,0,1,69,157,0,19,54,0,inf,>30,IND,Away,Upto 2014
MJ Haslam,NZ,Spin,1995-11-08,Cuttack,India,1995,1,42,90,1,1,195,570,8,153,480,7,24.375,<=30,IND,Away,Upto 2014
MJ Henry,NZ,Pace,2015-05-21,Lord's,England,2015,2,199,323,6,1,1185,2044,33,986,1721,27,35.90909090909091,>30,ENG,Away,After 1965
MJ Henry,NZ,Pace,2015-05-29,Leeds,England,2015,2,141,194,2,1,1058,1587,28,917,1393,26,37.785714285714285,>30,ENG,Away,After 1965
MJ Henry,NZ,Pace,2015-11-13,W.A.C.A,Australia,2015,2,158,252,2,1,1234,1914,22,1076,1662,20,56.09090909090909,>30,AUS,Away,After 1965
MJ Henry,NZ,Pace,2016-02-20,Christchurch,New Zealand,2016,2,134,246,0,1,1247,2076,29,1113,1830,29,43.0,>30,NZ,Home,After 1965
MJ Henry,NZ,Pace,2016-09-30,Eden Gardens,India,2016,2,105,240,6,1,483,1061,26,378,821,20,18.576923076923077,<=30,IND,Away,After 1965
MJ Henry,NZ,Pace,2016-10-08,Indore,India,2016,2,149,252,0,1,519,876,3,370,624,3,173.0,>30,IND,Away,After 1965
MJ Henry,NZ,Pace,2016-11-25,Hamilton,New Zealand,2016,2,68,228,1,1,921,1796,32,853,1568,31,28.78125,<=30,NZ,Home,After 1965
MJ Henry,NZ,Pace,2017-03-25,Hamilton,New Zealand,2017,2,113,210,5,1,618,1215,19,505,1005,14,32.526315789473685,>30,NZ,Home,After 1965
MJ Henry,NZ,Pace,2017-12-01,Wellington,New Zealand,2017,2,96,210,3,1,782,1474,25,686,1264,22,31.28,>30,NZ,Home,After 1965
MJ Henry,NZ,Pace,2019-03-08,Wellington,New Zealand,2019,2,107,144,2,1,692,1031,24,585,887,22,28.833333333333332,<=30,NZ,Home,After 1965
MJ Henry,NZ,Pace,2019-11-29,Hamilton,New Zealand,2019,1,87,198,1,1,881,1878,20,794,1680,19,44.05,>30,NZ,Home,After 1965
MJ Henry,NZ,Pace,2020-01-03,Sydney,Australia,2020,2,148,264,2,1,593,1249,16,445,985,14,37.0625,>30,AUS,Away,After 1965
MJ Henry,NZ,Pace,2021-01-03,Christchurch,New Zealand,2021,2,93,192,1,1,918,1730,25,825,1538,24,36.72,>30,NZ,Home,After 1965
MJ Henry,NZ,Pace,2021-06-10,Birmingham,England,2021,2,114,228,6,1,672,1387,27,558,1159,21,24.88888888888889,<=30,ENG,Away,After 1965
MJ Henry,NZ,Pace,2022-02-17,Christchurch,New Zealand,2022,2,55,156,9,1,630,1205,28,575,1049,19,22.5,<=30,NZ,Home,After 1965
MJ Henry,NZ,Pace,2022-02-25,Christchurch,New Zealand,2022,2,171,354,5,1,1098,2154,35,927,1800,30,31.37142857142857,>30,NZ,Home,After 1965
MJ Henry,NZ,Pace,2022-06-10,Nottingham,England,2022,2,195,252,2,1,1254,1921,26,1059,1669,24,48.23076923076923,>30,ENG,Away,After 1965
MJ Henry,NZ,Pace,2023-01-02,Karachi,Pakistan,2023,2,127,294,2,1,583,1266,12,456,972,10,48.583333333333336,>30,PAK,Away,After 1965
MJ Henry,NZ,Pace,2023-02-24,Wellington,New Zealand,2023,2,175,264,6,1,965,1553,25,790,1289,19,38.6,>30,NZ,Home,After 1965
MJ Henry,NZ,Pace,2023-03-09,Christchurch,New Zealand,2023,2,151,324,7,1,1067,1960,32,916,1636,25,33.34375,>30,NZ,Home,After 1965
MJ Henry,NZ,Pace,2023-03-17,Wellington,New Zealand,2023,2,103,294,4,1,761,1427,16,658,1133,12,47.5625,>30,NZ,Home,After 1965
MJ Henry,NZ,Pace,2024-02-04,Mount Maunganui,New Zealand,2024,2,64,150,4,1,753,1368,17,689,1218,13,44.294117647058826,>30,NZ,Home,After 1965
MJ Henry,NZ,Pace,2024-02-13,Hamilton,New Zealand,2024,2,59,168,2,1,507,1179,18,448,1011,16,28.166666666666668,<=30,NZ,Home,After 1965
MJ Henry,NZ,Pace,2024-02-29,Wellington,New Zealand,2024,2,106,254,8,1,689,1266,22,583,1012,14,31.318181818181817,>30,NZ,Home,After 1965
MJ Henry,NZ,Pace,2024-03-08,Christchurch,New Zealand,2024,2,161,252,9,1,918,1490,33,757,1238,24,27.818181818181817,<=30,NZ,Home,After 1965
MJ Henry,NZ,Pace,2024-10-16,Bengaluru,India,2024,2,117,227,8,1,462,863,22,345,636,14,21.0,<=30,IND,Away,After 1965
MJ Henry,NZ,Pace,2024-11-01,Wankhede,India,2024,2,36,66,2,1,89,174,4,53,108,2,22.25,<=30,IND,Away,After 1965
MJ Henry,NZ,Pace,2024-11-28,Christchurch,New Zealand,2024,2,96,156,5,1,709,1026,15,613,870,10,47.266666666666666,>30,NZ,Home,After 1965
MJ Henry,NZ,Pace,2024-12-06,Wellington,New Zealand,2024,2,143,198,4,1,601,832,22,458,634,18,27.318181818181817,<=30,NZ,Home,After 1965
MJ Henry,NZ,Pace,2024-12-14,Hamilton,New Zealand,2024,2,110,160,6,1,652,1099,24,542,939,18,27.166666666666668,<=30,NZ,Home,After 1965
MJ Hilton,ENG,Spin,1950-08-12,The Oval,England,1950,1,91,246,0,1,654,1981,25,563,1735,25,26.16,<=30,ENG,Home,Upto 2014
MJ Hilton,ENG,Spin,1951-07-26,Leeds,England,1951,2,193,429,3,1,749,2072,16,556,1643,13,46.8125,>30,ENG,Home,Upto 2014
MJ Hilton,ENG,Spin,1952-01-12,Kanpur,India,1952,2,93,329,9,1,484,1339,31,391,1010,22,15.612903225806452,<=30,IND,Away,Upto 2014
MJ Hilton,ENG,Spin,1952-02-06,Chennai,India,1952,1,100,240,2,1,648,1564,25,548,1324,23,25.92,<=30,IND,Away,Upto 2014
MJ Hoggard,ENG,Pace,2000-06-29,Lord's,England,2000,1,49,78,0,1,573,1340,36,524,1262,36,15.916666666666666,<=30,ENG,Home,Upto 2014
MJ Hoggard,ENG,Pace,2001-05-31,Manchester,England,2001,2,172,288,6,1,1134,1996,31,962,1708,25,36.58064516129032,>30,ENG,Home,Upto 2014
MJ Hoggard,ENG,Pace,2001-12-03,Mohali,India,2001,2,103,194,3,1,398,794,9,295,600,6,44.22222222222222,>30,IND,Away,Upto 2014
MJ Hoggard,ENG,Pace,2001-12-11,Ahmedabad,India,2001,2,98,270,2,1,368,804,6,270,534,4,61.333333333333336,>30,IND,Away,Upto 2014
MJ Hoggard,ENG,Pace,2001-12-19,Bengaluru,India,2001,1,80,147,4,1,273,609,12,193,462,8,22.75,<=30,IND,Away,Upto 2014
MJ Hoggard,ENG,Pace,2002-03-13,Christchurch,New Zealand,2002,2,205,275,8,1,1052,1583,35,847,1308,27,30.057142857142857,>30,NZ,Away,Upto 2014
MJ Hoggard,ENG,Pace,2002-03-21,Wellington,New Zealand,2002,2,63,156,2,1,587,1212,18,524,1056,16,32.611111111111114,>30,NZ,Away,Upto 2014
MJ Hoggard,ENG,Pace,2002-03-30,Auckland,New Zealand,2002,2,134,285,7,1,809,1459,39,675,1174,32,20.743589743589745,<=30,NZ,Away,Upto 2014
MJ Hoggard,ENG,Pace,2002-05-16,Lord's,England,2002,2,167,240,2,1,1188,2251,20,1021,2011,18,59.4,>30,ENG,Home,Upto 2014
MJ Hoggard,ENG,Pace,2002-05-30,Birmingham,England,2002,2,147,240,7,1,687,1192,22,540,952,15,31.227272727272727,>30,ENG,Home,Upto 2014
MJ Hoggard,ENG,Pace,2002-06-13,Manchester,England,2002,2,135,318,5,1,775,1409,20,640,1091,15,38.75,>30,ENG,Home,Upto 2014
MJ Hoggard,ENG,Pace,2002-07-25,Lord's,England,2002,2,120,245,7,1,837,1449,22,717,1204,15,38.04545454545455,>30,ENG,Home,Upto 2014
MJ Hoggard,ENG,Pace,2002-08-08,Nottingham,England,2002,2,214,349,5,1,996,1602,22,782,1253,17,45.27272727272727,>30,ENG,Home,Upto 2014
MJ Hoggard,ENG,Pace,2002-08-22,Leeds,England,2002,1,102,216,1,1,769,1387,15,667,1171,14,51.266666666666666,>30,ENG,Home,Upto 2014
MJ Hoggard,ENG,Pace,2002-09-05,The Oval,England,2002,1,97,150,1,1,664,1200,10,567,1050,9,66.4,>30,ENG,Home,Upto 2014
MJ Hoggard,ENG,Pace,2002-11-07,Brisbane,Australia,2002,2,164,258,0,1,677,1218,20,513,960,20,33.85,>30,AUS,Away,Upto 2014
MJ Hoggard,ENG,Pace,2002-11-21,Adelaide,Australia,2002,1,84,156,1,1,643,1143,16,559,987,15,40.1875,>30,AUS,Away,Upto 2014
MJ Hoggard,ENG,Pace,2003-01-02,Sydney,Australia,2003,2,127,207,5,1,1004,1656,32,877,1449,27,31.375,>30,AUS,Away,Upto 2014
MJ Hoggard,ENG,Pace,2003-05-22,Lord's,England,2003,2,59,198,3,1,641,1236,26,582,1038,23,24.653846153846153,<=30,ENG,Home,Upto 2014
MJ Hoggard,ENG,Pace,2003-10-21,Dhaka,Bangladesh,2003,2,103,300,7,1,448,1151,23,345,851,16,19.47826086956522,<=30,BAN,Away,Upto 2014
MJ Hoggard,ENG,Pace,2003-10-29,Chattogram,Bangladesh,2003,2,101,192,2,1,551,1109,24,450,917,22,22.958333333333332,<=30,BAN,Away,Upto 2014
MJ Hoggard,ENG,Pace,2003-12-02,Galle,Sri Lanka,2003,2,82,174,1,1,348,780,10,266,606,9,34.8,>30,SL,Away,Upto 2014
MJ Hoggard,ENG,Pace,2004-03-11,Kingston,West Indies,2004,2,89,166,5,1,561,1123,25,472,957,20,22.44,<=30,WI,Away,Upto 2014
MJ Hoggard,ENG,Pace,2004-03-19,Port of Spain,West Indies,2004,2,86,186,3,1,720,1489,29,634,1303,26,24.82758620689655,<=30,WI,Away,Upto 2014
MJ Hoggard,ENG,Pace,2004-04-01,Bridgetown,West Indies,2004,2,69,180,5,1,550,1209,31,481,1029,26,17.741935483870968,<=30,WI,Away,Upto 2014
MJ Hoggard,ENG,Pace,2004-04-10,St John's,West Indies,2004,1,82,108,0,1,955,1635,13,873,1527,13,73.46153846153847,>30,WI,Away,Upto 2014
MJ Hoggard,ENG,Pace,2004-05-20,Lord's,England,2004,2,107,216,1,1,1118,2072,26,1011,1856,25,43.0,>30,ENG,Home,Upto 2014
MJ Hoggard,ENG,Pace,2004-06-03,Leeds,England,2004,2,168,252,6,1,915,1695,27,747,1443,21,33.888888888888886,>30,ENG,Home,Upto 2014
MJ Hoggard,ENG,Pace,2004-06-10,Nottingham,England,2004,2,110,186,2,1,1015,1836,30,905,1650,28,33.833333333333336,>30,ENG,Home,Upto 2014
MJ Hoggard,ENG,Pace,2004-07-22,Lord's,England,2004,2,154,252,4,1,966,1493,22,812,1241,18,43.90909090909091,>30,ENG,Home,Upto 2014
MJ Hoggard,ENG,Pace,2004-07-29,Birmingham,England,2004,2,153,204,6,1,971,1389,23,818,1185,17,42.21739130434783,>30,ENG,Home,Upto 2014
MJ Hoggard,ENG,Pace,2004-08-12,Manchester,England,2004,2,104,174,4,1,785,1467,28,681,1293,24,28.035714285714285,<=30,ENG,Home,Upto 2014
MJ Hoggard,ENG,Pace,2004-08-19,The Oval,England,2004,2,81,126,2,1,794,1252,26,713,1126,24,30.53846153846154,>30,ENG,Home,Upto 2014
MJ Hoggard,ENG,Pace,2004-12-17,Gqeberha,South Africa,2004,2,94,192,4,1,915,1720,27,821,1528,23,33.888888888888886,>30,SA,Away,Upto 2014
MJ Hoggard,ENG,Pace,2004-12-26,Durban,South Africa,2004,2,116,252,5,1,968,1978,29,852,1726,24,33.37931034482759,>30,SA,Away,Upto 2014
MJ Hoggard,ENG,Pace,2005-01-02,Cape Town,South Africa,2005,2,133,252,3,1,830,1832,29,697,1580,26,28.620689655172413,<=30,SA,Away,Upto 2014
MJ Hoggard,ENG,Pace,2005-01-13,Johannesburg,South Africa,2005,2,205,315,12,1,1212,2062,34,1007,1747,22,35.64705882352941,>30,SA,Away,Upto 2014
MJ Hoggard,ENG,Pace,2005-01-21,Centurion,South Africa,2005,2,115,192,2,1,788,1589,28,673,1397,26,28.142857142857142,<=30,SA,Away,Upto 2014
MJ Hoggard,ENG,Pace,2005-05-26,Lord's,England,2005,2,84,134,6,1,522,823,21,438,689,15,24.857142857142858,<=30,ENG,Home,Upto 2014
MJ Hoggard,ENG,Pace,2005-06-03,Chester-le-Street,England,2005,2,97,167,8,1,697,946,22,600,779,14,31.681818181818183,>30,ENG,Home,Upto 2014
MJ Hoggard,ENG,Pace,2005-07-21,Lord's,England,2005,2,96,144,3,1,726,1256,32,630,1112,29,22.6875,<=30,ENG,Home,Upto 2014
MJ Hoggard,ENG,Pace,2005-08-04,Birmingham,England,2005,2,67,78,2,1,817,1095,24,750,1017,22,34.041666666666664,>30,ENG,Home,Upto 2014
MJ Hoggard,ENG,Pace,2005-08-11,Manchester,England,2005,2,71,114,2,1,929,1432,27,858,1318,25,34.407407407407405,>30,ENG,Home,Upto 2014
MJ Hoggard,ENG,Pace,2005-08-25,Nottingham,England,2005,2,142,252,5,1,944,1543,26,802,1291,21,36.30769230769231,>30,ENG,Home,Upto 2014
MJ Hoggard,ENG,Pace,2005-09-08,The Oval,England,2005,1,97,145,4,1,707,1205,18,610,1060,14,39.27777777777778,>30,ENG,Home,Upto 2014
MJ Hoggard,ENG,Pace,2005-11-12,Multan,Pakistan,2005,2,136,294,4,1,730,1407,32,594,1113,28,22.8125,<=30,PAK,Away,Upto 2014
MJ Hoggard,ENG,Pace,2005-11-20,Faisalabad,Pakistan,2005,2,165,228,5,1,802,1439,26,637,1211,21,30.846153846153847,>30,PAK,Away,Upto 2014
MJ Hoggard,ENG,Pace,2005-11-29,Lahore,Pakistan,2005,1,106,138,2,1,870,1496,17,764,1358,15,51.1764705882353,>30,PAK,Away,Upto 2014
MJ Hoggard,ENG,Pace,2006-03-01,Nagpur,India,2006,2,86,281,7,1,629,1284,22,543,1003,15,28.59090909090909,<=30,IND,Away,Upto 2014
MJ Hoggard,ENG,Pace,2006-03-09,Mohali,India,2006,2,79,156,3,1,422,800,12,343,644,9,35.166666666666664,>30,IND,Away,Upto 2014
MJ Hoggard,ENG,Pace,2006-03-18,Wankhede,India,2006,2,67,204,3,1,416,973,19,349,769,16,21.894736842105264,<=30,IND,Away,Upto 2014
MJ Hoggard,ENG,Pace,2006-05-11,Lord's,England,2006,2,137,360,6,1,982,1899,19,845,1539,13,51.68421052631579,>30,ENG,Home,Upto 2014
MJ Hoggard,ENG,Pace,2006-05-25,Birmingham,England,2006,2,96,222,5,1,504,1093,20,408,871,15,25.2,<=30,ENG,Home,Upto 2014
MJ Hoggard,ENG,Pace,2006-06-02,Nottingham,England,2006,2,136,234,4,1,634,1203,19,498,969,15,33.36842105263158,>30,ENG,Home,Upto 2014
MJ Hoggard,ENG,Pace,2006-07-13,Lord's,England,2006,2,148,270,5,1,919,1514,18,771,1244,13,51.05555555555556,>30,ENG,Home,Upto 2014
MJ Hoggard,ENG,Pace,2006-07-27,Manchester,England,2006,2,82,138,0,1,487,865,18,405,727,18,27.055555555555557,<=30,ENG,Home,Upto 2014
MJ Hoggard,ENG,Pace,2006-08-04,Leeds,England,2006,2,119,216,2,1,1053,1569,26,934,1353,24,40.5,>30,ENG,Home,Upto 2014
MJ Hoggard,ENG,Pace,2006-08-17,The Oval,England,2006,1,124,204,3,1,700,1093,21,576,889,18,33.333333333333336,>30,ENG,Home,Upto 2014
MJ Hoggard,ENG,Pace,2006-11-23,Brisbane,Australia,2006,2,141,252,2,1,985,1659,24,844,1407,22,41.041666666666664,>30,AUS,Away,Upto 2014
MJ Hoggard,ENG,Pace,2006-12-01,Adelaide,Australia,2006,2,138,276,8,1,876,1646,21,738,1370,13,41.714285714285715,>30,AUS,Away,Upto 2014
MJ Hoggard,ENG,Pace,2006-12-14,W.A.C.A,Australia,2006,2,125,192,2,1,846,1471,19,721,1279,17,44.526315789473685,>30,AUS,Away,Upto 2014
MJ Hoggard,ENG,Pace,2006-12-26,Melbourne,Australia,2006,1,82,126,1,1,551,1154,23,469,1028,22,23.956521739130434,<=30,AUS,Away,Upto 2014
MJ Hoggard,ENG,Pace,2007-05-17,Lord's,England,2007,1,29,61,0,1,1013,1620,14,984,1559,14,72.35714285714286,>30,ENG,Home,Upto 2014
MJ Hoggard,ENG,Pace,2007-06-15,Chester-le-Street,England,2007,2,86,222,5,1,807,1380,26,721,1158,21,31.03846153846154,>30,ENG,Home,Upto 2014
MJ Hoggard,ENG,Pace,2007-12-01,Kandy,Sri Lanka,2007,2,84,192,6,1,767,1367,21,683,1175,15,36.523809523809526,>30,SL,Away,Upto 2014
MJ Hoggard,ENG,Pace,2007-12-18,Galle,Sri Lanka,2007,1,121,192,1,1,606,1192,16,485,1000,15,37.875,>30,SL,Away,Upto 2014
MJ Hoggard,ENG,Pace,2008-03-05,Hamilton,New Zealand,2008,2,151,228,1,1,672,1450,27,521,1222,26,24.88888888888889,<=30,NZ,Away,Upto 2014
MJ Horne,NZ,Pace,1997-03-07,Dunedin,New Zealand,1997,2,22,60,0,1,739,1295,21,717,1235,21,35.19047619047619,>30,NZ,Home,Upto 2014
MJ Horne,NZ,Pace,1999-01-02,Hamilton,New Zealand,1999,1,4,6,0,1,1002,1896,23,998,1890,23,43.56521739130435,>30,NZ,Home,Upto 2014
MJ Horton,ENG,Spin,1959-06-04,Nottingham,England,1959,2,35,144,0,1,354,956,10,319,812,10,35.4,>30,ENG,Home,Upto 2014
MJ Horton,ENG,Spin,1959-06-18,Lord's,England,1959,1,24,94,2,1,208,491,11,184,397,9,18.90909090909091,<=30,ENG,Home,Upto 2014
MJ Humphreys,IRE,Spin,2023-04-24,Galle,Sri Lanka,2023,1,67,60,0,1,963,1611,14,896,1551,14,68.78571428571429,>30,SL,Away,After 1965
MJ Humphreys,IRE,Spin,2024-07-25,Belfast,Northern Ireland,2024,1,20,30,1,1,127,307,10,107,277,9,12.7,<=30,Northern Ireland,Away,After 1965
MJ Leach,ENG,Spin,2018-03-30,Christchurch,New Zealand,2018,2,113,306,2,1,236,508,3,123,202,1,78.66666666666667,>30,NZ,Away,After 1965
MJ Leach,ENG,Spin,2018-11-06,Galle,Sri Lanka,2018,2,101,234,5,1,876,1627,28,775,1393,23,31.285714285714285,>30,SL,Away,After 1965
MJ Leach,ENG,Spin,2018-11-14,Pallekele,Sri Lanka,2018,2,153,342,8,1,1031,1760,38,878,1418,30,27.13157894736842,<=30,SL,Away,After 1965
MJ Leach,ENG,Spin,2018-11-23,Colombo (SSC),Sri Lanka,2018,2,131,280,5,1,913,1615,34,782,1335,29,26.852941176470587,<=30,SL,Away,After 1965
MJ Leach,ENG,Spin,2019-07-24,Lord's,England,2019,1,26,18,0,1,87,104,1,61,86,1,87.0,>30,ENG,Home,After 1965
MJ Leach,ENG,Spin,2019-08-14,Lord's,England,2019,2,56,165,4,1,239,466,7,183,301,3,34.142857142857146,>30,ENG,Home,After 1965
MJ Leach,ENG,Spin,2019-08-22,Leeds,England,2019,1,46,66,1,1,178,342,3,132,276,2,59.333333333333336,>30,ENG,Home,After 1965
MJ Leach,ENG,Spin,2019-09-04,Manchester,England,2019,2,141,211,3,1,337,685,7,196,474,4,48.142857142857146,>30,ENG,Home,After 1965
MJ Leach,ENG,Spin,2019-09-12,The Oval,England,2019,2,67,168,4,1,205,441,10,138,273,6,20.5,<=30,ENG,Home,After 1965
MJ Leach,ENG,Spin,2019-11-21,Mount Maunganui,New Zealand,2019,1,153,282,2,1,303,672,6,150,390,4,50.5,>30,NZ,Away,After 1965
MJ Leach,ENG,Spin,2021-01-14,Galle,Sri Lanka,2021,2,177,353,6,1,751,1413,23,574,1060,17,32.65217391304348,>30,SL,Away,After 1965
MJ Leach,ENG,Spin,2021-01-22,Galle,Sri Lanka,2021,2,178,312,4,1,734,1377,23,556,1065,19,31.91304347826087,>30,SL,Away,After 1965
MJ Leach,ENG,Spin,2021-02-05,Chennai,India,2021,2,181,300,6,1,867,1480,24,686,1180,18,36.125,>30,IND,Away,After 1965
MJ Leach,ENG,Spin,2021-02-13,Chennai,India,2021,2,178,360,6,1,686,1393,32,508,1033,26,21.4375,<=30,IND,Away,After 1965
MJ Leach,ENG,Spin,2021-02-24,Ahmedabad,India,2021,2,69,144,4,1,247,614,28,178,470,24,8.821428571428571,<=30,IND,Away,After 1965
MJ Leach,ENG,Spin,2021-03-04,Ahmedabad,India,2021,1,89,162,2,1,456,994,20,367,832,18,22.8,<=30,IND,Away,After 1965
MJ Leach,ENG,Spin,2021-12-08,Brisbane,Australia,2021,1,102,78,1,1,257,390,6,155,312,5,42.833333333333336,>30,AUS,Away,After 1965
MJ Leach,ENG,Spin,2021-12-26,Melbourne,Australia,2021,1,46,90,1,1,82,175,4,36,85,3,20.5,<=30,AUS,Away,After 1965
MJ Leach,ENG,Spin,2022-01-05,Sydney,Australia,2022,2,173,275,4,1,414,683,10,241,408,6,41.4,>30,AUS,Away,After 1965
MJ Leach,ENG,Spin,2022-03-08,North Sound,West Indies,2022,2,136,442,5,1,307,730,6,171,288,1,51.166666666666664,>30,WI,Away,After 1965
MJ Leach,ENG,Spin,2022-03-16,Bridgetown,West Indies,2022,2,154,569,6,1,465,1126,13,311,557,7,35.76923076923077,>30,WI,Away,After 1965
MJ Leach,ENG,Spin,2022-03-24,St George's,West Indies,2022,1,49,126,0,1,75,217,2,26,91,2,37.5,>30,WI,Away,After 1965
MJ Leach,ENG,Spin,2022-06-10,Nottingham,England,2022,2,226,354,3,1,364,530,6,138,176,3,60.666666666666664,>30,ENG,Home,After 1965
MJ Leach,ENG,Spin,2022-06-23,Leeds,England,2022,2,166,425,10,1,388,637,13,222,212,3,29.846153846153847,<=30,ENG,Home,After 1965
MJ Leach,ENG,Spin,2022-07-01,Birmingham,England,2022,2,99,126,1,1,204,304,2,105,178,1,102.0,>30,ENG,Home,After 1965
MJ Leach,ENG,Spin,2022-08-17,Lord's,England,2022,1,42,84,1,1,77,156,3,35,72,2,25.666666666666668,<=30,ENG,Home,After 1965
MJ Leach,ENG,Spin,2022-08-25,Manchester,England,2022,2,37,176,1,1,204,480,4,167,304,3,51.0,>30,ENG,Home,After 1965
MJ Leach,ENG,Spin,2022-09-08,The Oval,England,2022,1,10,12,0,1,10,12,0,0,0,0,inf,>30,ENG,Home,After 1965
MJ Leach,ENG,Spin,2022-12-01,Rawalpindi,Pakistan,2022,2,246,405,3,1,949,1152,16,703,747,13,59.3125,>30,PAK,Away,After 1965
MJ Leach,ENG,Spin,2022-12-09,Multan,Pakistan,2022,2,211,318,5,1,774,1107,26,563,789,21,29.76923076923077,<=30,PAK,Away,After 1965
MJ Leach,ENG,Spin,2022-12-17,Karachi,Pakistan,2022,2,212,342,7,1,895,1264,27,683,922,20,33.148148148148145,>30,PAK,Away,After 1965
MJ Leach,ENG,Spin,2023-02-16,Mount Maunganui,New Zealand,2023,2,109,174,2,1,205,347,5,96,173,3,41.0,>30,NZ,Away,After 1965
MJ Leach,ENG,Spin,2023-02-24,Wellington,New Zealand,2023,2,237,471,8,1,403,711,11,166,240,3,36.63636363636363,>30,NZ,Away,After 1965
MJ Leach,ENG,Spin,2023-06-01,Lord's,England,2023,2,125,204,4,1,283,346,7,158,142,3,40.42857142857143,>30,ENG,Home,After 1965
MJ Leach,ENG,Spin,2024-01-25,Hyderabad,India,2024,2,96,216,2,1,1067,1778,32,971,1562,30,33.34375,>30,IND,Away,After 1965
MJ Leach,ENG,Spin,2024-10-07,Multan,Pakistan,2024,2,190,281,7,1,918,1193,16,728,912,9,57.375,>30,PAK,Away,After 1965
MJ Leach,ENG,Spin,2024-10-15,Multan,Pakistan,2024,2,181,333,7,1,831,1418,37,650,1085,30,22.45945945945946,<=30,PAK,Away,After 1965
MJ Leach,ENG,Spin,2024-10-24,Rawalpindi,Pakistan,2024,2,132,198,2,1,719,1161,29,587,963,27,24.79310344827586,<=30,PAK,Away,After 1965
MJ Macaulay,SA,Spin,1965-02-12,Gqeberha,South Africa,1965,2,73,276,2,1,437,1309,10,364,1033,8,43.7,>30,SA,Home,Upto 2014
MJ Mason,NZ,Pace,2004-03-26,Wellington,New Zealand,2004,2,105,132,0,1,820,1651,25,715,1519,25,32.8,>30,NZ,Home,Upto 2014
MJ McCague,ENG,Pace,1993-07-01,Nottingham,England,1993,2,179,309,4,1,786,1563,21,607,1254,17,37.42857142857143,>30,ENG,Home,Upto 2014
MJ McCague,ENG,Pace,1993-07-22,Leeds,England,1993,1,115,168,0,1,901,1757,18,786,1589,18,50.05555555555556,>30,ENG,Home,Upto 2014
MJ McCague,ENG,Pace,1994-11-25,Brisbane,Australia,1994,1,96,116,2,1,726,1262,21,630,1146,19,34.57142857142857,>30,AUS,Away,Upto 2014
MJ Mindley,WI,Pace,2022-12-08,Adelaide,Australia,2022,1,11,12,0,1,712,1214,23,701,1202,23,30.956521739130434,>30,AUS,Away,After 1965
MJ Nicholson,AUS,Pace,1998-12-26,Melbourne,Australia,1998,2,115,150,4,1,840,1515,33,725,1365,29,25.454545454545453,<=30,AUS,Home,Upto 2014
MJ North,AUS,Spin,2009-02-26,Johannesburg,South Africa,2009,2,56,84,1,1,210,342,4,154,258,3,52.5,>30,SA,Away,Upto 2014
MJ North,AUS,Spin,2009-03-06,Durban,South Africa,2009,2,42,144,1,1,264,614,7,222,470,6,37.714285714285715,>30,SA,Away,Upto 2014
MJ North,AUS,Spin,2009-07-08,Cardiff,England,2009,1,14,42,0,1,464,923,7,450,881,7,66.28571428571429,>30,ENG,Away,Upto 2014
MJ North,AUS,Spin,2009-07-16,Lord's,England,2009,1,59,99,0,1,283,468,8,224,369,8,35.375,>30,ENG,Away,Upto 2014
MJ North,AUS,Spin,2009-08-20,The Oval,England,2009,2,131,264,4,1,318,638,12,187,374,8,26.5,<=30,ENG,Away,Upto 2014
MJ North,AUS,Spin,2009-12-04,Adelaide,Australia,2009,1,42,84,0,1,454,1020,7,412,936,7,64.85714285714286,>30,AUS,Home,Upto 2014
MJ North,AUS,Spin,2009-12-16,W.A.C.A,Australia,2009,1,20,42,0,1,338,660,10,318,618,10,33.8,>30,AUS,Home,Upto 2014
MJ North,AUS,Spin,2010-03-19,Wellington,New Zealand,2010,2,15,54,0,1,326,678,4,311,624,4,81.5,>30,NZ,Away,Upto 2014
MJ North,AUS,Spin,2010-03-27,Hamilton,New Zealand,2010,1,0,12,0,1,478,999,10,478,987,10,47.8,>30,NZ,Away,Upto 2014
MJ North,AUS,Spin,2010-07-13,Lord's,England,2010,1,55,109,6,1,298,547,14,243,438,8,21.285714285714285,<=30,ENG,Away,Upto 2014
MJ North,AUS,Spin,2010-10-01,Mohali,India,2010,2,47,96,1,1,557,1225,12,510,1129,11,46.416666666666664,>30,IND,Away,Upto 2014
MJ North,AUS,Spin,2010-11-25,Brisbane,Australia,2010,2,48,120,1,1,363,731,5,315,611,4,72.6,>30,AUS,Home,Upto 2014
MJ North,AUS,Spin,2010-12-03,Adelaide,Australia,2010,1,62,108,0,1,391,709,9,329,601,9,43.44444444444444,>30,AUS,Home,Upto 2014
MJ Potts,ENG,Pace,2022-06-02,Lord's,England,2022,2,68,176,7,1,722,1408,33,654,1232,26,21.87878787878788,<=30,ENG,Home,After 1965
MJ Potts,ENG,Pace,2022-06-10,Nottingham,England,2022,2,158,273,3,1,1254,1921,26,1096,1648,23,48.23076923076923,>30,ENG,Home,After 1965
MJ Potts,ENG,Pace,2022-06-23,Leeds,England,2022,2,100,306,4,1,862,1428,19,762,1122,15,45.36842105263158,>30,ENG,Home,After 1965
MJ Potts,ENG,Pace,2022-07-01,Birmingham,England,2022,2,155,222,4,1,1049,1525,30,894,1303,26,34.96666666666667,>30,ENG,Home,After 1965
MJ Potts,ENG,Pace,2022-08-17,Lord's,England,2022,1,79,120,2,1,531,875,27,452,755,25,19.666666666666668,<=30,ENG,Home,After 1965
MJ Potts,ENG,Pace,2023-06-01,Lord's,England,2023,2,113,200,3,1,757,1010,16,644,810,13,47.3125,>30,ENG,Home,After 1965
MJ Potts,ENG,Pace,2024-08-21,Manchester,England,2024,2,95,159,3,1,733,1160,25,638,1001,22,29.32,<=30,ENG,Home,After 1965
MJ Potts,ENG,Pace,2024-08-29,Lord's,England,2024,2,53,132,2,1,781,1252,34,728,1120,32,22.970588235294116,<=30,ENG,Home,After 1965
MJ Potts,ENG,Pace,2024-10-15,Multan,Pakistan,2024,2,85,188,3,1,157,284,3,72,96,0,52.333333333333336,>30,PAK,Away,After 1965
MJ Potts,ENG,Pace,2024-12-14,Hamilton,New Zealand,2024,2,154,265,5,1,652,1099,24,498,834,19,27.166666666666668,<=30,NZ,Away,After 1965
MJ Procter,SA,Pace,1967-01-20,Durban,South Africa,1967,2,98,259,7,1,725,1921,25,627,1662,18,29.0,<=30,SA,Home,Upto 2014
MJ Procter,SA,Pace,1967-02-03,Johannesburg,South Africa,1967,2,70,210,6,1,518,1312,23,448,1102,17,22.52173913043478,<=30,SA,Home,Upto 2014
MJ Procter,SA,Pace,1967-02-24,Gqeberha,South Africa,1967,2,95,187,2,1,655,1640,26,560,1453,24,25.192307692307693,<=30,SA,Home,Upto 2014
MJ Procter,SA,Pace,1970-01-22,Cape Town,South Africa,1970,2,77,174,6,1,471,1312,21,394,1138,15,22.428571428571427,<=30,SA,Home,Upto 2014
MJ Procter,SA,Pace,1970-02-05,Durban,South Africa,1970,2,101,179,5,1,686,1387,21,585,1208,16,32.666666666666664,>30,SA,Home,Upto 2014
MJ Procter,SA,Pace,1970-02-19,Johannesburg,South Africa,1970,2,72,210,6,1,766,1822,28,694,1612,22,27.357142857142858,<=30,SA,Home,Upto 2014
MJ Procter,SA,Pace,1970-03-05,Gqeberha,South Africa,1970,2,103,295,9,1,887,1974,33,784,1679,24,26.87878787878788,<=30,SA,Home,Upto 2014
MJ Saggers,ENG,Pace,2003-10-29,Chattogram,Bangladesh,2003,2,62,115,3,1,551,1109,24,489,994,21,22.958333333333332,<=30,BAN,Away,Upto 2014
MJ Saggers,ENG,Pace,2004-06-03,Leeds,England,2004,2,91,210,2,1,915,1695,27,824,1485,25,33.888888888888886,>30,ENG,Home,Upto 2014
MJ Saggers,ENG,Pace,2004-06-10,Nottingham,England,2004,2,94,168,2,1,1015,1836,30,921,1668,28,33.833333333333336,>30,ENG,Home,Upto 2014
MJ Santner,NZ,Spin,2015-11-27,Adelaide,Australia,2015,2,62,108,2,1,218,366,7,156,258,5,31.142857142857142,>30,AUS,Away,After 1965
MJ Santner,NZ,Spin,2015-12-10,Dunedin,New Zealand,2015,2,90,259,4,1,310,569,7,220,310,3,44.285714285714285,>30,NZ,Home,After 1965
MJ Santner,NZ,Spin,2015-12-18,Hamilton,New Zealand,2015,1,34,42,0,1,163,255,2,129,213,2,81.5,>30,NZ,Home,After 1965
MJ Santner,NZ,Spin,2016-07-28,Bulawayo,Zimbabwe,2016,2,48,186,3,1,461,827,6,413,641,3,76.83333333333333,>30,ZIM,Away,After 1965
MJ Santner,NZ,Spin,2016-08-06,Bulawayo,Zimbabwe,2016,2,120,282,3,1,624,1160,15,504,878,12,41.6,>30,ZIM,Away,After 1965
MJ Santner,NZ,Spin,2016-08-19,Durban,South Africa,2016,1,22,66,2,1,27,72,2,5,6,0,13.5,<=30,SA,Away,After 1965
MJ Santner,NZ,Spin,2016-08-27,Centurion,South Africa,2016,1,62,84,1,1,150,198,3,88,114,2,50.0,>30,SA,Away,After 1965
MJ Santner,NZ,Spin,2016-09-22,Kanpur,India,2016,2,173,332,5,1,859,1714,26,686,1382,21,33.03846153846154,>30,IND,Away,After 1965
MJ Santner,NZ,Spin,2016-09-30,Eden Gardens,India,2016,2,143,234,4,1,455,834,14,312,600,10,32.5,>30,IND,Away,After 1965
MJ Santner,NZ,Spin,2016-10-08,Indore,India,2016,2,208,366,1,1,676,1243,22,468,877,21,30.727272727272727,>30,IND,Away,After 1965
MJ Santner,NZ,Spin,2016-11-25,Hamilton,New Zealand,2016,2,62,120,2,1,91,174,2,29,54,0,45.5,>30,NZ,Home,After 1965
MJ Santner,NZ,Spin,2017-01-12,Wellington,New Zealand,2017,2,98,198,2,1,423,748,8,325,550,6,52.875,>30,NZ,Home,After 1965
MJ Santner,NZ,Spin,2017-03-08,Dunedin,New Zealand,2017,2,69,222,1,1,338,837,10,269,615,9,33.8,>30,NZ,Home,After 1965
MJ Santner,NZ,Spin,2017-03-25,Hamilton,New Zealand,2017,2,31,72,1,1,252,528,5,221,456,4,50.4,>30,NZ,Home,After 1965
MJ Santner,NZ,Spin,2017-12-01,Wellington,New Zealand,2017,1,25,102,1,1,166,328,3,141,226,2,55.333333333333336,>30,NZ,Home,After 1965
MJ Santner,NZ,Spin,2017-12-09,Hamilton,New Zealand,2017,1,13,29,2,1,199,291,4,186,262,2,49.75,>30,NZ,Home,After 1965
MJ Santner,NZ,Spin,2019-08-14,Galle,Sri Lanka,2019,2,69,144,0,1,786,1622,23,717,1478,23,34.17391304347826,>30,SL,Away,After 1965
MJ Santner,NZ,Spin,2019-11-21,Mount Maunganui,New Zealand,2019,2,77,276,3,1,303,672,6,226,396,3,50.5,>30,NZ,Home,After 1965
MJ Santner,NZ,Spin,2019-11-29,Hamilton,New Zealand,2019,1,88,210,1,1,165,324,1,77,114,0,165.0,>30,NZ,Home,After 1965
MJ Santner,NZ,Spin,2019-12-12,Perth,Australia,2019,2,146,246,0,1,325,635,8,179,389,8,40.625,>30,AUS,Away,After 1965
MJ Santner,NZ,Spin,2019-12-26,Melbourne,Australia,2019,2,104,168,1,1,244,396,6,140,228,5,40.666666666666664,>30,AUS,Away,After 1965
MJ Santner,NZ,Spin,2020-12-26,Mount Maunganui,New Zealand,2020,2,59,153,2,1,211,453,5,152,300,3,42.2,>30,NZ,Home,After 1965
MJ Santner,NZ,Spin,2021-06-02,Lord's,England,2021,2,68,138,0,1,134,256,1,66,118,1,134.0,>30,ENG,Away,After 1965
MJ Santner,NZ,Spin,2023-12-06,Mirpur,Bangladesh,2023,2,116,234,6,1,542,923,30,426,689,24,18.066666666666666,<=30,BAN,Away,After 1965
MJ Santner,NZ,Spin,2024-02-04,Mount Maunganui,New Zealand,2024,2,93,282,6,1,328,671,17,235,389,11,19.294117647058822,<=30,NZ,Home,After 1965
MJ Santner,NZ,Spin,2024-09-18,Galle,Sri Lanka,2024,2,115,200,1,1,849,1559,29,734,1359,28,29.275862068965516,<=30,SL,Away,After 1965
MJ Santner,NZ,Spin,2024-09-26,Galle,Sri Lanka,2024,1,82,198,0,1,824,1411,22,742,1213,22,37.45454545454545,>30,SL,Away,After 1965
MJ Santner,NZ,Spin,2024-10-24,Pune,India,2024,2,157,291,13,1,741,1336,37,584,1045,24,20.027027027027028,<=30,IND,Away,After 1965
MJ Santner,NZ,Spin,2024-12-14,Hamilton,New Zealand,2024,2,92,104,7,1,463,592,15,371,488,8,30.866666666666667,>30,NZ,Home,After 1965
MJ Slater,AUS,Pace,1994-10-05,Rawalpindi,Pakistan,1994,1,4,7,1,1,838,1506,23,834,1499,22,36.43478260869565,>30,PAK,Away,Upto 2014
MJ Slater,AUS,Pace,2000-01-02,Sydney,Australia,2000,1,2,6,0,1,643,1127,22,641,1121,22,29.227272727272727,<=30,AUS,Home,Upto 2014
MJ Slater,AUS,Pace,2001-03-11,Eden Gardens,India,2001,1,4,12,0,1,800,1488,16,796,1476,16,50.0,>30,IND,Away,Upto 2014
MJ Swepson,AUS,Spin,2022-03-12,Karachi,Pakistan,2022,2,188,376,2,1,673,1474,11,485,1098,9,61.18181818181818,>30,PAK,Away,After 1965
MJ Swepson,AUS,Spin,2022-03-21,Lahore,Pakistan,2022,2,78,168,0,1,557,1146,9,479,978,9,61.888888888888886,>30,PAK,Away,After 1965
MJ Swepson,AUS,Spin,2022-06-29,Galle,Sri Lanka,2022,2,89,120,5,1,491,729,25,402,609,20,19.64,<=30,SL,Away,After 1965
MJ Swepson,AUS,Spin,2022-07-08,Galle,Sri Lanka,2022,1,103,228,3,1,757,1422,23,654,1194,20,32.91304347826087,>30,SL,Away,After 1965
MJC Allom,ENG,Pace,1930-01-10,Christchurch,New Zealand,1930,2,55,204,8,1,310,868,23,255,664,15,13.478260869565217,<=30,NZ,Away,Upto 2014
MJC Allom,ENG,Pace,1930-01-24,Wellington,New Zealand,1930,2,94,204,1,1,569,1265,15,475,1061,14,37.93333333333333,>30,NZ,Away,Upto 2014
MJC Allom,ENG,Pace,1930-02-14,Auckland,New Zealand,1930,1,3,36,0,1,146,336,1,143,300,1,146.0,>30,NZ,Away,Upto 2014
MJC Allom,ENG,Pace,1930-02-21,Auckland,New Zealand,1930,1,42,157,4,1,366,961,11,324,804,7,33.27272727272727,>30,NZ,Away,Upto 2014
MJC Allom,ENG,Pace,1931-01-16,Durban,South Africa,1931,2,71,216,1,1,276,836,9,205,620,8,30.666666666666668,>30,SA,Away,Upto 2014
MJF Shrimpton,NZ,Spin,1966-03-11,Auckland,New Zealand,1966,1,1,12,0,1,300,776,10,299,764,10,30.0,<=30,NZ,Home,Upto 2014
MJF Shrimpton,NZ,Spin,1971-02-25,Christchurch,New Zealand,1971,2,56,117,3,1,395,1134,21,339,1017,18,18.80952380952381,<=30,NZ,Home,Upto 2014
MJF Shrimpton,NZ,Spin,1971-03-05,Auckland,New Zealand,1971,2,62,72,0,1,315,824,7,253,752,7,45.0,>30,NZ,Home,Upto 2014
MJF Shrimpton,NZ,Spin,1973-12-29,Melbourne,Australia,1973,1,39,56,2,1,322,917,12,283,861,10,26.833333333333332,<=30,AUS,Away,Upto 2014
MJK Smith,ENG,Spin,1960-03-25,Port of Spain,West Indies,1960,1,15,6,0,1,649,1404,16,634,1398,16,40.5625,>30,WI,Away,Upto 2014
MJK Smith,ENG,Spin,1961-11-11,Brabourne,India,1961,1,10,48,1,1,727,1890,18,717,1842,17,40.388888888888886,>30,IND,Away,Upto 2014
MJK Smith,ENG,Spin,1964-02-08,Delhi,India,1964,1,52,78,0,1,1001,2631,20,949,2553,20,50.05,>30,IND,Away,Upto 2014
MJK Smith,ENG,Spin,1965-01-01,Cape Town,South Africa,1965,1,43,66,0,1,605,1499,14,562,1433,14,43.214285714285715,>30,SA,Away,Upto 2014
MJK Smith,ENG,Spin,1965-12-30,Melbourne,Australia,1965,1,8,16,0,1,661,1476,9,653,1460,9,73.44444444444444,>30,AUS,Away,Upto 2014
MK Elgie,SA,Spin,1961-12-26,Johannesburg,South Africa,1961,1,28,24,0,1,298,572,6,270,548,6,49.666666666666664,>30,SA,Home,Upto 2014
MK Elgie,SA,Spin,1962-01-01,Cape Town,South Africa,1962,1,18,42,0,1,569,1566,23,551,1524,23,24.73913043478261,<=30,SA,Home,Upto 2014
MKDI Amerasinghe,SL,Pace,2008-04-03,Port of Spain,West Indies,2008,2,105,150,1,1,851,1278,24,746,1128,23,35.458333333333336,>30,WI,Away,Upto 2014
MKGCP Lakshitha,SL,Pace,2002-07-28,Colombo (SSC),Sri Lanka,2002,2,81,144,3,1,518,934,16,437,790,13,32.375,>30,SL,Home,Upto 2014
MKGCP Lakshitha,SL,Pace,2002-11-15,Centurion,South Africa,2002,2,77,144,2,1,905,1840,32,828,1696,30,28.28125,<=30,SA,Away,Upto 2014
ML Apte,IND,Spin,1953-02-19,Port of Spain,West Indies,1953,1,3,6,0,1,777,2186,14,774,2180,14,55.5,>30,WI,Away,Upto 2014
ML Cummins,WI,Pace,2016-07-30,Kingston,West Indies,2016,1,87,160,0,1,509,984,9,422,824,9,56.55555555555556,>30,WI,Home,After 1965
ML Cummins,WI,Pace,2016-08-09,Gros Islet,West Indies,2016,2,102,196,9,1,570,1190,26,468,994,17,21.923076923076923,<=30,WI,Home,After 1965
ML Cummins,WI,Pace,2016-10-13,Dubai (DICS),UAE,2016,2,128,192,0,1,642,1209,9,514,1017,9,71.33333333333333,>30,UAE,Away,After 1965
ML Cummins,WI,Pace,2016-10-21,Abu Dhabi,UAE,2016,2,91,162,1,1,485,1009,16,394,847,15,30.3125,>30,UAE,Away,After 1965
ML Cummins,WI,Pace,2017-08-17,Birmingham,England,2017,1,87,144,1,1,610,1081,19,523,937,18,32.10526315789474,>30,ENG,Away,After 1965
ML Cummins,WI,Pace,2017-12-01,Wellington,New Zealand,2017,1,92,162,2,1,782,1474,25,690,1312,23,31.28,>30,NZ,Away,After 1965
ML Cummins,WI,Pace,2017-12-09,Hamilton,New Zealand,2017,2,126,222,5,1,876,1573,33,750,1351,28,26.545454545454547,<=30,NZ,Away,After 1965
ML Cummins,WI,Pace,2018-06-06,Port of Spain,West Indies,2018,2,62,148,3,1,624,1324,21,562,1176,18,29.714285714285715,<=30,WI,Home,After 1965
ML Cummins,WI,Pace,2018-06-14,Gros Islet,West Indies,2018,2,113,192,0,1,739,1498,33,626,1306,33,22.393939393939394,<=30,WI,Home,After 1965
ML Cummins,WI,Pace,2018-06-23,Bridgetown,West Indies,2018,2,46,126,0,1,501,1108,32,455,982,32,15.65625,<=30,WI,Home,After 1965
ML Cummins,WI,Pace,2018-07-04,North Sound,West Indies,2018,2,27,68,5,1,363,699,24,336,631,19,15.125,<=30,WI,Home,After 1965
ML Cummins,WI,Pace,2018-07-12,Kingston,West Indies,2018,2,54,84,1,1,360,661,22,306,577,21,16.363636363636363,<=30,WI,Home,After 1965
ML Cummins,WI,Pace,2019-08-22,North Sound,West Indies,2019,2,69,120,0,1,576,1302,29,507,1182,29,19.862068965517242,<=30,WI,Home,After 1965
ML Hayden,AUS,Pace,2000-12-01,W.A.C.A,Australia,2000,1,9,12,0,1,637,1158,23,628,1146,23,27.695652173913043,<=30,AUS,Home,Upto 2014
ML Hayden,AUS,Pace,2001-03-11,Eden Gardens,India,2001,1,24,36,0,1,800,1488,16,776,1452,16,50.0,>30,IND,Away,Upto 2014
ML Hayden,AUS,Pace,2001-03-18,Chennai,India,2001,1,7,6,0,1,331,733,10,324,727,10,33.1,>30,IND,Away,Upto 2014
ML Jaisimha,IND,Spin,1959-06-18,Lord's,England,1959,1,8,6,0,1,208,491,11,200,485,11,18.90909090909091,<=30,ENG,Away,Upto 2014
ML Jaisimha,IND,Spin,1960-01-23,Eden Gardens,India,1960,2,30,60,0,1,425,1054,13,395,994,13,32.69230769230769,>30,IND,Home,Upto 2014
ML Jaisimha,IND,Spin,1960-12-16,Kanpur,India,1960,1,5,18,0,1,619,1984,16,614,1966,16,38.6875,>30,IND,Home,Upto 2014
ML Jaisimha,IND,Spin,1961-01-13,Chennai,India,1961,1,8,18,0,1,664,1638,11,656,1620,11,60.36363636363637,>30,IND,Home,Upto 2014
ML Jaisimha,IND,Spin,1961-12-01,Kanpur,India,1961,1,8,36,0,1,792,2016,16,784,1980,16,49.5,>30,IND,Home,Upto 2014
ML Jaisimha,IND,Spin,1961-12-13,Delhi,India,1961,1,28,66,0,1,505,1242,8,477,1176,8,63.125,>30,IND,Home,Upto 2014
ML Jaisimha,IND,Spin,1962-01-10,Chennai,India,1962,1,18,30,0,1,866,2320,33,848,2290,33,26.242424242424242,<=30,IND,Home,Upto 2014
ML Jaisimha,IND,Spin,1962-03-23,Bridgetown,West Indies,1962,1,6,6,0,1,596,2431,22,590,2425,22,27.09090909090909,<=30,WI,Away,Upto 2014
ML Jaisimha,IND,Spin,1962-04-04,Port of Spain,West Indies,1962,2,66,132,1,1,911,2452,24,845,2320,23,37.958333333333336,>30,WI,Away,Upto 2014
ML Jaisimha,IND,Spin,1962-04-13,Kingston,West Indies,1962,1,7,24,0,1,527,1208,20,520,1184,20,26.35,<=30,WI,Away,Upto 2014
ML Jaisimha,IND,Spin,1964-01-10,Chennai,India,1964,2,24,66,0,1,876,2493,27,852,2427,27,32.44444444444444,>30,IND,Home,Upto 2014
ML Jaisimha,IND,Spin,1964-01-21,Brabourne,India,1964,2,45,150,1,1,560,2208,16,515,2058,15,35.0,>30,IND,Home,Upto 2014
ML Jaisimha,IND,Spin,1964-01-29,Eden Gardens,India,1964,2,42,102,0,1,555,1794,16,513,1692,16,34.6875,>30,IND,Home,Upto 2014
ML Jaisimha,IND,Spin,1964-02-08,Delhi,India,1964,1,14,24,0,1,1001,2631,20,987,2607,20,50.05,>30,IND,Home,Upto 2014
ML Jaisimha,IND,Spin,1964-02-15,Kanpur,India,1964,1,54,114,2,1,987,2874,18,933,2760,16,54.833333333333336,>30,IND,Home,Upto 2014
ML Jaisimha,IND,Spin,1964-10-02,Chennai,India,1964,2,26,78,0,1,735,1918,23,709,1840,23,31.956521739130434,>30,IND,Home,Upto 2014
ML Jaisimha,IND,Spin,1964-10-10,Brabourne,India,1964,2,38,114,0,1,796,2173,26,758,2059,26,30.615384615384617,>30,IND,Home,Upto 2014
ML Jaisimha,IND,Spin,1964-10-17,Eden Gardens,India,1964,2,6,42,0,1,407,1253,16,401,1211,16,25.4375,<=30,IND,Home,Upto 2014
ML Jaisimha,IND,Spin,1965-02-27,Chennai,India,1965,2,38,96,1,1,616,1705,17,578,1609,16,36.23529411764706,>30,IND,Home,Upto 2014
ML Jaisimha,IND,Spin,1965-03-05,Eden Gardens,India,1965,2,94,211,1,1,632,1531,17,538,1320,16,37.1764705882353,>30,IND,Home,Upto 2014
ML Jaisimha,IND,Spin,1965-03-12,Brabourne,India,1965,2,57,138,1,1,545,1316,11,488,1178,10,49.54545454545455,>30,IND,Home,Upto 2014
ML Jaisimha,IND,Spin,1965-03-19,Delhi,India,1965,2,14,36,0,1,716,1840,21,702,1804,21,34.095238095238095,>30,IND,Home,Upto 2014
ML Jaisimha,IND,Spin,1966-12-13,Brabourne,India,1966,2,8,18,0,1,1023,2319,28,1015,2301,28,36.535714285714285,>30,IND,Home,Upto 2014
ML Jaisimha,IND,Spin,1966-12-31,Eden Gardens,India,1966,1,11,36,1,1,445,1335,20,434,1299,19,22.25,<=30,IND,Home,Upto 2014
ML Jaisimha,IND,Spin,1968-01-19,Brisbane,Australia,1968,1,6,8,0,1,711,2018,22,705,2010,22,32.31818181818182,>30,AUS,Away,Upto 2014
ML Jaisimha,IND,Spin,1968-01-26,Sydney,Australia,1968,2,11,24,1,1,552,1735,27,541,1711,26,20.444444444444443,<=30,AUS,Away,Upto 2014
ML Jaisimha,IND,Spin,1968-02-22,Christchurch,New Zealand,1968,2,15,30,0,1,599,1533,16,584,1503,16,37.4375,>30,NZ,Away,Upto 2014
ML Jaisimha,IND,Spin,1968-02-29,Wellington,New Zealand,1968,2,44,162,0,1,408,1093,20,364,931,20,20.4,<=30,NZ,Away,Upto 2014
ML Jaisimha,IND,Spin,1968-03-07,Auckland,New Zealand,1968,2,19,60,0,1,303,1079,19,284,1019,19,15.947368421052632,<=30,NZ,Away,Upto 2014
ML Jaisimha,IND,Spin,1969-10-15,Hyderabad (Deccan),India,1969,2,15,48,0,1,301,978,13,286,930,13,23.153846153846153,<=30,IND,Home,Upto 2014
ML Jaisimha,IND,Spin,1971-02-18,Kingston,West Indies,1971,1,32,78,0,1,757,1901,17,725,1823,17,44.529411764705884,>30,WI,Away,Upto 2014
ML Jaisimha,IND,Spin,1971-04-01,Bridgetown,West Indies,1971,1,32,60,0,1,692,1614,11,660,1554,11,62.90909090909091,>30,WI,Away,Upto 2014
ML Jaisimha,IND,Spin,1971-04-13,Port of Spain,West Indies,1971,1,0,6,0,1,963,2470,24,963,2464,24,40.125,>30,WI,Away,Upto 2014
ML Nkala,ZIM,Pace,2000-06-01,Nottingham,England,2000,2,104,252,5,1,655,1521,23,551,1269,18,28.47826086956522,<=30,ENG,Away,Upto 2014
ML Nkala,ZIM,Pace,2000-09-12,Bulawayo,Zimbabwe,2000,2,45,138,0,1,470,1291,13,425,1153,13,36.15384615384615,>30,ZIM,Home,Upto 2014
ML Nkala,ZIM,Pace,2000-09-19,Harare,Zimbabwe,2000,2,77,108,1,1,838,2129,25,761,2021,24,33.52,>30,ZIM,Home,Upto 2014
ML Nkala,ZIM,Pace,2000-11-25,Nagpur,India,2000,1,86,132,0,1,629,1195,8,543,1063,8,78.625,>30,IND,Away,Upto 2014
ML Nkala,ZIM,Pace,2001-04-19,Bulawayo,Zimbabwe,2001,2,79,132,1,1,731,1458,26,652,1326,25,28.115384615384617,<=30,ZIM,Home,Upto 2014
ML Nkala,ZIM,Pace,2001-04-26,Harare,Zimbabwe,2001,2,41,150,0,1,669,1497,14,628,1347,14,47.785714285714285,>30,ZIM,Home,Upto 2014
ML Nkala,ZIM,Pace,2002-11-16,Bulawayo,Zimbabwe,2002,1,93,150,1,1,555,1011,16,462,861,15,34.6875,>30,ZIM,Home,Upto 2014
ML Nkala,ZIM,Pace,2004-05-06,Harare,Zimbabwe,2004,1,41,42,0,1,612,996,20,571,954,20,30.6,>30,ZIM,Home,Upto 2014
ML Nkala,ZIM,Pace,2004-05-14,Bulawayo,Zimbabwe,2004,1,111,192,1,1,856,1362,13,745,1170,12,65.84615384615384,>30,ZIM,Home,Upto 2014
ML Nkala,ZIM,Pace,2005-01-06,Chattogram,Bangladesh,2005,1,50,156,2,1,681,1423,24,631,1267,22,28.375,<=30,BAN,Away,Upto 2014
ML Page,NZ,Spin,1930-01-10,Christchurch,New Zealand,1930,1,3,12,1,1,139,270,9,136,258,8,15.444444444444445,<=30,NZ,Home,Upto 2014
ML Page,NZ,Spin,1930-01-24,Wellington,New Zealand,1930,1,8,12,0,1,379,753,13,371,741,13,29.153846153846153,<=30,NZ,Home,Upto 2014
ML Page,NZ,Spin,1930-02-14,Auckland,New Zealand,1930,1,16,30,0,1,274,396,3,258,366,3,91.33333333333333,>30,NZ,Home,Upto 2014
ML Page,NZ,Spin,1930-02-21,Auckland,New Zealand,1930,1,36,88,1,1,488,1141,10,452,1053,9,48.8,>30,NZ,Home,Upto 2014
ML Page,NZ,Spin,1931-06-27,Lord's,England,1931,1,18,18,0,1,753,1396,20,735,1378,20,37.65,>30,ENG,Away,Upto 2014
ML Page,NZ,Spin,1932-02-27,Christchurch,New Zealand,1932,1,27,36,0,1,356,669,15,329,633,15,23.733333333333334,<=30,NZ,Home,Upto 2014
ML Page,NZ,Spin,1932-03-04,Wellington,New Zealand,1932,2,44,84,1,1,627,1075,19,583,991,18,33.0,>30,NZ,Home,Upto 2014
ML Page,NZ,Spin,1933-03-24,Christchurch,New Zealand,1933,1,21,15,2,1,316,759,7,295,744,5,45.142857142857146,>30,NZ,Home,Upto 2014
ML Page,NZ,Spin,1933-03-31,Auckland,New Zealand,1933,1,30,36,0,1,345,534,4,315,498,4,86.25,>30,NZ,Home,Upto 2014
ML Page,NZ,Spin,1937-06-26,Lord's,England,1937,1,12,18,0,1,512,1098,11,500,1080,11,46.54545454545455,>30,ENG,Away,Upto 2014
ML Page,NZ,Spin,1937-07-24,Manchester,England,1937,1,16,30,0,1,559,1166,19,543,1136,19,29.42105263157895,<=30,ENG,Away,Upto 2014
ML Su'a,NZ,Pace,1992-01-30,Auckland,New Zealand,1992,2,87,186,3,1,740,1678,33,653,1492,30,22.424242424242426,<=30,NZ,Home,Upto 2014
ML Su'a,NZ,Pace,1992-02-06,Wellington,New Zealand,1992,2,149,414,5,1,603,1369,15,454,955,10,40.2,>30,NZ,Home,Upto 2014
ML Su'a,NZ,Pace,1992-11-01,Bulawayo,Zimbabwe,1992,2,27,91,2,1,481,878,7,454,787,5,68.71428571428571,>30,ZIM,Away,Upto 2014
ML Su'a,NZ,Pace,1992-11-07,Harare,Zimbabwe,1992,2,115,294,6,1,623,1378,20,508,1084,14,31.15,>30,ZIM,Away,Upto 2014
ML Su'a,NZ,Pace,1992-11-27,Moratuwa,Sri Lanka,1992,1,62,150,2,1,602,1223,13,540,1073,11,46.30769230769231,>30,SL,Away,Upto 2014
ML Su'a,NZ,Pace,1992-12-06,Colombo (SSC),Sri Lanka,1992,2,64,168,2,1,402,864,12,338,696,10,33.5,>30,SL,Away,Upto 2014
ML Su'a,NZ,Pace,1993-01-02,Hamilton,New Zealand,1993,2,120,222,7,1,500,1200,33,380,978,26,15.151515151515152,<=30,NZ,Home,Upto 2014
ML Su'a,NZ,Pace,1993-02-25,Christchurch,New Zealand,1993,1,106,198,1,1,651,1526,21,545,1328,20,31.0,>30,NZ,Home,Upto 2014
ML Su'a,NZ,Pace,1993-03-12,Auckland,New Zealand,1993,2,83,192,1,1,620,1465,22,537,1273,21,28.181818181818183,<=30,NZ,Home,Upto 2014
ML Su'a,NZ,Pace,1993-11-12,W.A.C.A,Australia,1993,2,143,239,2,1,942,1817,19,799,1578,17,49.578947368421055,>30,AUS,Away,Upto 2014
ML Su'a,NZ,Pace,1993-11-26,Hobart,Australia,1993,1,102,144,1,1,577,1014,7,475,870,6,82.42857142857143,>30,AUS,Away,Upto 2014
ML Su'a,NZ,Pace,1995-02-10,Wellington,New Zealand,1995,1,179,264,0,1,598,1142,20,419,878,20,29.9,<=30,NZ,Home,Upto 2014
ML Su'a,NZ,Pace,1995-03-18,Dunedin,New Zealand,1995,2,140,281,4,1,657,1600,18,517,1319,14,36.5,>30,NZ,Home,Upto 2014
MLC Foster,WI,Spin,1969-06-12,Manchester,England,1969,1,7,12,0,1,322,1014,6,315,1002,6,53.666666666666664,>30,ENG,Away,Upto 2014
MLC Foster,WI,Spin,1971-04-01,Bridgetown,West Indies,1971,2,38,150,0,1,692,1614,11,654,1464,11,62.90909090909091,>30,WI,Home,Upto 2014
MLC Foster,WI,Spin,1971-04-13,Port of Spain,West Indies,1971,2,14,84,1,1,963,2470,24,949,2386,23,40.125,>30,WI,Home,Upto 2014
MLC Foster,WI,Spin,1972-02-16,Kingston,West Indies,1972,2,32,138,0,1,653,1794,11,621,1656,11,59.36363636363637,>30,WI,Home,Upto 2014
MLC Foster,WI,Spin,1972-03-09,Port of Spain,West Indies,1972,2,21,96,1,1,722,2183,14,701,2087,13,51.57142857142857,>30,WI,Home,Upto 2014
MLC Foster,WI,Spin,1972-03-23,Bridgetown,West Indies,1972,1,40,84,0,1,454,1224,7,414,1140,7,64.85714285714286,>30,WI,Home,Upto 2014
MLC Foster,WI,Spin,1973-02-16,Kingston,West Indies,1973,2,155,396,1,1,500,1086,7,345,690,6,71.42857142857143,>30,WI,Home,Upto 2014
MLC Foster,WI,Spin,1973-03-09,Bridgetown,West Indies,1973,2,64,168,1,1,470,1314,10,406,1146,9,47.0,>30,WI,Home,Upto 2014
MLC Foster,WI,Spin,1973-03-23,Port of Spain,West Indies,1973,1,12,36,0,1,758,1913,26,746,1877,26,29.153846153846153,<=30,WI,Home,Upto 2014
MLC Foster,WI,Spin,1973-04-21,Port of Spain,West Indies,1973,2,18,66,1,1,694,1730,21,676,1664,20,33.04761904761905,>30,WI,Home,Upto 2014
MLC Foster,WI,Spin,1973-08-23,Lord's,England,1973,1,2,6,0,1,503,859,9,501,853,9,55.888888888888886,>30,ENG,Away,Upto 2014
MLC Foster,WI,Spin,1974-03-22,Georgetown,West Indies,1974,1,32,96,0,1,367,917,8,335,821,8,45.875,>30,WI,Home,Upto 2014
MLC Foster,WI,Spin,1977-02-18,Bridgetown,West Indies,1977,2,75,210,3,1,180,418,4,105,208,1,45.0,>30,WI,Home,Upto 2014
MLC Foster,WI,Spin,1978-04-28,Kingston,West Indies,1978,2,90,234,1,1,606,1484,19,516,1250,18,31.894736842105264,>30,WI,Home,Upto 2014
MM Ali,ENG,Spin,2014-06-12,Lord's,England,2014,2,91,168,1,1,336,573,6,245,405,5,56.0,>30,ENG,Home,After 1965
MM Ali,ENG,Spin,2014-06-20,Leeds,England,2014,2,90,144,2,1,219,552,5,129,408,3,43.8,>30,ENG,Home,After 1965
MM Ali,ENG,Spin,2014-07-09,Nottingham,England,2014,2,202,276,4,1,324,594,5,122,318,1,64.8,>30,ENG,Home,After 1965
MM Ali,ENG,Spin,2014-07-17,Lord's,England,2014,2,66,150,3,1,190,511,7,124,361,4,27.142857142857142,<=30,ENG,Home,After 1965
MM Ali,ENG,Spin,2014-07-27,Southampton,England,2014,2,129,232,8,1,407,690,15,278,458,7,27.133333333333333,<=30,ENG,Home,After 1965
MM Ali,ENG,Spin,2014-08-07,Manchester,England,2014,1,39,78,4,1,104,243,5,65,165,1,20.8,<=30,ENG,Home,After 1965
MM Ali,ENG,Spin,2014-08-15,The Oval,England,2014,1,1,6,0,1,73,135,3,72,129,3,24.333333333333332,<=30,ENG,Home,After 1965
MM Ali,ENG,Spin,2015-04-21,St George's,West Indies,2015,2,98,226,4,1,451,913,9,353,687,5,50.111111111111114,>30,WI,Away,After 1965
MM Ali,ENG,Spin,2015-05-01,Bridgetown,West Indies,2015,2,110,136,2,1,352,610,8,242,474,6,44.0,>30,WI,Away,After 1965
MM Ali,ENG,Spin,2015-05-21,Lord's,England,2015,2,129,204,4,1,317,528,7,188,324,3,45.285714285714285,>30,ENG,Home,After 1965
MM Ali,ENG,Spin,2015-05-29,Leeds,England,2015,2,121,162,1,1,285,593,9,164,431,8,31.666666666666668,>30,ENG,Home,After 1965
MM Ali,ENG,Spin,2015-07-08,Cardiff,England,2015,2,130,189,5,1,311,478,13,181,289,8,23.923076923076923,<=30,ENG,Home,After 1965
MM Ali,ENG,Spin,2015-07-16,Lord's,England,2015,2,216,312,3,1,392,582,8,176,270,5,49.0,>30,ENG,Home,After 1965
MM Ali,ENG,Spin,2015-07-29,Birmingham,England,2015,1,64,97,1,1,159,256,4,95,159,3,39.75,>30,ENG,Home,After 1965
MM Ali,ENG,Spin,2015-08-06,Nottingham,England,2015,1,34,36,0,1,99,114,0,65,78,0,inf,>30,ENG,Home,After 1965
MM Ali,ENG,Spin,2015-08-20,The Oval,England,2015,1,102,108,3,1,215,360,8,113,252,5,26.875,<=30,ENG,Home,After 1965
MM Ali,ENG,Spin,2015-10-13,Abu Dhabi,UAE,2015,2,149,222,2,1,740,1307,14,591,1085,12,52.857142857142854,>30,UAE,Away,After 1965
MM Ali,ENG,Spin,2015-10-22,Dubai (DICS),UAE,2015,2,168,216,4,1,700,1353,17,532,1137,13,41.1764705882353,>30,UAE,Away,After 1965
MM Ali,ENG,Spin,2015-11-01,Sharjah,UAE,2015,2,121,206,3,1,743,1504,24,622,1298,21,30.958333333333332,>30,UAE,Away,After 1965
MM Ali,ENG,Spin,2015-12-26,Durban,South Africa,2015,2,116,306,7,1,402,738,13,286,432,6,30.923076923076923,>30,SA,Away,After 1965
MM Ali,ENG,Spin,2016-01-02,Cape Town,South Africa,2016,1,155,312,0,1,386,750,3,231,438,3,128.66666666666666,>30,SA,Away,After 1965
MM Ali,ENG,Spin,2016-01-14,Johannesburg,South Africa,2016,1,50,96,1,1,60,118,3,10,22,2,20.0,<=30,SA,Away,After 1965
MM Ali,ENG,Spin,2016-01-22,Centurion,South Africa,2016,2,164,252,2,1,309,534,4,145,282,2,77.25,>30,SA,Away,After 1965
MM Ali,ENG,Spin,2016-05-19,Leeds,England,2016,1,2,6,1,1,27,75,3,25,69,2,9.0,<=30,ENG,Home,After 1965
MM Ali,ENG,Spin,2016-05-27,Chester-le-Street,England,2016,2,136,192,1,1,355,530,5,219,338,4,71.0,>30,ENG,Home,After 1965
MM Ali,ENG,Spin,2016-06-09,Lord's,England,2016,2,42,96,0,1,192,434,4,150,338,4,48.0,>30,ENG,Home,After 1965
MM Ali,ENG,Spin,2016-07-14,Lord's,England,2016,2,95,120,2,1,236,480,12,141,360,10,19.666666666666668,<=30,ENG,Home,After 1965
MM Ali,ENG,Spin,2016-07-22,Manchester,England,2016,2,131,158,5,1,470,620,7,339,462,2,67.14285714285714,>30,ENG,Home,After 1965
MM Ali,ENG,Spin,2016-08-03,Birmingham,England,2016,2,128,209,2,1,391,671,5,263,462,3,78.2,>30,ENG,Home,After 1965
MM Ali,ENG,Spin,2016-08-11,The Oval,England,2016,2,158,173,2,1,324,517,8,166,344,6,40.5,>30,ENG,Home,After 1965
MM Ali,ENG,Spin,2016-10-20,Chattogram,Bangladesh,2016,2,135,216,5,1,760,1579,30,625,1363,25,25.333333333333332,<=30,BAN,Away,After 1965
MM Ali,ENG,Spin,2016-10-28,Mirpur,Bangladesh,2016,2,117,233,6,1,691,1258,32,574,1025,26,21.59375,<=30,BAN,Away,After 1965
MM Ali,ENG,Spin,2016-11-09,Rajkot,India,2016,2,132,300,3,1,954,1677,22,822,1377,19,43.36363636363637,>30,IND,Away,After 1965
MM Ali,ENG,Spin,2016-11-17,Visakhapatnam,India,2016,2,107,169,4,1,632,1483,25,525,1314,21,25.28,<=30,IND,Away,After 1965
MM Ali,ENG,Spin,2016-11-26,Mohali,India,2016,2,46,96,0,1,572,1216,17,526,1120,17,33.64705882352941,>30,IND,Away,After 1965
MM Ali,ENG,Spin,2016-12-08,Wankhede,India,2016,1,174,318,2,1,864,1639,27,690,1321,25,32.0,>30,IND,Away,After 1965
MM Ali,ENG,Spin,2016-12-16,Chennai,India,2016,1,190,246,1,1,966,1770,17,776,1524,16,56.8235294117647,>30,IND,Away,After 1965
MM Ali,ENG,Spin,2017-07-06,Lord's,England,2017,2,112,210,10,1,426,749,18,314,539,8,23.666666666666668,<=30,ENG,Home,After 1965
MM Ali,ENG,Spin,2017-07-14,Nottingham,England,2017,2,99,144,4,1,230,384,11,131,240,7,20.90909090909091,<=30,ENG,Home,After 1965
MM Ali,ENG,Spin,2017-07-27,The Oval,England,2017,2,54,127,4,1,198,330,8,144,203,4,24.75,<=30,ENG,Home,After 1965
MM Ali,ENG,Spin,2017-08-04,Manchester,England,2017,2,126,245,7,1,291,609,10,165,364,3,29.1,<=30,ENG,Home,After 1965
MM Ali,ENG,Spin,2017-08-17,Birmingham,England,2017,2,69,96,3,1,188,290,7,119,194,4,26.857142857142858,<=30,ENG,Home,After 1965
MM Ali,ENG,Spin,2017-08-25,Leeds,England,2017,2,160,294,2,1,415,774,7,255,480,5,59.285714285714285,>30,ENG,Home,After 1965
MM Ali,ENG,Spin,2017-09-07,Lord's,England,2017,2,19,36,0,1,84,138,1,65,102,1,84.0,>30,ENG,Home,After 1965
MM Ali,ENG,Spin,2017-11-23,Brisbane,Australia,2017,2,97,204,2,1,277,645,8,180,441,6,34.625,>30,AUS,Away,After 1965
MM Ali,ENG,Spin,2017-12-02,Adelaide,Australia,2017,2,99,174,0,1,220,493,6,121,319,6,36.666666666666664,>30,AUS,Away,After 1965
MM Ali,ENG,Spin,2017-12-14,W.A.C.A,Australia,2017,1,120,198,1,1,269,492,4,149,294,3,67.25,>30,AUS,Away,After 1965
MM Ali,ENG,Spin,2017-12-26,Melbourne,Australia,2017,2,89,152,0,1,251,518,4,162,366,4,62.75,>30,AUS,Away,After 1965
MM Ali,ENG,Spin,2018-01-04,Sydney,Australia,2018,1,170,288,2,1,530,1068,7,360,780,5,75.71428571428571,>30,AUS,Away,After 1965
MM Ali,ENG,Spin,2018-03-22,Auckland,New Zealand,2018,1,59,102,0,1,112,223,4,53,121,4,28.0,<=30,NZ,Away,After 1965
MM Ali,ENG,Spin,2018-08-30,Southampton,England,2018,2,134,252,9,1,298,647,12,164,395,3,24.833333333333332,<=30,ENG,Home,After 1965
MM Ali,ENG,Spin,2018-09-07,The Oval,England,2018,2,118,204,3,1,513,915,16,395,711,13,32.0625,>30,ENG,Home,After 1965
MM Ali,ENG,Spin,2018-11-06,Galle,Sri Lanka,2018,2,137,246,8,1,876,1627,28,739,1381,20,31.285714285714285,>30,SL,Away,After 1965
MM Ali,ENG,Spin,2018-11-14,Pallekele,Sri Lanka,2018,2,157,264,6,1,1031,1760,38,874,1496,32,27.13157894736842,<=30,SL,Away,After 1965
MM Ali,ENG,Spin,2018-11-23,Colombo (SSC),Sri Lanka,2018,2,147,234,4,1,913,1615,34,766,1381,30,26.852941176470587,<=30,SL,Away,After 1965
MM Ali,ENG,Spin,2019-01-23,Bridgetown,West Indies,2019,2,137,192,4,1,371,593,12,234,401,8,30.916666666666668,>30,WI,Away,After 1965
MM Ali,ENG,Spin,2019-01-31,North Sound,West Indies,2019,1,62,150,3,1,94,204,3,32,54,0,31.333333333333332,>30,WI,Away,After 1965
MM Ali,ENG,Spin,2019-02-09,Gros Islet,West Indies,2019,2,135,216,7,1,312,576,7,177,360,0,44.57142857142857,>30,WI,Away,After 1965
MM Ali,ENG,Spin,2019-07-24,Lord's,England,2019,1,14,26,1,1,87,104,1,73,78,0,87.0,>30,ENG,Home,After 1965
MM Ali,ENG,Spin,2019-08-01,Birmingham,England,2019,2,172,252,3,1,478,833,12,306,581,9,39.833333333333336,>30,ENG,Home,After 1965
MM Ali,ENG,Spin,2021-02-13,Chennai,India,2021,2,226,366,8,1,686,1393,32,460,1027,24,21.4375,<=30,IND,Away,After 1965
MM Ali,ENG,Spin,2021-08-12,Lord's,England,2021,2,137,264,3,1,194,462,3,57,198,0,64.66666666666667,>30,ENG,Home,After 1965
MM Ali,ENG,Spin,2021-08-25,Leeds,England,2021,2,44,96,1,1,147,324,3,103,228,2,49.0,>30,ENG,Home,After 1965
MM Ali,ENG,Spin,2021-09-02,The Oval,England,2021,1,118,156,2,1,220,480,7,102,324,5,31.428571428571427,>30,ENG,Home,After 1965
MM Ali,ENG,Spin,2023-06-16,Birmingham,England,2023,2,204,282,3,1,491,732,12,287,450,9,40.916666666666664,>30,ENG,Home,After 1965
MM Ali,ENG,Spin,2023-07-06,Leeds,England,2023,2,74,156,2,1,127,219,3,53,63,1,42.333333333333336,>30,ENG,Home,After 1965
MM Ali,ENG,Spin,2023-07-19,Manchester,England,2023,2,109,180,1,1,196,264,2,87,84,1,98.0,>30,ENG,Home,After 1965
MM Ali,ENG,Spin,2023-07-27,The Oval,England,2023,1,76,138,3,1,267,408,11,191,270,8,24.272727272727273,<=30,ENG,Home,After 1965
MM Patel,ENG,Spin,1996-06-06,Birmingham,England,1996,2,32,60,0,1,130,258,1,98,198,1,130.0,>30,ENG,Home,Upto 2014
MM Patel,ENG,Spin,1996-07-04,Nottingham,England,1996,2,148,216,1,1,381,828,3,233,612,2,127.0,>30,ENG,Home,Upto 2014
MM Patel,IND,Spin,2006-03-09,Mohali,India,2006,2,97,228,7,1,492,1055,19,395,827,12,25.894736842105264,<=30,IND,Home,Upto 2014
MM Patel,IND,Spin,2006-03-18,Wankhede,India,2006,2,120,252,3,1,517,1300,19,397,1048,16,27.210526315789473,<=30,IND,Home,Upto 2014
MM Patel,IND,Spin,2006-06-02,St John's,West Indies,2006,2,135,288,4,1,672,1196,20,537,908,16,33.6,>30,WI,Away,Upto 2014
MM Patel,IND,Spin,2006-06-10,Gros Islet,West Indies,2006,2,101,228,5,1,473,1177,17,372,949,12,27.823529411764707,<=30,WI,Away,Upto 2014
MM Patel,IND,Spin,2006-06-22,Basseterre,West Indies,2006,2,177,234,3,1,722,1248,13,545,1014,10,55.53846153846154,>30,WI,Away,Upto 2014
MM Patel,IND,Spin,2006-06-30,Kingston,West Indies,2006,2,50,144,2,1,275,517,14,225,373,12,19.642857142857142,<=30,WI,Away,Upto 2014
MM Patel,IND,Spin,2007-01-02,Cape Town,South Africa,2007,2,45,126,1,1,487,1042,13,442,916,12,37.46153846153846,>30,SA,Away,Upto 2014
MM Patel,IND,Spin,2007-11-22,Delhi,India,2007,2,109,204,1,1,425,937,15,316,733,14,28.333333333333332,<=30,IND,Home,Upto 2014
MM Patel,IND,Spin,2007-11-30,Eden Gardens,India,2007,2,106,186,2,1,851,1606,18,745,1420,16,47.27777777777778,>30,IND,Home,Upto 2014
MM Patel,IND,Spin,2009-03-18,Hamilton,New Zealand,2009,2,120,210,5,1,359,787,15,239,577,10,23.933333333333334,<=30,NZ,Away,Upto 2014
MM Patel,IND,Spin,2009-03-26,Napier,New Zealand,2009,1,128,168,0,1,685,1306,9,557,1138,9,76.11111111111111,>30,NZ,Away,Upto 2014
MM Patel,IND,Spin,2009-04-03,Wellington,New Zealand,2009,2,42,126,1,1,383,840,12,341,714,11,31.916666666666668,>30,NZ,Away,Upto 2014
MM Patel,IND,Spin,2011-07-06,Roseau,West Indies,2011,2,119,264,1,1,478,1095,12,359,831,11,39.833333333333336,>30,WI,Away,Upto 2014
MN Hart,NZ,Spin,1994-02-17,Wellington,New Zealand,1994,1,102,188,1,1,228,416,2,126,228,1,114.0,>30,NZ,Home,Upto 2014
MN Hart,NZ,Spin,1994-02-24,Christchurch,New Zealand,1994,2,84,162,4,1,187,378,5,103,216,1,37.4,>30,NZ,Home,Upto 2014
MN Hart,NZ,Spin,1994-03-19,Hamilton,New Zealand,1994,2,99,204,2,1,491,1160,14,392,956,12,35.07142857142857,>30,NZ,Home,Upto 2014
MN Hart,NZ,Spin,1994-06-02,Nottingham,England,1994,1,123,210,1,1,324,936,7,201,726,6,46.285714285714285,>30,ENG,Away,Upto 2014
MN Hart,NZ,Spin,1994-06-16,Lord's,England,1994,2,105,510,2,1,425,1219,7,320,709,5,60.714285714285715,>30,ENG,Away,Upto 2014
MN Hart,NZ,Spin,1994-06-30,Manchester,England,1994,1,50,165,1,1,174,423,5,124,258,4,34.8,>30,ENG,Away,Upto 2014
MN Hart,NZ,Spin,1994-11-25,Johannesburg,South Africa,1994,2,134,352,8,1,233,640,10,99,288,2,23.3,<=30,SA,Away,Upto 2014
MN Hart,NZ,Spin,1994-12-26,Durban,South Africa,1994,2,106,184,2,1,116,208,3,10,24,1,38.666666666666664,>30,SA,Away,Upto 2014
MN Hart,NZ,Spin,1995-01-02,Cape Town,South Africa,1995,2,192,416,5,1,383,1034,9,191,618,4,42.55555555555556,>30,SA,Away,Upto 2014
MN Hart,NZ,Spin,1995-02-03,Christchurch,New Zealand,1995,1,75,150,0,1,170,372,2,95,222,2,85.0,>30,NZ,Home,Upto 2014
MN Hart,NZ,Spin,1995-02-10,Wellington,New Zealand,1995,1,181,276,0,1,377,624,4,196,348,4,94.25,>30,NZ,Home,Upto 2014
MN Hart,NZ,Spin,1995-03-04,Auckland,New Zealand,1995,2,95,138,1,1,298,642,4,203,504,3,74.5,>30,NZ,Home,Upto 2014
MN Hart,NZ,Spin,1995-10-18,Bengaluru,India,1995,2,62,101,2,1,388,811,15,326,710,13,25.866666666666667,<=30,IND,Away,Upto 2014
MN Hart,NZ,Spin,1995-11-08,Cuttack,India,1995,1,30,30,0,1,195,570,8,165,540,8,24.375,<=30,IND,Away,Upto 2014
MN Samuels,WI,Spin,2000-12-15,Adelaide,Australia,2000,2,66,150,2,1,394,779,14,328,629,12,28.142857142857142,<=30,AUS,Away,Upto 2014
MN Samuels,WI,Spin,2000-12-26,Melbourne,Australia,2000,1,56,84,0,1,195,381,6,139,297,6,32.5,>30,AUS,Away,Upto 2014
MN Samuels,WI,Spin,2001-01-02,Sydney,Australia,2001,2,63,131,1,1,641,1329,18,578,1198,17,35.611111111111114,>30,AUS,Away,Upto 2014
MN Samuels,WI,Spin,2001-03-09,Georgetown,West Indies,2001,2,5,18,0,1,353,904,9,348,886,9,39.22222222222222,>30,WI,Home,Upto 2014
MN Samuels,WI,Spin,2001-03-29,Bridgetown,West Indies,2001,2,10,24,0,1,341,1000,14,331,976,14,24.357142857142858,<=30,WI,Home,Upto 2014
MN Samuels,WI,Spin,2001-07-19,Bulawayo,Zimbabwe,2001,1,5,6,0,1,317,696,7,312,690,7,45.285714285714285,>30,ZIM,Away,Upto 2014
MN Samuels,WI,Spin,2001-07-27,Harare,Zimbabwe,2001,1,11,18,0,1,386,944,10,375,926,10,38.6,>30,ZIM,Away,Upto 2014
MN Samuels,WI,Spin,2001-11-13,Galle,Sri Lanka,2001,1,5,6,0,1,681,1597,17,676,1591,17,40.05882352941177,>30,SL,Away,Upto 2014
MN Samuels,WI,Spin,2001-11-21,Kandy,Sri Lanka,2001,1,18,18,0,1,458,1038,19,440,1020,19,24.105263157894736,<=30,SL,Away,Upto 2014
MN Samuels,WI,Spin,2002-10-30,Eden Gardens,India,2002,1,21,96,1,1,592,1269,12,571,1173,11,49.333333333333336,>30,IND,Away,Upto 2014
MN Samuels,WI,Spin,2003-04-10,Georgetown,West Indies,2003,2,90,181,0,1,403,631,9,313,450,9,44.77777777777778,>30,WI,Home,Upto 2014
MN Samuels,WI,Spin,2003-04-19,Port of Spain,West Indies,2003,2,176,282,1,1,510,828,7,334,546,6,72.85714285714286,>30,WI,Home,Upto 2014
MN Samuels,WI,Spin,2003-06-20,Gros Islet,West Indies,2003,2,24,36,0,1,398,848,9,374,812,9,44.22222222222222,>30,WI,Home,Upto 2014
MN Samuels,WI,Spin,2005-11-03,Brisbane,Australia,2005,2,75,96,0,1,248,570,7,173,474,7,35.42857142857143,>30,AUS,Away,Upto 2014
MN Samuels,WI,Spin,2006-06-22,Basseterre,West Indies,2006,2,78,162,0,1,722,1248,13,644,1086,13,55.53846153846154,>30,WI,Home,Upto 2014
MN Samuels,WI,Spin,2007-06-15,Chester-le-Street,England,2007,2,47,54,0,1,166,317,7,119,263,7,23.714285714285715,<=30,ENG,Away,Upto 2014
MN Samuels,WI,Spin,2007-12-26,Gqeberha,South Africa,2007,1,14,41,1,1,118,315,6,104,274,5,19.666666666666668,<=30,SA,Away,Upto 2014
MN Samuels,WI,Spin,2008-01-02,Cape Town,South Africa,2008,2,35,67,0,1,172,365,4,137,298,4,43.0,>30,SA,Away,Upto 2014
MN Samuels,WI,Spin,2008-01-10,Durban,South Africa,2008,1,90,126,1,1,101,144,1,11,18,0,101.0,>30,SA,Away,Upto 2014
MN Samuels,WI,Spin,2011-10-21,Chattogram,Bangladesh,2011,2,114,246,3,1,473,864,18,359,618,15,26.27777777777778,<=30,BAN,Away,Upto 2014
MN Samuels,WI,Spin,2011-10-29,Mirpur,Bangladesh,2011,2,79,168,2,1,846,1669,23,767,1501,21,36.78260869565217,>30,BAN,Away,Upto 2014
MN Samuels,WI,Spin,2011-11-06,Delhi,India,2011,2,70,126,2,1,434,957,21,364,831,19,20.666666666666668,<=30,IND,Away,Upto 2014
MN Samuels,WI,Spin,2011-11-14,Eden Gardens,India,2011,1,104,162,0,1,689,1188,12,585,1026,12,57.416666666666664,>30,IND,Away,Upto 2014
MN Samuels,WI,Spin,2011-11-22,Wankhede,India,2011,2,167,252,5,1,794,1593,24,627,1341,19,33.083333333333336,>30,IND,Away,Upto 2014
MN Samuels,WI,Spin,2012-05-17,Lord's,England,2012,2,89,145,1,1,200,366,4,111,221,3,50.0,>30,ENG,Away,Upto 2014
MN Samuels,WI,Spin,2012-05-25,Nottingham,England,2012,2,32,74,3,1,256,436,7,224,362,4,36.57142857142857,>30,ENG,Away,Upto 2014
MN Samuels,WI,Spin,2012-06-07,Birmingham,England,2012,1,29,54,1,1,184,300,1,155,246,0,184.0,>30,ENG,Away,Upto 2014
MN Samuels,WI,Spin,2012-07-25,North Sound,West Indies,2012,2,36,54,0,1,474,1059,11,438,1005,11,43.09090909090909,>30,WI,Home,Upto 2014
MN Samuels,WI,Spin,2012-08-02,Kingston,West Indies,2012,1,2,6,0,1,213,524,11,211,518,11,19.363636363636363,<=30,WI,Home,Upto 2014
MN Samuels,WI,Spin,2012-11-13,Mirpur,Bangladesh,2012,2,30,48,0,1,992,1679,19,962,1631,19,52.21052631578947,>30,BAN,Away,Upto 2014
MN Samuels,WI,Spin,2012-11-21,Khulna,Bangladesh,2012,1,15,12,0,1,763,1327,11,748,1315,11,69.36363636363636,>30,BAN,Away,Upto 2014
MN Samuels,WI,Spin,2013-03-12,Bridgetown,West Indies,2013,1,13,40,4,1,270,496,14,257,456,10,19.285714285714285,<=30,WI,Home,Upto 2014
MN Samuels,WI,Spin,2013-03-20,Roseau,West Indies,2013,2,50,110,6,1,314,673,21,264,563,15,14.952380952380953,<=30,WI,Home,Upto 2014
MN Samuels,WI,Spin,2013-11-06,Eden Gardens,India,2013,1,12,24,0,1,456,988,15,444,964,15,30.4,>30,IND,Away,Upto 2014
MN Samuels,WI,Spin,2013-11-14,Wankhede,India,2013,1,42,66,0,1,497,770,24,455,704,24,20.708333333333332,<=30,IND,Away,Upto 2014
MN Samuels,WI,Spin,2014-06-08,Kingston,West Indies,2014,2,77,126,0,1,767,1332,22,690,1206,22,34.86363636363637,>30,WI,Home,After 1965
MN Samuels,WI,Spin,2014-12-17,Centurion,South Africa,2014,1,89,120,0,1,274,453,3,185,333,3,91.33333333333333,>30,SA,Away,After 1965
MN Samuels,WI,Spin,2014-12-26,Gqeberha,South Africa,2014,1,0,6,0,1,215,336,4,215,330,4,53.75,>30,SA,Away,After 1965
MN Samuels,WI,Spin,2015-01-02,Cape Town,South Africa,2015,2,92,122,2,1,390,806,12,298,684,10,32.5,>30,SA,Away,After 1965
MN Samuels,WI,Spin,2015-04-13,North Sound,West Indies,2015,2,104,154,1,1,466,940,10,362,786,9,46.6,>30,WI,Home,After 1965
MN Samuels,WI,Spin,2015-04-21,St George's,West Indies,2015,2,92,201,1,1,451,913,9,359,712,8,50.111111111111114,>30,WI,Home,After 1965
MN Samuels,WI,Spin,2015-05-01,Bridgetown,West Indies,2015,2,63,186,1,1,352,610,8,289,424,7,44.0,>30,WI,Home,After 1965
MN Samuels,WI,Spin,2015-06-03,Roseau,West Indies,2015,1,71,132,1,1,294,570,11,223,438,10,26.727272727272727,<=30,WI,Home,After 1965
MN Samuels,WI,Spin,2015-10-14,Galle,Sri Lanka,2015,1,84,162,1,1,555,1017,18,471,855,17,30.833333333333332,>30,SL,Away,After 1965
MN Waller,ZIM,Spin,2011-11-01,Bulawayo,Zimbabwe,2011,1,8,18,0,1,535,1222,13,527,1204,13,41.15384615384615,>30,ZIM,Home,Upto 2014
MN Waller,ZIM,Spin,2014-11-03,Khulna,Bangladesh,2014,2,124,300,6,1,829,1764,29,705,1464,23,28.586206896551722,<=30,BAN,Away,After 1965
MN Waller,ZIM,Spin,2016-10-29,Harare,Zimbabwe,2016,2,42,66,2,1,573,1161,19,531,1095,17,30.157894736842106,>30,ZIM,Home,After 1965
MN Waller,ZIM,Spin,2016-11-06,Harare,Zimbabwe,2016,1,23,30,0,1,564,968,25,541,938,25,22.56,<=30,ZIM,Home,After 1965
MN Waller,ZIM,Spin,2017-07-14,Colombo (RPS),Sri Lanka,2017,2,12,30,0,1,1059,1917,28,1047,1887,28,37.82142857142857,>30,SL,Away,After 1965
MN Waller,ZIM,Spin,2017-10-21,Bulawayo,Zimbabwe,2017,1,9,12,0,1,674,1311,28,665,1299,28,24.071428571428573,<=30,ZIM,Home,After 1965
MP Bicknell,ENG,Pace,1993-07-22,Leeds,England,1993,1,155,300,1,1,901,1757,18,746,1457,17,50.05555555555556,>30,ENG,Home,Upto 2014
MP Bicknell,ENG,Pace,1993-08-05,Birmingham,England,1993,2,108,222,3,1,389,833,10,281,611,7,38.9,>30,ENG,Home,Upto 2014
MP Bicknell,ENG,Pace,2003-08-21,Leeds,England,2003,2,125,294,4,1,1130,2145,39,1005,1851,35,28.974358974358974,<=30,ENG,Home,Upto 2014
MP Bicknell,ENG,Pace,2003-09-04,The Oval,England,2003,2,155,264,6,1,1075,1870,24,920,1606,18,44.791666666666664,>30,ENG,Home,Upto 2014
MP Donnelly,NZ,Spin,1949-06-11,Leeds,England,1949,1,20,30,0,1,545,1101,10,525,1071,10,54.5,>30,ENG,Away,Upto 2014
MP Jarvis,ZIM,Pace,1992-10-18,Harare,Zimbabwe,1992,1,73,228,1,1,480,1630,15,407,1402,14,32.0,>30,ZIM,Home,Upto 2014
MP Jarvis,ZIM,Pace,1992-11-01,Bulawayo,Zimbabwe,1992,2,125,223,3,1,481,878,7,356,655,4,68.71428571428571,>30,ZIM,Home,Upto 2014
MP Jarvis,ZIM,Pace,1994-10-11,Harare,Zimbabwe,1994,1,76,246,2,1,445,1241,16,369,995,14,27.8125,<=30,ZIM,Home,Upto 2014
MP Jarvis,ZIM,Pace,1994-10-20,Bulawayo,Zimbabwe,1994,2,54,348,4,1,524,1630,17,470,1282,13,30.823529411764707,>30,ZIM,Home,Upto 2014
MP Jarvis,ZIM,Pace,1994-10-26,Harare,Zimbabwe,1994,2,65,228,1,1,659,1576,19,594,1348,18,34.68421052631579,>30,ZIM,Home,Upto 2014
MP Kuhnemann,AUS,Spin,2023-02-17,Delhi,India,2023,2,110,171,2,1,582,1082,28,472,911,26,20.785714285714285,<=30,IND,Away,After 1965
MP Kuhnemann,AUS,Spin,2023-03-01,Indore,India,2023,2,76,150,6,1,438,973,26,362,823,20,16.846153846153847,<=30,IND,Away,After 1965
MP Kuhnemann,AUS,Spin,2023-03-09,Ahmedabad,India,2023,1,94,150,1,1,725,1892,17,631,1742,16,42.64705882352941,>30,IND,Away,After 1965
MP Kuhnemann,AUS,Spin,2025-01-29,Galle,Sri Lanka,2025,2,149,215,9,1,941,1397,23,792,1182,14,40.91304347826087,>30,SL,Away,After 1965
MP Vaughan,ENG,Spin,1999-11-25,Johannesburg,South Africa,1999,1,39,66,0,1,75,138,1,36,72,1,75.0,>30,SA,Away,Upto 2014
MP Vaughan,ENG,Spin,1999-12-09,Gqeberha,South Africa,1999,2,25,30,0,1,220,492,4,195,462,4,55.0,>30,SA,Away,Upto 2014
MP Vaughan,ENG,Spin,2000-01-14,Centurion,South Africa,2000,1,9,12,0,1,36,48,0,27,36,0,inf,>30,SA,Away,Upto 2014
MP Vaughan,ENG,Spin,2000-06-29,Lord's,England,2000,1,10,18,0,1,40,66,0,30,48,0,inf,>30,ENG,Home,Upto 2014
MP Vaughan,ENG,Spin,2000-08-03,Manchester,England,2000,1,3,12,0,1,254,606,4,251,594,4,63.5,>30,ENG,Home,Upto 2014
MP Vaughan,ENG,Spin,2000-08-31,The Oval,England,2000,1,12,18,0,1,192,479,8,180,461,8,24.0,<=30,ENG,Home,Upto 2014
MP Vaughan,ENG,Spin,2001-05-17,Lord's,England,2001,1,12,6,0,1,39,36,0,27,30,0,inf,>30,ENG,Home,Upto 2014
MP Vaughan,ENG,Spin,2001-05-31,Manchester,England,2001,1,21,12,0,1,175,476,6,154,464,6,29.166666666666668,<=30,ENG,Home,Upto 2014
MP Vaughan,ENG,Spin,2002-03-21,Wellington,New Zealand,2002,1,15,30,0,1,323,744,10,308,714,10,32.3,>30,NZ,Away,Upto 2014
MP Vaughan,ENG,Spin,2002-05-16,Lord's,England,2002,1,35,84,0,1,171,426,1,136,342,1,171.0,>30,ENG,Home,Upto 2014
MP Vaughan,ENG,Spin,2002-06-13,Manchester,England,2002,1,9,12,0,1,309,728,8,300,716,8,38.625,>30,ENG,Home,Upto 2014
MP Vaughan,ENG,Spin,2002-07-25,Lord's,England,2002,1,12,36,1,1,509,942,14,497,906,13,36.357142857142854,>30,ENG,Home,Upto 2014
MP Vaughan,ENG,Spin,2002-08-08,Nottingham,England,2002,1,71,126,2,1,350,564,6,279,438,4,58.333333333333336,>30,ENG,Home,Upto 2014
MP Vaughan,ENG,Spin,2002-08-22,Leeds,England,2002,1,1,6,0,1,393,893,12,392,887,12,32.75,>30,ENG,Home,Upto 2014
MP Vaughan,ENG,Spin,2002-09-05,The Oval,England,2002,1,36,72,1,1,410,922,9,374,850,8,45.55555555555556,>30,ENG,Home,Upto 2014
MP Vaughan,ENG,Spin,2003-07-24,Birmingham,England,2003,1,26,48,1,1,314,558,6,288,510,5,52.333333333333336,>30,ENG,Home,Upto 2014
MP Vaughan,ENG,Spin,2003-08-14,Nottingham,England,2003,1,0,6,0,1,70,225,2,70,219,2,35.0,>30,ENG,Home,Upto 2014
MP Vaughan,ENG,Spin,2003-08-21,Leeds,England,2003,1,13,30,0,1,14,42,1,1,12,1,14.0,<=30,ENG,Home,Upto 2014
MP Vaughan,ENG,Spin,2003-09-04,The Oval,England,2003,1,24,30,0,1,289,420,3,265,390,3,96.33333333333333,>30,ENG,Home,Upto 2014
MP Vaughan,ENG,Spin,2003-12-02,Galle,Sri Lanka,2003,1,2,6,0,1,603,1823,28,601,1817,28,21.535714285714285,<=30,SL,Away,Upto 2014
MP Vaughan,ENG,Spin,2003-12-10,Kandy,Sri Lanka,2003,2,20,48,0,1,692,1702,20,672,1654,20,34.6,>30,SL,Away,Upto 2014
MP Vaughan,ENG,Spin,2003-12-18,Colombo (SSC),Sri Lanka,2003,1,5,6,0,1,552,1368,13,547,1362,13,42.46153846153846,>30,SL,Away,Upto 2014
MP Vaughan,ENG,Spin,2004-03-11,Kingston,West Indies,2004,1,2,6,0,1,110,185,4,108,179,4,27.5,<=30,WI,Away,Upto 2014
MP Vaughan,ENG,Spin,2004-04-10,St John's,West Indies,2004,1,60,78,0,1,477,993,7,417,915,7,68.14285714285714,>30,WI,Away,Upto 2014
MP Vaughan,ENG,Spin,2004-06-03,Leeds,England,2004,1,3,12,0,1,153,264,2,150,252,2,76.5,>30,ENG,Home,Upto 2014
MP Vaughan,ENG,Spin,2004-06-10,Nottingham,England,2004,1,5,6,0,1,125,318,6,120,312,6,20.833333333333332,<=30,ENG,Home,Upto 2014
MP Vaughan,ENG,Spin,2004-07-29,Birmingham,England,2004,2,17,24,0,1,350,688,15,333,664,15,23.333333333333332,<=30,ENG,Home,Upto 2014
MP Vaughan,ENG,Spin,2004-12-26,Durban,South Africa,2004,2,29,66,1,1,324,528,5,295,462,4,64.8,>30,SA,Away,Upto 2014
MP Vaughan,ENG,Spin,2005-08-11,Manchester,England,2005,1,21,30,0,1,423,776,8,402,746,8,52.875,>30,ENG,Home,Upto 2014
MP Vaughan,ENG,Spin,2007-07-19,Lord's,England,2007,1,18,24,0,1,243,486,5,225,462,5,48.6,>30,ENG,Home,Upto 2014
MP Vaughan,ENG,Spin,2007-12-01,Kandy,Sri Lanka,2007,1,6,18,0,1,361,894,16,355,876,16,22.5625,<=30,SL,Away,Upto 2014
MR Adair,IRE,Pace,2019-07-24,Lord's,England,2019,2,98,166,6,1,515,949,38,417,783,32,13.552631578947368,<=30,ENG,Away,After 1965
MR Adair,IRE,Pace,2023-04-04,Mirpur,Bangladesh,2023,2,94,138,3,1,400,606,10,306,468,7,40.0,>30,BAN,Away,After 1965
MR Adair,IRE,Pace,2023-04-16,Galle,Sri Lanka,2023,1,95,147,1,1,244,399,7,149,252,6,34.857142857142854,>30,SL,Away,After 1965
MR Adair,IRE,Pace,2023-06-01,Lord's,England,2023,2,139,124,0,1,757,1010,16,618,886,16,47.3125,>30,ENG,Away,After 1965
MR Adair,IRE,Pace,2024-02-28,Tolerance Oval,UAE,2024,2,95,197,8,1,418,850,26,323,653,18,16.076923076923077,<=30,UAE,Away,After 1965
MR Adair,IRE,Pace,2024-07-25,Belfast,Northern Ireland,2024,2,91,198,4,1,610,1116,26,519,918,22,23.46153846153846,<=30,Northern Ireland,Away,After 1965
MR Bynoe,WI,Pace,1967-01-13,Chennai,India,1967,1,5,30,1,1,515,900,14,510,870,13,36.785714285714285,>30,IND,Away,Upto 2014
MR Gillespie,NZ,Pace,2007-11-16,Centurion,South Africa,2007,1,136,180,5,1,609,994,26,473,814,21,23.423076923076923,<=30,SA,Away,Upto 2014
MR Gillespie,NZ,Pace,2008-03-13,Wellington,New Zealand,2008,2,142,210,6,1,966,1899,38,824,1689,32,25.42105263157895,<=30,NZ,Home,Upto 2014
MR Gillespie,NZ,Pace,2008-12-11,Dunedin,New Zealand,2008,1,102,126,0,1,619,1080,13,517,954,13,47.61538461538461,>30,NZ,Home,Upto 2014
MR Gillespie,NZ,Pace,2012-03-15,Hamilton,New Zealand,2012,2,83,114,5,1,549,1079,27,466,965,22,20.333333333333332,<=30,NZ,Home,Upto 2014
MR Gillespie,NZ,Pace,2012-03-23,Wellington,New Zealand,2012,2,168,238,6,1,873,1620,25,705,1382,19,34.92,>30,NZ,Home,Upto 2014
MR Marsh,AUS,Pace,2014-10-22,Dubai (DICS),UAE,2014,2,63,144,0,1,384,954,8,321,810,8,48.0,>30,UAE,Away,After 1965
MR Marsh,AUS,Pace,2014-10-30,Abu Dhabi,UAE,2014,2,47,96,0,1,549,1024,11,502,928,11,49.90909090909091,>30,UAE,Away,After 1965
MR Marsh,AUS,Pace,2014-12-09,Adelaide,Australia,2014,2,40,90,0,1,885,1420,15,845,1330,15,59.0,>30,AUS,Home,After 1965
MR Marsh,AUS,Pace,2014-12-17,Brisbane,Australia,2014,1,14,36,1,1,959,1402,28,945,1366,27,34.25,>30,AUS,Home,After 1965
MR Marsh,AUS,Pace,2015-07-16,Lord's,England,2015,2,31,66,3,1,791,1369,21,760,1303,18,37.666666666666664,>30,ENG,Away,After 1965
MR Marsh,AUS,Pace,2015-07-29,Birmingham,England,2015,2,32,49,0,1,619,1035,28,587,986,28,22.107142857142858,<=30,ENG,Away,After 1965
MR Marsh,AUS,Pace,2015-08-20,The Oval,England,2015,2,86,150,5,1,638,1293,22,552,1143,17,29.0,<=30,ENG,Away,After 1965
MR Marsh,AUS,Pace,2015-11-05,Brisbane,Australia,2015,2,57,90,3,1,1023,1505,20,966,1415,17,51.15,>30,AUS,Home,After 1965
MR Marsh,AUS,Pace,2015-11-13,W.A.C.A,Australia,2015,2,82,108,1,1,1234,1914,22,1152,1806,21,56.09090909090909,>30,AUS,Home,After 1965
MR Marsh,AUS,Pace,2015-11-27,Adelaide,Australia,2015,2,71,114,3,1,584,1142,29,513,1028,26,20.137931034482758,<=30,AUS,Home,After 1965
MR Marsh,AUS,Pace,2015-12-10,Hobart,Australia,2015,2,50,60,1,1,634,903,16,584,843,15,39.625,>30,AUS,Home,After 1965
MR Marsh,AUS,Pace,2015-12-26,Melbourne,Australia,2015,2,76,147,4,1,837,1482,18,761,1335,14,46.5,>30,AUS,Home,After 1965
MR Marsh,AUS,Pace,2016-01-03,Sydney,Australia,2016,1,15,24,0,1,234,354,3,219,330,3,78.0,>30,AUS,Home,After 1965
MR Marsh,AUS,Pace,2016-02-12,Wellington,New Zealand,2016,2,88,141,3,1,769,1383,21,681,1242,18,36.61904761904762,>30,NZ,Away,After 1965
MR Marsh,AUS,Pace,2016-02-20,Christchurch,New Zealand,2016,2,111,150,1,1,1247,2076,29,1136,1926,28,43.0,>30,NZ,Away,After 1965
MR Marsh,AUS,Pace,2016-07-26,Pallekele,Sri Lanka,2016,1,33,54,1,1,306,556,14,273,502,13,21.857142857142858,<=30,SL,Away,After 1965
MR Marsh,AUS,Pace,2016-08-04,Galle,Sri Lanka,2016,2,37,78,1,1,224,424,15,187,346,14,14.933333333333334,<=30,SL,Away,After 1965
MR Marsh,AUS,Pace,2016-08-13,Colombo (SSC),Sri Lanka,2016,2,48,78,0,1,336,652,8,288,574,8,42.0,>30,SL,Away,After 1965
MR Marsh,AUS,Pace,2016-11-03,W.A.C.A,Australia,2016,2,100,192,2,1,937,1726,29,837,1534,27,32.310344827586206,>30,AUS,Home,After 1965
MR Marsh,AUS,Pace,2017-03-04,Bengaluru,India,2017,2,6,30,0,1,391,822,14,385,792,14,27.928571428571427,<=30,IND,Away,After 1965
MR Marsh,AUS,Pace,2017-12-14,W.A.C.A,Australia,2017,2,57,72,0,1,965,1713,24,908,1641,24,40.208333333333336,>30,AUS,Home,After 1965
MR Marsh,AUS,Pace,2017-12-26,Melbourne,Australia,2017,1,42,72,0,1,816,1807,20,774,1735,20,40.8,>30,AUS,Home,After 1965
MR Marsh,AUS,Pace,2018-01-04,Sydney,Australia,2018,2,33,48,0,1,630,1294,17,597,1246,17,37.05882352941177,>30,AUS,Home,After 1965
MR Marsh,AUS,Pace,2018-03-01,Durban,South Africa,2018,1,21,42,1,1,640,1256,26,619,1214,25,24.615384615384617,<=30,SA,Away,After 1965
MR Marsh,AUS,Pace,2018-03-09,Gqeberha,South Africa,2018,1,26,54,2,1,673,1296,28,647,1242,26,24.035714285714285,<=30,SA,Away,After 1965
MR Marsh,AUS,Pace,2018-03-22,Cape Town,South Africa,2018,2,52,72,1,1,789,1457,31,737,1385,30,25.451612903225808,<=30,SA,Away,After 1965
MR Marsh,AUS,Pace,2018-03-30,Johannesburg,South Africa,2018,2,70,84,0,1,666,1427,26,596,1343,26,25.615384615384617,<=30,SA,Away,After 1965
MR Marsh,AUS,Pace,2018-10-07,Dubai (DICS),UAE,2018,1,38,60,0,1,373,938,11,335,878,11,33.90909090909091,>30,UAE,Away,After 1965
MR Marsh,AUS,Pace,2018-10-16,Abu Dhabi,UAE,2018,2,60,120,2,1,398,700,16,338,580,14,24.875,<=30,UAE,Away,After 1965
MR Marsh,AUS,Pace,2018-12-26,Melbourne,Australia,2018,1,51,156,0,1,621,1425,29,570,1269,29,21.413793103448278,<=30,AUS,Home,After 1965
MR Marsh,AUS,Pace,2019-09-12,The Oval,England,2019,2,86,176,7,1,856,1530,30,770,1354,23,28.533333333333335,<=30,ENG,Away,After 1965
MR Marsh,AUS,Pace,2023-07-06,Leeds,England,2023,2,32,54,2,1,803,1163,34,771,1109,32,23.61764705882353,<=30,ENG,Away,After 1965
MR Marsh,AUS,Pace,2023-07-19,Manchester,England,2023,1,57,54,0,1,889,1350,23,832,1296,23,38.65217391304348,>30,ENG,Away,After 1965
MR Marsh,AUS,Pace,2023-07-27,The Oval,England,2023,2,78,96,1,1,971,1598,29,893,1502,28,33.48275862068966,>30,ENG,Away,After 1965
MR Marsh,AUS,Pace,2023-12-14,Perth,Australia,2023,1,34,54,1,1,810,1410,28,776,1356,27,28.928571428571427,<=30,AUS,Home,After 1965
MR Marsh,AUS,Pace,2023-12-26,Melbourne,Australia,2023,2,24,30,0,1,818,1640,35,794,1610,35,23.37142857142857,<=30,AUS,Home,After 1965
MR Marsh,AUS,Pace,2024-01-03,Sydney,Australia,2024,1,27,42,1,1,504,897,22,477,855,21,22.90909090909091,<=30,AUS,Home,After 1965
MR Marsh,AUS,Pace,2024-01-17,Adelaide,Australia,2024,1,5,12,0,1,512,947,27,507,935,27,18.962962962962962,<=30,AUS,Home,After 1965
MR Marsh,AUS,Pace,2024-01-25,Brisbane,Australia,2024,1,3,12,0,1,777,1334,30,774,1322,30,25.9,<=30,AUS,Home,After 1965
MR Marsh,AUS,Pace,2024-02-29,Wellington,New Zealand,2024,1,10,24,1,1,689,1266,22,679,1242,21,31.318181818181817,>30,NZ,Away,After 1965
MR Marsh,AUS,Pace,2024-03-08,Christchurch,New Zealand,2024,2,29,54,0,1,918,1490,33,889,1436,33,27.818181818181817,<=30,NZ,Away,After 1965
MR Marsh,AUS,Pace,2024-11-22,Perth,Australia,2024,2,77,102,3,1,555,1114,27,478,1012,24,20.555555555555557,<=30,AUS,Home,After 1965
MR Marsh,AUS,Pace,2024-12-06,Adelaide,Australia,2024,1,26,24,0,1,507,779,28,481,755,28,18.107142857142858,<=30,AUS,Home,After 1965
MR Marsh,AUS,Pace,2024-12-14,Brisbane,Australia,2024,1,6,12,0,1,550,932,24,544,920,24,22.916666666666668,<=30,AUS,Home,After 1965
MR Marsh,AUS,Pace,2024-12-26,Melbourne,Australia,2024,2,30,60,0,1,849,1700,27,819,1640,27,31.444444444444443,>30,AUS,Home,After 1965
MR Ramprakash,ENG,Spin,1992-06-04,Birmingham,England,1992,1,3,6,0,1,247,450,2,244,444,2,123.5,>30,ENG,Home,Upto 2014
MR Ramprakash,ENG,Spin,1992-08-06,The Oval,England,1992,1,5,1,0,1,191,493,4,186,492,4,47.75,>30,ENG,Home,Upto 2014
MR Ramprakash,ENG,Spin,1994-03-17,Georgetown,West Indies,1994,1,35,90,0,1,318,558,4,283,468,4,79.5,>30,WI,Away,Upto 2014
MR Ramprakash,ENG,Spin,1994-03-25,Port of Spain,West Indies,1994,1,8,12,0,1,162,288,3,154,276,3,54.0,>30,WI,Away,Upto 2014
MR Ramprakash,ENG,Spin,1994-04-16,St John's,West Indies,1994,1,5,18,0,1,364,732,3,359,714,3,121.33333333333333,>30,WI,Away,Upto 2014
MR Ramprakash,ENG,Spin,1995-02-03,W.A.C.A,Australia,1995,2,74,114,0,1,185,366,5,111,252,5,37.0,>30,AUS,Away,Upto 2014
MR Ramprakash,ENG,Spin,1995-11-30,Johannesburg,South Africa,1995,1,19,24,0,1,180,594,4,161,570,4,45.0,>30,SA,Away,Upto 2014
MR Ramprakash,ENG,Spin,1998-02-27,Georgetown,West Indies,1998,1,2,12,1,1,391,1045,18,389,1033,17,21.72222222222222,<=30,WI,Away,Upto 2014
MR Ramprakash,ENG,Spin,1998-03-12,Bridgetown,West Indies,1998,2,35,120,1,1,286,824,8,251,704,7,35.75,>30,WI,Away,Upto 2014
MR Ramprakash,ENG,Spin,1998-03-20,St John's,West Indies,1998,1,81,114,1,1,334,948,8,253,834,7,41.75,>30,WI,Away,Upto 2014
MR Ramprakash,ENG,Spin,1998-07-02,Manchester,England,1998,1,17,30,0,1,380,1050,6,363,1020,6,63.333333333333336,>30,ENG,Home,Upto 2014
MR Ramprakash,ENG,Spin,1998-08-27,The Oval,England,1998,1,24,30,0,1,481,1390,17,457,1360,17,28.294117647058822,<=30,ENG,Home,Upto 2014
MR Ramprakash,ENG,Spin,1998-11-20,Brisbane,Australia,1998,2,8,24,0,1,328,690,9,320,666,9,36.44444444444444,>30,AUS,Away,Upto 2014
MR Ramprakash,ENG,Spin,1998-11-28,W.A.C.A,Australia,1998,1,12,12,1,1,27,84,2,15,72,1,13.5,<=30,AUS,Away,Upto 2014
MR Ramprakash,ENG,Spin,1998-12-11,Adelaide,Australia,1998,2,54,126,0,1,473,1152,14,419,1026,14,33.785714285714285,>30,AUS,Away,Upto 2014
MR Ramprakash,ENG,Spin,1998-12-26,Melbourne,Australia,1998,1,6,12,0,1,148,294,7,142,282,7,21.142857142857142,<=30,AUS,Away,Upto 2014
MR Ramprakash,ENG,Spin,1999-01-02,Sydney,Australia,1999,1,56,90,0,1,526,1105,23,470,1015,23,22.869565217391305,<=30,AUS,Away,Upto 2014
MR Ramprakash,ENG,Spin,1999-07-22,Lord's,England,1999,1,1,6,0,1,143,403,4,142,397,4,35.75,>30,ENG,Home,Upto 2014
MR Ramprakash,ENG,Spin,2000-06-01,Nottingham,England,2000,1,1,6,0,1,131,266,2,130,260,2,65.5,>30,ENG,Home,Upto 2014
MR Ramprakash,ENG,Spin,2001-08-16,Leeds,England,2001,1,12,24,0,1,126,236,1,114,212,1,126.0,>30,ENG,Home,Upto 2014
MR Ramprakash,ENG,Spin,2001-08-23,The Oval,England,2001,1,19,24,0,1,630,1004,15,611,980,15,42.0,>30,ENG,Home,Upto 2014
MR Whitney,AUS,Pace,1981-08-13,Manchester,England,1981,2,124,264,4,1,887,1850,35,763,1586,31,25.34285714285714,<=30,ENG,Away,Upto 2014
MR Whitney,AUS,Pace,1981-08-27,The Oval,England,1981,2,122,204,1,1,972,2088,35,850,1884,34,27.771428571428572,<=30,ENG,Away,Upto 2014
MR Whitney,AUS,Pace,1987-12-26,Melbourne,Australia,1987,2,137,321,4,1,846,1960,31,709,1639,27,27.29032258064516,<=30,AUS,Home,Upto 2014
MR Whitney,AUS,Pace,1989-02-03,Adelaide,Australia,1989,2,149,300,9,1,834,1481,18,685,1181,9,46.333333333333336,>30,AUS,Home,Upto 2014
MR Whitney,AUS,Pace,1991-03-01,Kingston,West Indies,1991,2,113,228,0,1,694,1365,21,581,1137,21,33.04761904761905,>30,WI,Away,Upto 2014
MR Whitney,AUS,Pace,1991-03-23,Georgetown,West Indies,1991,1,103,168,0,1,808,1623,19,705,1455,19,42.526315789473685,>30,WI,Away,Upto 2014
MR Whitney,AUS,Pace,1991-11-29,Brisbane,Australia,1991,2,137,230,4,1,581,1459,29,444,1229,25,20.03448275862069,<=30,AUS,Home,Upto 2014
MR Whitney,AUS,Pace,1992-01-25,Adelaide,Australia,1992,2,127,260,2,1,796,1827,30,669,1567,28,26.533333333333335,<=30,AUS,Home,Upto 2014
MR Whitney,AUS,Pace,1992-02-01,W.A.C.A,Australia,1992,2,95,211,11,1,946,1994,34,851,1783,23,27.823529411764707,<=30,AUS,Home,Upto 2014
MR Whitney,AUS,Pace,1992-08-17,Colombo (SSC),Sri Lanka,1992,2,97,222,1,1,793,1548,19,696,1326,18,41.73684210526316,>30,SL,Away,Upto 2014
MR Whitney,AUS,Pace,1992-08-28,Colombo (RPS),Sri Lanka,1992,2,62,126,1,1,531,1227,20,469,1101,19,26.55,<=30,SL,Away,Upto 2014
MR Whitney,AUS,Pace,1992-12-26,Melbourne,Australia,1992,2,59,138,2,1,743,1849,31,684,1711,29,23.967741935483872,<=30,AUS,Home,Upto 2014
MRCN Bandaratilleke,SL,Spin,1998-05-27,Colombo (RPS),Sri Lanka,1998,2,156,366,2,1,939,2077,27,783,1711,25,34.77777777777778,>30,SL,Home,Upto 2014
MRCN Bandaratilleke,SL,Spin,1998-06-03,Galle,Sri Lanka,1998,2,83,372,9,1,443,1219,25,360,847,16,17.72,<=30,SL,Home,Upto 2014
MRCN Bandaratilleke,SL,Spin,1998-06-10,Colombo (SSC),Sri Lanka,1998,2,100,222,5,1,526,1430,27,426,1208,22,19.48148148148148,<=30,SL,Home,Upto 2014
MRCN Bandaratilleke,SL,Spin,1999-03-04,Lahore,Pakistan,1999,2,144,336,3,1,525,960,12,381,624,9,43.75,>30,PAK,Away,Upto 2014
MRCN Bandaratilleke,SL,Spin,2001-11-13,Galle,Sri Lanka,2001,2,122,246,2,1,681,1597,17,559,1351,15,40.05882352941177,>30,SL,Home,Upto 2014
MRCN Bandaratilleke,SL,Spin,2001-11-21,Kandy,Sri Lanka,2001,2,54,114,2,1,458,1038,19,404,924,17,24.105263157894736,<=30,SL,Home,Upto 2014
MRCN Bandaratilleke,SL,Spin,2001-11-29,Colombo (SSC),Sri Lanka,2001,2,39,66,0,1,542,1074,5,503,1008,5,108.4,>30,SL,Home,Upto 2014
MS Atapattu,SL,Spin,1997-04-26,Colombo (SSC),Sri Lanka,1997,1,9,24,1,1,882,1775,14,873,1751,13,63.0,>30,SL,Home,Upto 2014
MS Atapattu,SL,Spin,1997-08-02,Colombo (RPS),Sri Lanka,1997,1,3,6,0,1,1044,2082,8,1041,2076,8,130.5,>30,SL,Home,Upto 2014
MS Atapattu,SL,Spin,1997-11-26,Nagpur,India,1997,1,4,6,0,1,254,546,2,250,540,2,127.0,>30,IND,Away,Upto 2014
MS Atapattu,SL,Spin,1998-01-07,Kandy,Sri Lanka,1998,1,1,6,0,1,546,1374,23,545,1368,23,23.73913043478261,<=30,SL,Home,Upto 2014
MS Atapattu,SL,Spin,1998-03-19,Cape Town,South Africa,1998,1,7,6,0,1,499,1068,16,492,1062,16,31.1875,>30,SA,Away,Upto 2014
MS Crane,ENG,Spin,2018-01-04,Sydney,Australia,2018,1,193,288,1,1,530,1068,7,337,780,6,75.71428571428571,>30,AUS,Away,After 1965
MS Dhoni,IND,Pace,2006-01-21,Faisalabad,Pakistan,2006,1,13,6,0,1,888,1366,17,875,1360,17,52.23529411764706,>30,PAK,Away,Upto 2014
MS Dhoni,IND,Pace,2008-12-19,Mohali,India,2008,1,1,6,0,1,522,1070,12,521,1064,12,43.5,>30,IND,Home,Upto 2014
MS Dhoni,IND,Pace,2010-11-04,Ahmedabad,India,2010,1,5,6,0,1,415,862,12,410,856,12,34.583333333333336,>30,IND,Home,Upto 2014
MS Dhoni,IND,Pace,2011-07-21,Lord's,England,2011,2,39,60,0,1,813,1712,30,774,1652,30,27.1,<=30,ENG,Away,Upto 2014
MS Dhoni,IND,Pace,2013-12-18,Johannesburg,South Africa,2013,1,4,12,0,1,1012,2037,30,1008,2025,30,33.733333333333334,>30,SA,Away,Upto 2014
MS Dhoni,IND,Pace,2014-02-14,Wellington,New Zealand,2014,1,5,6,0,1,1271,2109,30,1266,2103,30,42.36666666666667,>30,NZ,Away,After 1965
MS Hardikar,IND,Spin,1958-11-28,Brabourne,India,1958,2,45,102,1,1,512,1219,9,467,1117,8,56.888888888888886,>30,IND,Home,Upto 2014
MS Hardikar,IND,Spin,1958-12-12,Kanpur,India,1958,1,10,6,0,1,669,1431,13,659,1425,13,51.46153846153846,>30,IND,Home,Upto 2014
MS Kasprowicz,AUS,Pace,1996-11-22,Brisbane,Australia,1996,2,89,210,0,1,925,1944,28,836,1734,28,33.035714285714285,>30,AUS,Home,Upto 2014
MS Kasprowicz,AUS,Pace,1996-11-29,Sydney,Australia,1996,1,37,78,0,1,754,1620,23,717,1542,23,32.78260869565217,>30,AUS,Home,Upto 2014
MS Kasprowicz,AUS,Pace,1997-06-05,Birmingham,England,1997,2,155,276,5,1,837,1443,24,682,1167,19,34.875,>30,ENG,Away,Upto 2014
MS Kasprowicz,AUS,Pace,1997-06-19,Lord's,England,1997,2,63,120,1,1,411,849,18,348,729,17,22.833333333333332,<=30,ENG,Away,Upto 2014
MS Kasprowicz,AUS,Pace,1997-08-21,The Oval,England,1997,2,92,165,8,1,435,825,24,343,660,16,18.125,<=30,ENG,Away,Upto 2014
MS Kasprowicz,AUS,Pace,1997-11-07,Brisbane,Australia,1997,2,74,192,2,1,809,1711,25,735,1519,23,32.36,>30,AUS,Home,Upto 2014
MS Kasprowicz,AUS,Pace,1997-11-20,W.A.C.A,Australia,1997,2,83,216,4,1,605,1158,21,522,942,17,28.80952380952381,<=30,AUS,Home,Upto 2014
MS Kasprowicz,AUS,Pace,1997-11-27,Hobart,Australia,1997,2,76,96,0,1,691,1411,18,615,1315,18,38.388888888888886,>30,AUS,Home,Upto 2014
MS Kasprowicz,AUS,Pace,1997-12-26,Melbourne,Australia,1997,2,73,167,3,1,627,1621,23,554,1454,20,27.26086956521739,<=30,AUS,Home,Upto 2014
MS Kasprowicz,AUS,Pace,1998-01-30,Adelaide,Australia,1998,2,180,342,5,1,879,2002,24,699,1660,19,36.625,>30,AUS,Home,Upto 2014
MS Kasprowicz,AUS,Pace,1998-03-06,Chennai,India,1998,2,86,210,1,1,310,705,5,224,495,4,62.0,>30,IND,Away,Upto 2014
MS Kasprowicz,AUS,Pace,1998-03-18,Eden Gardens,India,1998,1,122,204,1,1,398,718,11,276,514,10,36.18181818181818,>30,IND,Away,Upto 2014
MS Kasprowicz,AUS,Pace,1998-03-25,Bengaluru,India,1998,2,104,282,6,1,319,612,10,215,330,4,31.9,>30,IND,Away,Upto 2014
MS Kasprowicz,AUS,Pace,1998-11-20,Brisbane,Australia,1998,2,110,222,2,1,919,1808,20,809,1586,18,45.95,>30,AUS,Home,Upto 2014
MS Kasprowicz,AUS,Pace,1999-11-26,W.A.C.A,Australia,1999,2,132,168,7,1,717,1143,27,585,975,20,26.555555555555557,<=30,AUS,Home,Upto 2014
MS Kasprowicz,AUS,Pace,1999-12-10,Adelaide,Australia,1999,2,85,102,0,1,755,1459,27,670,1357,27,27.962962962962962,<=30,AUS,Home,Upto 2014
MS Kasprowicz,AUS,Pace,2001-03-11,Eden Gardens,India,2001,2,178,288,2,1,800,1488,16,622,1200,14,50.0,>30,IND,Away,Upto 2014
MS Kasprowicz,AUS,Pace,2004-03-08,Galle,Sri Lanka,2004,2,69,168,3,1,256,624,5,187,456,2,51.2,>30,SL,Away,Upto 2014
MS Kasprowicz,AUS,Pace,2004-03-16,Kandy,Sri Lanka,2004,2,138,246,5,1,512,998,21,374,752,16,24.38095238095238,<=30,SL,Away,Upto 2014
MS Kasprowicz,AUS,Pace,2004-03-24,Colombo (SSC),Sri Lanka,2004,2,95,233,4,1,527,998,13,432,765,9,40.53846153846154,>30,SL,Away,Upto 2014
MS Kasprowicz,AUS,Pace,2004-07-01,Darwin,Australia,2004,2,54,148,7,1,425,1034,30,371,886,23,14.166666666666666,<=30,AUS,Home,Upto 2014
MS Kasprowicz,AUS,Pace,2004-07-09,Cairns,Australia,2004,2,147,258,1,1,844,1536,15,697,1278,14,56.266666666666666,>30,AUS,Home,Upto 2014
MS Kasprowicz,AUS,Pace,2004-10-06,Bengaluru,India,2004,2,66,204,4,1,461,1068,18,395,864,14,25.61111111111111,<=30,IND,Away,Upto 2014
MS Kasprowicz,AUS,Pace,2004-10-14,Chennai,India,2004,1,65,150,1,1,378,888,4,313,738,3,94.5,>30,IND,Away,Upto 2014
MS Kasprowicz,AUS,Pace,2004-10-26,Nagpur,India,2004,2,84,168,2,1,596,1196,23,512,1028,21,25.91304347826087,<=30,IND,Away,Upto 2014
MS Kasprowicz,AUS,Pace,2004-11-03,Wankhede,India,2004,2,40,129,2,1,204,507,11,164,378,9,18.545454545454547,<=30,IND,Away,Upto 2014
MS Kasprowicz,AUS,Pace,2004-11-18,Brisbane,Australia,2004,2,111,216,5,1,723,1283,17,612,1067,12,42.529411764705884,>30,AUS,Home,Upto 2014
MS Kasprowicz,AUS,Pace,2004-11-26,Adelaide,Australia,2004,2,105,180,4,1,602,1087,15,497,907,11,40.13333333333333,>30,AUS,Home,Upto 2014
MS Kasprowicz,AUS,Pace,2004-12-16,W.A.C.A,Australia,2004,2,34,120,7,1,677,1213,30,643,1093,23,22.566666666666666,<=30,AUS,Home,Upto 2014
MS Kasprowicz,AUS,Pace,2004-12-26,Melbourne,Australia,2004,2,108,216,2,1,584,1094,18,476,878,16,32.44444444444444,>30,AUS,Home,Upto 2014
MS Kasprowicz,AUS,Pace,2005-03-10,Christchurch,New Zealand,2005,2,118,210,2,1,768,1398,17,650,1188,15,45.1764705882353,>30,NZ,Away,Upto 2014
MS Kasprowicz,AUS,Pace,2005-03-18,Wellington,New Zealand,2005,2,53,114,4,1,569,942,15,516,828,11,37.93333333333333,>30,NZ,Away,Upto 2014
MS Kasprowicz,AUS,Pace,2005-03-26,Auckland,New Zealand,2005,2,148,266,2,1,759,1379,20,611,1113,18,37.95,>30,NZ,Away,Upto 2014
MS Kasprowicz,AUS,Pace,2005-08-04,Birmingham,England,2005,2,109,108,3,1,817,1095,24,708,987,21,34.041666666666664,>30,ENG,Away,Upto 2014
MS Kasprowicz,AUS,Pace,2005-08-25,Nottingham,England,2005,2,141,204,1,1,944,1543,26,803,1339,25,36.30769230769231,>30,ENG,Away,Upto 2014
MS Kasprowicz,AUS,Pace,2006-03-16,Cape Town,South Africa,2006,2,83,150,3,1,563,1099,28,480,949,25,20.107142857142858,<=30,SA,Away,Upto 2014
MS Kasprowicz,AUS,Pace,2006-03-24,Durban,South Africa,2006,2,111,156,2,1,838,1637,23,727,1481,21,36.43478260869565,>30,SA,Away,Upto 2014
MS Kasprowicz,AUS,Pace,2006-03-31,Johannesburg,South Africa,2006,2,98,158,2,1,824,1490,30,726,1332,28,27.466666666666665,<=30,SA,Away,Upto 2014
MS Nichols,ENG,Pace,1930-01-10,Christchurch,New Zealand,1930,2,51,189,6,1,310,868,23,259,679,17,13.478260869565217,<=30,NZ,Away,Upto 2014
MS Nichols,ENG,Pace,1930-01-24,Wellington,New Zealand,1930,2,88,174,1,1,569,1265,15,481,1091,14,37.93333333333333,>30,NZ,Away,Upto 2014
MS Nichols,ENG,Pace,1930-02-14,Auckland,New Zealand,1930,1,18,30,0,1,146,336,1,128,306,1,146.0,>30,NZ,Away,Upto 2014
MS Nichols,ENG,Pace,1930-02-21,Auckland,New Zealand,1930,1,45,114,1,1,366,961,11,321,847,10,33.27272727272727,>30,NZ,Away,Upto 2014
MS Nichols,ENG,Pace,1930-07-25,Manchester,England,1930,1,33,126,2,1,183,630,11,150,504,9,16.636363636363637,<=30,ENG,Home,Upto 2014
MS Nichols,ENG,Pace,1933-08-12,The Oval,England,1933,2,87,144,3,1,389,809,16,302,665,13,24.3125,<=30,ENG,Home,Upto 2014
MS Nichols,ENG,Pace,1933-12-15,Mumbai,India,1933,2,108,283,8,1,534,1100,19,426,817,11,28.105263157894736,<=30,IND,Away,Upto 2014
MS Nichols,ENG,Pace,1934-01-05,Eden Gardens,India,1934,2,126,288,4,1,492,1256,17,366,968,13,28.941176470588236,<=30,IND,Away,Upto 2014
MS Nichols,ENG,Pace,1934-02-10,Chennai,India,1934,2,53,108,1,1,459,1077,17,406,969,16,27.0,<=30,IND,Away,Upto 2014
MS Nichols,ENG,Pace,1935-06-15,Nottingham,England,1935,2,49,173,7,1,248,671,10,199,498,3,24.8,<=30,ENG,Home,Upto 2014
MS Nichols,ENG,Pace,1935-06-29,Lord's,England,1935,2,111,234,3,1,344,844,15,233,610,12,22.933333333333334,<=30,ENG,Home,Upto 2014
MS Nichols,ENG,Pace,1935-07-13,Leeds,England,1935,2,123,262,3,1,570,1397,20,447,1135,17,28.5,<=30,ENG,Home,Upto 2014
MS Nichols,ENG,Pace,1935-08-17,The Oval,England,1935,2,99,168,0,1,741,1240,14,642,1072,14,52.92857142857143,>30,ENG,Home,Upto 2014
MS Nichols,ENG,Pace,1939-08-19,The Oval,England,1939,1,161,272,2,1,751,1240,17,590,968,15,44.1764705882353,>30,ENG,Home,Upto 2014
MS Panesar,ENG,Spin,2006-03-01,Nagpur,India,2006,2,131,348,3,1,588,1296,7,457,948,4,84.0,>30,IND,Away,Upto 2014
MS Panesar,ENG,Spin,2006-03-09,Mohali,India,2006,2,113,180,1,1,492,1055,19,379,875,18,25.894736842105264,<=30,IND,Away,Upto 2014
MS Panesar,ENG,Spin,2006-03-18,Wankhede,India,2006,2,68,180,1,1,517,1300,19,449,1120,18,27.210526315789473,<=30,IND,Away,Upto 2014
MS Panesar,ENG,Spin,2006-05-11,Lord's,England,2006,1,49,162,2,1,239,486,5,190,324,3,47.8,>30,ENG,Home,Upto 2014
MS Panesar,ENG,Spin,2006-05-25,Birmingham,England,2006,2,80,180,3,1,204,410,13,124,230,10,15.692307692307692,<=30,ENG,Home,Upto 2014
MS Panesar,ENG,Spin,2006-06-02,Nottingham,England,2006,2,81,253,5,1,298,834,19,217,581,14,15.68421052631579,<=30,ENG,Home,Upto 2014
MS Panesar,ENG,Spin,2006-07-13,Lord's,England,2006,2,153,324,2,1,515,1101,11,362,777,9,46.81818181818182,>30,ENG,Home,Upto 2014
MS Panesar,ENG,Spin,2006-07-27,Manchester,England,2006,2,93,208,8,1,286,568,10,193,360,2,28.6,<=30,ENG,Home,Upto 2014
MS Panesar,ENG,Spin,2006-08-04,Leeds,England,2006,2,166,393,6,1,443,837,10,277,444,4,44.3,>30,ENG,Home,Upto 2014
MS Panesar,ENG,Spin,2006-08-17,The Oval,England,2006,1,103,180,1,1,237,438,3,134,258,2,79.0,>30,ENG,Home,Upto 2014
MS Panesar,ENG,Spin,2006-12-14,W.A.C.A,Australia,2006,2,237,348,8,1,460,746,15,223,398,7,30.666666666666668,>30,AUS,Away,Upto 2014
MS Panesar,ENG,Spin,2006-12-26,Melbourne,Australia,2006,1,52,72,0,1,167,338,7,115,266,7,23.857142857142858,<=30,AUS,Away,Upto 2014
MS Panesar,ENG,Spin,2007-01-02,Sydney,Australia,2007,1,90,117,2,1,208,355,4,118,238,2,52.0,>30,AUS,Away,Upto 2014
MS Panesar,ENG,Spin,2007-05-17,Lord's,England,2007,2,142,235,6,1,293,462,9,151,227,3,32.55555555555556,>30,ENG,Home,Upto 2014
MS Panesar,ENG,Spin,2007-05-25,Leeds,England,2007,2,21,42,1,1,99,126,2,78,84,1,49.5,>30,ENG,Home,Upto 2014
MS Panesar,ENG,Spin,2007-06-07,Manchester,England,2007,2,187,411,10,1,304,603,11,117,192,1,27.636363636363637,<=30,ENG,Home,Upto 2014
MS Panesar,ENG,Spin,2007-06-15,Chester-le-Street,England,2007,2,80,175,6,1,166,317,7,86,142,1,23.714285714285715,<=30,ENG,Home,Upto 2014
MS Panesar,ENG,Spin,2007-07-19,Lord's,England,2007,2,85,204,2,1,243,486,5,158,282,3,48.6,>30,ENG,Home,Upto 2014
MS Panesar,ENG,Spin,2007-07-27,Nottingham,England,2007,1,101,203,4,1,275,482,10,174,279,6,27.5,<=30,ENG,Home,Upto 2014
MS Panesar,ENG,Spin,2007-08-09,The Oval,England,2007,2,217,378,2,1,584,973,9,367,595,7,64.88888888888889,>30,ENG,Home,Upto 2014
MS Panesar,ENG,Spin,2007-12-01,Kandy,Sri Lanka,2007,2,178,354,6,1,361,894,16,183,540,10,22.5625,<=30,SL,Away,Upto 2014
MS Panesar,ENG,Spin,2007-12-09,Colombo (SSC),Sri Lanka,2007,1,151,300,2,1,447,920,9,296,620,7,49.666666666666664,>30,SL,Away,Upto 2014
MS Panesar,ENG,Spin,2007-12-18,Galle,Sri Lanka,2007,1,76,156,0,1,195,456,4,119,300,4,48.75,>30,SL,Away,Upto 2014
MS Panesar,ENG,Spin,2008-03-05,Hamilton,New Zealand,2008,2,151,318,4,1,412,1080,12,261,762,8,34.333333333333336,>30,NZ,Away,Upto 2014
MS Panesar,ENG,Spin,2008-03-13,Wellington,New Zealand,2008,2,55,135,1,1,128,279,1,73,144,0,128.0,>30,NZ,Away,Upto 2014
MS Panesar,ENG,Spin,2008-03-22,Napier,New Zealand,2008,2,126,282,6,1,490,971,14,364,689,8,35.0,>30,NZ,Away,Upto 2014
MS Panesar,ENG,Spin,2008-05-15,Lord's,England,2008,2,86,210,2,1,176,375,7,90,165,5,25.142857142857142,<=30,ENG,Home,Upto 2014
MS Panesar,ENG,Spin,2008-05-23,Manchester,England,2008,2,138,234,7,1,323,648,13,185,414,6,24.846153846153847,<=30,ENG,Home,Upto 2014
MS Panesar,ENG,Spin,2008-06-05,Nottingham,England,2008,1,21,66,0,1,98,239,1,77,173,1,98.0,>30,ENG,Home,Upto 2014
MS Panesar,ENG,Spin,2008-07-10,Lord's,England,2008,2,190,516,4,1,341,797,8,151,281,4,42.625,>30,ENG,Home,Upto 2014
MS Panesar,ENG,Spin,2008-07-18,Leeds,England,2008,1,65,176,3,1,114,290,3,49,114,0,38.0,>30,ENG,Home,Upto 2014
MS Panesar,ENG,Spin,2008-07-30,Birmingham,England,2008,2,116,240,2,1,217,456,4,101,216,2,54.25,>30,ENG,Home,Upto 2014
MS Panesar,ENG,Spin,2008-08-07,The Oval,England,2008,2,41,119,4,1,131,334,7,90,215,3,18.714285714285715,<=30,ENG,Home,Upto 2014
MS Panesar,ENG,Spin,2008-12-11,Chennai,India,2008,2,170,276,3,1,742,1371,17,572,1095,14,43.64705882352941,>30,IND,Away,Upto 2014
MS Panesar,ENG,Spin,2008-12-19,Mohali,India,2008,2,133,198,3,1,508,989,13,375,791,10,39.07692307692308,>30,IND,Away,Upto 2014
MS Panesar,ENG,Spin,2009-02-04,Kingston,West Indies,2009,1,122,282,1,1,286,814,10,164,532,9,28.6,<=30,WI,Away,Upto 2014
MS Panesar,ENG,Spin,2009-03-06,Port of Spain,West Indies,2009,2,148,377,4,1,578,1262,14,430,885,10,41.285714285714285,>30,WI,Away,Upto 2014
MS Panesar,ENG,Spin,2009-07-08,Cardiff,England,2009,1,115,210,1,1,464,923,7,349,713,6,66.28571428571429,>30,ENG,Home,Upto 2014
MS Panesar,ENG,Spin,2012-01-25,Abu Dhabi,UAE,2012,2,153,428,7,1,558,1443,31,405,1015,24,18.0,<=30,UAE,Away,Upto 2014
MS Panesar,ENG,Spin,2012-02-03,Dubai (DICS),UAE,2012,2,149,418,7,1,528,1381,25,379,963,18,21.12,<=30,UAE,Away,Upto 2014
MS Panesar,ENG,Spin,2012-03-26,Galle,Sri Lanka,2012,2,101,282,2,1,607,1324,28,506,1042,26,21.678571428571427,<=30,SL,Away,Upto 2014
MS Panesar,ENG,Spin,2012-11-23,Wankhede,India,2012,2,210,414,11,1,747,1449,28,537,1035,17,26.678571428571427,<=30,IND,Away,Upto 2014
MS Panesar,ENG,Spin,2012-12-05,Eden Gardens,India,2012,2,165,372,5,1,665,1360,18,500,988,13,36.94444444444444,>30,IND,Away,Upto 2014
MS Panesar,ENG,Spin,2012-12-13,Nagpur,India,2012,1,81,312,1,1,722,2045,15,641,1733,14,48.13333333333333,>30,IND,Away,Upto 2014
MS Panesar,ENG,Spin,2013-03-06,Dunedin,New Zealand,2013,1,83,132,1,1,254,582,6,171,450,5,42.333333333333336,>30,NZ,Away,Upto 2014
MS Panesar,ENG,Spin,2013-03-14,Wellington,New Zealand,2013,2,91,312,1,1,255,641,7,164,329,6,36.42857142857143,>30,NZ,Away,Upto 2014
MS Panesar,ENG,Spin,2013-03-22,Auckland,New Zealand,2013,2,176,338,3,1,355,860,7,179,522,4,50.714285714285715,>30,NZ,Away,Upto 2014
MS Panesar,ENG,Spin,2013-12-05,Adelaide,Australia,2013,2,198,324,2,1,565,912,7,367,588,5,80.71428571428571,>30,AUS,Away,Upto 2014
MS Panesar,ENG,Spin,2013-12-26,Melbourne,Australia,2013,2,59,101,1,1,184,361,7,125,260,6,26.285714285714285,<=30,AUS,Away,Upto 2014
MS Sinclair,NZ,Pace,2000-12-08,Johannesburg,South Africa,2000,1,13,24,0,1,417,1127,13,404,1103,13,32.07692307692308,>30,SA,Away,Upto 2014
MS Sinclair,NZ,Pace,2010-03-27,Hamilton,New Zealand,2010,1,1,18,0,1,795,1294,27,794,1276,27,29.444444444444443,<=30,NZ,Home,Upto 2014
MS Wade,AUS,Pace,2012-12-14,Hobart,Australia,2012,1,0,6,0,1,927,1883,26,927,1877,26,35.65384615384615,>30,AUS,Home,Upto 2014
MS Wade,AUS,Pace,2019-08-01,Birmingham,England,2019,1,7,6,0,1,758,1453,25,751,1447,25,30.32,>30,ENG,Away,After 1965
MS Wade,AUS,Pace,2019-12-12,Perth,Australia,2019,1,8,12,0,1,626,1383,31,618,1371,31,20.193548387096776,<=30,AUS,Home,After 1965
MS Wade,AUS,Pace,2019-12-26,Melbourne,Australia,2019,1,13,6,0,1,729,1616,26,716,1610,26,28.03846153846154,<=30,AUS,Home,After 1965
MT Chinouya,ZIM,Pace,2016-07-28,Bulawayo,Zimbabwe,2016,1,79,156,1,1,542,1115,20,463,959,19,27.1,<=30,ZIM,Home,After 1965
MT Chinouya,ZIM,Pace,2016-08-06,Bulawayo,Zimbabwe,2016,2,109,186,2,1,578,1230,11,469,1044,9,52.54545454545455,>30,ZIM,Home,After 1965
MT Renshaw,AUS,Spin,2018-03-30,Johannesburg,South Africa,2018,2,13,24,0,1,456,724,9,443,700,9,50.666666666666664,>30,SA,Away,After 1965
MT Renshaw,AUS,Spin,2023-02-09,Nagpur,India,2023,1,7,6,0,1,475,1061,24,468,1055,24,19.791666666666668,<=30,IND,Away,After 1965
MTG Elliott,AUS,Pace,1997-11-27,Hobart,Australia,1997,1,0,6,0,1,691,1411,18,691,1405,18,38.388888888888886,>30,AUS,Home,Upto 2014
MTG Elliott,AUS,Pace,1998-01-02,Sydney,Australia,1998,1,4,6,0,1,405,1054,13,401,1048,13,31.153846153846153,>30,AUS,Home,Upto 2014
MV Boucher,SA,Pace,2005-04-29,St John's,West Indies,2005,1,6,8,1,1,1036,1736,12,1030,1728,11,86.33333333333333,>30,WI,Away,Upto 2014
MV Nagamootoo,WI,Spin,2000-08-31,The Oval,England,2000,2,92,258,3,1,192,479,8,100,221,5,24.0,<=30,ENG,Away,Upto 2014
MV Nagamootoo,WI,Spin,2001-01-02,Sydney,Australia,2001,2,147,264,3,1,641,1329,18,494,1065,15,35.611111111111114,>30,AUS,Away,Upto 2014
MV Nagamootoo,WI,Spin,2002-04-11,Georgetown,West Indies,2002,1,103,240,1,1,369,751,4,266,511,3,92.25,>30,WI,Home,Upto 2014
MV Nagamootoo,WI,Spin,2002-06-28,St George's,West Indies,2002,2,163,450,2,1,457,1176,9,294,726,7,50.77777777777778,>30,WI,Home,Upto 2014
MV Nagamootoo,WI,Spin,2002-10-09,Wankhede,India,2002,1,132,282,3,1,416,1045,19,284,763,16,21.894736842105264,<=30,IND,Away,Upto 2014
MV Narasimha Rao,IND,Spin,1978-12-29,Eden Gardens,India,1978,2,76,169,1,1,375,1048,13,299,879,12,28.846153846153847,<=30,IND,Home,Upto 2014
MV Narasimha Rao,IND,Spin,1979-01-12,Chennai,India,1979,1,31,60,0,1,234,496,9,203,436,9,26.0,<=30,IND,Home,Upto 2014
MV Narasimha Rao,IND,Spin,1979-10-13,Delhi,India,1979,2,96,186,2,1,604,1308,12,508,1122,10,50.333333333333336,>30,IND,Home,Upto 2014
MV Narasimha Rao,IND,Spin,1979-10-26,Eden Gardens,India,1979,1,24,48,0,1,581,1386,14,557,1338,14,41.5,>30,IND,Home,Upto 2014
MVT Fernando,SL,Pace,2016-08-04,Galle,Sri Lanka,2016,1,16,12,1,1,224,424,15,208,412,14,14.933333333333334,<=30,SL,Home,After 1965
MVT Fernando,SL,Pace,2017-08-12,Pallekele,Sri Lanka,2017,1,87,156,2,1,344,606,10,257,450,8,34.4,>30,SL,Home,After 1965
MVT Fernando,SL,Pace,2019-02-01,Canberra,Australia,2019,2,169,246,4,1,709,1113,23,540,867,19,30.82608695652174,>30,AUS,Away,After 1965
MVT Fernando,SL,Pace,2019-02-13,Durban,South Africa,2019,2,133,205,8,1,725,1312,28,592,1107,20,25.892857142857142,<=30,SA,Away,After 1965
MVT Fernando,SL,Pace,2019-02-21,Gqeberha,South Africa,2019,2,94,170,4,1,552,954,24,458,784,20,23.0,<=30,SA,Away,After 1965
MVT Fernando,SL,Pace,2019-12-11,Rawalpindi,Pakistan,2019,1,49,78,0,1,376,750,8,327,672,8,47.0,>30,PAK,Away,After 1965
MVT Fernando,SL,Pace,2019-12-19,Karachi,Pakistan,2019,2,136,222,2,1,653,1162,24,517,940,22,27.208333333333332,<=30,PAK,Away,After 1965
MVT Fernando,SL,Pace,2020-01-27,Harare,Zimbabwe,2020,2,88,204,2,1,441,1205,12,353,1001,10,36.75,>30,ZIM,Away,After 1965
MVT Fernando,SL,Pace,2020-12-26,Centurion,South Africa,2020,1,129,187,3,1,827,1226,23,698,1039,20,35.95652173913044,>30,SA,Away,After 1965
MVT Fernando,SL,Pace,2021-01-03,Johannesburg,South Africa,2021,2,124,166,5,1,660,1080,30,536,914,25,22.0,<=30,SA,Away,After 1965
MVT Fernando,SL,Pace,2021-03-21,North Sound,West Indies,2021,2,125,216,4,1,742,1672,25,617,1456,21,29.68,<=30,WI,Away,After 1965
MVT Fernando,SL,Pace,2021-03-29,North Sound,West Indies,2021,2,120,238,1,1,742,1513,23,622,1275,22,32.26086956521739,>30,WI,Away,After 1965
MVT Fernando,SL,Pace,2021-04-21,Pallekele,Sri Lanka,2021,2,114,240,4,1,611,1140,12,497,900,8,50.916666666666664,>30,SL,Home,After 1965
MVT Fernando,SL,Pace,2021-04-29,Pallekele,Sri Lanka,2021,1,19,42,0,1,391,680,8,372,638,8,48.875,>30,SL,Home,After 1965
MVT Fernando,SL,Pace,2022-03-04,Mohali,India,2022,1,135,156,2,1,395,599,10,260,443,8,39.5,>30,IND,Away,After 1965
MVT Fernando,SL,Pace,2022-03-12,Bengaluru,India,2022,2,66,78,1,1,203,372,12,137,294,11,16.916666666666668,<=30,IND,Away,After 1965
MVT Fernando,SL,Pace,2022-05-15,Chattogram,Bangladesh,2022,1,42,48,0,1,332,607,7,290,559,7,47.42857142857143,>30,BAN,Away,After 1965
MVT Fernando,SL,Pace,2023-04-16,Galle,Sri Lanka,2023,2,41,78,4,1,244,399,7,203,321,3,34.857142857142854,>30,SL,Home,After 1965
MVT Fernando,SL,Pace,2023-04-24,Galle,Sri Lanka,2023,2,107,180,2,1,403,633,9,296,453,7,44.77777777777778,>30,SL,Home,After 1965
MVT Fernando,SL,Pace,2023-07-16,Galle,Sri Lanka,2023,2,75,120,1,1,424,660,10,349,540,9,42.4,>30,SL,Home,After 1965
MVT Fernando,SL,Pace,2024-02-02,Colombo (SSC),Sri Lanka,2024,2,88,156,4,1,535,897,18,447,741,14,29.72222222222222,<=30,SL,Home,After 1965
MVT Fernando,SL,Pace,2024-03-22,Sylhet,Bangladesh,2024,2,84,183,7,1,733,1127,31,649,944,24,23.64516129032258,<=30,BAN,Away,After 1965
MVT Fernando,SL,Pace,2024-03-30,Chattogram,Bangladesh,2024,2,77,156,3,1,504,886,22,427,730,19,22.90909090909091,<=30,BAN,Away,After 1965
MVT Fernando,SL,Pace,2024-08-21,Manchester,England,2024,2,119,165,2,1,733,1160,25,614,995,23,29.32,<=30,ENG,Away,After 1965
MVT Fernando,SL,Pace,2024-09-06,The Oval,England,2024,2,86,126,5,1,809,1069,28,723,943,23,28.892857142857142,<=30,ENG,Away,After 1965
MVT Fernando,SL,Pace,2024-11-27,Durban,South Africa,2024,2,99,198,4,1,556,1001,29,457,803,25,19.17241379310345,<=30,SA,Away,After 1965
MVT Fernando,SL,Pace,2024-12-05,Gqeberha,South Africa,2024,2,112,246,4,1,793,1361,26,681,1115,22,30.5,>30,SA,Away,After 1965
MW Booth,ENG,Pace,1913-12-13,Durban,South Africa,1913,1,38,60,2,1,479,1054,20,441,994,18,23.95,<=30,SA,Away,Upto 2014
MW Booth,ENG,Pace,1914-02-27,Gqeberha,South Africa,1914,2,92,252,5,1,418,956,19,326,704,14,22.0,<=30,SA,Away,Upto 2014
MW Gatting,ENG,Pace,1978-03-04,Auckland,New Zealand,1978,1,1,8,0,1,754,2126,17,753,2118,17,44.35294117647059,>30,NZ,Away,Upto 2014
MW Gatting,ENG,Pace,1981-08-13,Manchester,England,1981,1,13,18,0,1,887,1850,35,874,1832,35,25.34285714285714,<=30,ENG,Home,Upto 2014
MW Gatting,ENG,Pace,1982-01-13,Chennai,India,1982,1,4,6,0,1,631,1176,8,627,1170,8,78.875,>30,IND,Away,Upto 2014
MW Gatting,ENG,Pace,1982-08-26,Leeds,England,1982,2,21,60,0,1,717,1887,34,696,1827,34,21.08823529411765,<=30,ENG,Home,Upto 2014
MW Gatting,ENG,Pace,1983-08-25,Nottingham,England,1983,2,13,42,0,1,763,1600,21,750,1558,21,36.333333333333336,>30,ENG,Home,Upto 2014
MW Gatting,ENG,Pace,1984-01-20,Wellington,New Zealand,1984,1,14,48,1,1,1002,2037,24,988,1989,23,41.75,>30,NZ,Away,Upto 2014
MW Gatting,ENG,Pace,1984-02-03,Christchurch,New Zealand,1984,1,14,12,0,1,404,927,25,390,915,25,16.16,<=30,NZ,Away,Upto 2014
MW Gatting,ENG,Pace,1984-03-12,Faisalabad,Pakistan,1984,2,35,30,1,1,538,960,13,503,930,12,41.38461538461539,>30,PAK,Away,Upto 2014
MW Gatting,ENG,Pace,1984-11-28,Wankhede,India,1984,1,20,42,0,1,378,744,6,358,702,6,63.0,>30,IND,Away,Upto 2014
MW Gatting,ENG,Pace,1984-12-12,Delhi,India,1984,2,8,18,0,1,406,798,8,398,780,8,50.75,>30,IND,Away,Upto 2014
MW Gatting,ENG,Pace,1984-12-31,Eden Gardens,India,1984,1,1,12,0,1,288,729,8,287,717,8,36.0,>30,IND,Away,Upto 2014
MW Gatting,ENG,Pace,1985-01-31,Kanpur,India,1985,1,7,6,0,1,413,773,9,406,767,9,45.888888888888886,>30,IND,Away,Upto 2014
MW Gatting,ENG,Pace,1985-07-11,Nottingham,England,1985,1,2,6,0,1,706,1344,15,704,1338,15,47.06666666666667,>30,ENG,Home,Upto 2014
MW Gatting,ENG,Pace,1985-08-01,Manchester,England,1985,1,14,24,0,1,622,1074,12,608,1050,12,51.833333333333336,>30,ENG,Home,Upto 2014
MW Gatting,ENG,Pace,1986-07-03,Birmingham,England,1986,1,10,12,0,1,804,1599,21,794,1587,21,38.285714285714285,>30,ENG,Home,Upto 2014
MW Gatting,ENG,Pace,1986-11-14,Brisbane,Australia,1986,2,4,18,0,1,755,1483,27,751,1465,27,27.962962962962962,<=30,AUS,Away,Upto 2014
MW Gatting,ENG,Pace,1986-11-28,W.A.C.A,Australia,1986,1,3,30,0,1,963,1802,22,960,1772,22,43.77272727272727,>30,AUS,Away,Upto 2014
MW Gatting,ENG,Pace,1986-12-12,Adelaide,Australia,1986,2,26,66,0,1,567,1198,11,541,1132,11,51.54545454545455,>30,AUS,Away,Upto 2014
MW Gatting,ENG,Pace,1986-12-26,Melbourne,Australia,1986,1,4,6,0,1,497,1065,22,493,1059,22,22.59090909090909,<=30,AUS,Away,Upto 2014
MW Gatting,ENG,Pace,1987-01-10,Sydney,Australia,1987,2,2,18,0,1,483,1157,14,481,1139,14,34.5,>30,AUS,Away,Upto 2014
MW Gatting,ENG,Pace,1987-07-02,Leeds,England,1987,1,16,54,0,1,511,1279,29,495,1225,29,17.620689655172413,<=30,ENG,Home,Upto 2014
MW Gatting,ENG,Pace,1987-07-23,Birmingham,England,1987,1,6,18,0,1,1037,2130,29,1031,2112,29,35.758620689655174,>30,ENG,Home,Upto 2014
MW Gatting,ENG,Pace,1987-08-06,The Oval,England,1987,1,18,60,0,1,607,1188,10,589,1128,10,60.7,>30,ENG,Home,Upto 2014
MW Gatting,ENG,Pace,1988-02-25,Auckland,New Zealand,1988,1,40,102,1,1,724,1989,22,684,1887,21,32.90909090909091,>30,NZ,Away,Upto 2014
MW Gatting,ENG,Pace,1988-03-03,Wellington,New Zealand,1988,1,21,36,1,1,376,817,5,355,781,4,75.2,>30,NZ,Away,Upto 2014
MW Goodwin,ZIM,Spin,1998-01-07,Kandy,Sri Lanka,1998,1,7,24,0,1,546,1374,23,539,1350,23,23.73913043478261,<=30,SL,Away,Upto 2014
MW Goodwin,ZIM,Spin,1998-01-14,Colombo (SSC),Sri Lanka,1998,1,4,5,0,1,688,1695,18,684,1690,18,38.22222222222222,>30,SL,Away,Upto 2014
MW Goodwin,ZIM,Spin,1998-02-26,Auckland,New Zealand,1998,1,27,36,0,1,314,511,5,287,475,5,62.8,>30,NZ,Away,Upto 2014
MW Goodwin,ZIM,Spin,1998-03-14,Bulawayo,Zimbabwe,1998,2,6,18,0,1,364,712,5,358,694,5,72.8,>30,ZIM,Home,Upto 2014
MW Goodwin,ZIM,Spin,1998-03-21,Harare,Zimbabwe,1998,1,9,12,0,1,303,593,6,294,581,6,50.5,>30,ZIM,Home,Upto 2014
MW Goodwin,ZIM,Spin,1998-10-07,Harare,Zimbabwe,1998,1,5,12,0,1,303,670,13,298,658,13,23.307692307692307,<=30,ZIM,Home,Upto 2014
MW Goodwin,ZIM,Spin,1999-11-11,Harare,Zimbabwe,1999,1,11,12,0,1,131,233,4,120,221,4,32.75,>30,ZIM,Home,Upto 2014
MW Parkinson,ENG,Spin,2022-06-02,Lord's,England,2022,1,47,93,1,1,71,111,1,24,18,0,71.0,>30,ENG,Home,After 1965
MW Priest,NZ,Spin,1990-06-07,Nottingham,England,1990,1,26,72,1,1,148,408,4,122,336,3,37.0,>30,ENG,Away,Upto 2014
MW Priest,NZ,Spin,1998-02-26,Auckland,New Zealand,1998,2,55,90,0,1,314,511,5,259,421,5,62.8,>30,NZ,Home,Upto 2014
MW Priest,NZ,Spin,1998-06-10,Colombo (SSC),Sri Lanka,1998,2,77,215,2,1,526,1430,27,449,1215,25,19.48148148148148,<=30,SL,Away,Upto 2014
MW Pringle,SA,Pace,1992-04-18,Bridgetown,West Indies,1992,2,105,208,2,1,919,1991,34,814,1783,32,27.029411764705884,<=30,WI,Away,Upto 2014
MW Pringle,SA,Pace,1992-11-13,Durban,South Africa,1992,1,67,204,1,1,480,1371,14,413,1167,13,34.285714285714285,>30,SA,Home,Upto 2014
MW Pringle,SA,Pace,1995-11-30,Johannesburg,South Africa,1995,2,98,240,2,1,999,2058,30,901,1818,28,33.3,>30,SA,Home,Upto 2014
MW Sievers,AUS,Pace,1936-12-04,Brisbane,Australia,1936,2,71,286,3,1,297,839,25,226,553,22,11.88,<=30,AUS,Home,Upto 2014
MW Sievers,AUS,Pace,1936-12-18,Sydney,Australia,1936,1,30,130,0,1,331,936,17,301,806,17,19.470588235294116,<=30,AUS,Home,Upto 2014
MW Sievers,AUS,Pace,1937-01-01,Melbourne,Australia,1937,2,60,186,6,1,510,1173,17,450,987,11,30.0,<=30,AUS,Home,Upto 2014
MW Tate,ENG,Spin,1924-06-14,Birmingham,England,1924,2,115,340,8,1,396,946,10,281,606,2,39.6,>30,ENG,Home,Upto 2014
MW Tate,ENG,Spin,1924-06-28,Lord's,England,1924,2,105,364,4,1,563,1396,14,458,1032,10,40.214285714285715,>30,ENG,Home,Upto 2014
MW Tate,ENG,Spin,1924-07-12,Leeds,England,1924,2,106,282,9,1,557,1271,20,451,989,11,27.85,<=30,ENG,Home,Upto 2014
MW Tate,ENG,Spin,1924-07-26,Manchester,England,1924,1,34,144,3,1,64,287,4,30,143,1,16.0,<=30,ENG,Home,Upto 2014
MW Tate,ENG,Spin,1924-08-16,The Oval,England,1924,1,64,174,3,1,425,954,15,361,780,12,28.333333333333332,<=30,ENG,Home,Upto 2014
MW Tate,ENG,Spin,1924-12-19,Sydney,Australia,1924,2,228,712,11,1,978,2361,24,750,1649,13,40.75,>30,AUS,Away,Upto 2014
MW Tate,ENG,Spin,1925-01-01,Melbourne,Australia,1925,2,241,627,9,1,988,2427,24,747,1800,15,41.166666666666664,>30,AUS,Away,Upto 2014
MW Tate,ENG,Spin,1925-01-16,Adelaide,Australia,1925,2,60,224,2,1,1079,2740,29,1019,2516,27,37.206896551724135,>30,AUS,Away,Upto 2014
MW Tate,ENG,Spin,1925-02-13,Melbourne,Australia,1925,2,145,333,7,1,718,1606,23,573,1273,16,31.217391304347824,>30,AUS,Away,Upto 2014
MW Tate,ENG,Spin,1925-02-27,Sydney,Australia,1925,2,207,632,9,1,638,1899,28,431,1267,19,22.785714285714285,<=30,AUS,Away,Upto 2014
MW Tate,ENG,Spin,1926-06-26,Lord's,England,1926,2,149,450,3,1,556,1523,10,407,1073,7,55.6,>30,ENG,Home,Upto 2014
MW Tate,ENG,Spin,1926-07-10,Leeds,England,1926,1,99,306,4,1,810,1836,19,711,1530,15,42.63157894736842,>30,ENG,Home,Upto 2014
MW Tate,ENG,Spin,1926-07-24,Manchester,England,1926,1,88,218,2,1,479,1184,11,391,966,9,43.54545454545455,>30,ENG,Home,Upto 2014
MW Tate,ENG,Spin,1926-08-14,The Oval,England,1926,2,52,277,4,1,808,2213,28,756,1936,24,28.857142857142858,<=30,ENG,Home,Upto 2014
MW Tate,ENG,Spin,1928-06-23,Lord's,England,1928,2,82,294,4,1,284,808,17,202,514,13,16.705882352941178,<=30,ENG,Home,Upto 2014
MW Tate,ENG,Spin,1928-07-21,Manchester,England,1928,2,78,264,2,1,291,903,19,213,639,17,15.31578947368421,<=30,ENG,Home,Upto 2014
MW Tate,ENG,Spin,1928-08-11,The Oval,England,1928,2,86,204,7,1,308,610,14,222,406,7,22.0,<=30,ENG,Home,Upto 2014
MW Tate,ENG,Spin,1928-11-30,Brisbane,Australia,1928,2,76,192,5,1,545,1303,22,469,1111,17,24.772727272727273,<=30,AUS,Away,Upto 2014
MW Tate,ENG,Spin,1928-12-14,Sydney,Australia,1928,2,128,402,4,1,782,1986,12,654,1584,8,65.16666666666667,>30,AUS,Away,Upto 2014
MW Tate,ENG,Spin,1928-12-29,Melbourne,Australia,1928,2,157,558,4,1,717,2327,21,560,1769,17,34.142857142857146,>30,AUS,Away,Upto 2014
MW Tate,ENG,Spin,1929-02-01,Adelaide,Australia,1929,2,152,474,4,1,757,2268,26,605,1794,22,29.115384615384617,<=30,AUS,Away,Upto 2014
MW Tate,ENG,Spin,1929-03-08,Melbourne,Australia,1929,2,184,600,0,1,660,1893,8,476,1293,8,82.5,>30,AUS,Away,Upto 2014
MW Tate,ENG,Spin,1929-06-15,Birmingham,England,1929,2,108,360,3,1,416,1126,6,308,766,3,69.33333333333333,>30,ENG,Home,Upto 2014
MW Tate,ENG,Spin,1929-06-29,Lord's,England,1929,2,135,300,4,1,382,1002,11,247,702,7,34.72727272727273,>30,ENG,Home,Upto 2014
MW Tate,ENG,Spin,1929-07-13,Leeds,England,1929,2,90,312,3,1,624,1466,25,534,1154,22,24.96,<=30,ENG,Home,Upto 2014
MW Tate,ENG,Spin,1930-06-13,Nottingham,England,1930,2,89,414,6,1,620,1484,29,531,1070,23,21.379310344827587,<=30,ENG,Home,Upto 2014
MW Tate,ENG,Spin,1930-06-27,Lord's,England,1930,2,169,462,2,1,960,1932,18,791,1470,16,53.333333333333336,>30,ENG,Home,Upto 2014
MW Tate,ENG,Spin,1930-07-11,Leeds,England,1930,1,124,234,5,1,548,1255,15,424,1021,10,36.53333333333333,>30,ENG,Home,Upto 2014
MW Tate,ENG,Spin,1930-07-25,Manchester,England,1930,1,39,180,1,1,355,1021,7,316,841,6,50.714285714285715,>30,ENG,Home,Upto 2014
MW Tate,ENG,Spin,1930-08-16,The Oval,England,1930,1,153,391,1,1,762,1847,19,609,1456,18,40.10526315789474,>30,ENG,Home,Upto 2014
MW Tate,ENG,Spin,1930-12-24,Johannesburg,South Africa,1930,2,67,182,3,1,386,746,13,319,564,10,29.692307692307693,<=30,SA,Away,Upto 2014
MW Tate,ENG,Spin,1931-01-01,Cape Town,South Africa,1931,1,79,258,3,1,731,1678,19,652,1420,16,38.473684210526315,>30,SA,Away,Upto 2014
MW Tate,ENG,Spin,1931-01-16,Durban,South Africa,1931,2,45,216,3,1,228,660,10,183,444,7,22.8,<=30,SA,Away,Upto 2014
MW Tate,ENG,Spin,1931-02-13,Johannesburg,South Africa,1931,2,98,294,4,1,443,1089,15,345,795,11,29.533333333333335,<=30,SA,Away,Upto 2014
MW Tate,ENG,Spin,1931-02-21,Durban,South Africa,1931,2,52,186,1,1,436,1147,20,384,961,19,21.8,<=30,SA,Away,Upto 2014
MW Tate,ENG,Spin,1931-07-29,The Oval,England,1931,2,37,234,4,1,591,1465,18,554,1231,14,32.833333333333336,>30,ENG,Home,Upto 2014
MW Tate,ENG,Spin,1933-03-24,Christchurch,New Zealand,1933,2,47,240,2,1,316,759,7,269,519,5,45.142857142857146,>30,NZ,Away,Upto 2014
MW Tate,ENG,Spin,1935-07-27,Manchester,England,1935,2,87,189,2,1,449,1029,11,362,840,9,40.81818181818182,>30,ENG,Home,Upto 2014
MWW Selvey,ENG,Pace,1976-07-08,Manchester,England,1976,2,152,258,6,1,437,1066,29,285,808,23,15.068965517241379,<=30,ENG,Home,Upto 2014
MWW Selvey,ENG,Pace,1976-08-12,The Oval,England,1976,2,111,144,0,1,768,1323,20,657,1179,20,38.4,>30,ENG,Home,Upto 2014
MWW Selvey,ENG,Pace,1977-02-11,Wankhede,India,1977,1,80,90,0,1,299,578,10,219,488,10,29.9,<=30,IND,Away,Upto 2014
Mahbubul Alam,BAN,Pace,2008-10-25,Mirpur,Bangladesh,2008,2,49,66,1,1,137,265,6,88,199,5,22.833333333333332,<=30,BAN,Home,Upto 2014
Mahbubul Alam,BAN,Pace,2008-11-19,Bloemfontein,South Africa,2008,1,62,149,2,1,387,770,21,325,621,19,18.428571428571427,<=30,SA,Away,Upto 2014
Mahbubul Alam,BAN,Pace,2008-11-26,Centurion,South Africa,2008,1,85,156,1,1,529,990,19,444,834,18,27.842105263157894,<=30,SA,Away,Upto 2014
Mahbubul Alam,BAN,Pace,2008-12-26,Mirpur,Bangladesh,2008,2,118,216,1,1,517,896,12,399,680,11,43.083333333333336,>30,BAN,Home,Upto 2014
Mahmood Hussain,PAK,Pace,1952-10-23,Lucknow,India,1952,2,92,252,4,1,415,1291,25,323,1039,21,16.6,<=30,IND,Away,Upto 2014
Mahmood Hussain,PAK,Pace,1952-11-13,Brabourne,India,1952,2,142,246,3,1,405,896,8,263,650,5,50.625,>30,IND,Away,Upto 2014
Mahmood Hussain,PAK,Pace,1952-11-28,Chennai,India,1952,1,70,132,2,1,235,515,6,165,383,4,39.166666666666664,>30,IND,Away,Upto 2014
Mahmood Hussain,PAK,Pace,1952-12-12,Eden Gardens,India,1952,1,114,276,3,1,409,1086,14,295,810,11,29.214285714285715,<=30,IND,Away,Upto 2014
Mahmood Hussain,PAK,Pace,1954-07-22,Manchester,England,1954,1,88,162,0,1,265,605,10,177,443,10,26.5,<=30,ENG,Away,Upto 2014
Mahmood Hussain,PAK,Pace,1954-08-12,The Oval,England,1954,2,90,213,5,1,370,1087,27,280,874,22,13.703703703703704,<=30,ENG,Away,Upto 2014
Mahmood Hussain,PAK,Pace,1955-01-01,Dhaka,Bangladesh,1955,2,88,204,6,1,253,947,14,165,743,8,18.071428571428573,<=30,BAN,Away,Upto 2014
Mahmood Hussain,PAK,Pace,1955-01-15,Bahawalpur,Pakistan,1955,2,103,252,2,1,416,1187,15,313,935,13,27.733333333333334,<=30,PAK,Home,Upto 2014
Mahmood Hussain,PAK,Pace,1955-01-29,Lahore,Pakistan,1955,2,71,163,4,1,171,571,7,100,408,3,24.428571428571427,<=30,PAK,Home,Upto 2014
Mahmood Hussain,PAK,Pace,1955-02-12,Peshawar,Pakistan,1955,2,80,240,2,1,201,612,7,121,372,5,28.714285714285715,<=30,PAK,Home,Upto 2014
Mahmood Hussain,PAK,Pace,1955-02-26,Karachi,Pakistan,1955,2,30,60,0,1,257,771,19,227,711,19,13.526315789473685,<=30,PAK,Home,Upto 2014
Mahmood Hussain,PAK,Pace,1955-10-26,Lahore,Pakistan,1955,2,114,317,1,1,619,1402,11,505,1085,10,56.27272727272727,>30,PAK,Home,Upto 2014
Mahmood Hussain,PAK,Pace,1958-01-17,Bridgetown,West Indies,1958,1,153,248,4,1,627,1370,15,474,1122,11,41.8,>30,WI,Away,Upto 2014
Mahmood Hussain,PAK,Pace,1958-02-05,Port of Spain,West Indies,1958,2,260,438,4,1,632,1494,19,372,1056,15,33.26315789473684,>30,WI,Away,Upto 2014
Mahmood Hussain,PAK,Pace,1958-02-26,Kingston,West Indies,1958,1,2,5,0,1,916,1594,17,914,1589,17,53.88235294117647,>30,WI,Away,Upto 2014
Mahmood Hussain,PAK,Pace,1959-02-20,Karachi,Pakistan,1959,2,72,204,2,1,346,942,12,274,738,10,28.833333333333332,<=30,PAK,Home,Upto 2014
Mahmood Hussain,PAK,Pace,1959-03-06,Dhaka,Bangladesh,1959,2,69,179,5,1,310,823,30,241,644,25,10.333333333333334,<=30,BAN,Away,Upto 2014
Mahmood Hussain,PAK,Pace,1959-03-26,Lahore,Pakistan,1959,1,99,168,1,1,381,764,12,282,596,11,31.75,>30,PAK,Home,Upto 2014
Mahmood Hussain,PAK,Pace,1960-12-02,Brabourne,India,1960,1,129,310,5,1,494,1042,13,365,732,8,38.0,>30,IND,Away,Upto 2014
Mahmood Hussain,PAK,Pace,1960-12-16,Kanpur,India,1960,1,101,269,2,1,201,695,5,100,426,3,40.2,>30,IND,Away,Upto 2014
Mahmood Hussain,PAK,Pace,1960-12-30,Eden Gardens,India,1960,2,65,234,2,1,412,1155,15,347,921,13,27.466666666666665,<=30,IND,Away,Upto 2014
Mahmood Hussain,PAK,Pace,1961-01-13,Chennai,India,1961,1,86,222,1,1,342,929,6,256,707,5,57.0,>30,IND,Away,Upto 2014
Mahmood Hussain,PAK,Pace,1961-02-08,Delhi,India,1961,2,122,246,3,1,579,1092,16,457,846,13,36.1875,>30,IND,Away,Upto 2014
Mahmood Hussain,PAK,Pace,1961-10-21,Lahore,Pakistan,1961,2,65,222,1,1,400,1080,13,335,858,12,30.76923076923077,>30,PAK,Home,Upto 2014
Mahmood Hussain,PAK,Pace,1962-05-31,Birmingham,England,1962,1,130,258,2,1,384,834,12,254,576,10,32.0,>30,ENG,Away,Upto 2014
Mahmood Hussain,PAK,Pace,1962-06-21,Lord's,England,1962,1,106,240,2,1,524,1195,25,418,955,23,20.96,<=30,ENG,Away,Upto 2014
Mahmood Hussain,PAK,Pace,1962-07-05,Leeds,England,1962,1,87,150,2,1,501,1157,23,414,1007,21,21.782608695652176,<=30,ENG,Away,Upto 2014
Mahmudul Hasan Joy,BAN,Spin,2022-05-15,Chattogram,Bangladesh,2022,1,0,1,0,1,772,1873,17,772,1872,17,45.411764705882355,>30,BAN,Home,After 1965
Mahmudul Hasan Joy,BAN,Spin,2024-10-29,Chattogram,Bangladesh,2024,1,14,12,0,1,583,920,17,569,908,17,34.294117647058826,>30,BAN,Home,After 1965
Mahmudullah,BAN,Spin,2009-07-09,Kingstown,West Indies,2009,2,110,208,8,1,504,1195,18,394,987,10,28.0,<=30,WI,Away,Upto 2014
Mahmudullah,BAN,Spin,2009-07-17,St George's,West Indies,2009,2,81,168,4,1,462,930,22,381,762,18,21.0,<=30,WI,Away,Upto 2014
Mahmudullah,BAN,Spin,2010-01-17,Chattogram,Bangladesh,2010,2,69,96,2,1,565,949,23,496,853,21,24.565217391304348,<=30,BAN,Home,Upto 2014
Mahmudullah,BAN,Spin,2010-01-24,Mirpur,Bangladesh,2010,1,78,90,0,1,600,1045,11,522,955,11,54.54545454545455,>30,BAN,Home,Upto 2014
Mahmudullah,BAN,Spin,2010-02-15,Hamilton,New Zealand,2010,2,105,156,2,1,711,1173,10,606,1017,8,71.1,>30,NZ,Away,Upto 2014
Mahmudullah,BAN,Spin,2010-03-12,Chattogram,Bangladesh,2010,2,104,186,3,1,894,1491,22,790,1305,19,40.63636363636363,>30,BAN,Home,Upto 2014
Mahmudullah,BAN,Spin,2010-03-20,Mirpur,Bangladesh,2010,2,91,162,1,1,865,1792,20,774,1630,19,43.25,>30,BAN,Home,Upto 2014
Mahmudullah,BAN,Spin,2010-05-27,Lord's,England,2010,2,130,229,2,1,517,907,10,387,678,8,51.7,>30,ENG,Away,Upto 2014
Mahmudullah,BAN,Spin,2010-06-04,Manchester,England,2010,1,31,72,0,1,455,779,14,424,707,14,32.5,>30,ENG,Away,Upto 2014
Mahmudullah,BAN,Spin,2011-08-04,Harare,Zimbabwe,2011,2,35,84,1,1,318,704,9,283,620,8,35.333333333333336,>30,ZIM,Away,Upto 2014
Mahmudullah,BAN,Spin,2011-12-09,Chattogram,Bangladesh,2011,1,94,180,1,1,717,1447,18,623,1267,17,39.833333333333336,>30,BAN,Home,Upto 2014
Mahmudullah,BAN,Spin,2011-12-17,Mirpur,Bangladesh,2011,1,45,90,0,1,690,1381,17,645,1291,17,40.588235294117645,>30,BAN,Home,Upto 2014
Mahmudullah,BAN,Spin,2012-11-13,Mirpur,Bangladesh,2012,2,57,102,0,1,992,1679,19,935,1577,19,52.21052631578947,>30,BAN,Home,Upto 2014
Mahmudullah,BAN,Spin,2012-11-21,Khulna,Bangladesh,2012,1,42,60,0,1,763,1327,11,721,1267,11,69.36363636363636,>30,BAN,Home,Upto 2014
Mahmudullah,BAN,Spin,2013-03-08,Galle,Sri Lanka,2013,2,115,186,3,1,1160,1920,13,1045,1734,10,89.23076923076923,>30,SL,Away,Upto 2014
Mahmudullah,BAN,Spin,2013-03-16,Colombo (RPS),Sri Lanka,2013,2,49,87,1,1,481,1042,18,432,955,17,26.72222222222222,<=30,SL,Away,Upto 2014
Mahmudullah,BAN,Spin,2013-04-17,Harare,Zimbabwe,2013,2,26,42,0,1,326,755,9,300,713,9,36.22222222222222,>30,ZIM,Away,Upto 2014
Mahmudullah,BAN,Spin,2014-02-04,Chattogram,Bangladesh,2014,2,156,312,3,1,1153,1976,25,997,1664,22,46.12,>30,BAN,Home,After 1965
Mahmudullah,BAN,Spin,2014-09-05,Kingstown,West Indies,2014,1,64,114,0,1,510,1180,16,446,1066,16,31.875,>30,WI,Away,After 1965
Mahmudullah,BAN,Spin,2014-09-13,Gros Islet,West Indies,2014,2,113,192,3,1,411,807,13,298,615,10,31.615384615384617,>30,WI,Away,After 1965
Mahmudullah,BAN,Spin,2014-10-25,Mirpur,Bangladesh,2014,1,2,6,0,1,460,898,22,458,892,22,20.90909090909091,<=30,BAN,Home,After 1965
Mahmudullah,BAN,Spin,2014-11-03,Khulna,Bangladesh,2014,1,13,12,0,1,829,1764,29,816,1752,29,28.586206896551722,<=30,BAN,Home,After 1965
Mahmudullah,BAN,Spin,2014-11-12,Chattogram,Bangladesh,2014,2,11,42,1,1,952,1674,19,941,1632,18,50.10526315789474,>30,BAN,Home,After 1965
Mahmudullah,BAN,Spin,2015-04-28,Khulna,Bangladesh,2015,1,30,24,0,1,1092,1798,20,1062,1774,20,54.6,>30,BAN,Home,After 1965
Mahmudullah,BAN,Spin,2015-05-06,Mirpur,Bangladesh,2015,2,20,25,1,1,692,1014,18,672,989,17,38.44444444444444,>30,BAN,Home,After 1965
Mahmudullah,BAN,Spin,2015-07-21,Chattogram,Bangladesh,2015,2,9,24,1,1,318,607,10,309,583,9,31.8,>30,BAN,Home,After 1965
Mahmudullah,BAN,Spin,2016-10-20,Chattogram,Bangladesh,2016,2,23,18,0,1,760,1579,30,737,1561,30,25.333333333333332,<=30,BAN,Home,After 1965
Mahmudullah,BAN,Spin,2017-01-12,Wellington,New Zealand,2017,1,15,18,2,1,423,748,8,408,730,6,52.875,>30,NZ,Away,After 1965
Mahmudullah,BAN,Spin,2017-02-09,Hyderabad,India,2017,1,16,30,0,1,881,1634,19,865,1604,19,46.36842105263158,>30,IND,Away,After 1965
Mahmudullah,BAN,Spin,2017-03-07,Galle,Sri Lanka,2017,1,10,12,0,1,752,1277,25,742,1265,25,30.08,>30,SL,Away,After 1965
Mahmudullah,BAN,Spin,2017-09-28,Potchefstroom,South Africa,2017,2,45,54,0,1,504,803,10,459,749,10,50.4,>30,SA,Away,After 1965
Mahmudullah,BAN,Spin,2017-10-06,Bloemfontein,South Africa,2017,1,35,54,0,1,239,300,1,204,246,1,239.0,>30,SA,Away,After 1965
Mahmudullah,BAN,Spin,2018-01-31,Chattogram,Bangladesh,2018,1,7,6,0,1,1210,2061,19,1203,2055,19,63.68421052631579,>30,BAN,Home,After 1965
Mahmudullah,BAN,Spin,2018-07-04,North Sound,West Indies,2018,1,18,66,1,1,218,480,6,200,414,5,36.333333333333336,>30,WI,Away,After 1965
Mahmudullah,BAN,Spin,2018-07-12,Kingston,West Indies,2018,1,20,48,0,1,399,810,18,379,762,18,22.166666666666668,<=30,WI,Away,After 1965
Mahmudullah,BAN,Spin,2018-11-03,Sylhet,Bangladesh,2018,2,10,42,1,1,549,1328,32,539,1286,31,17.15625,<=30,BAN,Home,After 1965
Mahmudullah,BAN,Spin,2018-11-11,Mirpur,Bangladesh,2018,2,15,18,0,1,819,1414,17,804,1396,17,48.1764705882353,>30,BAN,Home,After 1965
Mahmudullah,BAN,Spin,2018-11-22,Chattogram,Bangladesh,2018,1,7,12,0,1,618,1097,34,611,1085,34,18.176470588235293,<=30,BAN,Home,After 1965
Mahmudullah,BAN,Spin,2018-11-30,Mirpur,Bangladesh,2018,2,6,12,0,1,676,1230,27,670,1218,27,25.037037037037038,<=30,BAN,Home,After 1965
Mahmudullah,BAN,Spin,2019-02-28,Hamilton,New Zealand,2019,1,3,6,1,1,362,462,3,359,456,2,120.66666666666667,>30,NZ,Away,After 1965
Mahmudullah,BAN,Spin,2019-09-05,Chattogram,Bangladesh,2019,1,9,24,1,1,903,1930,38,894,1906,37,23.763157894736842,<=30,BAN,Home,After 1965
Mahmudullah,BAN,Spin,2019-11-14,Indore,India,2019,1,24,18,0,1,411,632,6,387,614,6,68.5,>30,IND,Away,After 1965
Mahmudullah,BAN,Spin,2020-02-07,Rawalpindi,Pakistan,2020,1,6,12,0,1,309,548,8,303,536,8,38.625,>30,PAK,Away,After 1965
Mahmudullah,BAN,Spin,2021-07-07,Harare,Zimbabwe,2021,1,9,24,0,1,544,1099,15,535,1075,15,36.266666666666666,>30,ZIM,Away,After 1965
Majid Khan,PAK,Spin,1964-10-24,Karachi,Pakistan,1964,2,97,276,3,1,840,2130,18,743,1854,15,46.666666666666664,>30,PAK,Home,Upto 2014
Majid Khan,PAK,Spin,1965-03-27,Rawalpindi,Pakistan,1965,2,20,54,1,1,362,890,18,342,836,17,20.11111111111111,<=30,PAK,Home,Upto 2014
Majid Khan,PAK,Spin,1965-04-02,Lahore,Pakistan,1965,1,57,144,1,1,697,1836,15,640,1692,14,46.46666666666667,>30,PAK,Home,Upto 2014
Majid Khan,PAK,Spin,1965-04-09,Karachi,Pakistan,1965,2,93,168,1,1,606,1528,19,513,1360,18,31.894736842105264,>30,PAK,Home,Upto 2014
Majid Khan,PAK,Spin,1967-07-27,Lord's,England,1967,2,60,126,2,1,583,1689,19,523,1563,17,30.68421052631579,>30,ENG,Away,Upto 2014
Majid Khan,PAK,Spin,1967-08-24,The Oval,England,1967,1,29,60,1,1,475,1075,13,446,1015,12,36.53846153846154,>30,ENG,Away,Upto 2014
Majid Khan,PAK,Spin,1969-02-21,Lahore,Pakistan,1969,2,66,228,3,1,546,1362,17,480,1134,14,32.11764705882353,>30,PAK,Home,Upto 2014
Majid Khan,PAK,Spin,1969-02-28,Dhaka,Bangladesh,1969,1,15,66,0,1,397,1246,15,382,1180,15,26.466666666666665,<=30,BAN,Away,Upto 2014
Majid Khan,PAK,Spin,1969-03-06,Karachi,Pakistan,1969,1,51,120,0,1,302,679,5,251,559,5,60.4,>30,PAK,Home,Upto 2014
Majid Khan,PAK,Spin,1971-06-03,Birmingham,England,1971,1,8,24,0,1,451,1037,8,443,1013,8,56.375,>30,ENG,Away,Upto 2014
Majid Khan,PAK,Spin,1971-06-17,Lord's,England,1971,2,23,60,0,1,197,492,2,174,432,2,98.5,>30,ENG,Away,Upto 2014
Majid Khan,PAK,Spin,1972-12-22,Adelaide,Australia,1972,1,88,160,2,1,497,880,15,409,720,13,33.13333333333333,>30,AUS,Away,Upto 2014
Majid Khan,PAK,Spin,1972-12-29,Melbourne,Australia,1972,2,141,304,1,1,666,1379,10,525,1075,9,66.6,>30,AUS,Away,Upto 2014
Majid Khan,PAK,Spin,1973-01-06,Sydney,Australia,1973,1,66,144,1,1,122,273,3,56,129,2,40.666666666666664,>30,AUS,Away,Upto 2014
Majid Khan,PAK,Spin,1973-02-02,Wellington,New Zealand,1973,1,19,72,1,1,304,776,6,285,704,5,50.666666666666664,>30,NZ,Away,Upto 2014
Majid Khan,PAK,Spin,1973-02-16,Auckland,New Zealand,1973,2,41,48,0,1,488,1070,18,447,1022,18,27.11111111111111,<=30,NZ,Away,Upto 2014
Majid Khan,PAK,Spin,1973-03-02,Lahore,Pakistan,1973,1,12,18,0,1,766,1787,23,754,1769,23,33.30434782608695,>30,PAK,Home,Upto 2014
Majid Khan,PAK,Spin,1973-03-16,Hyderabad (Sind),Pakistan,1973,1,4,12,0,1,993,2402,21,989,2390,21,47.285714285714285,>30,PAK,Home,Upto 2014
Majid Khan,PAK,Spin,1973-03-24,Karachi,Pakistan,1973,1,51,132,2,1,724,1728,23,673,1596,21,31.47826086956522,>30,PAK,Home,Upto 2014
Majid Khan,PAK,Spin,1974-08-08,Lord's,England,1974,1,10,12,0,1,263,688,20,253,676,20,13.15,<=30,ENG,Away,Upto 2014
Majid Khan,PAK,Spin,1976-10-23,Hyderabad (Sind),Pakistan,1976,1,0,16,0,1,481,1360,16,481,1344,16,30.0625,>30,PAK,Home,Upto 2014
Majid Khan,PAK,Spin,1976-10-30,Karachi,Pakistan,1976,2,23,112,0,1,499,1183,10,476,1071,10,49.9,>30,PAK,Home,Upto 2014
Majid Khan,PAK,Spin,1977-01-01,Melbourne,Australia,1977,2,22,30,1,1,386,751,13,364,721,12,29.692307692307693,<=30,AUS,Away,Upto 2014
Majid Khan,PAK,Spin,1977-02-18,Bridgetown,West Indies,1977,2,2,12,0,1,180,418,4,178,406,4,45.0,>30,WI,Away,Upto 2014
Majid Khan,PAK,Spin,1977-03-04,Port of Spain,West Indies,1977,1,9,48,0,1,450,1050,10,441,1002,10,45.0,>30,WI,Away,Upto 2014
Majid Khan,PAK,Spin,1977-03-18,Georgetown,West Indies,1977,2,56,162,4,1,174,438,6,118,276,2,29.0,<=30,WI,Away,Upto 2014
Majid Khan,PAK,Spin,1977-04-01,Port of Spain,West Indies,1977,1,3,60,0,1,392,967,20,389,907,20,19.6,<=30,WI,Away,Upto 2014
Majid Khan,PAK,Spin,1978-10-27,Lahore,Pakistan,1978,1,5,12,0,1,591,988,6,586,976,6,98.5,>30,PAK,Home,Upto 2014
Majid Khan,PAK,Spin,1979-02-16,Napier,New Zealand,1979,1,13,40,0,1,237,587,3,224,547,3,79.0,>30,NZ,Away,Upto 2014
Majid Khan,PAK,Spin,1979-03-10,Melbourne,Australia,1979,1,34,72,0,1,258,519,6,224,447,6,43.0,>30,AUS,Away,Upto 2014
Majid Khan,PAK,Spin,1979-11-21,Bengaluru,India,1979,1,55,168,3,1,552,1383,11,497,1215,8,50.18181818181818,>30,IND,Away,Upto 2014
Majid Khan,PAK,Spin,1979-12-04,Delhi,India,1979,2,20,30,0,1,303,672,3,283,642,3,101.0,>30,IND,Away,Upto 2014
Majid Khan,PAK,Spin,1979-12-16,Wankhede,India,1979,2,66,162,0,1,435,1053,22,369,891,22,19.772727272727273,<=30,IND,Away,Upto 2014
Majid Khan,PAK,Spin,1980-01-15,Chennai,India,1980,1,30,54,0,1,236,570,6,206,516,6,39.333333333333336,>30,IND,Away,Upto 2014
Majid Khan,PAK,Spin,1980-01-29,Eden Gardens,India,1980,1,10,12,0,1,248,600,5,238,588,5,49.6,>30,IND,Away,Upto 2014
Majid Khan,PAK,Spin,1980-02-27,Karachi,Pakistan,1980,2,13,18,0,1,432,1328,28,419,1310,28,15.428571428571429,<=30,PAK,Home,Upto 2014
Majid Khan,PAK,Spin,1980-03-06,Faisalabad,Pakistan,1980,1,66,132,0,1,592,1272,6,526,1140,6,98.66666666666667,>30,PAK,Home,Upto 2014
Majid Khan,PAK,Spin,1980-03-18,Lahore,Pakistan,1980,2,26,66,0,1,686,1374,15,660,1308,15,45.733333333333334,>30,PAK,Home,Upto 2014
Majid Khan,PAK,Spin,1980-12-22,Karachi,Pakistan,1980,1,12,48,0,1,122,421,6,110,373,6,20.333333333333332,<=30,PAK,Home,Upto 2014
Majid Khan,PAK,Spin,1981-11-27,Brisbane,Australia,1981,1,21,54,0,1,312,546,7,291,492,7,44.57142857142857,>30,AUS,Away,Upto 2014
Majid Khan,PAK,Spin,1981-12-11,Melbourne,Australia,1981,2,15,36,0,1,491,1248,15,476,1212,15,32.733333333333334,>30,AUS,Away,Upto 2014
Majid Khan,PAK,Spin,1982-03-22,Lahore,Pakistan,1982,1,0,6,0,1,386,750,7,386,744,7,55.142857142857146,>30,PAK,Home,Upto 2014
Majid Khan,PAK,Spin,1983-01-23,Lahore,Pakistan,1983,1,4,6,0,1,176,366,3,172,360,3,58.666666666666664,>30,PAK,Home,Upto 2014
Maninder Singh,IND,Spin,1982-12-23,Karachi,Pakistan,1982,1,67,138,0,1,277,474,7,210,336,7,39.57142857142857,>30,PAK,Away,Upto 2014
Maninder Singh,IND,Spin,1983-01-03,Faisalabad,Pakistan,1983,1,103,174,1,1,324,501,2,221,327,1,162.0,>30,PAK,Away,Upto 2014
Maninder Singh,IND,Spin,1983-01-14,Hyderabad (Sind),Pakistan,1983,1,135,300,0,1,496,1008,6,361,708,6,82.66666666666667,>30,PAK,Away,Upto 2014
Maninder Singh,IND,Spin,1983-01-23,Lahore,Pakistan,1983,1,90,192,2,1,176,366,3,86,174,1,58.666666666666664,>30,PAK,Away,Upto 2014
Maninder Singh,IND,Spin,1983-01-30,Karachi,Pakistan,1983,1,49,96,0,1,287,546,2,238,450,2,143.5,>30,PAK,Away,Upto 2014
Maninder Singh,IND,Spin,1983-02-23,Kingston,West Indies,1983,1,51,186,0,1,239,624,5,188,438,5,47.8,>30,WI,Away,Upto 2014
Maninder Singh,IND,Spin,1983-03-11,Port of Spain,West Indies,1983,1,51,159,1,1,280,699,7,229,540,6,40.0,>30,WI,Away,Upto 2014
Maninder Singh,IND,Spin,1983-03-31,Georgetown,West Indies,1983,1,90,162,1,1,357,630,4,267,468,3,89.25,>30,WI,Away,Upto 2014
Maninder Singh,IND,Spin,1983-11-12,Ahmedabad,India,1983,2,133,288,4,1,250,501,5,117,213,1,50.0,>30,IND,Home,Upto 2014
Maninder Singh,IND,Spin,1983-11-24,Wankhede,India,1983,2,96,252,1,1,386,913,10,290,661,9,38.6,>30,IND,Home,Upto 2014
Maninder Singh,IND,Spin,1983-12-10,Eden Gardens,India,1983,1,54,168,2,1,206,486,5,152,318,3,41.2,>30,IND,Home,Upto 2014
Maninder Singh,IND,Spin,1983-12-24,Chennai,India,1983,2,51,213,3,1,365,891,7,314,678,4,52.142857142857146,>30,IND,Home,Upto 2014
Maninder Singh,IND,Spin,1984-10-17,Lahore,Pakistan,1984,1,90,240,1,1,362,1073,9,272,833,8,40.22222222222222,>30,PAK,Away,Upto 2014
Maninder Singh,IND,Spin,1985-08-30,Colombo (SSC),Sri Lanka,1985,1,82,240,2,1,225,696,4,143,456,2,56.25,>30,SL,Away,Upto 2014
Maninder Singh,IND,Spin,1985-09-14,Kandy,Sri Lanka,1985,2,130,279,4,1,249,489,4,119,210,0,62.25,>30,SL,Away,Upto 2014
Maninder Singh,IND,Spin,1986-06-05,Lord's,England,1986,2,54,304,4,1,225,844,8,171,540,4,28.125,<=30,ENG,Away,Upto 2014
Maninder Singh,IND,Spin,1986-06-19,Leeds,England,1986,1,26,99,4,1,106,321,7,80,222,3,15.142857142857142,<=30,ENG,Away,Upto 2014
Maninder Singh,IND,Spin,1986-07-03,Birmingham,England,1986,2,107,282,4,1,336,971,13,229,689,9,25.846153846153847,<=30,ENG,Away,Upto 2014
Maninder Singh,IND,Spin,1986-09-18,Chennai,India,1986,2,195,348,3,1,1032,1788,27,837,1440,24,38.22222222222222,>30,IND,Home,Upto 2014
Maninder Singh,IND,Spin,1986-09-26,Delhi,India,1986,1,54,114,0,1,149,340,2,95,226,2,74.5,>30,IND,Home,Upto 2014
Maninder Singh,IND,Spin,1986-10-15,Wankhede,India,1986,2,103,318,2,1,676,1768,13,573,1450,11,52.0,>30,IND,Home,Upto 2014
Maninder Singh,IND,Spin,1986-12-17,Kanpur,India,1986,1,89,192,2,1,263,540,3,174,348,1,87.66666666666667,>30,IND,Home,Upto 2014
Maninder Singh,IND,Spin,1986-12-27,Nagpur,India,1986,2,107,226,10,1,408,845,19,301,619,9,21.473684210526315,<=30,IND,Home,Upto 2014
Maninder Singh,IND,Spin,1987-01-04,Cuttack,India,1987,2,83,205,6,1,354,865,18,271,660,12,19.666666666666668,<=30,IND,Home,Upto 2014
Maninder Singh,IND,Spin,1987-02-03,Chennai,India,1987,2,182,510,7,1,827,1860,14,645,1350,7,59.07142857142857,>30,IND,Home,Upto 2014
Maninder Singh,IND,Spin,1987-02-11,Eden Gardens,India,1987,2,51,217,1,1,258,750,5,207,533,4,51.6,>30,IND,Home,Upto 2014
Maninder Singh,IND,Spin,1987-03-04,Ahmedabad,India,1987,2,119,462,2,1,616,1851,11,497,1389,9,56.0,>30,IND,Home,Upto 2014
Maninder Singh,IND,Spin,1987-03-13,Bengaluru,India,1987,2,126,373,10,1,527,1530,35,401,1157,25,15.057142857142857,<=30,IND,Home,Upto 2014
Maninder Singh,IND,Spin,1987-11-25,Delhi,India,1987,2,88,162,0,1,217,492,5,129,330,5,43.4,>30,IND,Home,Upto 2014
Maninder Singh,IND,Spin,1987-12-11,Wankhede,India,1987,1,68,102,1,1,252,507,7,184,405,6,36.0,>30,IND,Home,Upto 2014
Maninder Singh,IND,Spin,1987-12-26,Eden Gardens,India,1987,2,154,317,1,1,615,1451,5,461,1134,4,123.0,>30,IND,Home,Upto 2014
Maninder Singh,IND,Spin,1989-11-23,Faisalabad,Pakistan,1989,1,70,126,0,1,216,414,1,146,288,1,216.0,>30,PAK,Away,Upto 2014
Maninder Singh,IND,Spin,1989-12-01,Lahore,Pakistan,1989,1,191,366,2,1,665,1174,7,474,808,5,95.0,>30,PAK,Away,Upto 2014
Maninder Singh,IND,Spin,1989-12-09,Sialkot,Pakistan,1989,1,4,6,0,1,4,24,0,0,18,0,inf,>30,PAK,Away,Upto 2014
Maninder Singh,IND,Spin,1993-03-13,Delhi,India,1993,2,145,402,7,1,645,1548,21,500,1146,14,30.714285714285715,>30,IND,Home,Upto 2014
Manjural Islam,BAN,Pace,2001-04-19,Bulawayo,Zimbabwe,2001,1,81,210,6,1,731,1458,26,650,1248,20,28.115384615384617,<=30,ZIM,Away,Upto 2014
Manjural Islam,BAN,Pace,2001-04-26,Harare,Zimbabwe,2001,2,134,258,0,1,669,1497,14,535,1239,14,47.785714285714285,>30,ZIM,Away,Upto 2014
Manjural Islam,BAN,Pace,2001-08-29,Multan,Pakistan,2001,1,103,114,0,1,512,738,9,409,624,9,56.888888888888886,>30,PAK,Away,Upto 2014
Manjural Islam,BAN,Pace,2001-09-06,Colombo (SSC),Sri Lanka,2001,1,94,108,0,1,535,726,8,441,618,8,66.875,>30,SL,Away,Upto 2014
Manjural Islam,BAN,Pace,2001-11-08,Dhaka,Bangladesh,2001,1,74,156,2,1,386,858,18,312,702,16,21.444444444444443,<=30,BAN,Home,Upto 2014
Manjural Islam,BAN,Pace,2001-12-18,Hamilton,New Zealand,2001,1,66,108,2,1,586,928,27,520,820,25,21.703703703703702,<=30,NZ,Away,Upto 2014
Manjural Islam,BAN,Pace,2001-12-26,Wellington,New Zealand,2001,1,99,174,3,1,447,846,18,348,672,15,24.833333333333332,<=30,NZ,Away,Upto 2014
Manjural Islam,BAN,Pace,2002-01-09,Dhaka,Bangladesh,2002,1,124,198,2,1,377,686,15,253,488,13,25.133333333333333,<=30,BAN,Home,Upto 2014
Manjural Islam,BAN,Pace,2002-01-16,Chattogram,Bangladesh,2002,1,95,210,2,1,326,664,15,231,454,13,21.733333333333334,<=30,BAN,Home,Upto 2014
Manjural Islam,BAN,Pace,2002-07-21,Colombo (PSS),Sri Lanka,2002,1,128,150,2,1,532,738,12,404,588,10,44.333333333333336,>30,SL,Away,Upto 2014
Manjural Islam,BAN,Pace,2002-07-28,Colombo (SSC),Sri Lanka,2002,2,74,192,3,1,518,934,16,444,742,13,32.375,>30,SL,Away,Upto 2014
Manjural Islam,BAN,Pace,2002-10-18,East London,South Africa,2002,1,104,174,0,1,686,1167,21,582,993,21,32.666666666666664,>30,SA,Away,Upto 2014
Manjural Islam,BAN,Pace,2002-10-25,Potchefstroom,South Africa,2002,1,80,156,0,1,588,1047,21,508,891,21,28.0,<=30,SA,Away,Upto 2014
Manjural Islam,BAN,Pace,2002-12-16,Chattogram,Bangladesh,2002,2,72,174,2,1,655,1306,30,583,1132,28,21.833333333333332,<=30,BAN,Home,Upto 2014
Manjural Islam,BAN,Pace,2003-07-18,Darwin,Australia,2003,1,78,144,1,1,496,985,17,418,841,16,29.176470588235293,<=30,AUS,Away,Upto 2014
Manjural Islam,BAN,Pace,2003-09-03,Multan,Pakistan,2003,2,106,204,2,1,593,1160,25,487,956,23,23.72,<=30,PAK,Away,Upto 2014
Manjural Islam,BAN,Pace,2004-02-19,Harare,Zimbabwe,2004,2,93,240,1,1,617,1260,23,524,1020,22,26.82608695652174,<=30,ZIM,Away,Upto 2014
Manjural Islam Rana,BAN,Spin,2004-02-19,Harare,Zimbabwe,2004,2,66,122,2,1,538,1129,14,472,1007,12,38.42857142857143,>30,ZIM,Away,Upto 2014
Manjural Islam Rana,BAN,Spin,2004-02-26,Bulawayo,Zimbabwe,2004,1,33,36,0,1,156,307,6,123,271,6,26.0,<=30,ZIM,Away,Upto 2014
Manjural Islam Rana,BAN,Spin,2004-06-04,Kingston,West Indies,2004,1,100,168,0,1,393,750,8,293,582,8,49.125,>30,WI,Away,Upto 2014
Manjural Islam Rana,BAN,Spin,2004-10-19,Dhaka,Bangladesh,2004,1,84,252,3,1,383,1134,20,299,882,17,19.15,<=30,BAN,Home,Upto 2014
Manjural Islam Rana,BAN,Spin,2004-12-10,Dhaka,Bangladesh,2004,1,55,72,0,1,324,603,8,269,531,8,40.5,>30,BAN,Home,Upto 2014
Manjural Islam Rana,BAN,Spin,2004-12-17,Chattogram,Bangladesh,2004,1,63,99,0,1,442,811,15,379,712,15,29.466666666666665,<=30,BAN,Home,Upto 2014
Manzoor Elahi,PAK,Pace,1984-10-24,Faisalabad,Pakistan,1984,1,74,126,1,1,679,1180,8,605,1054,7,84.875,>30,PAK,Home,Upto 2014
Manzoor Elahi,PAK,Pace,1984-11-25,Hyderabad (Sind),Pakistan,1984,1,2,12,0,1,178,432,6,176,420,6,29.666666666666668,<=30,PAK,Home,Upto 2014
Manzoor Elahi,PAK,Pace,1987-03-04,Ahmedabad,India,1987,1,8,18,1,1,194,539,11,186,521,10,17.636363636363637,<=30,IND,Away,Upto 2014
Manzoor Elahi,PAK,Pace,1995-02-07,Bulawayo,Zimbabwe,1995,2,70,210,3,1,563,1357,30,493,1147,27,18.766666666666666,<=30,ZIM,Away,Upto 2014
Manzoor Elahi,PAK,Pace,1995-02-15,Harare,Zimbabwe,1995,2,40,78,2,1,795,1808,39,755,1730,37,20.384615384615383,<=30,ZIM,Away,Upto 2014
Maqsood Ahmed,PAK,Pace,1952-10-16,Delhi,India,1952,1,13,36,0,1,227,672,5,214,636,5,45.4,>30,IND,Away,Upto 2014
Maqsood Ahmed,PAK,Pace,1952-10-23,Lucknow,India,1952,2,37,60,2,1,415,1291,25,378,1231,23,16.6,<=30,IND,Away,Upto 2014
Maqsood Ahmed,PAK,Pace,1952-11-13,Brabourne,India,1952,1,20,42,0,1,405,896,8,385,854,8,50.625,>30,IND,Away,Upto 2014
Maqsood Ahmed,PAK,Pace,1952-11-28,Chennai,India,1952,1,10,24,0,1,235,515,6,225,491,6,39.166666666666664,>30,IND,Away,Upto 2014
Maqsood Ahmed,PAK,Pace,1952-12-12,Eden Gardens,India,1952,1,20,48,0,1,409,1086,14,389,1038,14,29.214285714285715,<=30,IND,Away,Upto 2014
Maqsood Ahmed,PAK,Pace,1954-07-01,Nottingham,England,1954,1,25,18,0,1,686,1378,19,661,1360,19,36.10526315789474,>30,ENG,Away,Upto 2014
Maqsood Ahmed,PAK,Pace,1954-07-22,Manchester,England,1954,1,14,24,0,1,265,605,10,251,581,10,26.5,<=30,ENG,Away,Upto 2014
Maqsood Ahmed,PAK,Pace,1955-01-01,Dhaka,Bangladesh,1955,1,4,18,0,1,253,947,14,249,929,14,18.071428571428573,<=30,BAN,Away,Upto 2014
Maqsood Ahmed,PAK,Pace,1955-01-15,Bahawalpur,Pakistan,1955,1,19,42,0,1,416,1187,15,397,1145,15,27.733333333333334,<=30,PAK,Home,Upto 2014
Maqsood Ahmed,PAK,Pace,1955-01-29,Lahore,Pakistan,1955,1,4,24,0,1,171,571,7,167,547,7,24.428571428571427,<=30,PAK,Home,Upto 2014
Maqsood Ahmed,PAK,Pace,1955-02-12,Peshawar,Pakistan,1955,2,16,78,0,1,201,612,7,185,534,7,28.714285714285715,<=30,PAK,Home,Upto 2014
Maqsood Ahmed,PAK,Pace,1955-02-26,Karachi,Pakistan,1955,1,5,30,1,1,257,771,19,252,741,18,13.526315789473685,<=30,PAK,Home,Upto 2014
Maqsood Ahmed,PAK,Pace,1955-10-26,Lahore,Pakistan,1955,1,4,18,0,1,619,1402,11,615,1384,11,56.27272727272727,>30,PAK,Home,Upto 2014
Marshall Ayub,BAN,Spin,2013-10-09,Chattogram,Bangladesh,2013,1,15,12,0,1,1057,1946,22,1042,1934,22,48.04545454545455,>30,BAN,Home,Upto 2014
Marshall Ayub,BAN,Spin,2014-01-27,Mirpur,Bangladesh,2014,1,38,48,0,1,658,946,13,620,898,13,50.61538461538461,>30,BAN,Home,After 1965
Mashrafe Mortaza,BAN,Pace,2001-11-08,Dhaka,Bangladesh,2001,1,106,192,4,1,386,858,18,280,666,14,21.444444444444443,<=30,BAN,Home,Upto 2014
Mashrafe Mortaza,BAN,Pace,2001-11-15,Chattogram,Bangladesh,2001,2,111,178,4,1,536,1126,10,425,948,6,53.6,>30,BAN,Home,Upto 2014
Mashrafe Mortaza,BAN,Pace,2001-12-18,Hamilton,New Zealand,2001,1,100,162,3,1,586,928,27,486,766,24,21.703703703703702,<=30,NZ,Away,Upto 2014
Mashrafe Mortaza,BAN,Pace,2001-12-26,Wellington,New Zealand,2001,1,57,96,1,1,447,846,18,390,750,17,24.833333333333332,<=30,NZ,Away,Upto 2014
Mashrafe Mortaza,BAN,Pace,2003-04-24,Chattogram,Bangladesh,2003,1,108,144,1,1,514,1056,11,406,912,10,46.72727272727273,>30,BAN,Home,Upto 2014
Mashrafe Mortaza,BAN,Pace,2003-05-01,Dhaka,Bangladesh,2003,1,53,120,1,1,304,666,13,251,546,12,23.384615384615383,<=30,BAN,Home,Upto 2014
Mashrafe Mortaza,BAN,Pace,2003-07-18,Darwin,Australia,2003,1,74,138,3,1,496,985,17,422,847,14,29.176470588235293,<=30,AUS,Away,Upto 2014
Mashrafe Mortaza,BAN,Pace,2003-07-25,Cairns,Australia,2003,1,60,150,1,1,637,1169,12,577,1019,11,53.083333333333336,>30,AUS,Away,Upto 2014
Mashrafe Mortaza,BAN,Pace,2003-08-20,Karachi,Pakistan,2003,2,130,222,3,1,660,1252,19,530,1030,16,34.73684210526316,>30,PAK,Away,Upto 2014
Mashrafe Mortaza,BAN,Pace,2003-08-27,Peshawar,Pakistan,2003,2,74,150,0,1,501,1075,20,427,925,20,25.05,<=30,PAK,Away,Upto 2014
Mashrafe Mortaza,BAN,Pace,2003-10-21,Dhaka,Bangladesh,2003,2,87,204,4,1,448,1151,23,361,947,19,19.47826086956522,<=30,BAN,Home,Upto 2014
Mashrafe Mortaza,BAN,Pace,2003-10-29,Chattogram,Bangladesh,2003,2,83,192,4,1,551,1109,24,468,917,20,22.958333333333332,<=30,BAN,Home,Upto 2014
Mashrafe Mortaza,BAN,Pace,2004-12-10,Dhaka,Bangladesh,2004,1,125,186,2,1,566,884,20,441,698,18,28.3,<=30,BAN,Home,Upto 2014
Mashrafe Mortaza,BAN,Pace,2004-12-17,Chattogram,Bangladesh,2004,1,60,156,3,1,505,785,14,445,629,11,36.07142857142857,>30,BAN,Home,Upto 2014
Mashrafe Mortaza,BAN,Pace,2005-01-06,Chattogram,Bangladesh,2005,2,104,288,5,1,681,1423,24,577,1135,19,28.375,<=30,BAN,Home,Upto 2014
Mashrafe Mortaza,BAN,Pace,2005-01-14,Dhaka,Bangladesh,2005,2,120,256,4,1,545,1416,17,425,1160,13,32.05882352941177,>30,BAN,Home,Upto 2014
Mashrafe Mortaza,BAN,Pace,2005-05-26,Lord's,England,2005,1,107,174,2,1,522,823,21,415,649,19,24.857142857142858,<=30,ENG,Away,Upto 2014
Mashrafe Mortaza,BAN,Pace,2005-06-03,Chester-le-Street,England,2005,1,91,132,2,1,697,946,22,606,814,20,31.681818181818183,>30,ENG,Away,Upto 2014
Mashrafe Mortaza,BAN,Pace,2006-04-09,Fatullah,Bangladesh,2006,2,107,264,3,1,364,804,10,257,540,7,36.4,>30,BAN,Home,Upto 2014
Mashrafe Mortaza,BAN,Pace,2006-04-16,Chattogram,Bangladesh,2006,1,114,156,0,1,238,372,5,124,216,5,47.6,>30,BAN,Home,Upto 2014
Mashrafe Mortaza,BAN,Pace,2007-05-18,Chattogram,Bangladesh,2007,2,133,197,5,1,364,589,13,231,392,8,28.0,<=30,BAN,Home,Upto 2014
Mashrafe Mortaza,BAN,Pace,2007-05-25,Mirpur,Bangladesh,2007,1,100,190,1,1,511,762,11,411,572,10,46.45454545454545,>30,BAN,Home,Upto 2014
Mashrafe Mortaza,BAN,Pace,2007-06-25,Colombo (SSC),Sri Lanka,2007,1,72,114,1,1,288,528,11,216,414,10,26.181818181818183,<=30,SL,Away,Upto 2014
Mashrafe Mortaza,BAN,Pace,2007-07-03,Colombo (PSS),Sri Lanka,2007,1,77,180,2,1,411,758,15,334,578,13,27.4,<=30,SL,Away,Upto 2014
Mashrafe Mortaza,BAN,Pace,2007-07-11,Kandy,Sri Lanka,2007,1,125,144,0,1,437,738,11,312,594,11,39.72727272727273,>30,SL,Away,Upto 2014
Mashrafe Mortaza,BAN,Pace,2008-01-04,Dunedin,New Zealand,2008,2,88,162,5,1,478,890,22,390,728,17,21.727272727272727,<=30,NZ,Away,Upto 2014
Mashrafe Mortaza,BAN,Pace,2008-01-12,Wellington,New Zealand,2008,1,100,174,2,1,450,866,22,350,692,20,20.454545454545453,<=30,NZ,Away,Upto 2014
Mashrafe Mortaza,BAN,Pace,2008-02-22,Mirpur,Bangladesh,2008,2,90,126,0,1,379,784,18,289,658,18,21.055555555555557,<=30,BAN,Home,Upto 2014
Mashrafe Mortaza,BAN,Pace,2008-02-29,Chattogram,Bangladesh,2008,1,92,168,0,1,376,687,12,284,519,12,31.333333333333332,>30,BAN,Home,Upto 2014
Mashrafe Mortaza,BAN,Pace,2008-10-17,Chattogram,Bangladesh,2008,2,50,126,1,1,258,774,7,208,648,6,36.857142857142854,>30,BAN,Home,Upto 2014
Mashrafe Mortaza,BAN,Pace,2008-10-25,Mirpur,Bangladesh,2008,2,35,66,2,1,137,265,6,102,199,4,22.833333333333332,<=30,BAN,Home,Upto 2014
Mashrafe Mortaza,BAN,Pace,2008-11-19,Bloemfontein,South Africa,2008,1,69,132,1,1,387,770,21,318,638,20,18.428571428571427,<=30,SA,Away,Upto 2014
Mashrafe Mortaza,BAN,Pace,2008-11-26,Centurion,South Africa,2008,1,74,156,1,1,529,990,19,455,834,18,27.842105263157894,<=30,SA,Away,Upto 2014
Mashrafe Mortaza,BAN,Pace,2008-12-26,Mirpur,Bangladesh,2008,2,126,234,4,1,517,896,12,391,662,8,43.083333333333336,>30,BAN,Home,Upto 2014
Mashrafe Mortaza,BAN,Pace,2009-01-03,Chattogram,Bangladesh,2009,2,111,222,3,1,228,510,8,117,288,5,28.5,<=30,BAN,Home,Upto 2014
Mashrafe Mortaza,BAN,Pace,2009-07-09,Kingstown,West Indies,2009,1,26,39,0,1,537,1048,20,511,1009,20,26.85,<=30,WI,Away,Upto 2014
Masood Anwar,PAK,Spin,1990-12-06,Lahore,Pakistan,1990,2,102,161,3,1,232,389,5,130,228,2,46.4,>30,PAK,Home,Upto 2014
Mehidy Hasan Miraz,BAN,Spin,2016-10-20,Chattogram,Bangladesh,2016,2,138,359,7,1,760,1579,30,622,1220,23,25.333333333333332,<=30,BAN,Home,After 1965
Mehidy Hasan Miraz,BAN,Spin,2016-10-28,Mirpur,Bangladesh,2016,2,159,297,12,1,691,1258,32,532,961,20,21.59375,<=30,BAN,Home,After 1965
Mehidy Hasan Miraz,BAN,Spin,2017-01-12,Wellington,New Zealand,2017,2,182,292,2,1,423,748,8,241,456,6,52.875,>30,NZ,Away,After 1965
Mehidy Hasan Miraz,BAN,Spin,2017-01-20,Christchurch,New Zealand,2017,2,86,150,2,1,177,254,6,91,104,4,29.5,<=30,NZ,Away,After 1965
Mehidy Hasan Miraz,BAN,Spin,2017-02-09,Hyderabad,India,2017,2,197,294,2,1,881,1634,19,684,1340,17,46.36842105263158,>30,IND,Away,After 1965
Mehidy Hasan Miraz,BAN,Spin,2017-03-07,Galle,Sri Lanka,2017,2,190,252,6,1,752,1277,25,562,1025,19,30.08,>30,SL,Away,After 1965
Mehidy Hasan Miraz,BAN,Spin,2017-03-15,Colombo (PSS),Sri Lanka,2017,2,161,270,4,1,916,1838,26,755,1568,22,35.23076923076923,>30,SL,Away,After 1965
Mehidy Hasan Miraz,BAN,Spin,2017-08-27,Mirpur,Bangladesh,2017,2,142,270,5,1,693,1433,34,551,1163,29,20.38235294117647,<=30,BAN,Home,After 1965
Mehidy Hasan Miraz,BAN,Spin,2017-09-04,Chattogram,Bangladesh,2017,1,93,228,3,1,709,1537,24,616,1309,21,29.541666666666668,<=30,BAN,Home,After 1965
Mehidy Hasan Miraz,BAN,Spin,2017-09-28,Potchefstroom,South Africa,2017,2,247,402,0,1,504,803,10,257,401,10,50.4,>30,SA,Away,After 1965
Mehidy Hasan Miraz,BAN,Spin,2018-01-31,Chattogram,Bangladesh,2018,1,174,294,3,1,1210,2061,19,1036,1767,16,63.68421052631579,>30,BAN,Home,After 1965
Mehidy Hasan Miraz,BAN,Spin,2018-02-08,Mirpur,Bangladesh,2018,2,91,198,2,1,561,1029,30,470,831,28,18.7,<=30,BAN,Home,After 1965
Mehidy Hasan Miraz,BAN,Spin,2018-07-04,North Sound,West Indies,2018,1,101,204,3,1,218,480,6,117,276,3,36.333333333333336,>30,WI,Away,After 1965
Mehidy Hasan Miraz,BAN,Spin,2018-07-12,Kingston,West Indies,2018,2,138,240,7,1,399,810,18,261,570,11,22.166666666666668,<=30,WI,Away,After 1965
Mehidy Hasan Miraz,BAN,Spin,2018-11-03,Sylhet,Bangladesh,2018,2,93,276,3,1,549,1328,32,456,1052,29,17.15625,<=30,BAN,Home,After 1965
Mehidy Hasan Miraz,BAN,Spin,2018-11-11,Mirpur,Bangladesh,2018,2,99,229,8,1,819,1414,17,720,1185,9,48.1764705882353,>30,BAN,Home,After 1965
Mehidy Hasan Miraz,BAN,Spin,2018-11-22,Chattogram,Bangladesh,2018,2,94,138,3,1,618,1097,34,524,959,31,18.176470588235293,<=30,BAN,Home,After 1965
Mehidy Hasan Miraz,BAN,Spin,2018-11-30,Mirpur,Bangladesh,2018,2,117,216,12,1,676,1230,27,559,1014,15,25.037037037037038,<=30,BAN,Home,After 1965
Mehidy Hasan Miraz,BAN,Spin,2019-02-28,Hamilton,New Zealand,2019,1,246,294,2,1,362,462,3,116,168,1,120.66666666666667,>30,NZ,Away,After 1965
Mehidy Hasan Miraz,BAN,Spin,2019-09-05,Chattogram,Bangladesh,2019,2,108,241,3,1,903,1930,38,795,1689,35,23.763157894736842,<=30,BAN,Home,After 1965
Mehidy Hasan Miraz,BAN,Spin,2019-11-14,Indore,India,2019,1,125,162,1,1,411,632,6,286,470,5,68.5,>30,IND,Away,After 1965
Mehidy Hasan Miraz,BAN,Spin,2021-02-03,Chattogram,Bangladesh,2021,2,171,366,8,1,955,2045,28,784,1679,20,34.107142857142854,>30,BAN,Home,After 1965
Mehidy Hasan Miraz,BAN,Spin,2021-02-11,Mirpur,Bangladesh,2021,2,90,234,2,1,665,1522,28,575,1288,26,23.75,<=30,BAN,Home,After 1965
Mehidy Hasan Miraz,BAN,Spin,2021-04-21,Pallekele,Sri Lanka,2021,1,161,348,1,1,649,1170,4,488,822,3,162.25,>30,SL,Away,After 1965
Mehidy Hasan Miraz,BAN,Spin,2021-04-29,Pallekele,Sri Lanka,2021,2,184,300,3,1,753,1454,28,569,1154,25,26.892857142857142,<=30,SL,Away,After 1965
Mehidy Hasan Miraz,BAN,Spin,2021-07-07,Harare,Zimbabwe,2021,2,148,370,9,1,544,1099,15,396,729,6,36.266666666666666,>30,ZIM,Away,After 1965
Mehidy Hasan Miraz,BAN,Spin,2021-11-26,Chattogram,Bangladesh,2021,2,127,291,2,1,541,1197,14,414,906,12,38.642857142857146,>30,BAN,Home,After 1965
Mehidy Hasan Miraz,BAN,Spin,2021-12-04,Mirpur,Bangladesh,2021,1,37,84,0,1,366,844,15,329,760,15,24.4,<=30,BAN,Home,After 1965
Mehidy Hasan Miraz,BAN,Spin,2022-01-01,Mount Maunganui,New Zealand,2022,2,129,328,4,1,219,557,6,90,229,2,36.5,>30,NZ,Away,After 1965
Mehidy Hasan Miraz,BAN,Spin,2022-01-09,Christchurch,New Zealand,2022,1,125,186,0,1,174,231,2,49,45,2,87.0,>30,NZ,Away,After 1965
Mehidy Hasan Miraz,BAN,Spin,2022-03-31,Durban,South Africa,2022,2,179,450,6,1,428,1068,20,249,618,14,21.4,<=30,SA,Away,After 1965
Mehidy Hasan Miraz,BAN,Spin,2022-04-08,Gqeberha,South Africa,2022,2,119,217,3,1,500,972,27,381,755,24,18.51851851851852,<=30,SA,Away,After 1965
Mehidy Hasan Miraz,BAN,Spin,2022-06-16,North Sound,West Indies,2022,2,69,155,4,1,173,401,5,104,246,1,34.6,>30,WI,Away,After 1965
Mehidy Hasan Miraz,BAN,Spin,2022-06-24,Gros Islet,West Indies,2022,1,91,234,3,1,137,342,3,46,108,0,45.666666666666664,>30,WI,Away,After 1965
Mehidy Hasan Miraz,BAN,Spin,2022-12-14,Chattogram,Bangladesh,2022,2,194,275,5,1,800,1534,23,606,1259,18,34.78260869565217,>30,BAN,Home,After 1965
Mehidy Hasan Miraz,BAN,Spin,2022-12-22,Mirpur,Bangladesh,2022,2,124,216,6,1,578,1084,25,454,868,19,23.12,<=30,BAN,Home,After 1965
Mehidy Hasan Miraz,BAN,Spin,2023-04-04,Mirpur,Bangladesh,2023,2,101,284,2,1,595,1200,23,494,916,21,25.869565217391305,<=30,BAN,Home,After 1965
Mehidy Hasan Miraz,BAN,Spin,2023-06-14,Mirpur,Bangladesh,2023,2,20,66,3,1,497,697,11,477,631,8,45.18181818181818,>30,BAN,Home,After 1965
Mehidy Hasan Miraz,BAN,Spin,2023-11-28,Sylhet,Bangladesh,2023,2,108,222,2,1,883,1678,32,775,1456,30,27.59375,<=30,BAN,Home,After 1965
Mehidy Hasan Miraz,BAN,Spin,2023-12-06,Mirpur,Bangladesh,2023,2,105,166,6,1,542,923,30,437,757,24,18.066666666666666,<=30,BAN,Home,After 1965
Mehidy Hasan Miraz,BAN,Spin,2024-03-22,Sylhet,Bangladesh,2024,2,99,234,4,1,284,550,7,185,316,3,40.57142857142857,>30,BAN,Home,After 1965
Mehidy Hasan Miraz,BAN,Spin,2024-03-30,Chattogram,Bangladesh,2024,1,146,276,1,1,649,1230,12,503,954,11,54.083333333333336,>30,BAN,Home,After 1965
Mehidy Hasan Miraz,BAN,Spin,2024-08-21,Rawalpindi,Pakistan,2024,2,101,197,5,1,433,770,10,332,573,5,43.3,>30,PAK,Away,After 1965
Mehidy Hasan Miraz,BAN,Spin,2024-08-30,Rawalpindi,Pakistan,2024,2,85,181,5,1,286,641,10,201,460,5,28.6,<=30,PAK,Away,After 1965
Mehidy Hasan Miraz,BAN,Spin,2024-09-19,Chennai,India,2024,2,180,276,3,1,522,763,14,342,487,11,37.285714285714285,>30,IND,Away,After 1965
Mehidy Hasan Miraz,BAN,Spin,2024-09-27,Kanpur,India,2024,2,85,94,6,1,428,548,20,343,454,14,21.4,<=30,IND,Away,After 1965
Mehidy Hasan Miraz,BAN,Spin,2024-10-21,Mirpur,Bangladesh,2024,2,76,106,2,1,586,1001,17,510,895,15,34.470588235294116,>30,BAN,Home,After 1965
Mehidy Hasan Miraz,BAN,Spin,2024-10-29,Chattogram,Bangladesh,2024,1,171,234,0,1,583,920,17,412,686,17,34.294117647058826,>30,BAN,Home,After 1965
Mehidy Hasan Miraz,BAN,Spin,2024-11-22,North Sound,West Indies,2024,2,130,295,4,1,296,631,6,166,336,2,49.333333333333336,>30,WI,Away,After 1965
Mehidy Hasan Miraz,BAN,Spin,2024-11-30,Kingston,West Indies,2024,2,46,78,1,1,139,318,7,93,240,6,19.857142857142858,<=30,WI,Away,After 1965
Mehrab Hossain,BAN,Pace,2003-05-01,Dhaka,Bangladesh,2003,1,5,12,0,1,304,666,13,299,654,13,23.384615384615383,<=30,BAN,Home,Upto 2014
Mehrab Hossain jnr,BAN,Spin,2007-07-03,Colombo (PSS),Sri Lanka,2007,1,29,47,2,1,383,661,9,354,614,7,42.55555555555556,>30,SL,Away,Upto 2014
Mehrab Hossain jnr,BAN,Spin,2008-10-17,Chattogram,Bangladesh,2008,2,14,18,0,1,669,1820,29,655,1802,29,23.06896551724138,<=30,BAN,Home,Upto 2014
Mehrab Hossain jnr,BAN,Spin,2008-10-25,Mirpur,Bangladesh,2008,2,31,42,0,1,361,720,10,330,678,10,36.1,>30,BAN,Home,Upto 2014
Mehrab Hossain jnr,BAN,Spin,2008-11-19,Bloemfontein,South Africa,2008,1,24,48,0,1,324,498,7,300,450,7,46.285714285714285,>30,SA,Away,Upto 2014
Mehrab Hossain jnr,BAN,Spin,2008-11-26,Centurion,South Africa,2008,1,50,66,0,1,253,380,8,203,314,8,31.625,>30,SA,Away,Upto 2014
Mehrab Hossain jnr,BAN,Spin,2008-12-26,Mirpur,Bangladesh,2008,2,59,96,2,1,727,1408,21,668,1312,19,34.61904761904762,>30,BAN,Home,Upto 2014
Mehrab Hossain jnr,BAN,Spin,2009-01-03,Chattogram,Bangladesh,2009,2,74,90,0,1,931,1570,27,857,1480,27,34.48148148148148,>30,BAN,Home,Upto 2014
Mir Hamza,PAK,Pace,2018-10-16,Abu Dhabi,UAE,2018,2,67,90,1,1,398,700,16,331,610,15,24.875,<=30,UAE,Away,After 1965
Mir Hamza,PAK,Pace,2022-12-26,Karachi,Pakistan,2022,2,87,162,0,1,287,569,4,200,407,4,71.75,>30,PAK,Home,After 1965
Mir Hamza,PAK,Pace,2023-01-02,Karachi,Pakistan,2023,2,110,192,1,1,583,1266,12,473,1074,11,48.583333333333336,>30,PAK,Home,After 1965
Mir Hamza,PAK,Pace,2023-12-26,Melbourne,Australia,2023,2,83,241,6,1,818,1640,35,735,1399,29,23.37142857142857,<=30,AUS,Away,After 1965
Mir Hamza,PAK,Pace,2024-01-03,Sydney,Australia,2024,2,62,138,1,1,504,897,22,442,759,21,22.90909090909091,<=30,AUS,Away,After 1965
Mir Hamza,PAK,Pace,2024-08-30,Rawalpindi,Pakistan,2024,2,96,180,3,1,585,958,24,489,778,21,24.375,<=30,PAK,Home,After 1965
Mir Hamza,PAK,Pace,2025-01-03,Cape Town,South Africa,2025,1,127,180,2,1,862,1222,17,735,1042,15,50.705882352941174,>30,SA,Away,After 1965
Miran Bakhsh,PAK,Spin,1955-01-29,Lahore,Pakistan,1955,1,82,288,2,1,591,2024,18,509,1736,16,32.833333333333336,>30,PAK,Home,Upto 2014
Miran Bakhsh,PAK,Spin,1955-02-12,Peshawar,Pakistan,1955,2,33,60,0,1,400,1761,19,367,1701,19,21.05263157894737,<=30,PAK,Home,Upto 2014
Mohammad Abbas,PAK,Pace,2017-04-21,Kingston,West Indies,2017,2,98,198,3,1,500,1200,21,402,1002,18,23.80952380952381,<=30,WI,Away,After 1965
Mohammad Abbas,PAK,Pace,2017-04-30,Bridgetown,West Indies,2017,2,113,288,6,1,469,1258,27,356,970,21,17.37037037037037,<=30,WI,Away,After 1965
Mohammad Abbas,PAK,Pace,2017-05-10,Roseau,West Indies,2017,2,77,270,6,1,472,1494,20,395,1224,14,23.6,<=30,WI,Away,After 1965
Mohammad Abbas,PAK,Pace,2017-09-28,Abu Dhabi,UAE,2017,2,97,233,5,1,437,1023,13,340,790,8,33.61538461538461,>30,UAE,Away,After 1965
Mohammad Abbas,PAK,Pace,2017-10-06,Dubai (DICS),UAE,2017,2,106,222,3,1,468,1044,16,362,822,13,29.25,<=30,UAE,Away,After 1965
Mohammad Abbas,PAK,Pace,2018-05-11,Dublin (Malahide),Ireland,2018,2,110,237,9,1,792,1625,28,682,1388,19,28.285714285714285,<=30,IRE,Away,After 1965
Mohammad Abbas,PAK,Pace,2018-05-24,Lord's,England,2018,2,64,186,8,1,631,1332,28,567,1146,20,22.535714285714285,<=30,ENG,Away,After 1965
Mohammad Abbas,PAK,Pace,2018-06-01,Leeds,England,2018,1,78,156,2,1,552,1035,26,474,879,24,21.23076923076923,<=30,ENG,Away,After 1965
Mohammad Abbas,PAK,Pace,2018-10-07,Dubai (DICS),UAE,2018,2,85,276,7,1,373,938,11,288,662,4,33.90909090909091,>30,UAE,Away,After 1965
Mohammad Abbas,PAK,Pace,2018-10-16,Abu Dhabi,UAE,2018,2,95,178,10,1,398,700,16,303,522,6,24.875,<=30,UAE,Away,After 1965
Mohammad Abbas,PAK,Pace,2018-11-16,Abu Dhabi,UAE,2018,2,44,204,2,1,312,840,18,268,636,16,17.333333333333332,<=30,UAE,Away,After 1965
Mohammad Abbas,PAK,Pace,2018-11-24,Dubai (DICS),UAE,2018,2,47,144,0,1,331,924,7,284,780,7,47.285714285714285,>30,UAE,Away,After 1965
Mohammad Abbas,PAK,Pace,2019-01-03,Cape Town,South Africa,2019,2,114,228,2,1,809,1380,31,695,1152,29,26.096774193548388,<=30,SA,Away,After 1965
Mohammad Abbas,PAK,Pace,2019-01-11,Johannesburg,South Africa,2019,2,117,216,3,1,906,1496,35,789,1280,32,25.885714285714286,<=30,SA,Away,After 1965
Mohammad Abbas,PAK,Pace,2019-11-29,Adelaide,Australia,2019,1,100,174,0,1,654,1168,17,554,994,17,38.470588235294116,>30,AUS,Away,After 1965
Mohammad Abbas,PAK,Pace,2019-12-11,Rawalpindi,Pakistan,2019,1,72,162,1,1,376,750,8,304,588,7,47.0,>30,PAK,Home,After 1965
Mohammad Abbas,PAK,Pace,2019-12-19,Karachi,Pakistan,2019,2,88,234,5,1,653,1162,24,565,928,19,27.208333333333332,<=30,PAK,Home,After 1965
Mohammad Abbas,PAK,Pace,2020-02-07,Rawalpindi,Pakistan,2020,2,52,208,3,1,527,1060,20,475,852,17,26.35,<=30,PAK,Home,After 1965
Mohammad Abbas,PAK,Pace,2020-08-05,Manchester,England,2020,2,69,186,3,1,609,1268,24,540,1082,21,25.375,<=30,ENG,Away,After 1965
Mohammad Abbas,PAK,Pace,2020-08-13,Southampton,England,2020,1,28,84,2,1,292,740,12,264,656,10,24.333333333333332,<=30,ENG,Away,After 1965
Mohammad Abbas,PAK,Pace,2020-08-21,Southampton,England,2020,1,82,198,0,1,619,1361,14,537,1163,14,44.214285714285715,>30,ENG,Away,After 1965
Mohammad Abbas,PAK,Pace,2020-12-26,Mount Maunganui,New Zealand,2020,2,82,252,2,1,873,2105,28,791,1853,26,31.178571428571427,>30,NZ,Away,After 1965
Mohammad Abbas,PAK,Pace,2021-01-03,Christchurch,New Zealand,2021,1,98,204,2,1,918,1730,25,820,1526,23,36.72,>30,NZ,Away,After 1965
Mohammad Abbas,PAK,Pace,2021-08-12,Kingston,West Indies,2021,2,70,204,3,1,661,1558,37,591,1354,34,17.864864864864863,<=30,WI,Away,After 1965
Mohammad Abbas,PAK,Pace,2021-08-20,Kingston,West Indies,2021,2,86,192,3,1,688,1393,29,602,1201,26,23.724137931034484,<=30,WI,Away,After 1965
Mohammad Abbas,PAK,Pace,2024-12-26,Centurion,South Africa,2024,2,133,243,7,1,742,1206,32,609,963,25,23.1875,<=30,SA,Away,After 1965
Mohammad Abbas,PAK,Pace,2025-01-03,Cape Town,South Africa,2025,2,113,177,3,1,862,1222,17,749,1045,14,50.705882352941174,>30,SA,Away,After 1965
Mohammad Akram,PAK,Pace,1995-09-15,Faisalabad,Pakistan,1995,2,120,246,3,1,465,1059,21,345,813,18,22.142857142857142,<=30,PAK,Home,Upto 2014
Mohammad Akram,PAK,Pace,1995-09-22,Sialkot,Pakistan,1995,2,76,222,4,1,584,1401,24,508,1179,20,24.333333333333332,<=30,PAK,Home,Upto 2014
Mohammad Akram,PAK,Pace,1995-11-09,Brisbane,Australia,1995,1,97,199,1,1,520,1074,13,423,875,12,40.0,>30,AUS,Away,Upto 2014
Mohammad Akram,PAK,Pace,1995-11-17,Hobart,Australia,1995,2,99,120,1,1,693,1398,29,594,1278,28,23.896551724137932,<=30,AUS,Away,Upto 2014
Mohammad Akram,PAK,Pace,1996-08-22,The Oval,England,1996,2,71,132,1,1,690,1195,17,619,1063,16,40.588235294117645,>30,ENG,Away,Upto 2014
Mohammad Akram,PAK,Pace,1996-11-28,Rawalpindi,Pakistan,1996,2,59,114,0,1,614,1126,22,555,1012,22,27.90909090909091,<=30,PAK,Home,Upto 2014
Mohammad Akram,PAK,Pace,1999-11-26,W.A.C.A,Australia,1999,1,138,167,5,1,717,1143,27,579,976,22,26.555555555555557,<=30,AUS,Away,Upto 2014
Mohammad Akram,PAK,Pace,2000-03-12,Karachi,Pakistan,2000,2,93,145,2,1,750,1272,22,657,1127,20,34.09090909090909,>30,PAK,Home,Upto 2014
Mohammad Akram,PAK,Pace,2001-03-27,Hamilton,New Zealand,2001,1,106,132,0,1,506,942,23,400,810,23,22.0,<=30,NZ,Away,Upto 2014
Mohammad Ali,PAK,Pace,2022-12-01,Rawalpindi,Pakistan,2022,2,188,204,4,1,786,1181,21,598,977,17,37.42857142857143,>30,PAK,Home,After 1965
Mohammad Ali,PAK,Pace,2022-12-09,Multan,Pakistan,2022,2,73,90,0,1,291,582,12,218,492,12,24.25,<=30,PAK,Home,After 1965
Mohammad Ali,PAK,Pace,2024-08-21,Rawalpindi,Pakistan,2024,1,88,186,2,1,696,1287,16,608,1101,14,43.5,>30,PAK,Home,After 1965
Mohammad Ali,PAK,Pace,2024-08-30,Rawalpindi,Pakistan,2024,2,57,144,0,1,585,958,24,528,814,24,24.375,<=30,PAK,Home,After 1965
Mohammad Amir,PAK,Pace,2009-07-04,Galle,Sri Lanka,2009,2,112,180,6,1,560,942,21,448,762,15,26.666666666666668,<=30,SL,Away,Upto 2014
Mohammad Amir,PAK,Pace,2009-07-12,Colombo (PSS),Sri Lanka,2009,2,69,114,0,1,365,700,17,296,586,17,21.470588235294116,<=30,SL,Away,Upto 2014
Mohammad Amir,PAK,Pace,2009-07-20,Colombo (SSC),Sri Lanka,2009,2,80,186,0,1,669,1180,14,589,994,14,47.785714285714285,>30,SL,Away,Upto 2014
Mohammad Amir,PAK,Pace,2009-11-24,Dunedin,New Zealand,2009,2,116,240,4,1,862,1655,33,746,1415,29,26.12121212121212,<=30,NZ,Away,Upto 2014
Mohammad Amir,PAK,Pace,2009-12-03,Wellington,New Zealand,2009,2,89,162,3,1,635,1257,30,546,1095,27,21.166666666666668,<=30,NZ,Away,Upto 2014
Mohammad Amir,PAK,Pace,2009-12-11,Napier,New Zealand,2009,2,101,168,0,1,858,1683,18,757,1515,18,47.666666666666664,>30,NZ,Away,Upto 2014
Mohammad Amir,PAK,Pace,2009-12-26,Melbourne,Australia,2009,2,180,306,5,1,736,1512,23,556,1206,18,32.0,>30,AUS,Away,Upto 2014
Mohammad Amir,PAK,Pace,2010-01-14,Hobart,Australia,2010,2,143,258,3,1,758,1508,15,615,1250,12,50.53333333333333,>30,AUS,Away,Upto 2014
Mohammad Amir,PAK,Pace,2010-07-13,Lord's,England,2010,2,139,227,4,1,698,1252,26,559,1025,22,26.846153846153847,<=30,ENG,Away,Upto 2014
Mohammad Amir,PAK,Pace,2010-07-21,Leeds,England,2010,2,106,228,7,1,714,1273,33,608,1045,26,21.636363636363637,<=30,ENG,Away,Upto 2014
Mohammad Amir,PAK,Pace,2010-07-29,Nottingham,England,2010,2,76,240,4,1,558,1225,33,482,985,29,16.90909090909091,<=30,ENG,Away,Upto 2014
Mohammad Amir,PAK,Pace,2010-08-06,Birmingham,England,2010,2,88,186,3,1,468,1160,20,380,974,17,23.4,<=30,ENG,Away,Upto 2014
Mohammad Amir,PAK,Pace,2010-08-18,The Oval,England,2010,2,101,204,6,1,645,1152,22,544,948,16,29.318181818181817,<=30,ENG,Away,Upto 2014
Mohammad Amir,PAK,Pace,2010-08-26,Lord's,England,2010,1,84,168,6,1,413,794,18,329,626,12,22.944444444444443,<=30,ENG,Away,Upto 2014
Mohammad Amir,PAK,Pace,2016-07-14,Lord's,England,2016,2,104,215,3,1,760,1521,27,656,1306,24,28.14814814814815,<=30,ENG,Away,After 1965
Mohammad Amir,PAK,Pace,2016-07-22,Manchester,England,2016,2,132,240,3,1,705,1279,22,573,1039,19,32.04545454545455,>30,ENG,Away,After 1965
Mohammad Amir,PAK,Pace,2016-08-03,Birmingham,England,2016,2,128,282,4,1,912,1860,29,784,1578,25,31.448275862068964,>30,ENG,Away,After 1965
Mohammad Amir,PAK,Pace,2016-08-11,The Oval,England,2016,2,145,238,2,1,784,1374,21,639,1136,19,37.333333333333336,>30,ENG,Away,After 1965
Mohammad Amir,PAK,Pace,2016-10-13,Dubai (DICS),UAE,2016,2,117,270,3,1,642,1209,9,525,939,6,71.33333333333333,>30,UAE,Away,After 1965
Mohammad Amir,PAK,Pace,2016-10-30,Sharjah,UAE,2016,2,114,209,3,1,508,1019,20,394,810,17,25.4,<=30,UAE,Away,After 1965
Mohammad Amir,PAK,Pace,2016-11-17,Christchurch,New Zealand,2016,2,55,150,4,1,500,1232,31,445,1082,27,16.129032258064516,<=30,NZ,Away,After 1965
Mohammad Amir,PAK,Pace,2016-11-25,Hamilton,New Zealand,2016,2,145,246,3,1,921,1796,32,776,1550,29,28.78125,<=30,NZ,Away,After 1965
Mohammad Amir,PAK,Pace,2016-12-15,Brisbane,Australia,2016,2,134,234,5,1,820,1566,28,686,1332,23,29.285714285714285,<=30,AUS,Away,After 1965
Mohammad Amir,PAK,Pace,2016-12-26,Melbourne,Australia,2016,1,91,198,0,1,778,1397,19,687,1199,19,40.94736842105263,>30,AUS,Away,After 1965
Mohammad Amir,PAK,Pace,2017-01-03,Sydney,Australia,2017,1,83,144,0,1,587,1109,15,504,965,15,39.13333333333333,>30,AUS,Away,After 1965
Mohammad Amir,PAK,Pace,2017-04-21,Kingston,West Indies,2017,2,64,240,7,1,500,1200,21,436,960,14,23.80952380952381,<=30,WI,Away,After 1965
Mohammad Amir,PAK,Pace,2017-04-30,Bridgetown,West Indies,2017,2,109,282,4,1,469,1258,27,360,976,23,17.37037037037037,<=30,WI,Away,After 1965
Mohammad Amir,PAK,Pace,2017-05-10,Roseau,West Indies,2017,2,54,252,2,1,472,1494,20,418,1242,18,23.6,<=30,WI,Away,After 1965
Mohammad Amir,PAK,Pace,2017-09-28,Abu Dhabi,UAE,2017,2,90,234,0,1,437,1023,13,347,789,13,33.61538461538461,>30,UAE,Away,After 1965
Mohammad Amir,PAK,Pace,2017-10-06,Dubai (DICS),UAE,2017,1,74,117,1,1,468,1044,16,394,927,15,29.25,<=30,UAE,Away,After 1965
Mohammad Amir,PAK,Pace,2018-05-11,Dublin (Malahide),Ireland,2018,2,72,236,5,1,792,1625,28,720,1389,23,28.285714285714285,<=30,IRE,Away,After 1965
Mohammad Amir,PAK,Pace,2018-05-24,Lord's,England,2018,2,77,193,5,1,631,1332,28,554,1139,23,22.535714285714285,<=30,ENG,Away,After 1965
Mohammad Amir,PAK,Pace,2018-06-01,Leeds,England,2018,1,72,138,2,1,552,1035,26,480,897,24,21.23076923076923,<=30,ENG,Away,After 1965
Mohammad Amir,PAK,Pace,2018-12-26,Centurion,South Africa,2018,2,86,192,4,1,620,1128,33,534,936,29,18.78787878787879,<=30,SA,Away,After 1965
Mohammad Amir,PAK,Pace,2019-01-03,Cape Town,South Africa,2019,2,105,228,4,1,809,1380,31,704,1152,27,26.096774193548388,<=30,SA,Away,After 1965
Mohammad Amir,PAK,Pace,2019-01-11,Johannesburg,South Africa,2019,2,92,214,4,1,906,1496,35,814,1282,31,25.885714285714286,<=30,SA,Away,After 1965
Mohammad Ashraful,BAN,Spin,2001-09-06,Colombo (SSC),Sri Lanka,2001,1,63,60,0,1,422,724,14,359,664,14,30.142857142857142,>30,SL,Away,Upto 2014
Mohammad Ashraful,BAN,Spin,2001-11-08,Dhaka,Bangladesh,2001,1,49,90,0,1,256,612,4,207,522,4,64.0,>30,BAN,Home,Upto 2014
Mohammad Ashraful,BAN,Spin,2001-11-15,Chattogram,Bangladesh,2001,1,62,102,1,1,538,1183,18,476,1081,17,29.88888888888889,<=30,BAN,Home,Upto 2014
Mohammad Ashraful,BAN,Spin,2001-12-18,Hamilton,New Zealand,2001,1,25,18,0,1,67,162,2,42,144,2,33.5,>30,NZ,Away,Upto 2014
Mohammad Ashraful,BAN,Spin,2001-12-26,Wellington,New Zealand,2001,1,11,18,0,1,143,312,4,132,294,4,35.75,>30,NZ,Away,Upto 2014
Mohammad Ashraful,BAN,Spin,2002-01-09,Dhaka,Bangladesh,2002,1,13,6,0,1,399,740,13,386,734,13,30.692307692307693,>30,BAN,Home,Upto 2014
Mohammad Ashraful,BAN,Spin,2002-12-08,Dhaka,Bangladesh,2002,1,57,78,2,1,276,570,4,219,492,2,69.0,>30,BAN,Home,Upto 2014
Mohammad Ashraful,BAN,Spin,2002-12-16,Chattogram,Bangladesh,2002,2,32,36,0,1,127,195,2,95,159,2,63.5,>30,BAN,Home,Upto 2014
Mohammad Ashraful,BAN,Spin,2003-04-24,Chattogram,Bangladesh,2003,1,31,48,0,1,336,618,11,305,570,11,30.545454545454547,>30,BAN,Home,Upto 2014
Mohammad Ashraful,BAN,Spin,2003-05-01,Dhaka,Bangladesh,2003,1,42,60,2,1,312,727,15,270,667,13,20.8,<=30,BAN,Home,Upto 2014
Mohammad Ashraful,BAN,Spin,2003-07-18,Darwin,Australia,2003,1,9,12,0,1,161,283,8,152,271,8,20.125,<=30,AUS,Away,Upto 2014
Mohammad Ashraful,BAN,Spin,2003-07-25,Cairns,Australia,2003,1,22,24,0,1,356,572,12,334,548,12,29.666666666666668,<=30,AUS,Away,Upto 2014
Mohammad Ashraful,BAN,Spin,2003-08-27,Peshawar,Pakistan,2003,2,16,18,0,1,404,889,11,388,871,11,36.72727272727273,>30,PAK,Away,Upto 2014
Mohammad Ashraful,BAN,Spin,2004-02-19,Harare,Zimbabwe,2004,1,9,12,0,1,538,1129,14,529,1117,14,38.42857142857143,>30,ZIM,Away,Upto 2014
Mohammad Ashraful,BAN,Spin,2004-02-26,Bulawayo,Zimbabwe,2004,1,6,8,0,1,156,307,6,150,299,6,26.0,<=30,ZIM,Away,Upto 2014
Mohammad Ashraful,BAN,Spin,2004-05-28,Gros Islet,West Indies,2004,1,19,18,0,1,308,824,12,289,806,12,25.666666666666668,<=30,WI,Away,Upto 2014
Mohammad Ashraful,BAN,Spin,2004-06-04,Kingston,West Indies,2004,1,0,6,0,1,393,750,8,393,744,8,49.125,>30,WI,Away,Upto 2014
Mohammad Ashraful,BAN,Spin,2004-10-19,Dhaka,Bangladesh,2004,1,7,6,0,1,383,1134,20,376,1128,20,19.15,<=30,BAN,Home,Upto 2014
Mohammad Ashraful,BAN,Spin,2004-10-26,Chattogram,Bangladesh,2004,1,5,6,0,1,719,1390,23,714,1384,23,31.26086956521739,>30,BAN,Home,Upto 2014
Mohammad Ashraful,BAN,Spin,2004-12-10,Dhaka,Bangladesh,2004,1,2,4,1,1,324,603,8,322,599,7,40.5,>30,BAN,Home,Upto 2014
Mohammad Ashraful,BAN,Spin,2004-12-17,Chattogram,Bangladesh,2004,1,29,42,1,1,442,811,15,413,769,14,29.466666666666665,<=30,BAN,Home,Upto 2014
Mohammad Ashraful,BAN,Spin,2005-01-06,Chattogram,Bangladesh,2005,1,19,30,0,1,450,957,14,431,927,14,32.142857142857146,>30,BAN,Home,Upto 2014
Mohammad Ashraful,BAN,Spin,2005-01-14,Dhaka,Bangladesh,2005,1,22,54,1,1,497,1234,18,475,1180,17,27.61111111111111,<=30,BAN,Home,Upto 2014
Mohammad Ashraful,BAN,Spin,2005-09-12,Colombo (RPS),Sri Lanka,2005,1,2,6,0,1,396,772,20,394,766,20,19.8,<=30,SL,Away,Upto 2014
Mohammad Ashraful,BAN,Spin,2005-09-20,Colombo (PSS),Sri Lanka,2005,1,11,12,0,1,417,656,12,406,644,12,34.75,>30,SL,Away,Upto 2014
Mohammad Ashraful,BAN,Spin,2006-02-28,Chattogram,Bangladesh,2006,2,33,30,0,1,666,1170,22,633,1140,22,30.272727272727273,>30,BAN,Home,Upto 2014
Mohammad Ashraful,BAN,Spin,2006-03-08,Bogra,Bangladesh,2006,1,16,24,1,1,552,1040,19,536,1016,18,29.05263157894737,<=30,BAN,Home,Upto 2014
Mohammad Ashraful,BAN,Spin,2006-04-09,Fatullah,Bangladesh,2006,1,11,6,0,1,739,1451,25,728,1445,25,29.56,<=30,BAN,Home,Upto 2014
Mohammad Ashraful,BAN,Spin,2007-05-18,Chattogram,Bangladesh,2007,1,5,6,0,1,447,726,13,442,720,13,34.38461538461539,>30,BAN,Home,Upto 2014
Mohammad Ashraful,BAN,Spin,2007-05-25,Mirpur,Bangladesh,2007,1,35,48,0,1,453,725,12,418,677,12,37.75,>30,BAN,Home,Upto 2014
Mohammad Ashraful,BAN,Spin,2007-06-25,Colombo (SSC),Sri Lanka,2007,1,52,78,0,1,605,1005,14,553,927,14,43.214285714285715,>30,SL,Away,Upto 2014
Mohammad Ashraful,BAN,Spin,2007-07-03,Colombo (PSS),Sri Lanka,2007,1,31,42,0,1,383,661,9,352,619,9,42.55555555555556,>30,SL,Away,Upto 2014
Mohammad Ashraful,BAN,Spin,2007-07-11,Kandy,Sri Lanka,2007,1,74,72,0,1,353,551,12,279,479,12,29.416666666666668,<=30,SL,Away,Upto 2014
Mohammad Ashraful,BAN,Spin,2008-01-04,Dunedin,New Zealand,2008,2,52,55,2,1,288,481,9,236,426,7,32.0,>30,NZ,Away,Upto 2014
Mohammad Ashraful,BAN,Spin,2008-01-12,Wellington,New Zealand,2008,1,16,12,0,1,156,309,6,140,297,6,26.0,<=30,NZ,Away,Upto 2014
Mohammad Ashraful,BAN,Spin,2008-02-22,Mirpur,Bangladesh,2008,2,15,18,1,1,350,752,16,335,734,15,21.875,<=30,BAN,Home,Upto 2014
Mohammad Ashraful,BAN,Spin,2008-02-29,Chattogram,Bangladesh,2008,1,20,18,0,1,550,943,13,530,925,13,42.30769230769231,>30,BAN,Home,Upto 2014
Mohammad Ashraful,BAN,Spin,2008-10-17,Chattogram,Bangladesh,2008,2,27,30,1,1,669,1820,29,642,1790,28,23.06896551724138,<=30,BAN,Home,Upto 2014
Mohammad Ashraful,BAN,Spin,2008-10-25,Mirpur,Bangladesh,2008,2,11,24,1,1,361,720,10,350,696,9,36.1,>30,BAN,Home,Upto 2014
Mohammad Ashraful,BAN,Spin,2008-11-26,Centurion,South Africa,2008,1,15,12,0,1,253,380,8,238,368,8,31.625,>30,SA,Away,Upto 2014
Mohammad Ashraful,BAN,Spin,2008-12-26,Mirpur,Bangladesh,2008,2,30,42,0,1,727,1408,21,697,1366,21,34.61904761904762,>30,BAN,Home,Upto 2014
Mohammad Ashraful,BAN,Spin,2009-01-03,Chattogram,Bangladesh,2009,2,75,114,3,1,931,1570,27,856,1456,24,34.48148148148148,>30,BAN,Home,Upto 2014
Mohammad Ashraful,BAN,Spin,2009-07-09,Kingstown,West Indies,2009,2,19,66,2,1,504,1195,18,485,1129,16,28.0,<=30,WI,Away,Upto 2014
Mohammad Ashraful,BAN,Spin,2009-07-17,St George's,West Indies,2009,2,14,24,0,1,462,930,22,448,906,22,21.0,<=30,WI,Away,Upto 2014
Mohammad Ashraful,BAN,Spin,2010-01-17,Chattogram,Bangladesh,2010,2,14,12,0,1,565,949,23,551,937,23,24.565217391304348,<=30,BAN,Home,Upto 2014
Mohammad Ashraful,BAN,Spin,2010-01-24,Mirpur,Bangladesh,2010,1,38,54,1,1,600,1045,11,562,991,10,54.54545454545455,>30,BAN,Home,Upto 2014
Mohammad Ashraful,BAN,Spin,2010-02-15,Hamilton,New Zealand,2010,1,9,18,0,1,711,1173,10,702,1155,10,71.1,>30,NZ,Away,Upto 2014
Mohammad Ashraful,BAN,Spin,2010-05-27,Lord's,England,2010,1,13,12,0,1,517,907,10,504,895,10,51.7,>30,ENG,Away,Upto 2014
Mohammad Ashraful,BAN,Spin,2011-12-09,Chattogram,Bangladesh,2011,1,20,24,0,1,717,1447,18,697,1423,18,39.833333333333336,>30,BAN,Home,Upto 2014
Mohammad Ashraful,BAN,Spin,2013-03-08,Galle,Sri Lanka,2013,2,33,30,0,1,1160,1920,13,1127,1890,13,89.23076923076923,>30,SL,Away,Upto 2014
Mohammad Ashraful,BAN,Spin,2013-03-16,Colombo (RPS),Sri Lanka,2013,2,17,34,0,1,481,1042,18,464,1008,18,26.72222222222222,<=30,SL,Away,Upto 2014
Mohammad Ashraful,BAN,Spin,2013-04-25,Harare,Zimbabwe,2013,2,13,54,1,1,425,789,13,412,735,12,32.69230769230769,>30,ZIM,Away,Upto 2014
Mohammad Asif,PAK,Pace,2005-01-02,Sydney,Australia,2005,2,88,108,0,1,541,846,9,453,738,9,60.111111111111114,>30,AUS,Away,Upto 2014
Mohammad Asif,PAK,Pace,2006-01-21,Faisalabad,Pakistan,2006,1,103,204,1,1,888,1366,17,785,1162,16,52.23529411764706,>30,PAK,Home,Upto 2014
Mohammad Asif,PAK,Pace,2006-01-29,Karachi,Pakistan,2006,2,126,187,7,1,991,1398,31,865,1211,24,31.967741935483872,>30,PAK,Home,Upto 2014
Mohammad Asif,PAK,Pace,2006-03-26,Colombo (SSC),Sri Lanka,2006,2,112,234,6,1,568,1044,16,456,810,10,35.5,>30,SL,Away,Upto 2014
Mohammad Asif,PAK,Pace,2006-04-03,Kandy,Sri Lanka,2006,2,71,210,11,1,524,943,20,453,733,9,26.2,<=30,SL,Away,Upto 2014
Mohammad Asif,PAK,Pace,2006-08-17,The Oval,England,2006,2,135,216,5,1,700,1093,21,565,877,16,33.333333333333336,>30,ENG,Away,Upto 2014
Mohammad Asif,PAK,Pace,2007-01-11,Centurion,South Africa,2007,2,145,251,7,1,894,1492,25,749,1241,18,35.76,>30,SA,Away,Upto 2014
Mohammad Asif,PAK,Pace,2007-01-19,Gqeberha,South Africa,2007,2,110,282,7,1,653,1296,27,543,1014,20,24.185185185185187,<=30,SA,Away,Upto 2014
Mohammad Asif,PAK,Pace,2007-01-26,Cape Town,South Africa,2007,2,96,222,5,1,527,865,27,431,643,22,19.51851851851852,<=30,SA,Away,Upto 2014
Mohammad Asif,PAK,Pace,2007-10-01,Karachi,Pakistan,2007,2,97,192,1,1,523,1031,16,426,839,15,32.6875,>30,PAK,Home,Upto 2014
Mohammad Asif,PAK,Pace,2007-10-08,Lahore,Pakistan,2007,2,97,228,1,1,635,1158,14,538,930,13,45.357142857142854,>30,PAK,Home,Upto 2014
Mohammad Asif,PAK,Pace,2009-11-24,Dunedin,New Zealand,2009,2,151,324,8,1,862,1655,33,711,1331,25,26.12121212121212,<=30,NZ,Away,Upto 2014
Mohammad Asif,PAK,Pace,2009-12-03,Wellington,New Zealand,2009,2,107,220,9,1,635,1257,30,528,1037,21,21.166666666666668,<=30,NZ,Away,Upto 2014
Mohammad Asif,PAK,Pace,2009-12-11,Napier,New Zealand,2009,2,118,216,2,1,858,1683,18,740,1467,16,47.666666666666664,>30,NZ,Away,Upto 2014
Mohammad Asif,PAK,Pace,2009-12-26,Melbourne,Australia,2009,2,124,258,3,1,736,1512,23,612,1254,20,32.0,>30,AUS,Away,Upto 2014
Mohammad Asif,PAK,Pace,2010-01-03,Sydney,Australia,2010,2,94,282,8,1,640,1344,29,546,1062,21,22.06896551724138,<=30,AUS,Away,Upto 2014
Mohammad Asif,PAK,Pace,2010-01-14,Hobart,Australia,2010,2,152,270,2,1,758,1508,15,606,1238,13,50.53333333333333,>30,AUS,Away,Upto 2014
Mohammad Asif,PAK,Pace,2010-07-13,Lord's,England,2010,2,140,240,6,1,698,1252,26,558,1012,20,26.846153846153847,<=30,ENG,Away,Upto 2014
Mohammad Asif,PAK,Pace,2010-07-21,Leeds,England,2010,2,113,217,5,1,714,1273,33,601,1056,28,21.636363636363637,<=30,ENG,Away,Upto 2014
Mohammad Asif,PAK,Pace,2010-07-29,Nottingham,England,2010,2,133,264,6,1,558,1225,33,425,961,27,16.90909090909091,<=30,ENG,Away,Upto 2014
Mohammad Asif,PAK,Pace,2010-08-06,Birmingham,England,2010,2,61,156,2,1,468,1160,20,407,1004,18,23.4,<=30,ENG,Away,Upto 2014
Mohammad Asif,PAK,Pace,2010-08-18,The Oval,England,2010,2,113,216,3,1,645,1152,22,532,936,19,29.318181818181817,<=30,ENG,Away,Upto 2014
Mohammad Asif,PAK,Pace,2010-08-26,Lord's,England,2010,1,97,174,1,1,413,794,18,316,620,17,22.944444444444443,<=30,ENG,Away,Upto 2014
Mohammad Farooq,PAK,Pace,1960-12-02,Brabourne,India,1960,1,139,276,4,1,494,1042,13,355,766,9,38.0,>30,IND,Away,Upto 2014
Mohammad Farooq,PAK,Pace,1961-02-08,Delhi,India,1961,2,109,180,2,1,579,1092,16,470,912,14,36.1875,>30,IND,Away,Upto 2014
Mohammad Farooq,PAK,Pace,1962-06-21,Lord's,England,1962,2,107,156,4,1,524,1195,25,417,1039,21,20.96,<=30,ENG,Away,Upto 2014
Mohammad Farooq,PAK,Pace,1962-07-05,Leeds,England,1962,1,74,168,1,1,501,1157,23,427,989,22,21.782608695652176,<=30,ENG,Away,Upto 2014
Mohammad Farooq,PAK,Pace,1965-03-27,Rawalpindi,Pakistan,1965,2,82,168,5,1,167,432,11,85,264,6,15.181818181818182,<=30,PAK,Home,Upto 2014
Mohammad Farooq,PAK,Pace,1965-04-02,Lahore,Pakistan,1965,1,71,246,2,1,328,882,6,257,636,4,54.666666666666664,>30,PAK,Home,Upto 2014
Mohammad Farooq,PAK,Pace,1965-04-09,Karachi,Pakistan,1965,2,100,228,3,1,333,774,10,233,546,7,33.3,>30,PAK,Home,Upto 2014
Mohammad Hafeez,PAK,Spin,2003-08-20,Karachi,Pakistan,2003,2,28,126,1,1,435,1074,13,407,948,12,33.46153846153846,>30,PAK,Home,Upto 2014
Mohammad Hafeez,PAK,Spin,2003-08-27,Peshawar,Pakistan,2003,1,26,60,0,1,404,889,11,378,829,11,36.72727272727273,>30,PAK,Home,Upto 2014
Mohammad Hafeez,PAK,Spin,2003-09-03,Multan,Pakistan,2003,1,7,18,0,1,248,589,11,241,571,11,22.545454545454547,<=30,PAK,Home,Upto 2014
Mohammad Hafeez,PAK,Spin,2006-08-17,The Oval,England,2006,1,13,24,0,1,237,438,3,224,414,3,79.0,>30,ENG,Away,Upto 2014
Mohammad Hafeez,PAK,Spin,2006-11-11,Lahore,Pakistan,2006,1,11,24,1,1,296,600,9,285,576,8,32.888888888888886,>30,PAK,Home,Upto 2014
Mohammad Hafeez,PAK,Spin,2006-11-19,Multan,Pakistan,2006,1,72,144,0,1,610,1072,9,538,928,9,67.77777777777777,>30,PAK,Home,Upto 2014
Mohammad Hafeez,PAK,Spin,2006-11-27,Karachi,Pakistan,2006,1,10,24,0,1,303,725,10,293,701,10,30.3,>30,PAK,Home,Upto 2014
Mohammad Hafeez,PAK,Spin,2007-01-11,Centurion,South Africa,2007,2,60,138,1,1,295,739,8,235,601,7,36.875,>30,SA,Away,Upto 2014
Mohammad Hafeez,PAK,Spin,2007-01-19,Gqeberha,South Africa,2007,1,32,48,0,1,226,545,7,194,497,7,32.285714285714285,>30,SA,Away,Upto 2014
Mohammad Hafeez,PAK,Spin,2007-01-26,Cape Town,South Africa,2007,1,7,30,0,1,134,404,7,127,374,7,19.142857142857142,<=30,SA,Away,Upto 2014
Mohammad Hafeez,PAK,Spin,2007-10-01,Karachi,Pakistan,2007,2,53,114,1,1,692,1416,21,639,1302,20,32.95238095238095,>30,PAK,Home,Upto 2014
Mohammad Hafeez,PAK,Spin,2010-11-12,Dubai (DICS),UAE,2010,2,21,72,0,1,753,1614,13,732,1542,13,57.92307692307692,>30,UAE,Away,Upto 2014
Mohammad Hafeez,PAK,Spin,2010-11-20,Abu Dhabi,UAE,2010,2,90,168,2,1,553,1225,14,463,1057,12,39.5,>30,UAE,Away,Upto 2014
Mohammad Hafeez,PAK,Spin,2011-01-07,Hamilton,New Zealand,2011,1,4,12,0,1,193,540,7,189,528,7,27.571428571428573,<=30,NZ,Away,Upto 2014
Mohammad Hafeez,PAK,Spin,2011-01-15,Wellington,New Zealand,2011,2,48,126,2,1,445,1147,12,397,1021,10,37.083333333333336,>30,NZ,Away,Upto 2014
Mohammad Hafeez,PAK,Spin,2011-05-12,Providence,West Indies,2011,2,37,132,3,1,348,989,21,311,857,18,16.571428571428573,<=30,WI,Away,Upto 2014
Mohammad Hafeez,PAK,Spin,2011-05-20,Basseterre,West Indies,2011,2,46,108,3,1,530,1213,20,484,1105,17,26.5,<=30,WI,Away,Upto 2014
Mohammad Hafeez,PAK,Spin,2011-09-01,Bulawayo,Zimbabwe,2011,2,61,144,4,1,525,1193,17,464,1049,13,30.88235294117647,>30,ZIM,Away,Upto 2014
Mohammad Hafeez,PAK,Spin,2011-10-18,Abu Dhabi,UAE,2011,2,54,186,0,1,499,1258,7,445,1072,7,71.28571428571429,>30,UAE,Away,Upto 2014
Mohammad Hafeez,PAK,Spin,2011-10-26,Dubai (DICS),UAE,2011,2,37,96,1,1,466,1189,19,429,1093,18,24.526315789473685,<=30,UAE,Away,Upto 2014
Mohammad Hafeez,PAK,Spin,2011-11-03,Sharjah,UAE,2011,2,37,66,1,1,589,1524,15,552,1458,14,39.266666666666666,>30,UAE,Away,Upto 2014
Mohammad Hafeez,PAK,Spin,2011-12-09,Chattogram,Bangladesh,2011,2,30,60,1,1,717,1447,18,687,1387,17,39.833333333333336,>30,BAN,Away,Upto 2014
Mohammad Hafeez,PAK,Spin,2011-12-17,Mirpur,Bangladesh,2011,2,35,72,0,1,690,1381,17,655,1309,17,40.588235294117645,>30,BAN,Away,Upto 2014
Mohammad Hafeez,PAK,Spin,2012-01-17,Dubai (DICS),UAE,2012,2,9,48,1,1,302,659,19,293,611,18,15.894736842105264,<=30,UAE,Away,Upto 2014
Mohammad Hafeez,PAK,Spin,2012-01-25,Abu Dhabi,UAE,2012,2,65,180,4,1,558,1443,31,493,1263,27,18.0,<=30,UAE,Away,Upto 2014
Mohammad Hafeez,PAK,Spin,2012-02-03,Dubai (DICS),UAE,2012,1,6,30,0,1,528,1381,25,522,1351,25,21.12,<=30,UAE,Away,Upto 2014
Mohammad Hafeez,PAK,Spin,2012-06-22,Galle,Sri Lanka,2012,1,55,116,3,1,621,1409,23,566,1293,20,27.0,<=30,SL,Away,Upto 2014
Mohammad Hafeez,PAK,Spin,2012-06-30,Colombo (SSC),Sri Lanka,2012,1,29,48,0,1,609,1048,13,580,1000,13,46.84615384615385,>30,SL,Away,Upto 2014
Mohammad Hafeez,PAK,Spin,2012-07-08,Pallekele,Sri Lanka,2012,2,32,84,0,1,298,765,13,266,681,13,22.923076923076923,<=30,SL,Away,Upto 2014
Mohammad Hafeez,PAK,Spin,2013-02-01,Johannesburg,South Africa,2013,2,48,74,4,1,230,410,6,182,336,2,38.333333333333336,>30,SA,Away,Upto 2014
Mohammad Hafeez,PAK,Spin,2013-02-14,Cape Town,South Africa,2013,2,35,67,1,1,363,754,16,328,687,15,22.6875,<=30,SA,Away,Upto 2014
Mohammad Hafeez,PAK,Spin,2013-02-22,Centurion,South Africa,2013,1,24,30,0,1,179,318,2,155,288,2,89.5,>30,SA,Away,Upto 2014
Mohammad Hafeez,PAK,Spin,2013-09-10,Harare,Zimbabwe,2013,1,12,24,0,1,357,809,10,345,785,10,35.7,>30,ZIM,Away,Upto 2014
Mohammad Hafeez,PAK,Spin,2013-12-31,Abu Dhabi,UAE,2013,1,23,54,0,1,396,907,6,373,853,6,66.0,>30,UAE,Away,Upto 2014
Mohammad Hafeez,PAK,Spin,2014-01-08,Dubai (DICS),UAE,2014,2,33,84,1,1,299,751,9,266,667,8,33.22222222222222,>30,UAE,Away,After 1965
Mohammad Hafeez,PAK,Spin,2014-10-22,Dubai (DICS),UAE,2014,2,83,244,1,1,843,1550,22,760,1306,21,38.31818181818182,>30,UAE,Away,After 1965
Mohammad Hafeez,PAK,Spin,2014-10-30,Abu Dhabi,UAE,2014,2,51,134,3,1,756,1259,18,705,1125,15,42.0,>30,UAE,Away,After 1965
Mohammad Hafeez,PAK,Spin,2014-11-09,Abu Dhabi,UAE,2014,2,81,132,2,1,765,1282,14,684,1150,12,54.642857142857146,>30,UAE,Away,After 1965
Mohammad Hafeez,PAK,Spin,2014-11-26,Sharjah,UAE,2014,1,110,138,2,1,856,1190,21,746,1052,19,40.76190476190476,>30,UAE,Away,After 1965
Mohammad Hafeez,PAK,Spin,2015-04-28,Khulna,Bangladesh,2015,2,129,228,4,1,1092,1798,20,963,1570,16,54.6,>30,BAN,Away,After 1965
Mohammad Hafeez,PAK,Spin,2015-05-06,Mirpur,Bangladesh,2015,2,16,42,2,1,692,1014,18,676,972,16,38.44444444444444,>30,BAN,Away,After 1965
Mohammad Hafeez,PAK,Spin,2015-06-17,Galle,Sri Lanka,2015,2,64,120,2,1,617,1159,20,553,1039,18,30.85,>30,SL,Away,After 1965
Mohammad Hafeez,PAK,Spin,2015-06-25,Colombo (PSS),Sri Lanka,2015,2,39,84,1,1,521,1055,17,482,971,16,30.647058823529413,>30,SL,Away,After 1965
Mohammad Hafeez,PAK,Spin,2018-10-07,Dubai (DICS),UAE,2018,2,31,54,1,1,793,1735,21,762,1681,20,37.76190476190476,>30,UAE,Away,After 1965
Mohammad Hafeez,PAK,Spin,2018-11-16,Abu Dhabi,UAE,2018,2,4,24,0,1,468,1015,21,464,991,21,22.285714285714285,<=30,UAE,Away,After 1965
Mohammad Hafeez,PAK,Spin,2018-11-24,Dubai (DICS),UAE,2018,2,7,30,0,1,473,968,16,466,938,16,29.5625,<=30,UAE,Away,After 1965
Mohammad Hafeez,PAK,Spin,2018-12-03,Abu Dhabi,UAE,2018,1,3,6,0,1,612,1532,24,609,1526,24,25.5,<=30,UAE,Away,After 1965
Mohammad Hussain,PAK,Spin,1996-10-24,Faisalabad,Pakistan,1996,2,21,60,1,1,168,373,4,147,313,3,42.0,>30,PAK,Home,Upto 2014
Mohammad Hussain,PAK,Spin,1998-10-01,Rawalpindi,Pakistan,1998,1,66,120,2,1,561,1319,19,495,1199,17,29.526315789473685,<=30,PAK,Home,Upto 2014
Mohammad Ilyas,PAK,Spin,1965-01-22,Wellington,New Zealand,1965,1,28,42,0,1,356,1080,8,328,1038,8,44.5,>30,NZ,Away,Upto 2014
Mohammad Ilyas,PAK,Spin,1965-01-29,Auckland,New Zealand,1965,1,12,12,0,1,450,1734,24,438,1722,24,18.75,<=30,NZ,Away,Upto 2014
Mohammad Ilyas,PAK,Spin,1965-02-12,Christchurch,New Zealand,1965,1,14,18,0,1,466,1098,16,452,1080,16,29.125,<=30,NZ,Away,Upto 2014
Mohammad Ilyas,PAK,Spin,1965-04-02,Lahore,Pakistan,1965,1,8,6,0,1,697,1836,15,689,1830,15,46.46666666666667,>30,PAK,Home,Upto 2014
Mohammad Ilyas,PAK,Spin,1969-02-28,Dhaka,Bangladesh,1969,1,1,6,0,1,397,1246,15,396,1240,15,26.466666666666665,<=30,BAN,Away,Upto 2014
Mohammad Irfan,PAK,Pace,2013-02-14,Cape Town,South Africa,2013,2,121,186,3,1,620,1269,20,499,1083,17,31.0,>30,SA,Away,Upto 2014
Mohammad Irfan,PAK,Pace,2013-02-22,Centurion,South Africa,2013,1,80,131,0,1,578,1050,26,498,919,26,22.23076923076923,<=30,SA,Away,Upto 2014
Mohammad Irfan,PAK,Pace,2013-10-14,Abu Dhabi,UAE,2013,2,86,188,4,1,476,1024,18,390,836,14,26.444444444444443,<=30,UAE,Away,Upto 2014
Mohammad Irfan,PAK,Pace,2013-10-23,Dubai (DICS),UAE,2013,1,102,207,3,1,404,958,9,302,751,6,44.888888888888886,>30,UAE,Away,Upto 2014
Mohammad Khalil,PAK,Pace,2004-12-16,W.A.C.A,Australia,2004,2,97,152,0,1,677,1213,30,580,1061,30,22.566666666666666,<=30,AUS,Away,Upto 2014
Mohammad Khalil,PAK,Pace,2005-03-16,Eden Gardens,India,2005,2,103,138,0,1,678,1069,14,575,931,14,48.42857142857143,>30,IND,Away,Upto 2014
Mohammad Munaf,PAK,Pace,1959-11-21,Lahore,Pakistan,1959,2,138,246,4,1,401,960,14,263,714,10,28.642857142857142,<=30,PAK,Home,Upto 2014
Mohammad Munaf,PAK,Pace,1959-12-04,Karachi,Pakistan,1959,2,52,66,1,1,568,1464,19,516,1398,18,29.894736842105264,<=30,PAK,Home,Upto 2014
Mohammad Munaf,PAK,Pace,1961-10-21,Lahore,Pakistan,1961,2,96,277,5,1,400,1080,13,304,803,8,30.76923076923077,>30,PAK,Home,Upto 2014
Mohammad Munaf,PAK,Pace,1962-01-19,Dhaka,Bangladesh,1962,1,55,180,1,1,164,648,2,109,468,1,82.0,>30,BAN,Away,Upto 2014
Mohammad Nabi,AFG,Spin,2018-06-14,Bengaluru,India,2018,1,65,78,1,1,388,572,15,323,494,14,25.866666666666667,<=30,IND,Away,After 1965
Mohammad Nabi,AFG,Spin,2019-03-15,Dehradun,India,2019,2,94,204,3,1,656,1295,22,562,1091,19,29.818181818181817,<=30,IND,Away,After 1965
Mohammad Nabi,AFG,Spin,2019-09-05,Chattogram,Bangladesh,2019,2,95,264,4,1,903,1930,38,808,1666,34,23.763157894736842,<=30,BAN,Away,After 1965
Mohammad Nawaz,3,Spin,2016-10-13,Dubai (DICS),UAE,2016,2,70,209,4,1,657,1312,22,587,1103,18,29.863636363636363,<=30,UAE,Away,After 1965
Mohammad Nawaz,3,Spin,2016-10-21,Abu Dhabi,UAE,2016,2,37,84,1,1,703,1324,15,666,1240,14,46.86666666666667,>30,UAE,Away,After 1965
Mohammad Nawaz,3,Spin,2016-10-30,Sharjah,UAE,2016,2,40,90,0,1,457,972,14,417,882,14,32.642857142857146,>30,UAE,Away,After 1965
Mohammad Nawaz,3,Spin,2022-07-16,Galle,Sri Lanka,2022,2,106,204,6,1,840,1795,26,734,1591,20,32.30769230769231,>30,SL,Away,After 1965
Mohammad Nawaz,3,Spin,2022-07-24,Galle,Sri Lanka,2022,2,155,240,4,1,907,1657,29,752,1417,25,31.275862068965516,>30,SL,Away,After 1965
Mohammad Nawaz,3,Spin,2022-12-09,Multan,Pakistan,2022,2,88,132,1,1,774,1107,26,686,975,25,29.76923076923077,<=30,PAK,Away,After 1965
Mohammad Nazir,PAK,Spin,1969-10-24,Karachi,Pakistan,1969,2,114,265,7,1,665,1813,26,551,1548,19,25.576923076923077,<=30,PAK,Home,Upto 2014
Mohammad Nazir,PAK,Spin,1969-10-30,Lahore,Pakistan,1969,2,73,291,3,1,434,1339,23,361,1048,20,18.869565217391305,<=30,PAK,Home,Upto 2014
Mohammad Nazir,PAK,Spin,1969-11-08,Dhaka,Bangladesh,1969,2,41,198,0,1,498,1577,22,457,1379,22,22.636363636363637,<=30,BAN,Away,Upto 2014
Mohammad Nazir,PAK,Spin,1973-03-16,Hyderabad (Sind),Pakistan,1973,2,125,312,0,1,993,2402,21,868,2090,21,47.285714285714285,>30,PAK,Home,Upto 2014
Mohammad Nazir,PAK,Spin,1980-11-24,Lahore,Pakistan,1980,1,38,102,2,1,274,622,12,236,520,10,22.833333333333332,<=30,PAK,Home,Upto 2014
Mohammad Nazir,PAK,Spin,1980-12-08,Faisalabad,Pakistan,1980,2,120,330,8,1,460,1075,25,340,745,17,18.4,<=30,PAK,Home,Upto 2014
Mohammad Nazir,PAK,Spin,1980-12-22,Karachi,Pakistan,1980,1,21,54,2,1,122,421,6,101,367,4,20.333333333333332,<=30,PAK,Home,Upto 2014
Mohammad Nazir,PAK,Spin,1980-12-30,Multan,Pakistan,1980,2,104,246,4,1,206,498,8,102,252,4,25.75,<=30,PAK,Home,Upto 2014
Mohammad Nazir,PAK,Spin,1983-09-14,Bengaluru,India,1983,2,73,186,0,1,224,589,2,151,403,2,112.0,>30,IND,Away,Upto 2014
Mohammad Nazir,PAK,Spin,1983-09-24,Jalandhar,India,1983,1,76,312,0,1,262,937,8,186,625,8,32.75,>30,IND,Away,Upto 2014
Mohammad Nazir,PAK,Spin,1983-10-05,Nagpur,India,1983,2,122,432,7,1,396,1114,18,274,682,11,22.0,<=30,IND,Away,Upto 2014
Mohammad Nazir,PAK,Spin,1983-11-11,W.A.C.A,Australia,1983,1,91,174,1,1,212,366,4,121,192,3,53.0,>30,AUS,Away,Upto 2014
Mohammad Nazir,PAK,Spin,1983-11-25,Brisbane,Australia,1983,1,50,144,0,1,302,612,4,252,468,4,75.5,>30,AUS,Away,Upto 2014
Mohammad Nazir,PAK,Spin,1983-12-09,Adelaide,Australia,1983,2,76,216,0,1,433,870,5,357,654,5,86.6,>30,AUS,Away,Upto 2014
Mohammad Rafique,BAN,Spin,2000-11-10,Dhaka,Bangladesh,2000,2,120,318,3,1,558,1251,19,438,933,16,29.36842105263158,<=30,BAN,Home,Upto 2014
Mohammad Rafique,BAN,Spin,2002-10-18,East London,South Africa,2002,1,85,138,0,1,247,486,3,162,348,3,82.33333333333333,>30,SA,Away,Upto 2014
Mohammad Rafique,BAN,Spin,2003-05-01,Dhaka,Bangladesh,2003,1,77,224,6,1,312,727,15,235,503,9,20.8,<=30,BAN,Home,Upto 2014
Mohammad Rafique,BAN,Spin,2003-08-20,Karachi,Pakistan,2003,2,137,348,5,1,435,1074,13,298,726,8,33.46153846153846,>30,PAK,Away,Upto 2014
Mohammad Rafique,BAN,Spin,2003-08-27,Peshawar,Pakistan,2003,2,152,342,5,1,404,889,11,252,547,6,36.72727272727273,>30,PAK,Away,Upto 2014
Mohammad Rafique,BAN,Spin,2003-09-03,Multan,Pakistan,2003,2,116,286,7,1,248,589,11,132,303,4,22.545454545454547,<=30,PAK,Away,Upto 2014
Mohammad Rafique,BAN,Spin,2003-10-21,Dhaka,Bangladesh,2003,2,141,293,5,1,443,953,10,302,660,5,44.3,>30,BAN,Home,Upto 2014
Mohammad Rafique,BAN,Spin,2003-10-29,Chattogram,Bangladesh,2003,2,169,396,5,1,331,702,7,162,306,2,47.285714285714285,>30,BAN,Home,Upto 2014
Mohammad Rafique,BAN,Spin,2004-02-19,Harare,Zimbabwe,2004,2,183,462,6,1,538,1129,14,355,667,8,38.42857142857143,>30,ZIM,Away,Upto 2014
Mohammad Rafique,BAN,Spin,2004-02-26,Bulawayo,Zimbabwe,2004,1,53,120,0,1,156,307,6,103,187,6,26.0,<=30,ZIM,Away,Upto 2014
Mohammad Rafique,BAN,Spin,2004-05-28,Gros Islet,West Indies,2004,2,97,246,3,1,308,824,12,211,578,9,25.666666666666668,<=30,WI,Away,Upto 2014
Mohammad Rafique,BAN,Spin,2004-06-04,Kingston,West Indies,2004,1,124,228,1,1,393,750,8,269,522,7,49.125,>30,WI,Away,Upto 2014
Mohammad Rafique,BAN,Spin,2004-10-19,Dhaka,Bangladesh,2004,1,122,355,6,1,383,1134,20,261,779,14,19.15,<=30,BAN,Home,Upto 2014
Mohammad Rafique,BAN,Spin,2004-10-26,Chattogram,Bangladesh,2004,1,130,330,3,1,719,1390,23,589,1060,20,31.26086956521739,>30,BAN,Home,Upto 2014
Mohammad Rafique,BAN,Spin,2004-12-10,Dhaka,Bangladesh,2004,1,113,240,2,1,324,603,8,211,363,6,40.5,>30,BAN,Home,Upto 2014
Mohammad Rafique,BAN,Spin,2004-12-17,Chattogram,Bangladesh,2004,1,156,300,4,1,442,811,15,286,511,11,29.466666666666665,<=30,BAN,Home,Upto 2014
Mohammad Rafique,BAN,Spin,2005-01-06,Chattogram,Bangladesh,2005,2,108,340,5,1,450,957,14,342,617,9,32.142857142857146,>30,BAN,Home,Upto 2014
Mohammad Rafique,BAN,Spin,2005-01-14,Dhaka,Bangladesh,2005,2,113,372,1,1,497,1234,18,384,862,17,27.61111111111111,<=30,BAN,Home,Upto 2014
Mohammad Rafique,BAN,Spin,2005-05-26,Lord's,England,2005,1,150,246,1,1,251,318,1,101,72,0,251.0,>30,ENG,Away,Upto 2014
Mohammad Rafique,BAN,Spin,2005-06-03,Chester-le-Street,England,2005,1,107,108,0,1,151,198,1,44,90,1,151.0,>30,ENG,Away,Upto 2014
Mohammad Rafique,BAN,Spin,2005-09-12,Colombo (RPS),Sri Lanka,2005,1,114,222,5,1,396,772,20,282,550,15,19.8,<=30,SL,Away,Upto 2014
Mohammad Rafique,BAN,Spin,2005-09-20,Colombo (PSS),Sri Lanka,2005,1,92,138,0,1,417,656,12,325,518,12,34.75,>30,SL,Away,Upto 2014
Mohammad Rafique,BAN,Spin,2006-02-28,Chattogram,Bangladesh,2006,2,104,222,2,1,666,1170,22,562,948,20,30.272727272727273,>30,BAN,Home,Upto 2014
Mohammad Rafique,BAN,Spin,2006-03-08,Bogra,Bangladesh,2006,2,116,246,1,1,552,1040,19,436,794,18,29.05263157894737,<=30,BAN,Home,Upto 2014
Mohammad Rafique,BAN,Spin,2006-04-09,Fatullah,Bangladesh,2006,2,160,422,9,1,739,1451,25,579,1029,16,29.56,<=30,BAN,Home,Upto 2014
Mohammad Rafique,BAN,Spin,2006-04-16,Chattogram,Bangladesh,2006,1,145,291,2,1,796,1393,18,651,1102,16,44.22222222222222,>30,BAN,Home,Upto 2014
Mohammad Rafique,BAN,Spin,2007-05-18,Chattogram,Bangladesh,2007,2,126,192,4,1,447,726,13,321,534,9,34.38461538461539,>30,BAN,Home,Upto 2014
Mohammad Rafique,BAN,Spin,2007-05-25,Mirpur,Bangladesh,2007,1,181,270,2,1,453,725,12,272,455,10,37.75,>30,BAN,Home,Upto 2014
Mohammad Rafique,BAN,Spin,2007-06-25,Colombo (SSC),Sri Lanka,2007,1,138,173,1,1,605,1005,14,467,832,13,43.214285714285715,>30,SL,Away,Upto 2014
Mohammad Rafique,BAN,Spin,2007-07-03,Colombo (PSS),Sri Lanka,2007,1,134,210,0,1,383,661,9,249,451,9,42.55555555555556,>30,SL,Away,Upto 2014
Mohammad Rafique,BAN,Spin,2007-07-11,Kandy,Sri Lanka,2007,1,72,84,0,1,353,551,12,281,467,12,29.416666666666668,<=30,SL,Away,Upto 2014
Mohammad Rafique,BAN,Spin,2008-02-22,Mirpur,Bangladesh,2008,2,109,317,4,1,350,752,16,241,435,12,21.875,<=30,BAN,Home,Upto 2014
Mohammad Rafique,BAN,Spin,2008-02-29,Chattogram,Bangladesh,2008,1,132,265,2,1,550,943,13,418,678,11,42.30769230769231,>30,BAN,Home,Upto 2014
Mohammad Saleem,AFG,Pace,2024-02-02,Colombo (SSC),Sri Lanka,2024,1,57,73,0,1,535,897,18,478,824,18,29.72222222222222,<=30,SL,Away,After 1965
Mohammad Sami,PAK,Pace,2001-03-08,Auckland,New Zealand,2001,2,106,280,8,1,702,1474,24,596,1194,16,29.25,<=30,NZ,Away,Upto 2014
Mohammad Sami,PAK,Pace,2001-03-15,Christchurch,New Zealand,2001,2,139,282,0,1,802,1722,12,663,1440,12,66.83333333333333,>30,NZ,Away,Upto 2014
Mohammad Sami,PAK,Pace,2002-03-06,Lahore,Pakistan,2002,2,135,239,5,1,853,1374,23,718,1135,18,37.08695652173913,>30,PAK,Home,Upto 2014
Mohammad Sami,PAK,Pace,2002-10-03,Colombo (PSS),Sri Lanka,2002,2,106,156,1,1,672,1175,21,566,1019,20,32.0,>30,SL,Away,Upto 2014
Mohammad Sami,PAK,Pace,2002-10-19,Sharjah,UAE,2002,1,81,168,0,1,365,713,15,284,545,15,24.333333333333332,<=30,UAE,Away,Upto 2014
Mohammad Sami,PAK,Pace,2002-11-09,Harare,Zimbabwe,2002,2,103,204,5,1,875,1422,31,772,1218,26,28.225806451612904,<=30,ZIM,Away,Upto 2014
Mohammad Sami,PAK,Pace,2002-11-16,Bulawayo,Zimbabwe,2002,2,85,204,2,1,555,1011,16,470,807,14,34.6875,>30,ZIM,Away,Upto 2014
Mohammad Sami,PAK,Pace,2002-12-26,Durban,South Africa,2002,2,128,186,3,1,631,1153,23,503,967,20,27.434782608695652,<=30,SA,Away,Upto 2014
Mohammad Sami,PAK,Pace,2003-01-02,Cape Town,South Africa,2003,1,124,168,1,1,694,1175,21,570,1007,20,33.04761904761905,>30,SA,Away,Upto 2014
Mohammad Sami,PAK,Pace,2003-10-17,Lahore,Pakistan,2003,2,143,195,1,1,569,1080,10,426,885,9,56.9,>30,PAK,Home,Upto 2014
Mohammad Sami,PAK,Pace,2003-12-19,Hamilton,New Zealand,2003,2,170,258,5,1,863,1591,23,693,1333,18,37.52173913043478,>30,NZ,Away,Upto 2014
Mohammad Sami,PAK,Pace,2003-12-26,Wellington,New Zealand,2003,2,76,204,1,1,696,1646,29,620,1442,28,24.0,<=30,NZ,Away,Upto 2014
Mohammad Sami,PAK,Pace,2004-03-28,Multan,Pakistan,2004,1,110,204,2,1,716,1290,10,606,1086,8,71.6,>30,PAK,Home,Upto 2014
Mohammad Sami,PAK,Pace,2004-04-05,Lahore,Pakistan,2004,2,209,294,4,1,744,1284,22,535,990,18,33.81818181818182,>30,PAK,Home,Upto 2014
Mohammad Sami,PAK,Pace,2004-04-13,Rawalpindi,Pakistan,2004,1,116,240,1,1,687,1266,18,571,1026,17,38.166666666666664,>30,PAK,Home,Upto 2014
Mohammad Sami,PAK,Pace,2004-10-20,Faisalabad,Pakistan,2004,2,119,202,4,1,726,1252,21,607,1050,17,34.57142857142857,>30,PAK,Home,Upto 2014
Mohammad Sami,PAK,Pace,2004-12-16,W.A.C.A,Australia,2004,2,159,239,4,1,677,1213,30,518,974,26,22.566666666666666,<=30,AUS,Away,Upto 2014
Mohammad Sami,PAK,Pace,2004-12-26,Melbourne,Australia,2004,2,124,168,1,1,584,1094,18,460,926,17,32.44444444444444,>30,AUS,Away,Upto 2014
Mohammad Sami,PAK,Pace,2005-03-08,Mohali,India,2005,2,145,258,2,1,866,1468,17,721,1210,15,50.94117647058823,>30,IND,Away,Upto 2014
Mohammad Sami,PAK,Pace,2005-03-16,Eden Gardens,India,2005,2,158,270,3,1,678,1069,14,520,799,11,48.42857142857143,>30,IND,Away,Upto 2014
Mohammad Sami,PAK,Pace,2005-03-24,Bengaluru,India,2005,2,190,330,5,1,604,960,8,414,630,3,75.5,>30,IND,Away,Upto 2014
Mohammad Sami,PAK,Pace,2005-11-12,Multan,Pakistan,2005,2,107,150,3,1,730,1407,32,623,1257,29,22.8125,<=30,PAK,Home,Upto 2014
Mohammad Sami,PAK,Pace,2005-11-20,Faisalabad,Pakistan,2005,2,69,150,1,1,802,1439,26,733,1289,25,30.846153846153847,>30,PAK,Home,Upto 2014
Mohammad Sami,PAK,Pace,2005-11-29,Lahore,Pakistan,2005,2,96,204,3,1,870,1496,17,774,1292,14,51.1764705882353,>30,PAK,Home,Upto 2014
Mohammad Sami,PAK,Pace,2006-01-13,Lahore,Pakistan,2006,1,67,72,0,1,476,638,4,409,566,4,119.0,>30,PAK,Home,Upto 2014
Mohammad Sami,PAK,Pace,2006-07-13,Lord's,England,2006,2,139,204,1,1,919,1514,18,780,1310,17,51.05555555555556,>30,ENG,Away,Upto 2014
Mohammad Sami,PAK,Pace,2006-07-27,Manchester,England,2006,1,92,168,2,1,487,865,18,395,697,16,27.055555555555557,<=30,ENG,Away,Upto 2014
Mohammad Sami,PAK,Pace,2006-08-04,Leeds,England,2006,2,235,285,5,1,1053,1569,26,818,1284,21,40.5,>30,ENG,Away,Upto 2014
Mohammad Sami,PAK,Pace,2007-01-19,Gqeberha,South Africa,2007,2,105,210,2,1,653,1296,27,548,1086,25,24.185185185185187,<=30,SA,Away,Upto 2014
Mohammad Sami,PAK,Pace,2007-01-26,Cape Town,South Africa,2007,2,50,60,2,1,527,865,27,477,805,25,19.51851851851852,<=30,SA,Away,Upto 2014
Mohammad Sami,PAK,Pace,2007-11-22,Delhi,India,2007,2,136,192,0,1,485,979,16,349,787,16,30.3125,>30,IND,Away,Upto 2014
Mohammad Sami,PAK,Pace,2007-11-30,Eden Gardens,India,2007,2,127,204,0,1,574,936,5,447,732,5,114.8,>30,IND,Away,Upto 2014
Mohammad Sami,PAK,Pace,2007-12-08,Bengaluru,India,2007,2,212,336,4,1,758,1372,19,546,1036,15,39.89473684210526,>30,IND,Away,Upto 2014
Mohammad Sami,PAK,Pace,2010-01-03,Sydney,Australia,2010,2,101,191,3,1,640,1344,29,539,1153,26,22.06896551724138,<=30,AUS,Away,Upto 2014
Mohammad Sami,PAK,Pace,2010-11-20,Abu Dhabi,UAE,2010,2,129,174,0,1,798,1290,13,669,1116,13,61.38461538461539,>30,UAE,Away,Upto 2014
Mohammad Sami,PAK,Pace,2012-07-08,Pallekele,Sri Lanka,2012,2,92,150,1,1,780,1418,19,688,1268,18,41.05263157894737,>30,SL,Away,Upto 2014
Mohammad Shahid,BAN,Pace,2015-04-28,Khulna,Bangladesh,2015,1,59,114,1,1,401,750,6,342,636,5,66.83333333333333,>30,BAN,Home,After 1965
Mohammad Shahid,BAN,Pace,2015-05-06,Mirpur,Bangladesh,2015,2,95,246,4,1,464,771,14,369,525,10,33.142857142857146,>30,BAN,Home,After 1965
Mohammad Shahid,BAN,Pace,2015-06-10,Fatullah,Bangladesh,2015,1,88,132,0,1,199,300,1,111,168,1,199.0,>30,BAN,Home,After 1965
Mohammad Shahid,BAN,Pace,2015-07-21,Chattogram,Bangladesh,2015,2,46,138,0,1,297,719,10,251,581,10,29.7,<=30,BAN,Home,After 1965
Mohammad Sharif,BAN,Pace,2001-04-19,Bulawayo,Zimbabwe,2001,1,112,174,1,1,731,1458,26,619,1284,25,28.115384615384617,<=30,ZIM,Away,Upto 2014
Mohammad Sharif,BAN,Pace,2001-04-26,Harare,Zimbabwe,2001,2,144,208,2,1,669,1497,14,525,1289,12,47.785714285714285,>30,ZIM,Away,Upto 2014
Mohammad Sharif,BAN,Pace,2001-08-29,Multan,Pakistan,2001,1,110,149,2,1,512,738,9,402,589,7,56.888888888888886,>30,PAK,Away,Upto 2014
Mohammad Sharif,BAN,Pace,2001-09-06,Colombo (SSC),Sri Lanka,2001,1,120,102,0,1,535,726,8,415,624,8,66.875,>30,SL,Away,Upto 2014
Mohammad Sharif,BAN,Pace,2001-11-15,Chattogram,Bangladesh,2001,1,118,174,0,1,536,1126,10,418,952,10,53.6,>30,BAN,Home,Upto 2014
Mohammad Sharif,BAN,Pace,2001-12-18,Hamilton,New Zealand,2001,1,114,121,3,1,586,928,27,472,807,24,21.703703703703702,<=30,NZ,Away,Upto 2014
Mohammad Sharif,BAN,Pace,2002-01-09,Dhaka,Bangladesh,2002,1,95,210,2,1,377,686,15,282,476,13,25.133333333333333,<=30,BAN,Home,Upto 2014
Mohammad Sharif,BAN,Pace,2002-01-16,Chattogram,Bangladesh,2002,1,98,215,4,1,326,664,15,228,449,11,21.733333333333334,<=30,BAN,Home,Upto 2014
Mohammad Sharif,BAN,Pace,2007-05-25,Mirpur,Bangladesh,2007,1,109,154,0,1,511,762,11,402,608,11,46.45454545454545,>30,BAN,Home,Upto 2014
Mohammad Sharif,BAN,Pace,2007-07-03,Colombo (PSS),Sri Lanka,2007,1,86,144,0,1,411,758,15,325,614,15,27.4,<=30,SL,Away,Upto 2014
Mohammad Talha,PAK,Pace,2009-03-01,Lahore,Pakistan,2009,1,88,102,1,1,395,504,8,307,402,7,49.375,>30,PAK,Home,Upto 2014
Mohammad Talha,PAK,Pace,2014-01-16,Sharjah,UAE,2014,2,164,330,6,1,610,1197,18,446,867,12,33.888888888888886,>30,UAE,Away,After 1965
Mohammad Talha,PAK,Pace,2014-08-06,Galle,Sri Lanka,2014,2,116,176,2,1,513,974,10,397,798,8,51.3,>30,SL,Away,After 1965
Mohammad Talha,PAK,Pace,2014-11-26,Sharjah,UAE,2014,1,136,132,0,1,429,804,9,293,672,9,47.666666666666664,>30,UAE,Away,After 1965
Mohammad Wasim,1,Spin,2022-12-17,Karachi,Pakistan,2022,2,111,145,1,1,895,1264,27,784,1119,26,33.148148148148145,>30,PAK,Away,After 1965
Mohammad Wasim,1,Spin,2022-12-26,Karachi,Pakistan,2022,2,120,213,1,1,1086,2053,24,966,1840,23,45.25,>30,PAK,Away,After 1965
Mohammad Yousuf,PAK,Spin,2001-03-15,Christchurch,New Zealand,2001,1,3,6,0,1,390,912,6,387,906,6,65.0,>30,NZ,Away,Upto 2014
Mohammad Zahid,PAK,Pace,1996-11-28,Rawalpindi,Pakistan,1996,2,130,246,11,1,614,1126,22,484,880,11,27.90909090909091,<=30,PAK,Home,Upto 2014
Mohammad Zahid,PAK,Pace,1997-04-19,Colombo (RPS),Sri Lanka,1997,2,104,168,1,1,337,618,3,233,450,2,112.33333333333333,>30,SL,Away,Upto 2014
Mohammad Zahid,PAK,Pace,1997-04-26,Colombo (SSC),Sri Lanka,1997,1,44,72,1,1,378,693,12,334,621,11,31.5,>30,SL,Away,Upto 2014
Mohammad Zahid,PAK,Pace,1998-10-15,Peshawar,Pakistan,1998,2,116,156,0,1,690,1183,11,574,1027,11,62.72727272727273,>30,PAK,Home,Upto 2014
Mohammad Zahid,PAK,Pace,2003-01-02,Cape Town,South Africa,2003,1,108,150,2,1,694,1175,21,586,1025,19,33.04761904761905,>30,SA,Away,Upto 2014
Mohammed Shami,IND,Pace,2013-11-06,Eden Gardens,India,2013,2,118,181,9,1,366,583,13,248,402,4,28.153846153846153,<=30,IND,Home,Upto 2014
Mohammed Shami,IND,Pace,2013-11-14,Wankhede,India,2013,2,64,114,2,1,332,492,5,268,378,3,66.4,>30,IND,Home,Upto 2014
Mohammed Shami,IND,Pace,2013-12-18,Johannesburg,South Africa,2013,2,155,276,5,1,1012,2037,30,857,1761,25,33.733333333333334,>30,SA,Away,Upto 2014
Mohammed Shami,IND,Pace,2013-12-26,Durban,South Africa,2013,2,108,174,1,1,714,1389,18,606,1215,17,39.666666666666664,>30,SA,Away,Upto 2014
Mohammed Shami,IND,Pace,2014-02-06,Auckland,New Zealand,2014,2,132,240,4,1,873,1527,37,741,1287,33,23.594594594594593,<=30,NZ,Away,After 1965
Mohammed Shami,IND,Pace,2014-02-14,Wellington,New Zealand,2014,2,219,359,6,1,1271,2109,30,1052,1750,24,42.36666666666667,>30,NZ,Away,After 1965
Mohammed Shami,IND,Pace,2014-07-09,Nottingham,England,2014,1,128,174,2,1,984,1979,23,856,1805,21,42.78260869565217,>30,ENG,Away,After 1965
Mohammed Shami,IND,Pace,2014-07-17,Lord's,England,2014,2,91,180,2,1,890,1823,32,799,1643,30,27.8125,<=30,ENG,Away,After 1965
Mohammed Shami,IND,Pace,2014-07-27,Southampton,England,2014,2,147,222,1,1,815,1573,15,668,1351,14,54.333333333333336,>30,ENG,Away,After 1965
Mohammed Shami,IND,Pace,2014-12-09,Adelaide,Australia,2014,2,162,210,3,1,885,1420,15,723,1210,12,59.0,>30,AUS,Away,After 1965
Mohammed Shami,IND,Pace,2014-12-26,Melbourne,Australia,2014,2,230,342,6,1,1069,1880,27,839,1538,21,39.592592592592595,>30,AUS,Away,After 1965
Mohammed Shami,IND,Pace,2015-01-06,Sydney,Australia,2015,2,145,207,6,1,942,1653,21,797,1446,15,44.857142857142854,>30,AUS,Away,After 1965
Mohammed Shami,IND,Pace,2016-07-21,North Sound,West Indies,2016,2,92,180,4,1,466,972,12,374,792,8,38.833333333333336,>30,WI,Away,After 1965
Mohammed Shami,IND,Pace,2016-07-30,Kingston,West Indies,2016,2,105,174,4,1,509,984,9,404,810,5,56.55555555555556,>30,WI,Away,After 1965
Mohammed Shami,IND,Pace,2016-08-09,Gros Islet,West Indies,2016,2,73,168,3,1,570,1190,26,497,1022,23,21.923076923076923,<=30,WI,Away,After 1965
Mohammed Shami,IND,Pace,2016-08-18,Port of Spain,West Indies,2016,1,14,36,0,1,34,102,1,20,66,1,34.0,>30,WI,Away,After 1965
Mohammed Shami,IND,Pace,2016-09-22,Kanpur,India,2016,2,53,114,2,1,304,612,8,251,498,6,38.0,>30,IND,Home,After 1965
Mohammed Shami,IND,Pace,2016-09-30,Eden Gardens,India,2016,2,116,217,6,1,483,1061,26,367,844,20,18.576923076923077,<=30,IND,Home,After 1965
Mohammed Shami,IND,Pace,2016-10-08,Indore,India,2016,2,74,120,0,1,519,876,3,445,756,3,173.0,>30,IND,Home,After 1965
Mohammed Shami,IND,Pace,2016-11-09,Rajkot,India,2016,2,94,235,2,1,455,1020,7,361,785,5,65.0,>30,IND,Home,After 1965
Mohammed Shami,IND,Pace,2016-11-17,Visakhapatnam,India,2016,2,58,168,3,1,406,876,14,348,708,11,29.0,<=30,IND,Home,After 1965
Mohammed Shami,IND,Pace,2016-11-26,Mohali,India,2016,2,100,215,5,1,431,841,13,331,626,8,33.15384615384615,>30,IND,Home,After 1965
Mohammed Shami,IND,Pace,2017-07-26,Galle,Sri Lanka,2017,2,88,126,3,1,627,805,16,539,679,13,39.1875,>30,SL,Away,After 1965
Mohammed Shami,IND,Pace,2017-08-03,Colombo (SSC),Sri Lanka,2017,2,40,108,2,1,216,460,7,176,352,5,30.857142857142858,>30,SL,Away,After 1965
Mohammed Shami,IND,Pace,2017-08-12,Pallekele,Sri Lanka,2017,2,49,131,5,1,344,606,10,295,475,5,34.4,>30,SL,Away,After 1965
Mohammed Shami,IND,Pace,2017-11-16,Eden Gardens,India,2017,2,134,216,6,1,743,1322,32,609,1106,26,23.21875,<=30,IND,Home,After 1965
Mohammed Shami,IND,Pace,2017-12-02,Delhi,India,2017,2,135,246,3,1,549,946,10,414,700,7,54.9,>30,IND,Home,After 1965
Mohammed Shami,IND,Pace,2018-01-05,Cape Town,South Africa,2018,2,75,168,4,1,684,1276,37,609,1108,33,18.486486486486488,<=30,SA,Away,After 1965
Mohammed Shami,IND,Pace,2018-01-13,Centurion,South Africa,2018,2,107,186,5,1,739,1521,29,632,1335,24,25.482758620689655,<=30,SA,Away,After 1965
Mohammed Shami,IND,Pace,2018-01-24,Johannesburg,South Africa,2018,2,74,147,6,1,749,1777,40,675,1630,34,18.725,<=30,SA,Away,After 1965
Mohammed Shami,IND,Pace,2018-08-01,Birmingham,England,2018,2,102,190,3,1,700,1284,29,598,1094,26,24.137931034482758,<=30,ENG,Away,After 1965
Mohammed Shami,IND,Pace,2018-08-09,Lord's,England,2018,1,96,138,3,1,483,867,26,387,729,23,18.576923076923077,<=30,ENG,Away,After 1965
Mohammed Shami,IND,Pace,2018-08-18,Nottingham,England,2018,2,134,174,2,1,905,1711,32,771,1537,30,28.28125,<=30,ENG,Away,After 1965
Mohammed Shami,IND,Pace,2018-08-30,Southampton,England,2018,2,108,204,6,1,624,1317,26,516,1113,20,24.0,<=30,ENG,Away,After 1965
Mohammed Shami,IND,Pace,2018-09-07,The Oval,England,2018,2,182,330,2,1,781,1629,21,599,1299,19,37.19047619047619,>30,ENG,Away,After 1965
Mohammed Shami,IND,Pace,2018-10-04,Rajkot,India,2018,2,33,72,2,1,307,492,6,274,420,4,51.166666666666664,>30,IND,Home,After 1965
Mohammed Shami,IND,Pace,2018-12-06,Adelaide,Australia,2018,2,123,220,5,1,635,1467,25,512,1247,20,25.4,<=30,AUS,Away,After 1965
Mohammed Shami,IND,Pace,2018-12-14,Perth,Australia,2018,2,136,288,6,1,753,1685,30,617,1397,24,25.1,<=30,AUS,Away,After 1965
Mohammed Shami,IND,Pace,2018-12-26,Melbourne,Australia,2018,2,98,186,3,1,621,1425,29,523,1239,26,21.413793103448278,<=30,AUS,Away,After 1965
Mohammed Shami,IND,Pace,2019-01-03,Sydney,Australia,2019,2,62,126,2,1,459,804,6,397,678,4,76.5,>30,AUS,Away,After 1965
Mohammed Shami,IND,Pace,2019-08-22,North Sound,West Indies,2019,2,61,132,4,1,576,1302,29,515,1170,25,19.862068965517242,<=30,WI,Away,After 1965
Mohammed Shami,IND,Pace,2019-08-30,Kingston,West Indies,2019,2,99,174,5,1,512,1121,25,413,947,20,20.48,<=30,WI,Away,After 1965
Mohammed Shami,IND,Pace,2019-10-02,Visakhapatnam,India,2019,2,82,173,5,1,350,737,9,268,564,4,38.888888888888886,>30,IND,Home,After 1965
Mohammed Shami,IND,Pace,2019-10-10,Pune,India,2019,2,78,156,3,1,453,864,13,375,708,10,34.84615384615385,>30,IND,Home,After 1965
Mohammed Shami,IND,Pace,2019-10-19,Ranchi,India,2019,2,32,120,5,1,354,633,14,322,513,9,25.285714285714285,<=30,IND,Home,After 1965
Mohammed Shami,IND,Pace,2019-11-14,Indore,India,2019,2,58,174,7,1,430,819,19,372,645,12,22.63157894736842,<=30,IND,Home,After 1965
Mohammed Shami,IND,Pace,2019-11-22,Eden Gardens,India,2019,2,78,111,2,1,491,776,27,413,665,25,18.185185185185187,<=30,IND,Home,After 1965
Mohammed Shami,IND,Pace,2020-02-21,Wellington,New Zealand,2020,1,91,138,1,1,586,1297,26,495,1159,25,22.53846153846154,<=30,NZ,Away,After 1965
Mohammed Shami,IND,Pace,2020-02-29,Christchurch,New Zealand,2020,2,92,157,4,1,623,1219,30,531,1062,26,20.766666666666666,<=30,NZ,Away,After 1965
Mohammed Shami,IND,Pace,2020-12-17,Adelaide,Australia,2020,1,41,102,0,1,408,970,22,367,868,22,18.545454545454547,<=30,AUS,Away,After 1965
Mohammed Shami,IND,Pace,2021-06-18,Southampton,England,2021,2,107,221,4,1,643,1620,27,536,1399,23,23.814814814814813,<=30,ENG,Away,After 1965
Mohammed Shami,IND,Pace,2021-08-04,Nottingham,England,2021,2,100,197,4,1,737,1406,30,637,1209,26,24.566666666666666,<=30,ENG,Away,After 1965
Mohammed Shami,IND,Pace,2021-08-12,Lord's,England,2021,2,108,216,3,1,917,2031,34,809,1815,31,26.970588235294116,<=30,ENG,Away,After 1965
Mohammed Shami,IND,Pace,2021-08-25,Leeds,England,2021,1,95,168,4,1,610,1311,27,515,1143,23,22.59259259259259,<=30,ENG,Away,After 1965
Mohammed Shami,IND,Pace,2021-12-26,Centurion,South Africa,2021,2,107,198,8,1,741,1479,38,634,1281,30,19.5,<=30,SA,Away,After 1965
Mohammed Shami,IND,Pace,2022-01-03,Johannesburg,South Africa,2022,2,107,228,3,1,818,1482,32,711,1254,29,25.5625,<=30,SA,Away,After 1965
Mohammed Shami,IND,Pace,2022-01-11,Cape Town,South Africa,2022,2,80,186,3,1,686,1515,32,606,1329,29,21.4375,<=30,SA,Away,After 1965
Mohammed Shami,IND,Pace,2022-03-04,Mohali,India,2022,2,75,120,3,1,395,599,10,320,479,7,39.5,>30,IND,Home,After 1965
Mohammed Shami,IND,Pace,2022-03-12,Bengaluru,India,2022,2,44,72,2,1,203,372,12,159,300,10,16.916666666666668,<=30,IND,Home,After 1965
Mohammed Shami,IND,Pace,2022-07-01,Birmingham,England,2022,2,142,222,2,1,1049,1525,30,907,1303,28,34.96666666666667,>30,ENG,Away,After 1965
Mohammed Shami,IND,Pace,2023-02-09,Nagpur,India,2023,2,31,81,3,1,173,354,6,142,273,3,28.833333333333332,<=30,IND,Home,After 1965
Mohammed Shami,IND,Pace,2023-02-17,Delhi,India,2023,2,70,100,4,1,141,238,5,71,138,1,28.2,<=30,IND,Home,After 1965
Mohammed Shami,IND,Pace,2023-03-09,Ahmedabad,India,2023,2,153,234,2,1,466,654,3,313,420,1,155.33333333333334,>30,IND,Home,After 1965
Mohammed Shami,IND,Pace,2023-06-07,The Oval,England,2023,2,161,273,4,1,1032,1672,28,871,1399,24,36.857142857142854,>30,ENG,Away,After 1965
Mohammed Siraj,IND,Pace,2020-12-26,Melbourne,Australia,2020,2,77,219,5,1,523,1170,20,446,951,15,26.15,<=30,AUS,Away,After 1965
Mohammed Siraj,IND,Pace,2021-01-07,Sydney,Australia,2021,2,157,300,2,1,762,1640,19,605,1340,17,40.10526315789474,>30,AUS,Away,After 1965
Mohammed Siraj,IND,Pace,2021-01-15,Brisbane,Australia,2021,2,150,287,6,1,950,1738,30,800,1451,24,31.666666666666668,>30,AUS,Away,After 1965
Mohammed Siraj,IND,Pace,2021-02-13,Chennai,India,2021,2,11,48,1,1,192,382,7,181,334,6,27.428571428571427,<=30,IND,Home,After 1965
Mohammed Siraj,IND,Pace,2021-03-04,Ahmedabad,India,2021,2,57,108,2,1,213,478,9,156,370,7,23.666666666666668,<=30,IND,Home,After 1965
Mohammed Siraj,IND,Pace,2021-08-04,Nottingham,England,2021,2,132,222,3,1,737,1406,30,605,1184,27,24.566666666666666,<=30,ENG,Away,After 1965
Mohammed Siraj,IND,Pace,2021-08-12,Lord's,England,2021,2,126,245,8,1,917,2031,34,791,1786,26,26.970588235294116,<=30,ENG,Away,After 1965
Mohammed Siraj,IND,Pace,2021-08-25,Leeds,England,2021,1,86,138,2,1,610,1311,27,524,1173,25,22.59259259259259,<=30,ENG,Away,After 1965
Mohammed Siraj,IND,Pace,2021-09-02,The Oval,England,2021,2,86,156,1,1,900,1837,30,814,1681,29,30.0,<=30,ENG,Away,After 1965
Mohammed Siraj,IND,Pace,2021-12-03,Wankhede,India,2021,2,32,54,3,1,192,474,3,160,420,0,64.0,>30,IND,Home,After 1965
Mohammed Siraj,IND,Pace,2021-12-26,Centurion,South Africa,2021,2,92,199,3,1,741,1479,38,649,1280,35,19.5,<=30,SA,Away,After 1965
Mohammed Siraj,IND,Pace,2022-01-03,Johannesburg,South Africa,2022,2,61,95,0,1,818,1482,32,757,1387,32,25.5625,<=30,SA,Away,After 1965
Mohammed Siraj,IND,Pace,2022-07-01,Birmingham,England,2022,2,164,159,4,1,1049,1525,30,885,1366,26,34.96666666666667,>30,ENG,Away,After 1965
Mohammed Siraj,IND,Pace,2022-12-14,Chattogram,Bangladesh,2022,2,87,192,4,1,311,654,9,224,462,5,34.55555555555556,>30,BAN,Away,After 1965
Mohammed Siraj,IND,Pace,2022-12-22,Mirpur,Bangladesh,2022,2,80,120,2,1,319,582,11,239,462,9,29.0,<=30,BAN,Away,After 1965
Mohammed Siraj,IND,Pace,2023-02-09,Nagpur,India,2023,2,30,48,1,1,173,354,6,143,306,5,28.833333333333332,<=30,IND,Home,After 1965
Mohammed Siraj,IND,Pace,2023-02-17,Delhi,India,2023,1,30,60,0,1,141,238,5,111,178,5,28.2,<=30,IND,Home,After 1965
Mohammed Siraj,IND,Pace,2023-03-01,Indore,India,2023,1,13,36,0,1,84,162,4,71,126,4,21.0,<=30,IND,Home,After 1965
Mohammed Siraj,IND,Pace,2023-06-07,The Oval,England,2023,2,188,291,5,1,1032,1672,28,844,1381,23,36.857142857142854,>30,ENG,Away,After 1965
Mohammed Siraj,IND,Pace,2023-07-12,Roseau,West Indies,2023,2,41,108,2,1,260,590,5,219,482,3,52.0,>30,WI,Away,After 1965
Mohammed Siraj,IND,Pace,2023-07-20,Port of Spain,West Indies,2023,2,84,190,5,1,656,1048,14,572,858,9,46.857142857142854,>30,WI,Away,After 1965
Mohammed Siraj,IND,Pace,2023-12-26,Centurion,South Africa,2023,1,91,144,2,1,718,1149,27,627,1005,25,26.59259259259259,<=30,SA,Away,After 1965
Mohammed Siraj,IND,Pace,2024-01-03,Cape Town,South Africa,2024,2,46,108,7,1,441,642,32,395,534,25,13.78125,<=30,SA,Away,After 1965
Mohammed Siraj,IND,Pace,2024-01-25,Hyderabad,India,2024,2,50,66,0,1,181,364,6,131,298,6,30.166666666666668,>30,IND,Home,After 1965
Mohammed Siraj,IND,Pace,2024-02-15,Rajkot,India,2024,2,100,157,4,1,471,750,11,371,593,7,42.81818181818182,>30,IND,Home,After 1965
Mohammed Siraj,IND,Pace,2024-02-23,Ranchi,India,2024,2,94,126,2,1,291,444,7,197,318,5,41.57142857142857,>30,IND,Home,After 1965
Mohammed Siraj,IND,Pace,2024-03-07,Dharamsala,India,2024,2,32,54,0,1,287,408,5,255,354,5,57.4,>30,IND,Home,After 1965
Mohammed Siraj,IND,Pace,2024-09-19,Chennai,India,2024,2,62,121,2,1,481,825,20,419,704,18,24.05,<=30,IND,Home,After 1965
Mohammed Siraj,IND,Pace,2024-09-27,Kanpur,India,2024,2,76,126,2,1,315,492,12,239,366,10,26.25,<=30,IND,Home,After 1965
Mohammed Siraj,IND,Pace,2024-10-16,Bengaluru,India,2024,2,100,150,2,1,462,863,22,362,713,20,21.0,<=30,IND,Home,After 1965
Mohammed Siraj,IND,Pace,2024-11-01,Wankhede,India,2024,1,16,36,0,1,89,174,4,73,138,4,22.25,<=30,IND,Home,After 1965
Mohammed Siraj,IND,Pace,2024-11-22,Perth,Australia,2024,2,71,162,5,1,555,1114,27,484,952,22,20.555555555555557,<=30,AUS,Away,After 1965
Mohammed Siraj,IND,Pace,2024-12-06,Adelaide,Australia,2024,2,107,155,4,1,507,779,28,400,624,24,18.107142857142858,<=30,AUS,Away,After 1965
Mohammed Siraj,IND,Pace,2024-12-14,Brisbane,Australia,2024,2,133,182,4,1,550,932,24,417,750,20,22.916666666666668,<=30,AUS,Away,After 1965
Mohammed Siraj,IND,Pace,2024-12-26,Melbourne,Australia,2024,2,192,276,3,1,849,1700,27,657,1424,24,31.444444444444443,>30,AUS,Away,After 1965
Mohammed Siraj,IND,Pace,2025-01-03,Sydney,Australia,2025,2,120,168,4,1,502,925,30,382,757,26,16.733333333333334,<=30,AUS,Away,After 1965
Mohsin Kamal,PAK,Pace,1984-03-19,Lahore,Pakistan,1984,2,125,192,2,1,528,1035,19,403,843,17,27.789473684210527,<=30,PAK,Home,Upto 2014
Mohsin Kamal,PAK,Pace,1985-10-27,Sialkot,Pakistan,1985,2,88,174,4,1,662,1204,31,574,1030,27,21.35483870967742,<=30,PAK,Home,Upto 2014
Mohsin Kamal,PAK,Pace,1986-03-14,Colombo (CCC),Sri Lanka,1986,1,52,90,2,1,530,1137,31,478,1047,29,17.096774193548388,<=30,SL,Away,Upto 2014
Mohsin Kamal,PAK,Pace,1987-06-04,Manchester,England,1987,1,127,234,4,1,470,978,11,343,744,7,42.72727272727273,>30,ENG,Away,Upto 2014
Mohsin Kamal,PAK,Pace,1987-06-18,Lord's,England,1987,1,42,54,1,1,256,527,7,214,473,6,36.57142857142857,>30,ENG,Away,Upto 2014
Mohsin Kamal,PAK,Pace,1987-07-02,Leeds,England,1987,2,41,106,4,1,511,1279,29,470,1173,25,17.620689655172413,<=30,ENG,Away,Upto 2014
Mohsin Kamal,PAK,Pace,1987-07-23,Birmingham,England,1987,1,122,174,0,1,1037,2130,29,915,1956,29,35.758620689655174,>30,ENG,Away,Upto 2014
Mohsin Kamal,PAK,Pace,1994-10-05,Rawalpindi,Pakistan,1994,1,109,156,3,1,838,1506,23,729,1350,20,36.43478260869565,>30,PAK,Home,Upto 2014
Mohsin Kamal,PAK,Pace,1994-11-01,Lahore,Pakistan,1994,1,116,168,4,1,516,907,10,400,739,6,51.6,>30,PAK,Home,Upto 2014
Mohsin Khan,PAK,Pace,1978-01-18,Karachi,Pakistan,1978,1,3,8,0,1,226,792,5,223,784,5,45.2,>30,PAK,Home,Upto 2014
Mohsin Khan,PAK,Pace,1983-01-30,Karachi,Pakistan,1983,1,3,6,0,1,655,1382,13,652,1376,13,50.38461538461539,>30,PAK,Home,Upto 2014
Mohsin Khan,PAK,Pace,1983-09-24,Jalandhar,India,1983,1,9,30,0,1,450,936,11,441,906,11,40.90909090909091,>30,IND,Away,Upto 2014
Mohsin Khan,PAK,Pace,1983-10-05,Nagpur,India,1983,1,7,18,0,1,439,897,10,432,879,10,43.9,>30,IND,Away,Upto 2014
Mohsin Khan,PAK,Pace,1983-12-09,Adelaide,Australia,1983,2,8,24,0,1,947,1786,20,939,1762,20,47.35,>30,AUS,Away,Upto 2014
Mominul Haque,BAN,Spin,2013-03-08,Galle,Sri Lanka,2013,2,42,42,0,1,1160,1920,13,1118,1878,13,89.23076923076923,>30,SL,Away,Upto 2014
Mominul Haque,BAN,Spin,2013-03-16,Colombo (RPS),Sri Lanka,2013,1,6,12,0,1,481,1042,18,475,1030,18,26.72222222222222,<=30,SL,Away,Upto 2014
Mominul Haque,BAN,Spin,2013-10-09,Chattogram,Bangladesh,2013,2,20,61,1,1,1057,1946,22,1037,1885,21,48.04545454545455,>30,BAN,Home,Upto 2014
Mominul Haque,BAN,Spin,2013-10-21,Mirpur,Bangladesh,2013,1,7,18,0,1,460,965,12,453,947,12,38.333333333333336,>30,BAN,Home,Upto 2014
Mominul Haque,BAN,Spin,2014-01-27,Mirpur,Bangladesh,2014,1,20,36,0,1,658,946,13,638,910,13,50.61538461538461,>30,BAN,Home,After 1965
Mominul Haque,BAN,Spin,2014-02-04,Chattogram,Bangladesh,2014,2,54,66,0,1,1153,1976,25,1099,1910,25,46.12,>30,BAN,Home,After 1965
Mominul Haque,BAN,Spin,2014-09-05,Kingstown,West Indies,2014,1,1,6,0,1,510,1180,16,509,1174,16,31.875,>30,WI,Away,After 1965
Mominul Haque,BAN,Spin,2014-09-13,Gros Islet,West Indies,2014,1,17,24,0,1,411,807,13,394,783,13,31.615384615384617,>30,WI,Away,After 1965
Mominul Haque,BAN,Spin,2014-11-03,Khulna,Bangladesh,2014,1,0,6,0,1,829,1764,29,829,1758,29,28.586206896551722,<=30,BAN,Home,After 1965
Mominul Haque,BAN,Spin,2015-04-28,Khulna,Bangladesh,2015,1,13,30,0,1,1092,1798,20,1079,1768,20,54.6,>30,BAN,Home,After 1965
Mominul Haque,BAN,Spin,2015-05-06,Mirpur,Bangladesh,2015,1,12,18,0,1,692,1014,18,680,996,18,38.44444444444444,>30,BAN,Home,After 1965
Mominul Haque,BAN,Spin,2016-10-20,Chattogram,Bangladesh,2016,1,0,6,0,1,760,1579,30,760,1573,30,25.333333333333332,<=30,BAN,Home,After 1965
Mominul Haque,BAN,Spin,2017-09-04,Chattogram,Bangladesh,2017,1,6,12,0,1,709,1537,24,703,1525,24,29.541666666666668,<=30,BAN,Home,After 1965
Mominul Haque,BAN,Spin,2017-09-28,Potchefstroom,South Africa,2017,2,42,48,3,1,504,803,10,462,755,7,50.4,>30,SA,Away,After 1965
Mominul Haque,BAN,Spin,2017-10-06,Bloemfontein,South Africa,2017,1,6,6,0,1,239,300,1,233,294,1,239.0,>30,SA,Away,After 1965
Mominul Haque,BAN,Spin,2018-01-31,Chattogram,Bangladesh,2018,1,6,12,0,1,1210,2061,19,1204,2049,19,63.68421052631579,>30,BAN,Home,After 1965
Mominul Haque,BAN,Spin,2018-07-04,North Sound,West Indies,2018,1,8,12,0,1,218,480,6,210,468,6,36.333333333333336,>30,WI,Away,After 1965
Mominul Haque,BAN,Spin,2018-11-03,Sylhet,Bangladesh,2018,1,4,6,0,1,549,1328,32,545,1322,32,17.15625,<=30,BAN,Home,After 1965
Mominul Haque,BAN,Spin,2018-11-11,Mirpur,Bangladesh,2018,1,17,12,0,1,819,1414,17,802,1402,17,48.1764705882353,>30,BAN,Home,After 1965
Mominul Haque,BAN,Spin,2019-02-28,Hamilton,New Zealand,2019,1,32,30,0,1,362,462,3,330,432,3,120.66666666666667,>30,NZ,Away,After 1965
Mominul Haque,BAN,Spin,2019-03-08,Wellington,New Zealand,2019,1,41,54,0,1,140,180,2,99,126,2,70.0,>30,NZ,Away,After 1965
Mominul Haque,BAN,Spin,2019-09-05,Chattogram,Bangladesh,2019,2,22,84,0,1,903,1930,38,881,1846,38,23.763157894736842,<=30,BAN,Home,After 1965
Mominul Haque,BAN,Spin,2021-04-21,Pallekele,Sri Lanka,2021,1,18,24,0,1,649,1170,4,631,1146,4,162.25,>30,SL,Away,After 1965
Mominul Haque,BAN,Spin,2021-07-07,Harare,Zimbabwe,2021,1,3,6,0,1,544,1099,15,541,1093,15,36.266666666666666,>30,ZIM,Away,After 1965
Mominul Haque,BAN,Spin,2021-11-26,Chattogram,Bangladesh,2021,1,12,18,0,1,541,1197,14,529,1179,14,38.642857142857146,>30,BAN,Home,After 1965
Mominul Haque,BAN,Spin,2022-01-01,Mount Maunganui,New Zealand,2022,2,13,49,2,1,219,557,6,206,508,4,36.5,>30,NZ,Away,After 1965
Mominul Haque,BAN,Spin,2022-01-09,Christchurch,New Zealand,2022,1,34,18,1,1,174,231,2,140,213,1,87.0,>30,NZ,Away,After 1965
Mominul Haque,BAN,Spin,2022-03-31,Durban,South Africa,2022,2,17,30,0,1,428,1068,20,411,1038,20,21.4,<=30,SA,Away,After 1965
Mominul Haque,BAN,Spin,2022-05-23,Mirpur,Bangladesh,2022,1,7,18,0,1,553,1141,6,546,1123,6,92.16666666666667,>30,BAN,Home,After 1965
Mominul Haque,BAN,Spin,2023-04-04,Mirpur,Bangladesh,2023,1,2,6,0,1,595,1200,23,593,1194,23,25.869565217391305,<=30,BAN,Home,After 1965
Mominul Haque,BAN,Spin,2023-11-28,Sylhet,Bangladesh,2023,2,9,35,3,1,883,1678,32,874,1643,29,27.59375,<=30,BAN,Home,After 1965
Mominul Haque,BAN,Spin,2023-12-06,Mirpur,Bangladesh,2023,2,21,18,0,1,542,923,30,521,905,30,18.066666666666666,<=30,BAN,Home,After 1965
Mominul Haque,BAN,Spin,2024-03-22,Sylhet,Bangladesh,2024,1,0,6,0,1,284,550,7,284,544,7,40.57142857142857,>30,BAN,Home,After 1965
Mominul Haque,BAN,Spin,2024-09-19,Chennai,India,2024,2,19,18,0,1,522,763,14,503,745,14,37.285714285714285,>30,IND,Away,After 1965
Mominul Haque,BAN,Spin,2024-10-21,Mirpur,Bangladesh,2024,1,16,12,0,1,586,1001,17,570,989,17,34.470588235294116,>30,BAN,Home,After 1965
Mominul Haque,BAN,Spin,2024-10-29,Chattogram,Bangladesh,2024,1,15,24,0,1,583,920,17,568,896,17,34.294117647058826,>30,BAN,Home,After 1965
Mosaddek Hossain,BAN,Spin,2017-03-15,Colombo (PSS),Sri Lanka,2017,2,21,42,0,1,916,1838,26,895,1796,26,35.23076923076923,>30,SL,Away,After 1965
Mosaddek Hossain,BAN,Spin,2018-01-31,Chattogram,Bangladesh,2018,1,24,18,0,1,1210,2061,19,1186,2043,19,63.68421052631579,>30,BAN,Home,After 1965
Mosaddek Hossain,BAN,Spin,2019-09-05,Chattogram,Bangladesh,2019,2,4,30,0,1,903,1930,38,899,1900,38,23.763157894736842,<=30,BAN,Home,After 1965
Mosaddek Hossain,BAN,Spin,2022-05-23,Mirpur,Bangladesh,2022,1,38,72,0,1,553,1141,6,515,1069,6,92.16666666666667,>30,BAN,Home,After 1965
Mudassar Nazar,PAK,Pace,1978-01-18,Karachi,Pakistan,1978,1,1,8,0,1,226,792,5,225,784,5,45.2,>30,PAK,Home,Upto 2014
Mudassar Nazar,PAK,Pace,1978-06-01,Birmingham,England,1978,1,59,162,1,1,618,1454,19,559,1292,18,32.526315789473685,>30,ENG,Away,Upto 2014
Mudassar Nazar,PAK,Pace,1978-06-15,Lord's,England,1978,1,16,26,1,1,397,739,22,381,713,21,18.045454545454547,<=30,ENG,Away,Upto 2014
Mudassar Nazar,PAK,Pace,1978-06-29,Leeds,England,1978,1,12,30,0,1,225,754,16,213,724,16,14.0625,<=30,ENG,Away,Upto 2014
Mudassar Nazar,PAK,Pace,1978-10-27,Lahore,Pakistan,1978,2,9,42,3,1,667,1298,21,658,1256,18,31.761904761904763,>30,PAK,Home,Upto 2014
Mudassar Nazar,PAK,Pace,1978-11-14,Karachi,Pakistan,1978,2,18,36,0,1,801,1525,25,783,1489,25,32.04,>30,PAK,Home,Upto 2014
Mudassar Nazar,PAK,Pace,1979-02-02,Christchurch,New Zealand,1979,1,16,32,0,1,652,1680,19,636,1648,19,34.31578947368421,>30,NZ,Away,Upto 2014
Mudassar Nazar,PAK,Pace,1979-03-24,W.A.C.A,Australia,1979,2,83,209,3,1,924,2172,25,841,1963,22,36.96,>30,AUS,Away,Upto 2014
Mudassar Nazar,PAK,Pace,1979-11-21,Bengaluru,India,1979,1,14,36,0,1,355,754,9,341,718,9,39.44444444444444,>30,IND,Away,Upto 2014
Mudassar Nazar,PAK,Pace,1979-12-04,Delhi,India,1979,2,69,168,1,1,647,1401,30,578,1233,29,21.566666666666666,<=30,IND,Away,Upto 2014
Mudassar Nazar,PAK,Pace,1979-12-16,Wankhede,India,1979,2,25,78,1,1,330,772,18,305,694,17,18.333333333333332,<=30,IND,Away,Upto 2014
Mudassar Nazar,PAK,Pace,1979-12-25,Kanpur,India,1979,2,41,78,0,1,450,1133,20,409,1055,20,22.5,<=30,IND,Away,Upto 2014
Mudassar Nazar,PAK,Pace,1980-01-15,Chennai,India,1980,2,56,108,1,1,708,1186,22,652,1078,21,32.18181818181818,>30,IND,Away,Upto 2014
Mudassar Nazar,PAK,Pace,1980-02-27,Karachi,Pakistan,1980,2,10,24,0,1,240,648,5,230,624,5,48.0,>30,PAK,Home,Upto 2014
Mudassar Nazar,PAK,Pace,1980-03-18,Lahore,Pakistan,1980,2,36,48,0,1,489,1014,8,453,966,8,61.125,>30,PAK,Home,Upto 2014
Mudassar Nazar,PAK,Pace,1981-11-13,W.A.C.A,Australia,1981,1,1,12,0,1,628,1440,27,627,1428,27,23.25925925925926,<=30,AUS,Away,Upto 2014
Mudassar Nazar,PAK,Pace,1981-11-27,Brisbane,Australia,1981,1,10,12,0,1,651,1292,22,641,1280,22,29.59090909090909,<=30,AUS,Away,Upto 2014
Mudassar Nazar,PAK,Pace,1982-03-22,Lahore,Pakistan,1982,1,23,48,0,1,456,794,20,433,746,20,22.8,<=30,PAK,Home,Upto 2014
Mudassar Nazar,PAK,Pace,1982-07-29,Birmingham,England,1982,1,8,30,0,1,641,1313,30,633,1283,30,21.366666666666667,<=30,ENG,Away,Upto 2014
Mudassar Nazar,PAK,Pace,1982-08-12,Lord's,England,1982,2,38,138,6,1,700,1644,21,662,1506,15,33.333333333333336,>30,ENG,Away,Upto 2014
Mudassar Nazar,PAK,Pace,1982-08-26,Leeds,England,1982,2,58,156,4,1,717,1887,34,659,1731,30,21.08823529411765,<=30,ENG,Away,Upto 2014
Mudassar Nazar,PAK,Pace,1982-09-22,Karachi,Pakistan,1982,1,33,78,0,1,384,853,11,351,775,11,34.90909090909091,>30,PAK,Home,Upto 2014
Mudassar Nazar,PAK,Pace,1982-09-30,Faisalabad,Pakistan,1982,2,34,96,1,1,292,720,7,258,624,6,41.714285714285715,>30,PAK,Home,Upto 2014
Mudassar Nazar,PAK,Pace,1982-10-14,Lahore,Pakistan,1982,2,22,48,0,1,661,1346,22,639,1298,22,30.045454545454547,>30,PAK,Home,Upto 2014
Mudassar Nazar,PAK,Pace,1982-12-10,Lahore,Pakistan,1982,1,10,18,0,1,700,1379,14,690,1361,14,50.0,>30,PAK,Home,Upto 2014
Mudassar Nazar,PAK,Pace,1983-01-03,Faisalabad,Pakistan,1983,2,66,138,2,1,934,1450,28,868,1312,26,33.357142857142854,>30,PAK,Home,Upto 2014
Mudassar Nazar,PAK,Pace,1983-01-23,Lahore,Pakistan,1983,1,41,66,0,1,359,745,10,318,679,10,35.9,>30,PAK,Home,Upto 2014
Mudassar Nazar,PAK,Pace,1983-01-30,Karachi,Pakistan,1983,1,30,90,1,1,655,1382,13,625,1292,12,50.38461538461539,>30,PAK,Home,Upto 2014
Mudassar Nazar,PAK,Pace,1983-09-14,Bengaluru,India,1983,2,63,151,3,1,497,1170,18,434,1019,15,27.61111111111111,<=30,IND,Away,Upto 2014
Mudassar Nazar,PAK,Pace,1983-09-24,Jalandhar,India,1983,1,80,168,0,1,450,936,11,370,768,11,40.90909090909091,>30,IND,Away,Upto 2014
Mudassar Nazar,PAK,Pace,1983-10-05,Nagpur,India,1983,1,43,84,1,1,439,897,10,396,813,9,43.9,>30,IND,Away,Upto 2014
Mudassar Nazar,PAK,Pace,1983-11-11,W.A.C.A,Australia,1983,1,39,90,0,1,628,1218,24,589,1128,24,26.166666666666668,<=30,AUS,Away,Upto 2014
Mudassar Nazar,PAK,Pace,1983-11-25,Brisbane,Australia,1983,1,47,96,0,1,428,757,16,381,661,16,26.75,<=30,AUS,Away,Upto 2014
Mudassar Nazar,PAK,Pace,1983-12-09,Adelaide,Australia,1983,1,45,60,0,1,947,1786,20,902,1726,20,47.35,>30,AUS,Away,Upto 2014
Mudassar Nazar,PAK,Pace,1983-12-26,Melbourne,Australia,1983,1,76,120,0,1,818,1728,17,742,1608,17,48.11764705882353,>30,AUS,Away,Upto 2014
Mudassar Nazar,PAK,Pace,1984-01-02,Sydney,Australia,1984,1,81,186,3,1,768,1631,25,687,1445,22,30.72,>30,AUS,Away,Upto 2014
Mudassar Nazar,PAK,Pace,1984-03-12,Faisalabad,Pakistan,1984,1,39,78,1,1,538,960,13,499,882,12,41.38461538461539,>30,PAK,Home,Upto 2014
Mudassar Nazar,PAK,Pace,1984-10-17,Lahore,Pakistan,1984,2,66,183,2,1,564,1248,16,498,1065,14,35.25,>30,PAK,Home,Upto 2014
Mudassar Nazar,PAK,Pace,1984-10-24,Faisalabad,Pakistan,1984,1,74,150,1,1,679,1180,8,605,1030,7,84.875,>30,PAK,Home,Upto 2014
Mudassar Nazar,PAK,Pace,1984-11-16,Lahore,Pakistan,1984,2,38,126,3,1,340,861,14,302,735,11,24.285714285714285,<=30,PAK,Home,Upto 2014
Mudassar Nazar,PAK,Pace,1984-11-25,Hyderabad (Sind),Pakistan,1984,2,22,72,2,1,178,432,6,156,360,4,29.666666666666668,<=30,PAK,Home,Upto 2014
Mudassar Nazar,PAK,Pace,1984-12-10,Karachi,Pakistan,1984,1,45,94,0,1,473,890,12,428,796,12,39.416666666666664,>30,PAK,Home,Upto 2014
Mudassar Nazar,PAK,Pace,1985-01-18,Wellington,New Zealand,1985,2,93,210,2,1,458,1096,12,365,886,10,38.166666666666664,>30,NZ,Away,Upto 2014
Mudassar Nazar,PAK,Pace,1985-01-25,Auckland,New Zealand,1985,1,85,204,2,1,673,1429,25,588,1225,23,26.92,<=30,NZ,Away,Upto 2014
Mudassar Nazar,PAK,Pace,1985-02-09,Dunedin,New Zealand,1985,1,20,54,0,1,862,2018,34,842,1964,34,25.352941176470587,<=30,NZ,Away,Upto 2014
Mudassar Nazar,PAK,Pace,1985-10-16,Faisalabad,Pakistan,1985,1,29,81,1,1,718,1505,9,689,1424,8,79.77777777777777,>30,PAK,Home,Upto 2014
Mudassar Nazar,PAK,Pace,1985-10-27,Sialkot,Pakistan,1985,2,34,107,3,1,662,1204,31,628,1097,28,21.35483870967742,<=30,PAK,Home,Upto 2014
Mudassar Nazar,PAK,Pace,1985-11-07,Karachi,Pakistan,1985,1,6,18,0,1,402,787,17,396,769,17,23.647058823529413,<=30,PAK,Home,Upto 2014
Mudassar Nazar,PAK,Pace,1986-03-14,Colombo (CCC),Sri Lanka,1986,1,36,84,1,1,530,1137,31,494,1053,30,17.096774193548388,<=30,SL,Away,Upto 2014
Mudassar Nazar,PAK,Pace,1986-03-22,Colombo (PSS),Sri Lanka,1986,2,48,102,0,1,728,1538,20,680,1436,20,36.4,>30,SL,Away,Upto 2014
Mudassar Nazar,PAK,Pace,1986-11-20,Karachi,Pakistan,1986,1,15,24,1,1,343,1168,21,328,1144,20,16.333333333333332,<=30,PAK,Home,Upto 2014
Mudassar Nazar,PAK,Pace,1987-06-04,Manchester,England,1987,1,133,222,0,1,470,978,11,337,756,11,42.72727272727273,>30,ENG,Away,Upto 2014
Mudassar Nazar,PAK,Pace,1987-06-18,Lord's,England,1987,1,26,96,2,1,256,527,7,230,431,5,36.57142857142857,>30,ENG,Away,Upto 2014
Mudassar Nazar,PAK,Pace,1987-07-02,Leeds,England,1987,2,26,96,1,1,511,1279,29,485,1183,28,17.620689655172413,<=30,ENG,Away,Upto 2014
Mudassar Nazar,PAK,Pace,1987-07-23,Birmingham,England,1987,1,97,210,0,1,1037,2130,29,940,1920,29,35.758620689655174,>30,ENG,Away,Upto 2014
Mudassar Nazar,PAK,Pace,1987-08-06,The Oval,England,1987,1,21,36,0,1,607,1188,10,586,1152,10,60.7,>30,ENG,Away,Upto 2014
Mudassar Nazar,PAK,Pace,1987-11-25,Lahore,Pakistan,1987,2,13,36,0,1,221,462,3,208,426,3,73.66666666666667,>30,PAK,Home,Upto 2014
Mudassar Nazar,PAK,Pace,1987-12-07,Faisalabad,Pakistan,1987,2,41,90,1,1,157,324,5,116,234,4,31.4,>30,PAK,Home,Upto 2014
Mudassar Nazar,PAK,Pace,1987-12-16,Karachi,Pakistan,1987,2,2,30,1,1,422,869,15,420,839,14,28.133333333333333,<=30,PAK,Home,Upto 2014
Mudassar Nazar,PAK,Pace,1988-04-02,Georgetown,West Indies,1988,1,9,30,0,1,579,1055,22,570,1025,22,26.318181818181817,<=30,WI,Away,Upto 2014
Mudassar Nazar,PAK,Pace,1988-04-14,Port of Spain,West Indies,1988,1,3,6,0,1,692,1635,27,689,1629,27,25.62962962962963,<=30,WI,Away,Upto 2014
Mudassar Nazar,PAK,Pace,1988-04-22,Bridgetown,West Indies,1988,1,24,60,2,1,833,1467,30,809,1407,28,27.766666666666666,<=30,WI,Away,Upto 2014
Mudassar Nazar,PAK,Pace,1988-09-15,Karachi,Pakistan,1988,2,20,78,1,1,264,678,7,244,600,6,37.714285714285715,>30,PAK,Home,Upto 2014
Mudassar Nazar,PAK,Pace,1988-09-23,Faisalabad,Pakistan,1988,2,44,114,2,1,528,1164,17,484,1050,15,31.058823529411764,>30,PAK,Home,Upto 2014
Mudassar Nazar,PAK,Pace,1988-10-07,Lahore,Pakistan,1988,2,31,108,1,1,344,894,11,313,786,10,31.272727272727273,>30,PAK,Home,Upto 2014
Mudassar Nazar,PAK,Pace,1989-02-10,Wellington,New Zealand,1989,1,59,132,2,1,750,1984,22,691,1852,20,34.09090909090909,>30,NZ,Away,Upto 2014
Mudassar Nazar,PAK,Pace,1989-02-24,Auckland,New Zealand,1989,2,20,66,2,1,397,1018,6,377,952,4,66.16666666666667,>30,NZ,Away,Upto 2014
Mufasir-ul-Haq,PAK,Pace,1965-02-12,Christchurch,New Zealand,1965,2,84,222,3,1,416,1052,17,332,830,14,24.470588235294116,<=30,NZ,Away,Upto 2014
Muhammad Musa,PAK,Pace,2019-11-29,Adelaide,Australia,2019,1,114,120,0,1,654,1168,17,540,1048,17,38.470588235294116,>30,AUS,Away,After 1965
Mujeeb Ur Rahman,AFG,Spin,2018-06-14,Bengaluru,India,2018,1,75,90,1,1,388,572,15,313,482,14,25.866666666666667,<=30,IND,Away,After 1965
Mukesh Kumar,IND,Pace,2023-07-20,Port of Spain,West Indies,2023,2,53,138,2,1,656,1048,14,603,910,12,46.857142857142854,>30,WI,Away,After 1965
Mukesh Kumar,IND,Pace,2024-01-03,Cape Town,South Africa,2024,2,56,74,4,1,441,642,32,385,568,28,13.78125,<=30,SA,Away,After 1965
Mukesh Kumar,IND,Pace,2024-02-02,Visakhapatnam,India,2024,2,70,72,1,1,237,481,15,167,409,14,15.8,<=30,IND,Home,After 1965
Munir Malik,PAK,Pace,1959-12-04,Karachi,Pakistan,1959,2,100,186,3,1,568,1464,19,468,1278,16,29.894736842105264,<=30,PAK,Home,Upto 2014
Munir Malik,PAK,Pace,1962-07-05,Leeds,England,1962,1,128,294,5,1,501,1157,23,373,863,18,21.782608695652176,<=30,ENG,Away,Upto 2014
Munir Malik,PAK,Pace,1962-07-26,Nottingham,England,1962,1,130,204,1,1,602,1369,18,472,1165,17,33.44444444444444,>30,ENG,Away,Upto 2014
Mushfiqur Rahman,BAN,Pace,2001-04-19,Bulawayo,Zimbabwe,2001,1,53,120,0,1,731,1458,26,678,1338,26,28.115384615384617,<=30,ZIM,Away,Upto 2014
Mushfiqur Rahman,BAN,Pace,2001-04-26,Harare,Zimbabwe,2001,2,59,102,0,1,669,1497,14,610,1395,14,47.785714285714285,>30,ZIM,Away,Upto 2014
Mushfiqur Rahman,BAN,Pace,2003-10-21,Dhaka,Bangladesh,2003,2,71,120,2,1,448,1151,23,377,1031,21,19.47826086956522,<=30,BAN,Home,Upto 2014
Mushfiqur Rahman,BAN,Pace,2003-10-29,Chattogram,Bangladesh,2003,2,91,141,2,1,551,1109,24,460,968,22,22.958333333333332,<=30,BAN,Home,Upto 2014
Mushfiqur Rahman,BAN,Pace,2004-02-19,Harare,Zimbabwe,2004,2,124,200,3,1,617,1260,23,493,1060,20,26.82608695652174,<=30,ZIM,Away,Upto 2014
Mushfiqur Rahman,BAN,Pace,2004-02-26,Bulawayo,Zimbabwe,2004,1,36,60,0,1,218,510,6,182,450,6,36.333333333333336,>30,ZIM,Away,Upto 2014
Mushfiqur Rahman,BAN,Pace,2004-05-28,Gros Islet,West Indies,2004,2,90,190,4,1,821,1459,16,731,1269,12,51.3125,>30,WI,Away,Upto 2014
Mushfiqur Rahman,BAN,Pace,2004-06-04,Kingston,West Indies,2004,1,127,198,0,1,592,1032,15,465,834,15,39.46666666666667,>30,WI,Away,Upto 2014
Mushfiqur Rahman,BAN,Pace,2004-10-26,Chattogram,Bangladesh,2004,1,68,90,0,1,237,372,3,169,282,3,79.0,>30,BAN,Home,Upto 2014
Mushfiqur Rahman,BAN,Pace,2004-12-10,Dhaka,Bangladesh,2004,1,104,144,2,1,566,884,20,462,740,18,28.3,<=30,BAN,Home,Upto 2014
Mushtaq Ahmed,PAK,Spin,1990-01-19,Adelaide,Australia,1990,2,141,288,1,1,427,941,7,286,653,6,61.0,>30,AUS,Away,Upto 2014
Mushtaq Ahmed,PAK,Spin,1990-11-15,Karachi,Pakistan,1990,2,94,198,3,1,289,648,5,195,450,2,57.8,>30,PAK,Home,Upto 2014
Mushtaq Ahmed,PAK,Spin,1990-11-23,Faisalabad,Pakistan,1990,2,6,30,0,1,109,218,2,103,188,2,54.5,>30,PAK,Home,Upto 2014
Mushtaq Ahmed,PAK,Spin,1992-06-04,Birmingham,England,1992,1,156,300,2,1,247,450,2,91,150,0,123.5,>30,ENG,Away,Upto 2014
Mushtaq Ahmed,PAK,Spin,1992-06-18,Lord's,England,1992,2,89,169,5,1,212,416,11,123,247,6,19.272727272727273,<=30,ENG,Away,Upto 2014
Mushtaq Ahmed,PAK,Spin,1992-07-02,Manchester,England,1992,1,50,60,0,1,251,294,0,201,234,0,inf,>30,ENG,Away,Upto 2014
Mushtaq Ahmed,PAK,Spin,1992-07-23,Leeds,England,1992,2,87,261,5,1,87,273,5,0,12,0,17.4,<=30,ENG,Away,Upto 2014
Mushtaq Ahmed,PAK,Spin,1992-08-06,The Oval,England,1992,2,93,282,3,1,191,493,4,98,211,1,47.75,>30,ENG,Away,Upto 2014
Mushtaq Ahmed,PAK,Spin,1993-01-02,Hamilton,New Zealand,1993,1,87,228,3,1,217,463,6,130,235,3,36.166666666666664,>30,NZ,Away,Upto 2014
Mushtaq Ahmed,PAK,Spin,1993-04-16,Port of Spain,West Indies,1993,2,66,126,1,1,204,311,8,138,185,7,25.5,<=30,WI,Away,Upto 2014
Mushtaq Ahmed,PAK,Spin,1993-12-01,Karachi,Pakistan,1993,2,113,336,3,1,291,834,6,178,498,3,48.5,>30,PAK,Home,Upto 2014
Mushtaq Ahmed,PAK,Spin,1993-12-16,Lahore,Pakistan,1993,1,13,30,0,1,31,97,0,18,67,0,inf,>30,PAK,Home,Upto 2014
Mushtaq Ahmed,PAK,Spin,1994-02-10,Auckland,New Zealand,1994,1,79,102,3,1,96,126,4,17,24,1,24.0,<=30,NZ,Away,Upto 2014
Mushtaq Ahmed,PAK,Spin,1994-08-09,Colombo (PSS),Sri Lanka,1994,2,82,120,3,1,791,1520,23,709,1400,20,34.391304347826086,>30,SL,Away,Upto 2014
Mushtaq Ahmed,PAK,Spin,1994-08-26,Kandy,Sri Lanka,1994,1,34,45,3,1,159,284,7,125,239,4,22.714285714285715,<=30,SL,Away,Upto 2014
Mushtaq Ahmed,PAK,Spin,1994-09-28,Karachi,Pakistan,1994,2,148,270,4,1,538,1117,15,390,847,11,35.86666666666667,>30,PAK,Home,Upto 2014
Mushtaq Ahmed,PAK,Spin,1994-10-05,Rawalpindi,Pakistan,1994,2,146,222,1,1,440,796,6,294,574,5,73.33333333333333,>30,PAK,Home,Upto 2014
Mushtaq Ahmed,PAK,Spin,1994-11-01,Lahore,Pakistan,1994,1,121,271,4,1,660,1368,20,539,1097,16,33.0,>30,PAK,Home,Upto 2014
Mushtaq Ahmed,PAK,Spin,1995-11-17,Hobart,Australia,1995,2,198,408,9,1,263,594,9,65,186,0,29.22222222222222,<=30,AUS,Away,Upto 2014
Mushtaq Ahmed,PAK,Spin,1995-11-30,Sydney,Australia,1995,2,186,398,9,1,467,1214,20,281,816,11,23.35,<=30,AUS,Away,Upto 2014
Mushtaq Ahmed,PAK,Spin,1995-12-08,Christchurch,New Zealand,1995,2,171,392,10,1,251,572,11,80,180,1,22.818181818181817,<=30,NZ,Away,Upto 2014
Mushtaq Ahmed,PAK,Spin,1996-07-25,Lord's,England,1996,2,149,456,6,1,309,758,8,160,302,2,38.625,>30,ENG,Away,Upto 2014
Mushtaq Ahmed,PAK,Spin,1996-08-08,Leeds,England,1996,1,142,330,3,1,168,414,4,26,84,1,42.0,>30,ENG,Away,Upto 2014
Mushtaq Ahmed,PAK,Spin,1996-08-22,The Oval,England,1996,2,156,384,8,1,418,892,11,262,508,3,38.0,>30,ENG,Away,Upto 2014
Mushtaq Ahmed,PAK,Spin,1996-11-21,Lahore,Pakistan,1996,2,143,325,10,1,322,664,17,179,339,7,18.941176470588236,<=30,PAK,Home,Upto 2014
Mushtaq Ahmed,PAK,Spin,1996-11-28,Rawalpindi,Pakistan,1996,2,139,312,8,1,194,426,8,55,114,0,24.25,<=30,PAK,Home,Upto 2014
Mushtaq Ahmed,PAK,Spin,1997-04-19,Colombo (RPS),Sri Lanka,1997,2,217,439,6,1,757,2006,23,540,1567,17,32.91304347826087,>30,SL,Away,Upto 2014
Mushtaq Ahmed,PAK,Spin,1997-04-26,Colombo (SSC),Sri Lanka,1997,2,203,390,4,1,882,1775,14,679,1385,10,63.0,>30,SL,Away,Upto 2014
Mushtaq Ahmed,PAK,Spin,1997-10-06,Rawalpindi,Pakistan,1997,1,126,353,3,1,443,1103,12,317,750,9,36.916666666666664,>30,PAK,Home,Upto 2014
Mushtaq Ahmed,PAK,Spin,1997-10-17,Sheikhupura,Pakistan,1997,1,122,228,4,1,314,555,8,192,327,4,39.25,>30,PAK,Home,Upto 2014
Mushtaq Ahmed,PAK,Spin,1997-10-24,Faisalabad,Pakistan,1997,2,138,264,7,1,337,693,15,199,429,8,22.466666666666665,<=30,PAK,Home,Upto 2014
Mushtaq Ahmed,PAK,Spin,1997-11-17,Peshawar,Pakistan,1997,2,106,249,10,1,271,573,12,165,324,2,22.583333333333332,<=30,PAK,Home,Upto 2014
Mushtaq Ahmed,PAK,Spin,1997-11-29,Rawalpindi,Pakistan,1997,2,75,138,1,1,146,240,1,71,102,0,146.0,>30,PAK,Home,Upto 2014
Mushtaq Ahmed,PAK,Spin,1997-12-06,Karachi,Pakistan,1997,2,112,126,1,1,300,618,11,188,492,10,27.272727272727273,<=30,PAK,Home,Upto 2014
Mushtaq Ahmed,PAK,Spin,1998-02-14,Johannesburg,South Africa,1998,1,66,162,3,1,141,272,5,75,110,2,28.2,<=30,SA,Away,Upto 2014
Mushtaq Ahmed,PAK,Spin,1998-02-26,Durban,South Africa,1998,2,149,414,9,1,177,468,9,28,54,0,19.666666666666668,<=30,SA,Away,Upto 2014
Mushtaq Ahmed,PAK,Spin,1998-03-06,Gqeberha,South Africa,1998,1,65,96,1,1,101,198,4,36,102,3,25.25,<=30,SA,Away,Upto 2014
Mushtaq Ahmed,PAK,Spin,1998-03-21,Harare,Zimbabwe,1998,2,158,342,4,1,303,593,6,145,251,2,50.5,>30,ZIM,Away,Upto 2014
Mushtaq Ahmed,PAK,Spin,1998-10-01,Rawalpindi,Pakistan,1998,1,115,246,2,1,561,1319,19,446,1073,17,29.526315789473685,<=30,PAK,Home,Upto 2014
Mushtaq Ahmed,PAK,Spin,1998-10-15,Peshawar,Pakistan,1998,2,212,396,2,1,751,1422,7,539,1026,5,107.28571428571429,>30,PAK,Home,Upto 2014
Mushtaq Ahmed,PAK,Spin,1998-11-27,Peshawar,Pakistan,1998,2,35,54,1,1,65,84,1,30,30,0,65.0,>30,PAK,Home,Upto 2014
Mushtaq Ahmed,PAK,Spin,1999-02-04,Delhi,India,1999,2,150,312,4,1,634,1395,31,484,1083,27,20.451612903225808,<=30,IND,Away,Upto 2014
Mushtaq Ahmed,PAK,Spin,1999-11-05,Brisbane,Australia,1999,2,214,240,3,1,367,559,6,153,319,3,61.166666666666664,>30,AUS,Away,Upto 2014
Mushtaq Ahmed,PAK,Spin,2000-05-05,Georgetown,West Indies,2000,1,91,192,3,1,162,360,3,71,168,0,54.0,>30,WI,Away,Upto 2014
Mushtaq Ahmed,PAK,Spin,2000-05-18,Bridgetown,West Indies,2000,2,129,252,2,1,391,966,10,262,714,8,39.1,>30,WI,Away,Upto 2014
Mushtaq Ahmed,PAK,Spin,2000-05-25,St John's,West Indies,2000,2,129,246,3,1,289,648,4,160,402,1,72.25,>30,WI,Away,Upto 2014
Mushtaq Ahmed,PAK,Spin,2000-06-14,Colombo (SSC),Sri Lanka,2000,2,45,90,1,1,317,840,16,272,750,15,19.8125,<=30,SL,Away,Upto 2014
Mushtaq Ahmed,PAK,Spin,2000-06-28,Kandy,Sri Lanka,2000,1,108,156,0,1,245,468,3,137,312,3,81.66666666666667,>30,SL,Away,Upto 2014
Mushtaq Ahmed,PAK,Spin,2000-11-15,Lahore,Pakistan,2000,2,164,312,1,1,697,1762,20,533,1450,19,34.85,>30,PAK,Home,Upto 2014
Mushtaq Ahmed,PAK,Spin,2001-03-08,Auckland,New Zealand,2001,2,83,186,1,1,297,718,10,214,532,9,29.7,<=30,NZ,Away,Upto 2014
Mushtaq Ahmed,PAK,Spin,2003-10-17,Lahore,Pakistan,2003,2,98,156,1,1,515,1054,21,417,898,20,24.523809523809526,<=30,PAK,Home,Upto 2014
Mushtaq Ahmed,PAK,Spin,2003-10-24,Faisalabad,Pakistan,2003,2,101,150,1,1,613,1195,9,512,1045,8,68.11111111111111,>30,PAK,Home,Upto 2014
Mushtaq Mohammad,PAK,Spin,1959-03-26,Lahore,Pakistan,1959,1,34,36,0,1,360,902,15,326,866,15,24.0,<=30,PAK,Home,Upto 2014
Mushtaq Mohammad,PAK,Spin,1960-12-02,Brabourne,India,1960,1,0,6,0,1,412,1324,9,412,1318,9,45.77777777777778,>30,IND,Away,Upto 2014
Mushtaq Mohammad,PAK,Spin,1960-12-16,Kanpur,India,1960,1,3,12,0,1,619,1984,16,616,1972,16,38.6875,>30,IND,Away,Upto 2014
Mushtaq Mohammad,PAK,Spin,1960-12-30,Eden Gardens,India,1960,1,9,18,0,1,295,842,11,286,824,11,26.818181818181817,<=30,IND,Away,Upto 2014
Mushtaq Mohammad,PAK,Spin,1962-02-02,Karachi,Pakistan,1962,1,10,12,0,1,769,2063,17,759,2051,17,45.23529411764706,>30,PAK,Home,Upto 2014
Mushtaq Mohammad,PAK,Spin,1962-06-21,Lord's,England,1962,1,8,6,0,1,359,496,6,351,490,6,59.833333333333336,>30,ENG,Away,Upto 2014
Mushtaq Mohammad,PAK,Spin,1962-08-16,The Oval,England,1962,1,3,3,0,1,452,1071,6,449,1068,6,75.33333333333333,>30,ENG,Away,Upto 2014
Mushtaq Mohammad,PAK,Spin,1967-07-27,Lord's,England,1967,2,58,165,4,1,583,1689,19,525,1524,15,30.68421052631579,>30,ENG,Away,Upto 2014
Mushtaq Mohammad,PAK,Spin,1967-08-10,Nottingham,England,1967,2,19,64,1,1,240,772,12,221,708,11,20.0,<=30,ENG,Away,Upto 2014
Mushtaq Mohammad,PAK,Spin,1967-08-24,The Oval,England,1967,1,80,160,4,1,475,1075,13,395,915,9,36.53846153846154,>30,ENG,Away,Upto 2014
Mushtaq Mohammad,PAK,Spin,1969-02-21,Lahore,Pakistan,1969,2,39,138,1,1,546,1362,17,507,1224,16,32.11764705882353,>30,PAK,Home,Upto 2014
Mushtaq Mohammad,PAK,Spin,1969-02-28,Dhaka,Bangladesh,1969,1,18,66,1,1,397,1246,15,379,1180,14,26.466666666666665,<=30,BAN,Away,Upto 2014
Mushtaq Mohammad,PAK,Spin,1969-03-06,Karachi,Pakistan,1969,1,69,139,2,1,302,679,5,233,540,3,60.4,>30,PAK,Home,Upto 2014
Mushtaq Mohammad,PAK,Spin,1969-10-24,Karachi,Pakistan,1969,2,32,102,1,1,665,1813,26,633,1711,25,25.576923076923077,<=30,PAK,Home,Upto 2014
Mushtaq Mohammad,PAK,Spin,1969-10-30,Lahore,Pakistan,1969,1,34,48,0,1,434,1339,23,400,1291,23,18.869565217391305,<=30,PAK,Home,Upto 2014
Mushtaq Mohammad,PAK,Spin,1971-06-03,Birmingham,England,1971,2,62,126,0,1,451,1037,8,389,911,8,56.375,>30,ENG,Away,Upto 2014
Mushtaq Mohammad,PAK,Spin,1971-06-17,Lord's,England,1971,1,31,66,0,1,197,492,2,166,426,2,98.5,>30,ENG,Away,Upto 2014
Mushtaq Mohammad,PAK,Spin,1971-07-08,Leeds,England,1971,2,26,54,0,1,601,1757,16,575,1703,16,37.5625,>30,ENG,Away,Upto 2014
Mushtaq Mohammad,PAK,Spin,1972-12-22,Adelaide,Australia,1972,1,67,90,3,1,497,880,15,430,790,12,33.13333333333333,>30,AUS,Away,Upto 2014
Mushtaq Mohammad,PAK,Spin,1972-12-29,Melbourne,Australia,1972,1,33,56,0,1,666,1379,10,633,1323,10,66.6,>30,AUS,Away,Upto 2014
Mushtaq Mohammad,PAK,Spin,1973-01-06,Sydney,Australia,1973,1,13,25,1,1,122,273,3,109,248,2,40.666666666666664,>30,AUS,Away,Upto 2014
Mushtaq Mohammad,PAK,Spin,1973-02-07,Dunedin,New Zealand,1973,2,64,173,7,1,480,1145,19,416,972,12,25.263157894736842,<=30,NZ,Away,Upto 2014
Mushtaq Mohammad,PAK,Spin,1973-02-16,Auckland,New Zealand,1973,1,26,40,1,1,488,1070,18,462,1030,17,27.11111111111111,<=30,NZ,Away,Upto 2014
Mushtaq Mohammad,PAK,Spin,1973-03-02,Lahore,Pakistan,1973,2,87,147,5,1,766,1787,23,679,1640,18,33.30434782608695,>30,PAK,Home,Upto 2014
Mushtaq Mohammad,PAK,Spin,1973-03-16,Hyderabad (Sind),Pakistan,1973,2,135,330,5,1,993,2402,21,858,2072,16,47.285714285714285,>30,PAK,Home,Upto 2014
Mushtaq Mohammad,PAK,Spin,1973-03-24,Karachi,Pakistan,1973,1,73,207,2,1,724,1728,23,651,1521,21,31.47826086956522,>30,PAK,Home,Upto 2014
Mushtaq Mohammad,PAK,Spin,1974-07-25,Leeds,England,1974,2,8,30,0,1,110,348,4,102,318,4,27.5,<=30,ENG,Away,Upto 2014
Mushtaq Mohammad,PAK,Spin,1974-08-08,Lord's,England,1974,1,16,42,1,1,263,688,20,247,646,19,13.15,<=30,ENG,Away,Upto 2014
Mushtaq Mohammad,PAK,Spin,1974-08-22,The Oval,England,1974,1,51,174,1,1,476,1138,12,425,964,11,39.666666666666664,>30,ENG,Away,Upto 2014
Mushtaq Mohammad,PAK,Spin,1975-02-15,Lahore,Pakistan,1975,1,20,48,0,1,210,572,5,190,524,5,42.0,>30,PAK,Home,Upto 2014
Mushtaq Mohammad,PAK,Spin,1975-03-01,Karachi,Pakistan,1975,1,56,120,1,1,404,1072,11,348,952,10,36.72727272727273,>30,PAK,Home,Upto 2014
Mushtaq Mohammad,PAK,Spin,1976-10-09,Lahore,Pakistan,1976,2,62,128,3,1,495,1028,17,433,900,14,29.11764705882353,<=30,PAK,Home,Upto 2014
Mushtaq Mohammad,PAK,Spin,1976-10-23,Hyderabad (Sind),Pakistan,1976,2,28,128,1,1,481,1360,16,453,1232,15,30.0625,>30,PAK,Home,Upto 2014
Mushtaq Mohammad,PAK,Spin,1976-10-30,Karachi,Pakistan,1976,2,39,96,0,1,499,1183,10,460,1087,10,49.9,>30,PAK,Home,Upto 2014
Mushtaq Mohammad,PAK,Spin,1976-12-24,Adelaide,Australia,1976,2,108,228,4,1,612,1524,18,504,1296,14,34.0,>30,AUS,Away,Upto 2014
Mushtaq Mohammad,PAK,Spin,1977-01-01,Melbourne,Australia,1977,1,18,24,0,1,386,751,13,368,727,13,29.692307692307693,<=30,AUS,Away,Upto 2014
Mushtaq Mohammad,PAK,Spin,1977-01-14,Sydney,Australia,1977,1,2,16,0,1,67,202,1,65,186,1,67.0,>30,AUS,Away,Upto 2014
Mushtaq Mohammad,PAK,Spin,1977-02-18,Bridgetown,West Indies,1977,1,27,30,0,1,180,418,4,153,388,4,45.0,>30,WI,Away,Upto 2014
Mushtaq Mohammad,PAK,Spin,1977-03-04,Port of Spain,West Indies,1977,2,77,174,4,1,450,1050,10,373,876,6,45.0,>30,WI,Away,Upto 2014
Mushtaq Mohammad,PAK,Spin,1977-03-18,Georgetown,West Indies,1977,1,74,177,1,1,174,438,6,100,261,5,29.0,<=30,WI,Away,Upto 2014
Mushtaq Mohammad,PAK,Spin,1977-04-01,Port of Spain,West Indies,1977,2,97,251,8,1,392,967,20,295,716,12,19.6,<=30,WI,Away,Upto 2014
Mushtaq Mohammad,PAK,Spin,1977-04-15,Kingston,West Indies,1977,2,53,108,0,1,227,438,8,174,330,8,28.375,<=30,WI,Away,Upto 2014
Mushtaq Mohammad,PAK,Spin,1978-10-16,Faisalabad,Pakistan,1978,1,55,162,4,1,700,1410,15,645,1248,11,46.666666666666664,>30,PAK,Home,Upto 2014
Mushtaq Mohammad,PAK,Spin,1978-10-27,Lahore,Pakistan,1978,2,138,216,2,1,591,988,6,453,772,4,98.5,>30,PAK,Home,Upto 2014
Mushtaq Mohammad,PAK,Spin,1978-11-14,Karachi,Pakistan,1978,2,42,72,0,1,383,654,5,341,582,5,76.6,>30,PAK,Home,Upto 2014
Mushtaq Mohammad,PAK,Spin,1979-02-02,Christchurch,New Zealand,1979,2,119,376,9,1,329,962,17,210,586,8,19.352941176470587,<=30,NZ,Away,Upto 2014
Mushtaq Mohammad,PAK,Spin,1979-02-16,Napier,New Zealand,1979,1,70,139,1,1,237,587,3,167,448,2,79.0,>30,NZ,Away,Upto 2014
Mushtaq Mohammad,PAK,Spin,1979-02-23,Auckland,New Zealand,1979,1,39,88,1,1,67,144,1,28,56,0,67.0,>30,NZ,Away,Upto 2014
Mushtaq Mohammad,PAK,Spin,1979-03-10,Melbourne,Australia,1979,2,77,144,0,1,258,519,6,181,375,6,43.0,>30,AUS,Away,Upto 2014
Mustafizur Rahman,BAN,Pace,2015-07-21,Chattogram,Bangladesh,2015,2,58,136,4,1,297,719,10,239,583,6,29.7,<=30,BAN,Home,After 1965
Mustafizur Rahman,BAN,Pace,2017-03-07,Galle,Sri Lanka,2017,2,92,204,3,1,497,858,9,405,654,6,55.22222222222222,>30,SL,Away,After 1965
Mustafizur Rahman,BAN,Pace,2017-03-15,Colombo (PSS),Sri Lanka,2017,2,128,264,5,1,356,675,9,228,411,4,39.55555555555556,>30,SL,Away,After 1965
Mustafizur Rahman,BAN,Pace,2017-08-27,Mirpur,Bangladesh,2017,2,21,54,0,1,186,391,4,165,337,4,46.5,>30,BAN,Home,After 1965
Mustafizur Rahman,BAN,Pace,2017-09-04,Chattogram,Bangladesh,2017,2,100,155,5,1,189,383,7,89,228,2,27.0,<=30,BAN,Home,After 1965
Mustafizur Rahman,BAN,Pace,2017-09-28,Potchefstroom,South Africa,2017,2,128,228,3,1,634,1140,16,506,912,13,39.625,>30,SA,Away,After 1965
Mustafizur Rahman,BAN,Pace,2017-10-06,Bloemfontein,South Africa,2017,1,113,150,0,1,638,933,23,525,783,23,27.73913043478261,<=30,SA,Away,After 1965
Mustafizur Rahman,BAN,Pace,2018-01-31,Chattogram,Bangladesh,2018,1,113,192,1,1,301,515,4,188,323,3,75.25,>30,BAN,Home,After 1965
Mustafizur Rahman,BAN,Pace,2018-02-08,Mirpur,Bangladesh,2018,2,66,168,5,1,102,258,8,36,90,3,12.75,<=30,BAN,Home,After 1965
Mustafizur Rahman,BAN,Pace,2018-11-11,Mirpur,Bangladesh,2018,2,77,186,1,1,422,1002,13,345,816,12,32.46153846153846,>30,BAN,Home,After 1965
Mustafizur Rahman,BAN,Pace,2018-11-22,Chattogram,Bangladesh,2018,2,15,24,0,1,183,270,6,168,246,6,30.5,>30,BAN,Home,After 1965
Mustafizur Rahman,BAN,Pace,2019-03-08,Wellington,New Zealand,2019,1,74,84,1,1,692,1031,24,618,947,23,28.833333333333332,<=30,NZ,Away,After 1965
Mustafizur Rahman,BAN,Pace,2021-02-03,Chattogram,Bangladesh,2021,2,117,168,2,1,327,606,6,210,438,4,54.5,>30,BAN,Home,After 1965
Mustafizur Rahman,BAN,Pace,2022-06-16,North Sound,West Indies,2022,2,37,132,1,1,515,1150,28,478,1018,27,18.392857142857142,<=30,WI,Away,After 1965
N Boje,SA,Spin,2000-02-24,Wankhede,India,2000,1,17,30,0,1,274,666,12,257,636,12,22.833333333333332,<=30,IND,Away,Upto 2014
N Boje,SA,Spin,2000-03-02,Bengaluru,India,2000,2,93,318,7,1,474,1252,16,381,934,9,29.625,<=30,IND,Away,Upto 2014
N Boje,SA,Spin,2000-07-20,Galle,Sri Lanka,2000,1,72,132,1,1,705,1392,24,633,1260,23,29.375,<=30,SL,Away,Upto 2014
N Boje,SA,Spin,2000-07-30,Kandy,Sri Lanka,2000,2,74,151,4,1,551,1139,19,477,988,15,29.0,<=30,SL,Away,Upto 2014
N Boje,SA,Spin,2000-08-06,Colombo (SSC),Sri Lanka,2000,2,127,324,5,1,525,1357,18,398,1033,13,29.166666666666668,<=30,SL,Away,Upto 2014
N Boje,SA,Spin,2000-11-17,Bloemfontein,South Africa,2000,2,96,336,1,1,207,537,3,111,201,2,69.0,>30,SA,Home,Upto 2014
N Boje,SA,Spin,2000-11-30,Gqeberha,South Africa,2000,2,75,204,2,1,168,385,3,93,181,1,56.0,>30,SA,Home,Upto 2014
N Boje,SA,Spin,2000-12-08,Johannesburg,South Africa,2000,1,16,18,0,1,16,18,0,0,0,0,inf,>30,SA,Home,Upto 2014
N Boje,SA,Spin,2000-12-26,Durban,South Africa,2000,2,74,258,4,1,274,753,15,200,495,11,18.266666666666666,<=30,SA,Home,Upto 2014
N Boje,SA,Spin,2001-01-02,Cape Town,South Africa,2001,1,28,60,4,1,231,506,8,203,446,4,28.875,<=30,SA,Home,Upto 2014
N Boje,SA,Spin,2001-01-20,Centurion,South Africa,2001,1,45,66,1,1,110,198,2,65,132,1,55.0,>30,SA,Home,Upto 2014
N Boje,SA,Spin,2001-03-09,Georgetown,West Indies,2001,2,149,337,5,1,353,904,9,204,567,4,39.22222222222222,>30,WI,Away,Upto 2014
N Boje,SA,Spin,2001-03-17,Port of Spain,West Indies,2001,1,65,114,0,1,234,564,4,169,450,4,58.5,>30,WI,Away,Upto 2014
N Boje,SA,Spin,2001-03-29,Bridgetown,West Indies,2001,2,84,268,6,1,341,1000,14,257,732,8,24.357142857142858,<=30,WI,Away,Upto 2014
N Boje,SA,Spin,2001-04-06,St John's,West Indies,2001,2,144,342,4,1,425,1266,13,281,924,9,32.69230769230769,>30,WI,Away,Upto 2014
N Boje,SA,Spin,2001-11-03,Bloemfontein,South Africa,2001,1,21,30,0,1,225,426,4,204,396,4,56.25,>30,SA,Home,Upto 2014
N Boje,SA,Spin,2001-11-16,Gqeberha,South Africa,2001,2,41,108,0,1,330,708,5,289,600,5,66.0,>30,SA,Home,Upto 2014
N Boje,SA,Spin,2002-01-02,Sydney,Australia,2002,2,78,165,4,1,581,1150,17,503,985,13,34.1764705882353,>30,AUS,Away,Upto 2014
N Boje,SA,Spin,2002-02-22,Johannesburg,South Africa,2002,1,153,210,1,1,223,336,7,70,126,6,31.857142857142858,>30,SA,Home,Upto 2014
N Boje,SA,Spin,2002-12-26,Durban,South Africa,2002,1,53,114,2,1,180,360,6,127,246,4,30.0,<=30,SA,Home,Upto 2014
N Boje,SA,Spin,2003-01-02,Cape Town,South Africa,2003,2,135,192,2,1,396,516,5,261,324,3,79.2,>30,SA,Home,Upto 2014
N Boje,SA,Spin,2004-03-18,Auckland,New Zealand,2004,2,114,134,1,1,247,374,2,133,240,1,123.5,>30,NZ,Away,Upto 2014
N Boje,SA,Spin,2004-03-26,Wellington,New Zealand,2004,2,134,320,8,1,263,584,8,129,264,0,32.875,>30,NZ,Away,Upto 2014
N Boje,SA,Spin,2004-08-04,Galle,Sri Lanka,2004,2,236,384,7,1,688,1462,17,452,1078,10,40.470588235294116,>30,SL,Away,Upto 2014
N Boje,SA,Spin,2004-08-11,Colombo (SSC),Sri Lanka,2004,2,183,345,3,1,470,988,13,287,643,10,36.15384615384615,>30,SL,Away,Upto 2014
N Boje,SA,Spin,2004-12-26,Durban,South Africa,2004,2,184,318,2,1,324,528,5,140,210,3,64.8,>30,SA,Home,Upto 2014
N Boje,SA,Spin,2005-01-02,Cape Town,South Africa,2005,2,86,228,4,1,243,528,7,157,300,3,34.714285714285715,>30,SA,Home,Upto 2014
N Boje,SA,Spin,2005-01-13,Johannesburg,South Africa,2005,2,101,156,0,1,150,235,2,49,79,2,75.0,>30,SA,Home,Upto 2014
N Boje,SA,Spin,2005-01-21,Centurion,South Africa,2005,2,59,120,0,1,140,288,1,81,168,1,140.0,>30,SA,Home,Upto 2014
N Boje,SA,Spin,2005-03-04,Cape Town,South Africa,2005,1,106,158,4,1,206,230,7,100,72,3,29.428571428571427,<=30,SA,Home,Upto 2014
N Boje,SA,Spin,2005-03-11,Centurion,South Africa,2005,2,87,198,1,1,252,431,4,165,233,3,63.0,>30,SA,Home,Upto 2014
N Boje,SA,Spin,2005-03-31,Georgetown,West Indies,2005,1,106,175,1,1,281,750,4,175,575,3,70.25,>30,WI,Away,Upto 2014
N Boje,SA,Spin,2005-04-08,Port of Spain,West Indies,2005,2,89,240,3,1,187,617,7,98,377,4,26.714285714285715,<=30,WI,Away,Upto 2014
N Boje,SA,Spin,2005-04-21,Bridgetown,West Indies,2005,2,98,162,1,1,288,498,4,190,336,3,72.0,>30,WI,Away,Upto 2014
N Boje,SA,Spin,2005-04-29,St John's,West Indies,2005,1,76,180,0,1,410,840,3,334,660,3,136.66666666666666,>30,WI,Away,Upto 2014
N Boje,SA,Spin,2005-12-26,Melbourne,Australia,2005,2,124,193,0,1,426,859,14,302,666,14,30.428571428571427,>30,AUS,Away,Upto 2014
N Boje,SA,Spin,2006-03-16,Cape Town,South Africa,2006,2,84,127,2,1,224,354,5,140,227,3,44.8,>30,SA,Home,Upto 2014
N Boje,SA,Spin,2006-03-24,Durban,South Africa,2006,2,148,274,3,1,362,753,11,214,479,8,32.90909090909091,>30,SA,Home,Upto 2014
N Boje,SA,Spin,2006-03-31,Johannesburg,South Africa,2006,2,75,138,2,1,258,450,7,183,312,5,36.857142857142854,>30,SA,Home,Upto 2014
N Boje,SA,Spin,2006-04-15,Centurion,South Africa,2006,1,29,42,0,1,126,259,2,97,217,2,63.0,>30,SA,Home,Upto 2014
N Boje,SA,Spin,2006-04-27,Cape Town,South Africa,2006,2,103,204,0,1,434,954,6,331,750,6,72.33333333333333,>30,SA,Home,Upto 2014
N Boje,SA,Spin,2006-07-27,Colombo (SSC),Sri Lanka,2006,1,221,390,0,1,531,1166,11,310,776,11,48.27272727272727,>30,SL,Away,Upto 2014
N Boje,SA,Spin,2006-08-04,Colombo (PSS),Sri Lanka,2006,2,182,357,5,1,476,925,17,294,568,12,28.0,<=30,SL,Away,Upto 2014
N Brand,SA,Spin,2024-02-04,Mount Maunganui,New Zealand,2024,2,171,234,8,1,328,671,17,157,437,9,19.294117647058822,<=30,NZ,Away,After 1965
N Burger,SA,Pace,2023-12-26,Centurion,South Africa,2023,2,83,154,7,1,718,1149,27,635,995,20,26.59259259259259,<=30,SA,Home,After 1965
N Burger,SA,Pace,2024-01-03,Cape Town,South Africa,2024,2,71,72,4,1,441,642,32,370,570,28,13.78125,<=30,SA,Home,After 1965
N Burger,SA,Pace,2024-08-15,Providence,West Indies,2024,2,83,150,3,1,482,1012,28,399,862,25,17.214285714285715,<=30,WI,Away,After 1965
N Chopra,IND,Spin,2000-03-02,Bengaluru,India,2000,1,78,144,0,1,474,1252,16,396,1108,16,29.625,<=30,IND,Home,Upto 2014
N Deonarine,WI,Spin,2005-03-31,Georgetown,West Indies,2005,2,40,191,2,1,281,750,4,241,559,2,70.25,>30,WI,Home,Upto 2014
N Deonarine,WI,Spin,2005-04-29,St John's,West Indies,2005,2,89,126,0,1,410,840,3,321,714,3,136.66666666666666,>30,WI,Home,Upto 2014
N Deonarine,WI,Spin,2005-07-13,Colombo (SSC),Sri Lanka,2005,1,9,6,0,1,301,612,9,292,606,9,33.44444444444444,>30,SL,Away,Upto 2014
N Deonarine,WI,Spin,2005-07-22,Kandy,Sri Lanka,2005,1,13,18,0,1,292,585,15,279,567,15,19.466666666666665,<=30,SL,Away,Upto 2014
N Deonarine,WI,Spin,2009-12-16,W.A.C.A,Australia,2009,2,75,144,2,1,338,660,10,263,516,8,33.8,>30,AUS,Away,Upto 2014
N Deonarine,WI,Spin,2010-06-18,Basseterre,West Indies,2010,1,20,18,0,1,665,1266,8,645,1248,8,83.125,>30,WI,Home,Upto 2014
N Deonarine,WI,Spin,2012-04-07,Bridgetown,West Indies,2012,2,89,180,4,1,422,828,8,333,648,4,52.75,>30,WI,Home,Upto 2014
N Deonarine,WI,Spin,2012-04-15,Port of Spain,West Indies,2012,2,46,132,2,1,339,951,13,293,819,11,26.076923076923077,<=30,WI,Home,Upto 2014
N Deonarine,WI,Spin,2012-04-23,Roseau,West Indies,2012,2,59,108,3,1,565,1160,26,506,1052,23,21.73076923076923,<=30,WI,Home,Upto 2014
N Deonarine,WI,Spin,2012-07-25,North Sound,West Indies,2012,2,11,42,0,1,474,1059,11,463,1017,11,43.09090909090909,>30,WI,Home,Upto 2014
N Deonarine,WI,Spin,2012-08-02,Kingston,West Indies,2012,2,80,204,6,1,213,524,11,133,320,5,19.363636363636363,<=30,WI,Home,Upto 2014
N Deonarine,WI,Spin,2013-11-14,Wankhede,India,2013,1,45,66,2,1,497,770,24,452,704,22,20.708333333333332,<=30,IND,Away,Upto 2014
N Deonarine,WI,Spin,2013-12-03,Dunedin,New Zealand,2013,2,83,144,2,1,483,925,11,400,781,9,43.90909090909091,>30,NZ,Away,Upto 2014
N Deonarine,WI,Spin,2013-12-11,Wellington,New Zealand,2013,1,39,96,1,1,170,312,2,131,216,1,85.0,>30,NZ,Away,Upto 2014
N Deonarine,WI,Spin,2013-12-19,Hamilton,New Zealand,2013,2,15,28,0,1,359,765,9,344,737,9,39.888888888888886,>30,NZ,Away,Upto 2014
N Gallichan,NZ,Spin,1937-07-24,Manchester,England,1937,2,113,264,3,1,559,1166,19,446,902,16,29.42105263157895,<=30,ENG,Away,Upto 2014
N Gifford,ENG,Spin,1964-06-18,Lord's,England,1964,2,31,174,3,1,149,558,5,118,384,2,29.8,<=30,ENG,Home,Upto 2014
N Gifford,ENG,Spin,1964-07-02,Leeds,England,1964,2,109,324,2,1,349,1116,11,240,792,9,31.727272727272727,>30,ENG,Home,Upto 2014
N Gifford,ENG,Spin,1971-06-17,Lord's,England,1971,1,13,72,1,1,197,492,2,184,420,1,98.5,>30,ENG,Home,Upto 2014
N Gifford,ENG,Spin,1971-07-08,Leeds,England,1971,2,120,526,5,1,601,1757,16,481,1231,11,37.5625,>30,ENG,Home,Upto 2014
N Gifford,ENG,Spin,1971-07-22,Lord's,England,1971,2,127,387,8,1,610,1919,28,483,1532,20,21.785714285714285,<=30,ENG,Home,Upto 2014
N Gifford,ENG,Spin,1972-06-08,Manchester,England,1972,1,29,18,0,1,177,420,8,148,402,8,22.125,<=30,ENG,Home,Upto 2014
N Gifford,ENG,Spin,1972-06-22,Lord's,England,1972,1,20,66,0,1,154,359,2,134,293,2,77.0,>30,ENG,Home,Upto 2014
N Gifford,ENG,Spin,1972-07-13,Nottingham,England,1972,2,67,120,1,1,374,904,5,307,784,4,74.8,>30,ENG,Home,Upto 2014
N Gifford,ENG,Spin,1973-01-12,Chennai,India,1973,2,86,251,3,1,632,1828,31,546,1577,28,20.387096774193548,<=30,IND,Away,Upto 2014
N Gifford,ENG,Spin,1973-01-25,Kanpur,India,1973,1,17,48,0,1,638,1919,18,621,1871,18,35.44444444444444,>30,IND,Away,Upto 2014
N Gifford,ENG,Spin,1973-03-16,Hyderabad (Sind),Pakistan,1973,1,111,312,3,1,993,2402,21,882,2090,18,47.285714285714285,>30,PAK,Away,Upto 2014
N Gifford,ENG,Spin,1973-03-24,Karachi,Pakistan,1973,2,154,450,7,1,724,1728,23,570,1278,16,31.47826086956522,>30,PAK,Away,Upto 2014
N Gifford,ENG,Spin,1973-06-07,Nottingham,England,1973,1,35,102,0,1,224,617,9,189,515,9,24.88888888888889,<=30,ENG,Home,Upto 2014
N Gifford,ENG,Spin,1973-06-21,Lord's,England,1973,1,107,234,0,1,444,1278,9,337,1044,9,49.333333333333336,>30,ENG,Home,Upto 2014
N Gordon,SA,Pace,1938-12-24,Johannesburg,South Africa,1938,2,162,380,7,1,680,1468,10,518,1088,3,68.0,>30,SA,Home,Upto 2014
N Gordon,SA,Pace,1938-12-31,Cape Town,South Africa,1938,1,157,320,5,1,456,999,10,299,679,5,45.6,>30,SA,Home,Upto 2014
N Gordon,SA,Pace,1939-01-20,Durban,South Africa,1939,1,127,232,2,1,487,999,14,360,767,12,34.785714285714285,>30,SA,Home,Upto 2014
N Gordon,SA,Pace,1939-02-18,Johannesburg,South Africa,1939,2,105,296,5,1,381,1034,15,276,738,10,25.4,<=30,SA,Home,Upto 2014
N Gordon,SA,Pace,1939-03-03,Durban,South Africa,1939,2,256,738,1,1,1100,3449,18,844,2711,17,61.111111111111114,>30,SA,Home,Upto 2014
N Hussain,ENG,Spin,1999-12-26,Durban,South Africa,1999,1,15,30,0,1,272,696,4,257,666,4,68.0,>30,SA,Away,Upto 2014
N Kapil Dev,IND,Pace,1978-10-16,Faisalabad,Pakistan,1978,2,96,168,1,1,508,904,5,412,736,4,101.6,>30,PAK,Away,Upto 2014
N Kapil Dev,IND,Pace,1978-10-27,Lahore,Pakistan,1978,2,151,228,2,1,667,1298,21,516,1070,19,31.761904761904763,>30,PAK,Away,Upto 2014
N Kapil Dev,IND,Pace,1978-11-14,Karachi,Pakistan,1978,2,179,306,4,1,801,1525,25,622,1219,21,32.04,>30,PAK,Away,Upto 2014
N Kapil Dev,IND,Pace,1978-12-01,Wankhede,India,1978,1,70,114,1,1,499,1002,13,429,888,12,38.38461538461539,>30,IND,Home,Upto 2014
N Kapil Dev,IND,Pace,1978-12-15,Bengaluru,India,1978,2,109,186,3,1,557,1034,19,448,848,16,29.31578947368421,<=30,IND,Home,Upto 2014
N Kapil Dev,IND,Pace,1978-12-29,Eden Gardens,India,1978,2,109,202,2,1,744,1474,17,635,1272,15,43.76470588235294,>30,IND,Home,Upto 2014
N Kapil Dev,IND,Pace,1979-01-12,Chennai,India,1979,2,84,168,7,1,433,993,27,349,825,20,16.037037037037038,<=30,IND,Home,Upto 2014
N Kapil Dev,IND,Pace,1979-01-24,Delhi,India,1979,2,91,144,3,1,605,998,12,514,854,9,50.416666666666664,>30,IND,Home,Upto 2014
N Kapil Dev,IND,Pace,1979-02-02,Kanpur,India,1979,1,98,120,1,1,581,990,8,483,870,7,72.625,>30,IND,Home,Upto 2014
N Kapil Dev,IND,Pace,1979-07-12,Birmingham,England,1979,1,146,288,5,1,689,1489,22,543,1201,17,31.318181818181817,>30,ENG,Away,Upto 2014
N Kapil Dev,IND,Pace,1979-08-02,Lord's,England,1979,1,93,228,3,1,523,1253,16,430,1025,13,32.6875,>30,ENG,Away,Upto 2014
N Kapil Dev,IND,Pace,1979-08-16,Leeds,England,1979,1,84,162,3,1,293,690,9,209,528,6,32.55555555555556,>30,ENG,Away,Upto 2014
N Kapil Dev,IND,Pace,1979-08-30,The Oval,England,1979,2,172,365,5,1,700,1610,24,528,1245,19,29.166666666666668,<=30,ENG,Away,Upto 2014
N Kapil Dev,IND,Pace,1979-09-11,Chennai,India,1979,2,125,208,3,1,448,938,6,323,730,3,74.66666666666667,>30,IND,Home,Upto 2014
N Kapil Dev,IND,Pace,1979-09-19,Bengaluru,India,1979,2,90,168,2,1,384,678,4,294,510,2,96.0,>30,IND,Home,Upto 2014
N Kapil Dev,IND,Pace,1979-10-02,Kanpur,India,1979,2,108,260,6,1,482,1119,27,374,859,21,17.85185185185185,<=30,IND,Home,Upto 2014
N Kapil Dev,IND,Pace,1979-10-13,Delhi,India,1979,2,130,312,7,1,509,1106,14,379,794,7,36.357142857142854,>30,IND,Home,Upto 2014
N Kapil Dev,IND,Pace,1979-10-26,Eden Gardens,India,1979,2,107,258,6,1,481,1011,15,374,753,9,32.06666666666667,>30,IND,Home,Upto 2014
N Kapil Dev,IND,Pace,1979-11-03,Wankhede,India,1979,2,65,133,4,1,295,643,9,230,510,5,32.77777777777778,>30,IND,Home,Upto 2014
N Kapil Dev,IND,Pace,1979-11-21,Bengaluru,India,1979,2,73,168,2,1,355,754,9,282,586,7,39.44444444444444,>30,IND,Home,Upto 2014
N Kapil Dev,IND,Pace,1979-12-04,Delhi,India,1979,2,121,280,9,1,647,1401,30,526,1121,21,21.566666666666666,<=30,IND,Home,Upto 2014
N Kapil Dev,IND,Pace,1979-12-16,Wankhede,India,1979,2,49,123,2,1,330,772,18,281,649,16,18.333333333333332,<=30,IND,Home,Upto 2014
N Kapil Dev,IND,Pace,1979-12-25,Kanpur,India,1979,1,63,168,6,1,450,1133,20,387,965,14,22.5,<=30,IND,Home,Upto 2014
N Kapil Dev,IND,Pace,1980-01-15,Chennai,India,1980,2,146,256,11,1,708,1186,22,562,930,11,32.18181818181818,>30,IND,Home,Upto 2014
N Kapil Dev,IND,Pace,1980-01-29,Eden Gardens,India,1980,2,114,276,2,1,644,1456,21,530,1180,19,30.666666666666668,>30,IND,Home,Upto 2014
N Kapil Dev,IND,Pace,1980-02-15,Wankhede,India,1980,2,85,222,3,1,555,1195,28,470,973,25,19.821428571428573,<=30,IND,Home,Upto 2014
N Kapil Dev,IND,Pace,1981-01-02,Sydney,Australia,1981,1,97,217,5,1,622,1071,25,525,854,20,24.88,<=30,AUS,Away,Upto 2014
N Kapil Dev,IND,Pace,1981-01-23,Adelaide,Australia,1981,2,167,294,3,1,673,1308,18,506,1014,15,37.388888888888886,>30,AUS,Away,Upto 2014
N Kapil Dev,IND,Pace,1981-02-07,Melbourne,Australia,1981,2,69,214,6,1,509,1262,25,440,1048,19,20.36,<=30,AUS,Away,Upto 2014
N Kapil Dev,IND,Pace,1981-02-21,Wellington,New Zealand,1981,2,146,324,7,1,725,1705,33,579,1381,26,21.96969696969697,<=30,NZ,Away,Upto 2014
N Kapil Dev,IND,Pace,1981-03-06,Christchurch,New Zealand,1981,1,60,132,0,1,349,1020,11,289,888,11,31.727272727272727,>30,NZ,Away,Upto 2014
N Kapil Dev,IND,Pace,1981-03-13,Auckland,New Zealand,1981,2,49,180,1,1,366,1193,11,317,1013,10,33.27272727272727,>30,NZ,Away,Upto 2014
N Kapil Dev,IND,Pace,1981-11-27,Wankhede,India,1981,2,99,212,6,1,460,1013,28,361,801,22,16.428571428571427,<=30,IND,Home,Upto 2014
N Kapil Dev,IND,Pace,1981-12-09,Bengaluru,India,1981,2,185,312,4,1,557,1122,12,372,810,8,46.416666666666664,>30,IND,Home,Upto 2014
N Kapil Dev,IND,Pace,1981-12-23,Delhi,India,1981,2,144,268,1,1,608,1217,15,464,949,14,40.53333333333333,>30,IND,Home,Upto 2014
N Kapil Dev,IND,Pace,1982-01-01,Eden Gardens,India,1982,2,172,312,6,1,453,960,12,281,648,6,37.75,>30,IND,Home,Upto 2014
N Kapil Dev,IND,Pace,1982-01-13,Chennai,India,1982,1,88,155,3,1,631,1176,8,543,1021,5,78.875,>30,IND,Home,Upto 2014
N Kapil Dev,IND,Pace,1982-01-30,Kanpur,India,1982,1,147,204,2,1,435,720,7,288,516,5,62.142857142857146,>30,IND,Home,Upto 2014
N Kapil Dev,IND,Pace,1982-06-10,Lord's,England,1982,2,168,318,8,1,701,1384,31,533,1066,23,22.612903225806452,<=30,ENG,Away,Upto 2014
N Kapil Dev,IND,Pace,1982-06-24,Manchester,England,1982,1,109,216,0,1,426,732,7,317,516,7,60.857142857142854,>30,ENG,Away,Upto 2014
N Kapil Dev,IND,Pace,1982-07-08,The Oval,England,1982,2,162,264,2,1,668,1272,12,506,1008,10,55.666666666666664,>30,ENG,Away,Upto 2014
N Kapil Dev,IND,Pace,1982-09-17,Chennai,India,1982,2,207,284,8,1,686,896,18,479,612,10,38.111111111111114,>30,IND,Home,Upto 2014
N Kapil Dev,IND,Pace,1982-12-10,Lahore,Pakistan,1982,2,176,282,2,1,700,1379,14,524,1097,12,50.0,>30,PAK,Away,Upto 2014
N Kapil Dev,IND,Pace,1982-12-23,Karachi,Pakistan,1982,1,102,173,5,1,510,865,22,408,692,17,23.181818181818183,<=30,PAK,Away,Upto 2014
N Kapil Dev,IND,Pace,1983-01-03,Faisalabad,Pakistan,1983,1,220,232,7,1,934,1450,28,714,1218,21,33.357142857142854,>30,PAK,Away,Upto 2014
N Kapil Dev,IND,Pace,1983-01-14,Hyderabad (Sind),Pakistan,1983,1,111,162,0,1,503,996,17,392,834,17,29.58823529411765,<=30,PAK,Away,Upto 2014
N Kapil Dev,IND,Pace,1983-01-23,Lahore,Pakistan,1983,1,85,185,8,1,359,745,10,274,560,2,35.9,>30,PAK,Away,Upto 2014
N Kapil Dev,IND,Pace,1983-01-30,Karachi,Pakistan,1983,1,137,198,2,1,655,1382,13,518,1184,11,50.38461538461539,>30,PAK,Away,Upto 2014
N Kapil Dev,IND,Pace,1983-02-23,Kingston,West Indies,1983,2,118,231,8,1,545,1266,30,427,1035,22,18.166666666666668,<=30,WI,Away,Upto 2014
N Kapil Dev,IND,Pace,1983-03-11,Port of Spain,West Indies,1983,1,91,186,3,1,669,1364,18,578,1178,15,37.166666666666664,>30,WI,Away,Upto 2014
N Kapil Dev,IND,Pace,1983-03-31,Georgetown,West Indies,1983,1,68,180,2,1,361,700,8,293,520,6,45.125,>30,WI,Away,Upto 2014
N Kapil Dev,IND,Pace,1983-04-15,Bridgetown,West Indies,1983,1,76,194,3,1,618,1146,24,542,952,21,25.75,<=30,WI,Away,Upto 2014
N Kapil Dev,IND,Pace,1983-04-28,St John's,West Indies,1983,1,71,132,1,1,719,1355,18,648,1223,17,39.94444444444444,>30,WI,Away,Upto 2014
N Kapil Dev,IND,Pace,1983-09-14,Bengaluru,India,1983,1,68,174,5,1,497,1170,18,429,996,13,27.61111111111111,<=30,IND,Home,Upto 2014
N Kapil Dev,IND,Pace,1983-09-24,Jalandhar,India,1983,2,89,204,4,1,450,936,11,361,732,7,40.90909090909091,>30,IND,Home,Upto 2014
N Kapil Dev,IND,Pace,1983-10-05,Nagpur,India,1983,2,68,168,3,1,439,897,10,371,729,7,43.9,>30,IND,Home,Upto 2014
N Kapil Dev,IND,Pace,1983-10-21,Kanpur,India,1983,1,99,146,4,1,584,1065,26,485,919,22,22.46153846153846,<=30,IND,Home,Upto 2014
N Kapil Dev,IND,Pace,1983-10-29,Delhi,India,1983,2,103,228,6,1,784,1399,23,681,1171,17,34.08695652173913,>30,IND,Home,Upto 2014
N Kapil Dev,IND,Pace,1983-11-12,Ahmedabad,India,1983,2,135,345,10,1,524,1257,33,389,912,23,15.878787878787879,<=30,IND,Home,Upto 2014
N Kapil Dev,IND,Pace,1983-11-24,Wankhede,India,1983,2,54,168,2,1,698,1403,16,644,1235,14,43.625,>30,IND,Home,Upto 2014
N Kapil Dev,IND,Pace,1983-12-10,Eden Gardens,India,1983,1,91,210,4,1,475,988,25,384,778,21,19.0,<=30,IND,Home,Upto 2014
N Kapil Dev,IND,Pace,1983-12-24,Chennai,India,1983,2,55,126,3,1,443,882,12,388,756,9,36.916666666666664,>30,IND,Home,Upto 2014
N Kapil Dev,IND,Pace,1984-10-17,Lahore,Pakistan,1984,1,104,180,1,1,564,1248,16,460,1068,15,35.25,>30,PAK,Away,Upto 2014
N Kapil Dev,IND,Pace,1984-10-24,Faisalabad,Pakistan,1984,1,22,29,0,1,679,1180,8,657,1151,8,84.875,>30,PAK,Away,Upto 2014
N Kapil Dev,IND,Pace,1984-11-28,Wankhede,India,1984,2,78,258,3,1,378,744,6,300,486,3,63.0,>30,IND,Home,Upto 2014
N Kapil Dev,IND,Pace,1984-12-12,Delhi,India,1984,2,107,228,1,1,406,798,8,299,570,7,50.75,>30,IND,Home,Upto 2014
N Kapil Dev,IND,Pace,1985-01-13,Chennai,India,1985,2,151,234,2,1,557,887,19,406,653,17,29.31578947368421,<=30,IND,Home,Upto 2014
N Kapil Dev,IND,Pace,1985-01-31,Kanpur,India,1985,2,100,251,4,1,413,773,9,313,522,5,45.888888888888886,>30,IND,Home,Upto 2014
N Kapil Dev,IND,Pace,1985-08-30,Colombo (SSC),Sri Lanka,1985,2,110,208,5,1,634,1521,27,524,1313,22,23.48148148148148,<=30,SL,Away,Upto 2014
N Kapil Dev,IND,Pace,1985-09-06,Colombo (PSS),Sri Lanka,1985,2,142,312,1,1,740,1533,28,598,1221,27,26.428571428571427,<=30,SL,Away,Upto 2014
N Kapil Dev,IND,Pace,1985-09-14,Kandy,Sri Lanka,1985,2,120,258,5,1,808,1515,25,688,1257,20,32.32,>30,SL,Away,Upto 2014
N Kapil Dev,IND,Pace,1985-12-13,Adelaide,Australia,1985,2,109,246,8,1,620,1368,17,511,1122,9,36.470588235294116,>30,AUS,Away,Upto 2014
N Kapil Dev,IND,Pace,1985-12-26,Melbourne,Australia,1985,2,91,270,3,1,429,932,13,338,662,10,33.0,>30,AUS,Away,Upto 2014
N Kapil Dev,IND,Pace,1986-01-02,Sydney,Australia,1986,2,76,192,1,1,382,756,4,306,564,3,95.5,>30,AUS,Away,Upto 2014
N Kapil Dev,IND,Pace,1986-06-05,Lord's,England,1986,2,119,318,5,1,690,1580,26,571,1262,21,26.53846153846154,<=30,ENG,Away,Upto 2014
N Kapil Dev,IND,Pace,1986-06-19,Leeds,England,1986,2,60,224,3,1,608,1416,31,548,1192,28,19.612903225806452,<=30,ENG,Away,Upto 2014
N Kapil Dev,IND,Pace,1986-07-03,Birmingham,England,1986,2,127,228,2,1,804,1599,21,677,1371,19,38.285714285714285,>30,ENG,Away,Upto 2014
N Kapil Dev,IND,Pace,1986-09-18,Chennai,India,1986,2,57,114,0,1,433,618,3,376,504,3,144.33333333333334,>30,IND,Home,Upto 2014
N Kapil Dev,IND,Pace,1986-09-26,Delhi,India,1986,1,27,84,0,1,158,270,3,131,186,3,52.666666666666664,>30,IND,Home,Upto 2014
N Kapil Dev,IND,Pace,1986-10-15,Wankhede,India,1986,2,40,72,0,1,351,666,3,311,594,3,117.0,>30,IND,Home,Upto 2014
N Kapil Dev,IND,Pace,1986-12-17,Kanpur,India,1986,1,81,180,2,1,810,1291,13,729,1111,11,62.30769230769231,>30,IND,Home,Upto 2014
N Kapil Dev,IND,Pace,1986-12-27,Nagpur,India,1986,2,45,96,2,1,372,581,7,327,485,5,53.142857142857146,>30,IND,Home,Upto 2014
N Kapil Dev,IND,Pace,1987-01-04,Cuttack,India,1987,2,105,252,5,1,333,711,12,228,459,7,27.75,<=30,IND,Home,Upto 2014
N Kapil Dev,IND,Pace,1987-02-03,Chennai,India,1987,2,104,162,0,1,341,600,5,237,438,5,68.2,>30,IND,Home,Upto 2014
N Kapil Dev,IND,Pace,1987-02-11,Eden Gardens,India,1987,2,129,288,3,1,698,1442,20,569,1154,17,34.9,>30,IND,Home,Upto 2014
N Kapil Dev,IND,Pace,1987-02-21,Jaipur,India,1987,1,84,162,2,1,305,699,6,221,537,4,50.833333333333336,>30,IND,Home,Upto 2014
N Kapil Dev,IND,Pace,1987-03-04,Ahmedabad,India,1987,2,65,222,3,1,194,539,11,129,317,8,17.636363636363637,<=30,IND,Home,Upto 2014
N Kapil Dev,IND,Pace,1987-03-13,Bengaluru,India,1987,2,48,138,3,1,134,282,5,86,144,2,26.8,<=30,IND,Home,Upto 2014
N Kapil Dev,IND,Pace,1987-11-25,Delhi,India,1987,2,85,228,4,1,549,1170,28,464,942,24,19.607142857142858,<=30,IND,Home,Upto 2014
N Kapil Dev,IND,Pace,1987-12-11,Wankhede,India,1987,2,74,156,1,1,509,808,22,435,652,21,23.136363636363637,<=30,IND,Home,Upto 2014
N Kapil Dev,IND,Pace,1987-12-26,Eden Gardens,India,1987,2,122,228,2,1,580,866,11,458,638,9,52.72727272727273,>30,IND,Home,Upto 2014
N Kapil Dev,IND,Pace,1988-01-11,Chennai,India,1988,2,28,66,1,1,358,643,15,330,577,14,23.866666666666667,<=30,IND,Home,Upto 2014
N Kapil Dev,IND,Pace,1988-11-12,Bengaluru,India,1988,2,40,81,3,1,219,525,9,179,444,6,24.333333333333332,<=30,IND,Home,Upto 2014
N Kapil Dev,IND,Pace,1988-11-24,Wankhede,India,1988,2,100,237,3,1,384,842,15,284,605,12,25.6,<=30,IND,Home,Upto 2014
N Kapil Dev,IND,Pace,1988-12-02,Hyderabad (Deccan),India,1988,2,92,216,4,1,410,867,17,318,651,13,24.11764705882353,<=30,IND,Home,Upto 2014
N Kapil Dev,IND,Pace,1989-03-25,Georgetown,West Indies,1989,1,66,168,2,1,194,462,4,128,294,2,48.5,>30,WI,Away,Upto 2014
N Kapil Dev,IND,Pace,1989-04-07,Bridgetown,West Indies,1989,2,110,197,2,1,726,1450,23,616,1253,21,31.565217391304348,>30,WI,Away,Upto 2014
N Kapil Dev,IND,Pace,1989-04-15,Port of Spain,West Indies,1989,2,103,264,7,1,469,1127,29,366,863,22,16.17241379310345,<=30,WI,Away,Upto 2014
N Kapil Dev,IND,Pace,1989-04-28,Kingston,West Indies,1989,2,106,252,7,1,590,1241,28,484,989,21,21.071428571428573,<=30,WI,Away,Upto 2014
N Kapil Dev,IND,Pace,1989-11-15,Karachi,Pakistan,1989,2,151,360,7,1,875,1711,26,724,1351,19,33.65384615384615,>30,PAK,Away,Upto 2014
N Kapil Dev,IND,Pace,1989-11-23,Faisalabad,Pakistan,1989,1,106,270,3,1,850,1756,23,744,1486,20,36.95652173913044,>30,PAK,Away,Upto 2014
N Kapil Dev,IND,Pace,1989-12-01,Lahore,Pakistan,1989,1,77,168,0,1,513,1118,6,436,950,6,85.5,>30,PAK,Away,Upto 2014
N Kapil Dev,IND,Pace,1989-12-09,Sialkot,Pakistan,1989,1,44,214,2,1,741,1608,26,697,1394,24,28.5,<=30,PAK,Away,Upto 2014
N Kapil Dev,IND,Pace,1990-02-02,Christchurch,New Zealand,1990,1,89,171,3,1,683,1242,22,594,1071,19,31.045454545454547,>30,NZ,Away,Upto 2014
N Kapil Dev,IND,Pace,1990-02-09,Napier,New Zealand,1990,1,30,84,0,1,406,996,10,376,912,10,40.6,>30,NZ,Away,Upto 2014
N Kapil Dev,IND,Pace,1990-02-22,Auckland,New Zealand,1990,2,186,362,2,1,1075,1694,19,889,1332,17,56.578947368421055,>30,NZ,Away,Upto 2014
N Kapil Dev,IND,Pace,1990-07-26,Lord's,England,1990,2,173,264,1,1,1076,1683,21,903,1419,20,51.23809523809524,>30,ENG,Away,Upto 2014
N Kapil Dev,IND,Pace,1990-08-09,Manchester,England,1990,2,136,210,3,1,835,1242,15,699,1032,12,55.666666666666664,>30,ENG,Away,Upto 2014
N Kapil Dev,IND,Pace,1990-08-23,The Oval,England,1990,2,136,294,3,1,853,1642,16,717,1348,13,53.3125,>30,ENG,Away,Upto 2014
N Kapil Dev,IND,Pace,1990-11-23,Chandigarh,India,1990,2,50,226,5,1,244,603,12,194,377,7,20.333333333333332,<=30,IND,Home,Upto 2014
N Kapil Dev,IND,Pace,1991-11-29,Brisbane,Australia,1991,2,103,258,4,1,581,1459,29,478,1201,25,20.03448275862069,<=30,AUS,Away,Upto 2014
N Kapil Dev,IND,Pace,1991-12-26,Melbourne,Australia,1991,2,127,282,5,1,732,1688,29,605,1406,24,25.24137931034483,<=30,AUS,Away,Upto 2014
N Kapil Dev,IND,Pace,1992-01-02,Sydney,Australia,1992,2,101,312,4,1,641,1594,19,540,1282,15,33.73684210526316,>30,AUS,Away,Upto 2014
N Kapil Dev,IND,Pace,1992-01-25,Adelaide,Australia,1992,2,163,444,8,1,796,1827,30,633,1383,22,26.533333333333335,<=30,AUS,Away,Upto 2014
N Kapil Dev,IND,Pace,1992-02-01,W.A.C.A,Australia,1992,2,151,408,4,1,946,1994,34,795,1586,30,27.823529411764707,<=30,AUS,Away,Upto 2014
N Kapil Dev,IND,Pace,1992-10-18,Harare,Zimbabwe,1992,2,93,324,3,1,480,1630,15,387,1306,12,32.0,>30,ZIM,Away,Upto 2014
N Kapil Dev,IND,Pace,1992-11-13,Durban,South Africa,1992,2,62,246,3,1,480,1371,14,418,1125,11,34.285714285714285,>30,SA,Away,Upto 2014
N Kapil Dev,IND,Pace,1992-11-26,Johannesburg,South Africa,1992,2,112,294,1,1,741,2035,23,629,1741,22,32.21739130434783,>30,SA,Away,Upto 2014
N Kapil Dev,IND,Pace,1992-12-26,Gqeberha,South Africa,1992,2,54,174,2,1,485,1194,23,431,1020,21,21.08695652173913,<=30,SA,Away,Upto 2014
N Kapil Dev,IND,Pace,1993-01-02,Cape Town,South Africa,1993,2,71,276,2,1,434,1582,19,363,1306,17,22.842105263157894,<=30,SA,Away,Upto 2014
N Kapil Dev,IND,Pace,1993-01-29,Eden Gardens,India,1993,2,30,86,2,1,387,856,9,357,770,7,43.0,>30,IND,Home,Upto 2014
N Kapil Dev,IND,Pace,1993-02-11,Chennai,India,1993,2,47,90,2,1,257,522,5,210,432,3,51.4,>30,IND,Home,Upto 2014
N Kapil Dev,IND,Pace,1993-02-19,Wankhede,India,1993,2,56,132,3,1,325,648,9,269,516,6,36.111111111111114,>30,IND,Home,Upto 2014
N Kapil Dev,IND,Pace,1993-03-13,Delhi,India,1993,2,41,102,1,1,351,630,4,310,528,3,87.75,>30,IND,Home,Upto 2014
N Kapil Dev,IND,Pace,1993-07-17,Kandy,Sri Lanka,1993,1,10,30,1,1,23,72,3,13,42,2,7.666666666666667,<=30,SL,Away,Upto 2014
N Kapil Dev,IND,Pace,1993-07-27,Colombo (SSC),Sri Lanka,1993,2,60,222,2,1,627,1409,18,567,1187,16,34.833333333333336,>30,SL,Away,Upto 2014
N Kapil Dev,IND,Pace,1993-08-04,Colombo (PSS),Sri Lanka,1993,2,89,307,2,1,384,1057,10,295,750,8,38.4,>30,SL,Away,Upto 2014
N Kapil Dev,IND,Pace,1994-01-18,Lucknow,India,1994,2,35,78,1,1,249,514,6,214,436,5,41.5,>30,IND,Home,Upto 2014
N Kapil Dev,IND,Pace,1994-01-26,Bengaluru,India,1994,2,114,178,5,1,326,460,11,212,282,6,29.636363636363637,<=30,IND,Home,Upto 2014
N Kapil Dev,IND,Pace,1994-02-08,Ahmedabad,India,1994,2,27,84,1,1,174,408,3,147,324,2,58.0,>30,IND,Home,Upto 2014
N Kapil Dev,IND,Pace,1994-03-19,Hamilton,New Zealand,1994,2,72,150,2,1,466,1167,15,394,1017,13,31.066666666666666,>30,NZ,Away,Upto 2014
N M'shangwe,ZIM,Spin,2014-11-03,Khulna,Bangladesh,2014,2,209,400,5,1,829,1764,29,620,1364,24,28.586206896551722,<=30,BAN,Away,After 1965
N M'shangwe,ZIM,Spin,2014-11-12,Chattogram,Bangladesh,2014,2,226,390,2,1,952,1674,19,726,1284,17,50.10526315789474,>30,BAN,Away,After 1965
N Ncube,ZIM,Pace,2011-11-01,Bulawayo,Zimbabwe,2011,2,121,210,1,1,759,1445,23,638,1235,22,33.0,>30,ZIM,Home,Upto 2014
N Phillip,WI,Pace,1978-03-31,Georgetown,West Indies,1978,2,140,222,6,1,786,1458,28,646,1236,22,28.071428571428573,<=30,WI,Home,Upto 2014
N Phillip,WI,Pace,1978-04-15,Port of Spain,West Indies,1978,2,97,144,2,1,408,786,17,311,642,15,24.0,<=30,WI,Home,Upto 2014
N Phillip,WI,Pace,1978-04-28,Kingston,West Indies,1978,2,154,294,1,1,520,1042,12,366,748,11,43.333333333333336,>30,WI,Home,Upto 2014
N Phillip,WI,Pace,1978-12-01,Wankhede,India,1978,2,86,168,1,1,499,1002,13,413,834,12,38.38461538461539,>30,IND,Away,Upto 2014
N Phillip,WI,Pace,1978-12-15,Bengaluru,India,1978,1,86,150,3,1,557,1034,19,471,884,16,29.31578947368421,<=30,IND,Away,Upto 2014
N Phillip,WI,Pace,1978-12-29,Eden Gardens,India,1978,2,145,228,4,1,744,1474,17,599,1246,13,43.76470588235294,>30,IND,Away,Upto 2014
N Phillip,WI,Pace,1979-01-12,Chennai,India,1979,2,85,222,7,1,433,993,27,348,771,20,16.037037037037038,<=30,IND,Away,Upto 2014
N Phillip,WI,Pace,1979-01-24,Delhi,India,1979,1,159,230,3,1,605,998,12,446,768,9,50.416666666666664,>30,IND,Away,Upto 2014
N Phillip,WI,Pace,1979-02-02,Kanpur,India,1979,1,89,162,1,1,581,990,8,492,828,7,72.625,>30,IND,Away,Upto 2014
N Pradeep,SL,Pace,2011-10-18,Abu Dhabi,UAE,2011,2,110,168,0,1,689,1303,17,579,1135,17,40.529411764705884,>30,UAE,Away,Upto 2014
N Pradeep,SL,Pace,2012-06-22,Galle,Sri Lanka,2012,2,84,144,1,1,350,768,9,266,624,8,38.888888888888886,>30,SL,Home,Upto 2014
N Pradeep,SL,Pace,2012-06-30,Colombo (SSC),Sri Lanka,2012,2,151,192,0,1,504,822,6,353,630,6,84.0,>30,SL,Home,Upto 2014
N Pradeep,SL,Pace,2013-01-03,Sydney,Australia,2013,2,128,132,2,1,729,1200,20,601,1068,18,36.45,>30,AUS,Away,Upto 2014
N Pradeep,SL,Pace,2014-01-08,Dubai (DICS),UAE,2014,2,112,222,5,1,719,1539,21,607,1317,16,34.23809523809524,>30,UAE,Away,After 1965
N Pradeep,SL,Pace,2014-02-04,Chattogram,Bangladesh,2014,2,129,148,0,1,379,646,2,250,498,2,189.5,>30,BAN,Away,After 1965
N Pradeep,SL,Pace,2014-06-12,Lord's,England,2014,2,160,252,4,1,1099,1996,30,939,1744,26,36.63333333333333,>30,ENG,Away,After 1965
N Pradeep,SL,Pace,2014-06-20,Leeds,England,2014,2,145,210,2,1,1059,2060,34,914,1850,32,31.147058823529413,>30,ENG,Away,After 1965
N Pradeep,SL,Pace,2015-01-03,Wellington,New Zealand,2015,2,180,318,7,1,987,1835,28,807,1517,21,35.25,>30,NZ,Away,After 1965
N Pradeep,SL,Pace,2015-06-17,Galle,Sri Lanka,2015,2,89,126,2,1,383,708,10,294,582,8,38.3,>30,SL,Home,After 1965
N Pradeep,SL,Pace,2015-07-03,Pallekele,Sri Lanka,2015,2,80,192,3,1,740,1384,19,660,1192,16,38.94736842105263,>30,SL,Home,After 1965
N Pradeep,SL,Pace,2015-08-12,Galle,Sri Lanka,2015,2,106,192,3,1,393,630,9,287,438,6,43.666666666666664,>30,SL,Home,After 1965
N Pradeep,SL,Pace,2015-08-28,Colombo (SSC),Sri Lanka,2015,2,114,234,5,1,606,1122,27,492,888,22,22.444444444444443,<=30,SL,Home,After 1965
N Pradeep,SL,Pace,2015-10-14,Galle,Sri Lanka,2015,2,84,174,2,1,384,801,11,300,627,9,34.90909090909091,>30,SL,Home,After 1965
N Pradeep,SL,Pace,2015-10-22,Colombo (PSS),Sri Lanka,2015,2,35,84,0,1,259,558,12,224,474,12,21.583333333333332,<=30,SL,Home,After 1965
N Pradeep,SL,Pace,2015-12-10,Dunedin,New Zealand,2015,2,164,217,4,1,942,1677,26,778,1460,22,36.23076923076923,>30,NZ,Away,After 1965
N Pradeep,SL,Pace,2015-12-18,Hamilton,New Zealand,2015,2,82,178,2,1,667,1250,30,585,1072,28,22.233333333333334,<=30,NZ,Away,After 1965
N Pradeep,SL,Pace,2016-05-19,Leeds,England,2016,1,56,114,1,1,468,901,27,412,787,26,17.333333333333332,<=30,ENG,Away,After 1965
N Pradeep,SL,Pace,2016-05-27,Chester-le-Street,England,2016,2,119,210,4,1,773,1433,25,654,1223,21,30.92,>30,ENG,Away,After 1965
N Pradeep,SL,Pace,2016-06-09,Lord's,England,2016,2,141,252,5,1,770,1481,24,629,1229,19,32.083333333333336,>30,ENG,Away,After 1965
N Pradeep,SL,Pace,2016-07-26,Pallekele,Sri Lanka,2016,2,52,132,2,1,306,556,14,254,424,12,21.857142857142858,<=30,SL,Home,After 1965
N Pradeep,SL,Pace,2016-12-26,Gqeberha,South Africa,2016,2,131,215,3,1,798,1468,25,667,1253,22,31.92,>30,SA,Away,After 1965
N Pradeep,SL,Pace,2017-01-02,Cape Town,South Africa,2017,2,92,160,0,1,701,1233,30,609,1073,30,23.366666666666667,<=30,SA,Away,After 1965
N Pradeep,SL,Pace,2017-01-12,Johannesburg,South Africa,2017,1,78,162,4,1,621,1136,30,543,974,26,20.7,<=30,SA,Away,After 1965
N Pradeep,SL,Pace,2017-07-26,Galle,Sri Lanka,2017,2,195,258,6,1,627,805,16,432,547,10,39.1875,>30,SL,Home,After 1965
N Pradeep,SL,Pace,2017-08-03,Colombo (SSC),Sri Lanka,2017,1,63,106,0,1,216,460,7,153,354,7,30.857142857142858,>30,SL,Home,After 1965
N Pradeep,SL,Pace,2017-09-28,Abu Dhabi,UAE,2017,2,81,165,2,1,437,1023,13,356,858,11,33.61538461538461,>30,UAE,Away,After 1965
N Pradeep,SL,Pace,2017-10-06,Dubai (DICS),UAE,2017,2,42,120,1,1,468,1044,16,426,924,15,29.25,<=30,UAE,Away,After 1965
N Puna,NZ,Spin,1966-02-25,Christchurch,New Zealand,1966,2,103,192,1,1,245,648,5,142,456,4,49.0,>30,NZ,Home,Upto 2014
N Puna,NZ,Spin,1966-03-04,Dunedin,New Zealand,1966,1,40,84,2,1,185,556,9,145,472,7,20.555555555555557,<=30,NZ,Home,Upto 2014
N Puna,NZ,Spin,1966-03-11,Auckland,New Zealand,1966,2,97,204,1,1,300,776,10,203,572,9,30.0,<=30,NZ,Home,Upto 2014
N Reid,SA,Spin,1921-11-26,Cape Town,South Africa,1921,1,63,126,2,1,400,850,17,337,724,15,23.529411764705884,<=30,SA,Home,Upto 2014
N Wagner,NZ,Pace,2012-07-25,North Sound,West Indies,2012,2,144,228,1,1,734,1446,19,590,1218,18,38.63157894736842,>30,WI,Away,Upto 2014
N Wagner,NZ,Pace,2012-08-02,Kingston,West Indies,2012,2,65,132,3,1,597,1132,23,532,1000,20,25.956521739130434,<=30,WI,Away,Upto 2014
N Wagner,NZ,Pace,2013-01-11,Gqeberha,South Africa,2013,1,135,198,1,1,619,1262,23,484,1064,22,26.91304347826087,<=30,SA,Away,Upto 2014
N Wagner,NZ,Pace,2013-03-06,Dunedin,New Zealand,2013,2,183,324,7,1,764,1468,18,581,1144,11,42.44444444444444,>30,NZ,Home,Upto 2014
N Wagner,NZ,Pace,2013-03-14,Wellington,New Zealand,2013,1,122,198,2,1,612,1184,15,490,986,13,40.8,>30,NZ,Home,Upto 2014
N Wagner,NZ,Pace,2013-03-22,Auckland,New Zealand,2013,2,97,240,3,1,822,1793,28,725,1553,25,29.357142857142858,<=30,NZ,Home,Upto 2014
N Wagner,NZ,Pace,2013-05-16,Lord's,England,2013,2,114,246,4,1,569,1283,36,455,1037,32,15.805555555555555,<=30,ENG,Away,Upto 2014
N Wagner,NZ,Pace,2013-05-24,Leeds,England,2013,2,140,240,3,1,701,1279,21,561,1039,18,33.38095238095238,>30,ENG,Away,Upto 2014
N Wagner,NZ,Pace,2013-10-21,Mirpur,Bangladesh,2013,2,116,222,7,1,508,858,10,392,636,3,50.8,>30,BAN,Away,Upto 2014
N Wagner,NZ,Pace,2013-12-03,Dunedin,New Zealand,2013,2,159,258,3,1,879,1520,20,720,1262,17,43.95,>30,NZ,Home,Upto 2014
N Wagner,NZ,Pace,2013-12-11,Wellington,New Zealand,2013,2,104,144,2,1,603,1007,28,499,863,26,21.535714285714285,<=30,NZ,Home,Upto 2014
N Wagner,NZ,Pace,2013-12-19,Hamilton,New Zealand,2013,2,101,168,3,1,543,1073,23,442,905,20,23.608695652173914,<=30,NZ,Home,Upto 2014
N Wagner,NZ,Pace,2014-02-06,Auckland,New Zealand,2014,2,126,216,8,1,873,1527,37,747,1311,29,23.594594594594593,<=30,NZ,Home,After 1965
N Wagner,NZ,Pace,2014-02-14,Wellington,New Zealand,2014,2,144,202,3,1,1271,2109,30,1127,1907,27,42.36666666666667,>30,NZ,Home,After 1965
N Wagner,NZ,Pace,2014-06-26,Bridgetown,West Indies,2014,2,114,258,5,1,620,1276,27,506,1018,22,22.962962962962962,<=30,WI,Away,After 1965
N Wagner,NZ,Pace,2014-12-26,Christchurch,New Zealand,2014,2,136,246,3,1,757,1417,28,621,1171,25,27.035714285714285,<=30,NZ,Home,After 1965
N Wagner,NZ,Pace,2015-12-10,Dunedin,New Zealand,2015,2,143,252,5,1,942,1677,26,799,1425,21,36.23076923076923,>30,NZ,Home,After 1965
N Wagner,NZ,Pace,2015-12-18,Hamilton,New Zealand,2015,2,91,108,4,1,667,1250,30,576,1142,26,22.233333333333334,<=30,NZ,Home,After 1965
N Wagner,NZ,Pace,2016-02-20,Christchurch,New Zealand,2016,2,166,301,7,1,1247,2076,29,1081,1775,22,43.0,>30,NZ,Home,After 1965
N Wagner,NZ,Pace,2016-07-28,Bulawayo,Zimbabwe,2016,2,103,227,8,1,542,1115,20,439,888,12,27.1,<=30,ZIM,Away,After 1965
N Wagner,NZ,Pace,2016-08-06,Bulawayo,Zimbabwe,2016,2,84,258,3,1,578,1230,11,494,972,8,52.54545454545455,>30,ZIM,Away,After 1965
N Wagner,NZ,Pace,2016-08-19,Durban,South Africa,2016,1,47,90,3,1,247,526,10,200,436,7,24.7,<=30,SA,Away,After 1965
N Wagner,NZ,Pace,2016-08-27,Centurion,South Africa,2016,2,104,294,6,1,829,1709,31,725,1415,25,26.741935483870968,<=30,SA,Away,After 1965
N Wagner,NZ,Pace,2016-09-22,Kanpur,India,2016,2,94,186,2,1,304,612,8,210,426,6,38.0,>30,IND,Away,After 1965
N Wagner,NZ,Pace,2016-09-30,Eden Gardens,India,2016,2,102,210,3,1,483,1061,26,381,851,23,18.576923076923077,<=30,IND,Away,After 1965
N Wagner,NZ,Pace,2016-11-17,Christchurch,New Zealand,2016,2,47,150,3,1,500,1232,31,453,1082,28,16.129032258064516,<=30,NZ,Home,After 1965
N Wagner,NZ,Pace,2016-11-25,Hamilton,New Zealand,2016,2,116,205,6,1,921,1796,32,805,1591,26,28.78125,<=30,NZ,Home,After 1965
N Wagner,NZ,Pace,2017-01-12,Wellington,New Zealand,2017,2,188,354,6,1,1047,1639,21,859,1285,15,49.857142857142854,>30,NZ,Home,After 1965
N Wagner,NZ,Pace,2017-01-20,Christchurch,New Zealand,2017,2,88,180,4,1,735,1238,24,647,1058,20,30.625,>30,NZ,Home,After 1965
N Wagner,NZ,Pace,2017-03-08,Dunedin,New Zealand,2017,2,145,348,5,1,518,1198,16,373,850,11,32.375,>30,NZ,Home,After 1965
N Wagner,NZ,Pace,2017-03-16,Wellington,New Zealand,2017,2,120,180,4,1,662,1203,19,542,1023,15,34.8421052631579,>30,NZ,Home,After 1965
N Wagner,NZ,Pace,2017-03-25,Hamilton,New Zealand,2017,2,120,182,3,1,618,1215,19,498,1033,16,32.526315789473685,>30,NZ,Home,After 1965
N Wagner,NZ,Pace,2017-12-01,Wellington,New Zealand,2017,2,141,220,9,1,782,1474,25,641,1254,16,31.28,>30,NZ,Home,After 1965
N Wagner,NZ,Pace,2017-12-09,Hamilton,New Zealand,2017,2,115,180,5,1,876,1573,33,761,1393,28,26.545454545454547,<=30,NZ,Home,After 1965
N Wagner,NZ,Pace,2018-03-22,Auckland,New Zealand,2018,1,77,192,3,1,669,1504,24,592,1312,21,27.875,<=30,NZ,Home,After 1965
N Wagner,NZ,Pace,2018-03-30,Christchurch,New Zealand,2018,2,120,256,2,1,933,2022,34,813,1766,32,27.441176470588236,<=30,NZ,Home,After 1965
N Wagner,NZ,Pace,2018-11-16,Abu Dhabi,UAE,2018,2,57,186,3,1,312,840,18,255,654,15,17.333333333333332,<=30,UAE,Away,After 1965
N Wagner,NZ,Pace,2018-11-24,Dubai (DICS),UAE,2018,1,63,222,0,1,331,924,7,268,702,7,47.285714285714285,>30,UAE,Away,After 1965
N Wagner,NZ,Pace,2018-12-15,Wellington,New Zealand,2018,2,175,258,2,1,859,1641,18,684,1383,16,47.72222222222222,>30,NZ,Home,After 1965
N Wagner,NZ,Pace,2018-12-26,Christchurch,New Zealand,2018,2,58,204,4,1,838,1658,30,780,1454,26,27.933333333333334,<=30,NZ,Home,After 1965
N Wagner,NZ,Pace,2019-02-28,Hamilton,New Zealand,2019,2,151,242,7,1,1009,1490,23,858,1248,16,43.869565217391305,>30,NZ,Home,After 1965
N Wagner,NZ,Pace,2019-03-08,Wellington,New Zealand,2019,2,73,162,9,1,692,1031,24,619,869,15,28.833333333333332,<=30,NZ,Home,After 1965
N Wagner,NZ,Pace,2019-11-21,Mount Maunganui,New Zealand,2019,2,134,308,8,1,805,1856,23,671,1548,15,35.0,>30,NZ,Home,After 1965
N Wagner,NZ,Pace,2019-11-29,Hamilton,New Zealand,2019,1,124,215,5,1,881,1878,20,757,1663,15,44.05,>30,NZ,Home,After 1965
N Wagner,NZ,Pace,2019-12-12,Perth,Australia,2019,2,151,360,7,1,626,1383,31,475,1023,24,20.193548387096776,<=30,AUS,Away,After 1965
N Wagner,NZ,Pace,2019-12-26,Melbourne,Australia,2019,2,133,332,7,1,729,1616,26,596,1284,19,28.03846153846154,<=30,AUS,Away,After 1965
N Wagner,NZ,Pace,2020-01-03,Sydney,Australia,2020,2,103,253,3,1,593,1249,16,490,996,13,37.0625,>30,AUS,Away,After 1965
N Wagner,NZ,Pace,2020-02-29,Christchurch,New Zealand,2020,2,47,108,2,1,623,1219,30,576,1111,28,20.766666666666666,<=30,NZ,Home,After 1965
N Wagner,NZ,Pace,2020-12-03,Hamilton,New Zealand,2020,2,99,173,6,1,725,1439,25,626,1266,19,29.0,<=30,NZ,Home,After 1965
N Wagner,NZ,Pace,2020-12-11,Wellington,New Zealand,2020,2,82,175,3,1,834,1421,28,752,1246,25,29.785714285714285,<=30,NZ,Home,After 1965
N Wagner,NZ,Pace,2020-12-26,Mount Maunganui,New Zealand,2020,2,105,294,4,1,873,2105,28,768,1811,24,31.178571428571427,>30,NZ,Home,After 1965
N Wagner,NZ,Pace,2021-06-02,Lord's,England,2021,2,110,240,3,1,792,1822,27,682,1582,24,29.333333333333332,<=30,ENG,Away,After 1965
N Wagner,NZ,Pace,2021-06-10,Birmingham,England,2021,2,86,186,4,1,672,1387,27,586,1201,23,24.88888888888889,<=30,ENG,Away,After 1965
N Wagner,NZ,Pace,2021-06-18,Southampton,England,2021,2,84,180,3,1,643,1620,27,559,1440,24,23.814814814814813,<=30,ENG,Away,After 1965
N Wagner,NZ,Pace,2022-01-01,Mount Maunganui,New Zealand,2022,2,105,258,3,1,752,1693,25,647,1435,22,30.08,>30,NZ,Home,After 1965
N Wagner,NZ,Pace,2022-01-09,Christchurch,New Zealand,2022,2,100,174,3,1,738,1267,23,638,1093,20,32.08695652173913,>30,NZ,Home,After 1965
N Wagner,NZ,Pace,2022-02-17,Christchurch,New Zealand,2022,2,30,98,3,1,630,1205,28,600,1107,25,22.5,<=30,NZ,Home,After 1965
N Wagner,NZ,Pace,2022-02-25,Christchurch,New Zealand,2022,2,183,324,6,1,1098,2154,35,915,1830,29,31.37142857142857,>30,NZ,Home,After 1965
N Wagner,NZ,Pace,2022-06-23,Leeds,England,2022,2,108,120,2,1,862,1428,19,754,1308,17,45.36842105263158,>30,ENG,Away,After 1965
N Wagner,NZ,Pace,2022-12-26,Karachi,Pakistan,2022,2,73,144,1,1,287,569,4,214,425,3,71.75,>30,PAK,Away,After 1965
N Wagner,NZ,Pace,2023-02-16,Mount Maunganui,New Zealand,2023,2,192,176,6,1,901,1216,34,709,1040,28,26.5,<=30,NZ,Home,After 1965
N Wagner,NZ,Pace,2023-02-24,Wellington,New Zealand,2023,2,181,218,5,1,965,1553,25,784,1335,20,38.6,>30,NZ,Home,After 1965
N Wagner,NZ,Pace,2023-03-09,Christchurch,New Zealand,2023,2,77,78,0,1,1067,1960,32,990,1882,32,33.34375,>30,NZ,Home,After 1965
N Wagner,NZ,Pace,2024-02-13,Hamilton,New Zealand,2024,2,74,144,2,1,507,1179,18,433,1035,16,28.166666666666668,<=30,NZ,Home,After 1965
NA Foster,ENG,Pace,1983-08-11,Lord's,England,1983,2,75,168,1,1,667,1618,29,592,1450,28,23.0,<=30,ENG,Home,Upto 2014
NA Foster,ENG,Pace,1984-01-20,Wellington,New Zealand,1984,2,151,366,3,1,1002,2037,24,851,1671,21,41.75,>30,NZ,Away,Upto 2014
NA Foster,ENG,Pace,1984-02-10,Auckland,New Zealand,1984,1,78,180,1,1,656,1758,12,578,1578,11,54.666666666666664,>30,NZ,Away,Upto 2014
NA Foster,ENG,Pace,1984-03-12,Faisalabad,Pakistan,1984,2,119,210,2,1,538,960,13,419,750,11,41.38461538461539,>30,PAK,Away,Upto 2014
NA Foster,ENG,Pace,1984-03-19,Lahore,Pakistan,1984,2,111,282,5,1,528,1035,19,417,753,14,27.789473684210527,<=30,PAK,Away,Upto 2014
NA Foster,ENG,Pace,1984-06-28,Lord's,England,1984,2,82,108,0,1,986,1843,27,904,1735,27,36.51851851851852,>30,ENG,Home,Upto 2014
NA Foster,ENG,Pace,1985-01-13,Chennai,India,1985,2,163,306,11,1,557,887,19,394,581,8,29.31578947368421,<=30,IND,Away,Upto 2014
NA Foster,ENG,Pace,1985-01-31,Kanpur,India,1985,1,123,216,3,1,413,773,9,290,557,6,45.888888888888886,>30,IND,Away,Upto 2014
NA Foster,ENG,Pace,1985-06-27,Lord's,England,1985,1,83,138,1,1,753,1358,25,670,1220,24,30.12,>30,ENG,Home,Upto 2014
NA Foster,ENG,Pace,1986-03-21,Bridgetown,West Indies,1986,1,76,114,3,1,585,983,28,509,869,25,20.892857142857142,<=30,WI,Away,Upto 2014
NA Foster,ENG,Pace,1986-04-03,Port of Spain,West Indies,1986,2,83,161,2,1,614,1036,27,531,875,25,22.74074074074074,<=30,WI,Away,Upto 2014
NA Foster,ENG,Pace,1986-04-11,St John's,West Indies,1986,2,126,228,2,1,906,1622,22,780,1394,20,41.18181818181818,>30,WI,Away,Upto 2014
NA Foster,ENG,Pace,1986-07-03,Birmingham,England,1986,2,141,378,4,1,804,1599,21,663,1221,17,38.285714285714285,>30,ENG,Home,Upto 2014
NA Foster,ENG,Pace,1986-07-24,Lord's,England,1986,2,69,168,1,1,599,1428,17,530,1260,16,35.23529411764706,>30,ENG,Home,Upto 2014
NA Foster,ENG,Pace,1987-06-04,Manchester,England,1987,1,34,90,1,1,470,978,11,436,888,10,42.72727272727273,>30,ENG,Home,Upto 2014
NA Foster,ENG,Pace,1987-07-02,Leeds,England,1987,1,107,278,8,1,511,1279,29,404,1001,21,17.620689655172413,<=30,ENG,Home,Upto 2014
NA Foster,ENG,Pace,1987-07-23,Birmingham,England,1987,2,166,384,6,1,1037,2130,29,871,1746,23,35.758620689655174,>30,ENG,Home,Upto 2014
NA Foster,ENG,Pace,1987-08-06,The Oval,England,1987,1,32,72,0,1,607,1188,10,575,1116,10,60.7,>30,ENG,Home,Upto 2014
NA Foster,ENG,Pace,1987-11-25,Lahore,Pakistan,1987,1,58,138,2,1,221,462,3,163,324,1,73.66666666666667,>30,PAK,Away,Upto 2014
NA Foster,ENG,Pace,1987-12-07,Faisalabad,Pakistan,1987,2,46,126,4,1,157,324,5,111,198,1,31.4,>30,PAK,Away,Upto 2014
NA Foster,ENG,Pace,1988-01-29,Sydney,Australia,1988,2,54,204,2,1,421,1098,12,367,894,10,35.083333333333336,>30,AUS,Away,Upto 2014
NA Foster,ENG,Pace,1988-07-21,Leeds,England,1988,2,134,236,3,1,613,1328,28,479,1092,25,21.892857142857142,<=30,ENG,Home,Upto 2014
NA Foster,ENG,Pace,1988-08-04,The Oval,England,1988,2,116,204,6,1,629,1534,24,513,1330,18,26.208333333333332,<=30,ENG,Home,Upto 2014
NA Foster,ENG,Pace,1988-08-25,Lord's,England,1988,2,149,324,5,1,947,1904,31,798,1580,26,30.548387096774192,>30,ENG,Home,Upto 2014
NA Foster,ENG,Pace,1989-06-08,Leeds,England,1989,2,174,390,4,1,1372,2385,30,1198,1995,26,45.733333333333334,>30,ENG,Home,Upto 2014
NA Foster,ENG,Pace,1989-06-22,Lord's,England,1989,2,168,378,6,1,1092,2047,30,924,1669,24,36.4,>30,ENG,Home,Upto 2014
NA Foster,ENG,Pace,1989-07-27,Manchester,England,1989,2,79,234,2,1,673,1605,23,594,1371,21,29.26086956521739,<=30,ENG,Home,Upto 2014
NA Foster,ENG,Pace,1993-06-17,Lord's,England,1993,1,94,180,0,1,536,1020,6,442,840,6,89.33333333333333,>30,ENG,Home,Upto 2014
NA Knox,ENG,Pace,1907-07-29,Leeds,England,1907,1,13,18,1,1,113,315,7,100,297,6,16.142857142857142,<=30,ENG,Home,Upto 2014
NA Knox,ENG,Pace,1907-08-19,The Oval,England,1907,2,92,108,2,1,261,564,14,169,456,12,18.642857142857142,<=30,ENG,Home,Upto 2014
NA Mallender,ENG,Pace,1992-07-23,Leeds,England,1992,2,122,276,8,1,719,1557,27,597,1281,19,26.62962962962963,<=30,ENG,Home,Upto 2014
NA Mallender,ENG,Pace,1992-08-06,The Oval,England,1992,1,93,173,2,1,546,1176,25,453,1003,23,21.84,<=30,ENG,Home,Upto 2014
NA Quinn,SA,Pace,1929-06-15,Birmingham,England,1929,2,117,282,3,1,506,1355,18,389,1073,15,28.11111111111111,<=30,ENG,Away,Upto 2014
NA Quinn,SA,Pace,1929-07-13,Leeds,England,1929,2,138,281,6,1,359,767,10,221,486,4,35.9,>30,ENG,Away,Upto 2014
NA Quinn,SA,Pace,1929-07-27,Manchester,England,1929,1,95,186,2,1,396,1059,11,301,873,9,36.0,>30,ENG,Away,Upto 2014
NA Quinn,SA,Pace,1929-08-17,The Oval,England,1929,2,91,237,2,1,426,1011,9,335,774,7,47.333333333333336,>30,ENG,Away,Upto 2014
NA Quinn,SA,Pace,1931-01-16,Durban,South Africa,1931,1,42,114,0,1,276,836,9,234,722,9,30.666666666666668,>30,SA,Home,Upto 2014
NA Quinn,SA,Pace,1931-11-27,Brisbane,Australia,1931,1,113,231,2,1,377,952,14,264,721,12,26.928571428571427,<=30,AUS,Away,Upto 2014
NA Quinn,SA,Pace,1931-12-18,Sydney,Australia,1931,1,95,252,1,1,383,911,14,288,659,13,27.357142857142858,<=30,AUS,Away,Upto 2014
NA Quinn,SA,Pace,1931-12-31,Melbourne,Australia,1931,2,155,406,5,1,596,1454,16,441,1048,11,37.25,>30,AUS,Away,Upto 2014
NA Quinn,SA,Pace,1932-01-29,Adelaide,Australia,1932,2,119,240,2,1,508,1020,9,389,780,7,56.44444444444444,>30,AUS,Away,Upto 2014
NA Quinn,SA,Pace,1932-02-12,Melbourne,Australia,1932,1,29,117,3,1,107,351,12,78,234,9,8.916666666666666,<=30,AUS,Away,Upto 2014
NA Quinn,SA,Pace,1932-02-27,Christchurch,New Zealand,1932,2,63,264,3,1,481,1211,11,418,947,8,43.72727272727273,>30,NZ,Away,Upto 2014
NA Quinn,SA,Pace,1932-03-04,Wellington,New Zealand,1932,2,88,312,6,1,449,1052,12,361,740,6,37.416666666666664,>30,NZ,Away,Upto 2014
NA Saini,IND,Pace,2021-01-07,Sydney,Australia,2021,2,119,174,4,1,762,1640,19,643,1466,15,40.10526315789474,>30,AUS,Away,After 1965
NA Saini,IND,Pace,2021-01-15,Brisbane,Australia,2021,2,53,77,0,1,950,1738,30,897,1661,30,31.666666666666668,>30,AUS,Away,After 1965
NAM McLean,WI,Pace,1998-02-05,Port of Spain,West Indies,1998,2,74,186,3,1,715,1728,33,641,1542,30,21.666666666666668,<=30,WI,Home,Upto 2014
NAM McLean,WI,Pace,1998-02-13,Port of Spain,West Indies,1998,2,40,78,0,1,618,1619,31,578,1541,31,19.93548387096774,<=30,WI,Home,Upto 2014
NAM McLean,WI,Pace,1998-03-12,Bridgetown,West Indies,1998,2,89,204,2,1,686,1395,17,597,1191,15,40.35294117647059,>30,WI,Home,Upto 2014
NAM McLean,WI,Pace,1998-11-26,Johannesburg,South Africa,1998,2,83,132,3,1,642,1519,31,559,1387,28,20.70967741935484,<=30,SA,Away,Upto 2014
NAM McLean,WI,Pace,1998-12-10,Gqeberha,South Africa,1998,2,85,144,2,1,639,1208,36,554,1064,34,17.75,<=30,SA,Away,Upto 2014
NAM McLean,WI,Pace,1999-01-02,Cape Town,South Africa,1999,2,129,251,5,1,785,1771,27,656,1520,22,29.074074074074073,<=30,SA,Away,Upto 2014
NAM McLean,WI,Pace,1999-01-15,Centurion,South Africa,1999,2,160,249,2,1,776,1416,26,616,1167,24,29.846153846153847,<=30,SA,Away,Upto 2014
NAM McLean,WI,Pace,2000-05-05,Georgetown,West Indies,2000,1,93,156,2,1,344,903,13,251,747,11,26.46153846153846,<=30,WI,Home,Upto 2014
NAM McLean,WI,Pace,2000-05-18,Bridgetown,West Indies,2000,2,175,238,3,1,788,1618,23,613,1380,20,34.26086956521739,>30,WI,Home,Upto 2014
NAM McLean,WI,Pace,2000-08-17,Leeds,England,2000,1,93,132,1,1,405,817,24,312,685,23,16.875,<=30,ENG,Away,Upto 2014
NAM McLean,WI,Pace,2000-08-31,The Oval,England,2000,2,140,306,6,1,613,1636,30,473,1330,24,20.433333333333334,<=30,ENG,Away,Upto 2014
NAM McLean,WI,Pace,2000-11-23,Brisbane,Australia,2000,1,79,150,0,1,456,1175,24,377,1025,24,19.0,<=30,AUS,Away,Upto 2014
NAM McLean,WI,Pace,2000-12-01,W.A.C.A,Australia,2000,1,78,132,2,1,637,1158,23,559,1026,21,27.695652173913043,<=30,AUS,Away,Upto 2014
NAM McLean,WI,Pace,2000-12-15,Adelaide,Australia,2000,2,78,156,2,1,620,1329,20,542,1173,18,31.0,>30,AUS,Away,Upto 2014
NAM McLean,WI,Pace,2000-12-26,Melbourne,Australia,2000,2,125,216,3,1,686,1407,27,561,1191,24,25.40740740740741,<=30,AUS,Away,Upto 2014
NAM McLean,WI,Pace,2001-01-02,Sydney,Australia,2001,2,116,168,2,1,570,1068,13,454,900,11,43.84615384615385,>30,AUS,Away,Upto 2014
NAM McLean,WI,Pace,2001-03-09,Georgetown,West Indies,2001,2,100,192,3,1,709,1722,18,609,1530,15,39.388888888888886,>30,WI,Home,Upto 2014
NAM McLean,WI,Pace,2001-03-17,Port of Spain,West Indies,2001,2,136,209,3,1,814,1972,34,678,1763,31,23.941176470588236,<=30,WI,Home,Upto 2014
NAT Adcock,SA,Pace,1953-12-11,Durban,South Africa,1953,2,90,264,3,1,403,1104,13,313,840,10,31.0,>30,SA,Home,Upto 2014
NAT Adcock,SA,Pace,1953-12-24,Johannesburg,South Africa,1953,2,87,264,8,1,463,1350,29,376,1086,21,15.96551724137931,<=30,SA,Home,Upto 2014
NAT Adcock,SA,Pace,1954-01-01,Cape Town,South Africa,1954,1,105,232,1,1,315,963,9,210,731,8,35.0,>30,SA,Home,Upto 2014
NAT Adcock,SA,Pace,1954-01-29,Johannesburg,South Africa,1954,2,72,299,6,1,358,1413,20,286,1114,14,17.9,<=30,SA,Home,Upto 2014
NAT Adcock,SA,Pace,1954-02-05,Gqeberha,South Africa,1954,2,131,304,6,1,339,985,18,208,681,12,18.833333333333332,<=30,SA,Home,Upto 2014
NAT Adcock,SA,Pace,1955-06-09,Nottingham,England,1955,1,74,216,2,1,443,1507,20,369,1291,18,22.15,<=30,ENG,Away,Upto 2014
NAT Adcock,SA,Pace,1955-06-23,Lord's,England,1955,2,74,198,2,1,632,1622,27,558,1424,25,23.40740740740741,<=30,ENG,Away,Upto 2014
NAT Adcock,SA,Pace,1955-07-07,Manchester,England,1955,2,100,336,6,1,835,1929,28,735,1593,22,29.821428571428573,<=30,ENG,Away,Upto 2014
NAT Adcock,SA,Pace,1955-07-21,Leeds,England,1955,1,4,24,0,1,618,1800,24,614,1776,24,25.75,<=30,ENG,Away,Upto 2014
NAT Adcock,SA,Pace,1956-12-24,Johannesburg,South Africa,1956,2,69,264,7,1,465,1730,29,396,1466,22,16.03448275862069,<=30,SA,Home,Upto 2014
NAT Adcock,SA,Pace,1957-01-01,Cape Town,South Africa,1957,2,62,202,3,1,496,1551,13,434,1349,10,38.15384615384615,>30,SA,Home,Upto 2014
NAT Adcock,SA,Pace,1957-01-25,Durban,South Africa,1957,2,78,291,4,1,495,1563,15,417,1272,11,33.0,>30,SA,Home,Upto 2014
NAT Adcock,SA,Pace,1957-02-15,Johannesburg,South Africa,1957,2,74,232,2,1,520,1730,17,446,1498,15,30.58823529411765,>30,SA,Home,Upto 2014
NAT Adcock,SA,Pace,1957-03-01,Gqeberha,South Africa,1957,2,30,147,5,1,275,1498,30,245,1351,25,9.166666666666666,<=30,SA,Home,Upto 2014
NAT Adcock,SA,Pace,1957-12-23,Johannesburg,South Africa,1957,2,117,208,1,1,682,1716,24,565,1508,23,28.416666666666668,<=30,SA,Home,Upto 2014
NAT Adcock,SA,Pace,1957-12-31,Cape Town,South Africa,1957,1,80,216,1,1,357,1102,8,277,886,7,44.625,>30,SA,Home,Upto 2014
NAT Adcock,SA,Pace,1958-01-24,Durban,South Africa,1958,2,77,264,7,1,460,1804,17,383,1540,10,27.058823529411764,<=30,SA,Home,Upto 2014
NAT Adcock,SA,Pace,1958-02-07,Johannesburg,South Africa,1958,1,37,136,2,1,425,1453,14,388,1317,12,30.357142857142858,>30,SA,Home,Upto 2014
NAT Adcock,SA,Pace,1958-02-28,Gqeberha,South Africa,1958,2,99,224,3,1,429,1409,18,330,1185,15,23.833333333333332,<=30,SA,Home,Upto 2014
NAT Adcock,SA,Pace,1960-06-09,Birmingham,England,1960,2,119,419,8,1,549,1558,25,430,1139,17,21.96,<=30,ENG,Away,Upto 2014
NAT Adcock,SA,Pace,1960-06-23,Lord's,England,1960,1,70,216,3,1,549,1209,28,479,993,25,19.607142857142858,<=30,ENG,Away,Upto 2014
NAT Adcock,SA,Pace,1960-07-07,Nottingham,England,1960,2,102,226,1,1,545,1319,26,443,1093,25,20.96153846153846,<=30,ENG,Away,Upto 2014
NAT Adcock,SA,Pace,1960-07-21,Manchester,England,1960,2,125,300,7,1,475,1326,23,350,1026,16,20.652173913043477,<=30,ENG,Away,Upto 2014
NAT Adcock,SA,Pace,1960-08-18,The Oval,England,1960,2,171,417,7,1,792,1752,24,621,1335,17,33.0,>30,ENG,Away,Upto 2014
NAT Adcock,SA,Pace,1962-02-02,Johannesburg,South Africa,1962,2,63,204,5,1,533,1091,23,470,887,18,23.17391304347826,<=30,SA,Home,Upto 2014
NAT Adcock,SA,Pace,1962-02-16,Gqeberha,South Africa,1962,2,85,288,4,1,563,1365,25,478,1077,21,22.52,<=30,SA,Home,Upto 2014
NB Mahwire,ZIM,Pace,2002-11-09,Harare,Zimbabwe,2002,2,118,173,1,1,875,1422,31,757,1249,30,28.225806451612904,<=30,ZIM,Home,Upto 2014
NB Mahwire,ZIM,Pace,2003-10-17,Sydney,Australia,2003,1,61,60,0,1,646,1058,15,585,998,15,43.06666666666667,>30,AUS,Away,Upto 2014
NB Mahwire,ZIM,Pace,2003-11-04,Harare,Zimbabwe,2003,2,85,162,2,1,904,1627,24,819,1465,22,37.666666666666664,>30,ZIM,Home,Upto 2014
NB Mahwire,ZIM,Pace,2003-11-12,Bulawayo,Zimbabwe,2003,2,95,102,0,1,595,1210,25,500,1108,25,23.8,<=30,ZIM,Home,Upto 2014
NB Mahwire,ZIM,Pace,2004-02-26,Bulawayo,Zimbabwe,2004,1,36,60,0,1,218,510,6,182,450,6,36.333333333333336,>30,ZIM,Home,Upto 2014
NB Mahwire,ZIM,Pace,2004-05-06,Harare,Zimbabwe,2004,1,97,108,3,1,612,996,20,515,888,17,30.6,>30,ZIM,Home,Upto 2014
NB Mahwire,ZIM,Pace,2005-08-07,Harare,Zimbabwe,2005,1,115,156,3,1,432,774,20,317,618,17,21.6,<=30,ZIM,Home,Upto 2014
NB Mahwire,ZIM,Pace,2005-08-15,Bulawayo,Zimbabwe,2005,1,121,151,3,1,584,919,19,463,768,16,30.736842105263158,>30,ZIM,Home,Upto 2014
NB Mahwire,ZIM,Pace,2005-09-13,Bulawayo,Zimbabwe,2005,1,92,153,4,1,492,794,18,400,641,14,27.333333333333332,<=30,ZIM,Home,Upto 2014
NB Mahwire,ZIM,Pace,2005-09-20,Harare,Zimbabwe,2005,2,95,162,2,1,559,997,27,464,835,25,20.703703703703702,<=30,ZIM,Home,Upto 2014
NBF Mann,SA,Spin,1947-06-07,Nottingham,England,1947,2,104,480,1,1,885,2189,17,781,1709,16,52.05882352941177,>30,ENG,Away,Upto 2014
NBF Mann,SA,Spin,1947-06-21,Lord's,England,1947,2,115,337,1,1,699,1857,18,584,1520,17,38.833333333333336,>30,ENG,Away,Upto 2014
NBF Mann,SA,Spin,1947-07-05,Manchester,England,1947,2,104,294,3,1,418,900,10,314,606,7,41.8,>30,ENG,Away,Upto 2014
NBF Mann,SA,Spin,1947-07-26,Leeds,England,1947,2,85,322,4,1,420,1282,10,335,960,6,42.0,>30,ENG,Away,Upto 2014
NBF Mann,SA,Spin,1947-08-16,The Oval,England,1947,2,195,546,6,1,893,1980,23,698,1434,17,38.82608695652174,>30,ENG,Away,Upto 2014
NBF Mann,SA,Spin,1948-12-16,Durban,South Africa,1948,2,72,316,7,1,426,1415,21,354,1099,14,20.285714285714285,<=30,SA,Home,Upto 2014
NBF Mann,SA,Spin,1948-12-27,Johannesburg,South Africa,1948,1,107,240,3,1,725,1588,13,618,1348,10,55.76923076923077,>30,SA,Home,Upto 2014
NBF Mann,SA,Spin,1949-01-01,Cape Town,South Africa,1949,2,45,144,0,1,568,1444,18,523,1300,18,31.555555555555557,>30,SA,Home,Upto 2014
NBF Mann,SA,Spin,1949-02-12,Johannesburg,South Africa,1949,2,46,136,0,1,470,1288,10,424,1152,10,47.0,>30,SA,Home,Upto 2014
NBF Mann,SA,Spin,1949-03-05,Gqeberha,South Africa,1949,2,160,487,7,1,750,1935,20,590,1448,13,37.5,>30,SA,Home,Upto 2014
NBF Mann,SA,Spin,1949-12-24,Johannesburg,South Africa,1949,1,92,228,2,1,426,1143,20,334,915,18,21.3,<=30,SA,Home,Upto 2014
NBF Mann,SA,Spin,1949-12-31,Cape Town,South Africa,1949,2,128,288,6,1,803,1732,19,675,1444,13,42.26315789473684,>30,SA,Home,Upto 2014
NBF Mann,SA,Spin,1950-01-20,Durban,South Africa,1950,2,132,494,6,1,552,1758,29,420,1264,23,19.03448275862069,<=30,SA,Home,Upto 2014
NBF Mann,SA,Spin,1950-02-10,Johannesburg,South Africa,1950,2,117,264,0,1,517,1176,4,400,912,4,129.25,>30,SA,Home,Upto 2014
NBF Mann,SA,Spin,1950-03-03,Gqeberha,South Africa,1950,1,154,288,2,1,463,890,16,309,602,14,28.9375,<=30,SA,Home,Upto 2014
NBF Mann,SA,Spin,1951-06-07,Nottingham,England,1951,2,75,264,4,1,552,1676,17,477,1412,13,32.470588235294116,>30,ENG,Away,Upto 2014
NBF Mann,SA,Spin,1951-06-21,Lord's,England,1951,1,51,192,1,1,361,954,17,310,762,16,21.235294117647058,<=30,ENG,Away,Upto 2014
NBF Mann,SA,Spin,1951-07-05,Manchester,England,1951,2,42,111,2,1,293,819,11,251,708,9,26.636363636363637,<=30,ENG,Away,Upto 2014
NBF Mann,SA,Spin,1951-07-26,Leeds,England,1951,1,96,365,3,1,749,2072,16,653,1707,13,46.8125,>30,ENG,Away,Upto 2014
NC Johnson,ZIM,Pace,1998-10-07,Harare,Zimbabwe,1998,2,105,196,4,1,643,1431,26,538,1235,22,24.73076923076923,<=30,ZIM,Home,Upto 2014
NC Johnson,ZIM,Pace,1998-11-27,Peshawar,Pakistan,1998,2,89,144,1,1,700,1353,31,611,1209,30,22.580645161290324,<=30,PAK,Away,Upto 2014
NC Johnson,ZIM,Pace,1998-12-10,Lahore,Pakistan,1998,1,71,144,2,1,457,1020,11,386,876,9,41.54545454545455,>30,PAK,Away,Upto 2014
NC Johnson,ZIM,Pace,1999-10-14,Harare,Zimbabwe,1999,1,14,12,0,1,535,1322,16,521,1310,16,33.4375,>30,ZIM,Home,Upto 2014
NC Johnson,ZIM,Pace,1999-10-29,Bloemfontein,South Africa,1999,1,8,12,0,1,728,1549,24,720,1537,24,30.333333333333332,>30,SA,Away,Upto 2014
NC Johnson,ZIM,Pace,2000-03-16,Port of Spain,West Indies,2000,2,44,102,1,1,483,1518,30,439,1416,29,16.1,<=30,WI,Away,Upto 2014
NC Johnson,ZIM,Pace,2000-03-24,Kingston,West Indies,2000,2,104,252,4,1,544,1582,25,440,1330,21,21.76,<=30,WI,Away,Upto 2014
NC Johnson,ZIM,Pace,2000-05-18,Lord's,England,2000,1,55,120,0,1,527,1078,29,472,958,29,18.17241379310345,<=30,ENG,Away,Upto 2014
NC Johnson,ZIM,Pace,2000-06-01,Nottingham,England,2000,2,104,204,3,1,655,1521,23,551,1317,20,28.47826086956522,<=30,ENG,Away,Upto 2014
NC McGarrell,WI,Spin,2001-04-06,St John's,West Indies,2001,2,113,348,5,1,425,1266,13,312,918,8,32.69230769230769,>30,WI,Home,Upto 2014
NC McGarrell,WI,Spin,2001-07-19,Bulawayo,Zimbabwe,2001,2,60,216,5,1,317,696,7,257,480,2,45.285714285714285,>30,ZIM,Away,Upto 2014
NC McGarrell,WI,Spin,2001-07-27,Harare,Zimbabwe,2001,2,185,462,7,1,386,944,10,201,482,3,38.6,>30,ZIM,Away,Upto 2014
NC McGarrell,WI,Spin,2001-11-13,Galle,Sri Lanka,2001,1,95,186,0,1,681,1597,17,586,1411,17,40.05882352941177,>30,SL,Away,Upto 2014
NCL O'Neill,AUS,Spin,1959-01-30,Adelaide,Australia,1959,1,8,16,0,1,300,723,9,292,707,9,33.333333333333336,>30,AUS,Home,Upto 2014
NCL O'Neill,AUS,Spin,1959-11-21,Lahore,Pakistan,1959,1,37,78,1,1,563,1378,18,526,1300,17,31.27777777777778,>30,PAK,Away,Upto 2014
NCL O'Neill,AUS,Spin,1959-12-04,Karachi,Pakistan,1959,1,4,24,0,1,235,677,9,231,653,9,26.11111111111111,<=30,PAK,Away,Upto 2014
NCL O'Neill,AUS,Spin,1959-12-12,Delhi,India,1959,2,23,36,0,1,348,919,18,325,883,18,19.333333333333332,<=30,IND,Away,Upto 2014
NCL O'Neill,AUS,Spin,1959-12-19,Kanpur,India,1959,1,12,12,0,1,496,1305,26,484,1293,26,19.076923076923077,<=30,IND,Away,Upto 2014
NCL O'Neill,AUS,Spin,1960-01-01,Brabourne,India,1960,1,16,18,0,1,351,876,9,335,858,9,39.0,>30,IND,Away,Upto 2014
NCL O'Neill,AUS,Spin,1960-12-09,Brisbane,Australia,1960,1,2,8,0,1,778,1958,13,776,1950,13,59.84615384615385,>30,AUS,Home,Upto 2014
NCL O'Neill,AUS,Spin,1960-12-30,Melbourne,Australia,1960,1,10,40,1,1,443,1051,13,433,1011,12,34.07692307692308,>30,AUS,Home,Upto 2014
NCL O'Neill,AUS,Spin,1961-08-17,The Oval,England,1961,1,13,24,0,1,415,906,9,402,882,9,46.111111111111114,>30,ENG,Away,Upto 2014
NCL O'Neill,AUS,Spin,1962-11-30,Brisbane,Australia,1962,2,5,24,0,1,507,1344,11,502,1320,11,46.09090909090909,>30,AUS,Home,Upto 2014
NCL O'Neill,AUS,Spin,1962-12-29,Melbourne,Australia,1962,1,19,40,0,1,341,714,6,322,674,6,56.833333333333336,>30,AUS,Home,Upto 2014
NCL O'Neill,AUS,Spin,1963-01-11,Sydney,Australia,1963,1,7,56,1,1,280,848,15,273,792,14,18.666666666666668,<=30,AUS,Home,Upto 2014
NCL O'Neill,AUS,Spin,1963-01-25,Adelaide,Australia,1963,1,49,64,0,1,524,1033,6,475,969,6,87.33333333333333,>30,AUS,Home,Upto 2014
NCL O'Neill,AUS,Spin,1963-02-15,Sydney,Australia,1963,1,38,80,1,1,588,2042,17,550,1962,16,34.588235294117645,>30,AUS,Home,Upto 2014
NCL O'Neill,AUS,Spin,1963-12-06,Brisbane,Australia,1963,1,20,56,1,1,346,1069,8,326,1013,7,43.25,>30,AUS,Home,Upto 2014
NCL O'Neill,AUS,Spin,1964-01-10,Sydney,Australia,1964,2,75,152,1,1,363,985,5,288,833,4,72.6,>30,AUS,Home,Upto 2014
NCL O'Neill,AUS,Spin,1964-02-07,Sydney,Australia,1964,1,2,16,1,1,341,1120,10,339,1104,9,34.1,>30,AUS,Home,Upto 2014
NCL O'Neill,AUS,Spin,1964-07-23,Manchester,England,1964,1,37,60,0,1,477,1315,3,440,1255,3,159.0,>30,ENG,Away,Upto 2014
NCL O'Neill,AUS,Spin,1964-10-02,Chennai,India,1964,2,60,96,1,1,735,1918,23,675,1822,22,31.956521739130434,>30,IND,Away,Upto 2014
NCL O'Neill,AUS,Spin,1965-03-03,Kingston,West Indies,1965,1,34,42,1,1,482,1161,15,448,1119,14,32.13333333333333,>30,WI,Away,Upto 2014
NCL O'Neill,AUS,Spin,1965-03-26,Port of Spain,West Indies,1965,2,106,250,5,1,736,1898,17,630,1648,12,43.294117647058826,>30,WI,Away,Upto 2014
NCL O'Neill,AUS,Spin,1965-04-14,Georgetown,West Indies,1965,2,30,44,2,1,385,975,21,355,931,19,18.333333333333332,<=30,WI,Away,Upto 2014
NCL O'Neill,AUS,Spin,1965-05-05,Bridgetown,West Indies,1965,1,60,156,1,1,856,1946,10,796,1790,9,85.6,>30,WI,Away,Upto 2014
ND Hirwani,IND,Spin,1988-01-11,Chennai,India,1988,2,136,203,16,1,536,1127,23,400,924,7,23.304347826086957,<=30,IND,Home,Upto 2014
ND Hirwani,IND,Spin,1988-11-12,Bengaluru,India,1988,2,121,366,8,1,620,1702,21,499,1336,13,29.523809523809526,<=30,IND,Home,Upto 2014
ND Hirwani,IND,Spin,1988-11-24,Wankhede,India,1988,2,175,414,7,1,479,1162,25,304,748,18,19.16,<=30,IND,Home,Upto 2014
ND Hirwani,IND,Spin,1988-12-02,Hyderabad (Deccan),India,1988,2,94,228,5,1,319,748,13,225,520,8,24.53846153846154,<=30,IND,Home,Upto 2014
ND Hirwani,IND,Spin,1989-03-25,Georgetown,West Indies,1989,1,106,174,1,1,322,618,6,216,444,5,53.666666666666664,>30,WI,Away,Upto 2014
ND Hirwani,IND,Spin,1989-04-07,Bridgetown,West Indies,1989,2,139,204,2,1,380,726,8,241,522,6,47.5,>30,WI,Away,Upto 2014
ND Hirwani,IND,Spin,1989-04-15,Port of Spain,West Indies,1989,2,99,231,3,1,406,1089,11,307,858,8,36.90909090909091,>30,WI,Away,Upto 2014
ND Hirwani,IND,Spin,1990-02-02,Christchurch,New Zealand,1990,1,60,174,2,1,205,522,7,145,348,5,29.285714285714285,<=30,NZ,Away,Upto 2014
ND Hirwani,IND,Spin,1990-02-09,Napier,New Zealand,1990,1,40,108,0,1,117,306,0,77,198,0,inf,>30,NZ,Away,Upto 2014
ND Hirwani,IND,Spin,1990-02-22,Auckland,New Zealand,1990,2,209,378,4,1,382,711,6,173,333,2,63.666666666666664,>30,NZ,Away,Upto 2014
ND Hirwani,IND,Spin,1990-07-26,Lord's,England,1990,2,152,246,2,1,488,672,6,336,426,4,81.33333333333333,>30,ENG,Away,Upto 2014
ND Hirwani,IND,Spin,1990-08-09,Manchester,England,1990,2,226,462,5,1,724,1465,14,498,1003,9,51.714285714285715,>30,ENG,Away,Upto 2014
ND Hirwani,IND,Spin,1990-08-23,The Oval,England,1990,2,208,564,2,1,500,1062,6,292,498,4,83.33333333333333,>30,ENG,Away,Upto 2014
ND Hirwani,IND,Spin,1990-11-23,Chandigarh,India,1990,1,34,120,1,1,286,1097,16,252,977,15,17.875,<=30,IND,Home,Upto 2014
ND Hirwani,IND,Spin,1995-11-08,Cuttack,India,1995,1,59,186,6,1,195,570,8,136,384,2,24.375,<=30,IND,Home,Upto 2014
ND Hirwani,IND,Spin,1996-11-20,Ahmedabad,India,1996,1,38,90,2,1,390,956,20,352,866,18,19.5,<=30,IND,Home,Upto 2014
ND Hirwani,IND,Spin,1996-11-27,Eden Gardens,India,1996,2,91,150,0,1,508,781,6,417,631,6,84.66666666666667,>30,IND,Home,Upto 2014
ND McKenzie,SA,Pace,2001-11-16,Gqeberha,South Africa,2001,1,4,6,0,1,644,1436,22,640,1430,22,29.272727272727273,<=30,SA,Home,Upto 2014
ND McKenzie,SA,Pace,2002-02-22,Johannesburg,South Africa,2002,1,50,48,0,1,698,1059,20,648,1011,20,34.9,>30,SA,Home,Upto 2014
ND McKenzie,SA,Pace,2004-03-10,Hamilton,New Zealand,2004,1,1,6,0,1,760,1661,15,759,1655,15,50.666666666666664,>30,NZ,Away,Upto 2014
ND McKenzie,SA,Pace,2004-03-18,Auckland,New Zealand,2004,1,8,12,0,1,1016,1973,29,1008,1961,29,35.03448275862069,>30,NZ,Away,Upto 2014
ND McKenzie,SA,Pace,2008-02-22,Mirpur,Bangladesh,2008,1,4,12,0,1,379,784,18,375,772,18,21.055555555555557,<=30,BAN,Away,Upto 2014
ND McKenzie,SA,Pace,2008-11-26,Centurion,South Africa,2008,1,1,6,0,1,529,990,19,528,984,19,27.842105263157894,<=30,SA,Home,Upto 2014
NE Bonner,WI,Spin,2021-02-03,Chattogram,Bangladesh,2021,2,29,30,1,1,955,2045,28,926,2015,27,34.107142857142854,>30,BAN,Away,After 1965
NE Bonner,WI,Spin,2021-02-11,Mirpur,Bangladesh,2021,1,17,18,0,1,665,1522,28,648,1504,28,23.75,<=30,BAN,Away,After 1965
NE Bonner,WI,Spin,2021-08-20,Kingston,West Indies,2021,1,6,6,0,1,122,240,4,116,234,4,30.5,>30,WI,Home,After 1965
NE Bonner,WI,Spin,2021-11-29,Galle,Sri Lanka,2021,1,9,18,0,1,790,1806,36,781,1788,36,21.944444444444443,<=30,SL,Away,After 1965
NE Bonner,WI,Spin,2022-03-08,North Sound,West Indies,2022,1,8,6,0,1,307,730,6,299,724,6,51.166666666666664,>30,WI,Home,After 1965
NE Bonner,WI,Spin,2022-03-16,Bridgetown,West Indies,2022,1,3,6,0,1,465,1126,13,462,1120,13,35.76923076923077,>30,WI,Home,After 1965
NE Bonner,WI,Spin,2022-03-24,St George's,West Indies,2022,1,10,30,0,1,75,217,2,65,187,2,37.5,>30,WI,Home,After 1965
NE Haig,ENG,Pace,1921-06-11,Lord's,England,1921,2,88,138,2,1,453,764,17,365,626,15,26.647058823529413,<=30,ENG,Home,Upto 2014
NE Haig,ENG,Pace,1930-01-11,Bridgetown,West Indies,1930,2,67,180,1,1,797,1692,15,730,1512,14,53.13333333333333,>30,WI,Away,Upto 2014
NE Haig,ENG,Pace,1930-02-01,Port of Spain,West Indies,1930,2,66,174,3,1,688,1491,29,622,1317,26,23.724137931034484,<=30,WI,Away,Upto 2014
NE Haig,ENG,Pace,1930-02-21,Georgetown,West Indies,1930,2,105,198,3,1,688,1706,25,583,1508,22,27.52,<=30,WI,Away,Upto 2014
NE Haig,ENG,Pace,1930-04-03,Kingston,West Indies,1930,2,122,336,4,1,684,1474,14,562,1138,10,48.857142857142854,>30,WI,Away,Upto 2014
NE Marshall,WI,Spin,1955-04-26,Georgetown,West Indies,1955,2,62,279,2,1,484,1365,24,422,1086,22,20.166666666666668,<=30,WI,Home,Upto 2014
NF Williams,ENG,Pace,1990-08-23,The Oval,England,1990,1,148,246,2,1,853,1642,16,705,1396,14,53.3125,>30,ENG,Home,Upto 2014
NFD Thomson,AUS,Spin,1877-03-15,Melbourne,Australia,1877,1,14,68,1,1,437,1296,31,423,1228,30,14.096774193548388,<=30,AUS,Home,After 1965
NFD Thomson,AUS,Spin,1877-03-31,Melbourne,Australia,1877,1,17,44,0,1,437,1222,21,420,1178,21,20.80952380952381,<=30,AUS,Home,After 1965
NG Cowans,ENG,Pace,1982-11-12,W.A.C.A,Australia,1982,2,69,96,0,1,850,1760,19,781,1664,19,44.73684210526316,>30,AUS,Away,Upto 2014
NG Cowans,ENG,Pace,1982-11-26,Brisbane,Australia,1982,2,67,90,1,1,686,1313,27,619,1223,26,25.40740740740741,<=30,AUS,Away,Upto 2014
NG Cowans,ENG,Pace,1982-12-26,Melbourne,Australia,1982,2,146,252,8,1,837,1586,32,691,1334,24,26.15625,<=30,AUS,Away,Upto 2014
NG Cowans,ENG,Pace,1983-01-02,Sydney,Australia,1983,2,114,204,2,1,595,1175,21,481,971,19,28.333333333333332,<=30,AUS,Away,Upto 2014
NG Cowans,ENG,Pace,1983-07-14,The Oval,England,1983,2,101,180,1,1,726,1662,20,625,1482,19,36.3,>30,ENG,Home,Upto 2014
NG Cowans,ENG,Pace,1983-07-28,Leeds,England,1983,2,111,198,3,1,786,1782,32,675,1584,29,24.5625,<=30,ENG,Home,Upto 2014
NG Cowans,ENG,Pace,1983-08-11,Lord's,England,1983,2,66,120,2,1,667,1618,29,601,1498,27,23.0,<=30,ENG,Home,Upto 2014
NG Cowans,ENG,Pace,1983-08-25,Nottingham,England,1983,2,169,252,6,1,763,1600,21,594,1348,15,36.333333333333336,>30,ENG,Home,Upto 2014
NG Cowans,ENG,Pace,1984-02-03,Christchurch,New Zealand,1984,1,52,84,3,1,404,927,25,352,843,22,16.16,<=30,NZ,Away,Upto 2014
NG Cowans,ENG,Pace,1984-02-10,Auckland,New Zealand,1984,2,102,228,2,1,656,1758,12,554,1530,10,54.666666666666664,>30,NZ,Away,Upto 2014
NG Cowans,ENG,Pace,1984-03-02,Karachi,Pakistan,1984,2,44,87,0,1,284,740,10,240,653,10,28.4,<=30,PAK,Away,Upto 2014
NG Cowans,ENG,Pace,1984-03-19,Lahore,Pakistan,1984,2,131,258,7,1,528,1035,19,397,777,12,27.789473684210527,<=30,PAK,Away,Upto 2014
NG Cowans,ENG,Pace,1984-07-26,Manchester,England,1984,1,76,114,0,1,536,1172,18,460,1058,18,29.77777777777778,<=30,ENG,Home,Upto 2014
NG Cowans,ENG,Pace,1984-11-28,Wankhede,India,1984,2,127,198,3,1,378,744,6,251,546,3,63.0,>30,IND,Away,Upto 2014
NG Cowans,ENG,Pace,1984-12-12,Delhi,India,1984,2,113,198,2,1,406,798,8,293,600,6,50.75,>30,IND,Away,Upto 2014
NG Cowans,ENG,Pace,1984-12-31,Eden Gardens,India,1984,2,109,270,3,1,288,729,8,179,459,5,36.0,>30,IND,Away,Upto 2014
NG Cowans,ENG,Pace,1985-01-13,Chennai,India,1985,2,112,167,4,1,557,887,19,445,720,15,29.31578947368421,<=30,IND,Away,Upto 2014
NG Cowans,ENG,Pace,1985-01-31,Kanpur,India,1985,2,166,258,2,1,413,773,9,247,515,7,45.888888888888886,>30,IND,Away,Upto 2014
NG Cowans,ENG,Pace,1985-06-13,Leeds,England,1985,2,128,198,2,1,1140,1931,28,1012,1733,26,40.714285714285715,>30,ENG,Home,Upto 2014
NG Smith,NZ,Spin,2024-11-28,Christchurch,New Zealand,2024,2,179,178,3,1,459,659,17,280,481,14,27.0,<=30,NZ,Home,After 1965
NG Smith,NZ,Spin,2024-12-06,Wellington,New Zealand,2024,2,160,166,4,1,476,526,13,316,360,9,36.61538461538461,>30,NZ,Home,After 1965
NGB Cook,ENG,Spin,1983-08-11,Lord's,England,1983,2,125,320,8,1,227,566,11,102,246,3,20.636363636363637,<=30,ENG,Home,Upto 2014
NGB Cook,ENG,Spin,1983-08-25,Nottingham,England,1983,2,150,492,9,1,432,966,18,282,474,9,24.0,<=30,ENG,Home,Upto 2014
NGB Cook,ENG,Spin,1984-01-20,Wellington,New Zealand,1984,2,196,537,4,1,205,579,4,9,42,0,51.25,>30,NZ,Away,Upto 2014
NGB Cook,ENG,Spin,1984-03-02,Karachi,Pakistan,1984,2,83,264,11,1,352,1095,26,269,831,15,13.538461538461538,<=30,PAK,Away,Upto 2014
NGB Cook,ENG,Spin,1984-03-12,Faisalabad,Pakistan,1984,2,171,420,2,1,537,1272,7,366,852,5,76.71428571428571,>30,PAK,Away,Upto 2014
NGB Cook,ENG,Spin,1984-03-19,Lahore,Pakistan,1984,2,190,387,1,1,562,1203,13,372,816,12,43.23076923076923,>30,PAK,Away,Upto 2014
NGB Cook,ENG,Spin,1984-06-14,Birmingham,England,1984,1,127,228,1,1,266,420,4,139,192,3,66.5,>30,ENG,Home,Upto 2014
NGB Cook,ENG,Spin,1984-07-12,Leeds,England,1984,2,56,108,3,1,133,318,7,77,210,4,19.0,<=30,ENG,Home,Upto 2014
NGB Cook,ENG,Spin,1984-07-26,Manchester,England,1984,1,114,234,1,1,327,823,11,213,589,10,29.727272727272727,<=30,ENG,Home,Upto 2014
NGB Cook,ENG,Spin,1987-11-25,Lahore,Pakistan,1987,1,87,186,3,1,424,1316,26,337,1130,23,16.307692307692307,<=30,PAK,Away,Upto 2014
NGB Cook,ENG,Spin,1987-12-07,Faisalabad,Pakistan,1987,2,52,177,3,1,479,1253,22,427,1076,19,21.772727272727273,<=30,PAK,Away,Upto 2014
NGB Cook,ENG,Spin,1987-12-16,Karachi,Pakistan,1987,1,56,198,1,1,450,1486,13,394,1288,12,34.61538461538461,>30,PAK,Away,Upto 2014
NGB Cook,ENG,Spin,1989-07-27,Manchester,England,1989,2,103,197,2,1,359,881,8,256,684,6,44.875,>30,ENG,Home,Upto 2014
NGB Cook,ENG,Spin,1989-08-10,Nottingham,England,1989,1,91,240,3,1,273,660,7,182,420,4,39.0,>30,ENG,Home,Upto 2014
NGB Cook,ENG,Spin,1989-08-24,The Oval,England,1989,2,88,186,0,1,165,312,2,77,126,2,82.5,>30,ENG,Home,Upto 2014
NGRP Jayasuriya,SL,Spin,2022-07-08,Galle,Sri Lanka,2022,2,177,312,12,1,757,1422,23,580,1110,11,32.91304347826087,>30,SL,Home,After 1965
NGRP Jayasuriya,SL,Spin,2022-07-16,Galle,Sri Lanka,2022,2,217,572,9,1,840,1795,26,623,1223,17,32.30769230769231,>30,SL,Home,After 1965
NGRP Jayasuriya,SL,Spin,2022-07-24,Galle,Sri Lanka,2022,2,197,414,8,1,907,1657,29,710,1243,21,31.275862068965516,>30,SL,Home,After 1965
NGRP Jayasuriya,SL,Spin,2023-03-09,Christchurch,New Zealand,2023,2,138,174,3,1,216,294,4,78,120,1,54.0,>30,NZ,Away,After 1965
NGRP Jayasuriya,SL,Spin,2023-03-17,Wellington,New Zealand,2023,1,86,126,1,1,311,564,7,225,438,6,44.42857142857143,>30,NZ,Away,After 1965
NGRP Jayasuriya,SL,Spin,2023-04-16,Galle,Sri Lanka,2023,2,108,283,10,1,643,1027,18,535,744,8,35.72222222222222,>30,SL,Home,After 1965
NGRP Jayasuriya,SL,Spin,2023-04-24,Galle,Sri Lanka,2023,2,262,543,7,1,963,1611,14,701,1068,7,68.78571428571429,>30,SL,Home,After 1965
NGRP Jayasuriya,SL,Spin,2023-07-16,Galle,Sri Lanka,2023,2,201,299,7,1,731,1336,25,530,1037,18,29.24,<=30,SL,Home,After 1965
NGRP Jayasuriya,SL,Spin,2023-07-24,Colombo (SSC),Sri Lanka,2023,1,194,318,2,1,535,922,13,341,604,11,41.15384615384615,>30,SL,Home,After 1965
NGRP Jayasuriya,SL,Spin,2024-02-02,Colombo (SSC),Sri Lanka,2024,2,174,432,8,1,432,854,10,258,422,2,43.2,>30,SL,Home,After 1965
NGRP Jayasuriya,SL,Spin,2024-03-22,Sylhet,Bangladesh,2024,2,70,96,0,1,284,550,7,214,454,7,40.57142857142857,>30,BAN,Away,After 1965
NGRP Jayasuriya,SL,Spin,2024-03-30,Chattogram,Bangladesh,2024,2,164,306,4,1,649,1230,12,485,924,8,54.083333333333336,>30,BAN,Away,After 1965
NGRP Jayasuriya,SL,Spin,2024-08-21,Manchester,England,2024,2,183,338,5,1,370,678,9,187,340,4,41.111111111111114,>30,ENG,Away,After 1965
NGRP Jayasuriya,SL,Spin,2024-08-29,Lord's,England,2024,2,201,294,3,1,342,540,5,141,246,2,68.4,>30,ENG,Away,After 1965
NGRP Jayasuriya,SL,Spin,2024-09-18,Galle,Sri Lanka,2024,2,204,424,9,1,849,1559,29,645,1135,20,29.275862068965516,<=30,SL,Home,After 1965
NGRP Jayasuriya,SL,Spin,2024-09-26,Galle,Sri Lanka,2024,2,181,312,9,1,824,1411,22,643,1099,13,37.45454545454545,>30,SL,Home,After 1965
NGRP Jayasuriya,SL,Spin,2024-11-27,Durban,South Africa,2024,2,156,270,4,1,277,462,6,121,192,2,46.166666666666664,>30,SA,Away,After 1965
NGRP Jayasuriya,SL,Spin,2024-12-05,Gqeberha,South Africa,2024,2,213,390,6,1,411,788,13,198,398,7,31.615384615384617,>30,SA,Away,After 1965
NGRP Jayasuriya,SL,Spin,2025-01-29,Galle,Sri Lanka,2025,1,193,360,3,1,941,1397,23,748,1037,20,40.91304347826087,>30,SL,Home,After 1965
NH Fairbrother,ENG,Pace,1988-02-25,Auckland,New Zealand,1988,1,9,12,0,1,724,1989,22,715,1977,22,32.90909090909091,>30,NZ,Away,Upto 2014
NHCD Theunissen,SA,Pace,1889-03-25,Cape Town,South Africa,1889,1,51,80,0,1,290,589,13,239,509,13,22.307692307692307,<=30,SA,Home,After 1965
NI Thomson,ENG,Pace,1964-12-04,Durban,South Africa,1964,2,48,168,2,1,364,1062,8,316,894,6,45.5,>30,SA,Away,Upto 2014
NI Thomson,ENG,Pace,1964-12-23,Johannesburg,South Africa,1964,2,83,234,1,1,619,1341,11,536,1107,10,56.27272727272727,>30,SA,Away,Upto 2014
NI Thomson,ENG,Pace,1965-01-01,Cape Town,South Africa,1965,2,120,354,3,1,647,1572,12,527,1218,9,53.916666666666664,>30,SA,Away,Upto 2014
NI Thomson,ENG,Pace,1965-01-22,Johannesburg,South Africa,1965,2,134,300,0,1,754,1664,13,620,1364,13,58.0,>30,SA,Away,Upto 2014
NI Thomson,ENG,Pace,1965-02-12,Gqeberha,South Africa,1965,2,183,432,3,1,624,1549,12,441,1117,9,52.0,>30,SA,Away,Upto 2014
NJ Astle,NZ,Pace,1996-01-20,Auckland,New Zealand,1996,2,7,24,0,1,908,2025,23,901,2001,23,39.47826086956522,>30,NZ,Home,Upto 2014
NJ Astle,NZ,Pace,1996-04-19,Bridgetown,West Indies,1996,1,3,6,0,1,918,1755,25,915,1749,25,36.72,>30,WI,Away,Upto 2014
NJ Astle,NZ,Pace,1996-11-21,Lahore,Pakistan,1996,1,10,24,1,1,507,953,23,497,929,22,22.043478260869566,<=30,PAK,Away,Upto 2014
NJ Astle,NZ,Pace,1996-11-28,Rawalpindi,Pakistan,1996,1,31,54,1,1,614,1126,22,583,1072,21,27.90909090909091,<=30,PAK,Away,Upto 2014
NJ Astle,NZ,Pace,1997-01-24,Auckland,New Zealand,1997,1,33,84,0,1,815,1797,20,782,1713,20,40.75,>30,NZ,Home,Upto 2014
NJ Astle,NZ,Pace,1997-02-06,Wellington,New Zealand,1997,1,30,84,1,1,457,1115,23,427,1031,22,19.869565217391305,<=30,NZ,Home,Upto 2014
NJ Astle,NZ,Pace,1997-02-14,Christchurch,New Zealand,1997,2,71,234,3,1,695,1595,19,624,1361,16,36.578947368421055,>30,NZ,Home,Upto 2014
NJ Astle,NZ,Pace,1997-03-07,Dunedin,New Zealand,1997,2,62,108,2,1,739,1295,21,677,1187,19,35.19047619047619,>30,NZ,Home,Upto 2014
NJ Astle,NZ,Pace,1997-03-14,Hamilton,New Zealand,1997,2,17,36,0,1,399,988,18,382,952,18,22.166666666666668,<=30,NZ,Home,Upto 2014
NJ Astle,NZ,Pace,1997-09-18,Harare,Zimbabwe,1997,2,126,293,3,1,808,1794,25,682,1501,22,32.32,>30,ZIM,Away,Upto 2014
NJ Astle,NZ,Pace,1997-09-25,Bulawayo,Zimbabwe,1997,2,31,96,1,1,606,1326,9,575,1230,8,67.33333333333333,>30,ZIM,Away,Upto 2014
NJ Astle,NZ,Pace,1997-11-07,Brisbane,Australia,1997,2,34,72,0,1,809,1711,25,775,1639,25,32.36,>30,AUS,Away,Upto 2014
NJ Astle,NZ,Pace,1997-11-27,Hobart,Australia,1997,2,57,114,0,1,691,1411,18,634,1297,18,38.388888888888886,>30,AUS,Away,Upto 2014
NJ Astle,NZ,Pace,1998-02-26,Auckland,New Zealand,1998,1,15,30,0,1,557,1155,25,542,1125,25,22.28,<=30,NZ,Home,Upto 2014
NJ Astle,NZ,Pace,1998-05-27,Colombo (RPS),Sri Lanka,1998,1,2,12,0,1,355,626,8,353,614,8,44.375,>30,SL,Away,Upto 2014
NJ Astle,NZ,Pace,1998-06-03,Galle,Sri Lanka,1998,1,12,30,0,1,157,358,1,145,328,1,157.0,>30,SL,Away,Upto 2014
NJ Astle,NZ,Pace,1998-06-10,Colombo (SSC),Sri Lanka,1998,1,8,18,0,1,230,457,11,222,439,11,20.90909090909091,<=30,SL,Away,Upto 2014
NJ Astle,NZ,Pace,1998-12-26,Wellington,New Zealand,1998,2,12,54,1,1,632,1417,22,620,1363,21,28.727272727272727,<=30,NZ,Home,Upto 2014
NJ Astle,NZ,Pace,1999-02-27,Auckland,New Zealand,1999,1,30,54,0,1,841,1949,13,811,1895,13,64.6923076923077,>30,NZ,Home,Upto 2014
NJ Astle,NZ,Pace,1999-03-11,Christchurch,New Zealand,1999,1,76,109,0,1,581,1404,8,505,1295,8,72.625,>30,NZ,Home,Upto 2014
NJ Astle,NZ,Pace,1999-03-18,Wellington,New Zealand,1999,1,21,96,1,1,742,1762,20,721,1666,19,37.1,>30,NZ,Home,Upto 2014
NJ Astle,NZ,Pace,1999-07-01,Birmingham,England,1999,1,0,6,0,1,580,1146,27,580,1140,27,21.48148148148148,<=30,ENG,Away,Upto 2014
NJ Astle,NZ,Pace,1999-07-22,Lord's,England,1999,2,15,66,1,1,642,1427,25,627,1361,24,25.68,<=30,ENG,Away,Upto 2014
NJ Astle,NZ,Pace,1999-08-05,Manchester,England,1999,2,21,84,0,1,505,1189,11,484,1105,11,45.90909090909091,>30,ENG,Away,Upto 2014
NJ Astle,NZ,Pace,1999-08-19,The Oval,England,1999,1,0,6,0,1,501,1268,29,501,1262,29,17.275862068965516,<=30,ENG,Away,Upto 2014
NJ Astle,NZ,Pace,1999-10-10,Mohali,India,1999,1,82,186,1,1,577,1368,20,495,1182,19,28.85,<=30,IND,Away,Upto 2014
NJ Astle,NZ,Pace,1999-10-22,Kanpur,India,1999,1,27,156,2,1,214,642,8,187,486,6,26.75,<=30,IND,Away,Upto 2014
NJ Astle,NZ,Pace,1999-10-29,Ahmedabad,India,1999,2,68,132,2,1,649,1266,11,581,1134,9,59.0,>30,IND,Away,Upto 2014
NJ Astle,NZ,Pace,1999-12-16,Hamilton,New Zealand,1999,1,67,96,1,1,615,1231,21,548,1135,20,29.285714285714285,<=30,NZ,Home,Upto 2014
NJ Astle,NZ,Pace,1999-12-26,Wellington,New Zealand,1999,2,45,66,1,1,571,1324,20,526,1258,19,28.55,<=30,NZ,Home,Upto 2014
NJ Astle,NZ,Pace,2000-03-24,Wellington,New Zealand,2000,2,64,127,0,1,802,1476,20,738,1349,20,40.1,>30,NZ,Home,Upto 2014
NJ Astle,NZ,Pace,2000-03-31,Hamilton,New Zealand,2000,1,5,24,0,1,633,1061,24,628,1037,24,26.375,<=30,NZ,Home,Upto 2014
NJ Astle,NZ,Pace,2000-09-12,Bulawayo,Zimbabwe,2000,2,33,174,2,1,470,1291,13,437,1117,11,36.15384615384615,>30,ZIM,Away,Upto 2014
NJ Astle,NZ,Pace,2000-09-19,Harare,Zimbabwe,2000,2,95,300,3,1,838,2129,25,743,1829,22,33.52,>30,ZIM,Away,Upto 2014
NJ Astle,NZ,Pace,2000-11-17,Bloemfontein,South Africa,2000,1,57,144,1,1,906,1955,31,849,1811,30,29.225806451612904,<=30,SA,Away,Upto 2014
NJ Astle,NZ,Pace,2000-11-30,Gqeberha,South Africa,2000,2,54,228,1,1,698,1864,30,644,1636,29,23.266666666666666,<=30,SA,Away,Upto 2014
NJ Astle,NZ,Pace,2000-12-08,Johannesburg,South Africa,2000,1,31,156,0,1,417,1127,13,386,971,13,32.07692307692308,>30,SA,Away,Upto 2014
NJ Astle,NZ,Pace,2000-12-26,Wellington,New Zealand,2000,1,7,30,0,1,550,1397,13,543,1367,13,42.30769230769231,>30,NZ,Home,Upto 2014
NJ Astle,NZ,Pace,2001-03-08,Auckland,New Zealand,2001,2,36,126,0,1,702,1474,24,666,1348,24,29.25,<=30,NZ,Home,Upto 2014
NJ Astle,NZ,Pace,2001-03-15,Christchurch,New Zealand,2001,1,45,180,0,1,802,1722,12,757,1542,12,66.83333333333333,>30,NZ,Home,Upto 2014
NJ Astle,NZ,Pace,2001-03-27,Hamilton,New Zealand,2001,1,2,6,0,1,506,942,23,504,936,23,22.0,<=30,NZ,Home,Upto 2014
NJ Astle,NZ,Pace,2001-11-08,Brisbane,Australia,2001,1,46,114,1,1,871,1428,20,825,1314,19,43.55,>30,AUS,Away,Upto 2014
NJ Astle,NZ,Pace,2001-11-22,Hobart,Australia,2001,1,30,54,1,1,554,972,8,524,918,7,69.25,>30,AUS,Away,Upto 2014
NJ Astle,NZ,Pace,2001-11-30,W.A.C.A,Australia,2001,2,32,102,0,1,1026,1787,22,994,1685,22,46.63636363636363,>30,AUS,Away,Upto 2014
NJ Astle,NZ,Pace,2002-03-13,Christchurch,New Zealand,2002,2,52,142,3,1,1052,1583,35,1000,1441,32,30.057142857142857,>30,NZ,Home,Upto 2014
NJ Astle,NZ,Pace,2002-03-21,Wellington,New Zealand,2002,2,19,60,0,1,587,1212,18,568,1152,18,32.611111111111114,>30,NZ,Home,Upto 2014
NJ Astle,NZ,Pace,2002-03-30,Auckland,New Zealand,2002,1,44,114,1,1,809,1459,39,765,1345,38,20.743589743589745,<=30,NZ,Home,Upto 2014
NJ Astle,NZ,Pace,2002-06-21,Bridgetown,West Indies,2002,1,4,30,0,1,787,1616,30,783,1586,30,26.233333333333334,<=30,WI,Away,Upto 2014
NJ Astle,NZ,Pace,2002-06-28,St George's,West Indies,2002,1,15,36,0,1,623,1356,15,608,1320,15,41.53333333333333,>30,WI,Away,Upto 2014
NJ Astle,NZ,Pace,2002-12-12,Wellington,New Zealand,2002,1,10,18,0,1,505,1071,28,495,1053,28,18.035714285714285,<=30,NZ,Home,Upto 2014
NJ Astle,NZ,Pace,2002-12-19,Hamilton,New Zealand,2002,2,17,48,1,1,426,959,32,409,911,31,13.3125,<=30,NZ,Home,Upto 2014
NJ Astle,NZ,Pace,2004-10-26,Chattogram,Bangladesh,2004,1,1,12,0,1,237,372,3,236,360,3,79.0,>30,BAN,Away,Upto 2014
NJ Astle,NZ,Pace,2005-03-10,Christchurch,New Zealand,2005,1,32,84,1,1,768,1398,17,736,1314,16,45.1764705882353,>30,NZ,Home,Upto 2014
NJ Astle,NZ,Pace,2005-03-18,Wellington,New Zealand,2005,1,40,78,1,1,569,942,15,529,864,14,37.93333333333333,>30,NZ,Home,Upto 2014
NJ Astle,NZ,Pace,2005-03-26,Auckland,New Zealand,2005,2,83,168,1,1,759,1379,20,676,1211,19,37.95,>30,NZ,Home,Upto 2014
NJ Astle,NZ,Pace,2005-04-04,Napier,New Zealand,2005,1,46,108,1,1,832,1538,21,786,1430,20,39.61904761904762,>30,NZ,Home,Upto 2014
NJ Astle,NZ,Pace,2005-04-11,Wellington,New Zealand,2005,2,62,151,6,1,716,1428,28,654,1277,22,25.571428571428573,<=30,NZ,Home,Upto 2014
NJ Astle,NZ,Pace,2005-08-07,Harare,Zimbabwe,2005,1,15,30,0,1,432,774,20,417,744,20,21.6,<=30,ZIM,Away,Upto 2014
NJ Astle,NZ,Pace,2005-08-15,Bulawayo,Zimbabwe,2005,1,26,36,0,1,584,919,19,558,883,19,30.736842105263158,>30,ZIM,Away,Upto 2014
NJ Astle,NZ,Pace,2006-03-09,Auckland,New Zealand,2006,1,13,60,2,1,867,1612,27,854,1552,25,32.111111111111114,>30,NZ,Home,Upto 2014
NJ Astle,NZ,Pace,2006-03-17,Wellington,New Zealand,2006,2,21,96,1,1,633,1165,28,612,1069,27,22.607142857142858,<=30,NZ,Home,Upto 2014
NJ Astle,NZ,Pace,2006-03-25,Napier,New Zealand,2006,1,23,84,1,1,242,421,3,219,337,2,80.66666666666667,>30,NZ,Home,Upto 2014
NJ Astle,NZ,Pace,2006-04-15,Centurion,South Africa,2006,2,26,60,1,1,858,1550,38,832,1490,37,22.57894736842105,<=30,SA,Away,Upto 2014
NJ Astle,NZ,Pace,2006-04-27,Cape Town,South Africa,2006,1,9,12,0,1,739,1386,13,730,1374,13,56.84615384615385,>30,SA,Away,Upto 2014
NJ Astle,NZ,Pace,2006-05-05,Johannesburg,South Africa,2006,1,11,12,0,1,757,1280,36,746,1268,36,21.02777777777778,<=30,SA,Away,Upto 2014
NJ Astle,NZ,Pace,2006-12-07,Christchurch,New Zealand,2006,2,2,12,0,1,515,1047,25,513,1035,25,20.6,<=30,NZ,Home,Upto 2014
NJ Astle,NZ,Pace,2006-12-15,Wellington,New Zealand,2006,1,22,42,0,1,700,1140,20,678,1098,20,35.0,>30,NZ,Home,Upto 2014
NJ Contractor,IND,Pace,1955-12-16,Delhi,India,1955,1,17,36,0,1,511,1457,6,494,1421,6,85.16666666666667,>30,IND,Home,Upto 2014
NJ Contractor,IND,Pace,1959-02-06,Delhi,India,1959,1,11,24,0,1,501,1007,14,490,983,14,35.785714285714285,>30,IND,Home,Upto 2014
NJ Contractor,IND,Pace,1960-01-01,Brabourne,India,1960,1,5,12,0,1,552,1475,15,547,1463,15,36.8,>30,IND,Home,Upto 2014
NJ Contractor,IND,Pace,1960-01-23,Eden Gardens,India,1960,1,9,30,1,1,523,1340,17,514,1310,16,30.764705882352942,>30,IND,Home,Upto 2014
NJ Contractor,IND,Pace,1960-12-02,Brabourne,India,1960,2,16,48,0,1,494,1042,13,478,994,13,38.0,>30,IND,Home,Upto 2014
NJ Contractor,IND,Pace,1960-12-16,Kanpur,India,1960,1,6,6,0,1,201,695,5,195,689,5,40.2,>30,IND,Home,Upto 2014
NJ Contractor,IND,Pace,1961-01-13,Chennai,India,1961,1,1,6,0,1,342,929,6,341,923,6,57.0,>30,IND,Home,Upto 2014
NJ Contractor,IND,Pace,1961-12-01,Kanpur,India,1961,1,9,12,0,1,383,915,5,374,903,5,76.6,>30,IND,Home,Upto 2014
NJ Contractor,IND,Pace,1962-03-07,Kingston,West Indies,1962,1,6,12,0,1,392,737,11,386,725,11,35.63636363636363,>30,WI,Away,Upto 2014
NJ Maddinson,AUS,Spin,2016-12-15,Brisbane,Australia,2016,1,9,18,0,1,384,649,5,375,631,5,76.8,>30,AUS,Home,After 1965
NJ Maddinson,AUS,Spin,2016-12-26,Melbourne,Australia,2016,1,18,18,0,1,417,534,7,399,516,7,59.57142857142857,>30,AUS,Home,After 1965
NJN Hawke,AUS,Pace,1963-02-15,Sydney,Australia,1963,2,89,232,2,1,466,1318,15,377,1086,13,31.066666666666666,>30,AUS,Home,Upto 2014
NJN Hawke,AUS,Pace,1964-01-01,Melbourne,Australia,1964,2,130,312,4,1,870,1955,24,740,1643,20,36.25,>30,AUS,Home,Upto 2014
NJN Hawke,AUS,Pace,1964-01-10,Sydney,Australia,1964,2,99,296,4,1,926,1995,29,827,1699,25,31.93103448275862,>30,AUS,Home,Upto 2014
NJN Hawke,AUS,Pace,1964-01-24,Adelaide,Australia,1964,2,159,360,6,1,1036,2074,26,877,1714,20,39.84615384615385,>30,AUS,Home,Upto 2014
NJN Hawke,AUS,Pace,1964-02-07,Sydney,Australia,1964,2,85,208,0,1,694,1880,20,609,1672,20,34.7,>30,AUS,Home,Upto 2014
NJN Hawke,AUS,Pace,1964-06-04,Nottingham,England,1964,2,121,324,3,1,492,1276,20,371,952,17,24.6,<=30,ENG,Away,Upto 2014
NJN Hawke,AUS,Pace,1964-06-18,Lord's,England,1964,1,41,96,3,1,401,987,19,360,891,16,21.105263157894736,<=30,ENG,Away,Upto 2014
NJN Hawke,AUS,Pace,1964-07-02,Leeds,England,1964,2,103,267,6,1,604,1337,21,501,1070,15,28.761904761904763,<=30,ENG,Away,Upto 2014
NJN Hawke,AUS,Pace,1964-07-23,Manchester,England,1964,1,95,378,0,1,759,1991,14,664,1613,14,54.214285714285715,>30,ENG,Away,Upto 2014
NJN Hawke,AUS,Pace,1964-08-13,The Oval,England,1964,2,136,388,6,1,732,1783,22,596,1395,16,33.27272727272727,>30,ENG,Away,Upto 2014
NJN Hawke,AUS,Pace,1964-10-02,Chennai,India,1964,2,81,300,4,1,256,741,16,175,441,12,16.0,<=30,IND,Away,Upto 2014
NJN Hawke,AUS,Pace,1964-10-24,Karachi,Pakistan,1964,2,104,156,1,1,349,725,11,245,569,10,31.727272727272727,>30,PAK,Away,Upto 2014
NJN Hawke,AUS,Pace,1964-12-04,Melbourne,Australia,1964,2,141,336,7,1,621,1276,24,480,940,17,25.875,<=30,AUS,Home,Upto 2014
NJN Hawke,AUS,Pace,1965-03-03,Kingston,West Indies,1965,2,72,192,2,1,497,1218,24,425,1026,22,20.708333333333332,<=30,WI,Away,Upto 2014
NJN Hawke,AUS,Pace,1965-03-26,Port of Spain,West Indies,1965,2,92,264,2,1,537,1194,10,445,930,8,53.7,>30,WI,Away,Upto 2014
NJN Hawke,AUS,Pace,1965-04-14,Georgetown,West Indies,1965,2,115,316,10,1,434,874,16,319,558,6,27.125,<=30,WI,Away,Upto 2014
NJN Hawke,AUS,Pace,1965-05-05,Bridgetown,West Indies,1965,2,172,384,4,1,670,1290,13,498,906,9,51.53846153846154,>30,WI,Away,Upto 2014
NJN Hawke,AUS,Pace,1965-05-14,Port of Spain,West Indies,1965,2,73,156,6,1,271,612,18,198,456,12,15.055555555555555,<=30,WI,Away,Upto 2014
NJN Hawke,AUS,Pace,1965-12-10,Brisbane,Australia,1965,2,60,208,2,1,379,960,11,319,752,9,34.45454545454545,>30,AUS,Home,Upto 2014
NJN Hawke,AUS,Pace,1966-01-07,Sydney,Australia,1966,1,105,271,7,1,445,1015,16,340,744,9,27.8125,<=30,AUS,Home,Upto 2014
NJN Hawke,AUS,Pace,1966-01-28,Adelaide,Australia,1966,2,123,352,6,1,581,1367,21,458,1015,15,27.666666666666668,<=30,AUS,Home,Upto 2014
NJN Hawke,AUS,Pace,1966-02-11,Melbourne,Australia,1966,2,131,312,1,1,701,1506,15,570,1194,14,46.733333333333334,>30,AUS,Home,Upto 2014
NJN Hawke,AUS,Pace,1966-12-23,Johannesburg,South Africa,1966,2,71,134,2,1,809,1914,26,738,1780,24,31.115384615384617,>30,SA,Away,Upto 2014
NJN Hawke,AUS,Pace,1967-01-20,Durban,South Africa,1967,2,91,192,2,1,725,1921,25,634,1729,23,29.0,<=30,SA,Away,Upto 2014
NJN Hawke,AUS,Pace,1968-01-26,Sydney,Australia,1968,2,73,192,0,1,498,913,9,425,721,9,55.333333333333336,>30,AUS,Home,Upto 2014
NJN Hawke,AUS,Pace,1968-06-06,Manchester,England,1968,2,33,138,1,1,493,1497,18,460,1359,17,27.38888888888889,<=30,ENG,Away,Upto 2014
NJN Hawke,AUS,Pace,1968-06-20,Lord's,England,1968,1,82,210,0,1,427,1141,15,345,931,15,28.466666666666665,<=30,ENG,Away,Upto 2014
NLTC Perera,SL,Pace,2011-05-26,Cardiff,England,2011,1,81,144,0,1,591,1108,14,510,964,14,42.214285714285715,>30,ENG,Away,Upto 2014
NLTC Perera,SL,Pace,2011-06-16,Southampton,England,2011,1,101,144,2,1,719,1308,21,618,1164,19,34.23809523809524,>30,ENG,Away,Upto 2014
NLTC Perera,SL,Pace,2011-12-15,Centurion,South Africa,2011,1,114,144,3,1,635,1013,25,521,869,22,25.4,<=30,SA,Away,Upto 2014
NLTC Perera,SL,Pace,2011-12-26,Durban,South Africa,2011,2,75,132,2,1,674,1304,26,599,1172,24,25.923076923076923,<=30,SA,Away,Upto 2014
NLTC Perera,SL,Pace,2012-01-03,Cape Town,South Africa,2012,1,131,132,0,1,828,1318,18,697,1186,18,46.0,>30,SA,Away,Upto 2014
NLTC Perera,SL,Pace,2012-07-08,Pallekele,Sri Lanka,2012,2,151,258,4,1,780,1418,19,629,1160,15,41.05263157894737,>30,SL,Home,Upto 2014
NM Hauritz,AUS,Spin,2004-11-03,Wankhede,India,2004,2,103,162,5,1,365,706,29,262,544,24,12.586206896551724,<=30,IND,Away,Upto 2014
NM Hauritz,AUS,Spin,2008-11-28,Adelaide,Australia,2008,2,95,240,4,1,283,706,9,188,466,5,31.444444444444443,>30,AUS,Home,Upto 2014
NM Hauritz,AUS,Spin,2008-12-26,Melbourne,Australia,2008,2,139,318,4,1,278,678,5,139,360,1,55.6,>30,AUS,Home,Upto 2014
NM Hauritz,AUS,Spin,2009-01-03,Sydney,Australia,2009,2,115,288,1,1,278,623,6,163,335,5,46.333333333333336,>30,AUS,Home,Upto 2014
NM Hauritz,AUS,Spin,2009-07-08,Cardiff,England,2009,2,158,365,6,1,464,923,7,306,558,1,66.28571428571429,>30,ENG,Away,Upto 2014
NM Hauritz,AUS,Spin,2009-07-16,Lord's,England,2009,2,106,147,3,1,283,468,8,177,321,5,35.375,>30,ENG,Away,Upto 2014
NM Hauritz,AUS,Spin,2009-07-30,Birmingham,England,2009,1,57,108,1,1,180,306,3,123,198,2,60.0,>30,ENG,Away,Upto 2014
NM Hauritz,AUS,Spin,2009-11-26,Brisbane,Australia,2009,2,57,120,5,1,179,378,7,122,258,2,25.571428571428573,<=30,AUS,Home,Upto 2014
NM Hauritz,AUS,Spin,2009-12-04,Adelaide,Australia,2009,2,179,378,2,1,454,1020,7,275,642,5,64.85714285714286,>30,AUS,Home,Upto 2014
NM Hauritz,AUS,Spin,2009-12-16,W.A.C.A,Australia,2009,2,127,240,4,1,338,660,10,211,420,6,33.8,>30,AUS,Home,Upto 2014
NM Hauritz,AUS,Spin,2009-12-26,Melbourne,Australia,2009,2,159,264,6,1,412,721,8,253,457,2,51.5,>30,AUS,Home,Upto 2014
NM Hauritz,AUS,Spin,2010-01-03,Sydney,Australia,2010,2,130,168,6,1,308,485,11,178,317,5,28.0,<=30,AUS,Home,Upto 2014
NM Hauritz,AUS,Spin,2010-01-14,Hobart,Australia,2010,2,126,304,6,1,458,793,15,332,489,9,30.533333333333335,>30,AUS,Home,Upto 2014
NM Hauritz,AUS,Spin,2010-03-19,Wellington,New Zealand,2010,2,158,378,3,1,326,678,4,168,300,1,81.5,>30,NZ,Away,Upto 2014
NM Hauritz,AUS,Spin,2010-03-27,Hamilton,New Zealand,2010,2,105,180,1,1,478,999,10,373,819,9,47.8,>30,NZ,Away,Upto 2014
NM Hauritz,AUS,Spin,2010-10-01,Mohali,India,2010,2,161,229,3,1,557,1225,12,396,996,9,46.416666666666664,>30,IND,Away,Upto 2014
NM Hauritz,AUS,Spin,2010-10-09,Bengaluru,India,2010,2,229,311,3,1,696,1271,17,467,960,14,40.94117647058823,>30,IND,Away,Upto 2014
NM Kulkarni,IND,Spin,1997-08-02,Colombo (RPS),Sri Lanka,1997,1,195,420,1,1,1044,2082,8,849,1662,7,130.5,>30,SL,Away,Upto 2014
NM Kulkarni,IND,Spin,2001-03-18,Chennai,India,2001,2,137,318,1,1,924,1783,26,787,1465,25,35.53846153846154,>30,IND,Home,Upto 2014
NM Lyon,AUS,Spin,2011-08-31,Galle,Sri Lanka,2011,2,107,209,6,1,441,845,19,334,636,13,23.210526315789473,<=30,SL,Away,Upto 2014
NM Lyon,AUS,Spin,2011-09-08,Pallekele,Sri Lanka,2011,2,93,150,2,1,335,684,6,242,534,4,55.833333333333336,>30,SL,Away,Upto 2014
NM Lyon,AUS,Spin,2011-09-16,Colombo (SSC),Sri Lanka,2011,2,95,210,0,1,436,882,9,341,672,9,48.44444444444444,>30,SL,Away,Upto 2014
NM Lyon,AUS,Spin,2011-11-09,Cape Town,South Africa,2011,1,11,18,0,1,46,78,0,35,60,0,inf,>30,SA,Away,Upto 2014
NM Lyon,AUS,Spin,2011-11-17,Johannesburg,South Africa,2011,2,109,174,4,1,235,387,10,126,213,6,23.5,<=30,SA,Away,Upto 2014
NM Lyon,AUS,Spin,2011-12-01,Brisbane,Australia,2011,2,88,201,7,1,207,471,10,119,270,3,20.7,<=30,AUS,Home,Upto 2014
NM Lyon,AUS,Spin,2011-12-09,Hobart,Australia,2011,2,38,93,3,1,38,93,3,0,0,0,12.666666666666666,<=30,AUS,Home,Upto 2014
NM Lyon,AUS,Spin,2011-12-26,Melbourne,Australia,2011,2,91,137,1,1,247,467,5,156,330,4,49.4,>30,AUS,Home,Upto 2014
NM Lyon,AUS,Spin,2012-01-03,Sydney,Australia,2012,2,89,168,1,1,343,624,2,254,456,1,171.5,>30,AUS,Home,Upto 2014
NM Lyon,AUS,Spin,2012-01-24,Adelaide,Australia,2012,2,111,256,5,1,465,838,10,354,582,5,46.5,>30,AUS,Home,Upto 2014
NM Lyon,AUS,Spin,2012-04-07,Bridgetown,West Indies,2012,2,113,252,1,1,422,828,8,309,576,7,52.75,>30,WI,Away,Upto 2014
NM Lyon,AUS,Spin,2012-04-15,Port of Spain,West Indies,2012,1,68,174,5,1,339,951,13,271,777,8,26.076923076923077,<=30,WI,Away,Upto 2014
NM Lyon,AUS,Spin,2012-04-23,Roseau,West Indies,2012,2,156,375,7,1,565,1160,26,409,785,19,21.73076923076923,<=30,WI,Away,Upto 2014
NM Lyon,AUS,Spin,2012-11-09,Brisbane,Australia,2012,2,177,300,4,1,246,390,4,69,90,0,61.5,>30,AUS,Home,Upto 2014
NM Lyon,AUS,Spin,2012-11-22,Adelaide,Australia,2012,2,140,564,5,1,554,1050,7,414,486,2,79.14285714285714,>30,AUS,Home,Upto 2014
NM Lyon,AUS,Spin,2012-11-30,W.A.C.A,Australia,2012,2,169,204,3,1,376,409,9,207,205,6,41.77777777777778,>30,AUS,Home,Upto 2014
NM Lyon,AUS,Spin,2012-12-14,Hobart,Australia,2012,2,133,342,2,1,352,719,7,219,377,5,50.285714285714285,>30,AUS,Home,Upto 2014
NM Lyon,AUS,Spin,2012-12-26,Melbourne,Australia,2012,2,39,46,3,1,172,352,4,133,306,1,43.0,>30,AUS,Home,Upto 2014
NM Lyon,AUS,Spin,2013-01-03,Sydney,Australia,2013,2,135,204,2,1,392,713,11,257,509,9,35.63636363636363,>30,AUS,Home,Upto 2014
NM Lyon,AUS,Spin,2013-02-22,Chennai,India,2013,2,244,315,4,1,771,1539,24,527,1224,20,32.125,>30,IND,Away,Upto 2014
NM Lyon,AUS,Spin,2013-03-14,Mohali,India,2013,2,151,216,2,1,752,1501,18,601,1285,16,41.77777777777778,>30,IND,Away,Upto 2014
NM Lyon,AUS,Spin,2013-03-22,Delhi,India,2013,2,165,232,9,1,535,1112,29,370,880,20,18.448275862068964,<=30,IND,Away,Upto 2014
NM Lyon,AUS,Spin,2013-08-01,Manchester,England,2013,2,103,228,1,1,362,618,7,259,390,6,51.714285714285715,>30,ENG,Away,Upto 2014
NM Lyon,AUS,Spin,2013-08-09,Chester-le-Street,England,2013,2,97,253,7,1,200,493,11,103,240,4,18.181818181818183,<=30,ENG,Away,Upto 2014
NM Lyon,AUS,Spin,2013-08-21,The Oval,England,2013,2,103,228,1,1,310,576,4,207,348,3,77.5,>30,ENG,Away,Upto 2014
NM Lyon,AUS,Spin,2013-11-21,Brisbane,Australia,2013,2,63,174,4,1,355,624,6,292,450,2,59.166666666666664,>30,AUS,Home,Upto 2014
NM Lyon,AUS,Spin,2013-12-05,Adelaide,Australia,2013,2,142,276,2,1,565,912,7,423,636,5,80.71428571428571,>30,AUS,Home,Upto 2014
NM Lyon,AUS,Spin,2013-12-13,W.A.C.A,Australia,2013,2,109,228,4,1,300,552,7,191,324,3,42.857142857142854,>30,AUS,Home,Upto 2014
NM Lyon,AUS,Spin,2013-12-26,Melbourne,Australia,2013,2,117,236,6,1,184,361,7,67,125,1,26.285714285714285,<=30,AUS,Home,Upto 2014
NM Lyon,AUS,Spin,2014-01-03,Sydney,Australia,2014,2,127,144,3,1,226,246,7,99,102,4,32.285714285714285,>30,AUS,Home,After 1965
NM Lyon,AUS,Spin,2014-02-12,Centurion,South Africa,2014,2,71,162,2,1,266,474,6,195,312,4,44.333333333333336,>30,SA,Away,After 1965
NM Lyon,AUS,Spin,2014-02-20,Gqeberha,South Africa,2014,2,178,378,6,1,316,654,11,138,276,5,28.727272727272727,<=30,SA,Away,After 1965
NM Lyon,AUS,Spin,2014-03-01,Cape Town,South Africa,2014,2,63,204,0,1,386,690,6,323,486,6,64.33333333333333,>30,SA,Away,After 1965
NM Lyon,AUS,Spin,2014-10-22,Dubai (DICS),UAE,2014,2,220,330,2,1,843,1550,22,623,1220,20,38.31818181818182,>30,UAE,Away,After 1965
NM Lyon,AUS,Spin,2014-10-30,Abu Dhabi,UAE,2014,2,202,330,1,1,756,1259,18,554,929,17,42.0,>30,UAE,Away,After 1965
NM Lyon,AUS,Spin,2014-12-09,Adelaide,Australia,2014,2,286,421,12,1,652,937,17,366,516,5,38.35294117647059,>30,AUS,Home,After 1965
NM Lyon,AUS,Spin,2014-12-17,Brisbane,Australia,2014,2,138,214,5,1,289,440,7,151,226,2,41.285714285714285,>30,AUS,Home,After 1965
NM Lyon,AUS,Spin,2014-12-26,Melbourne,Australia,2014,2,144,246,2,1,388,732,7,244,486,5,55.42857142857143,>30,AUS,Home,After 1965
NM Lyon,AUS,Spin,2015-01-06,Sydney,Australia,2015,2,233,461,4,1,575,1013,9,342,552,5,63.888888888888886,>30,AUS,Home,After 1965
NM Lyon,AUS,Spin,2015-06-03,Roseau,West Indies,2015,2,87,180,3,1,294,570,11,207,390,8,26.727272727272727,<=30,WI,Away,After 1965
NM Lyon,AUS,Spin,2015-06-11,Kingston,West Indies,2015,2,67,126,5,1,355,671,7,288,545,2,50.714285714285715,>30,WI,Away,After 1965
NM Lyon,AUS,Spin,2015-07-08,Cardiff,England,2015,2,144,241,6,1,311,478,13,167,237,7,23.923076923076923,<=30,ENG,Away,After 1965
NM Lyon,AUS,Spin,2015-07-16,Lord's,England,2015,2,80,150,3,1,392,582,8,312,432,5,49.0,>30,ENG,Away,After 1965
NM Lyon,AUS,Spin,2015-07-29,Birmingham,England,2015,2,88,144,3,1,159,256,4,71,112,1,39.75,>30,ENG,Away,After 1965
NM Lyon,AUS,Spin,2015-08-06,Nottingham,England,2015,1,47,60,0,1,99,114,0,52,54,0,inf,>30,ENG,Away,After 1965
NM Lyon,AUS,Spin,2015-08-20,The Oval,England,2015,2,93,228,4,1,215,360,8,122,132,4,26.875,<=30,ENG,Away,After 1965
NM Lyon,AUS,Spin,2015-11-05,Brisbane,Australia,2015,2,109,228,4,1,385,554,8,276,326,4,48.125,>30,AUS,Home,After 1965
NM Lyon,AUS,Spin,2015-11-13,W.A.C.A,Australia,2015,2,142,269,3,1,404,593,6,262,324,3,67.33333333333333,>30,AUS,Home,After 1965
NM Lyon,AUS,Spin,2015-11-27,Adelaide,Australia,2015,2,78,150,3,1,218,366,7,140,216,4,31.142857142857142,>30,AUS,Home,After 1965
NM Lyon,AUS,Spin,2015-12-10,Hobart,Australia,2015,2,60,138,3,1,295,420,6,235,282,3,49.166666666666664,>30,AUS,Home,After 1965
NM Lyon,AUS,Spin,2015-12-26,Melbourne,Australia,2015,2,151,312,7,1,415,654,8,264,342,1,51.875,>30,AUS,Home,After 1965
NM Lyon,AUS,Spin,2016-01-03,Sydney,Australia,2016,1,120,276,3,1,265,547,8,145,271,5,33.125,>30,AUS,Home,After 1965
NM Lyon,AUS,Spin,2016-02-12,Wellington,New Zealand,2016,2,123,222,7,1,284,458,9,161,236,2,31.555555555555557,>30,NZ,Away,After 1965
NM Lyon,AUS,Spin,2016-02-20,Christchurch,New Zealand,2016,2,103,162,3,1,123,228,4,20,66,1,30.75,>30,NZ,Away,After 1965
NM Lyon,AUS,Spin,2016-07-26,Pallekele,Sri Lanka,2016,2,120,180,5,1,503,1219,26,383,1039,21,19.346153846153847,<=30,SL,Away,After 1965
NM Lyon,AUS,Spin,2016-08-04,Galle,Sri Lanka,2016,2,158,222,4,1,555,873,24,397,651,20,23.125,<=30,SL,Away,After 1965
NM Lyon,AUS,Spin,2016-08-13,Colombo (SSC),Sri Lanka,2016,2,233,522,7,1,860,1808,28,627,1286,21,30.714285714285715,>30,SL,Away,After 1965
NM Lyon,AUS,Spin,2016-11-03,W.A.C.A,Australia,2016,2,184,264,2,1,396,754,8,212,490,6,49.5,>30,AUS,Home,After 1965
NM Lyon,AUS,Spin,2016-11-12,Hobart,Australia,2016,1,57,102,0,1,82,156,0,25,54,0,inf,>30,AUS,Home,After 1965
NM Lyon,AUS,Spin,2016-11-24,Adelaide,Australia,2016,2,105,216,4,1,296,533,6,191,317,2,49.333333333333336,>30,AUS,Home,After 1965
NM Lyon,AUS,Spin,2016-12-15,Brisbane,Australia,2016,2,139,240,2,1,384,649,5,245,409,3,76.8,>30,AUS,Home,After 1965
NM Lyon,AUS,Spin,2016-12-26,Melbourne,Australia,2016,2,148,222,4,1,417,534,7,269,312,3,59.57142857142857,>30,AUS,Home,After 1965
NM Lyon,AUS,Spin,2017-01-03,Sydney,Australia,2017,2,215,360,5,1,736,1038,13,521,678,8,56.61538461538461,>30,AUS,Home,After 1965
NM Lyon,AUS,Spin,2017-02-23,Pune,India,2017,2,74,155,5,1,566,1181,31,492,1026,26,18.258064516129032,<=30,IND,Away,After 1965
NM Lyon,AUS,Spin,2017-03-04,Bengaluru,India,2017,2,132,332,8,1,406,1139,26,274,807,18,15.615384615384615,<=30,IND,Away,After 1965
NM Lyon,AUS,Spin,2017-03-16,Ranchi,India,2017,1,163,276,1,1,755,1725,15,592,1449,14,50.333333333333336,>30,IND,Away,After 1965
NM Lyon,AUS,Spin,2017-03-25,Dharamsala,India,2017,2,111,235,5,1,468,1025,18,357,790,13,26.0,<=30,IND,Away,After 1965
NM Lyon,AUS,Spin,2017-08-27,Mirpur,Bangladesh,2017,2,161,387,9,1,693,1433,34,532,1046,25,20.38235294117647,<=30,BAN,Away,After 1965
NM Lyon,AUS,Spin,2017-09-04,Chattogram,Bangladesh,2017,2,154,416,13,1,709,1537,24,555,1121,11,29.541666666666668,<=30,BAN,Away,After 1965
NM Lyon,AUS,Spin,2017-11-23,Brisbane,Australia,2017,2,145,360,5,1,277,645,8,132,285,3,34.625,>30,AUS,Home,After 1965
NM Lyon,AUS,Spin,2017-12-02,Adelaide,Australia,2017,2,105,295,6,1,220,493,6,115,198,0,36.666666666666664,>30,AUS,Home,After 1965
NM Lyon,AUS,Spin,2017-12-14,W.A.C.A,Australia,2017,2,115,222,3,1,269,492,4,154,270,1,67.25,>30,AUS,Home,After 1965
NM Lyon,AUS,Spin,2017-12-26,Melbourne,Australia,2017,1,109,252,3,1,251,518,4,142,266,1,62.75,>30,AUS,Home,After 1965
NM Lyon,AUS,Spin,2018-01-04,Sydney,Australia,2018,2,140,432,4,1,530,1068,7,390,636,3,75.71428571428571,>30,AUS,Home,After 1965
NM Lyon,AUS,Spin,2018-03-01,Durban,South Africa,2018,2,136,288,3,1,376,722,13,240,434,10,28.923076923076923,<=30,SA,Away,After 1965
NM Lyon,AUS,Spin,2018-03-09,Gqeberha,South Africa,2018,2,102,186,3,1,252,456,5,150,270,2,50.4,>30,SA,Away,After 1965
NM Lyon,AUS,Spin,2018-03-22,Cape Town,South Africa,2018,2,145,305,5,1,218,461,7,73,156,2,31.142857142857142,>30,SA,Away,After 1965
NM Lyon,AUS,Spin,2018-03-30,Johannesburg,South Africa,2018,2,298,486,5,1,456,724,9,158,238,4,50.666666666666664,>30,SA,Away,After 1965
NM Lyon,AUS,Spin,2018-10-07,Dubai (DICS),UAE,2018,2,172,467,4,1,793,1735,21,621,1268,17,37.76190476190476,>30,UAE,Away,After 1965
NM Lyon,AUS,Spin,2018-10-16,Abu Dhabi,UAE,2018,2,213,420,8,1,566,1108,20,353,688,12,28.3,<=30,UAE,Away,After 1965
NM Lyon,AUS,Spin,2018-12-06,Adelaide,Australia,2018,2,205,420,8,1,390,1013,14,185,593,6,27.857142857142858,<=30,AUS,Home,After 1965
NM Lyon,AUS,Spin,2018-12-14,Perth,Australia,2018,2,106,323,8,1,200,497,10,94,174,2,20.0,<=30,AUS,Home,After 1965
NM Lyon,AUS,Spin,2018-12-26,Melbourne,Australia,2018,2,150,366,1,1,293,756,6,143,390,5,48.833333333333336,>30,AUS,Home,After 1965
NM Lyon,AUS,Spin,2019-01-03,Sydney,Australia,2019,1,178,344,4,1,448,853,11,270,509,7,40.72727272727273,>30,AUS,Home,After 1965
NM Lyon,AUS,Spin,2019-01-24,Brisbane,Australia,2019,2,55,149,2,1,161,391,5,106,242,3,32.2,>30,AUS,Home,After 1965
NM Lyon,AUS,Spin,2019-02-01,Canberra,Australia,2019,2,121,222,2,1,375,678,4,254,456,2,93.75,>30,AUS,Home,After 1965
NM Lyon,AUS,Spin,2019-08-01,Birmingham,England,2019,2,161,383,9,1,478,833,12,317,450,3,39.833333333333336,>30,ENG,Away,After 1965
NM Lyon,AUS,Spin,2019-08-14,Lord's,England,2019,2,170,271,3,1,239,466,7,69,195,4,34.142857142857146,>30,ENG,Away,After 1965
NM Lyon,AUS,Spin,2019-08-22,Leeds,England,2019,2,116,240,2,1,178,342,3,62,102,1,59.333333333333336,>30,ENG,Away,After 1965
NM Lyon,AUS,Spin,2019-09-04,Manchester,England,2019,2,140,390,2,1,337,685,7,197,295,5,48.142857142857146,>30,ENG,Away,After 1965
NM Lyon,AUS,Spin,2019-09-12,The Oval,England,2019,2,81,171,4,1,205,441,10,124,270,6,20.5,<=30,ENG,Away,After 1965
NM Lyon,AUS,Spin,2019-11-21,Brisbane,Australia,2019,2,114,228,2,1,515,790,8,401,562,6,64.375,>30,AUS,Home,After 1965
NM Lyon,AUS,Spin,2019-11-29,Adelaide,Australia,2019,2,134,282,5,1,462,654,5,328,372,0,92.4,>30,AUS,Home,After 1965
NM Lyon,AUS,Spin,2019-12-12,Perth,Australia,2019,2,111,221,6,1,325,635,8,214,414,2,40.625,>30,AUS,Home,After 1965
NM Lyon,AUS,Spin,2019-12-26,Melbourne,Australia,2019,2,116,192,4,1,244,396,6,128,204,2,40.666666666666664,>30,AUS,Home,After 1965
NM Lyon,AUS,Spin,2020-01-03,Sydney,Australia,2020,2,118,285,10,1,444,825,14,326,540,4,31.714285714285715,>30,AUS,Home,After 1965
NM Lyon,AUS,Spin,2020-12-17,Adelaide,Australia,2020,1,68,126,1,1,142,276,6,74,150,5,23.666666666666668,<=30,AUS,Home,After 1965
NM Lyon,AUS,Spin,2020-12-26,Melbourne,Australia,2020,2,77,180,3,1,235,670,11,158,490,8,21.363636363636363,<=30,AUS,Home,After 1965
NM Lyon,AUS,Spin,2021-01-07,Sydney,Australia,2021,2,201,462,2,1,452,906,8,251,444,6,56.5,>30,AUS,Home,After 1965
NM Lyon,AUS,Spin,2021-01-15,Brisbane,Australia,2021,2,150,354,3,1,324,661,7,174,307,4,46.285714285714285,>30,AUS,Home,After 1965
NM Lyon,AUS,Spin,2021-12-08,Brisbane,Australia,2021,2,112,258,4,1,257,390,6,145,132,2,42.833333333333336,>30,AUS,Home,After 1965
NM Lyon,AUS,Spin,2021-12-16,Adelaide,Australia,2021,2,113,402,5,1,255,630,10,142,228,5,25.5,<=30,AUS,Home,After 1965
NM Lyon,AUS,Spin,2021-12-26,Melbourne,Australia,2021,1,36,85,3,1,82,175,4,46,90,1,20.5,<=30,AUS,Home,After 1965
NM Lyon,AUS,Spin,2022-01-05,Sydney,Australia,2022,2,116,234,4,1,414,683,10,298,449,6,41.4,>30,AUS,Home,After 1965
NM Lyon,AUS,Spin,2022-03-04,Rawalpindi,Pakistan,2022,2,236,468,1,1,676,1285,9,440,817,8,75.11111111111111,>30,PAK,Away,After 1965
NM Lyon,AUS,Spin,2022-03-12,Karachi,Pakistan,2022,2,125,384,5,1,673,1474,11,548,1090,6,61.18181818181818,>30,PAK,Away,After 1965
NM Lyon,AUS,Spin,2022-03-21,Lahore,Pakistan,2022,2,178,462,6,1,557,1146,9,379,684,3,61.888888888888886,>30,PAK,Away,After 1965
NM Lyon,AUS,Spin,2022-06-29,Galle,Sri Lanka,2022,2,121,216,9,1,491,729,25,370,513,16,19.64,<=30,SL,Away,After 1965
NM Lyon,AUS,Spin,2022-07-08,Galle,Sri Lanka,2022,1,194,384,2,1,757,1422,23,563,1038,21,32.91304347826087,>30,SL,Away,After 1965
NM Lyon,AUS,Spin,2022-11-30,Perth,Australia,2022,2,189,389,8,1,497,783,13,308,394,5,38.23076923076923,>30,AUS,Home,After 1965
NM Lyon,AUS,Spin,2022-12-08,Adelaide,Australia,2022,2,65,180,4,1,274,456,7,209,276,3,39.142857142857146,>30,AUS,Home,After 1965
NM Lyon,AUS,Spin,2022-12-17,Brisbane,Australia,2022,2,31,84,4,1,48,96,4,17,12,0,12.0,<=30,AUS,Home,After 1965
NM Lyon,AUS,Spin,2022-12-26,Melbourne,Australia,2022,2,111,204,4,1,255,472,5,144,268,1,51.0,>30,AUS,Home,After 1965
NM Lyon,AUS,Spin,2023-01-04,Sydney,Australia,2023,2,120,330,2,1,437,881,4,317,551,2,109.25,>30,AUS,Home,After 1965
NM Lyon,AUS,Spin,2023-02-09,Nagpur,India,2023,1,126,294,1,1,475,1061,24,349,767,23,19.791666666666668,<=30,IND,Away,After 1965
NM Lyon,AUS,Spin,2023-02-17,Delhi,India,2023,2,116,246,7,1,582,1082,28,466,836,21,20.785714285714285,<=30,IND,Away,After 1965
NM Lyon,AUS,Spin,2023-03-01,Indore,India,2023,2,99,209,11,1,438,973,26,339,764,15,16.846153846153847,<=30,IND,Away,After 1965
NM Lyon,AUS,Spin,2023-03-09,Ahmedabad,India,2023,1,151,390,3,1,725,1892,17,574,1502,14,42.64705882352941,>30,IND,Away,After 1965
NM Lyon,AUS,Spin,2023-06-07,The Oval,England,2023,2,60,117,5,1,174,363,9,114,246,4,19.333333333333332,<=30,ENG,Away,After 1965
NM Lyon,AUS,Spin,2023-06-16,Birmingham,England,2023,2,229,318,8,1,491,732,12,262,414,4,40.916666666666664,>30,ENG,Away,After 1965
NM Lyon,AUS,Spin,2023-06-28,Lord's,England,2023,1,35,78,1,1,95,198,5,60,120,4,19.0,<=30,ENG,Away,After 1965
NM Lyon,AUS,Spin,2023-12-14,Perth,Australia,2023,2,80,192,5,1,206,443,6,126,251,1,34.333333333333336,>30,AUS,Home,After 1965
NM Lyon,AUS,Spin,2023-12-26,Melbourne,Australia,2023,2,157,227,4,1,195,293,5,38,66,1,39.0,>30,AUS,Home,After 1965
NM Lyon,AUS,Spin,2024-01-03,Sydney,Australia,2024,2,110,206,4,1,332,638,10,222,432,6,33.2,>30,AUS,Home,After 1965
NM Lyon,AUS,Spin,2024-01-17,Adelaide,Australia,2024,2,40,93,3,1,82,165,3,42,72,0,27.333333333333332,<=30,AUS,Home,After 1965
NM Lyon,AUS,Spin,2024-01-25,Brisbane,Australia,2024,2,123,300,5,1,191,372,6,68,72,1,31.833333333333332,>30,AUS,Home,After 1965
NM Lyon,AUS,Spin,2024-02-29,Wellington,New Zealand,2024,2,108,211,10,1,189,379,17,81,168,7,11.117647058823529,<=30,NZ,Away,After 1965
NM Lyon,AUS,Spin,2024-03-08,Christchurch,New Zealand,2024,2,55,110,3,1,112,230,4,57,120,1,28.0,<=30,NZ,Away,After 1965
NM Lyon,AUS,Spin,2024-11-22,Perth,Australia,2024,2,119,264,2,1,374,651,9,255,387,7,41.55555555555556,>30,AUS,Home,After 1965
NM Lyon,AUS,Spin,2024-12-06,Adelaide,Australia,2024,1,6,6,0,1,178,252,2,172,246,2,89.0,>30,AUS,Home,After 1965
NM Lyon,AUS,Spin,2024-12-14,Brisbane,Australia,2024,1,55,138,1,1,218,365,3,163,227,2,72.66666666666667,>30,AUS,Home,After 1965
NM Lyon,AUS,Spin,2024-12-26,Melbourne,Australia,2024,2,133,292,5,1,350,730,11,217,438,6,31.818181818181817,>30,AUS,Home,After 1965
NM Lyon,AUS,Spin,2025-01-03,Sydney,Australia,2025,1,19,36,1,1,137,216,4,118,180,3,34.25,>30,AUS,Home,After 1965
NM Lyon,AUS,Spin,2025-01-29,Galle,Sri Lanka,2025,2,135,234,7,1,941,1397,23,806,1163,16,40.91304347826087,>30,SL,Away,After 1965
NO Miller,WI,Spin,2009-07-09,Kingstown,West Indies,2009,2,67,132,0,1,504,1195,18,437,1063,18,28.0,<=30,WI,Home,Upto 2014
NO Norton,SA,Pace,1910-03-11,Cape Town,South Africa,1910,1,47,90,4,1,301,570,12,254,480,8,25.083333333333332,<=30,SA,Home,Upto 2014
NO Perry,WI,Spin,1999-03-13,Kingston,West Indies,1999,2,149,258,6,1,346,591,10,197,333,4,34.6,>30,WI,Home,Upto 2014
NO Perry,WI,Spin,1999-03-26,Bridgetown,West Indies,1999,2,113,222,3,1,408,819,7,295,597,4,58.285714285714285,>30,WI,Home,Upto 2014
NO Perry,WI,Spin,1999-04-03,St John's,West Indies,1999,2,64,132,1,1,396,930,13,332,798,12,30.46153846153846,>30,WI,Home,Upto 2014
NO Perry,WI,Spin,1999-12-26,Wellington,New Zealand,1999,1,120,192,0,1,335,762,4,215,570,4,83.75,>30,NZ,Away,Upto 2014
NR Chowdhury,IND,Pace,1949-01-27,Chennai,India,1949,1,130,222,1,1,442,1095,18,312,873,17,24.555555555555557,<=30,IND,Home,Upto 2014
NR Chowdhury,IND,Pace,1951-11-02,Delhi,India,1951,2,75,294,0,1,354,1056,2,279,762,2,177.0,>30,IND,Home,Upto 2014
NS Sidhu,IND,Pace,1983-12-24,Chennai,India,1983,1,9,6,0,1,443,882,12,434,876,12,36.916666666666664,>30,IND,Home,Upto 2014
NS Yadav,IND,Spin,1979-09-19,Bengaluru,India,1979,2,81,231,7,1,418,1101,14,337,870,7,29.857142857142858,<=30,IND,Home,Upto 2014
NS Yadav,IND,Spin,1979-10-02,Kanpur,India,1979,2,100,222,6,1,449,1116,12,349,894,6,37.416666666666664,>30,IND,Home,Upto 2014
NS Yadav,IND,Spin,1979-10-13,Delhi,India,1979,2,157,378,3,1,604,1308,12,447,930,9,50.333333333333336,>30,IND,Home,Upto 2014
NS Yadav,IND,Spin,1979-10-26,Eden Gardens,India,1979,2,151,318,3,1,581,1386,14,430,1068,11,41.5,>30,IND,Home,Upto 2014
NS Yadav,IND,Spin,1979-11-03,Wankhede,India,1979,2,88,258,5,1,457,1061,17,369,803,12,26.88235294117647,<=30,IND,Home,Upto 2014
NS Yadav,IND,Spin,1979-11-21,Bengaluru,India,1979,2,136,300,3,1,552,1383,11,416,1083,8,50.18181818181818,>30,IND,Home,Upto 2014
NS Yadav,IND,Spin,1979-12-04,Delhi,India,1979,2,89,150,0,1,303,672,3,214,522,3,101.0,>30,IND,Home,Upto 2014
NS Yadav,IND,Spin,1979-12-16,Wankhede,India,1979,2,47,88,5,1,435,1053,22,388,965,17,19.772727272727273,<=30,IND,Home,Upto 2014
NS Yadav,IND,Spin,1979-12-25,Kanpur,India,1979,1,21,30,0,1,100,282,2,79,252,2,50.0,>30,IND,Home,Upto 2014
NS Yadav,IND,Spin,1980-01-29,Eden Gardens,India,1980,2,49,84,0,1,248,600,5,199,516,5,49.6,>30,IND,Home,Upto 2014
NS Yadav,IND,Spin,1980-02-15,Wankhede,India,1980,2,53,72,0,1,158,297,1,105,225,1,158.0,>30,IND,Home,Upto 2014
NS Yadav,IND,Spin,1981-01-23,Adelaide,Australia,1981,2,213,430,6,1,543,1406,16,330,976,10,33.9375,>30,AUS,Away,Upto 2014
NS Yadav,IND,Spin,1981-02-07,Melbourne,Australia,1981,1,100,192,2,1,474,1128,11,374,936,9,43.09090909090909,>30,AUS,Away,Upto 2014
NS Yadav,IND,Spin,1981-03-13,Auckland,New Zealand,1981,2,111,264,1,1,519,1803,22,408,1539,21,23.59090909090909,<=30,NZ,Away,Upto 2014
NS Yadav,IND,Spin,1982-01-01,Eden Gardens,India,1982,2,53,120,0,1,396,1328,13,343,1208,13,30.46153846153846,>30,IND,Home,Upto 2014
NS Yadav,IND,Spin,1983-11-24,Wankhede,India,1983,2,153,337,5,1,386,913,10,233,576,5,38.6,>30,IND,Home,Upto 2014
NS Yadav,IND,Spin,1983-12-10,Eden Gardens,India,1983,1,80,162,3,1,206,486,5,126,324,2,41.2,>30,IND,Home,Upto 2014
NS Yadav,IND,Spin,1983-12-24,Chennai,India,1983,1,96,168,1,1,365,891,7,269,723,6,52.142857142857146,>30,IND,Home,Upto 2014
NS Yadav,IND,Spin,1984-10-24,Faisalabad,Pakistan,1984,1,196,450,1,1,475,1147,7,279,697,6,67.85714285714286,>30,PAK,Away,Upto 2014
NS Yadav,IND,Spin,1984-11-28,Wankhede,India,1984,2,98,246,3,1,629,1557,23,531,1311,20,27.347826086956523,<=30,IND,Home,Upto 2014
NS Yadav,IND,Spin,1984-12-12,Delhi,India,1984,2,102,228,2,1,622,1733,22,520,1505,20,28.272727272727273,<=30,IND,Home,Upto 2014
NS Yadav,IND,Spin,1984-12-31,Eden Gardens,India,1984,1,86,192,4,1,444,1182,10,358,990,6,44.4,>30,IND,Home,Upto 2014
NS Yadav,IND,Spin,1985-01-13,Chennai,India,1985,1,76,138,0,1,779,1355,9,703,1217,9,86.55555555555556,>30,IND,Home,Upto 2014
NS Yadav,IND,Spin,1985-12-13,Adelaide,Australia,1985,2,68,174,1,1,282,786,3,214,612,2,94.0,>30,AUS,Away,Upto 2014
NS Yadav,IND,Spin,1985-12-26,Melbourne,Australia,1985,2,148,400,6,1,583,1474,19,435,1074,13,30.68421052631579,>30,AUS,Away,Upto 2014
NS Yadav,IND,Spin,1986-01-02,Sydney,Australia,1986,2,118,573,8,1,700,1797,15,582,1224,7,46.666666666666664,>30,AUS,Away,Upto 2014
NS Yadav,IND,Spin,1986-09-18,Chennai,India,1986,2,177,353,4,1,1032,1788,27,855,1435,23,38.22222222222222,>30,IND,Home,Upto 2014
NS Yadav,IND,Spin,1986-09-26,Delhi,India,1986,1,46,78,0,1,149,340,2,103,262,2,74.5,>30,IND,Home,Upto 2014
NS Yadav,IND,Spin,1986-10-15,Wankhede,India,1986,2,136,388,4,1,676,1768,13,540,1380,9,52.0,>30,IND,Home,Upto 2014
NS Yadav,IND,Spin,1986-12-27,Nagpur,India,1986,2,97,199,7,1,408,845,19,311,646,12,21.473684210526315,<=30,IND,Home,Upto 2014
NS Yadav,IND,Spin,1987-01-04,Cuttack,India,1987,2,53,168,4,1,354,865,18,301,697,14,19.666666666666668,<=30,IND,Home,Upto 2014
NS Yadav,IND,Spin,1987-02-03,Chennai,India,1987,2,156,336,1,1,827,1860,14,671,1524,13,59.07142857142857,>30,IND,Home,Upto 2014
NS Yadav,IND,Spin,1987-02-21,Jaipur,India,1987,1,65,150,1,1,591,1283,13,526,1133,12,45.46153846153846,>30,IND,Home,Upto 2014
NS Yadav,IND,Spin,1987-03-04,Ahmedabad,India,1987,2,127,375,4,1,616,1851,11,489,1476,7,56.0,>30,IND,Home,Upto 2014
NS Yadav,IND,Spin,1987-03-13,Bengaluru,India,1987,2,53,108,2,1,527,1530,35,474,1422,33,15.057142857142857,<=30,IND,Home,Upto 2014
NT Nyamhuri,ZIM,Spin,2024-12-26,Bulawayo,Zimbabwe,2024,1,82,138,1,1,1189,1856,20,1107,1718,19,59.45,>30,ZIM,Home,After 1965
NT Nyamhuri,ZIM,Spin,2025-01-02,Bulawayo,Zimbabwe,2025,2,102,153,3,1,588,1149,23,486,996,20,25.565217391304348,<=30,ZIM,Home,After 1965
NT Paranavitana,SL,Spin,2009-02-21,Karachi,Pakistan,2009,1,33,30,0,1,883,1568,9,850,1538,9,98.11111111111111,>30,PAK,Away,Upto 2014
NT Paranavitana,SL,Spin,2009-07-12,Colombo (PSS),Sri Lanka,2009,1,26,36,1,1,425,767,15,399,731,14,28.333333333333332,<=30,SL,Home,Upto 2014
NT Paranavitana,SL,Spin,2009-08-18,Galle,Sri Lanka,2009,1,8,12,0,1,652,1329,16,644,1317,16,40.75,>30,SL,Home,Upto 2014
NT Paranavitana,SL,Spin,2009-08-26,Colombo (SSC),Sri Lanka,2009,1,2,6,0,1,760,1587,27,758,1581,27,28.14814814814815,<=30,SL,Home,Upto 2014
NT Paranavitana,SL,Spin,2009-11-16,Ahmedabad,India,2009,1,7,6,0,1,904,1575,9,897,1569,9,100.44444444444444,>30,IND,Away,Upto 2014
NT Paranavitana,SL,Spin,2011-09-16,Colombo (SSC),Sri Lanka,2011,1,10,12,0,1,436,882,9,426,870,9,48.44444444444444,>30,SL,Home,Upto 2014
NT Pascal,WI,Pace,2010-06-10,Port of Spain,West Indies,2010,2,59,102,0,1,433,932,18,374,830,18,24.055555555555557,<=30,WI,Home,Upto 2014
NV Radford,ENG,Pace,1986-07-03,Birmingham,England,1986,2,148,228,2,1,804,1599,21,656,1371,19,38.285714285714285,>30,ENG,Home,Upto 2014
NV Radford,ENG,Pace,1986-07-24,Lord's,England,1986,1,71,150,1,1,599,1428,17,528,1278,16,35.23529411764706,>30,ENG,Home,Upto 2014
NV Radford,ENG,Pace,1988-02-25,Auckland,New Zealand,1988,2,132,300,1,1,724,1989,22,592,1689,21,32.90909090909091,>30,NZ,Away,Upto 2014
NW Bracken,AUS,Pace,2003-12-04,Brisbane,Australia,2003,2,102,180,3,1,735,1213,18,633,1033,15,40.833333333333336,>30,AUS,Home,Upto 2014
NW Bracken,AUS,Pace,2003-12-26,Melbourne,Australia,2003,2,116,318,3,1,819,1520,17,703,1202,14,48.1764705882353,>30,AUS,Home,Upto 2014
NW Bracken,AUS,Pace,2004-01-02,Sydney,Australia,2004,2,133,270,0,1,876,1379,11,743,1109,11,79.63636363636364,>30,AUS,Home,Upto 2014
NW Bracken,AUS,Pace,2005-11-03,Brisbane,Australia,2005,2,71,156,4,1,772,1215,25,701,1059,21,30.88,>30,AUS,Home,Upto 2014
NW Bracken,AUS,Pace,2005-12-16,W.A.C.A,Australia,2005,2,83,186,2,1,1099,2050,27,1016,1864,25,40.7037037037037,>30,AUS,Home,Upto 2014
NWD Yardley,ENG,Pace,1946-11-29,Brisbane,Australia,1946,1,47,104,0,1,604,1516,23,557,1412,23,26.26086956521739,<=30,AUS,Away,Upto 2014
NWD Yardley,ENG,Pace,1946-12-13,Sydney,Australia,1946,1,23,72,1,1,412,1072,9,389,1000,8,45.77777777777778,>30,AUS,Away,Upto 2014
NWD Yardley,ENG,Pace,1947-01-01,Melbourne,Australia,1947,2,117,320,5,1,922,1990,21,805,1670,16,43.904761904761905,>30,AUS,Away,Upto 2014
NWD Yardley,ENG,Pace,1947-01-31,Adelaide,Australia,1947,2,170,352,4,1,774,1993,20,604,1641,16,38.7,>30,AUS,Away,Upto 2014
NWD Yardley,ENG,Pace,1947-02-28,Sydney,Australia,1947,2,15,64,0,1,392,1131,16,377,1067,16,24.5,<=30,AUS,Away,Upto 2014
NWD Yardley,ENG,Pace,1947-03-21,Christchurch,New Zealand,1947,1,12,24,1,1,372,820,16,360,796,15,23.25,<=30,NZ,Away,Upto 2014
NWD Yardley,ENG,Pace,1947-06-07,Nottingham,England,1947,1,24,30,0,1,512,1333,14,488,1303,14,36.57142857142857,>30,ENG,Home,Upto 2014
NWD Yardley,ENG,Pace,1947-08-16,The Oval,England,1947,1,1,6,0,1,526,1254,9,525,1248,9,58.44444444444444,>30,ENG,Home,Upto 2014
NWD Yardley,ENG,Pace,1948-06-10,Nottingham,England,1948,1,32,102,2,1,600,1427,17,568,1325,15,35.294117647058826,>30,ENG,Home,Upto 2014
NWD Yardley,ENG,Pace,1948-06-24,Lord's,England,1948,2,71,168,4,1,703,1601,26,632,1433,22,27.03846153846154,<=30,ENG,Home,Upto 2014
NWD Yardley,ENG,Pace,1948-07-08,Manchester,England,1948,1,12,24,0,1,513,1476,16,501,1452,16,32.0625,>30,ENG,Home,Upto 2014
NWD Yardley,ENG,Pace,1948-07-22,Leeds,England,1948,2,82,180,3,1,942,2038,19,860,1858,16,49.578947368421055,>30,ENG,Home,Upto 2014
NWD Yardley,ENG,Pace,1948-08-14,The Oval,England,1948,1,7,30,0,1,239,753,15,232,723,15,15.933333333333334,<=30,ENG,Home,Upto 2014
NWD Yardley,ENG,Pace,1950-06-24,Lord's,England,1950,1,12,24,0,1,279,874,5,267,850,5,55.8,>30,ENG,Home,Upto 2014
NWD Yardley,ENG,Pace,1950-07-20,Nottingham,England,1950,1,82,162,1,1,535,1228,10,453,1066,9,53.5,>30,ENG,Home,Upto 2014
Nadeem Ghauri,PAK,Spin,1990-02-03,Sydney,Australia,1990,1,20,48,0,1,105,210,1,85,162,1,105.0,>30,AUS,Away,Upto 2014
Nadeem Khan,PAK,Spin,1993-05-01,St John's,West Indies,1993,2,195,312,2,1,315,516,3,120,204,1,105.0,>30,WI,Away,Upto 2014
Nadeem Khan,PAK,Spin,1999-01-28,Chennai,India,1999,2,35,120,0,1,572,1226,24,537,1106,24,23.833333333333332,<=30,IND,Away,Upto 2014
Naeem Islam,BAN,Spin,2008-10-17,Chattogram,Bangladesh,2008,2,27,90,1,1,669,1820,29,642,1730,28,23.06896551724138,<=30,BAN,Home,Upto 2014
Naeem Islam,BAN,Spin,2008-11-19,Bloemfontein,South Africa,2008,1,19,30,0,1,324,498,7,305,468,7,46.285714285714285,>30,SA,Away,Upto 2014
Naeem Islam,BAN,Spin,2010-03-12,Chattogram,Bangladesh,2010,2,56,90,0,1,894,1491,22,838,1401,22,40.63636363636363,>30,BAN,Home,Upto 2014
Naeem Islam,BAN,Spin,2010-03-20,Mirpur,Bangladesh,2010,2,48,66,0,1,865,1792,20,817,1726,20,43.25,>30,BAN,Home,Upto 2014
Naeem Islam,BAN,Spin,2011-10-21,Chattogram,Bangladesh,2011,1,4,12,0,1,473,864,18,469,852,18,26.27777777777778,<=30,BAN,Home,Upto 2014
Naeem Islam,BAN,Spin,2011-10-29,Mirpur,Bangladesh,2011,2,52,96,0,1,846,1669,23,794,1573,23,36.78260869565217,>30,BAN,Home,Upto 2014
Naeem Islam,BAN,Spin,2012-11-13,Mirpur,Bangladesh,2012,2,46,96,0,1,992,1679,19,946,1583,19,52.21052631578947,>30,BAN,Home,Upto 2014
Naeem Islam,BAN,Spin,2012-11-21,Khulna,Bangladesh,2012,2,51,94,0,1,763,1327,11,712,1233,11,69.36363636363636,>30,BAN,Home,Upto 2014
Nahid Rana,BAN,Pace,2024-03-22,Sylhet,Bangladesh,2024,2,215,204,5,1,733,1127,31,518,923,26,23.64516129032258,<=30,BAN,Home,After 1965
Nahid Rana,BAN,Pace,2024-08-21,Rawalpindi,Pakistan,2024,2,135,150,1,1,696,1287,16,561,1137,15,43.5,>30,PAK,Away,After 1965
Nahid Rana,BAN,Pace,2024-08-30,Rawalpindi,Pakistan,2024,2,102,156,5,1,585,958,24,483,802,19,24.375,<=30,PAK,Away,After 1965
Nahid Rana,BAN,Pace,2024-09-19,Chennai,India,2024,2,103,144,2,1,481,825,20,378,681,18,24.05,<=30,IND,Away,After 1965
Nahid Rana,BAN,Pace,2024-10-29,Chattogram,Bangladesh,2024,1,83,144,1,1,267,480,9,184,336,8,29.666666666666668,<=30,BAN,Home,After 1965
Nahid Rana,BAN,Pace,2024-11-30,Kingston,West Indies,2024,2,93,162,6,1,598,1162,33,505,1000,27,18.12121212121212,<=30,WI,Away,After 1965
Naimur Rahman,BAN,Spin,2000-11-10,Dhaka,Bangladesh,2000,2,154,291,6,1,558,1251,19,404,960,13,29.36842105263158,<=30,BAN,Home,Upto 2014
Naimur Rahman,BAN,Spin,2001-04-19,Bulawayo,Zimbabwe,2001,1,74,148,1,1,136,274,2,62,126,1,68.0,>30,ZIM,Away,Upto 2014
Naimur Rahman,BAN,Spin,2001-04-26,Harare,Zimbabwe,2001,2,68,171,2,1,348,861,12,280,690,10,29.0,<=30,ZIM,Away,Upto 2014
Naimur Rahman,BAN,Spin,2001-08-29,Multan,Pakistan,2001,1,77,114,0,1,304,445,14,227,331,14,21.714285714285715,<=30,PAK,Away,Upto 2014
Naimur Rahman,BAN,Spin,2001-09-06,Colombo (SSC),Sri Lanka,2001,1,117,183,2,1,422,724,14,305,541,12,30.142857142857142,>30,SL,Away,Upto 2014
Naimur Rahman,BAN,Spin,2001-11-08,Dhaka,Bangladesh,2001,1,56,108,0,1,256,612,4,200,504,4,64.0,>30,BAN,Home,Upto 2014
Naimur Rahman,BAN,Spin,2001-11-15,Chattogram,Bangladesh,2001,1,54,90,0,1,538,1183,18,484,1093,18,29.88888888888889,<=30,BAN,Home,Upto 2014
Naimur Rahman,BAN,Spin,2002-12-08,Dhaka,Bangladesh,2002,1,118,216,1,1,276,570,4,158,354,3,69.0,>30,BAN,Home,Upto 2014
Najmul Hossain Shanto,BAN,Spin,2017-01-20,Christchurch,New Zealand,2017,1,13,4,0,1,177,254,6,164,250,6,29.5,<=30,NZ,Away,After 1965
Najmul Hossain Shanto,BAN,Spin,2022-01-01,Mount Maunganui,New Zealand,2022,1,10,12,0,1,219,557,6,209,545,6,36.5,>30,NZ,Away,After 1965
Najmul Hossain Shanto,BAN,Spin,2022-01-09,Christchurch,New Zealand,2022,1,15,24,0,1,174,231,2,159,207,2,87.0,>30,NZ,Away,After 1965
Najmul Hossain Shanto,BAN,Spin,2022-03-31,Durban,South Africa,2022,1,3,6,0,1,428,1068,20,425,1062,20,21.4,<=30,SA,Away,After 1965
Najmul Hossain Shanto,BAN,Spin,2022-04-08,Gqeberha,South Africa,2022,1,9,18,0,1,500,972,27,491,954,27,18.51851851851852,<=30,SA,Away,After 1965
Najmul Hossain Shanto,BAN,Spin,2022-05-15,Chattogram,Bangladesh,2022,1,2,6,0,1,772,1873,17,770,1867,17,45.411764705882355,>30,BAN,Home,After 1965
Najmul Hossain Shanto,BAN,Spin,2022-06-16,North Sound,West Indies,2022,2,10,12,0,1,173,401,5,163,389,5,34.6,>30,WI,Away,After 1965
Najmul Hossain Shanto,BAN,Spin,2022-12-14,Chattogram,Bangladesh,2022,2,19,30,0,1,800,1534,23,781,1504,23,34.78260869565217,>30,BAN,Home,After 1965
Najmul Hossain Shanto,BAN,Spin,2024-03-22,Sylhet,Bangladesh,2024,1,5,6,0,1,284,550,7,279,544,7,40.57142857142857,>30,BAN,Home,After 1965
Naoomal Jaoomal,IND,Spin,1932-06-25,Lord's,England,1932,2,48,66,1,1,320,726,9,272,660,8,35.55555555555556,>30,ENG,Away,Upto 2014
Naoomal Jaoomal,IND,Spin,1934-01-05,Eden Gardens,India,1934,1,4,6,1,1,342,922,15,338,916,14,22.8,<=30,IND,Home,Upto 2014
Naoomal Jaoomal,IND,Spin,1934-02-10,Chennai,India,1934,1,16,36,0,1,484,943,18,468,907,18,26.88888888888889,<=30,IND,Home,Upto 2014
Naseem Shah,PAK,Pace,2019-11-21,Brisbane,Australia,2019,1,68,120,1,1,600,1180,22,532,1060,21,27.272727272727273,<=30,AUS,Away,After 1965
Naseem Shah,PAK,Pace,2019-12-11,Rawalpindi,Pakistan,2019,1,92,162,2,1,376,750,8,284,588,6,47.0,>30,PAK,Home,After 1965
Naseem Shah,PAK,Pace,2019-12-19,Karachi,Pakistan,2019,2,102,173,5,1,653,1162,24,551,989,19,27.208333333333332,<=30,PAK,Home,After 1965
Naseem Shah,PAK,Pace,2020-02-07,Rawalpindi,Pakistan,2020,2,87,146,5,1,527,1060,20,440,914,15,26.35,<=30,PAK,Home,After 1965
Naseem Shah,PAK,Pace,2020-08-05,Manchester,England,2020,2,89,174,2,1,609,1268,24,520,1094,22,25.375,<=30,ENG,Away,After 1965
Naseem Shah,PAK,Pace,2020-08-13,Southampton,England,2020,1,10,30,0,1,292,740,12,282,710,12,24.333333333333332,<=30,ENG,Away,After 1965
Naseem Shah,PAK,Pace,2020-08-21,Southampton,England,2020,1,109,162,1,1,619,1361,14,510,1199,13,44.214285714285715,>30,ENG,Away,After 1965
Naseem Shah,PAK,Pace,2020-12-26,Mount Maunganui,New Zealand,2020,2,151,225,4,1,873,2105,28,722,1880,24,31.178571428571427,>30,NZ,Away,After 1965
Naseem Shah,PAK,Pace,2021-01-03,Christchurch,New Zealand,2021,1,141,156,0,1,918,1730,25,777,1574,25,36.72,>30,NZ,Away,After 1965
Naseem Shah,PAK,Pace,2022-03-04,Rawalpindi,Pakistan,2022,1,89,126,1,1,479,990,4,390,864,3,119.75,>30,PAK,Home,After 1965
Naseem Shah,PAK,Pace,2022-03-21,Lahore,Pakistan,2022,2,81,258,5,1,523,1268,24,442,1010,19,21.791666666666668,<=30,PAK,Home,After 1965
Naseem Shah,PAK,Pace,2022-07-16,Galle,Sri Lanka,2022,2,77,120,2,1,258,511,10,181,391,8,25.8,<=30,SL,Away,After 1965
Naseem Shah,PAK,Pace,2022-07-24,Galle,Sri Lanka,2022,2,102,185,5,1,287,503,6,185,318,1,47.833333333333336,>30,SL,Away,After 1965
Naseem Shah,PAK,Pace,2022-12-01,Rawalpindi,Pakistan,2022,2,206,203,5,1,786,1181,21,580,978,16,37.42857142857143,>30,PAK,Home,After 1965
Naseem Shah,PAK,Pace,2023-01-02,Karachi,Pakistan,2023,2,114,222,4,1,583,1266,12,469,1044,8,48.583333333333336,>30,PAK,Home,After 1965
Naseem Shah,PAK,Pace,2023-07-16,Galle,Sri Lanka,2023,2,122,204,3,1,424,660,10,302,456,7,42.4,>30,SL,Away,After 1965
Naseem Shah,PAK,Pace,2023-07-24,Colombo (SSC),Sri Lanka,2023,2,85,190,6,1,369,580,10,284,390,4,36.9,>30,SL,Away,After 1965
Naseem Shah,PAK,Pace,2024-08-21,Rawalpindi,Pakistan,2024,2,100,183,3,1,696,1287,16,596,1104,13,43.5,>30,PAK,Home,After 1965
Naseem Shah,PAK,Pace,2024-10-07,Multan,Pakistan,2024,1,157,186,2,1,658,930,10,501,744,8,65.8,>30,PAK,Home,After 1965
Naseem Shah,PAK,Pace,2024-12-26,Centurion,South Africa,2024,2,126,186,4,1,742,1206,32,616,1020,28,23.1875,<=30,SA,Away,After 1965
Nasim-ul-Ghani,PAK,Spin,1958-01-17,Bridgetown,West Indies,1958,1,51,84,0,1,679,1898,11,628,1814,11,61.72727272727273,>30,WI,Away,Upto 2014
Nasim-ul-Ghani,PAK,Spin,1958-02-05,Port of Spain,West Indies,1958,2,106,279,6,1,477,1223,18,371,944,12,26.5,<=30,WI,Away,Upto 2014
Nasim-ul-Ghani,PAK,Spin,1958-02-26,Kingston,West Indies,1958,1,39,90,0,1,450,846,3,411,756,3,150.0,>30,WI,Away,Upto 2014
Nasim-ul-Ghani,PAK,Spin,1958-03-13,Georgetown,West Indies,1958,2,192,418,5,1,1032,2327,20,840,1909,15,51.6,>30,WI,Away,Upto 2014
Nasim-ul-Ghani,PAK,Spin,1958-03-26,Port of Spain,West Indies,1958,2,120,318,8,1,527,1152,14,407,834,6,37.642857142857146,>30,WI,Away,Upto 2014
Nasim-ul-Ghani,PAK,Spin,1959-02-20,Karachi,Pakistan,1959,2,69,246,5,1,375,1262,15,306,1016,10,25.0,<=30,PAK,Home,Upto 2014
Nasim-ul-Ghani,PAK,Spin,1959-03-06,Dhaka,Bangladesh,1959,2,38,90,3,1,170,591,9,132,501,6,18.88888888888889,<=30,BAN,Away,Upto 2014
Nasim-ul-Ghani,PAK,Spin,1959-03-26,Lahore,Pakistan,1959,1,106,180,3,1,360,902,15,254,722,12,24.0,<=30,PAK,Home,Upto 2014
Nasim-ul-Ghani,PAK,Spin,1959-11-13,Dhaka,Bangladesh,1959,2,67,162,3,1,203,699,11,136,537,8,18.454545454545453,<=30,BAN,Away,Upto 2014
Nasim-ul-Ghani,PAK,Spin,1959-11-21,Lahore,Pakistan,1959,2,90,147,1,1,563,1378,18,473,1231,17,31.27777777777778,>30,PAK,Home,Upto 2014
Nasim-ul-Ghani,PAK,Spin,1960-12-02,Brabourne,India,1960,1,74,246,0,1,412,1324,9,338,1078,9,45.77777777777778,>30,IND,Away,Upto 2014
Nasim-ul-Ghani,PAK,Spin,1960-12-16,Kanpur,India,1960,1,109,330,1,1,619,1984,16,510,1654,15,38.6875,>30,IND,Away,Upto 2014
Nasim-ul-Ghani,PAK,Spin,1960-12-30,Eden Gardens,India,1960,2,37,84,0,1,295,842,11,258,758,11,26.818181818181817,<=30,IND,Away,Upto 2014
Nasim-ul-Ghani,PAK,Spin,1961-01-13,Chennai,India,1961,1,123,276,2,1,664,1638,11,541,1362,9,60.36363636363637,>30,IND,Away,Upto 2014
Nasim-ul-Ghani,PAK,Spin,1962-01-19,Dhaka,Bangladesh,1962,2,119,318,2,1,862,2494,25,743,2176,23,34.48,>30,BAN,Away,Upto 2014
Nasim-ul-Ghani,PAK,Spin,1962-02-02,Karachi,Pakistan,1962,1,125,270,3,1,769,2063,17,644,1793,14,45.23529411764706,>30,PAK,Home,Upto 2014
Nasim-ul-Ghani,PAK,Spin,1962-05-31,Birmingham,England,1962,1,109,180,0,1,664,1386,13,555,1206,13,51.07692307692308,>30,ENG,Away,Upto 2014
Nasim-ul-Ghani,PAK,Spin,1962-06-21,Lord's,England,1962,1,15,12,0,1,359,496,6,344,484,6,59.833333333333336,>30,ENG,Away,Upto 2014
Nasim-ul-Ghani,PAK,Spin,1962-07-05,Leeds,England,1962,1,68,84,2,1,208,474,7,140,390,5,29.714285714285715,<=30,ENG,Away,Upto 2014
Nasim-ul-Ghani,PAK,Spin,1962-07-26,Nottingham,England,1962,1,76,122,0,1,232,572,3,156,450,3,77.33333333333333,>30,ENG,Away,Upto 2014
Nasim-ul-Ghani,PAK,Spin,1962-08-16,The Oval,England,1962,1,39,54,1,1,452,1071,6,413,1017,5,75.33333333333333,>30,ENG,Away,Upto 2014
Nasim-ul-Ghani,PAK,Spin,1964-10-24,Karachi,Pakistan,1964,2,41,96,1,1,840,2130,18,799,2034,17,46.666666666666664,>30,PAK,Home,Upto 2014
Nasim-ul-Ghani,PAK,Spin,1964-12-04,Melbourne,Australia,1964,1,36,32,0,1,473,1030,6,437,998,6,78.83333333333333,>30,AUS,Away,Upto 2014
Nasim-ul-Ghani,PAK,Spin,1965-01-22,Wellington,New Zealand,1965,1,5,18,0,1,356,1080,8,351,1062,8,44.5,>30,NZ,Away,Upto 2014
Nasim-ul-Ghani,PAK,Spin,1965-01-29,Auckland,New Zealand,1965,1,9,30,1,1,450,1734,24,441,1704,23,18.75,<=30,NZ,Away,Upto 2014
Nasim-ul-Ghani,PAK,Spin,1965-02-12,Christchurch,New Zealand,1965,2,8,42,1,1,466,1098,16,458,1056,15,29.125,<=30,NZ,Away,Upto 2014
Nasim-ul-Ghani,PAK,Spin,1967-07-27,Lord's,England,1967,2,68,150,3,1,583,1689,19,515,1539,16,30.68421052631579,>30,ENG,Away,Upto 2014
Nasim-ul-Ghani,PAK,Spin,1967-08-10,Nottingham,England,1967,1,20,48,1,1,240,772,12,220,724,11,20.0,<=30,ENG,Away,Upto 2014
Nasir Hossain,BAN,Spin,2011-10-21,Chattogram,Bangladesh,2011,2,19,54,0,1,473,864,18,454,810,18,26.27777777777778,<=30,BAN,Home,Upto 2014
Nasir Hossain,BAN,Spin,2011-10-29,Mirpur,Bangladesh,2011,2,130,300,3,1,846,1669,23,716,1369,20,36.78260869565217,>30,BAN,Home,Upto 2014
Nasir Hossain,BAN,Spin,2011-12-09,Chattogram,Bangladesh,2011,1,5,12,0,1,717,1447,18,712,1435,18,39.833333333333336,>30,BAN,Home,Upto 2014
Nasir Hossain,BAN,Spin,2011-12-17,Mirpur,Bangladesh,2011,1,24,54,0,1,690,1381,17,666,1327,17,40.588235294117645,>30,BAN,Home,Upto 2014
Nasir Hossain,BAN,Spin,2012-11-13,Mirpur,Bangladesh,2012,2,26,24,0,1,992,1679,19,966,1655,19,52.21052631578947,>30,BAN,Home,Upto 2014
Nasir Hossain,BAN,Spin,2012-11-21,Khulna,Bangladesh,2012,1,29,72,0,1,763,1327,11,734,1255,11,69.36363636363636,>30,BAN,Home,Upto 2014
Nasir Hossain,BAN,Spin,2013-03-08,Galle,Sri Lanka,2013,1,18,18,0,1,1160,1920,13,1142,1902,13,89.23076923076923,>30,SL,Away,Upto 2014
Nasir Hossain,BAN,Spin,2013-03-16,Colombo (RPS),Sri Lanka,2013,2,13,36,0,1,481,1042,18,468,1006,18,26.72222222222222,<=30,SL,Away,Upto 2014
Nasir Hossain,BAN,Spin,2013-04-17,Harare,Zimbabwe,2013,1,3,30,0,1,326,755,9,323,725,9,36.22222222222222,>30,ZIM,Away,Upto 2014
Nasir Hossain,BAN,Spin,2013-10-09,Chattogram,Bangladesh,2013,2,39,84,2,1,1057,1946,22,1018,1862,20,48.04545454545455,>30,BAN,Home,Upto 2014
Nasir Hossain,BAN,Spin,2013-10-21,Mirpur,Bangladesh,2013,1,7,18,1,1,460,965,12,453,947,11,38.333333333333336,>30,BAN,Home,Upto 2014
Nasir Hossain,BAN,Spin,2014-01-27,Mirpur,Bangladesh,2014,1,60,65,0,1,658,946,13,598,881,13,50.61538461538461,>30,BAN,Home,After 1965
Nasir Hossain,BAN,Spin,2014-02-04,Chattogram,Bangladesh,2014,2,29,58,2,1,1153,1976,25,1124,1918,23,46.12,>30,BAN,Home,After 1965
Nasir Hossain,BAN,Spin,2014-09-05,Kingstown,West Indies,2014,1,4,24,0,1,510,1180,16,506,1156,16,31.875,>30,WI,Away,After 1965
Nasir Hossain,BAN,Spin,2014-09-13,Gros Islet,West Indies,2014,1,7,12,0,1,411,807,13,404,795,13,31.615384615384617,>30,WI,Away,After 1965
Nasir Hossain,BAN,Spin,2017-08-27,Mirpur,Bangladesh,2017,2,5,24,0,1,693,1433,34,688,1409,34,20.38235294117647,<=30,BAN,Home,After 1965
Nasir Hossain,BAN,Spin,2017-09-04,Chattogram,Bangladesh,2017,2,24,39,0,1,709,1537,24,685,1498,24,29.541666666666668,<=30,BAN,Home,After 1965
Nasir Jamal,AFG,Spin,2023-06-14,Mirpur,Bangladesh,2023,1,4,12,0,1,497,697,11,493,685,11,45.18181818181818,>30,BAN,Away,After 1965
Naved Anjum,PAK,Pace,1989-11-23,Faisalabad,Pakistan,1989,2,149,306,4,1,850,1756,23,701,1450,19,36.95652173913044,>30,PAK,Home,Upto 2014
Naved Anjum,PAK,Pace,1990-10-26,Faisalabad,Pakistan,1990,1,13,36,0,1,725,1761,39,712,1725,39,18.58974358974359,<=30,PAK,Home,Upto 2014
Naved-ul-Hasan,PAK,Pace,2004-10-28,Karachi,Pakistan,2004,2,135,251,3,1,689,1333,19,554,1082,16,36.26315789473684,>30,PAK,Home,Upto 2014
Naved-ul-Hasan,PAK,Pace,2005-01-02,Sydney,Australia,2005,2,135,174,3,1,541,846,9,406,672,6,60.111111111111114,>30,AUS,Away,Upto 2014
Naved-ul-Hasan,PAK,Pace,2005-03-08,Mohali,India,2005,2,139,204,1,1,866,1468,17,727,1264,16,50.94117647058823,>30,IND,Away,Upto 2014
Naved-ul-Hasan,PAK,Pace,2005-05-26,Bridgetown,West Indies,2005,2,154,252,1,1,722,1198,25,568,946,24,28.88,<=30,WI,Away,Upto 2014
Naved-ul-Hasan,PAK,Pace,2005-06-03,Kingston,West Indies,2005,1,50,36,0,1,832,1351,29,782,1315,29,28.689655172413794,<=30,WI,Away,Upto 2014
Naved-ul-Hasan,PAK,Pace,2005-11-20,Faisalabad,Pakistan,2005,2,93,192,5,1,802,1439,26,709,1247,21,30.846153846153847,>30,PAK,Home,Upto 2014
Naved-ul-Hasan,PAK,Pace,2005-11-29,Lahore,Pakistan,2005,2,131,216,2,1,870,1496,17,739,1280,15,51.1764705882353,>30,PAK,Home,Upto 2014
Naved-ul-Hasan,PAK,Pace,2006-01-13,Lahore,Pakistan,2006,1,94,96,1,1,476,638,4,382,542,3,119.0,>30,PAK,Home,Upto 2014
Naved-ul-Hasan,PAK,Pace,2007-01-11,Centurion,South Africa,2007,2,113,144,2,1,894,1492,25,781,1348,23,35.76,>30,SA,Away,Upto 2014
Naveed Zadran,AFG,Pace,2024-02-02,Colombo (SSC),Sri Lanka,2024,2,113,155,4,1,535,897,18,422,742,14,29.72222222222222,<=30,SL,Away,After 1965
Naveed Zadran,AFG,Pace,2024-02-28,Tolerance Oval,UAE,2024,2,90,165,5,1,418,850,26,328,685,21,16.076923076923077,<=30,UAE,Away,After 1965
Naveed Zadran,AFG,Pace,2024-12-26,Bulawayo,Zimbabwe,2024,2,127,174,2,1,179,342,3,52,168,1,59.666666666666664,>30,ZIM,Away,After 1965
Nayeem Hasan,BAN,Spin,2018-11-22,Chattogram,Bangladesh,2018,2,90,126,5,1,618,1097,34,528,971,29,18.176470588235293,<=30,BAN,Home,After 1965
Nayeem Hasan,BAN,Spin,2018-11-30,Mirpur,Bangladesh,2018,2,43,102,1,1,676,1230,27,633,1128,26,25.037037037037038,<=30,BAN,Home,After 1965
Nayeem Hasan,BAN,Spin,2019-09-05,Chattogram,Bangladesh,2019,2,104,180,4,1,903,1930,38,799,1750,34,23.763157894736842,<=30,BAN,Home,After 1965
Nayeem Hasan,BAN,Spin,2020-02-22,Mirpur,Bangladesh,2020,2,152,372,9,1,601,1116,18,449,744,9,33.388888888888886,>30,BAN,Home,After 1965
Nayeem Hasan,BAN,Spin,2021-02-03,Chattogram,Bangladesh,2021,2,159,303,3,1,955,2045,28,796,1742,25,34.107142857142854,>30,BAN,Home,After 1965
Nayeem Hasan,BAN,Spin,2021-02-11,Mirpur,Bangladesh,2021,2,108,239,3,1,665,1522,28,557,1283,25,23.75,<=30,BAN,Home,After 1965
Nayeem Hasan,BAN,Spin,2022-05-15,Chattogram,Bangladesh,2022,2,184,318,6,1,772,1873,17,588,1555,11,45.411764705882355,>30,BAN,Home,After 1965
Nayeem Hasan,BAN,Spin,2023-11-28,Sylhet,Bangladesh,2023,2,113,246,3,1,883,1678,32,770,1432,29,27.59375,<=30,BAN,Home,After 1965
Nayeem Hasan,BAN,Spin,2023-12-06,Mirpur,Bangladesh,2023,2,36,42,2,1,542,923,30,506,881,28,18.066666666666666,<=30,BAN,Home,After 1965
Nayeem Hasan,BAN,Spin,2024-10-21,Mirpur,Bangladesh,2024,2,69,120,0,1,586,1001,17,517,881,17,34.470588235294116,>30,BAN,Home,After 1965
Nazar Mohammad,PAK,Spin,1952-12-12,Eden Gardens,India,1952,1,4,12,0,1,455,1230,13,451,1218,13,35.0,>30,IND,Away,Upto 2014
Nazmul Hossain,BAN,Pace,2004-12-17,Chattogram,Bangladesh,2004,1,114,155,2,1,505,785,14,391,630,12,36.07142857142857,>30,BAN,Home,Upto 2014
Nazmul Hossain,BAN,Pace,2011-12-17,Mirpur,Bangladesh,2011,2,80,174,3,1,436,810,14,356,636,11,31.142857142857142,>30,BAN,Home,Upto 2014
Nazmul Islam,BAN,Spin,2018-11-03,Sylhet,Bangladesh,2018,2,76,174,4,1,549,1328,32,473,1154,28,17.15625,<=30,BAN,Home,After 1965
Niaz Ahmed,PAK,Pace,1967-08-10,Nottingham,England,1967,1,72,222,2,1,254,846,14,182,624,12,18.142857142857142,<=30,ENG,Away,Upto 2014
Niaz Ahmed,PAK,Pace,1969-02-28,Dhaka,Bangladesh,1969,2,22,72,1,1,300,937,11,278,865,10,27.272727272727273,<=30,BAN,Away,Upto 2014
Nijat Masood,AFG,Pace,2023-06-14,Mirpur,Bangladesh,2023,2,162,173,5,1,553,731,21,391,558,16,26.333333333333332,<=30,BAN,Away,After 1965
Nijat Masood,AFG,Pace,2024-02-02,Colombo (SSC),Sri Lanka,2024,2,81,122,2,1,535,897,18,454,775,16,29.72222222222222,<=30,SL,Away,After 1965
Nijat Masood,AFG,Pace,2024-02-28,Tolerance Oval,UAE,2024,2,65,124,2,1,418,850,26,353,726,24,16.076923076923077,<=30,UAE,Away,After 1965
Noman Ali,PAK,Spin,2021-01-26,Karachi,Pakistan,2021,2,73,255,7,1,369,904,18,296,649,11,20.5,<=30,PAK,Home,After 1965
Noman Ali,PAK,Spin,2021-02-04,Rawalpindi,Pakistan,2021,2,99,222,1,1,496,1138,13,397,916,12,38.15384615384615,>30,PAK,Home,After 1965
Noman Ali,PAK,Spin,2021-04-29,Harare,Zimbabwe,2021,2,56,120,3,1,256,510,4,200,390,1,64.0,>30,ZIM,Away,After 1965
Noman Ali,PAK,Spin,2021-05-07,Harare,Zimbabwe,2021,2,89,162,5,1,364,605,9,275,443,4,40.44444444444444,>30,ZIM,Away,After 1965
Noman Ali,PAK,Spin,2021-08-20,Kingston,West Indies,2021,2,53,138,3,1,122,240,4,69,102,1,30.5,>30,WI,Away,After 1965
Noman Ali,PAK,Spin,2021-11-26,Chattogram,Bangladesh,2021,2,85,210,0,1,541,1197,14,456,987,14,38.642857142857146,>30,BAN,Away,After 1965
Noman Ali,PAK,Spin,2021-12-04,Mirpur,Bangladesh,2021,2,74,192,0,1,366,844,15,292,652,15,24.4,<=30,BAN,Away,After 1965
Noman Ali,PAK,Spin,2022-03-04,Rawalpindi,Pakistan,2022,1,107,229,6,1,676,1285,9,569,1056,3,75.11111111111111,>30,PAK,Home,After 1965
Noman Ali,PAK,Spin,2022-03-12,Karachi,Pakistan,2022,2,141,294,1,1,673,1474,11,532,1180,10,61.18181818181818,>30,PAK,Home,After 1965
Noman Ali,PAK,Spin,2022-03-21,Lahore,Pakistan,2022,2,132,204,2,1,557,1146,9,425,942,7,61.888888888888886,>30,PAK,Home,After 1965
Noman Ali,PAK,Spin,2022-07-24,Galle,Sri Lanka,2022,2,118,210,2,1,907,1657,29,789,1447,27,31.275862068965516,>30,SL,Away,After 1965
Noman Ali,PAK,Spin,2022-12-17,Karachi,Pakistan,2022,2,164,210,4,1,895,1264,27,731,1054,23,33.148148148148145,>30,PAK,Home,After 1965
Noman Ali,PAK,Spin,2022-12-26,Karachi,Pakistan,2022,1,185,378,3,1,1086,2053,24,901,1675,21,45.25,>30,PAK,Home,After 1965
Noman Ali,PAK,Spin,2023-07-16,Galle,Sri Lanka,2023,2,120,228,3,1,731,1336,25,611,1108,22,29.24,<=30,SL,Away,After 1965
Noman Ali,PAK,Spin,2023-07-24,Colombo (SSC),Sri Lanka,2023,2,80,156,7,1,535,922,13,455,766,6,41.15384615384615,>30,SL,Away,After 1965
Noman Ali,PAK,Spin,2024-10-15,Multan,Pakistan,2024,2,147,267,11,1,831,1418,37,684,1151,26,22.45945945945946,<=30,PAK,Home,After 1965
Noman Ali,PAK,Spin,2024-10-24,Rawalpindi,Pakistan,2024,2,130,278,9,1,719,1161,29,589,883,20,24.79310344827586,<=30,PAK,Home,After 1965
Noman Ali,PAK,Spin,2025-01-17,Multan,Pakistan,2025,2,81,126,6,1,519,896,34,438,770,28,15.264705882352942,<=30,PAK,Home,After 1965
Noman Ali,PAK,Spin,2025-01-25,Multan,Pakistan,2025,2,121,217,10,1,637,1154,37,516,937,27,17.216216216216218,<=30,PAK,Home,After 1965
O Henry,SA,Spin,1992-11-13,Durban,South Africa,1992,1,56,115,2,1,210,547,7,154,432,5,30.0,<=30,SA,Home,Upto 2014
O Henry,SA,Spin,1992-12-26,Gqeberha,South Africa,1992,2,47,114,0,1,329,957,7,282,843,7,47.0,>30,SA,Home,Upto 2014
O Henry,SA,Spin,1993-01-02,Cape Town,South Africa,1993,1,86,198,1,1,326,1020,6,240,822,5,54.333333333333336,>30,SA,Home,Upto 2014
OA Shah,ENG,Spin,2009-02-15,St John's,West Indies,2009,1,12,18,0,1,563,1022,15,551,1004,15,37.53333333333333,>30,WI,Away,Upto 2014
OA Shah,ENG,Spin,2009-02-26,Bridgetown,West Indies,2009,1,19,12,0,1,611,1066,8,592,1054,8,76.375,>30,WI,Away,Upto 2014
OAC Banks,WI,Spin,2003-05-01,Bridgetown,West Indies,2003,2,206,246,3,1,500,956,13,294,710,10,38.46153846153846,>30,WI,Home,Upto 2014
OAC Banks,WI,Spin,2003-05-09,St John's,West Indies,2003,2,215,342,3,1,401,650,6,186,308,3,66.83333333333333,>30,WI,Home,Upto 2014
OAC Banks,WI,Spin,2003-06-20,Gros Islet,West Indies,2003,2,102,258,1,1,398,848,9,296,590,8,44.22222222222222,>30,WI,Home,Upto 2014
OAC Banks,WI,Spin,2003-06-27,Kingston,West Indies,2003,2,37,144,2,1,148,370,7,111,226,5,21.142857142857142,<=30,WI,Home,Upto 2014
OAC Banks,WI,Spin,2003-11-12,Bulawayo,Zimbabwe,2003,2,141,337,5,1,453,841,14,312,504,9,32.357142857142854,>30,ZIM,Away,Upto 2014
OAC Banks,WI,Spin,2004-06-04,Kingston,West Indies,2004,2,127,264,6,1,393,750,8,266,486,2,49.125,>30,WI,Home,Upto 2014
OAC Banks,WI,Spin,2004-07-22,Lord's,England,2004,2,223,288,2,1,526,874,12,303,586,10,43.833333333333336,>30,ENG,Away,Upto 2014
OAC Banks,WI,Spin,2004-07-29,Birmingham,England,2004,2,128,192,1,1,350,688,15,222,496,14,23.333333333333332,<=30,ENG,Away,Upto 2014
OAC Banks,WI,Spin,2005-07-13,Colombo (SSC),Sri Lanka,2005,2,101,138,2,1,301,612,9,200,474,7,33.44444444444444,>30,SL,Away,Upto 2014
OAC Banks,WI,Spin,2005-07-22,Kandy,Sri Lanka,2005,2,87,192,3,1,292,585,15,205,393,12,19.466666666666665,<=30,SL,Away,Upto 2014
OC Dawson,SA,Pace,1947-06-07,Nottingham,England,1947,2,92,228,3,1,512,1333,14,420,1105,11,36.57142857142857,>30,ENG,Away,Upto 2014
OC Dawson,SA,Pace,1947-06-21,Lord's,England,1947,2,87,234,1,1,440,1124,10,353,890,9,44.0,>30,ENG,Away,Upto 2014
OC Dawson,SA,Pace,1947-07-05,Manchester,England,1947,2,82,143,2,1,744,1735,22,662,1592,20,33.81818181818182,>30,ENG,Away,Upto 2014
OC Dawson,SA,Pace,1947-07-26,Leeds,England,1947,2,25,48,0,1,268,799,16,243,751,16,16.75,<=30,ENG,Away,Upto 2014
OC Dawson,SA,Pace,1947-08-16,The Oval,England,1947,2,139,300,2,1,526,1254,9,387,954,7,58.44444444444444,>30,ENG,Away,Upto 2014
OC Dawson,SA,Pace,1948-12-16,Durban,South Africa,1948,1,16,24,0,1,290,749,16,274,725,16,18.125,<=30,SA,Home,Upto 2014
OC Dawson,SA,Pace,1948-12-27,Johannesburg,South Africa,1948,1,59,133,1,1,428,1173,8,369,1040,7,53.5,>30,SA,Home,Upto 2014
OC Dawson,SA,Pace,1949-01-01,Cape Town,South Africa,1949,2,68,160,1,1,484,1256,6,416,1096,5,80.66666666666667,>30,SA,Home,Upto 2014
OC Dawson,SA,Pace,1949-03-05,Gqeberha,South Africa,1949,1,10,24,0,1,319,1001,10,309,977,10,31.9,>30,SA,Home,Upto 2014
OC Scott,WI,Spin,1928-07-21,Manchester,England,1928,1,28,56,2,1,291,903,19,263,847,17,15.31578947368421,<=30,ENG,Away,Upto 2014
OC Scott,WI,Spin,1928-08-11,The Oval,England,1928,1,75,84,0,1,308,610,14,233,526,14,22.0,<=30,ENG,Away,Upto 2014
OC Scott,WI,Spin,1930-04-03,Kingston,West Indies,1930,2,374,632,9,1,1040,2209,18,666,1577,9,57.77777777777778,>30,WI,Home,Upto 2014
OC Scott,WI,Spin,1930-12-12,Adelaide,Australia,1930,2,138,203,4,1,578,1434,23,440,1231,19,25.130434782608695,<=30,AUS,Away,Upto 2014
OC Scott,WI,Spin,1931-01-01,Sydney,Australia,1931,1,66,94,4,1,251,536,17,185,442,13,14.764705882352942,<=30,AUS,Away,Upto 2014
OC Scott,WI,Spin,1931-01-16,Brisbane,Australia,1931,1,125,144,1,1,426,888,13,301,744,12,32.76923076923077,>30,AUS,Away,Upto 2014
OC Scott,WI,Spin,1931-02-13,Melbourne,Australia,1931,1,47,66,0,1,273,612,18,226,546,18,15.166666666666666,<=30,AUS,Away,Upto 2014
OC Scott,WI,Spin,1931-02-27,Sydney,Australia,1931,2,72,126,2,1,469,1050,14,397,924,12,33.5,>30,AUS,Away,Upto 2014
OC da Costa,WI,Pace,1930-04-03,Kingston,West Indies,1930,2,95,162,2,1,684,1474,14,589,1312,12,48.857142857142854,>30,WI,Home,Upto 2014
OC da Costa,WI,Pace,1933-06-24,Lord's,England,1933,1,15,24,0,1,246,540,10,231,516,10,24.6,<=30,ENG,Away,Upto 2014
OC da Costa,WI,Pace,1933-07-22,Manchester,England,1933,1,12,60,0,1,416,958,13,404,898,13,32.0,>30,ENG,Away,Upto 2014
OC da Costa,WI,Pace,1933-08-12,The Oval,England,1933,1,30,72,1,1,389,809,16,359,737,15,24.3125,<=30,ENG,Away,Upto 2014
OC da Costa,WI,Pace,1935-01-24,Port of Spain,West Indies,1935,2,23,54,0,1,486,1307,22,463,1253,22,22.09090909090909,<=30,WI,Home,Upto 2014
OD Gibson,WI,Pace,1995-06-22,Lord's,England,1995,2,132,204,2,1,1000,2102,38,868,1898,36,26.31578947368421,<=30,ENG,Away,Upto 2014
OD Gibson,WI,Pace,1999-01-02,Cape Town,South Africa,1999,2,143,268,1,1,785,1771,27,642,1503,26,29.074074074074073,<=30,SA,Away,Upto 2014
OE Nothling,AUS,Pace,1928-12-14,Sydney,Australia,1928,2,72,276,0,1,483,1249,14,411,973,14,34.5,>30,AUS,Home,Upto 2014
OE Robinson,ENG,Pace,2021-06-02,Lord's,England,2021,2,101,252,7,1,792,1822,27,691,1570,20,29.333333333333332,<=30,ENG,Home,After 1965
OE Robinson,ENG,Pace,2021-08-04,Nottingham,England,2021,2,106,185,5,1,737,1406,30,631,1221,25,24.566666666666666,<=30,ENG,Home,After 1965
OE Robinson,ENG,Pace,2021-08-12,Lord's,England,2021,2,118,300,4,1,917,2031,34,799,1731,30,26.970588235294116,<=30,ENG,Home,After 1965
OE Robinson,ENG,Pace,2021-08-25,Leeds,England,2021,2,81,216,7,1,610,1311,27,529,1095,20,22.59259259259259,<=30,ENG,Home,After 1965
OE Robinson,ENG,Pace,2021-09-02,The Oval,England,2021,2,143,297,5,1,900,1837,30,757,1540,25,30.0,<=30,ENG,Home,After 1965
OE Robinson,ENG,Pace,2021-12-08,Brisbane,Australia,2021,2,71,156,4,1,608,1187,25,537,1031,21,24.32,<=30,AUS,Away,After 1965
OE Robinson,ENG,Pace,2021-12-16,Adelaide,Australia,2021,2,99,252,3,1,845,1824,27,746,1572,24,31.296296296296298,>30,AUS,Away,After 1965
OE Robinson,ENG,Pace,2021-12-26,Melbourne,Australia,2021,1,64,116,2,1,423,909,26,359,793,24,16.26923076923077,<=30,AUS,Away,After 1965
OE Robinson,ENG,Pace,2022-01-14,Hobart,Australia,2022,2,47,114,2,1,700,1252,39,653,1138,37,17.94871794871795,<=30,AUS,Away,After 1965
OE Robinson,ENG,Pace,2022-08-25,Manchester,England,2022,2,91,175,5,1,514,991,25,423,816,20,20.56,<=30,ENG,Home,After 1965
OE Robinson,ENG,Pace,2022-09-08,The Oval,England,2022,2,89,174,7,1,547,897,31,458,723,24,17.64516129032258,<=30,ENG,Home,After 1965
OE Robinson,ENG,Pace,2022-12-01,Rawalpindi,Pakistan,2022,2,122,258,5,1,786,1181,21,664,923,16,37.42857142857143,>30,PAK,Away,After 1965
OE Robinson,ENG,Pace,2022-12-09,Multan,Pakistan,2022,2,25,115,3,1,291,582,12,266,467,9,24.25,<=30,PAK,Away,After 1965
OE Robinson,ENG,Pace,2022-12-17,Karachi,Pakistan,2022,2,44,90,1,1,137,318,3,93,228,2,45.666666666666664,>30,PAK,Away,After 1965
OE Robinson,ENG,Pace,2023-02-16,Mount Maunganui,New Zealand,2023,2,88,162,5,1,901,1216,34,813,1054,29,26.5,<=30,NZ,Away,After 1965
OE Robinson,ENG,Pace,2023-02-24,Wellington,New Zealand,2023,2,115,240,1,1,965,1553,25,850,1313,24,38.6,>30,NZ,Away,After 1965
OE Robinson,ENG,Pace,2023-06-16,Birmingham,England,2023,2,98,244,5,1,808,1386,24,710,1142,19,33.666666666666664,>30,ENG,Home,After 1965
OE Robinson,ENG,Pace,2023-06-28,Lord's,England,2023,2,148,304,5,1,1187,1964,35,1039,1660,30,33.91428571428571,>30,ENG,Home,After 1965
OE Robinson,ENG,Pace,2023-07-06,Leeds,England,2023,1,38,68,0,1,803,1163,34,765,1095,34,23.61764705882353,<=30,ENG,Home,After 1965
OE Robinson,ENG,Pace,2024-02-23,Ranchi,India,2024,1,54,78,0,1,291,444,7,237,366,7,41.57142857142857,>30,IND,Away,After 1965
OG Smith,WI,Spin,1955-03-26,Kingston,West Indies,1955,1,27,66,0,1,550,1394,11,523,1328,11,50.0,>30,WI,Home,Upto 2014
OG Smith,WI,Spin,1955-04-11,Port of Spain,West Indies,1955,1,48,90,0,1,545,1044,8,497,954,8,68.125,>30,WI,Home,Upto 2014
OG Smith,WI,Spin,1955-05-14,Bridgetown,West Indies,1955,2,120,336,3,1,1042,2444,22,922,2108,19,47.36363636363637,>30,WI,Home,Upto 2014
OG Smith,WI,Spin,1955-06-11,Kingston,West Indies,1955,1,145,316,2,1,758,1737,11,613,1421,9,68.9090909090909,>30,WI,Home,Upto 2014
OG Smith,WI,Spin,1956-02-03,Dunedin,New Zealand,1956,1,42,108,3,1,439,1372,20,397,1264,17,21.95,<=30,NZ,Away,Upto 2014
OG Smith,WI,Spin,1956-02-18,Christchurch,New Zealand,1956,2,76,119,6,1,464,1136,24,388,1017,18,19.333333333333332,<=30,NZ,Away,Upto 2014
OG Smith,WI,Spin,1956-03-03,Wellington,New Zealand,1956,2,50,258,3,1,421,1506,19,371,1248,16,22.157894736842106,<=30,NZ,Away,Upto 2014
OG Smith,WI,Spin,1956-03-09,Auckland,New Zealand,1956,2,73,210,1,1,420,1482,16,347,1272,15,26.25,<=30,NZ,Away,Upto 2014
OG Smith,WI,Spin,1957-05-30,Birmingham,England,1957,1,72,156,1,1,809,2558,20,737,2402,19,40.45,>30,ENG,Away,Upto 2014
OG Smith,WI,Spin,1957-07-04,Nottingham,England,1957,1,61,150,2,1,731,1812,9,670,1662,7,81.22222222222223,>30,ENG,Away,Upto 2014
OG Smith,WI,Spin,1957-07-25,Leeds,England,1957,1,17,48,0,1,269,814,12,252,766,12,22.416666666666668,<=30,ENG,Away,Upto 2014
OG Smith,WI,Spin,1957-08-22,The Oval,England,1957,1,73,180,2,1,485,1435,24,412,1255,22,20.208333333333332,<=30,ENG,Away,Upto 2014
OG Smith,WI,Spin,1958-01-17,Bridgetown,West Indies,1958,2,116,444,4,1,679,1898,11,563,1454,7,61.72727272727273,>30,WI,Home,Upto 2014
OG Smith,WI,Spin,1958-02-05,Port of Spain,West Indies,1958,2,102,264,4,1,477,1223,18,375,959,14,26.5,<=30,WI,Home,Upto 2014
OG Smith,WI,Spin,1958-02-26,Kingston,West Indies,1958,2,59,156,1,1,450,846,3,391,690,2,150.0,>30,WI,Home,Upto 2014
OG Smith,WI,Spin,1958-03-13,Georgetown,West Indies,1958,2,154,414,4,1,1032,2327,20,878,1913,16,51.6,>30,WI,Home,Upto 2014
OG Smith,WI,Spin,1958-03-26,Port of Spain,West Indies,1958,1,63,138,0,1,527,1152,14,464,1014,14,37.642857142857146,>30,WI,Home,Upto 2014
OG Smith,WI,Spin,1958-11-28,Brabourne,India,1958,1,30,108,0,1,512,1219,9,482,1111,9,56.888888888888886,>30,IND,Away,Upto 2014
OG Smith,WI,Spin,1958-12-12,Kanpur,India,1958,2,26,84,0,1,669,1431,13,643,1347,13,51.46153846153846,>30,IND,Away,Upto 2014
OG Smith,WI,Spin,1958-12-31,Eden Gardens,India,1958,1,1,12,0,1,513,906,7,512,894,7,73.28571428571429,>30,IND,Away,Upto 2014
OG Smith,WI,Spin,1959-01-21,Chennai,India,1959,2,26,48,1,1,586,1441,19,560,1393,18,30.842105263157894,>30,IND,Away,Upto 2014
OG Smith,WI,Spin,1959-02-06,Delhi,India,1959,2,184,492,8,1,775,1794,11,591,1302,3,70.45454545454545,>30,IND,Away,Upto 2014
OG Smith,WI,Spin,1959-02-20,Karachi,Pakistan,1959,2,45,180,2,1,375,1262,15,330,1082,13,25.0,<=30,PAK,Away,Upto 2014
OG Smith,WI,Spin,1959-03-26,Lahore,Pakistan,1959,2,15,54,1,1,360,902,15,345,848,14,24.0,<=30,PAK,Away,Upto 2014
OP Stone,ENG,Pace,2019-07-24,Lord's,England,2019,1,29,72,3,1,515,949,38,486,877,35,13.552631578947368,<=30,ENG,Home,After 1965
OP Stone,ENG,Pace,2021-02-13,Chennai,India,2021,2,68,136,4,1,192,382,7,124,246,3,27.428571428571427,<=30,IND,Away,After 1965
OP Stone,ENG,Pace,2021-06-10,Birmingham,England,2021,2,97,150,3,1,672,1387,27,575,1237,24,24.88888888888889,<=30,ENG,Home,After 1965
OP Stone,ENG,Pace,2024-08-29,Lord's,England,2024,2,126,150,4,1,781,1252,34,655,1102,30,22.970588235294116,<=30,ENG,Home,After 1965
OP Stone,ENG,Pace,2024-09-06,The Oval,England,2024,2,80,102,3,1,809,1069,28,729,967,25,28.892857142857142,<=30,ENG,Home,After 1965
P Bhandari,IND,Spin,1955-12-16,Delhi,India,1955,2,39,78,0,1,540,1398,4,501,1320,4,135.0,>30,IND,Home,Upto 2014
P Jayawickrama,SL,Spin,2021-04-29,Pallekele,Sri Lanka,2021,2,178,384,11,1,753,1454,28,575,1070,17,26.892857142857142,<=30,SL,Home,After 1965
P Jayawickrama,SL,Spin,2021-11-21,Galle,Sri Lanka,2021,2,68,203,5,1,748,1629,31,680,1426,26,24.129032258064516,<=30,SL,Home,After 1965
P Jayawickrama,SL,Spin,2021-11-29,Galle,Sri Lanka,2021,2,82,210,2,1,790,1806,36,708,1596,34,21.944444444444443,<=30,SL,Home,After 1965
P Jayawickrama,SL,Spin,2022-03-12,Bengaluru,India,2022,2,159,217,7,1,625,968,26,466,751,19,24.03846153846154,<=30,IND,Away,After 1965
P Jayawickrama,SL,Spin,2022-05-23,Mirpur,Bangladesh,2022,2,155,306,0,1,553,1141,6,398,835,6,92.16666666666667,>30,BAN,Away,After 1965
P Kumar,IND,Pace,2011-06-20,Kingston,West Indies,2011,2,80,204,6,1,535,1130,25,455,926,19,21.4,<=30,WI,Away,Upto 2014
P Kumar,IND,Pace,2011-06-28,Bridgetown,West Indies,2011,2,108,234,2,1,639,1424,28,531,1190,26,22.821428571428573,<=30,WI,Away,Upto 2014
P Kumar,IND,Pace,2011-07-06,Roseau,West Indies,2011,2,66,222,4,1,449,995,20,383,773,16,22.45,<=30,WI,Away,Upto 2014
P Kumar,IND,Pace,2011-07-21,Lord's,England,2011,2,176,363,6,1,813,1712,30,637,1349,24,27.1,<=30,ENG,Away,Upto 2014
P Kumar,IND,Pace,2011-07-29,Nottingham,England,2011,2,169,348,7,1,899,1645,37,730,1297,30,24.2972972972973,<=30,ENG,Away,Upto 2014
P Kumar,IND,Pace,2011-08-10,Birmingham,England,2011,1,98,240,2,1,731,1272,20,633,1032,18,36.55,>30,ENG,Away,Upto 2014
P Lever,ENG,Pace,1970-12-11,W.A.C.A,Australia,1970,2,88,208,2,1,852,2129,21,764,1921,19,40.57142857142857,>30,AUS,Away,Upto 2014
P Lever,ENG,Pace,1971-01-09,Sydney,Australia,1971,2,55,158,3,1,480,1339,18,425,1181,15,26.666666666666668,<=30,AUS,Away,Upto 2014
P Lever,ENG,Pace,1971-01-21,Melbourne,Australia,1971,2,132,296,0,1,660,1712,13,528,1416,13,50.76923076923077,>30,AUS,Away,Upto 2014
P Lever,ENG,Pace,1971-01-29,Adelaide,Australia,1971,2,98,273,4,1,768,1851,22,670,1578,18,34.90909090909091,>30,AUS,Away,Upto 2014
P Lever,ENG,Pace,1971-02-12,Sydney,Australia,1971,2,66,214,4,1,479,1333,21,413,1119,17,22.80952380952381,<=30,AUS,Away,Upto 2014
P Lever,ENG,Pace,1971-02-25,Christchurch,New Zealand,1971,2,31,160,1,1,205,688,11,174,528,10,18.636363636363637,<=30,NZ,Away,Upto 2014
P Lever,ENG,Pace,1971-03-05,Auckland,New Zealand,1971,2,49,168,0,1,561,1413,20,512,1245,20,28.05,<=30,NZ,Away,Upto 2014
P Lever,ENG,Pace,1971-06-03,Birmingham,England,1971,1,126,228,1,1,653,1403,13,527,1175,12,50.23076923076923,>30,ENG,Home,Upto 2014
P Lever,ENG,Pace,1971-06-17,Lord's,England,1971,1,38,96,2,1,276,712,9,238,616,7,30.666666666666668,>30,ENG,Home,Upto 2014
P Lever,ENG,Pace,1971-07-08,Leeds,England,1971,2,75,207,4,1,442,1309,24,367,1102,20,18.416666666666668,<=30,ENG,Home,Upto 2014
P Lever,ENG,Pace,1971-08-05,Manchester,England,1971,2,84,198,5,1,409,1030,17,325,832,12,24.058823529411764,<=30,ENG,Home,Upto 2014
P Lever,ENG,Pace,1972-07-13,Nottingham,England,1972,2,137,270,1,1,670,1779,23,533,1509,22,29.130434782608695,<=30,ENG,Home,Upto 2014
P Lever,ENG,Pace,1974-11-29,Brisbane,Australia,1974,2,111,272,0,1,649,1743,27,538,1471,27,24.037037037037038,<=30,AUS,Away,Upto 2014
P Lever,ENG,Pace,1975-02-08,Melbourne,Australia,1975,2,103,216,9,1,711,1562,25,608,1346,16,28.44,<=30,AUS,Away,Upto 2014
P Lever,ENG,Pace,1975-02-20,Auckland,New Zealand,1975,2,112,253,2,1,616,1261,8,504,1008,6,77.0,>30,NZ,Away,Upto 2014
P Lever,ENG,Pace,1975-02-28,Christchurch,New Zealand,1975,1,66,144,1,1,449,1000,7,383,856,6,64.14285714285714,>30,NZ,Away,Upto 2014
P Lever,ENG,Pace,1975-07-31,Lord's,England,1975,2,138,210,2,1,808,1552,18,670,1342,16,44.888888888888886,>30,ENG,Home,Upto 2014
P Roy,IND,Pace,1951-11-02,Delhi,India,1951,1,1,24,0,1,354,1056,2,353,1032,2,177.0,>30,IND,Home,Upto 2014
P Roy,IND,Pace,1952-12-12,Eden Gardens,India,1952,1,4,12,0,1,409,1086,14,405,1074,14,29.214285714285715,<=30,IND,Home,Upto 2014
P Roy,IND,Pace,1953-02-19,Port of Spain,West Indies,1953,1,35,36,0,1,346,1003,10,311,967,10,34.6,>30,WI,Away,Upto 2014
P Roy,IND,Pace,1959-02-06,Delhi,India,1959,1,12,12,0,1,501,1007,14,489,995,14,35.785714285714285,>30,IND,Home,Upto 2014
P Roy,IND,Pace,1959-06-18,Lord's,England,1959,1,4,2,0,1,428,1122,20,424,1120,20,21.4,<=30,ENG,Away,Upto 2014
P Roy,IND,Pace,1960-01-01,Brabourne,India,1960,1,6,12,1,1,552,1475,15,546,1463,14,36.8,>30,IND,Home,Upto 2014
P Roy,IND,Pace,1960-12-02,Brabourne,India,1960,1,4,6,0,1,494,1042,13,490,1036,13,38.0,>30,IND,Home,Upto 2014
P Utseya,ZIM,Spin,2004-05-06,Harare,Zimbabwe,2004,1,55,72,0,1,203,375,10,148,303,10,20.3,<=30,ZIM,Home,Upto 2014
P Utseya,ZIM,Spin,2013-03-20,Roseau,West Indies,2013,1,60,132,3,1,314,673,21,254,541,18,14.952380952380953,<=30,WI,Away,Upto 2014
P Utseya,ZIM,Spin,2013-09-03,Harare,Zimbabwe,2013,2,192,363,5,1,421,874,20,229,511,15,21.05,<=30,ZIM,Home,Upto 2014
P Utseya,ZIM,Spin,2013-09-10,Harare,Zimbabwe,2013,2,103,186,2,1,357,809,10,254,623,8,35.7,>30,ZIM,Home,Upto 2014
P Willey,ENG,Spin,1976-07-22,Leeds,England,1976,1,4,6,0,1,146,192,0,142,186,0,inf,>30,ENG,Home,Upto 2014
P Willey,ENG,Spin,1976-08-12,The Oval,England,1976,1,11,18,0,1,635,1217,8,624,1199,8,79.375,>30,ENG,Home,Upto 2014
P Willey,ENG,Spin,1979-08-30,The Oval,England,1979,2,106,287,2,1,489,1222,10,383,935,8,48.9,>30,ENG,Home,Upto 2014
P Willey,ENG,Spin,1979-12-14,W.A.C.A,Australia,1979,1,1,6,0,1,247,666,5,246,660,5,49.4,>30,AUS,Away,Upto 2014
P Willey,ENG,Spin,1980-01-04,Sydney,Australia,1980,2,19,30,0,1,132,272,5,113,242,5,26.4,<=30,AUS,Away,Upto 2014
P Willey,ENG,Spin,1980-02-01,Melbourne,Australia,1980,1,36,78,0,1,381,798,5,345,720,5,76.2,>30,AUS,Away,Upto 2014
P Willey,ENG,Spin,1980-06-05,Nottingham,England,1980,2,16,42,0,1,25,48,0,9,6,0,inf,>30,ENG,Home,Upto 2014
P Willey,ENG,Spin,1980-06-19,Lord's,England,1980,1,73,150,2,1,206,362,3,133,212,1,68.66666666666667,>30,ENG,Home,Upto 2014
P Willey,ENG,Spin,1980-07-24,The Oval,England,1980,1,22,66,0,1,102,312,2,80,246,2,51.0,>30,ENG,Home,Upto 2014
P Willey,ENG,Spin,1980-08-28,Lord's,England,1980,1,7,6,0,1,326,734,3,319,728,3,108.66666666666667,>30,ENG,Home,Upto 2014
P Willey,ENG,Spin,1981-02-13,Port of Spain,West Indies,1981,1,4,18,0,1,213,606,8,209,588,8,26.625,<=30,WI,Away,Upto 2014
P Willey,ENG,Spin,1981-03-13,Bridgetown,West Indies,1981,1,23,36,0,1,149,390,2,126,354,2,74.5,>30,WI,Away,Upto 2014
P Willey,ENG,Spin,1981-03-27,St John's,West Indies,1981,1,30,120,0,1,220,600,1,190,480,1,220.0,>30,WI,Away,Upto 2014
P Willey,ENG,Spin,1981-04-10,Kingston,West Indies,1981,1,54,108,1,1,271,768,4,217,660,3,67.75,>30,WI,Away,Upto 2014
P Willey,ENG,Spin,1981-07-16,Leeds,England,1981,2,35,96,1,1,50,120,1,15,24,0,50.0,>30,ENG,Home,Upto 2014
P Willey,ENG,Spin,1986-02-21,Kingston,West Indies,1986,1,15,24,1,1,68,156,1,53,132,0,68.0,>30,WI,Away,Upto 2014
P Wilson,AUS,Pace,1998-03-18,Eden Gardens,India,1998,1,50,72,0,1,398,718,11,348,646,11,36.18181818181818,>30,IND,Away,Upto 2014
PA Strang,ZIM,Spin,1994-10-26,Harare,Zimbabwe,1994,1,65,150,3,1,179,444,4,114,294,1,44.75,>30,ZIM,Home,Upto 2014
PA Strang,ZIM,Spin,1995-01-31,Harare,Zimbabwe,1995,2,80,204,1,1,301,564,1,221,360,0,301.0,>30,ZIM,Home,Upto 2014
PA Strang,ZIM,Spin,1995-02-07,Bulawayo,Zimbabwe,1995,1,48,90,0,1,53,103,2,5,13,2,26.5,<=30,ZIM,Home,Upto 2014
PA Strang,ZIM,Spin,1995-02-15,Harare,Zimbabwe,1995,1,41,78,0,1,48,90,0,7,12,0,inf,>30,ZIM,Home,Upto 2014
PA Strang,ZIM,Spin,1995-10-13,Harare,Zimbabwe,1995,2,85,162,0,1,142,312,1,57,150,1,142.0,>30,ZIM,Home,Upto 2014
PA Strang,ZIM,Spin,1996-01-13,Hamilton,New Zealand,1996,2,58,156,2,1,166,401,6,108,245,4,27.666666666666668,<=30,NZ,Away,Upto 2014
PA Strang,ZIM,Spin,1996-01-20,Auckland,New Zealand,1996,2,171,330,1,1,314,606,5,143,276,4,62.8,>30,NZ,Away,Upto 2014
PA Strang,ZIM,Spin,1996-09-11,Colombo (RPS),Sri Lanka,1996,1,106,207,5,1,302,952,21,196,745,16,14.380952380952381,<=30,SL,Away,Upto 2014
PA Strang,ZIM,Spin,1996-09-18,Colombo (SSC),Sri Lanka,1996,2,79,246,4,1,399,1111,19,320,865,15,21.0,<=30,SL,Away,Upto 2014
PA Strang,ZIM,Spin,1996-10-17,Sheikhupura,Pakistan,1996,1,212,414,5,1,616,1340,14,404,926,9,44.0,>30,PAK,Away,Upto 2014
PA Strang,ZIM,Spin,1996-10-24,Faisalabad,Pakistan,1996,2,74,157,1,1,168,373,4,94,216,3,42.0,>30,PAK,Away,Upto 2014
PA Strang,ZIM,Spin,1996-12-18,Bulawayo,Zimbabwe,1996,2,186,436,7,1,518,1335,18,332,899,11,28.77777777777778,<=30,ZIM,Home,Upto 2014
PA Strang,ZIM,Spin,1996-12-26,Harare,Zimbabwe,1996,2,73,264,3,1,217,642,8,144,378,5,27.125,<=30,ZIM,Home,Upto 2014
PA Strang,ZIM,Spin,1997-09-18,Harare,Zimbabwe,1997,2,107,342,3,1,277,714,8,170,372,5,34.625,>30,ZIM,Home,Upto 2014
PA Strang,ZIM,Spin,1997-09-25,Bulawayo,Zimbabwe,1997,2,191,420,4,1,722,1402,21,531,982,17,34.38095238095238,>30,ZIM,Home,Upto 2014
PA Strang,ZIM,Spin,1998-01-07,Kandy,Sri Lanka,1998,1,123,213,3,1,546,1374,23,423,1161,20,23.73913043478261,<=30,SL,Away,Upto 2014
PA Strang,ZIM,Spin,1998-01-14,Colombo (SSC),Sri Lanka,1998,2,152,263,4,1,688,1695,18,536,1432,14,38.22222222222222,>30,SL,Away,Upto 2014
PA Strang,ZIM,Spin,1998-02-19,Wellington,New Zealand,1998,1,126,295,3,1,396,984,10,270,689,7,39.6,>30,NZ,Away,Upto 2014
PA Strang,ZIM,Spin,1998-02-26,Auckland,New Zealand,1998,1,54,109,4,1,314,511,5,260,402,1,62.8,>30,NZ,Away,Upto 2014
PA Strang,ZIM,Spin,1998-03-14,Bulawayo,Zimbabwe,1998,2,123,319,4,1,364,712,5,241,393,1,72.8,>30,ZIM,Home,Upto 2014
PA Strang,ZIM,Spin,2000-09-12,Bulawayo,Zimbabwe,2000,2,158,435,10,1,456,1365,20,298,930,10,22.8,<=30,ZIM,Home,Upto 2014
PA Strang,ZIM,Spin,2000-09-19,Harare,Zimbabwe,2000,1,80,228,2,1,218,549,3,138,321,1,72.66666666666667,>30,ZIM,Home,Upto 2014
PA Strang,ZIM,Spin,2000-11-18,Delhi,India,2000,2,78,116,1,1,622,1309,9,544,1193,8,69.11111111111111,>30,IND,Away,Upto 2014
PA Strang,ZIM,Spin,2001-09-14,Bulawayo,Zimbabwe,2001,1,52,86,0,1,460,1130,12,408,1044,12,38.333333333333336,>30,ZIM,Home,Upto 2014
PA de Silva,SL,Spin,1985-10-16,Faisalabad,Pakistan,1985,1,22,30,0,1,278,675,3,256,645,3,92.66666666666667,>30,PAK,Away,Upto 2014
PA de Silva,SL,Spin,1988-02-12,W.A.C.A,Australia,1988,1,2,6,0,1,67,96,0,65,90,0,inf,>30,AUS,Away,Upto 2014
PA de Silva,SL,Spin,1989-12-08,Brisbane,Australia,1989,1,45,90,1,1,218,426,2,173,336,1,109.0,>30,AUS,Away,Upto 2014
PA de Silva,SL,Spin,1989-12-16,Hobart,Australia,1989,1,65,108,2,1,264,618,8,199,510,6,33.0,>30,AUS,Away,Upto 2014
PA de Silva,SL,Spin,1991-01-31,Wellington,New Zealand,1991,1,59,48,0,1,378,792,0,319,744,0,inf,>30,NZ,Away,Upto 2014
PA de Silva,SL,Spin,1991-02-22,Hamilton,New Zealand,1991,1,14,12,0,1,304,672,6,290,660,6,50.666666666666664,>30,NZ,Away,Upto 2014
PA de Silva,SL,Spin,1991-12-12,Sialkot,Pakistan,1991,1,13,24,0,1,197,606,6,184,582,6,32.833333333333336,>30,PAK,Away,Upto 2014
PA de Silva,SL,Spin,1992-11-27,Moratuwa,Sri Lanka,1992,1,8,24,0,1,176,750,7,168,726,7,25.142857142857142,<=30,SL,Home,Upto 2014
PA de Silva,SL,Spin,1993-07-27,Colombo (SSC),Sri Lanka,1993,1,17,42,0,1,544,1136,16,527,1094,16,34.0,>30,SL,Home,Upto 2014
PA de Silva,SL,Spin,1993-08-25,Moratuwa,Sri Lanka,1993,2,38,108,2,1,610,1439,14,572,1331,12,43.57142857142857,>30,SL,Home,Upto 2014
PA de Silva,SL,Spin,1993-09-06,Colombo (SSC),Sri Lanka,1993,1,39,78,3,1,286,744,8,247,666,5,35.75,>30,SL,Home,Upto 2014
PA de Silva,SL,Spin,1993-09-14,Colombo (PSS),Sri Lanka,1993,2,12,24,0,1,296,757,9,284,733,9,32.888888888888886,>30,SL,Home,Upto 2014
PA de Silva,SL,Spin,1994-02-08,Ahmedabad,India,1994,1,50,138,3,1,473,1433,26,423,1295,23,18.192307692307693,<=30,IND,Away,Upto 2014
PA de Silva,SL,Spin,1994-08-09,Colombo (PSS),Sri Lanka,1994,1,5,6,0,1,791,1520,23,786,1514,23,34.391304347826086,>30,SL,Home,Upto 2014
PA de Silva,SL,Spin,1994-10-11,Harare,Zimbabwe,1994,1,20,36,0,1,210,576,2,190,540,2,105.0,>30,ZIM,Away,Upto 2014
PA de Silva,SL,Spin,1994-10-20,Bulawayo,Zimbabwe,1994,1,4,6,0,1,318,948,5,314,942,5,63.6,>30,ZIM,Away,Upto 2014
PA de Silva,SL,Spin,1995-03-18,Dunedin,New Zealand,1995,1,11,6,0,1,246,774,9,235,768,9,27.333333333333332,<=30,NZ,Away,Upto 2014
PA de Silva,SL,Spin,1995-09-15,Faisalabad,Pakistan,1995,2,54,105,1,1,624,1381,17,570,1276,16,36.705882352941174,>30,PAK,Away,Upto 2014
PA de Silva,SL,Spin,1995-09-22,Sialkot,Pakistan,1995,2,34,84,3,1,336,832,11,302,748,8,30.545454545454547,>30,PAK,Away,Upto 2014
PA de Silva,SL,Spin,1995-12-08,W.A.C.A,Australia,1995,1,42,108,1,1,558,1018,9,516,910,8,62.0,>30,AUS,Away,Upto 2014
PA de Silva,SL,Spin,1995-12-26,Melbourne,Australia,1995,2,51,66,1,1,439,892,9,388,826,8,48.77777777777778,>30,AUS,Away,Upto 2014
PA de Silva,SL,Spin,1996-09-11,Colombo (RPS),Sri Lanka,1996,1,1,12,0,1,302,952,21,301,940,21,14.380952380952381,<=30,SL,Home,Upto 2014
PA de Silva,SL,Spin,1996-09-18,Colombo (SSC),Sri Lanka,1996,2,17,42,0,1,399,1111,19,382,1069,19,21.0,<=30,SL,Home,Upto 2014
PA de Silva,SL,Spin,1997-04-19,Colombo (RPS),Sri Lanka,1997,1,16,24,0,1,757,2006,23,741,1982,23,32.91304347826087,>30,SL,Home,Upto 2014
PA de Silva,SL,Spin,1997-08-09,Colombo (SSC),Sri Lanka,1997,1,7,30,0,1,450,1036,11,443,1006,11,40.90909090909091,>30,SL,Home,Upto 2014
PA de Silva,SL,Spin,1998-01-07,Kandy,Sri Lanka,1998,2,37,108,1,1,546,1374,23,509,1266,22,23.73913043478261,<=30,SL,Home,Upto 2014
PA de Silva,SL,Spin,1998-01-14,Colombo (SSC),Sri Lanka,1998,2,94,180,2,1,688,1695,18,594,1515,16,38.22222222222222,>30,SL,Home,Upto 2014
PA de Silva,SL,Spin,1998-03-19,Cape Town,South Africa,1998,2,15,30,0,1,499,1068,16,484,1038,16,31.1875,>30,SA,Away,Upto 2014
PA de Silva,SL,Spin,1998-03-27,Centurion,South Africa,1998,1,14,30,0,1,345,671,12,331,641,12,28.75,<=30,SA,Away,Upto 2014
PA de Silva,SL,Spin,1998-05-27,Colombo (RPS),Sri Lanka,1998,1,14,12,0,1,939,2077,27,925,2065,27,34.77777777777778,>30,SL,Home,Upto 2014
PA de Silva,SL,Spin,1998-06-03,Galle,Sri Lanka,1998,2,24,72,1,1,443,1219,25,419,1147,24,17.72,<=30,SL,Home,Upto 2014
PA de Silva,SL,Spin,1998-06-10,Colombo (SSC),Sri Lanka,1998,2,44,131,3,1,526,1430,27,482,1299,24,19.48148148148148,<=30,SL,Home,Upto 2014
PA de Silva,SL,Spin,1998-08-27,The Oval,England,1998,1,16,63,0,1,481,1390,17,465,1327,17,28.294117647058822,<=30,ENG,Away,Upto 2014
PA de Silva,SL,Spin,1999-02-24,Colombo (SSC),Sri Lanka,1999,1,59,110,2,1,484,1002,12,425,892,10,40.333333333333336,>30,SL,Home,Upto 2014
PA de Silva,SL,Spin,1999-03-12,Dhaka,Bangladesh,1999,1,44,72,0,1,550,1176,20,506,1104,20,27.5,<=30,BAN,Away,Upto 2014
PA de Silva,SL,Spin,1999-09-09,Kandy,Sri Lanka,1999,1,5,18,0,1,373,779,20,368,761,20,18.65,<=30,SL,Home,Upto 2014
PA de Silva,SL,Spin,2000-02-26,Rawalpindi,Pakistan,2000,1,10,36,0,1,401,1058,12,391,1022,12,33.416666666666664,>30,PAK,Away,Upto 2014
PA de Silva,SL,Spin,2000-06-14,Colombo (SSC),Sri Lanka,2000,1,4,18,0,1,317,840,16,313,822,16,19.8125,<=30,SL,Home,Upto 2014
PA de Silva,SL,Spin,2000-08-06,Colombo (SSC),Sri Lanka,2000,2,65,179,1,1,525,1357,18,460,1178,17,29.166666666666668,<=30,SL,Home,Upto 2014
PA de Silva,SL,Spin,2001-01-20,Centurion,South Africa,2001,1,5,12,0,1,110,198,2,105,186,2,55.0,>30,SA,Away,Upto 2014
PA de Silva,SL,Spin,2001-02-22,Galle,Sri Lanka,2001,1,5,18,0,1,636,1872,18,631,1854,18,35.333333333333336,>30,SL,Home,Upto 2014
PA de Silva,SL,Spin,2001-03-15,Colombo (SSC),Sri Lanka,2001,1,2,18,0,1,375,1120,19,373,1102,19,19.736842105263158,<=30,SL,Home,Upto 2014
PA de Silva,SL,Spin,2002-05-16,Lord's,England,2002,1,63,162,1,1,171,426,1,108,264,0,171.0,>30,ENG,Away,Upto 2014
PA de Silva,SL,Spin,2002-05-30,Birmingham,England,2002,1,30,42,0,1,264,643,6,234,601,6,44.0,>30,ENG,Away,Upto 2014
PA de Silva,SL,Spin,2002-06-13,Manchester,England,2002,1,5,12,0,1,309,728,8,304,716,8,38.625,>30,ENG,Away,Upto 2014
PA de Silva,SL,Spin,2002-07-21,Colombo (PSS),Sri Lanka,2002,1,7,15,1,1,331,649,16,324,634,15,20.6875,<=30,SL,Home,Upto 2014
PADLR Sandakan,SL,Spin,2016-07-26,Pallekele,Sri Lanka,2016,2,107,278,7,1,503,1219,26,396,941,19,19.346153846153847,<=30,SL,Home,After 1965
PADLR Sandakan,SL,Spin,2016-08-04,Galle,Sri Lanka,2016,2,30,38,2,1,555,873,24,525,835,22,23.125,<=30,SL,Home,After 1965
PADLR Sandakan,SL,Spin,2016-08-13,Colombo (SSC),Sri Lanka,2016,1,70,114,0,1,860,1808,28,790,1694,28,30.714285714285715,>30,SL,Home,After 1965
PADLR Sandakan,SL,Spin,2017-03-07,Galle,Sri Lanka,2017,2,98,186,2,1,752,1277,25,654,1091,23,30.08,>30,SL,Home,After 1965
PADLR Sandakan,SL,Spin,2017-03-15,Colombo (PSS),Sri Lanka,2017,2,174,234,4,1,916,1838,26,742,1604,22,35.23076923076923,>30,SL,Home,After 1965
PADLR Sandakan,SL,Spin,2017-08-12,Pallekele,Sri Lanka,2017,1,132,213,5,1,436,802,19,304,589,14,22.94736842105263,<=30,SL,Home,After 1965
PADLR Sandakan,SL,Spin,2017-09-28,Abu Dhabi,UAE,2017,2,102,216,0,1,623,1568,26,521,1352,26,23.96153846153846,<=30,UAE,Away,After 1965
PADLR Sandakan,SL,Spin,2017-12-02,Delhi,India,2017,2,217,263,5,1,881,1566,17,664,1303,12,51.8235294117647,>30,IND,Away,After 1965
PADLR Sandakan,SL,Spin,2018-01-31,Chattogram,Bangladesh,2018,2,156,240,3,1,1210,2061,19,1054,1821,16,63.68421052631579,>30,BAN,Away,After 1965
PADLR Sandakan,SL,Spin,2018-07-12,Galle,Sri Lanka,2018,2,19,53,2,1,416,921,25,397,868,23,16.64,<=30,SL,Home,After 1965
PADLR Sandakan,SL,Spin,2018-11-23,Colombo (SSC),Sri Lanka,2018,2,171,228,7,1,913,1615,34,742,1387,27,26.852941176470587,<=30,SL,Home,After 1965
PAJ DeFreitas,ENG,Pace,1986-11-14,Brisbane,Australia,1986,2,94,198,5,1,755,1483,27,661,1285,22,27.962962962962962,<=30,AUS,Away,Upto 2014
PAJ DeFreitas,ENG,Pace,1986-11-28,W.A.C.A,Australia,1986,2,114,226,1,1,963,1802,22,849,1576,21,43.77272727272727,>30,AUS,Away,Upto 2014
PAJ DeFreitas,ENG,Pace,1986-12-12,Adelaide,Australia,1986,2,164,288,2,1,567,1198,11,403,910,9,51.54545454545455,>30,AUS,Away,Upto 2014
PAJ DeFreitas,ENG,Pace,1986-12-26,Melbourne,Australia,1986,2,74,138,1,1,497,1065,22,423,927,21,22.59090909090909,<=30,AUS,Away,Upto 2014
PAJ DeFreitas,ENG,Pace,1987-06-04,Manchester,England,1987,1,36,72,1,1,470,978,11,434,906,10,42.72727272727273,>30,ENG,Home,Upto 2014
PAJ DeFreitas,ENG,Pace,1987-11-25,Lahore,Pakistan,1987,1,84,174,1,1,221,462,3,137,288,2,73.66666666666667,>30,PAK,Away,Upto 2014
PAJ DeFreitas,ENG,Pace,1987-12-16,Karachi,Pakistan,1987,1,86,143,5,1,422,869,15,336,726,10,28.133333333333333,<=30,PAK,Away,Upto 2014
PAJ DeFreitas,ENG,Pace,1988-02-12,Christchurch,New Zealand,1988,2,65,246,3,1,693,1999,33,628,1753,30,21.0,<=30,NZ,Away,Upto 2014
PAJ DeFreitas,ENG,Pace,1988-03-03,Wellington,New Zealand,1988,1,110,301,1,1,376,817,5,266,516,4,75.2,>30,NZ,Away,Upto 2014
PAJ DeFreitas,ENG,Pace,1988-06-02,Nottingham,England,1988,1,93,162,2,1,781,1741,19,688,1579,17,41.10526315789474,>30,ENG,Home,Upto 2014
PAJ DeFreitas,ENG,Pace,1988-06-30,Manchester,England,1988,1,81,210,1,1,423,1051,26,342,841,25,16.26923076923077,<=30,ENG,Home,Upto 2014
PAJ DeFreitas,ENG,Pace,1988-08-04,The Oval,England,1988,2,79,180,0,1,629,1534,24,550,1354,24,26.208333333333332,<=30,ENG,Home,Upto 2014
PAJ DeFreitas,ENG,Pace,1989-06-08,Leeds,England,1989,2,216,381,3,1,1372,2385,30,1156,2004,27,45.733333333333334,>30,ENG,Home,Upto 2014
PAJ DeFreitas,ENG,Pace,1990-04-05,Bridgetown,West Indies,1990,2,168,311,5,1,1177,2232,37,1009,1921,32,31.81081081081081,>30,WI,Away,Upto 2014
PAJ DeFreitas,ENG,Pace,1990-04-12,St John's,West Indies,1990,1,74,162,1,1,830,1554,26,756,1392,25,31.923076923076923,>30,WI,Away,Upto 2014
PAJ DeFreitas,ENG,Pace,1990-06-07,Nottingham,England,1990,2,53,144,6,1,425,1056,17,372,912,11,25.0,<=30,ENG,Home,Upto 2014
PAJ DeFreitas,ENG,Pace,1990-06-21,Lord's,England,1990,1,122,214,0,1,748,1364,15,626,1150,15,49.86666666666667,>30,ENG,Home,Upto 2014
PAJ DeFreitas,ENG,Pace,1990-12-26,Melbourne,Australia,1990,2,115,246,2,1,741,1809,29,626,1563,27,25.551724137931036,<=30,AUS,Away,Upto 2014
PAJ DeFreitas,ENG,Pace,1991-01-25,Adelaide,Australia,1991,2,117,296,5,1,1030,2159,28,913,1863,23,36.785714285714285,>30,AUS,Away,Upto 2014
PAJ DeFreitas,ENG,Pace,1991-02-01,W.A.C.A,Australia,1991,2,86,139,3,1,771,1442,29,685,1303,26,26.586206896551722,<=30,AUS,Away,Upto 2014
PAJ DeFreitas,ENG,Pace,1991-06-06,Leeds,England,1991,2,93,229,8,1,749,1729,37,656,1500,29,20.243243243243242,<=30,ENG,Home,Upto 2014
PAJ DeFreitas,ENG,Pace,1991-06-20,Lord's,England,1991,2,94,204,3,1,685,1326,19,591,1122,16,36.05263157894737,>30,ENG,Home,Upto 2014
PAJ DeFreitas,ENG,Pace,1991-07-04,Nottingham,England,1991,2,96,253,3,1,833,1718,28,737,1465,25,29.75,<=30,ENG,Home,Upto 2014
PAJ DeFreitas,ENG,Pace,1991-07-25,Birmingham,England,1991,2,94,231,5,1,722,1721,32,628,1490,27,22.5625,<=30,ENG,Home,Upto 2014
PAJ DeFreitas,ENG,Pace,1991-08-08,The Oval,England,1991,2,80,198,3,1,826,1668,26,746,1470,23,31.76923076923077,>30,ENG,Home,Upto 2014
PAJ DeFreitas,ENG,Pace,1991-08-22,Lord's,England,1991,2,115,288,8,1,770,1537,23,655,1249,15,33.47826086956522,>30,ENG,Home,Upto 2014
PAJ DeFreitas,ENG,Pace,1992-01-18,Christchurch,New Zealand,1992,2,108,334,2,1,763,1516,14,655,1182,12,54.5,>30,NZ,Away,Upto 2014
PAJ DeFreitas,ENG,Pace,1992-01-30,Auckland,New Zealand,1992,2,115,258,6,1,740,1678,33,625,1420,27,22.424242424242426,<=30,NZ,Away,Upto 2014
PAJ DeFreitas,ENG,Pace,1992-02-06,Wellington,New Zealand,1992,1,12,48,0,1,603,1369,15,591,1321,15,40.2,>30,NZ,Away,Upto 2014
PAJ DeFreitas,ENG,Pace,1992-06-04,Birmingham,England,1992,1,121,198,4,1,641,1086,9,520,888,5,71.22222222222223,>30,ENG,Home,Upto 2014
PAJ DeFreitas,ENG,Pace,1992-06-18,Lord's,England,1992,1,58,156,3,1,607,1221,26,549,1065,23,23.346153846153847,<=30,ENG,Home,Upto 2014
PAJ DeFreitas,ENG,Pace,1993-02-19,Wankhede,India,1993,1,75,120,0,1,325,648,9,250,528,9,36.111111111111114,>30,IND,Away,Upto 2014
PAJ DeFreitas,ENG,Pace,1993-06-03,Manchester,England,1993,2,126,282,2,1,704,1351,14,578,1069,12,50.285714285714285,>30,ENG,Home,Upto 2014
PAJ DeFreitas,ENG,Pace,1994-06-02,Nottingham,England,1994,2,165,273,9,1,704,1313,20,539,1040,11,35.2,>30,ENG,Home,Upto 2014
PAJ DeFreitas,ENG,Pace,1994-06-16,Lord's,England,1994,2,165,306,6,1,756,1458,24,591,1152,18,31.5,>30,ENG,Home,Upto 2014
PAJ DeFreitas,ENG,Pace,1994-06-30,Manchester,England,1994,2,121,282,6,1,638,1439,22,517,1157,16,29.0,<=30,ENG,Home,Upto 2014
PAJ DeFreitas,ENG,Pace,1994-07-21,Lord's,England,1994,2,110,192,0,1,636,1408,31,526,1216,31,20.516129032258064,<=30,ENG,Home,Upto 2014
PAJ DeFreitas,ENG,Pace,1994-08-04,Leeds,England,1994,2,130,259,5,1,1145,2209,21,1015,1950,16,54.523809523809526,>30,ENG,Home,Upto 2014
PAJ DeFreitas,ENG,Pace,1994-08-18,The Oval,England,1994,2,118,230,4,1,962,1490,30,844,1260,26,32.06666666666667,>30,ENG,Home,Upto 2014
PAJ DeFreitas,ENG,Pace,1994-11-25,Brisbane,Australia,1994,2,176,318,4,1,726,1262,21,550,944,17,34.57142857142857,>30,AUS,Away,Upto 2014
PAJ DeFreitas,ENG,Pace,1994-12-24,Melbourne,Australia,1994,2,136,294,3,1,587,1268,21,451,974,18,27.952380952380953,<=30,AUS,Away,Upto 2014
PAJ DeFreitas,ENG,Pace,1995-01-26,Adelaide,Australia,1995,2,101,186,2,1,823,1644,27,722,1458,25,30.48148148148148,>30,AUS,Away,Upto 2014
PAJ DeFreitas,ENG,Pace,1995-02-03,W.A.C.A,Australia,1995,2,145,306,4,1,946,1817,29,801,1511,25,32.62068965517241,>30,AUS,Away,Upto 2014
PAJ DeFreitas,ENG,Pace,1995-06-08,Leeds,England,1995,2,115,162,2,1,698,1234,27,583,1072,25,25.85185185185185,<=30,ENG,Home,Upto 2014
PAM Hands,SA,Spin,1913-12-26,Johannesburg,South Africa,1913,1,17,36,0,1,283,660,6,266,624,6,47.166666666666664,>30,SA,Home,Upto 2014
PAM Hands,SA,Spin,1921-11-26,Cape Town,South Africa,1921,1,1,1,0,1,400,850,17,399,849,17,23.529411764705884,<=30,SA,Home,Upto 2014
PC Charlton,AUS,Pace,1890-08-11,The Oval,England,1890,2,24,45,3,1,285,909,28,261,864,25,10.178571428571429,<=30,ENG,Away,After 1965
PC Strydom,SA,Spin,2000-01-14,Centurion,South Africa,2000,1,27,36,0,1,36,48,0,9,12,0,inf,>30,SA,Home,Upto 2014
PCR Tufnell,ENG,Spin,1990-12-26,Melbourne,Australia,1990,2,98,270,0,1,220,612,3,122,342,3,73.33333333333333,>30,AUS,Away,Upto 2014
PCR Tufnell,ENG,Spin,1991-01-04,Sydney,Australia,1991,2,156,402,6,1,645,1458,16,489,1056,10,40.3125,>30,AUS,Away,Upto 2014
PCR Tufnell,ENG,Spin,1991-01-25,Adelaide,Australia,1991,2,66,126,1,1,183,342,1,117,216,0,183.0,>30,AUS,Away,Upto 2014
PCR Tufnell,ENG,Spin,1991-02-01,W.A.C.A,Australia,1991,1,25,42,2,1,50,60,2,25,18,0,25.0,<=30,AUS,Away,Upto 2014
PCR Tufnell,ENG,Spin,1991-08-08,The Oval,England,1991,2,175,363,7,1,257,571,9,82,208,2,28.555555555555557,<=30,ENG,Home,Upto 2014
PCR Tufnell,ENG,Spin,1991-08-22,Lord's,England,1991,2,117,249,5,1,298,574,10,181,325,5,29.8,<=30,ENG,Home,Upto 2014
PCR Tufnell,ENG,Spin,1992-01-18,Christchurch,New Zealand,1992,2,147,511,11,1,362,1021,13,215,510,2,27.846153846153847,<=30,NZ,Away,Upto 2014
PCR Tufnell,ENG,Spin,1992-01-30,Auckland,New Zealand,1992,2,61,126,3,1,104,264,4,43,138,1,26.0,<=30,NZ,Away,Upto 2014
PCR Tufnell,ENG,Spin,1992-02-06,Wellington,New Zealand,1992,2,159,480,2,1,491,1353,13,332,873,11,37.76923076923077,>30,NZ,Away,Upto 2014
PCR Tufnell,ENG,Spin,1992-08-06,The Oval,England,1992,1,87,204,1,1,191,493,4,104,289,3,47.75,>30,ENG,Home,Upto 2014
PCR Tufnell,ENG,Spin,1993-02-11,Chennai,India,1993,1,132,246,0,1,792,1720,20,660,1474,20,39.6,>30,IND,Away,Upto 2014
PCR Tufnell,ENG,Spin,1993-02-19,Wankhede,India,1993,1,142,237,4,1,804,1796,20,662,1559,16,40.2,>30,IND,Away,Upto 2014
PCR Tufnell,ENG,Spin,1993-03-13,Colombo (SSC),Sri Lanka,1993,2,142,244,3,1,805,1517,22,663,1273,19,36.59090909090909,>30,SL,Away,Upto 2014
PCR Tufnell,ENG,Spin,1993-06-03,Manchester,England,1993,2,190,390,3,1,496,1275,19,306,885,16,26.105263157894736,<=30,ENG,Home,Upto 2014
PCR Tufnell,ENG,Spin,1993-06-17,Lord's,England,1993,1,129,234,2,1,634,1745,17,505,1511,15,37.294117647058826,>30,ENG,Home,Upto 2014
PCR Tufnell,ENG,Spin,1994-04-08,Bridgetown,West Indies,1994,2,176,408,4,1,263,593,6,87,185,2,43.833333333333336,>30,WI,Away,Upto 2014
PCR Tufnell,ENG,Spin,1994-04-16,St John's,West Indies,1994,2,115,270,0,1,364,732,3,249,462,3,121.33333333333333,>30,WI,Away,Upto 2014
PCR Tufnell,ENG,Spin,1994-08-04,Leeds,England,1994,2,112,330,4,1,136,384,4,24,54,0,34.0,>30,ENG,Home,Upto 2014
PCR Tufnell,ENG,Spin,1994-11-25,Brisbane,Australia,1994,2,151,378,4,1,405,1216,16,254,838,12,25.3125,<=30,AUS,Away,Upto 2014
PCR Tufnell,ENG,Spin,1994-12-24,Melbourne,Australia,1994,2,149,456,5,1,290,880,14,141,424,9,20.714285714285715,<=30,AUS,Away,Upto 2014
PCR Tufnell,ENG,Spin,1995-01-01,Sydney,Australia,1995,1,61,214,0,1,330,790,1,269,576,1,330.0,>30,AUS,Away,Upto 2014
PCR Tufnell,ENG,Spin,1995-01-26,Adelaide,Australia,1995,2,81,198,1,1,395,872,12,314,674,11,32.916666666666664,>30,AUS,Away,Upto 2014
PCR Tufnell,ENG,Spin,1996-12-18,Bulawayo,Zimbabwe,1996,2,137,347,6,1,518,1335,18,381,988,12,28.77777777777778,<=30,ZIM,Away,Upto 2014
PCR Tufnell,ENG,Spin,1996-12-26,Harare,Zimbabwe,1996,1,55,150,1,1,217,642,8,162,492,7,27.125,<=30,ZIM,Away,Upto 2014
PCR Tufnell,ENG,Spin,1997-01-24,Auckland,New Zealand,1997,2,133,390,3,1,302,804,7,169,414,4,43.142857142857146,>30,NZ,Away,Upto 2014
PCR Tufnell,ENG,Spin,1997-02-06,Wellington,New Zealand,1997,1,29,138,1,1,215,621,7,186,483,6,30.714285714285715,>30,NZ,Away,Upto 2014
PCR Tufnell,ENG,Spin,1997-02-14,Christchurch,New Zealand,1997,2,80,264,3,1,333,1099,15,253,835,12,22.2,<=30,NZ,Away,Upto 2014
PCR Tufnell,ENG,Spin,1997-08-21,The Oval,England,1997,2,93,286,11,1,198,586,16,105,300,5,12.375,<=30,ENG,Home,Upto 2014
PCR Tufnell,ENG,Spin,1998-02-05,Port of Spain,West Indies,1998,2,102,332,2,1,159,524,3,57,192,1,53.0,>30,WI,Away,Upto 2014
PCR Tufnell,ENG,Spin,1998-02-13,Port of Spain,West Indies,1998,2,24,144,0,1,83,378,4,59,234,4,20.75,<=30,WI,Away,Upto 2014
PCR Tufnell,ENG,Spin,1998-02-27,Georgetown,West Indies,1998,2,135,294,3,1,391,1045,18,256,751,15,21.72222222222222,<=30,WI,Away,Upto 2014
PCR Tufnell,ENG,Spin,1998-03-12,Bridgetown,West Indies,1998,2,80,297,2,1,286,824,8,206,527,6,35.75,>30,WI,Away,Upto 2014
PCR Tufnell,ENG,Spin,1998-03-20,St John's,West Indies,1998,1,97,210,0,1,334,948,8,237,738,8,41.75,>30,WI,Away,Upto 2014
PCR Tufnell,ENG,Spin,1999-07-01,Birmingham,England,1999,2,29,115,5,1,51,151,5,22,36,0,10.2,<=30,ENG,Home,Upto 2014
PCR Tufnell,ENG,Spin,1999-07-22,Lord's,England,1999,2,80,211,2,1,143,403,4,63,192,2,35.75,>30,ENG,Home,Upto 2014
PCR Tufnell,ENG,Spin,1999-08-05,Manchester,England,1999,1,111,276,2,1,316,834,9,205,558,7,35.111111111111114,>30,ENG,Home,Upto 2014
PCR Tufnell,ENG,Spin,1999-08-19,The Oval,England,1999,2,97,192,5,1,179,486,10,82,294,5,17.9,<=30,ENG,Home,Upto 2014
PCR Tufnell,ENG,Spin,1999-12-09,Gqeberha,South Africa,1999,2,195,462,4,1,220,492,4,25,30,0,55.0,>30,SA,Away,Upto 2014
PCR Tufnell,ENG,Spin,1999-12-26,Durban,South Africa,1999,2,141,330,1,1,272,696,4,131,366,3,68.0,>30,SA,Away,Upto 2014
PCR Tufnell,ENG,Spin,2000-01-02,Cape Town,South Africa,2000,1,97,238,1,1,194,523,5,97,285,4,38.8,>30,SA,Away,Upto 2014
PCR Tufnell,ENG,Spin,2001-08-23,The Oval,England,2001,1,174,234,1,1,630,1004,15,456,770,14,42.0,>30,ENG,Home,Upto 2014
PD Collingwood,ENG,Pace,2003-12-02,Galle,Sri Lanka,2003,1,12,24,0,1,348,780,10,336,756,10,34.8,>30,SL,Away,Upto 2014
PD Collingwood,ENG,Pace,2003-12-10,Kandy,Sri Lanka,2003,2,25,72,0,1,489,1010,13,464,938,13,37.61538461538461,>30,SL,Away,Upto 2014
PD Collingwood,ENG,Pace,2005-09-08,The Oval,England,2005,1,17,24,0,1,707,1205,18,690,1181,18,39.27777777777778,>30,ENG,Home,Upto 2014
PD Collingwood,ENG,Pace,2005-11-12,Multan,Pakistan,2005,1,15,24,0,1,730,1407,32,715,1383,32,22.8125,<=30,PAK,Away,Upto 2014
PD Collingwood,ENG,Pace,2005-11-29,Lahore,Pakistan,2005,1,22,36,0,1,870,1496,17,848,1460,17,51.1764705882353,>30,PAK,Away,Upto 2014
PD Collingwood,ENG,Pace,2006-03-09,Mohali,India,2006,1,20,18,0,1,422,800,12,402,782,12,35.166666666666664,>30,IND,Away,Upto 2014
PD Collingwood,ENG,Pace,2006-05-11,Lord's,England,2006,1,16,54,0,1,982,1899,19,966,1845,19,51.68421052631579,>30,ENG,Home,Upto 2014
PD Collingwood,ENG,Pace,2006-05-25,Birmingham,England,2006,1,0,12,0,1,504,1093,20,504,1081,20,25.2,<=30,ENG,Home,Upto 2014
PD Collingwood,ENG,Pace,2006-07-13,Lord's,England,2006,2,42,54,0,1,919,1514,18,877,1460,18,51.05555555555556,>30,ENG,Home,Upto 2014
PD Collingwood,ENG,Pace,2006-07-27,Manchester,England,2006,1,14,18,0,1,487,865,18,473,847,18,27.055555555555557,<=30,ENG,Home,Upto 2014
PD Collingwood,ENG,Pace,2006-08-04,Leeds,England,2006,1,33,60,1,1,1053,1569,26,1020,1509,25,40.5,>30,ENG,Home,Upto 2014
PD Collingwood,ENG,Pace,2006-08-17,The Oval,England,2006,1,29,36,0,1,700,1093,21,671,1057,21,33.333333333333336,>30,ENG,Home,Upto 2014
PD Collingwood,ENG,Pace,2006-12-26,Melbourne,Australia,2006,1,20,18,0,1,551,1154,23,531,1136,23,23.956521739130434,<=30,AUS,Away,Upto 2014
PD Collingwood,ENG,Pace,2007-05-17,Lord's,England,2007,1,34,71,1,1,1013,1620,14,979,1549,13,72.35714285714286,>30,ENG,Home,Upto 2014
PD Collingwood,ENG,Pace,2007-06-07,Manchester,England,2007,1,5,6,0,1,901,1654,29,896,1648,29,31.06896551724138,>30,ENG,Home,Upto 2014
PD Collingwood,ENG,Pace,2007-06-15,Chester-le-Street,England,2007,1,12,24,0,1,807,1380,26,795,1356,26,31.03846153846154,>30,ENG,Home,Upto 2014
PD Collingwood,ENG,Pace,2007-07-19,Lord's,England,2007,2,15,24,0,1,762,1573,34,747,1549,34,22.41176470588235,<=30,ENG,Home,Upto 2014
PD Collingwood,ENG,Pace,2007-07-27,Nottingham,England,2007,1,59,96,1,1,762,1633,23,703,1537,22,33.130434782608695,>30,ENG,Home,Upto 2014
PD Collingwood,ENG,Pace,2007-08-09,The Oval,England,2007,2,35,102,3,1,888,1674,23,853,1572,20,38.608695652173914,>30,ENG,Home,Upto 2014
PD Collingwood,ENG,Pace,2007-12-01,Kandy,Sri Lanka,2007,1,25,48,2,1,767,1367,21,742,1319,19,36.523809523809526,>30,SL,Away,Upto 2014
PD Collingwood,ENG,Pace,2007-12-09,Colombo (SSC),Sri Lanka,2007,1,0,6,0,1,676,1421,13,676,1415,13,52.0,>30,SL,Away,Upto 2014
PD Collingwood,ENG,Pace,2007-12-18,Galle,Sri Lanka,2007,1,38,59,1,1,606,1192,16,568,1133,15,37.875,>30,SL,Away,Upto 2014
PD Collingwood,ENG,Pace,2008-03-05,Hamilton,New Zealand,2008,2,62,126,2,1,672,1450,27,610,1324,25,24.88888888888889,<=30,NZ,Away,Upto 2014
PD Collingwood,ENG,Pace,2008-03-13,Wellington,New Zealand,2008,2,43,101,3,1,966,1899,38,923,1798,35,25.42105263157895,<=30,NZ,Away,Upto 2014
PD Collingwood,ENG,Pace,2008-03-22,Napier,New Zealand,2008,2,20,24,0,1,793,1402,23,773,1378,23,34.47826086956522,>30,NZ,Away,Upto 2014
PD Collingwood,ENG,Pace,2008-05-15,Lord's,England,2008,1,11,18,0,1,640,1330,19,629,1312,19,33.68421052631579,>30,ENG,Home,Upto 2014
PD Collingwood,ENG,Pace,2008-05-23,Manchester,England,2008,1,1,6,0,1,614,1172,16,613,1166,16,38.375,>30,ENG,Home,Upto 2014
PD Collingwood,ENG,Pace,2008-06-05,Nottingham,England,2008,2,10,24,0,1,579,1236,29,569,1212,29,19.96551724137931,<=30,ENG,Home,Upto 2014
PD Collingwood,ENG,Pace,2008-07-10,Lord's,England,2008,2,40,90,0,1,845,1704,13,805,1614,13,65.0,>30,ENG,Home,Upto 2014
PD Collingwood,ENG,Pace,2008-07-30,Birmingham,England,2008,1,12,12,0,1,903,1618,29,891,1606,29,31.137931034482758,>30,ENG,Home,Upto 2014
PD Collingwood,ENG,Pace,2008-12-19,Mohali,India,2008,1,10,12,0,1,522,1070,12,512,1058,12,43.5,>30,IND,Away,Upto 2014
PD Collingwood,ENG,Pace,2009-02-15,St John's,West Indies,2009,1,22,24,0,1,803,1574,19,781,1550,19,42.26315789473684,>30,WI,Away,Upto 2014
PD Collingwood,ENG,Pace,2009-02-26,Bridgetown,West Indies,2009,1,51,96,0,1,977,1508,9,926,1412,9,108.55555555555556,>30,WI,Away,Upto 2014
PD Collingwood,ENG,Pace,2009-07-08,Cardiff,England,2009,1,38,54,1,1,832,1434,18,794,1380,17,46.22222222222222,>30,ENG,Home,Upto 2014
PD Collingwood,ENG,Pace,2009-07-16,Lord's,England,2009,1,29,36,0,1,1009,1590,27,980,1554,27,37.370370370370374,>30,ENG,Home,Upto 2014
PD Collingwood,ENG,Pace,2009-07-30,Birmingham,England,2009,1,8,12,0,1,806,1353,22,798,1341,22,36.63636363636363,>30,ENG,Home,Upto 2014
PD Collingwood,ENG,Pace,2009-08-20,The Oval,England,2009,1,1,6,0,1,842,1408,23,841,1402,23,36.608695652173914,>30,ENG,Home,Upto 2014
PD Collingwood,ENG,Pace,2009-12-16,Centurion,South Africa,2009,2,37,78,0,1,848,1757,22,811,1679,22,38.54545454545455,>30,SA,Away,Upto 2014
PD Collingwood,ENG,Pace,2009-12-26,Durban,South Africa,2009,1,8,6,0,1,616,1251,15,608,1245,15,41.06666666666667,>30,SA,Away,Upto 2014
PD Collingwood,ENG,Pace,2010-01-14,Johannesburg,South Africa,2010,1,21,36,0,1,644,1109,23,623,1073,23,28.0,<=30,SA,Away,Upto 2014
PD Collingwood,ENG,Pace,2010-03-20,Mirpur,Bangladesh,2010,1,8,6,0,1,503,828,9,495,822,9,55.888888888888886,>30,BAN,Away,Upto 2014
PD Collingwood,ENG,Pace,2010-08-06,Birmingham,England,2010,1,14,42,0,1,468,1160,20,454,1118,20,23.4,<=30,ENG,Home,Upto 2014
PD Collingwood,ENG,Pace,2010-08-18,The Oval,England,2010,1,11,24,0,1,645,1152,22,634,1128,22,29.318181818181817,<=30,ENG,Home,Upto 2014
PD Collingwood,ENG,Pace,2010-11-25,Brisbane,Australia,2010,1,41,72,0,1,947,1750,17,906,1678,17,55.705882352941174,>30,AUS,Away,Upto 2014
PD Collingwood,ENG,Pace,2010-12-03,Adelaide,Australia,2010,2,21,42,0,1,745,1313,14,724,1271,14,53.214285714285715,>30,AUS,Away,Upto 2014
PD Collingwood,ENG,Pace,2010-12-16,W.A.C.A,Australia,2010,2,6,48,1,1,755,1419,38,749,1371,37,19.86842105263158,<=30,AUS,Away,Upto 2014
PD Collingwood,ENG,Pace,2011-01-03,Sydney,Australia,2011,1,5,24,1,1,873,1642,26,868,1618,25,33.57692307692308,>30,AUS,Away,Upto 2014
PD Lashley,WI,Pace,1966-08-04,Leeds,England,1966,1,1,18,1,1,453,936,13,452,918,12,34.84615384615385,>30,ENG,Away,Upto 2014
PDRL Perera,SL,Pace,1999-02-24,Colombo (SSC),Sri Lanka,1999,2,185,264,1,1,790,1434,9,605,1170,8,87.77777777777777,>30,SL,Home,Upto 2014
PDRL Perera,SL,Pace,2000-08-06,Colombo (SSC),Sri Lanka,2000,2,73,120,2,1,430,969,14,357,849,12,30.714285714285715,>30,SL,Home,Upto 2014
PDRL Perera,SL,Pace,2001-01-20,Centurion,South Africa,2001,1,73,114,1,1,628,1061,26,555,947,25,24.153846153846153,<=30,SA,Away,Upto 2014
PDRL Perera,SL,Pace,2001-08-14,Galle,Sri Lanka,2001,2,46,120,2,1,532,1132,18,486,1012,16,29.555555555555557,<=30,SL,Home,Upto 2014
PDRL Perera,SL,Pace,2001-08-22,Kandy,Sri Lanka,2001,2,49,96,2,1,745,1357,27,696,1261,25,27.59259259259259,<=30,SL,Home,Upto 2014
PDRL Perera,SL,Pace,2001-09-06,Colombo (SSC),Sri Lanka,2001,2,57,108,4,1,535,726,8,478,618,4,66.875,>30,SL,Home,Upto 2014
PDRL Perera,SL,Pace,2002-05-16,Lord's,England,2002,2,138,246,5,1,1188,2251,20,1050,2005,15,59.4,>30,ENG,Away,Upto 2014
PDRL Perera,SL,Pace,2002-11-08,Johannesburg,South Africa,2002,1,40,62,0,1,582,1139,26,542,1077,26,22.384615384615383,<=30,SA,Away,Upto 2014
PE McEwan,NZ,Pace,1984-12-10,Karachi,Pakistan,1984,2,13,36,0,1,473,890,12,460,854,12,39.416666666666664,>30,PAK,Away,Upto 2014
PE McIntyre,AUS,Spin,1995-01-26,Adelaide,Australia,1995,2,87,165,2,1,395,872,12,308,707,10,32.916666666666664,>30,AUS,Home,Upto 2014
PE McIntyre,AUS,Spin,1996-10-10,Delhi,India,1996,2,107,228,3,1,528,1278,19,421,1050,16,27.789473684210527,<=30,IND,Away,Upto 2014
PE Palia,IND,Spin,1932-06-25,Lord's,England,1932,2,13,42,0,1,320,726,9,307,684,9,35.55555555555556,>30,ENG,Away,Upto 2014
PE Richardson,ENG,Spin,1961-11-11,Brabourne,India,1961,1,10,36,2,1,727,1890,18,717,1854,16,40.388888888888886,>30,IND,Away,Upto 2014
PE Richardson,ENG,Spin,1962-01-19,Dhaka,Bangladesh,1962,1,28,72,1,1,862,2494,25,834,2422,24,34.48,>30,BAN,Away,Upto 2014
PE Richardson,ENG,Spin,1962-02-02,Karachi,Pakistan,1962,1,10,12,0,1,769,2063,17,759,2051,17,45.23529411764706,>30,PAK,Away,Upto 2014
PEW Jones,WI,Pace,1948-01-21,Bridgetown,West Indies,1948,2,83,206,4,1,345,968,10,262,762,6,34.5,>30,WI,Home,Upto 2014
PEW Jones,WI,Pace,1948-11-10,Delhi,India,1948,2,122,232,3,1,457,956,11,335,724,8,41.54545454545455,>30,IND,Away,Upto 2014
PEW Jones,WI,Pace,1948-12-09,Brabourne,India,1948,2,86,198,1,1,410,1014,5,324,816,4,82.0,>30,IND,Away,Upto 2014
PEW Jones,WI,Pace,1948-12-31,Eden Gardens,India,1948,2,97,228,1,1,577,1272,12,480,1044,11,48.083333333333336,>30,IND,Away,Upto 2014
PEW Jones,WI,Pace,1949-01-27,Chennai,India,1949,2,58,156,6,1,442,1095,18,384,939,12,24.555555555555557,<=30,IND,Away,Upto 2014
PEW Jones,WI,Pace,1949-02-04,Brabourne,India,1949,2,116,334,6,1,462,1177,18,346,843,12,25.666666666666668,<=30,IND,Away,Upto 2014
PEW Jones,WI,Pace,1950-06-24,Lord's,England,1950,2,35,94,1,1,279,874,5,244,780,4,55.8,>30,ENG,Away,Upto 2014
PEW Jones,WI,Pace,1950-08-12,The Oval,England,1950,1,70,138,0,1,259,680,4,189,542,4,64.75,>30,ENG,Away,Upto 2014
PEW Jones,WI,Pace,1951-11-30,Sydney,Australia,1951,2,84,256,3,1,387,1058,13,303,802,10,29.76923076923077,<=30,AUS,Away,Upto 2014
PG McShane,AUS,Pace,1885-03-21,Melbourne,Australia,1885,1,3,12,0,1,490,1192,20,487,1180,20,24.5,<=30,AUS,Home,After 1965
PG McShane,AUS,Pace,1887-01-28,Sydney,Australia,1887,1,6,12,0,1,241,1003,28,235,991,28,8.607142857142858,<=30,AUS,Home,After 1965
PG McShane,AUS,Pace,1888-02-10,Sydney,Australia,1888,1,39,84,1,1,187,670,24,148,586,23,7.791666666666667,<=30,AUS,Home,After 1965
PGH Fender,ENG,Spin,1921-01-14,Adelaide,Australia,1921,2,157,204,2,1,920,1706,23,763,1502,21,40.0,>30,AUS,Away,Upto 2014
PGH Fender,ENG,Spin,1921-02-11,Melbourne,Australia,1921,2,161,272,5,1,636,1301,23,475,1029,18,27.652173913043477,<=30,AUS,Away,Upto 2014
PGH Fender,ENG,Spin,1921-02-25,Sydney,Australia,1921,2,92,126,5,1,605,1063,17,513,937,12,35.588235294117645,>30,AUS,Away,Upto 2014
PGH Fender,ENG,Spin,1921-07-23,Manchester,England,1921,1,30,90,2,1,239,952,12,209,862,10,19.916666666666668,<=30,ENG,Home,Upto 2014
PGH Fender,ENG,Spin,1921-08-13,The Oval,England,1921,1,82,114,0,1,509,810,8,427,696,8,63.625,>30,ENG,Home,Upto 2014
PGH Fender,ENG,Spin,1922-12-23,Johannesburg,South Africa,1922,2,81,114,1,1,279,546,8,198,432,7,34.875,>30,SA,Away,Upto 2014
PGH Fender,ENG,Spin,1923-01-01,Cape Town,South Africa,1923,2,81,204,5,1,228,702,14,147,498,9,16.285714285714285,<=30,SA,Away,Upto 2014
PGH Fender,ENG,Spin,1923-01-18,Durban,South Africa,1923,1,72,174,1,1,244,574,4,172,400,3,61.0,>30,SA,Away,Upto 2014
PGH Fender,ENG,Spin,1923-02-09,Johannesburg,South Africa,1923,2,138,222,2,1,356,732,8,218,510,6,44.5,>30,SA,Away,Upto 2014
PGH Fender,ENG,Spin,1923-02-16,Durban,South Africa,1923,2,46,132,1,1,141,426,6,95,294,5,23.5,<=30,SA,Away,Upto 2014
PGH Fender,ENG,Spin,1924-06-14,Birmingham,England,1924,1,56,102,0,1,396,946,10,340,844,10,39.6,>30,ENG,Home,Upto 2014
PGH Fender,ENG,Spin,1924-06-28,Lord's,England,1924,2,70,138,2,1,563,1396,14,493,1258,12,40.214285714285715,>30,ENG,Home,Upto 2014
PGH Fender,ENG,Spin,1929-06-15,Birmingham,England,1929,2,119,286,3,1,416,1126,6,297,840,3,69.33333333333333,>30,ENG,Home,Upto 2014
PGZ Harris,NZ,Pace,1965-01-29,Auckland,New Zealand,1965,1,14,42,0,1,296,863,12,282,821,12,24.666666666666668,<=30,NZ,Home,Upto 2014
PH Carlson,AUS,Pace,1979-01-27,Adelaide,Australia,1979,2,75,288,2,1,561,1654,30,486,1366,28,18.7,<=30,AUS,Home,Upto 2014
PH Carlson,AUS,Pace,1979-02-10,Sydney,Australia,1979,1,24,80,0,1,293,735,11,269,655,11,26.636363636363637,<=30,AUS,Home,Upto 2014
PH Edmonds,ENG,Spin,1975-08-14,Leeds,England,1975,2,92,222,6,1,242,624,11,150,402,5,22.0,<=30,ENG,Home,Upto 2014
PH Edmonds,ENG,Spin,1975-08-28,The Oval,England,1975,2,132,265,0,1,533,1243,6,401,978,6,88.83333333333333,>30,ENG,Home,Upto 2014
PH Edmonds,ENG,Spin,1978-01-02,Hyderabad (Sind),Pakistan,1978,2,170,432,3,1,585,1882,17,415,1450,14,34.411764705882355,>30,PAK,Away,Upto 2014
PH Edmonds,ENG,Spin,1978-01-18,Karachi,Pakistan,1978,1,66,264,7,1,466,1665,20,400,1401,13,23.3,<=30,PAK,Away,Upto 2014
PH Edmonds,ENG,Spin,1978-02-10,Wellington,New Zealand,1978,2,11,32,0,1,32,112,1,21,80,1,32.0,>30,NZ,Away,Upto 2014
PH Edmonds,ENG,Spin,1978-02-24,Christchurch,New Zealand,1978,2,60,320,6,1,101,488,7,41,168,1,14.428571428571429,<=30,NZ,Away,Upto 2014
PH Edmonds,ENG,Spin,1978-03-04,Auckland,New Zealand,1978,2,130,440,3,1,296,915,11,166,475,8,26.90909090909091,<=30,NZ,Away,Upto 2014
PH Edmonds,ENG,Spin,1978-06-01,Birmingham,England,1978,2,46,180,4,1,153,396,7,107,216,3,21.857142857142858,<=30,ENG,Home,Upto 2014
PH Edmonds,ENG,Spin,1978-06-15,Lord's,England,1978,2,27,120,4,1,186,426,8,159,306,4,23.25,<=30,ENG,Home,Upto 2014
PH Edmonds,ENG,Spin,1978-06-29,Leeds,England,1978,1,22,66,0,1,69,204,1,47,138,1,69.0,>30,ENG,Home,Upto 2014
PH Edmonds,ENG,Spin,1978-07-27,The Oval,England,1978,2,61,307,4,1,243,991,11,182,684,7,22.09090909090909,<=30,ENG,Home,Upto 2014
PH Edmonds,ENG,Spin,1978-08-10,Nottingham,England,1978,2,65,293,6,1,118,533,8,53,240,2,14.75,<=30,ENG,Home,Upto 2014
PH Edmonds,ENG,Spin,1978-08-24,Lord's,England,1978,1,19,72,0,1,103,427,3,84,355,3,34.333333333333336,>30,ENG,Home,Upto 2014
PH Edmonds,ENG,Spin,1978-12-01,Brisbane,Australia,1978,2,27,104,0,1,206,680,3,179,576,3,68.66666666666667,>30,AUS,Away,Upto 2014
PH Edmonds,ENG,Spin,1979-07-12,Birmingham,England,1979,2,97,258,2,1,393,774,2,296,516,0,196.5,>30,ENG,Home,Upto 2014
PH Edmonds,ENG,Spin,1979-08-02,Lord's,England,1979,2,63,282,2,1,266,749,5,203,467,3,53.2,>30,ENG,Home,Upto 2014
PH Edmonds,ENG,Spin,1979-08-16,Leeds,England,1979,1,59,168,1,1,162,455,6,103,287,5,27.0,<=30,ENG,Home,Upto 2014
PH Edmonds,ENG,Spin,1979-08-30,The Oval,England,1979,2,104,258,1,1,489,1222,10,385,964,9,48.9,>30,ENG,Home,Upto 2014
PH Edmonds,ENG,Spin,1982-06-10,Lord's,England,1982,2,44,102,0,1,261,594,2,217,492,2,130.5,>30,ENG,Home,Upto 2014
PH Edmonds,ENG,Spin,1982-06-24,Manchester,England,1982,1,94,222,3,1,341,811,11,247,589,8,31.0,>30,ENG,Home,Upto 2014
PH Edmonds,ENG,Spin,1982-07-08,The Oval,England,1982,2,123,290,3,1,576,1184,12,453,894,9,48.0,>30,ENG,Home,Upto 2014
PH Edmonds,ENG,Spin,1983-07-14,The Oval,England,1983,2,120,253,3,1,330,901,10,210,648,7,33.0,>30,ENG,Home,Upto 2014
PH Edmonds,ENG,Spin,1983-07-28,Leeds,England,1983,1,101,270,1,1,109,276,1,8,6,0,109.0,>30,ENG,Home,Upto 2014
PH Edmonds,ENG,Spin,1984-11-28,Wankhede,India,1984,2,103,246,2,1,629,1557,23,526,1311,21,27.347826086956523,<=30,IND,Away,Upto 2014
PH Edmonds,ENG,Spin,1984-12-12,Delhi,India,1984,2,143,530,6,1,622,1733,22,479,1203,16,28.272727272727273,<=30,IND,Away,Upto 2014
PH Edmonds,ENG,Spin,1984-12-31,Eden Gardens,India,1984,2,74,306,3,1,444,1182,10,370,876,7,44.4,>30,IND,Away,Upto 2014
PH Edmonds,ENG,Spin,1985-01-13,Chennai,India,1985,2,152,287,2,1,779,1355,9,627,1068,7,86.55555555555556,>30,IND,Away,Upto 2014
PH Edmonds,ENG,Spin,1985-01-31,Kanpur,India,1985,1,112,288,1,1,695,1644,9,583,1356,8,77.22222222222223,>30,IND,Away,Upto 2014
PH Edmonds,ENG,Spin,1985-06-27,Lord's,England,1985,2,120,250,3,1,311,742,9,191,492,6,34.55555555555556,>30,ENG,Home,Upto 2014
PH Edmonds,ENG,Spin,1985-07-11,Nottingham,England,1985,1,155,396,2,1,443,1050,6,288,654,4,73.83333333333333,>30,ENG,Home,Upto 2014
PH Edmonds,ENG,Spin,1985-08-01,Manchester,England,1985,2,162,415,5,1,424,1147,11,262,732,6,38.54545454545455,>30,ENG,Home,Upto 2014
PH Edmonds,ENG,Spin,1985-08-15,Birmingham,England,1985,2,60,210,3,1,208,528,4,148,318,1,52.0,>30,ENG,Home,Upto 2014
PH Edmonds,ENG,Spin,1985-08-29,The Oval,England,1985,1,52,84,2,1,236,426,4,184,342,2,59.0,>30,ENG,Home,Upto 2014
PH Edmonds,ENG,Spin,1986-02-21,Kingston,West Indies,1986,1,53,126,0,1,68,156,1,15,30,1,68.0,>30,WI,Away,Upto 2014
PH Edmonds,ENG,Spin,1986-03-07,Port of Spain,West Indies,1986,2,122,255,3,1,243,525,10,121,270,7,24.3,<=30,WI,Away,Upto 2014
PH Edmonds,ENG,Spin,1986-03-21,Bridgetown,West Indies,1986,1,85,174,0,1,197,444,1,112,270,1,197.0,>30,WI,Away,Upto 2014
PH Edmonds,ENG,Spin,1986-06-05,Lord's,England,1986,2,92,198,2,1,225,844,8,133,646,6,28.125,<=30,ENG,Home,Upto 2014
PH Edmonds,ENG,Spin,1986-07-03,Birmingham,England,1986,2,86,312,5,1,336,971,13,250,659,8,25.846153846153847,<=30,ENG,Home,Upto 2014
PH Edmonds,ENG,Spin,1986-07-24,Lord's,England,1986,2,115,282,4,1,350,940,10,235,658,6,35.0,>30,ENG,Home,Upto 2014
PH Edmonds,ENG,Spin,1986-08-07,Nottingham,England,1986,2,68,192,2,1,295,797,10,227,605,8,29.5,<=30,ENG,Home,Upto 2014
PH Edmonds,ENG,Spin,1986-08-21,The Oval,England,1986,1,29,132,2,1,193,510,3,164,378,1,64.33333333333333,>30,ENG,Home,Upto 2014
PH Edmonds,ENG,Spin,1986-11-14,Brisbane,Australia,1986,2,58,216,1,1,263,785,6,205,569,5,43.833333333333336,>30,AUS,Away,Upto 2014
PH Edmonds,ENG,Spin,1986-11-28,W.A.C.A,Australia,1986,2,80,288,3,1,361,930,7,281,642,4,51.57142857142857,>30,AUS,Away,Upto 2014
PH Edmonds,ENG,Spin,1986-12-12,Adelaide,Australia,1986,2,197,486,3,1,609,1398,9,412,912,6,67.66666666666667,>30,AUS,Away,Upto 2014
PH Edmonds,ENG,Spin,1986-12-26,Melbourne,Australia,1986,1,45,118,3,1,169,430,6,124,312,3,28.166666666666668,<=30,AUS,Away,Upto 2014
PH Edmonds,ENG,Spin,1987-01-10,Sydney,Australia,1987,2,158,462,5,1,596,1662,26,438,1200,21,22.923076923076923,<=30,AUS,Away,Upto 2014
PH Edmonds,ENG,Spin,1987-06-04,Manchester,England,1987,1,2,42,1,1,82,268,3,80,226,2,27.333333333333332,<=30,ENG,Home,Upto 2014
PH Edmonds,ENG,Spin,1987-07-02,Leeds,England,1987,1,59,150,1,1,133,342,1,74,192,0,133.0,>30,ENG,Home,Upto 2014
PH Edmonds,ENG,Spin,1987-07-23,Birmingham,England,1987,2,61,171,2,1,177,477,2,116,306,0,88.5,>30,ENG,Home,Upto 2014
PH Edmonds,ENG,Spin,1987-08-06,The Oval,England,1987,1,97,192,0,1,612,1585,13,515,1393,13,47.07692307692308,>30,ENG,Home,Upto 2014
PH Parfitt,ENG,Spin,1962-01-10,Chennai,India,1962,2,46,132,2,1,866,2320,33,820,2188,31,26.242424242424242,<=30,IND,Away,Upto 2014
PH Parfitt,ENG,Spin,1962-01-19,Dhaka,Bangladesh,1962,1,14,48,0,1,862,2494,25,848,2446,25,34.48,>30,BAN,Away,Upto 2014
PH Parfitt,ENG,Spin,1962-02-02,Karachi,Pakistan,1962,1,4,18,0,1,769,2063,17,765,2045,17,45.23529411764706,>30,PAK,Away,Upto 2014
PH Parfitt,ENG,Spin,1962-05-31,Birmingham,England,1962,1,2,12,0,1,664,1386,13,662,1374,13,51.07692307692308,>30,ENG,Home,Upto 2014
PH Parfitt,ENG,Spin,1962-07-26,Nottingham,England,1962,1,5,6,0,1,232,572,3,227,566,3,77.33333333333333,>30,ENG,Home,Upto 2014
PH Parfitt,ENG,Spin,1964-01-29,Eden Gardens,India,1964,1,71,204,2,1,555,1794,16,484,1590,14,34.6875,>30,IND,Away,Upto 2014
PH Parfitt,ENG,Spin,1964-02-08,Delhi,India,1964,2,88,144,1,1,1001,2631,20,913,2487,19,50.05,>30,IND,Away,Upto 2014
PH Parfitt,ENG,Spin,1964-02-15,Kanpur,India,1964,2,129,342,2,1,987,2874,18,858,2532,16,54.833333333333336,>30,IND,Away,Upto 2014
PH Parfitt,ENG,Spin,1964-12-04,Durban,South Africa,1964,1,6,12,0,1,464,1264,16,458,1252,16,29.0,<=30,SA,Away,Upto 2014
PH Parfitt,ENG,Spin,1964-12-23,Johannesburg,South Africa,1964,1,6,24,0,1,545,1457,14,539,1433,14,38.92857142857143,>30,SA,Away,Upto 2014
PH Parfitt,ENG,Spin,1965-01-01,Cape Town,South Africa,1965,2,102,162,1,1,605,1499,14,503,1337,13,43.214285714285715,>30,SA,Away,Upto 2014
PH Parfitt,ENG,Spin,1965-06-17,Lord's,England,1965,1,25,36,1,1,329,839,9,304,803,8,36.55555555555556,>30,ENG,Home,Upto 2014
PH Parfitt,ENG,Spin,1966-02-25,Christchurch,New Zealand,1966,2,19,54,2,1,245,648,5,226,594,3,49.0,>30,NZ,Away,Upto 2014
PH Parfitt,ENG,Spin,1966-03-04,Dunedin,New Zealand,1966,1,30,102,1,1,185,556,9,155,454,8,20.555555555555557,<=30,NZ,Away,Upto 2014
PH Parfitt,ENG,Spin,1966-03-11,Auckland,New Zealand,1966,1,9,12,0,1,300,776,10,291,764,10,30.0,<=30,NZ,Away,Upto 2014
PH Parfitt,ENG,Spin,1969-06-26,Lord's,England,1969,1,8,6,0,1,394,1024,8,386,1018,8,49.25,>30,ENG,Home,Upto 2014
PH Parfitt,ENG,Spin,1972-08-10,The Oval,England,1972,1,10,12,0,1,544,1256,15,534,1244,15,36.266666666666666,>30,ENG,Home,Upto 2014
PH Sharma,IND,Pace,1976-12-17,Delhi,India,1976,1,6,18,0,1,217,567,13,211,549,13,16.692307692307693,<=30,IND,Home,Upto 2014
PH Sharma,IND,Pace,1977-01-01,Eden Gardens,India,1977,1,2,6,0,1,233,654,15,231,648,15,15.533333333333333,<=30,IND,Home,Upto 2014
PHJ Trimborn,SA,Pace,1967-01-20,Durban,South Africa,1967,2,82,252,2,1,725,1921,25,643,1669,23,29.0,<=30,SA,Home,Upto 2014
PHJ Trimborn,SA,Pace,1967-02-03,Johannesburg,South Africa,1967,2,35,102,1,1,518,1312,23,483,1210,22,22.52173913043478,<=30,SA,Home,Upto 2014
PHJ Trimborn,SA,Pace,1967-02-24,Gqeberha,South Africa,1967,2,49,169,4,1,655,1640,26,606,1471,22,25.192307692307693,<=30,SA,Home,Upto 2014
PHJ Trimborn,SA,Pace,1970-03-05,Gqeberha,South Africa,1970,2,91,224,4,1,887,1974,33,796,1750,29,26.87878787878788,<=30,SA,Home,Upto 2014
PHKD Mendis,SL,Spin,2024-03-30,Chattogram,Bangladesh,2024,1,32,60,3,1,649,1230,12,617,1170,9,54.083333333333336,>30,BAN,Away,After 1965
PHKD Mendis,SL,Spin,2024-08-21,Manchester,England,2024,1,13,12,0,1,370,678,9,357,666,9,41.111111111111114,>30,ENG,Away,After 1965
PHKD Mendis,SL,Spin,2024-08-29,Lord's,England,2024,1,27,18,0,1,342,540,5,315,522,5,68.4,>30,ENG,Away,After 1965
PHKD Mendis,SL,Spin,2024-09-18,Galle,Sri Lanka,2024,1,8,6,0,1,849,1559,29,841,1553,29,29.275862068965516,<=30,SL,Home,After 1965
PHKD Mendis,SL,Spin,2024-11-27,Durban,South Africa,2024,1,12,6,0,1,277,462,6,265,456,6,46.166666666666664,>30,SA,Away,After 1965
PHT Kaushal,SL,Spin,2014-12-26,Christchurch,New Zealand,2014,2,207,210,2,1,299,462,3,92,252,1,99.66666666666667,>30,NZ,Away,After 1965
PHT Kaushal,SL,Spin,2015-06-25,Colombo (PSS),Sri Lanka,2015,2,118,215,5,1,521,1055,17,403,840,12,30.647058823529413,>30,SL,Home,After 1965
PHT Kaushal,SL,Spin,2015-07-03,Pallekele,Sri Lanka,2015,2,190,270,4,1,413,744,13,223,474,9,31.76923076923077,>30,SL,Home,After 1965
PHT Kaushal,SL,Spin,2015-08-12,Galle,Sri Lanka,2015,2,181,303,8,1,627,1167,31,446,864,23,20.225806451612904,<=30,SL,Home,After 1965
PHT Kaushal,SL,Spin,2015-08-20,Colombo (PSS),Sri Lanka,2015,2,229,366,4,1,596,1144,22,367,778,18,27.09090909090909,<=30,SL,Home,After 1965
PHT Kaushal,SL,Spin,2015-08-28,Colombo (SSC),Sri Lanka,2015,2,86,144,1,1,433,759,12,347,615,11,36.083333333333336,>30,SL,Home,After 1965
PHT Kaushal,SL,Spin,2015-10-14,Galle,Sri Lanka,2015,2,94,150,1,1,555,1017,18,461,867,17,30.833333333333332,>30,SL,Home,After 1965
PI Philpott,AUS,Spin,1965-03-03,Kingston,West Indies,1965,2,165,366,6,1,482,1161,15,317,795,9,32.13333333333333,>30,WI,Away,Upto 2014
PI Philpott,AUS,Spin,1965-03-26,Port of Spain,West Indies,1965,2,139,384,3,1,736,1898,17,597,1514,14,43.294117647058826,>30,WI,Away,Upto 2014
PI Philpott,AUS,Spin,1965-04-14,Georgetown,West Indies,1965,2,124,252,5,1,385,975,21,261,723,16,18.333333333333332,<=30,WI,Away,Upto 2014
PI Philpott,AUS,Spin,1965-05-05,Bridgetown,West Indies,1965,2,176,414,2,1,856,1946,10,680,1532,8,85.6,>30,WI,Away,Upto 2014
PI Philpott,AUS,Spin,1965-05-14,Port of Spain,West Indies,1965,1,25,45,2,1,396,885,11,371,840,9,36.0,>30,WI,Away,Upto 2014
PI Philpott,AUS,Spin,1965-12-10,Brisbane,Australia,1965,2,152,337,6,1,514,1281,8,362,944,2,64.25,>30,AUS,Home,Upto 2014
PI Philpott,AUS,Spin,1965-12-30,Melbourne,Australia,1965,1,133,240,0,1,661,1476,9,528,1236,9,73.44444444444444,>30,AUS,Home,Upto 2014
PI Philpott,AUS,Spin,1966-01-07,Sydney,Australia,1966,1,86,224,2,1,404,1124,13,318,900,11,31.076923076923077,>30,AUS,Home,Upto 2014
PI Pocock,ENG,Spin,1968-02-29,Bridgetown,West Indies,1968,2,133,246,2,1,405,1049,8,272,803,6,50.625,>30,WI,Away,Upto 2014
PI Pocock,ENG,Spin,1968-03-28,Georgetown,West Indies,1968,2,144,330,3,1,621,1884,22,477,1554,19,28.227272727272727,<=30,WI,Away,Upto 2014
PI Pocock,ENG,Spin,1968-06-06,Manchester,England,1968,2,156,348,6,1,456,1101,19,300,753,13,24.0,<=30,ENG,Home,Upto 2014
PI Pocock,ENG,Spin,1969-02-21,Lahore,Pakistan,1969,2,80,156,1,1,546,1362,17,466,1206,16,32.11764705882353,>30,PAK,Away,Upto 2014
PI Pocock,ENG,Spin,1972-12-20,Delhi,India,1972,2,85,234,3,1,561,1750,23,476,1516,20,24.391304347826086,<=30,IND,Away,Upto 2014
PI Pocock,ENG,Spin,1972-12-30,Eden Gardens,India,1972,2,45,162,0,1,461,1469,28,416,1307,28,16.464285714285715,<=30,IND,Away,Upto 2014
PI Pocock,ENG,Spin,1973-01-12,Chennai,India,1973,2,142,354,8,1,632,1828,31,490,1474,23,20.387096774193548,<=30,IND,Away,Upto 2014
PI Pocock,ENG,Spin,1973-02-06,Brabourne,India,1973,2,138,312,3,1,967,2173,20,829,1861,17,48.35,>30,IND,Away,Upto 2014
PI Pocock,ENG,Spin,1973-03-02,Lahore,Pakistan,1973,2,115,234,1,1,766,1787,23,651,1553,22,33.30434782608695,>30,PAK,Away,Upto 2014
PI Pocock,ENG,Spin,1973-03-16,Hyderabad (Sind),Pakistan,1973,1,169,312,5,1,993,2402,21,824,2090,16,47.285714285714285,>30,PAK,Away,Upto 2014
PI Pocock,ENG,Spin,1973-03-24,Karachi,Pakistan,1973,1,93,228,2,1,724,1728,23,631,1500,21,31.47826086956522,>30,PAK,Away,Upto 2014
PI Pocock,ENG,Spin,1974-02-02,Port of Spain,West Indies,1974,2,159,354,6,1,671,1657,22,512,1303,16,30.5,>30,WI,Away,Upto 2014
PI Pocock,ENG,Spin,1974-02-16,Kingston,West Indies,1974,1,152,342,0,1,880,2436,16,728,2094,16,55.0,>30,WI,Away,Upto 2014
PI Pocock,ENG,Spin,1974-03-06,Bridgetown,West Indies,1974,1,93,168,0,1,534,1195,11,441,1027,11,48.54545454545455,>30,WI,Away,Upto 2014
PI Pocock,ENG,Spin,1974-03-30,Port of Spain,West Indies,1974,2,146,336,3,1,805,2406,29,659,2070,26,27.75862068965517,<=30,WI,Away,Upto 2014
PI Pocock,ENG,Spin,1976-06-17,Lord's,England,1976,2,65,180,1,1,283,691,11,218,511,10,25.727272727272727,<=30,ENG,Home,Upto 2014
PI Pocock,ENG,Spin,1976-07-08,Manchester,England,1976,2,108,186,3,1,286,618,6,178,432,3,47.666666666666664,>30,ENG,Home,Upto 2014
PI Pocock,ENG,Spin,1984-07-26,Manchester,England,1984,1,121,273,4,1,327,823,11,206,550,7,29.727272727272727,<=30,ENG,Home,Upto 2014
PI Pocock,ENG,Spin,1984-08-09,The Oval,England,1984,1,24,48,0,1,34,102,0,10,54,0,inf,>30,ENG,Home,Upto 2014
PI Pocock,ENG,Spin,1984-08-23,Lord's,England,1984,2,153,420,3,1,242,726,5,89,306,2,48.4,>30,ENG,Home,Upto 2014
PI Pocock,ENG,Spin,1984-11-28,Wankhede,India,1984,2,143,289,3,1,629,1557,23,486,1268,20,27.347826086956523,<=30,IND,Away,Upto 2014
PI Pocock,ENG,Spin,1984-12-12,Delhi,India,1984,2,163,430,7,1,622,1733,22,459,1303,15,28.272727272727273,<=30,IND,Away,Upto 2014
PI Pocock,ENG,Spin,1984-12-31,Eden Gardens,India,1984,2,112,324,1,1,444,1182,10,332,858,9,44.4,>30,IND,Away,Upto 2014
PI Pocock,ENG,Spin,1985-01-13,Chennai,India,1985,2,158,240,1,1,779,1355,9,621,1115,8,86.55555555555556,>30,IND,Away,Upto 2014
PI Pocock,ENG,Spin,1985-01-31,Kanpur,India,1985,1,79,144,1,1,695,1644,9,616,1500,8,77.22222222222223,>30,IND,Away,Upto 2014
PIC Thompson,WI,Pace,1996-04-19,Bridgetown,West Indies,1996,2,135,132,4,1,918,1755,25,783,1623,21,36.72,>30,WI,Home,Upto 2014
PIC Thompson,WI,Pace,1997-01-25,Adelaide,Australia,1997,1,80,96,1,1,488,1017,11,408,921,10,44.36363636363637,>30,AUS,Away,Upto 2014
PJ Allan,AUS,Pace,1965-12-10,Brisbane,Australia,1965,2,83,192,2,1,379,960,11,296,768,9,34.45454545454545,>30,AUS,Home,Upto 2014
PJ Cummins,AUS,Pace,2011-11-17,Johannesburg,South Africa,2011,2,117,264,7,1,938,1680,27,821,1416,20,34.74074074074074,>30,SA,Away,Upto 2014
PJ Cummins,AUS,Pace,2017-03-16,Ranchi,India,2017,1,106,234,4,1,451,960,9,345,726,5,50.111111111111114,>30,IND,Away,After 1965
PJ Cummins,AUS,Pace,2017-03-25,Dharamsala,India,2017,2,136,228,4,1,367,681,12,231,453,8,30.583333333333332,>30,IND,Away,After 1965
PJ Cummins,AUS,Pace,2017-08-27,Mirpur,Bangladesh,2017,2,101,180,4,1,186,391,4,85,211,0,46.5,>30,BAN,Away,After 1965
PJ Cummins,AUS,Pace,2017-09-04,Chattogram,Bangladesh,2017,2,73,198,2,1,189,383,7,116,185,5,27.0,<=30,BAN,Away,After 1965
PJ Cummins,AUS,Pace,2017-11-23,Brisbane,Australia,2017,2,108,256,4,1,713,1568,21,605,1312,17,33.95238095238095,>30,AUS,Home,After 1965
PJ Cummins,AUS,Pace,2017-12-02,Adelaide,Australia,2017,2,86,216,3,1,779,1712,31,693,1496,28,25.129032258064516,<=30,AUS,Home,After 1965
PJ Cummins,AUS,Pace,2017-12-14,W.A.C.A,Australia,2017,2,137,287,4,1,965,1713,24,828,1426,20,40.208333333333336,>30,AUS,Home,After 1965
PJ Cummins,AUS,Pace,2017-12-26,Melbourne,Australia,2017,1,117,175,4,1,816,1807,20,699,1632,16,40.8,>30,AUS,Home,After 1965
PJ Cummins,AUS,Pace,2018-01-04,Sydney,Australia,2018,2,119,249,8,1,630,1294,17,511,1045,9,37.05882352941177,>30,AUS,Home,After 1965
PJ Cummins,AUS,Pace,2018-03-01,Durban,South Africa,2018,2,94,162,2,1,640,1256,26,546,1094,24,24.615384615384617,<=30,SA,Away,After 1965
PJ Cummins,AUS,Pace,2018-03-09,Gqeberha,South Africa,2018,2,92,173,4,1,673,1296,28,581,1123,24,24.035714285714285,<=30,SA,Away,After 1965
PJ Cummins,AUS,Pace,2018-03-22,Cape Town,South Africa,2018,2,145,318,7,1,789,1457,31,644,1139,24,25.451612903225808,<=30,SA,Away,After 1965
PJ Cummins,AUS,Pace,2018-03-30,Johannesburg,South Africa,2018,2,141,281,9,1,666,1427,26,525,1146,17,25.615384615384617,<=30,SA,Away,After 1965
PJ Cummins,AUS,Pace,2018-12-06,Adelaide,Australia,2018,2,104,222,2,1,635,1467,25,531,1245,23,25.4,<=30,AUS,Home,After 1965
PJ Cummins,AUS,Pace,2018-12-14,Perth,Australia,2018,2,85,210,3,1,753,1685,30,668,1475,27,25.1,<=30,AUS,Home,After 1965
PJ Cummins,AUS,Pace,2018-12-26,Melbourne,Australia,2018,2,99,270,9,1,621,1425,29,522,1155,20,21.413793103448278,<=30,AUS,Home,After 1965
PJ Cummins,AUS,Pace,2019-01-03,Sydney,Australia,2019,1,101,168,0,1,459,804,6,358,636,6,76.5,>30,AUS,Home,After 1965
PJ Cummins,AUS,Pace,2019-01-24,Brisbane,Australia,2019,2,62,178,10,1,398,892,24,336,714,14,16.583333333333332,<=30,AUS,Home,After 1965
PJ Cummins,AUS,Pace,2019-02-01,Canberra,Australia,2019,2,47,132,4,1,709,1113,23,662,981,19,30.82608695652174,>30,AUS,Home,After 1965
PJ Cummins,AUS,Pace,2019-08-01,Birmingham,England,2019,2,116,267,7,1,758,1453,25,642,1186,18,30.32,>30,ENG,Away,After 1965
PJ Cummins,AUS,Pace,2019-08-14,Lord's,England,2019,2,96,228,6,1,589,1275,24,493,1047,18,24.541666666666668,<=30,ENG,Away,After 1965
PJ Cummins,AUS,Pace,2019-08-22,Leeds,England,2019,2,103,202,4,1,629,1344,34,526,1142,30,18.5,<=30,ENG,Away,After 1965
PJ Cummins,AUS,Pace,2019-09-04,Manchester,England,2019,2,103,288,7,1,783,1519,27,680,1231,20,29.0,<=30,ENG,Away,After 1965
PJ Cummins,AUS,Pace,2019-09-12,The Oval,England,2019,2,151,281,5,1,856,1530,30,705,1249,25,28.533333333333335,<=30,ENG,Away,After 1965
PJ Cummins,AUS,Pace,2019-11-21,Brisbane,Australia,2019,2,129,258,5,1,600,1180,22,471,922,17,27.272727272727273,<=30,AUS,Home,After 1965
PJ Cummins,AUS,Pace,2019-11-29,Adelaide,Australia,2019,2,128,226,3,1,654,1168,17,526,942,14,38.470588235294116,>30,AUS,Home,After 1965
PJ Cummins,AUS,Pace,2019-12-12,Perth,Australia,2019,2,77,202,3,1,626,1383,31,549,1181,28,20.193548387096776,<=30,AUS,Home,After 1965
PJ Cummins,AUS,Pace,2019-12-26,Melbourne,Australia,2019,2,75,210,5,1,729,1616,26,654,1406,21,28.03846153846154,<=30,AUS,Home,After 1965
PJ Cummins,AUS,Pace,2020-01-03,Sydney,Australia,2020,2,73,198,4,1,593,1249,16,520,1051,12,37.0625,>30,AUS,Home,After 1965
PJ Cummins,AUS,Pace,2020-12-17,Adelaide,Australia,2020,2,69,189,7,1,408,970,22,339,781,15,18.545454545454547,<=30,AUS,Home,After 1965
PJ Cummins,AUS,Pace,2020-12-26,Melbourne,Australia,2020,2,102,192,3,1,523,1170,20,421,978,17,26.15,<=30,AUS,Home,After 1965
PJ Cummins,AUS,Pace,2021-01-07,Sydney,Australia,2021,2,101,286,5,1,762,1640,19,661,1354,14,40.10526315789474,>30,AUS,Home,After 1965
PJ Cummins,AUS,Pace,2021-01-15,Brisbane,Australia,2021,2,149,306,6,1,950,1738,30,801,1432,24,31.666666666666668,>30,AUS,Home,After 1965
PJ Cummins,AUS,Pace,2021-12-08,Brisbane,Australia,2021,2,89,199,7,1,608,1187,25,519,988,18,24.32,<=30,AUS,Home,After 1965
PJ Cummins,AUS,Pace,2021-12-26,Melbourne,Australia,2021,2,55,150,3,1,423,909,26,368,759,23,16.26923076923077,<=30,AUS,Home,After 1965
PJ Cummins,AUS,Pace,2022-01-05,Sydney,Australia,2022,2,148,252,4,1,798,1621,23,650,1369,19,34.69565217391305,>30,AUS,Home,After 1965
PJ Cummins,AUS,Pace,2022-01-14,Hobart,Australia,2022,2,87,159,7,1,700,1252,39,613,1093,32,17.94871794871795,<=30,AUS,Home,After 1965
PJ Cummins,AUS,Pace,2022-03-04,Rawalpindi,Pakistan,2022,2,77,192,1,1,479,990,4,402,798,3,119.75,>30,PAK,Away,After 1965
PJ Cummins,AUS,Pace,2022-03-12,Karachi,Pakistan,2022,2,114,234,3,1,534,1143,14,420,909,11,38.142857142857146,>30,PAK,Away,After 1965
PJ Cummins,AUS,Pace,2022-03-21,Lahore,Pakistan,2022,2,79,235,8,1,523,1268,24,444,1033,16,21.791666666666668,<=30,PAK,Away,After 1965
PJ Cummins,AUS,Pace,2022-06-29,Galle,Sri Lanka,2022,1,25,72,1,1,116,191,4,91,119,3,29.0,<=30,SL,Away,After 1965
PJ Cummins,AUS,Pace,2022-07-08,Galle,Sri Lanka,2022,1,95,180,1,1,290,570,7,195,390,6,41.42857142857143,>30,SL,Away,After 1965
PJ Cummins,AUS,Pace,2022-11-30,Perth,Australia,2022,1,34,122,3,1,842,1610,13,808,1488,10,64.76923076923077,>30,AUS,Home,After 1965
PJ Cummins,AUS,Pace,2022-12-17,Brisbane,Australia,2022,2,77,150,7,1,432,770,30,355,620,23,14.4,<=30,AUS,Home,After 1965
PJ Cummins,AUS,Pace,2022-12-26,Melbourne,Australia,2022,2,50,180,1,1,684,1223,19,634,1043,18,36.0,>30,AUS,Home,After 1965
PJ Cummins,AUS,Pace,2023-01-04,Sydney,Australia,2023,2,76,186,4,1,386,804,12,310,618,8,32.166666666666664,>30,AUS,Home,After 1965
PJ Cummins,AUS,Pace,2023-02-09,Nagpur,India,2023,1,78,123,2,1,173,354,6,95,231,4,28.833333333333332,<=30,IND,Away,After 1965
PJ Cummins,AUS,Pace,2023-02-17,Delhi,India,2023,1,41,78,1,1,141,238,5,100,160,4,28.2,<=30,IND,Away,After 1965
PJ Cummins,AUS,Pace,2023-06-07,The Oval,England,2023,2,138,198,4,1,1032,1672,28,894,1474,24,36.857142857142854,>30,ENG,Away,After 1965
PJ Cummins,AUS,Pace,2023-06-16,Birmingham,England,2023,2,122,194,4,1,808,1386,24,686,1192,20,33.666666666666664,>30,ENG,Away,After 1965
PJ Cummins,AUS,Pace,2023-06-28,Lord's,England,2023,2,115,248,4,1,1187,1964,35,1072,1716,31,33.91428571428571,>30,ENG,Away,After 1965
PJ Cummins,AUS,Pace,2023-07-06,Leeds,England,2023,2,168,198,7,1,803,1163,34,635,965,27,23.61764705882353,<=30,ENG,Away,After 1965
PJ Cummins,AUS,Pace,2023-07-19,Manchester,England,2023,1,129,138,1,1,889,1350,23,760,1212,22,38.65217391304348,>30,ENG,Away,After 1965
PJ Cummins,AUS,Pace,2023-07-27,The Oval,England,2023,2,145,174,2,1,971,1598,29,826,1424,27,33.48275862068966,>30,ENG,Away,After 1965
PJ Cummins,AUS,Pace,2023-12-14,Perth,Australia,2023,2,46,156,3,1,810,1410,28,764,1254,25,28.928571428571427,<=30,AUS,Home,After 1965
PJ Cummins,AUS,Pace,2023-12-26,Melbourne,Australia,2023,2,97,228,10,1,818,1640,35,721,1412,25,23.37142857142857,<=30,AUS,Home,After 1965
PJ Cummins,AUS,Pace,2024-01-03,Sydney,Australia,2024,2,85,150,6,1,504,897,22,419,747,16,22.90909090909091,<=30,AUS,Home,After 1965
PJ Cummins,AUS,Pace,2024-01-17,Adelaide,Australia,2024,2,66,132,4,1,512,947,27,446,815,23,18.962962962962962,<=30,AUS,Home,After 1965
PJ Cummins,AUS,Pace,2024-01-25,Brisbane,Australia,2024,2,115,210,1,1,777,1334,30,662,1124,29,25.9,<=30,AUS,Home,After 1965
PJ Cummins,AUS,Pace,2024-02-29,Wellington,New Zealand,2024,2,73,132,1,1,689,1266,22,616,1134,21,31.318181818181817,>30,NZ,Away,After 1965
PJ Cummins,AUS,Pace,2024-03-08,Christchurch,New Zealand,2024,2,97,210,5,1,918,1490,33,821,1280,28,27.818181818181817,<=30,NZ,Away,After 1965
PJ Cummins,AUS,Pace,2024-11-22,Perth,Australia,2024,2,153,244,3,1,555,1114,27,402,870,24,20.555555555555557,<=30,AUS,Home,After 1965
PJ Cummins,AUS,Pace,2024-12-06,Adelaide,Australia,2024,2,98,156,7,1,507,779,28,409,623,21,18.107142857142858,<=30,AUS,Home,After 1965
PJ Cummins,AUS,Pace,2024-12-14,Brisbane,Australia,2024,2,85,138,4,1,550,932,24,465,794,20,22.916666666666668,<=30,AUS,Home,After 1965
PJ Cummins,AUS,Pace,2024-12-26,Melbourne,Australia,2024,2,117,282,6,1,849,1700,27,732,1418,21,31.444444444444443,>30,AUS,Home,After 1965
PJ Cummins,AUS,Pace,2025-01-03,Sydney,Australia,2025,2,81,182,5,1,502,925,30,421,743,25,16.733333333333334,<=30,AUS,Home,After 1965
PJ Loader,ENG,Pace,1954-08-12,The Oval,England,1954,2,61,204,3,1,370,1087,27,309,883,24,13.703703703703704,<=30,ENG,Home,Upto 2014
PJ Loader,ENG,Pace,1955-07-21,Leeds,England,1955,2,119,288,4,1,618,1800,24,499,1512,20,25.75,<=30,ENG,Home,Upto 2014
PJ Loader,ENG,Pace,1957-01-01,Cape Town,South Africa,1957,2,44,224,2,1,496,1551,13,452,1327,11,38.15384615384615,>30,SA,Away,Upto 2014
PJ Loader,ENG,Pace,1957-01-25,Durban,South Africa,1957,2,100,264,3,1,495,1563,15,395,1299,12,33.0,>30,SA,Away,Upto 2014
PJ Loader,ENG,Pace,1957-02-15,Johannesburg,South Africa,1957,2,111,288,1,1,520,1730,17,409,1442,16,30.58823529411765,>30,SA,Away,Upto 2014
PJ Loader,ENG,Pace,1957-03-01,Gqeberha,South Africa,1957,2,36,192,3,1,275,1498,30,239,1306,27,9.166666666666666,<=30,SA,Away,Upto 2014
PJ Loader,ENG,Pace,1957-07-25,Leeds,England,1957,2,86,207,9,1,268,663,16,182,456,7,16.75,<=30,ENG,Home,Upto 2014
PJ Loader,ENG,Pace,1957-08-22,The Oval,England,1957,2,14,60,1,1,85,210,3,71,150,2,28.333333333333332,<=30,ENG,Home,Upto 2014
PJ Loader,ENG,Pace,1958-06-05,Birmingham,England,1958,2,77,267,4,1,493,1493,26,416,1226,22,18.96153846153846,<=30,ENG,Home,Upto 2014
PJ Loader,ENG,Pace,1958-06-19,Lord's,England,1958,2,13,78,2,1,233,706,14,220,628,12,16.642857142857142,<=30,ENG,Home,Upto 2014
PJ Loader,ENG,Pace,1958-07-03,Leeds,England,1958,2,24,108,0,1,193,612,2,169,504,2,96.5,>30,ENG,Home,Upto 2014
PJ Loader,ENG,Pace,1958-12-05,Brisbane,Australia,1958,2,83,224,4,1,361,1352,20,278,1128,16,18.05,<=30,AUS,Away,Upto 2014
PJ Loader,ENG,Pace,1958-12-31,Melbourne,Australia,1958,2,110,258,3,1,456,1361,29,346,1103,26,15.724137931034482,<=30,AUS,Away,Upto 2014
PJ Malan,SA,Pace,2020-01-24,Johannesburg,South Africa,2020,1,5,12,0,1,1022,1773,39,1017,1761,39,26.205128205128204,<=30,SA,Home,After 1965
PJ Martin,ENG,Pace,1995-06-08,Leeds,England,1995,2,97,210,2,1,698,1234,27,601,1024,25,25.85185185185185,<=30,ENG,Home,Upto 2014
PJ Martin,ENG,Pace,1995-06-22,Lord's,England,1995,2,95,180,2,1,1000,2102,38,905,1922,36,26.31578947368421,<=30,ENG,Home,Upto 2014
PJ Martin,ENG,Pace,1995-07-06,Birmingham,England,1995,1,49,114,1,1,511,986,26,462,872,25,19.653846153846153,<=30,ENG,Home,Upto 2014
PJ Martin,ENG,Pace,1995-12-14,Durban,South Africa,1995,1,60,162,4,1,320,703,12,260,541,8,26.666666666666668,<=30,SA,Away,Upto 2014
PJ Martin,ENG,Pace,1995-12-26,Gqeberha,South Africa,1995,2,118,300,4,1,681,1783,21,563,1483,17,32.42857142857143,>30,SA,Away,Upto 2014
PJ Martin,ENG,Pace,1996-01-02,Cape Town,South Africa,1996,2,40,168,3,1,418,1109,22,378,941,19,19.0,<=30,SA,Away,Upto 2014
PJ Martin,ENG,Pace,1996-06-20,Lord's,England,1996,1,70,204,1,1,826,2028,26,756,1824,25,31.76923076923077,>30,ENG,Home,Upto 2014
PJ Martin,ENG,Pace,1997-08-21,The Oval,England,1997,2,51,114,0,1,435,825,24,384,711,24,18.125,<=30,ENG,Home,Upto 2014
PJ Newport,ENG,Pace,1988-08-25,Lord's,England,1988,2,164,285,7,1,947,1904,31,783,1619,24,30.548387096774192,>30,ENG,Home,Upto 2014
PJ Newport,ENG,Pace,1989-06-08,Leeds,England,1989,2,175,264,2,1,1372,2385,30,1197,2121,28,45.733333333333334,>30,ENG,Home,Upto 2014
PJ Newport,ENG,Pace,1991-02-01,W.A.C.A,Australia,1991,2,78,120,1,1,771,1442,29,693,1322,28,26.586206896551722,<=30,AUS,Away,Upto 2014
PJ Petherick,NZ,Spin,1976-10-09,Lahore,Pakistan,1976,2,129,183,5,1,495,1028,17,366,845,12,29.11764705882353,<=30,PAK,Away,Upto 2014
PJ Petherick,NZ,Spin,1976-10-23,Hyderabad (Sind),Pakistan,1976,1,154,288,2,1,481,1360,16,327,1072,14,30.0625,>30,PAK,Away,Upto 2014
PJ Petherick,NZ,Spin,1976-11-10,Wankhede,India,1976,2,135,275,4,1,560,1714,23,425,1439,19,24.347826086956523,<=30,IND,Away,Upto 2014
PJ Petherick,NZ,Spin,1976-11-18,Kanpur,India,1976,2,160,336,3,1,806,2159,22,646,1823,19,36.63636363636363,>30,IND,Away,Upto 2014
PJ Petherick,NZ,Spin,1976-11-26,Chennai,India,1976,2,89,191,2,1,433,1077,20,344,886,18,21.65,<=30,IND,Away,Upto 2014
PJ Petherick,NZ,Spin,1977-02-25,Auckland,New Zealand,1977,1,14,32,0,1,30,80,0,16,48,0,inf,>30,NZ,Home,Upto 2014
PJ Wiseman,NZ,Spin,1998-05-27,Colombo (RPS),Sri Lanka,1998,2,143,401,7,1,939,2077,27,796,1676,20,34.77777777777778,>30,SL,Away,Upto 2014
PJ Wiseman,NZ,Spin,1998-06-03,Galle,Sri Lanka,1998,1,95,180,2,1,443,1219,25,348,1039,23,17.72,<=30,SL,Away,Upto 2014
PJ Wiseman,NZ,Spin,1998-06-10,Colombo (SSC),Sri Lanka,1998,2,50,96,1,1,526,1430,27,476,1334,26,19.48148148148148,<=30,SL,Away,Upto 2014
PJ Wiseman,NZ,Spin,1998-12-26,Wellington,New Zealand,1998,1,90,114,2,1,442,922,12,352,808,10,36.833333333333336,>30,NZ,Home,Upto 2014
PJ Wiseman,NZ,Spin,1999-01-02,Hamilton,New Zealand,1999,2,126,150,1,1,438,743,6,312,593,5,73.0,>30,NZ,Home,Upto 2014
PJ Wiseman,NZ,Spin,1999-10-22,Kanpur,India,1999,2,120,204,2,1,568,1375,24,448,1171,22,23.666666666666668,<=30,IND,Away,Upto 2014
PJ Wiseman,NZ,Spin,1999-10-29,Ahmedabad,India,1999,1,85,144,0,1,599,1348,12,514,1204,12,49.916666666666664,>30,IND,Away,Upto 2014
PJ Wiseman,NZ,Spin,1999-12-16,Hamilton,New Zealand,1999,2,54,144,0,1,276,775,8,222,631,8,34.5,>30,NZ,Home,Upto 2014
PJ Wiseman,NZ,Spin,2000-03-11,Auckland,New Zealand,2000,2,159,287,5,1,549,1142,28,390,855,23,19.607142857142858,<=30,NZ,Home,Upto 2014
PJ Wiseman,NZ,Spin,2000-03-31,Hamilton,New Zealand,2000,2,73,120,4,1,265,576,9,192,456,5,29.444444444444443,<=30,NZ,Home,Upto 2014
PJ Wiseman,NZ,Spin,2000-09-12,Bulawayo,Zimbabwe,2000,2,144,420,8,1,456,1365,20,312,945,12,22.8,<=30,ZIM,Away,Upto 2014
PJ Wiseman,NZ,Spin,2000-09-19,Harare,Zimbabwe,2000,2,63,180,0,1,218,549,3,155,369,3,72.66666666666667,>30,ZIM,Away,Upto 2014
PJ Wiseman,NZ,Spin,2000-12-26,Wellington,New Zealand,2000,2,146,360,1,1,458,942,3,312,582,2,152.66666666666666,>30,NZ,Home,Upto 2014
PJ Wiseman,NZ,Spin,2001-03-08,Auckland,New Zealand,2001,2,142,258,1,1,297,718,10,155,460,9,29.7,<=30,NZ,Home,Upto 2014
PJ Wiseman,NZ,Spin,2003-04-25,Colombo (PSS),Sri Lanka,2003,1,127,246,2,1,714,1571,15,587,1325,13,47.6,>30,SL,Away,Upto 2014
PJ Wiseman,NZ,Spin,2003-05-03,Kandy,Sri Lanka,2003,2,124,249,4,1,468,1155,15,344,906,11,31.2,>30,SL,Away,Upto 2014
PJ Wiseman,NZ,Spin,2003-10-08,Ahmedabad,India,2003,2,144,197,4,1,719,1566,18,575,1369,14,39.94444444444444,>30,IND,Away,Upto 2014
PJ Wiseman,NZ,Spin,2003-10-16,Mohali,India,2003,2,132,294,1,1,664,1623,9,532,1329,8,73.77777777777777,>30,IND,Away,Upto 2014
PJ Wiseman,NZ,Spin,2004-03-10,Hamilton,New Zealand,2004,2,122,186,2,1,513,956,8,391,770,6,64.125,>30,NZ,Home,Upto 2014
PJ Wiseman,NZ,Spin,2004-10-19,Dhaka,Bangladesh,2004,2,106,197,3,1,383,1134,20,277,937,17,19.15,<=30,BAN,Away,Upto 2014
PJ Wiseman,NZ,Spin,2004-10-26,Chattogram,Bangladesh,2004,2,174,306,5,1,719,1390,23,545,1084,18,31.26086956521739,>30,BAN,Away,Upto 2014
PJ Wiseman,NZ,Spin,2004-11-26,Adelaide,Australia,2004,2,192,324,4,1,578,1205,15,386,881,11,38.53333333333333,>30,AUS,Away,Upto 2014
PJ Wiseman,NZ,Spin,2005-03-26,Auckland,New Zealand,2005,2,77,207,1,1,283,621,8,206,414,7,35.375,>30,NZ,Home,Upto 2014
PJ Wiseman,NZ,Spin,2005-04-04,Napier,New Zealand,2005,1,128,228,1,1,443,871,8,315,643,7,55.375,>30,NZ,Home,Upto 2014
PJ Wiseman,NZ,Spin,2005-04-11,Wellington,New Zealand,2005,2,87,168,0,1,233,396,0,146,228,0,inf,>30,NZ,Home,Upto 2014
PJW Allott,ENG,Pace,1981-08-13,Manchester,England,1981,2,88,138,4,1,887,1850,35,799,1712,31,25.34285714285714,<=30,ENG,Home,Upto 2014
PJW Allott,ENG,Pace,1982-01-13,Chennai,India,1982,1,135,186,0,1,631,1176,8,496,990,8,78.875,>30,IND,Away,Upto 2014
PJW Allott,ENG,Pace,1982-02-17,Colombo (PSS),Sri Lanka,1982,1,44,78,0,1,292,600,11,248,522,11,26.545454545454547,<=30,SL,Away,Upto 2014
PJW Allott,ENG,Pace,1982-06-10,Lord's,England,1982,2,66,126,1,1,701,1384,31,635,1258,30,22.612903225806452,<=30,ENG,Home,Upto 2014
PJW Allott,ENG,Pace,1982-07-08,The Oval,England,1982,2,81,168,1,1,668,1272,12,587,1104,11,55.666666666666664,>30,ENG,Home,Upto 2014
PJW Allott,ENG,Pace,1984-07-12,Leeds,England,1984,2,85,203,6,1,659,1294,24,574,1091,18,27.458333333333332,<=30,ENG,Home,Upto 2014
PJW Allott,ENG,Pace,1984-07-26,Manchester,England,1984,1,76,168,3,1,536,1172,18,460,1004,15,29.77777777777778,<=30,ENG,Home,Upto 2014
PJW Allott,ENG,Pace,1984-08-09,The Oval,England,1984,2,121,258,5,1,809,1686,40,688,1428,35,20.225,<=30,ENG,Home,Upto 2014
PJW Allott,ENG,Pace,1984-08-23,Lord's,England,1984,2,91,222,1,1,850,1633,19,759,1411,18,44.73684210526316,>30,ENG,Home,Upto 2014
PJW Allott,ENG,Pace,1985-06-13,Leeds,England,1985,2,131,234,2,1,1140,1931,28,1009,1697,26,40.714285714285715,>30,ENG,Home,Upto 2014
PJW Allott,ENG,Pace,1985-06-27,Lord's,England,1985,2,78,222,2,1,753,1358,25,675,1136,23,30.12,>30,ENG,Home,Upto 2014
PJW Allott,ENG,Pace,1985-07-11,Nottingham,England,1985,1,55,108,1,1,706,1344,15,651,1236,14,47.06666666666667,>30,ENG,Home,Upto 2014
PJW Allott,ENG,Pace,1985-08-01,Manchester,England,1985,2,33,114,0,1,622,1074,12,589,960,12,51.833333333333336,>30,ENG,Home,Upto 2014
PK Lee,AUS,Spin,1931-12-18,Sydney,Australia,1931,2,49,120,1,1,364,897,16,315,777,15,22.75,<=30,AUS,Home,Upto 2014
PK Lee,AUS,Spin,1933-02-23,Sydney,Australia,1933,2,163,316,4,1,492,1240,17,329,924,13,28.941176470588236,<=30,AUS,Home,Upto 2014
PK Wijetunge,SL,Spin,1993-08-25,Moratuwa,Sri Lanka,1993,2,118,312,2,1,610,1439,14,492,1127,12,43.57142857142857,>30,SL,Home,Upto 2014
PL Harris,SA,Spin,2007-01-02,Cape Town,South Africa,2007,2,179,354,5,1,487,1042,13,308,688,8,37.46153846153846,>30,SA,Home,Upto 2014
PL Harris,SA,Spin,2007-01-11,Centurion,South Africa,2007,2,71,200,4,1,295,739,8,224,539,4,36.875,>30,SA,Home,Upto 2014
PL Harris,SA,Spin,2007-01-19,Gqeberha,South Africa,2007,2,33,63,0,1,226,545,7,193,482,7,32.285714285714285,>30,SA,Home,Upto 2014
PL Harris,SA,Spin,2007-01-26,Cape Town,South Africa,2007,1,31,86,2,1,134,404,7,103,318,5,19.142857142857142,<=30,SA,Home,Upto 2014
PL Harris,SA,Spin,2007-10-01,Karachi,Pakistan,2007,2,131,396,7,1,692,1416,21,561,1020,14,32.95238095238095,>30,PAK,Away,Upto 2014
PL Harris,SA,Spin,2007-10-08,Lahore,Pakistan,2007,2,117,360,5,1,512,1276,13,395,916,8,39.38461538461539,>30,PAK,Away,Upto 2014
PL Harris,SA,Spin,2007-11-08,Johannesburg,South Africa,2007,1,11,36,1,1,163,386,3,152,350,2,54.333333333333336,>30,SA,Home,Upto 2014
PL Harris,SA,Spin,2007-11-16,Centurion,South Africa,2007,1,15,18,0,1,76,138,1,61,120,1,76.0,>30,SA,Home,Upto 2014
PL Harris,SA,Spin,2007-12-26,Gqeberha,South Africa,2007,2,104,274,5,1,118,315,6,14,41,1,19.666666666666668,<=30,SA,Home,Upto 2014
PL Harris,SA,Spin,2008-01-02,Cape Town,South Africa,2008,2,69,174,1,1,172,365,4,103,191,3,43.0,>30,SA,Home,Upto 2014
PL Harris,SA,Spin,2008-03-26,Chennai,India,2008,1,203,319,3,1,758,1458,16,555,1139,13,47.375,>30,IND,Away,Upto 2014
PL Harris,SA,Spin,2008-04-03,Ahmedabad,India,2008,1,68,150,1,1,281,588,6,213,438,5,46.833333333333336,>30,IND,Away,Upto 2014
PL Harris,SA,Spin,2008-04-11,Kanpur,India,2008,2,137,227,4,1,399,844,18,262,617,14,22.166666666666668,<=30,IND,Away,Upto 2014
PL Harris,SA,Spin,2008-07-10,Lord's,England,2008,1,129,230,3,1,341,797,8,212,567,5,42.625,>30,ENG,Away,Upto 2014
PL Harris,SA,Spin,2008-07-18,Leeds,England,2008,1,35,90,0,1,114,290,3,79,200,3,38.0,>30,ENG,Away,Upto 2014
PL Harris,SA,Spin,2008-07-30,Birmingham,England,2008,2,85,192,2,1,217,456,4,132,264,2,54.25,>30,ENG,Away,Upto 2014
PL Harris,SA,Spin,2008-08-07,The Oval,England,2008,2,89,209,3,1,131,334,7,42,125,4,18.714285714285715,<=30,ENG,Away,Upto 2014
PL Harris,SA,Spin,2008-11-19,Bloemfontein,South Africa,2008,1,26,42,1,1,324,498,7,298,456,6,46.285714285714285,>30,SA,Home,Upto 2014
PL Harris,SA,Spin,2008-12-17,W.A.C.A,Australia,2008,2,155,288,5,1,404,648,6,249,360,1,67.33333333333333,>30,AUS,Away,Upto 2014
PL Harris,SA,Spin,2008-12-26,Melbourne,Australia,2008,2,85,228,1,1,278,678,5,193,450,4,55.6,>30,AUS,Away,Upto 2014
PL Harris,SA,Spin,2009-01-03,Sydney,Australia,2009,2,147,299,4,1,278,623,6,131,324,2,46.333333333333336,>30,AUS,Away,Upto 2014
PL Harris,SA,Spin,2009-02-26,Johannesburg,South Africa,2009,2,100,174,3,1,210,342,4,110,168,1,52.5,>30,SA,Home,Upto 2014
PL Harris,SA,Spin,2009-03-06,Durban,South Africa,2009,2,134,312,2,1,264,614,7,130,302,5,37.714285714285715,>30,SA,Home,Upto 2014
PL Harris,SA,Spin,2009-03-19,Cape Town,South Africa,2009,2,161,359,9,1,333,503,11,172,144,2,30.272727272727273,>30,SA,Home,Upto 2014
PL Harris,SA,Spin,2009-12-16,Centurion,South Africa,2009,2,174,378,7,1,399,878,13,225,500,6,30.692307692307693,>30,SA,Home,Upto 2014
PL Harris,SA,Spin,2009-12-26,Durban,South Africa,2009,1,146,228,1,1,406,720,13,260,492,12,31.23076923076923,>30,SA,Home,Upto 2014
PL Harris,SA,Spin,2010-01-03,Cape Town,South Africa,2010,2,124,294,3,1,394,792,10,270,498,7,39.4,>30,SA,Home,Upto 2014
PL Harris,SA,Spin,2010-02-06,Nagpur,India,2010,2,115,330,4,1,517,1080,7,402,750,3,73.85714285714286,>30,IND,Away,Upto 2014
PL Harris,SA,Spin,2010-02-14,Eden Gardens,India,2010,1,182,300,1,1,547,1263,14,365,963,13,39.07142857142857,>30,IND,Away,Upto 2014
PL Harris,SA,Spin,2010-06-10,Port of Spain,West Indies,2010,2,116,195,2,1,480,983,16,364,788,14,30.0,<=30,WI,Away,Upto 2014
PL Harris,SA,Spin,2010-06-18,Basseterre,West Indies,2010,1,165,372,2,1,665,1266,8,500,894,6,83.125,>30,WI,Away,Upto 2014
PL Harris,SA,Spin,2010-06-26,Bridgetown,West Indies,2010,2,77,210,1,1,347,891,14,270,681,13,24.785714285714285,<=30,WI,Away,Upto 2014
PL Harris,SA,Spin,2010-11-12,Dubai (DICS),UAE,2010,2,104,336,2,1,753,1614,13,649,1278,11,57.92307692307692,>30,UAE,Away,Upto 2014
PL Harris,SA,Spin,2010-11-20,Abu Dhabi,UAE,2010,2,126,414,5,1,553,1225,14,427,811,9,39.5,>30,UAE,Away,Upto 2014
PL Harris,SA,Spin,2010-12-16,Centurion,South Africa,2010,2,94,186,2,1,391,504,4,297,318,2,97.75,>30,SA,Home,Upto 2014
PL Harris,SA,Spin,2010-12-26,Durban,South Africa,2010,2,62,132,1,1,148,356,7,86,224,6,21.142857142857142,<=30,SA,Home,Upto 2014
PL Harris,SA,Spin,2011-01-02,Cape Town,South Africa,2011,2,101,354,1,1,346,804,9,245,450,8,38.44444444444444,>30,SA,Home,Upto 2014
PL Mhambrey,IND,Pace,1996-06-06,Birmingham,England,1996,1,43,60,1,1,677,1326,30,634,1266,29,22.566666666666666,<=30,ENG,Away,Upto 2014
PL Mhambrey,IND,Pace,1996-06-20,Lord's,England,1996,2,105,198,1,1,826,2028,26,721,1830,25,31.76923076923077,>30,ENG,Away,Upto 2014
PL Symcox,SA,Spin,1993-08-25,Moratuwa,Sri Lanka,1993,2,175,294,3,1,610,1439,14,435,1145,11,43.57142857142857,>30,SL,Away,Upto 2014
PL Symcox,SA,Spin,1993-09-06,Colombo (SSC),Sri Lanka,1993,2,8,18,0,1,286,744,8,278,726,8,35.75,>30,SL,Away,Upto 2014
PL Symcox,SA,Spin,1993-09-14,Colombo (PSS),Sri Lanka,1993,1,47,108,1,1,296,757,9,249,649,8,32.888888888888886,>30,SL,Away,Upto 2014
PL Symcox,SA,Spin,1993-12-26,Melbourne,Australia,1993,1,49,101,2,1,190,527,4,141,426,2,47.5,>30,AUS,Away,Upto 2014
PL Symcox,SA,Spin,1994-01-02,Sydney,Australia,1994,2,104,336,2,1,327,960,14,223,624,12,23.357142857142858,<=30,AUS,Away,Upto 2014
PL Symcox,SA,Spin,1995-10-13,Harare,Zimbabwe,1995,2,43,132,1,1,142,312,1,99,180,0,142.0,>30,ZIM,Away,Upto 2014
PL Symcox,SA,Spin,1996-11-20,Ahmedabad,India,1996,2,95,258,4,1,390,956,20,295,698,16,19.5,<=30,IND,Away,Upto 2014
PL Symcox,SA,Spin,1996-11-27,Eden Gardens,India,1996,2,71,102,1,1,508,781,6,437,679,5,84.66666666666667,>30,IND,Away,Upto 2014
PL Symcox,SA,Spin,1996-12-08,Kanpur,India,1996,2,158,282,1,1,503,1168,19,345,886,18,26.473684210526315,<=30,IND,Away,Upto 2014
PL Symcox,SA,Spin,1997-03-21,Centurion,South Africa,1997,2,111,252,3,1,288,600,4,177,348,1,72.0,>30,SA,Home,Upto 2014
PL Symcox,SA,Spin,1997-10-06,Rawalpindi,Pakistan,1997,2,186,372,4,1,443,1103,12,257,731,8,36.916666666666664,>30,PAK,Away,Upto 2014
PL Symcox,SA,Spin,1997-10-17,Sheikhupura,Pakistan,1997,1,0,12,1,1,314,555,8,314,543,7,39.25,>30,PAK,Away,Upto 2014
PL Symcox,SA,Spin,1997-10-24,Faisalabad,Pakistan,1997,2,47,111,3,1,337,693,15,290,582,12,22.466666666666665,<=30,PAK,Away,Upto 2014
PL Symcox,SA,Spin,1997-12-26,Melbourne,Australia,1997,2,159,374,5,1,373,1058,13,214,684,8,28.692307692307693,<=30,AUS,Away,Upto 2014
PL Symcox,SA,Spin,1998-01-02,Sydney,Australia,1998,1,103,234,2,1,392,1015,16,289,781,14,24.5,<=30,AUS,Away,Upto 2014
PL Symcox,SA,Spin,1998-01-30,Adelaide,Australia,1998,2,82,191,1,1,384,731,9,302,540,8,42.666666666666664,>30,AUS,Away,Upto 2014
PL Symcox,SA,Spin,1998-02-14,Johannesburg,South Africa,1998,1,16,30,0,1,141,272,5,125,242,5,28.2,<=30,SA,Home,Upto 2014
PL Symcox,SA,Spin,1998-11-26,Johannesburg,South Africa,1998,2,80,222,3,1,205,491,4,125,269,1,51.25,>30,SA,Home,Upto 2014
PL Symcox,SA,Spin,1998-12-10,Gqeberha,South Africa,1998,1,9,12,0,1,44,54,0,35,42,0,inf,>30,SA,Home,Upto 2014
PL Symcox,SA,Spin,1998-12-26,Durban,South Africa,1998,2,60,120,0,1,241,454,1,181,334,1,241.0,>30,SA,Home,Upto 2014
PL Taylor,AUS,Spin,1987-01-10,Sydney,Australia,1987,2,154,330,8,1,596,1662,26,442,1332,18,22.923076923076923,<=30,AUS,Home,Upto 2014
PL Taylor,AUS,Spin,1988-01-29,Sydney,Australia,1988,1,84,204,4,1,513,1326,10,429,1122,6,51.3,>30,AUS,Home,Upto 2014
PL Taylor,AUS,Spin,1988-02-12,W.A.C.A,Australia,1988,1,3,12,0,1,67,96,0,64,84,0,inf,>30,AUS,Home,Upto 2014
PL Taylor,AUS,Spin,1988-09-15,Karachi,Pakistan,1988,1,73,96,0,1,427,1461,22,354,1365,22,19.40909090909091,<=30,PAK,Away,Upto 2014
PL Taylor,AUS,Spin,1988-10-07,Lahore,Pakistan,1988,2,89,192,4,1,510,1394,19,421,1202,15,26.842105263157894,<=30,PAK,Away,Upto 2014
PL Taylor,AUS,Spin,1988-12-24,Melbourne,Australia,1988,2,57,96,0,1,69,126,0,12,30,0,inf,>30,AUS,Home,Upto 2014
PL Taylor,AUS,Spin,1989-01-26,Sydney,Australia,1989,2,156,326,3,1,632,1677,20,476,1351,17,31.6,>30,AUS,Home,Upto 2014
PL Taylor,AUS,Spin,1990-01-19,Adelaide,Australia,1990,2,151,323,2,1,427,941,7,276,618,5,61.0,>30,AUS,Home,Upto 2014
PL Taylor,AUS,Spin,1990-02-03,Sydney,Australia,1990,1,23,48,0,1,105,210,1,82,162,1,105.0,>30,AUS,Home,Upto 2014
PL Taylor,AUS,Spin,1990-03-15,Wellington,New Zealand,1990,2,83,264,3,1,227,624,10,144,360,7,22.7,<=30,NZ,Away,Upto 2014
PL Taylor,AUS,Spin,1991-04-27,St John's,West Indies,1991,2,79,126,2,1,399,618,7,320,492,5,57.0,>30,WI,Away,Upto 2014
PL Taylor,AUS,Spin,1991-11-29,Brisbane,Australia,1991,1,56,108,0,1,182,335,1,126,227,1,182.0,>30,AUS,Home,Upto 2014
PL Taylor,AUS,Spin,1991-12-26,Melbourne,Australia,1991,2,60,102,1,1,193,372,3,133,270,2,64.33333333333333,>30,AUS,Home,Upto 2014
PL van der Merwe,SA,Spin,1964-01-01,Melbourne,Australia,1964,1,4,1,0,1,262,721,5,258,720,5,52.4,>30,AUS,Away,Upto 2014
PL van der Merwe,SA,Spin,1964-02-21,Wellington,New Zealand,1964,1,6,30,1,1,335,893,10,329,863,9,33.5,>30,NZ,Away,Upto 2014
PL van der Merwe,SA,Spin,1964-02-28,Dunedin,New Zealand,1964,1,12,48,0,1,207,662,16,195,614,16,12.9375,<=30,NZ,Away,Upto 2014
PLS Gamage,SL,Pace,2017-10-06,Dubai (DICS),UAE,2017,2,67,186,3,1,468,1044,16,401,858,13,29.25,<=30,UAE,Away,After 1965
PLS Gamage,SL,Pace,2017-11-16,Eden Gardens,India,2017,2,156,243,3,1,743,1322,32,587,1079,29,23.21875,<=30,IND,Away,After 1965
PLS Gamage,SL,Pace,2017-11-24,Nagpur,India,2017,1,97,210,1,1,472,859,9,375,649,8,52.44444444444444,>30,IND,Away,After 1965
PLS Gamage,SL,Pace,2017-12-02,Delhi,India,2017,2,143,227,3,1,549,946,10,406,719,7,54.9,>30,IND,Away,After 1965
PLS Gamage,SL,Pace,2018-06-06,Port of Spain,West Indies,2018,2,110,246,0,1,624,1324,21,514,1078,21,29.714285714285715,<=30,WI,Away,After 1965
PM Hornibrook,AUS,Spin,1929-03-08,Melbourne,Australia,1929,2,193,402,4,1,660,1893,8,467,1491,4,82.5,>30,AUS,Home,Upto 2014
PM Hornibrook,AUS,Spin,1930-06-13,Nottingham,England,1930,2,65,138,1,1,620,1484,29,555,1346,28,21.379310344827587,<=30,ENG,Away,Upto 2014
PM Hornibrook,AUS,Spin,1930-06-27,Lord's,England,1930,2,111,288,2,1,960,1932,18,849,1644,16,53.333333333333336,>30,ENG,Away,Upto 2014
PM Hornibrook,AUS,Spin,1930-07-11,Leeds,England,1930,2,108,317,2,1,548,1255,15,440,938,13,36.53333333333333,>30,ENG,Away,Upto 2014
PM Hornibrook,AUS,Spin,1930-07-25,Manchester,England,1930,1,41,156,1,1,355,1021,7,314,865,6,50.714285714285715,>30,ENG,Away,Upto 2014
PM Hornibrook,AUS,Spin,1930-08-16,The Oval,England,1930,2,146,278,7,1,762,1847,19,616,1569,12,40.10526315789474,>30,ENG,Away,Upto 2014
PM Pollock,SA,Pace,1961-12-08,Durban,South Africa,1961,2,99,255,9,1,481,1242,23,382,987,14,20.91304347826087,<=30,SA,Home,Upto 2014
PM Pollock,SA,Pace,1961-12-26,Johannesburg,South Africa,1961,2,67,204,2,1,549,1269,21,482,1065,19,26.142857142857142,<=30,SA,Home,Upto 2014
PM Pollock,SA,Pace,1962-02-16,Gqeberha,South Africa,1962,2,133,313,6,1,563,1365,25,430,1052,19,22.52,<=30,SA,Home,Upto 2014
PM Pollock,SA,Pace,1963-12-06,Brisbane,Australia,1963,2,121,230,6,1,562,1265,13,441,1035,7,43.23076923076923,>30,AUS,Away,Upto 2014
PM Pollock,SA,Pace,1964-01-01,Melbourne,Australia,1964,1,98,165,3,1,870,1955,24,772,1790,21,36.25,>30,AUS,Away,Upto 2014
PM Pollock,SA,Pace,1964-01-10,Sydney,Australia,1964,2,212,336,7,1,926,1995,29,714,1659,22,31.93103448275862,>30,AUS,Away,Upto 2014
PM Pollock,SA,Pace,1964-01-24,Adelaide,Australia,1964,2,169,280,5,1,1036,2074,26,867,1794,21,39.84615384615385,>30,AUS,Away,Upto 2014
PM Pollock,SA,Pace,1964-02-07,Sydney,Australia,1964,2,110,264,4,1,694,1880,20,584,1616,16,34.7,>30,AUS,Away,Upto 2014
PM Pollock,SA,Pace,1964-02-21,Wellington,New Zealand,1964,2,78,287,8,1,514,1667,18,436,1380,10,28.555555555555557,<=30,NZ,Away,Upto 2014
PM Pollock,SA,Pace,1964-02-28,Dunedin,New Zealand,1964,2,78,227,5,1,306,1085,13,228,858,8,23.53846153846154,<=30,NZ,Away,Upto 2014
PM Pollock,SA,Pace,1964-03-13,Auckland,New Zealand,1964,2,102,267,2,1,606,1729,24,504,1462,22,25.25,<=30,NZ,Away,Upto 2014
PM Pollock,SA,Pace,1964-12-04,Durban,South Africa,1964,1,80,198,0,1,364,1062,8,284,864,8,45.5,>30,SA,Home,Upto 2014
PM Pollock,SA,Pace,1964-12-23,Johannesburg,South Africa,1964,1,129,231,5,1,619,1341,11,490,1110,6,56.27272727272727,>30,SA,Home,Upto 2014
PM Pollock,SA,Pace,1965-01-01,Cape Town,South Africa,1965,1,89,234,2,1,647,1572,12,558,1338,10,53.916666666666664,>30,SA,Home,Upto 2014
PM Pollock,SA,Pace,1965-01-22,Johannesburg,South Africa,1965,2,69,158,4,1,754,1664,13,685,1506,9,58.0,>30,SA,Home,Upto 2014
PM Pollock,SA,Pace,1965-02-12,Gqeberha,South Africa,1965,2,78,194,1,1,624,1549,12,546,1355,11,52.0,>30,SA,Home,Upto 2014
PM Pollock,SA,Pace,1965-07-22,Lord's,England,1965,2,143,354,3,1,689,1908,25,546,1554,22,27.56,<=30,ENG,Away,Upto 2014
PM Pollock,SA,Pace,1965-08-05,Nottingham,England,1965,2,87,287,10,1,718,1736,30,631,1449,20,23.933333333333334,<=30,ENG,Away,Upto 2014
PM Pollock,SA,Pace,1965-08-26,The Oval,England,1965,2,136,345,7,1,786,1848,27,650,1503,20,29.11111111111111,<=30,ENG,Away,Upto 2014
PM Pollock,SA,Pace,1966-12-23,Johannesburg,South Africa,1966,2,107,258,1,1,809,1914,26,702,1656,25,31.115384615384617,>30,SA,Home,Upto 2014
PM Pollock,SA,Pace,1966-12-31,Cape Town,South Africa,1966,2,126,204,3,1,762,1783,22,636,1579,19,34.63636363636363,>30,SA,Home,Upto 2014
PM Pollock,SA,Pace,1967-01-20,Durban,South Africa,1967,2,93,192,2,1,725,1921,25,632,1729,23,29.0,<=30,SA,Home,Upto 2014
PM Pollock,SA,Pace,1967-02-03,Johannesburg,South Africa,1967,2,45,157,2,1,518,1312,23,473,1155,21,22.52173913043478,<=30,SA,Home,Upto 2014
PM Pollock,SA,Pace,1967-02-24,Gqeberha,South Africa,1967,2,99,192,4,1,655,1640,26,556,1448,22,25.192307692307693,<=30,SA,Home,Upto 2014
PM Pollock,SA,Pace,1970-01-22,Cape Town,South Africa,1970,2,39,180,4,1,471,1312,21,432,1132,17,22.428571428571427,<=30,SA,Home,Upto 2014
PM Pollock,SA,Pace,1970-02-05,Durban,South Africa,1970,2,76,189,3,1,686,1387,21,610,1198,18,32.666666666666664,>30,SA,Home,Upto 2014
PM Pollock,SA,Pace,1970-02-19,Johannesburg,South Africa,1970,2,95,230,5,1,766,1822,28,671,1592,23,27.357142857142858,<=30,SA,Home,Upto 2014
PM Pollock,SA,Pace,1970-03-05,Gqeberha,South Africa,1970,2,48,91,3,1,887,1974,33,839,1883,30,26.87878787878788,<=30,SA,Home,Upto 2014
PM Pushpakumara,SL,Spin,2017-08-03,Colombo (SSC),Sri Lanka,2017,1,156,230,2,1,953,1487,21,797,1257,19,45.38095238095238,>30,SL,Home,After 1965
PM Pushpakumara,SL,Spin,2017-08-12,Pallekele,Sri Lanka,2017,1,82,138,3,1,436,802,19,354,664,16,22.94736842105263,<=30,SL,Home,After 1965
PM Pushpakumara,SL,Spin,2018-11-14,Pallekele,Sri Lanka,2018,2,190,300,4,1,1031,1760,38,841,1460,34,27.13157894736842,<=30,SL,Home,After 1965
PM Pushpakumara,SL,Spin,2018-11-23,Colombo (SSC),Sri Lanka,2018,2,92,192,5,1,913,1615,34,821,1423,29,26.852941176470587,<=30,SL,Home,After 1965
PM Siddle,AUS,Pace,2008-10-17,Mohali,India,2008,2,176,258,4,1,846,1398,17,670,1140,13,49.76470588235294,>30,IND,Away,Upto 2014
PM Siddle,AUS,Pace,2008-12-17,W.A.C.A,Australia,2008,2,128,257,1,1,940,1782,28,812,1525,27,33.57142857142857,>30,AUS,Home,Upto 2014
PM Siddle,AUS,Pace,2008-12-26,Melbourne,Australia,2008,2,115,288,4,1,952,1716,26,837,1428,22,36.61538461538461,>30,AUS,Home,Upto 2014
PM Siddle,AUS,Pace,2009-01-03,Sydney,Australia,2009,2,113,329,8,1,952,2011,26,839,1682,18,36.61538461538461,>30,AUS,Home,Upto 2014
PM Siddle,AUS,Pace,2009-02-26,Johannesburg,South Africa,2009,2,122,276,6,1,938,1937,36,816,1661,30,26.055555555555557,<=30,SA,Away,Upto 2014
PM Siddle,AUS,Pace,2009-03-06,Durban,South Africa,2009,2,81,249,5,1,857,1739,26,776,1490,21,32.96153846153846,>30,SA,Away,Upto 2014
PM Siddle,AUS,Pace,2009-03-19,Cape Town,South Africa,2009,1,67,210,1,1,890,1587,18,823,1377,17,49.44444444444444,>30,SA,Away,Upto 2014
PM Siddle,AUS,Pace,2009-07-08,Cardiff,England,2009,2,172,270,3,1,832,1434,18,660,1164,15,46.22222222222222,>30,ENG,Away,Upto 2014
PM Siddle,AUS,Pace,2009-07-16,Lord's,England,2009,2,140,212,4,1,1009,1590,27,869,1378,23,37.370370370370374,>30,ENG,Away,Upto 2014
PM Siddle,AUS,Pace,2009-07-30,Birmingham,England,2009,1,89,129,3,1,806,1353,22,717,1224,19,36.63636363636363,>30,ENG,Away,Upto 2014
PM Siddle,AUS,Pace,2009-08-07,Leeds,England,2009,2,71,131,6,1,700,1101,30,629,970,24,23.333333333333332,<=30,ENG,Away,Upto 2014
PM Siddle,AUS,Pace,2009-08-20,The Oval,England,2009,2,144,228,4,1,842,1408,23,698,1180,19,36.608695652173914,>30,ENG,Away,Upto 2014
PM Siddle,AUS,Pace,2009-11-26,Brisbane,Australia,2009,2,92,138,2,1,697,1123,21,605,985,19,33.19047619047619,>30,AUS,Home,Upto 2014
PM Siddle,AUS,Pace,2009-12-04,Adelaide,Australia,2009,2,120,198,1,1,930,1567,26,810,1369,25,35.76923076923077,>30,AUS,Home,Upto 2014
PM Siddle,AUS,Pace,2009-12-26,Melbourne,Australia,2009,2,109,222,2,1,736,1512,23,627,1290,21,32.0,>30,AUS,Home,Upto 2014
PM Siddle,AUS,Pace,2010-01-03,Sydney,Australia,2010,2,89,156,1,1,640,1344,29,551,1188,28,22.06896551724138,<=30,AUS,Home,Upto 2014
PM Siddle,AUS,Pace,2010-01-14,Hobart,Australia,2010,2,64,212,5,1,758,1508,15,694,1296,10,50.53333333333333,>30,AUS,Home,Upto 2014
PM Siddle,AUS,Pace,2010-11-25,Brisbane,Australia,2010,2,144,240,6,1,947,1750,17,803,1510,11,55.705882352941174,>30,AUS,Home,Upto 2014
PM Siddle,AUS,Pace,2010-12-03,Adelaide,Australia,2010,1,121,180,0,1,745,1313,14,624,1133,14,53.214285714285715,>30,AUS,Home,Upto 2014
PM Siddle,AUS,Pace,2010-12-16,W.A.C.A,Australia,2010,2,33,78,1,1,755,1419,38,722,1341,37,19.86842105263158,<=30,AUS,Home,Upto 2014
PM Siddle,AUS,Pace,2010-12-26,Melbourne,Australia,2010,1,75,199,6,1,704,1424,26,629,1225,20,27.076923076923077,<=30,AUS,Home,Upto 2014
PM Siddle,AUS,Pace,2011-01-03,Sydney,Australia,2011,1,111,186,1,1,873,1642,26,762,1456,25,33.57692307692308,>30,AUS,Home,Upto 2014
PM Siddle,AUS,Pace,2011-09-16,Colombo (SSC),Sri Lanka,2011,1,91,210,4,1,825,1634,20,734,1424,16,41.25,>30,SL,Away,Upto 2014
PM Siddle,AUS,Pace,2011-11-09,Cape Town,South Africa,2011,2,65,98,1,1,597,929,31,532,831,30,19.258064516129032,<=30,SA,Away,Upto 2014
PM Siddle,AUS,Pace,2011-11-17,Johannesburg,South Africa,2011,2,140,252,3,1,938,1680,27,798,1428,24,34.74074074074074,>30,SA,Away,Upto 2014
PM Siddle,AUS,Pace,2011-12-01,Brisbane,Australia,2011,2,101,240,3,1,653,1114,19,552,874,16,34.36842105263158,>30,AUS,Home,Upto 2014
PM Siddle,AUS,Pace,2011-12-09,Hobart,Australia,2011,2,108,228,6,1,648,1341,37,540,1113,31,17.513513513513512,<=30,AUS,Home,Upto 2014
PM Siddle,AUS,Pace,2011-12-26,Melbourne,Australia,2011,2,105,181,6,1,739,1504,35,634,1323,29,21.114285714285714,<=30,AUS,Home,Upto 2014
PM Siddle,AUS,Pace,2012-01-03,Sydney,Australia,2012,2,143,225,5,1,874,1376,22,731,1151,17,39.72727272727273,>30,AUS,Home,Upto 2014
PM Siddle,AUS,Pace,2012-01-13,W.A.C.A,Australia,2012,2,85,164,6,1,668,1156,29,583,992,23,23.03448275862069,<=30,AUS,Home,Upto 2014
PM Siddle,AUS,Pace,2012-01-24,Adelaide,Australia,2012,2,96,174,6,1,749,1369,20,653,1195,14,37.45,>30,AUS,Home,Upto 2014
PM Siddle,AUS,Pace,2012-04-07,Bridgetown,West Indies,2012,2,115,288,3,1,725,1642,25,610,1354,22,29.0,<=30,WI,Away,Upto 2014
PM Siddle,AUS,Pace,2012-11-09,Brisbane,Australia,2012,2,147,318,3,1,917,1756,14,770,1438,11,65.5,>30,AUS,Home,Upto 2014
PM Siddle,AUS,Pace,2012-11-22,Adelaide,Australia,2012,2,195,383,6,1,863,1649,28,668,1266,22,30.821428571428573,>30,AUS,Home,Upto 2014
PM Siddle,AUS,Pace,2012-12-14,Hobart,Australia,2012,2,104,309,9,1,927,1883,26,823,1574,17,35.65384615384615,>30,AUS,Home,Upto 2014
PM Siddle,AUS,Pace,2012-12-26,Melbourne,Australia,2012,2,62,80,3,1,518,864,21,456,784,18,24.666666666666668,<=30,AUS,Home,Upto 2014
PM Siddle,AUS,Pace,2013-01-03,Sydney,Australia,2013,2,88,192,3,1,729,1200,20,641,1008,17,36.45,>30,AUS,Home,Upto 2014
PM Siddle,AUS,Pace,2013-02-22,Chennai,India,2013,2,70,165,1,1,415,813,8,345,648,7,51.875,>30,IND,Away,Upto 2014
PM Siddle,AUS,Pace,2013-03-02,Hyderabad,India,2013,1,92,186,1,1,327,744,7,235,558,6,46.714285714285715,>30,IND,Away,Upto 2014
PM Siddle,AUS,Pace,2013-03-14,Mohali,India,2013,2,105,241,6,1,473,880,15,368,639,9,31.533333333333335,>30,IND,Away,Upto 2014
PM Siddle,AUS,Pace,2013-03-22,Delhi,India,2013,1,38,72,1,1,259,450,5,221,378,4,51.8,>30,IND,Away,Upto 2014
PM Siddle,AUS,Pace,2013-07-10,Nottingham,England,2013,2,135,287,8,1,827,1665,33,692,1378,25,25.060606060606062,<=30,ENG,Away,Upto 2014
PM Siddle,AUS,Pace,2013-07-18,Lord's,England,2013,2,141,258,3,1,669,1424,21,528,1166,18,31.857142857142858,>30,ENG,Away,Upto 2014
PM Siddle,AUS,Pace,2013-08-01,Manchester,England,2013,2,71,198,5,1,710,1434,19,639,1236,14,37.36842105263158,>30,ENG,Away,Upto 2014
PM Siddle,AUS,Pace,2013-08-09,Chester-le-Street,England,2013,2,100,210,1,1,823,1578,29,723,1368,28,28.379310344827587,<=30,ENG,Away,Upto 2014
PM Siddle,AUS,Pace,2013-08-21,The Oval,England,2013,2,90,186,0,1,836,1443,25,746,1257,25,33.44,>30,ENG,Away,Upto 2014
PM Siddle,AUS,Pace,2013-11-21,Brisbane,Australia,2013,2,49,160,2,1,625,1326,30,576,1166,28,20.833333333333332,<=30,AUS,Home,Upto 2014
PM Siddle,AUS,Pace,2013-12-05,Adelaide,Australia,2013,2,91,198,5,1,606,1290,25,515,1092,20,24.24,<=30,AUS,Home,Upto 2014
PM Siddle,AUS,Pace,2013-12-13,W.A.C.A,Australia,2013,2,103,252,4,1,995,1739,27,892,1487,23,36.851851851851855,>30,AUS,Home,Upto 2014
PM Siddle,AUS,Pace,2013-12-26,Melbourne,Australia,2013,2,96,228,2,1,653,1410,24,557,1182,22,27.208333333333332,<=30,AUS,Home,Upto 2014
PM Siddle,AUS,Pace,2014-01-03,Sydney,Australia,2014,2,47,102,3,1,663,1122,33,616,1020,30,20.09090909090909,<=30,AUS,Home,After 1965
PM Siddle,AUS,Pace,2014-02-12,Centurion,South Africa,2014,2,88,174,3,1,767,1417,27,679,1243,24,28.40740740740741,<=30,SA,Away,After 1965
PM Siddle,AUS,Pace,2014-02-20,Gqeberha,South Africa,2014,2,185,318,2,1,800,1419,22,615,1101,20,36.36363636363637,>30,SA,Away,After 1965
PM Siddle,AUS,Pace,2014-10-22,Dubai (DICS),UAE,2014,2,94,228,1,1,384,954,8,290,726,7,48.0,>30,UAE,Away,After 1965
PM Siddle,AUS,Pace,2014-10-30,Abu Dhabi,UAE,2014,2,123,270,1,1,549,1024,11,426,754,10,49.90909090909091,>30,UAE,Away,After 1965
PM Siddle,AUS,Pace,2014-12-09,Adelaide,Australia,2014,2,109,166,2,1,885,1420,15,776,1254,13,59.0,>30,AUS,Home,After 1965
PM Siddle,AUS,Pace,2015-08-20,The Oval,England,2015,2,67,226,6,1,638,1293,22,571,1067,16,29.0,<=30,ENG,Away,After 1965
PM Siddle,AUS,Pace,2015-11-27,Adelaide,Australia,2015,2,89,186,2,1,584,1142,29,495,956,27,20.137931034482758,<=30,AUS,Home,After 1965
PM Siddle,AUS,Pace,2015-12-10,Hobart,Australia,2015,2,70,132,2,1,634,903,16,564,771,14,39.625,>30,AUS,Home,After 1965
PM Siddle,AUS,Pace,2015-12-26,Melbourne,Australia,2015,2,75,162,3,1,837,1482,18,762,1320,15,46.5,>30,AUS,Home,After 1965
PM Siddle,AUS,Pace,2016-02-12,Wellington,New Zealand,2016,2,67,120,3,1,769,1383,21,702,1263,18,36.61904761904762,>30,NZ,Away,After 1965
PM Siddle,AUS,Pace,2016-11-03,W.A.C.A,Australia,2016,2,98,228,3,1,937,1726,29,839,1498,26,32.310344827586206,>30,AUS,Home,After 1965
PM Siddle,AUS,Pace,2018-10-07,Dubai (DICS),UAE,2018,2,61,186,3,1,373,938,11,312,752,8,33.90909090909091,>30,UAE,Away,After 1965
PM Siddle,AUS,Pace,2018-10-16,Abu Dhabi,UAE,2018,2,107,198,0,1,398,700,16,291,502,16,24.875,<=30,UAE,Away,After 1965
PM Siddle,AUS,Pace,2019-08-01,Birmingham,England,2019,2,80,234,2,1,758,1453,25,678,1219,23,30.32,>30,ENG,Away,After 1965
PM Siddle,AUS,Pace,2019-08-14,Lord's,England,2019,2,102,168,3,1,589,1275,24,487,1107,21,24.541666666666668,<=30,ENG,Away,After 1965
PM Siddle,AUS,Pace,2019-09-12,The Oval,England,2019,2,113,180,2,1,856,1530,30,743,1350,28,28.533333333333335,<=30,ENG,Away,After 1965
PM Such,ENG,Spin,1993-06-03,Manchester,England,1993,2,145,387,8,1,496,1275,19,351,888,11,26.105263157894736,<=30,ENG,Home,Upto 2014
PM Such,ENG,Spin,1993-06-17,Lord's,England,1993,1,90,216,0,1,634,1745,17,544,1529,17,37.294117647058826,>30,ENG,Home,Upto 2014
PM Such,ENG,Spin,1993-07-01,Nottingham,England,1993,2,109,258,4,1,460,1186,11,351,928,7,41.81818181818182,>30,ENG,Home,Upto 2014
PM Such,ENG,Spin,1993-08-05,Birmingham,England,1993,2,148,440,4,1,613,1738,21,465,1298,17,29.19047619047619,<=30,ENG,Home,Upto 2014
PM Such,ENG,Spin,1993-08-19,The Oval,England,1993,2,49,138,0,1,310,756,7,261,618,7,44.285714285714285,>30,ENG,Home,Upto 2014
PM Such,ENG,Spin,1994-06-02,Nottingham,England,1994,2,78,318,3,1,324,936,7,246,618,4,46.285714285714285,>30,ENG,Home,Upto 2014
PM Such,ENG,Spin,1994-06-16,Lord's,England,1994,2,139,330,3,1,425,1219,7,286,889,4,60.714285714285715,>30,ENG,Home,Upto 2014
PM Such,ENG,Spin,1994-06-30,Manchester,England,1994,2,47,90,0,1,174,423,5,127,333,5,34.8,>30,ENG,Home,Upto 2014
PM Such,ENG,Spin,1998-12-11,Adelaide,Australia,1998,2,165,402,5,1,473,1152,14,308,750,9,33.785714285714285,>30,AUS,Away,Upto 2014
PM Such,ENG,Spin,1999-01-02,Sydney,Australia,1999,2,158,299,6,1,526,1105,23,368,806,17,22.869565217391305,<=30,AUS,Away,Upto 2014
PM Such,ENG,Spin,1999-08-05,Manchester,England,1999,1,114,246,4,1,316,834,9,202,588,5,35.111111111111114,>30,ENG,Home,Upto 2014
PM Toohey,AUS,Spin,1979-12-29,Melbourne,Australia,1979,1,4,2,0,1,126,210,3,122,208,3,42.0,>30,AUS,Home,Upto 2014
PM Walker,ENG,Spin,1960-06-09,Birmingham,England,1960,2,21,60,0,1,303,864,14,282,804,14,21.642857142857142,<=30,ENG,Home,Upto 2014
PM Walker,ENG,Spin,1960-07-07,Nottingham,England,1960,1,13,18,0,1,109,321,3,96,303,3,36.333333333333336,>30,ENG,Home,Upto 2014
PN Kirsten,SA,Spin,1992-11-26,Johannesburg,South Africa,1992,2,13,30,0,1,138,480,8,125,450,8,17.25,<=30,SA,Home,Upto 2014
PN Kirsten,SA,Spin,1994-01-28,Adelaide,Australia,1994,1,17,24,0,1,289,1015,8,272,991,8,36.125,>30,AUS,Away,Upto 2014
PNF Mansell,SA,Spin,1951-07-26,Leeds,England,1951,1,11,24,0,1,749,2072,16,738,2048,16,46.8125,>30,ENG,Away,Upto 2014
PNF Mansell,SA,Spin,1952-12-05,Brisbane,Australia,1952,1,40,64,0,1,592,1609,17,552,1545,17,34.8235294117647,>30,AUS,Away,Upto 2014
PNF Mansell,SA,Spin,1952-12-24,Melbourne,Australia,1952,2,127,264,3,1,730,1899,24,603,1635,21,30.416666666666668,>30,AUS,Away,Upto 2014
PNF Mansell,SA,Spin,1953-01-09,Sydney,Australia,1953,1,46,56,0,1,515,1280,12,469,1224,12,42.916666666666664,>30,AUS,Away,Upto 2014
PNF Mansell,SA,Spin,1953-01-24,Adelaide,Australia,1953,2,153,312,3,1,857,2379,23,704,2067,20,37.26086956521739,>30,AUS,Away,Upto 2014
PNF Mansell,SA,Spin,1953-02-06,Melbourne,Australia,1953,2,143,240,3,1,952,2221,20,809,1981,17,47.6,>30,AUS,Away,Upto 2014
PNF Mansell,SA,Spin,1953-03-06,Wellington,New Zealand,1953,2,57,144,0,1,540,1494,12,483,1350,12,45.0,>30,NZ,Away,Upto 2014
PNF Mansell,SA,Spin,1953-03-13,Auckland,New Zealand,1953,2,29,114,1,1,495,1529,18,466,1415,17,27.5,<=30,NZ,Away,Upto 2014
PNF Mansell,SA,Spin,1955-06-23,Lord's,England,1955,1,7,12,0,1,220,561,12,213,549,12,18.333333333333332,<=30,ENG,Away,Upto 2014
PNF Mansell,SA,Spin,1955-07-07,Manchester,England,1955,2,46,126,1,1,419,1223,6,373,1097,5,69.83333333333333,>30,ENG,Away,Upto 2014
PNF Mansell,SA,Spin,1955-07-21,Leeds,England,1955,1,53,114,0,1,458,1267,15,405,1153,15,30.533333333333335,>30,ENG,Away,Upto 2014
PNF Mansell,SA,Spin,1955-08-13,The Oval,England,1955,1,24,36,0,1,308,1166,23,284,1130,23,13.391304347826088,<=30,ENG,Away,Upto 2014
PP Chawla,IND,Spin,2006-03-09,Mohali,India,2006,2,53,85,1,1,492,1055,19,439,970,18,25.894736842105264,<=30,IND,Home,Upto 2014
PP Chawla,IND,Spin,2008-04-11,Kanpur,India,2008,2,84,120,2,1,399,844,18,315,724,16,22.166666666666668,<=30,IND,Home,Upto 2014
PP Chawla,IND,Spin,2012-12-13,Nagpur,India,2012,2,133,287,4,1,722,2045,15,589,1758,11,48.13333333333333,>30,IND,Home,Upto 2014
PP Ojha,IND,Spin,2009-11-24,Kanpur,India,2009,2,73,231,4,1,718,1197,20,645,966,16,35.9,>30,IND,Home,Upto 2014
PP Ojha,IND,Spin,2009-12-02,Brabourne,India,2009,2,185,280,5,1,870,1403,18,685,1123,13,48.333333333333336,>30,IND,Home,Upto 2014
PP Ojha,IND,Spin,2010-01-24,Mirpur,Bangladesh,2010,2,126,228,4,1,600,1045,11,474,817,7,54.54545454545455,>30,BAN,Away,Upto 2014
PP Ojha,IND,Spin,2010-07-18,Galle,Sri Lanka,2010,2,126,186,0,1,643,1145,10,517,959,10,64.3,>30,SL,Away,Upto 2014
PP Ojha,IND,Spin,2010-07-26,Colombo (SSC),Sri Lanka,2010,2,185,354,1,1,926,1870,14,741,1516,13,66.14285714285714,>30,SL,Away,Upto 2014
PP Ojha,IND,Spin,2010-08-03,Colombo (PSS),Sri Lanka,2010,2,204,444,7,1,813,1539,26,609,1095,19,31.26923076923077,>30,SL,Away,Upto 2014
PP Ojha,IND,Spin,2010-10-01,Mohali,India,2010,2,172,412,3,1,557,1225,12,385,813,9,46.416666666666664,>30,IND,Home,Upto 2014
PP Ojha,IND,Spin,2010-10-09,Bengaluru,India,2010,2,177,402,6,1,696,1271,17,519,869,11,40.94117647058823,>30,IND,Home,Upto 2014
PP Ojha,IND,Spin,2010-11-04,Ahmedabad,India,2010,2,108,336,4,1,781,1719,18,673,1383,14,43.388888888888886,>30,IND,Home,Upto 2014
PP Ojha,IND,Spin,2010-11-12,Hyderabad,India,2010,2,217,447,3,1,691,1414,15,474,967,12,46.06666666666667,>30,IND,Home,Upto 2014
PP Ojha,IND,Spin,2010-11-20,Nagpur,India,2010,2,124,219,5,1,493,909,15,369,690,10,32.86666666666667,>30,IND,Home,Upto 2014
PP Ojha,IND,Spin,2011-11-06,Delhi,India,2011,2,109,290,7,1,434,957,21,325,667,14,20.666666666666668,<=30,IND,Home,Upto 2014
PP Ojha,IND,Spin,2011-11-14,Eden Gardens,India,2011,2,168,324,6,1,689,1188,12,521,864,6,57.416666666666664,>30,IND,Home,Upto 2014
PP Ojha,IND,Spin,2011-11-22,Wankhede,India,2011,2,173,450,7,1,794,1593,24,621,1143,17,33.083333333333336,>30,IND,Home,Upto 2014
PP Ojha,IND,Spin,2012-08-23,Hyderabad,India,2012,2,92,294,6,1,326,884,22,234,590,16,14.818181818181818,<=30,IND,Home,Upto 2014
PP Ojha,IND,Spin,2012-08-31,Bengaluru,India,2012,2,148,295,7,1,445,783,16,297,488,9,27.8125,<=30,IND,Home,Upto 2014
PP Ojha,IND,Spin,2012-11-15,Ahmedabad,India,2012,2,165,464,9,1,729,1559,21,564,1095,12,34.714285714285715,>30,IND,Home,Upto 2014
PP Ojha,IND,Spin,2012-11-23,Wankhede,India,2012,2,159,264,5,1,747,1449,28,588,1185,23,26.678571428571427,<=30,IND,Home,Upto 2014
PP Ojha,IND,Spin,2012-12-05,Eden Gardens,India,2012,2,152,348,5,1,665,1360,18,513,1012,13,36.94444444444444,>30,IND,Home,Upto 2014
PP Ojha,IND,Spin,2012-12-13,Nagpur,India,2012,2,141,450,1,1,722,2045,15,581,1595,14,48.13333333333333,>30,IND,Home,Upto 2014
PP Ojha,IND,Spin,2013-03-14,Mohali,India,2013,2,144,294,4,1,752,1501,18,608,1207,14,41.77777777777778,>30,IND,Home,Upto 2014
PP Ojha,IND,Spin,2013-03-22,Delhi,India,2013,2,94,223,3,1,535,1112,29,441,889,26,18.448275862068964,<=30,IND,Home,Upto 2014
PP Ojha,IND,Spin,2013-11-06,Eden Gardens,India,2013,2,89,222,1,1,456,988,15,367,766,14,30.4,>30,IND,Home,Upto 2014
PP Ojha,IND,Spin,2013-11-14,Wankhede,India,2013,2,89,176,10,1,497,770,24,408,594,14,20.708333333333332,<=30,IND,Home,Upto 2014
PR Adams,SA,Spin,1995-12-26,Gqeberha,South Africa,1995,2,126,390,4,1,309,845,10,183,455,6,30.9,>30,SA,Home,Upto 2014
PR Adams,SA,Spin,1996-01-02,Cape Town,South Africa,1996,2,105,253,4,1,171,377,6,66,124,2,28.5,<=30,SA,Home,Upto 2014
PR Adams,SA,Spin,1996-11-20,Ahmedabad,India,1996,2,76,158,4,1,390,956,20,314,798,16,19.5,<=30,IND,Away,Upto 2014
PR Adams,SA,Spin,1996-11-27,Eden Gardens,India,1996,1,69,78,2,1,508,781,6,439,703,4,84.66666666666667,>30,IND,Away,Upto 2014
PR Adams,SA,Spin,1996-12-08,Kanpur,India,1996,2,139,235,8,1,503,1168,19,364,933,11,26.473684210526315,<=30,IND,Away,Upto 2014
PR Adams,SA,Spin,1997-01-02,Cape Town,South Africa,1997,2,94,206,5,1,351,752,7,257,546,2,50.142857142857146,>30,SA,Home,Upto 2014
PR Adams,SA,Spin,1997-01-16,Johannesburg,South Africa,1997,2,168,270,4,1,289,570,8,121,300,4,36.125,>30,SA,Home,Upto 2014
PR Adams,SA,Spin,1997-02-28,Johannesburg,South Africa,1997,1,163,312,1,1,374,844,13,211,532,12,28.76923076923077,<=30,SA,Home,Upto 2014
PR Adams,SA,Spin,1997-03-14,Gqeberha,South Africa,1997,2,71,150,3,1,179,488,11,108,338,8,16.272727272727273,<=30,SA,Home,Upto 2014
PR Adams,SA,Spin,1997-10-17,Sheikhupura,Pakistan,1997,1,0,12,0,1,314,555,8,314,543,8,39.25,>30,PAK,Away,Upto 2014
PR Adams,SA,Spin,1997-10-24,Faisalabad,Pakistan,1997,2,79,168,2,1,337,693,15,258,525,13,22.466666666666665,<=30,PAK,Away,Upto 2014
PR Adams,SA,Spin,1998-01-02,Sydney,Australia,1998,1,66,228,1,1,392,1015,16,326,787,15,24.5,<=30,AUS,Away,Upto 2014
PR Adams,SA,Spin,1998-03-06,Gqeberha,South Africa,1998,1,36,96,3,1,101,198,4,65,102,1,25.25,<=30,SA,Home,Upto 2014
PR Adams,SA,Spin,1998-03-19,Cape Town,South Africa,1998,2,152,282,4,1,499,1068,16,347,786,12,31.1875,>30,SA,Home,Upto 2014
PR Adams,SA,Spin,1998-03-27,Centurion,South Africa,1998,2,102,174,1,1,345,671,12,243,497,11,28.75,<=30,SA,Home,Upto 2014
PR Adams,SA,Spin,1998-06-04,Birmingham,England,1998,2,119,325,5,1,204,487,5,85,162,0,40.8,>30,ENG,Away,Upto 2014
PR Adams,SA,Spin,1998-06-18,Lord's,England,1998,1,62,138,3,1,85,192,3,23,54,0,28.333333333333332,<=30,ENG,Away,Upto 2014
PR Adams,SA,Spin,1998-07-02,Manchester,England,1998,2,153,492,5,1,380,1050,6,227,558,1,63.333333333333336,>30,ENG,Away,Upto 2014
PR Adams,SA,Spin,1998-07-23,Nottingham,England,1998,2,54,126,0,1,120,210,0,66,84,0,inf,>30,ENG,Away,Upto 2014
PR Adams,SA,Spin,1999-01-02,Cape Town,South Africa,1999,2,141,234,3,1,319,696,6,178,462,3,53.166666666666664,>30,SA,Home,Upto 2014
PR Adams,SA,Spin,1999-01-15,Centurion,South Africa,1999,1,64,128,4,1,279,568,9,215,440,5,31.0,>30,SA,Home,Upto 2014
PR Adams,SA,Spin,1999-02-27,Auckland,New Zealand,1999,2,199,456,4,1,327,720,5,128,264,1,65.4,>30,NZ,Away,Upto 2014
PR Adams,SA,Spin,1999-03-11,Christchurch,New Zealand,1999,2,61,124,2,1,135,274,3,74,150,1,45.0,>30,NZ,Away,Upto 2014
PR Adams,SA,Spin,1999-03-18,Wellington,New Zealand,1999,2,75,177,4,1,235,525,9,160,348,5,26.11111111111111,<=30,NZ,Away,Upto 2014
PR Adams,SA,Spin,1999-10-29,Bloemfontein,South Africa,1999,2,36,91,4,1,80,229,5,44,138,1,16.0,<=30,SA,Home,Upto 2014
PR Adams,SA,Spin,1999-11-11,Harare,Zimbabwe,1999,1,40,65,3,1,131,233,4,91,168,1,32.75,>30,ZIM,Away,Upto 2014
PR Adams,SA,Spin,1999-11-25,Johannesburg,South Africa,1999,2,36,72,1,1,75,138,1,39,66,0,75.0,>30,SA,Home,Upto 2014
PR Adams,SA,Spin,1999-12-26,Durban,South Africa,1999,1,74,258,2,1,272,696,4,198,438,2,68.0,>30,SA,Home,Upto 2014
PR Adams,SA,Spin,2000-01-02,Cape Town,South Africa,2000,2,80,243,4,1,194,523,5,114,280,1,38.8,>30,SA,Home,Upto 2014
PR Adams,SA,Spin,2000-07-20,Galle,Sri Lanka,2000,1,184,270,3,1,705,1392,24,521,1122,21,29.375,<=30,SL,Away,Upto 2014
PR Adams,SA,Spin,2000-07-30,Kandy,Sri Lanka,2000,2,70,102,0,1,551,1139,19,481,1037,19,29.0,<=30,SL,Away,Upto 2014
PR Adams,SA,Spin,2000-08-06,Colombo (SSC),Sri Lanka,2000,1,72,96,1,1,525,1357,18,453,1261,17,29.166666666666668,<=30,SL,Away,Upto 2014
PR Adams,SA,Spin,2001-04-19,Kingston,West Indies,2001,2,97,197,2,1,221,617,7,124,420,5,31.571428571428573,>30,WI,Away,Upto 2014
PR Adams,SA,Spin,2002-03-08,Cape Town,South Africa,2002,2,206,247,6,1,472,895,14,266,648,8,33.714285714285715,>30,SA,Home,Upto 2014
PR Adams,SA,Spin,2002-03-15,Durban,South Africa,2002,2,84,132,4,1,268,461,12,184,329,8,22.333333333333332,<=30,SA,Home,Upto 2014
PR Adams,SA,Spin,2003-04-24,Chattogram,Bangladesh,2003,2,106,187,10,1,336,618,11,230,431,1,30.545454545454547,>30,BAN,Away,Upto 2014
PR Adams,SA,Spin,2003-05-01,Dhaka,Bangladesh,2003,2,73,120,2,1,312,727,15,239,607,13,20.8,<=30,BAN,Away,Upto 2014
PR Adams,SA,Spin,2003-07-31,Lord's,England,2003,2,93,139,1,1,235,397,2,142,258,1,117.5,>30,ENG,Away,Upto 2014
PR Adams,SA,Spin,2003-08-14,Nottingham,England,2003,1,46,159,2,1,70,225,2,24,66,0,35.0,>30,ENG,Away,Upto 2014
PR Adams,SA,Spin,2003-09-04,The Oval,England,2003,2,99,120,1,1,289,420,3,190,300,2,96.33333333333333,>30,ENG,Away,Upto 2014
PR Adams,SA,Spin,2003-10-17,Lahore,Pakistan,2003,2,185,336,8,1,515,1054,21,330,718,13,24.523809523809526,<=30,PAK,Away,Upto 2014
PR Adams,SA,Spin,2003-10-24,Faisalabad,Pakistan,2003,2,157,270,2,1,613,1195,9,456,925,7,68.11111111111111,>30,PAK,Away,Upto 2014
PR Adams,SA,Spin,2004-01-02,Cape Town,South Africa,2004,2,173,246,0,1,458,726,4,285,480,4,114.5,>30,SA,Home,Upto 2014
PR Adams,SA,Spin,2004-03-10,Hamilton,New Zealand,2004,2,120,288,2,1,513,956,8,393,668,6,64.125,>30,NZ,Away,Upto 2014
PR George,AUS,Pace,2010-10-09,Bengaluru,India,2010,2,77,168,2,1,635,1166,15,558,998,13,42.333333333333336,>30,IND,Away,Upto 2014
PR Reiffel,AUS,Pace,1992-02-01,W.A.C.A,Australia,1992,2,80,168,2,1,946,1994,34,866,1826,32,27.823529411764707,<=30,AUS,Home,Upto 2014
PR Reiffel,AUS,Pace,1993-02-25,Christchurch,New Zealand,1993,2,86,216,2,1,651,1526,21,565,1310,19,31.0,>30,NZ,Away,Upto 2014
PR Reiffel,AUS,Pace,1993-03-04,Wellington,New Zealand,1993,2,82,234,3,1,647,1552,21,565,1318,18,30.80952380952381,>30,NZ,Away,Upto 2014
PR Reiffel,AUS,Pace,1993-03-12,Auckland,New Zealand,1993,2,82,168,0,1,620,1465,22,538,1297,22,28.181818181818183,<=30,NZ,Away,Upto 2014
PR Reiffel,AUS,Pace,1993-07-22,Leeds,England,1993,2,152,324,8,1,901,1757,18,749,1433,10,50.05555555555556,>30,ENG,Away,Upto 2014
PR Reiffel,AUS,Pace,1993-08-05,Birmingham,England,1993,2,101,203,6,1,389,833,10,288,630,4,38.9,>30,ENG,Away,Upto 2014
PR Reiffel,AUS,Pace,1993-08-19,The Oval,England,1993,2,143,317,5,1,872,1626,33,729,1309,28,26.424242424242426,<=30,ENG,Away,Upto 2014
PR Reiffel,AUS,Pace,1993-11-12,W.A.C.A,Australia,1993,2,100,186,2,1,942,1817,19,842,1631,17,49.578947368421055,>30,AUS,Home,Upto 2014
PR Reiffel,AUS,Pace,1993-11-26,Hobart,Australia,1993,2,41,102,0,1,577,1014,7,536,912,7,82.42857142857143,>30,AUS,Home,Upto 2014
PR Reiffel,AUS,Pace,1993-12-26,Melbourne,Australia,1993,1,55,126,0,1,399,858,6,344,732,6,66.5,>30,AUS,Home,Upto 2014
PR Reiffel,AUS,Pace,1994-01-28,Adelaide,Australia,1994,2,51,156,1,1,661,1638,23,610,1482,22,28.73913043478261,<=30,AUS,Home,Upto 2014
PR Reiffel,AUS,Pace,1994-03-25,Durban,South Africa,1994,1,77,180,2,1,810,2116,20,733,1936,18,40.5,>30,SA,Away,Upto 2014
PR Reiffel,AUS,Pace,1995-03-31,Bridgetown,West Indies,1995,2,56,132,2,1,554,1046,24,498,914,22,23.083333333333332,<=30,WI,Away,Upto 2014
PR Reiffel,AUS,Pace,1995-04-08,St John's,West Indies,1995,2,65,138,4,1,658,1384,24,593,1246,20,27.416666666666668,<=30,WI,Away,Upto 2014
PR Reiffel,AUS,Pace,1995-04-21,Port of Spain,West Indies,1995,2,47,132,2,1,399,876,29,352,744,27,13.758620689655173,<=30,WI,Away,Upto 2014
PR Reiffel,AUS,Pace,1995-04-29,Kingston,West Indies,1995,2,95,190,7,1,658,1221,21,563,1031,14,31.333333333333332,>30,WI,Away,Upto 2014
PR Reiffel,AUS,Pace,1995-11-09,Brisbane,Australia,1995,1,47,90,1,1,520,1074,13,473,984,12,40.0,>30,AUS,Home,Upto 2014
PR Reiffel,AUS,Pace,1995-11-17,Hobart,Australia,1995,2,80,179,7,1,693,1398,29,613,1219,22,23.896551724137932,<=30,AUS,Home,Upto 2014
PR Reiffel,AUS,Pace,1995-11-30,Sydney,Australia,1995,2,86,183,0,1,445,1017,19,359,834,19,23.42105263157895,<=30,AUS,Home,Upto 2014
PR Reiffel,AUS,Pace,1995-12-26,Melbourne,Australia,1995,2,119,240,3,1,608,1377,17,489,1137,14,35.76470588235294,>30,AUS,Home,Upto 2014
PR Reiffel,AUS,Pace,1996-01-25,Adelaide,Australia,1996,2,99,205,6,1,886,1812,32,787,1607,26,27.6875,<=30,AUS,Home,Upto 2014
PR Reiffel,AUS,Pace,1996-10-10,Delhi,India,1996,2,59,138,5,1,274,681,13,215,543,8,21.076923076923077,<=30,IND,Away,Upto 2014
PR Reiffel,AUS,Pace,1996-11-22,Brisbane,Australia,1996,2,116,199,5,1,925,1944,28,809,1745,23,33.035714285714285,>30,AUS,Home,Upto 2014
PR Reiffel,AUS,Pace,1996-12-26,Melbourne,Australia,1996,2,92,228,2,1,553,1299,28,461,1071,26,19.75,<=30,AUS,Home,Upto 2014
PR Reiffel,AUS,Pace,1997-02-01,W.A.C.A,Australia,1997,2,97,186,5,1,699,1242,25,602,1056,20,27.96,<=30,AUS,Home,Upto 2014
PR Reiffel,AUS,Pace,1997-06-19,Lord's,England,1997,2,46,168,2,1,411,849,18,365,681,16,22.833333333333332,<=30,ENG,Away,Upto 2014
PR Reiffel,AUS,Pace,1997-07-03,Manchester,England,1997,2,22,66,0,1,664,1429,26,642,1363,26,25.53846153846154,<=30,ENG,Away,Upto 2014
PR Reiffel,AUS,Pace,1997-07-24,Leeds,England,1997,2,90,247,6,1,800,1403,28,710,1156,22,28.571428571428573,<=30,ENG,Away,Upto 2014
PR Reiffel,AUS,Pace,1997-08-07,Nottingham,England,1997,2,135,192,3,1,974,1617,31,839,1425,28,31.419354838709676,>30,ENG,Away,Upto 2014
PR Reiffel,AUS,Pace,1997-11-07,Brisbane,Australia,1997,2,80,198,2,1,809,1711,25,729,1513,23,32.36,>30,AUS,Home,Upto 2014
PR Reiffel,AUS,Pace,1997-11-20,W.A.C.A,Australia,1997,2,72,192,2,1,605,1158,21,533,966,19,28.80952380952381,<=30,AUS,Home,Upto 2014
PR Reiffel,AUS,Pace,1997-11-27,Hobart,Australia,1997,2,74,168,4,1,691,1411,18,617,1243,14,38.388888888888886,>30,AUS,Home,Upto 2014
PR Reiffel,AUS,Pace,1997-12-26,Melbourne,Australia,1997,2,56,192,2,1,627,1621,23,571,1429,21,27.26086956521739,<=30,AUS,Home,Upto 2014
PR Reiffel,AUS,Pace,1998-01-02,Sydney,Australia,1998,2,62,216,3,1,405,1054,13,343,838,10,31.153846153846153,>30,AUS,Home,Upto 2014
PR Reiffel,AUS,Pace,1998-03-06,Chennai,India,1998,2,59,144,0,1,310,705,5,251,561,5,62.0,>30,IND,Away,Upto 2014
PR Sleep,AUS,Spin,1979-03-10,Melbourne,Australia,1979,2,78,127,2,1,258,519,6,180,392,4,43.0,>30,AUS,Home,Upto 2014
PR Sleep,AUS,Spin,1979-10-13,Delhi,India,1979,1,66,78,0,1,604,1308,12,538,1230,12,50.333333333333336,>30,IND,Away,Upto 2014
PR Sleep,AUS,Spin,1979-11-03,Wankhede,India,1979,1,79,168,0,1,457,1061,17,378,893,17,26.88235294117647,<=30,IND,Away,Upto 2014
PR Sleep,AUS,Spin,1982-09-30,Faisalabad,Pakistan,1982,1,158,216,1,1,662,1534,17,504,1318,16,38.94117647058823,>30,PAK,Away,Upto 2014
PR Sleep,AUS,Spin,1986-12-12,Adelaide,Australia,1986,2,132,312,4,1,609,1398,9,477,1086,5,67.66666666666667,>30,AUS,Home,Upto 2014
PR Sleep,AUS,Spin,1986-12-26,Melbourne,Australia,1986,1,65,168,1,1,169,430,6,104,262,5,28.166666666666668,<=30,AUS,Home,Upto 2014
PR Sleep,AUS,Spin,1987-01-10,Sydney,Australia,1987,2,119,336,5,1,596,1662,26,477,1326,21,22.923076923076923,<=30,AUS,Home,Upto 2014
PR Sleep,AUS,Spin,1987-12-04,Brisbane,Australia,1987,2,34,120,0,1,142,366,3,108,246,3,47.333333333333336,>30,AUS,Home,Upto 2014
PR Sleep,AUS,Spin,1987-12-11,Adelaide,Australia,1987,2,170,396,4,1,613,1530,11,443,1134,7,55.72727272727273,>30,AUS,Home,Upto 2014
PR Sleep,AUS,Spin,1987-12-26,Melbourne,Australia,1987,2,138,228,3,1,311,684,6,173,456,3,51.833333333333336,>30,AUS,Home,Upto 2014
PR Sleep,AUS,Spin,1988-01-29,Sydney,Australia,1988,1,114,270,2,1,513,1326,10,399,1056,8,51.3,>30,AUS,Home,Upto 2014
PR Sleep,AUS,Spin,1988-09-23,Faisalabad,Pakistan,1988,2,75,113,2,1,520,1112,15,445,999,13,34.666666666666664,>30,PAK,Away,Upto 2014
PR Sleep,AUS,Spin,1989-12-16,Hobart,Australia,1989,2,99,276,5,1,264,618,8,165,342,3,33.0,>30,AUS,Home,Upto 2014
PR Sleep,AUS,Spin,1990-01-12,Melbourne,Australia,1990,2,70,174,2,1,153,318,3,83,144,1,51.0,>30,AUS,Home,Upto 2014
PR Stirling,IRE,Spin,2018-05-11,Dublin (Malahide),Ireland,2018,1,11,12,0,1,106,282,4,95,270,4,26.5,<=30,IRE,Home,After 1965
PR Umrigar,IND,Spin,1948-12-09,Brabourne,India,1948,1,51,90,0,1,780,1868,11,729,1778,11,70.9090909090909,>30,IND,Home,Upto 2014
PR Umrigar,IND,Spin,1951-11-02,Delhi,India,1951,1,8,36,0,1,589,1935,18,581,1899,18,32.72222222222222,>30,IND,Home,Upto 2014
PR Umrigar,IND,Spin,1951-12-14,Brabourne,India,1951,1,3,18,0,1,561,1297,11,558,1279,11,51.0,>30,IND,Home,Upto 2014
PR Umrigar,IND,Spin,1951-12-30,Eden Gardens,India,1951,1,12,24,0,1,698,1841,19,686,1817,19,36.73684210526316,>30,IND,Home,Upto 2014
PR Umrigar,IND,Spin,1952-06-19,Lord's,England,1952,1,15,24,0,1,669,1629,14,654,1605,14,47.785714285714285,>30,ENG,Away,Upto 2014
PR Umrigar,IND,Spin,1952-10-23,Lucknow,India,1952,1,1,6,0,1,185,666,5,184,660,5,37.0,>30,IND,Home,Upto 2014
PR Umrigar,IND,Spin,1953-01-21,Port of Spain,West Indies,1953,1,14,12,0,1,842,2177,19,828,2165,19,44.31578947368421,>30,WI,Away,Upto 2014
PR Umrigar,IND,Spin,1955-01-01,Dhaka,Bangladesh,1955,1,17,90,0,1,438,1378,15,421,1288,15,29.2,<=30,BAN,Away,Upto 2014
PR Umrigar,IND,Spin,1955-01-15,Bahawalpur,Pakistan,1955,1,74,348,6,1,306,1050,8,232,702,2,38.25,>30,PAK,Away,Upto 2014
PR Umrigar,IND,Spin,1955-01-29,Lahore,Pakistan,1955,1,23,84,0,1,591,2024,18,568,1940,18,32.833333333333336,>30,PAK,Away,Upto 2014
PR Umrigar,IND,Spin,1955-02-26,Karachi,Pakistan,1955,2,68,192,2,1,327,894,7,259,702,5,46.714285714285715,>30,PAK,Away,Upto 2014
PR Umrigar,IND,Spin,1955-11-19,Hyderabad (Deccan),India,1955,1,0,24,0,1,665,1888,11,665,1864,11,60.45454545454545,>30,IND,Home,Upto 2014
PR Umrigar,IND,Spin,1955-12-28,Eden Gardens,India,1955,1,21,102,0,1,462,1292,19,441,1190,19,24.31578947368421,<=30,IND,Home,Upto 2014
PR Umrigar,IND,Spin,1956-10-19,Chennai,India,1956,1,17,24,0,1,458,1218,19,441,1194,19,24.105263157894736,<=30,IND,Home,Upto 2014
PR Umrigar,IND,Spin,1956-11-02,Eden Gardens,India,1956,2,51,216,0,1,552,1533,35,501,1317,35,15.771428571428572,<=30,IND,Home,Upto 2014
PR Umrigar,IND,Spin,1958-11-28,Brabourne,India,1958,2,34,72,0,1,512,1219,9,478,1147,9,56.888888888888886,>30,IND,Home,Upto 2014
PR Umrigar,IND,Spin,1958-12-12,Kanpur,India,1958,1,96,168,1,1,669,1431,13,573,1263,12,51.46153846153846,>30,IND,Home,Upto 2014
PR Umrigar,IND,Spin,1958-12-31,Eden Gardens,India,1958,1,62,96,1,1,513,906,7,451,810,6,73.28571428571429,>30,IND,Home,Upto 2014
PR Umrigar,IND,Spin,1959-01-21,Chennai,India,1959,2,41,114,0,1,586,1441,19,545,1327,19,30.842105263157894,>30,IND,Home,Upto 2014
PR Umrigar,IND,Spin,1959-06-18,Lord's,England,1959,2,8,12,0,1,208,491,11,200,479,11,18.90909090909091,<=30,ENG,Away,Upto 2014
PR Umrigar,IND,Spin,1959-07-02,Leeds,England,1959,1,44,144,0,1,383,883,14,339,739,14,27.357142857142858,<=30,ENG,Away,Upto 2014
PR Umrigar,IND,Spin,1959-07-23,Manchester,England,1959,2,51,156,0,1,721,1722,21,670,1566,21,34.333333333333336,>30,ENG,Away,Upto 2014
PR Umrigar,IND,Spin,1959-12-12,Delhi,India,1959,1,49,93,4,1,348,919,18,299,826,14,19.333333333333332,<=30,IND,Home,Upto 2014
PR Umrigar,IND,Spin,1959-12-19,Kanpur,India,1959,2,67,240,4,1,496,1305,26,429,1065,22,19.076923076923077,<=30,IND,Home,Upto 2014
PR Umrigar,IND,Spin,1960-01-01,Brabourne,India,1960,1,19,48,0,1,351,876,9,332,828,9,39.0,>30,IND,Home,Upto 2014
PR Umrigar,IND,Spin,1960-12-02,Brabourne,India,1960,1,46,102,0,1,412,1324,9,366,1222,9,45.77777777777778,>30,IND,Home,Upto 2014
PR Umrigar,IND,Spin,1960-12-16,Kanpur,India,1960,2,81,348,4,1,619,1984,16,538,1636,12,38.6875,>30,IND,Home,Upto 2014
PR Umrigar,IND,Spin,1960-12-30,Eden Gardens,India,1960,2,29,78,0,1,295,842,11,266,764,11,26.818181818181817,<=30,IND,Home,Upto 2014
PR Umrigar,IND,Spin,1961-01-13,Chennai,India,1961,1,64,318,2,1,664,1638,11,600,1320,9,60.36363636363637,>30,IND,Home,Upto 2014
PR Umrigar,IND,Spin,1961-02-08,Delhi,India,1961,2,22,48,0,1,386,1389,14,364,1341,14,27.571428571428573,<=30,IND,Home,Upto 2014
PR Umrigar,IND,Spin,1961-12-01,Kanpur,India,1961,2,64,150,0,1,792,2016,16,728,1866,16,49.5,>30,IND,Home,Upto 2014
PR Umrigar,IND,Spin,1961-12-13,Delhi,India,1961,1,3,24,0,1,505,1242,8,502,1218,8,63.125,>30,IND,Home,Upto 2014
PR Umrigar,IND,Spin,1961-12-30,Eden Gardens,India,1961,1,46,180,2,1,632,1788,29,586,1608,27,21.79310344827586,<=30,IND,Home,Upto 2014
PR Umrigar,IND,Spin,1962-01-10,Chennai,India,1962,2,23,108,0,1,866,2320,33,843,2212,33,26.242424242424242,<=30,IND,Home,Upto 2014
PR Umrigar,IND,Spin,1962-02-16,Port of Spain,West Indies,1962,1,77,210,2,1,339,916,17,262,706,15,19.941176470588236,<=30,WI,Away,Upto 2014
PR Umrigar,IND,Spin,1962-03-23,Bridgetown,West Indies,1962,1,48,294,2,1,596,2431,22,548,2137,20,27.09090909090909,<=30,WI,Away,Upto 2014
PR Umrigar,IND,Spin,1962-04-04,Port of Spain,West Indies,1962,2,124,432,5,1,911,2452,24,787,2020,19,37.958333333333336,>30,WI,Away,Upto 2014
PS Heine,SA,Pace,1955-06-23,Lord's,England,1955,2,147,324,6,1,632,1622,27,485,1298,21,23.40740740740741,<=30,ENG,Away,Upto 2014
PS Heine,SA,Pace,1955-07-07,Manchester,England,1955,2,157,336,8,1,835,1929,28,678,1593,20,29.821428571428573,<=30,ENG,Away,Upto 2014
PS Heine,SA,Pace,1955-07-21,Leeds,England,1955,2,103,263,4,1,618,1800,24,515,1537,20,25.75,<=30,ENG,Away,Upto 2014
PS Heine,SA,Pace,1955-08-13,The Oval,England,1955,2,87,276,3,1,283,1030,15,196,754,12,18.866666666666667,<=30,ENG,Away,Upto 2014
PS Heine,SA,Pace,1956-12-24,Johannesburg,South Africa,1956,2,130,400,5,1,465,1730,29,335,1330,24,16.03448275862069,<=30,SA,Home,Upto 2014
PS Heine,SA,Pace,1957-01-01,Cape Town,South Africa,1957,2,145,320,3,1,496,1551,13,351,1231,10,38.15384615384615,>30,SA,Home,Upto 2014
PS Heine,SA,Pace,1957-01-25,Durban,South Africa,1957,2,123,304,3,1,495,1563,15,372,1259,12,33.0,>30,SA,Home,Upto 2014
PS Heine,SA,Pace,1957-02-15,Johannesburg,South Africa,1957,2,75,248,2,1,520,1730,17,445,1482,15,30.58823529411765,>30,SA,Home,Upto 2014
PS Heine,SA,Pace,1957-03-01,Gqeberha,South Africa,1957,2,44,208,5,1,275,1498,30,231,1290,25,9.166666666666666,<=30,SA,Home,Upto 2014
PS Heine,SA,Pace,1957-12-23,Johannesburg,South Africa,1957,2,75,178,6,1,682,1716,24,607,1538,18,28.416666666666668,<=30,SA,Home,Upto 2014
PS Heine,SA,Pace,1958-01-24,Durban,South Africa,1958,2,70,252,2,1,460,1804,17,390,1552,15,27.058823529411764,<=30,SA,Home,Upto 2014
PS Heine,SA,Pace,1958-02-07,Johannesburg,South Africa,1958,1,96,301,6,1,425,1453,14,329,1152,8,30.357142857142858,>30,SA,Home,Upto 2014
PS Heine,SA,Pace,1958-02-28,Gqeberha,South Africa,1958,2,80,264,3,1,429,1409,18,349,1145,15,23.833333333333332,<=30,SA,Home,Upto 2014
PS Heine,SA,Pace,1962-02-02,Johannesburg,South Africa,1962,2,123,216,2,1,533,1091,23,410,875,21,23.17391304347826,<=30,SA,Home,Upto 2014
PS Masvaure,ZIM,Pace,2016-07-28,Bulawayo,Zimbabwe,2016,1,38,60,0,1,542,1115,20,504,1055,20,27.1,<=30,ZIM,Home,After 1965
PS Masvaure,ZIM,Pace,2016-08-06,Bulawayo,Zimbabwe,2016,1,23,24,0,1,578,1230,11,555,1206,11,52.54545454545455,>30,ZIM,Home,After 1965
PS McDonnell,AUS,Spin,1880-09-06,The Oval,England,1880,1,11,8,0,1,721,1528,21,710,1520,21,34.333333333333336,>30,ENG,Away,After 1965
PS McDonnell,AUS,Spin,1881-12-31,Melbourne,Australia,1881,1,15,16,0,1,812,2321,24,797,2305,24,33.833333333333336,>30,AUS,Home,After 1965
PS McDonnell,AUS,Spin,1883-01-26,Sydney,Australia,1883,1,16,16,0,1,194,600,10,178,584,10,19.4,<=30,AUS,Home,After 1965
PS McDonnell,AUS,Spin,1884-12-12,Adelaide,Australia,1884,1,11,12,0,1,511,1330,22,500,1318,22,23.227272727272727,<=30,AUS,Home,After 1965
PS de Villiers,SA,Pace,1993-12-26,Melbourne,Australia,1993,1,83,192,1,1,399,858,6,316,666,5,66.5,>30,AUS,Away,Upto 2014
PS de Villiers,SA,Pace,1994-01-02,Sydney,Australia,1994,2,123,357,10,1,459,1326,25,336,969,15,18.36,<=30,AUS,Away,Upto 2014
PS de Villiers,SA,Pace,1994-01-28,Adelaide,Australia,1994,1,105,246,0,1,661,1638,23,556,1392,23,28.73913043478261,<=30,AUS,Away,Upto 2014
PS de Villiers,SA,Pace,1994-03-04,Johannesburg,South Africa,1994,2,144,297,4,1,852,1646,28,708,1349,24,30.428571428571427,>30,SA,Home,Upto 2014
PS de Villiers,SA,Pace,1994-03-17,Cape Town,South Africa,1994,2,137,304,4,1,830,1910,22,693,1606,18,37.72727272727273,>30,SA,Home,Upto 2014
PS de Villiers,SA,Pace,1994-03-25,Durban,South Africa,1994,2,124,290,3,1,810,2116,20,686,1826,17,40.5,>30,SA,Home,Upto 2014
PS de Villiers,SA,Pace,1994-07-21,Lord's,England,1994,2,54,168,4,1,636,1408,31,582,1240,27,20.516129032258064,<=30,ENG,Away,Upto 2014
PS de Villiers,SA,Pace,1994-08-04,Leeds,England,1994,2,206,387,4,1,1145,2209,21,939,1822,17,54.523809523809526,>30,ENG,Away,Upto 2014
PS de Villiers,SA,Pace,1994-08-18,The Oval,England,1994,2,128,186,4,1,962,1490,30,834,1304,26,32.06666666666667,>30,ENG,Away,Upto 2014
PS de Villiers,SA,Pace,1994-11-25,Johannesburg,South Africa,1994,2,130,342,6,1,787,1709,30,657,1367,24,26.233333333333334,<=30,SA,Home,Upto 2014
PS de Villiers,SA,Pace,1994-12-26,Durban,South Africa,1994,2,120,332,8,1,610,1681,28,490,1349,20,21.785714285714285,<=30,SA,Home,Upto 2014
PS de Villiers,SA,Pace,1995-01-02,Cape Town,South Africa,1995,2,151,342,6,1,639,1598,22,488,1256,16,29.045454545454547,<=30,SA,Home,Upto 2014
PS de Villiers,SA,Pace,1995-01-19,Johannesburg,South Africa,1995,2,108,242,10,1,915,1724,33,807,1482,23,27.727272727272727,<=30,SA,Home,Upto 2014
PS de Villiers,SA,Pace,1995-03-04,Auckland,New Zealand,1995,2,120,324,6,1,789,1800,31,669,1476,25,25.451612903225808,<=30,NZ,Away,Upto 2014
PS de Villiers,SA,Pace,1996-11-20,Ahmedabad,India,1996,2,100,210,3,1,335,936,19,235,726,16,17.63157894736842,<=30,IND,Away,Upto 2014
PS de Villiers,SA,Pace,1996-12-08,Kanpur,India,1996,2,76,234,2,1,443,1201,16,367,967,14,27.6875,<=30,IND,Away,Upto 2014
PS de Villiers,SA,Pace,1998-02-26,Durban,South Africa,1998,2,106,204,2,1,733,1519,29,627,1315,27,25.275862068965516,<=30,SA,Home,Upto 2014
PS de Villiers,SA,Pace,1998-03-06,Gqeberha,South Africa,1998,2,48,148,8,1,625,1400,33,577,1252,25,18.939393939393938,<=30,SA,Home,Upto 2014
PT Collins,WI,Pace,1999-03-05,Port of Spain,West Indies,1999,2,118,264,3,1,566,1392,32,448,1128,29,17.6875,<=30,WI,Home,Upto 2014
PT Collins,WI,Pace,1999-03-13,Kingston,West Indies,1999,2,103,147,3,1,494,1032,18,391,885,15,27.444444444444443,<=30,WI,Home,Upto 2014
PT Collins,WI,Pace,1999-03-26,Bridgetown,West Indies,1999,2,141,267,2,1,815,1748,29,674,1481,27,28.103448275862068,<=30,WI,Home,Upto 2014
PT Collins,WI,Pace,2001-07-19,Bulawayo,Zimbabwe,2001,2,76,159,2,1,603,1276,18,527,1117,16,33.5,>30,ZIM,Away,Upto 2014
PT Collins,WI,Pace,2001-11-21,Kandy,Sri Lanka,2001,2,130,228,4,1,410,847,17,280,619,13,24.11764705882353,<=30,SL,Away,Upto 2014
PT Collins,WI,Pace,2001-11-29,Colombo (SSC),Sri Lanka,2001,2,171,297,3,1,728,1313,22,557,1016,19,33.09090909090909,>30,SL,Away,Upto 2014
PT Collins,WI,Pace,2002-01-31,Sharjah,UAE,2002,2,152,286,1,1,822,1590,24,670,1304,23,34.25,>30,UAE,Away,Upto 2014
PT Collins,WI,Pace,2002-02-07,Sharjah,UAE,2002,2,155,264,2,1,615,1212,24,460,948,22,25.625,<=30,UAE,Away,Upto 2014
PT Collins,WI,Pace,2002-05-02,Bridgetown,West Indies,2002,2,102,180,2,1,655,1356,22,553,1176,20,29.772727272727273,<=30,WI,Home,Upto 2014
PT Collins,WI,Pace,2002-05-10,St John's,West Indies,2002,1,125,264,3,1,856,1992,11,731,1728,8,77.81818181818181,>30,WI,Home,Upto 2014
PT Collins,WI,Pace,2002-05-18,Kingston,West Indies,2002,2,114,216,4,1,844,1737,30,730,1521,26,28.133333333333333,<=30,WI,Home,Upto 2014
PT Collins,WI,Pace,2002-06-21,Bridgetown,West Indies,2002,2,156,328,8,1,787,1616,30,631,1288,22,26.233333333333334,<=30,WI,Home,Upto 2014
PT Collins,WI,Pace,2002-06-28,St George's,West Indies,2002,2,96,282,4,1,623,1356,15,527,1074,11,41.53333333333333,>30,WI,Home,Upto 2014
PT Collins,WI,Pace,2002-10-09,Wankhede,India,2002,1,76,168,0,1,351,798,10,275,630,10,35.1,>30,IND,Away,Upto 2014
PT Collins,WI,Pace,2002-10-17,Chennai,India,2002,2,66,150,1,1,288,754,13,222,604,12,22.153846153846153,<=30,IND,Away,Upto 2014
PT Collins,WI,Pace,2002-12-08,Dhaka,Bangladesh,2002,2,56,157,6,1,465,906,25,409,749,19,18.6,<=30,BAN,Away,Upto 2014
PT Collins,WI,Pace,2002-12-16,Chattogram,Bangladesh,2002,2,118,235,6,1,655,1306,30,537,1071,24,21.833333333333332,<=30,BAN,Away,Upto 2014
PT Collins,WI,Pace,2003-04-10,Georgetown,West Indies,2003,2,110,174,1,1,811,1248,21,701,1074,20,38.61904761904762,>30,WI,Home,Upto 2014
PT Collins,WI,Pace,2003-04-19,Port of Spain,West Indies,2003,2,153,192,0,1,913,1617,20,760,1425,20,45.65,>30,WI,Home,Upto 2014
PT Collins,WI,Pace,2004-03-19,Port of Spain,West Indies,2004,2,96,198,4,1,720,1489,29,624,1291,25,24.82758620689655,<=30,WI,Home,Upto 2014
PT Collins,WI,Pace,2004-04-01,Bridgetown,West Indies,2004,2,76,162,3,1,550,1209,31,474,1047,28,17.741935483870968,<=30,WI,Home,Upto 2014
PT Collins,WI,Pace,2004-04-10,St John's,West Indies,2004,2,110,204,4,1,955,1635,13,845,1431,9,73.46153846153847,>30,WI,Home,Upto 2014
PT Collins,WI,Pace,2004-05-28,Gros Islet,West Indies,2004,2,125,267,5,1,821,1459,16,696,1192,11,51.3125,>30,WI,Home,Upto 2014
PT Collins,WI,Pace,2004-06-04,Kingston,West Indies,2004,2,117,222,9,1,592,1032,15,475,810,6,39.46666666666667,>30,WI,Home,Upto 2014
PT Collins,WI,Pace,2004-07-22,Lord's,England,2004,2,175,232,7,1,966,1493,22,791,1261,15,43.90909090909091,>30,ENG,Away,Upto 2014
PT Collins,WI,Pace,2004-07-29,Birmingham,England,2004,2,119,162,1,1,971,1389,23,852,1227,22,42.21739130434783,>30,ENG,Away,Upto 2014
PT Collins,WI,Pace,2004-08-12,Manchester,England,2004,2,53,110,2,1,785,1467,28,732,1357,26,28.035714285714285,<=30,ENG,Away,Upto 2014
PT Collins,WI,Pace,2005-03-31,Georgetown,West Indies,2005,2,83,252,4,1,687,1530,15,604,1278,11,45.8,>30,WI,Home,Upto 2014
PT Collins,WI,Pace,2005-04-08,Port of Spain,West Indies,2005,2,105,198,2,1,854,1820,25,749,1622,23,34.16,>30,WI,Home,Upto 2014
PT Collins,WI,Pace,2006-06-10,Gros Islet,West Indies,2006,1,116,168,4,1,597,938,8,481,770,4,74.625,>30,WI,Home,Upto 2014
PT Collins,WI,Pace,2006-06-22,Basseterre,West Indies,2006,2,183,285,4,1,636,1116,17,453,831,13,37.411764705882355,>30,WI,Home,Upto 2014
PT Collins,WI,Pace,2006-06-30,Kingston,West Indies,2006,2,95,246,2,1,405,1019,25,310,773,23,16.2,<=30,WI,Home,Upto 2014
PV Simmons,WI,Pace,1991-07-25,Birmingham,England,1991,1,7,18,0,1,722,1721,32,715,1703,32,22.5625,<=30,ENG,Away,Upto 2014
PV Simmons,WI,Pace,1992-04-18,Bridgetown,West Indies,1992,1,13,30,0,1,919,1991,34,906,1961,34,27.029411764705884,<=30,WI,Home,Upto 2014
PV Simmons,WI,Pace,1992-11-27,Brisbane,Australia,1992,2,21,48,0,1,859,1899,30,838,1851,30,28.633333333333333,<=30,AUS,Away,Upto 2014
PV Simmons,WI,Pace,1992-12-26,Melbourne,Australia,1992,2,57,168,2,1,743,1849,31,686,1681,29,23.967741935483872,<=30,AUS,Away,Upto 2014
PV Simmons,WI,Pace,1993-01-02,Sydney,Australia,1993,2,34,78,0,1,568,1162,8,534,1084,8,71.0,>30,AUS,Away,Upto 2014
PV Simmons,WI,Pace,1993-04-16,Port of Spain,West Indies,1993,1,5,6,0,1,566,1117,30,561,1111,30,18.866666666666667,<=30,WI,Home,Upto 2014
PV Simmons,WI,Pace,1993-05-01,St John's,West Indies,1993,1,17,30,0,1,577,1130,21,560,1100,21,27.476190476190474,<=30,WI,Home,Upto 2014
PV Simmons,WI,Pace,1994-02-19,Kingston,West Indies,1994,1,4,18,0,1,877,1820,28,873,1802,28,31.321428571428573,>30,WI,Home,Upto 2014
PV Simmons,WI,Pace,1996-04-19,Bridgetown,West Indies,1996,1,11,18,0,1,918,1755,25,907,1737,25,36.72,>30,WI,Home,Upto 2014
PV Simmons,WI,Pace,1996-04-27,St John's,West Indies,1996,1,12,60,1,1,915,1920,26,903,1860,25,35.19230769230769,>30,WI,Home,Upto 2014
PV Simmons,WI,Pace,1997-02-01,W.A.C.A,Australia,1997,2,67,138,1,1,699,1242,25,632,1104,24,27.96,<=30,AUS,Away,Upto 2014
PV Simmons,WI,Pace,1997-11-17,Peshawar,Pakistan,1997,1,9,12,0,1,444,1004,18,435,992,18,24.666666666666668,<=30,PAK,Away,Upto 2014
PVD Chameera,SL,Pace,2015-06-25,Colombo (PSS),Sri Lanka,2015,2,86,173,4,1,390,800,14,304,627,10,27.857142857142858,<=30,SL,Home,After 1965
PVD Chameera,SL,Pace,2015-08-20,Colombo (PSS),Sri Lanka,2015,2,135,204,2,1,525,996,16,390,792,14,32.8125,>30,SL,Home,After 1965
PVD Chameera,SL,Pace,2015-12-10,Dunedin,New Zealand,2015,2,173,204,3,1,942,1677,26,769,1473,23,36.23076923076923,>30,NZ,Away,After 1965
PVD Chameera,SL,Pace,2015-12-18,Hamilton,New Zealand,2015,2,115,180,9,1,667,1250,30,552,1070,21,22.233333333333334,<=30,NZ,Away,After 1965
PVD Chameera,SL,Pace,2016-05-19,Leeds,England,2016,1,64,102,3,1,468,901,27,404,799,24,17.333333333333332,<=30,ENG,Away,After 1965
PVD Chameera,SL,Pace,2016-12-26,Gqeberha,South Africa,2016,2,153,174,1,1,798,1468,25,645,1294,24,31.92,>30,SA,Away,After 1965
PVD Chameera,SL,Pace,2018-12-26,Christchurch,New Zealand,2018,2,190,228,1,1,838,1658,30,648,1430,29,27.933333333333334,<=30,NZ,Away,After 1965
PVD Chameera,SL,Pace,2019-01-24,Brisbane,Australia,2019,1,68,126,1,1,398,892,24,330,766,23,16.583333333333332,<=30,AUS,Away,After 1965
PVD Chameera,SL,Pace,2021-01-03,Johannesburg,South Africa,2021,1,53,84,1,1,660,1080,30,607,996,29,22.0,<=30,SA,Away,After 1965
PVD Chameera,SL,Pace,2021-03-21,North Sound,West Indies,2021,2,115,240,2,1,742,1672,25,627,1432,23,29.68,<=30,WI,Away,After 1965
PVD Chameera,SL,Pace,2021-03-29,North Sound,West Indies,2021,2,143,235,5,1,742,1513,23,599,1278,18,32.26086956521739,>30,WI,Away,After 1965
PVD Chameera,SL,Pace,2021-11-21,Galle,Sri Lanka,2021,2,26,72,0,1,180,408,3,154,336,3,60.0,>30,SL,Home,After 1965
PW Hasaranga,SL,Spin,2020-12-26,Centurion,South Africa,2020,1,171,270,4,1,312,480,4,141,210,0,78.0,>30,SA,Away,After 1965
PW Hasaranga,SL,Spin,2021-01-03,Johannesburg,South Africa,2021,2,39,38,0,1,39,38,0,0,0,0,inf,>30,SA,Away,After 1965
PW Hasaranga,SL,Spin,2021-01-14,Galle,Sri Lanka,2021,2,67,96,0,1,751,1413,23,684,1317,23,32.65217391304348,>30,SL,Home,After 1965
PW Hasaranga,SL,Spin,2021-04-21,Pallekele,Sri Lanka,2021,2,126,270,0,1,649,1170,4,523,900,4,162.25,>30,SL,Home,After 1965
PW Jarvis,ENG,Pace,1988-02-12,Christchurch,New Zealand,1988,2,73,228,3,1,693,1999,33,620,1771,30,21.0,<=30,NZ,Away,Upto 2014
PW Jarvis,ENG,Pace,1988-02-25,Auckland,New Zealand,1988,2,128,360,3,1,724,1989,22,596,1629,19,32.90909090909091,>30,NZ,Away,Upto 2014
PW Jarvis,ENG,Pace,1988-06-02,Nottingham,England,1988,1,63,109,2,1,781,1741,19,718,1632,17,41.10526315789474,>30,ENG,Home,Upto 2014
PW Jarvis,ENG,Pace,1988-06-16,Lord's,England,1988,2,154,234,4,1,943,1804,37,789,1570,33,25.486486486486488,<=30,ENG,Home,Upto 2014
PW Jarvis,ENG,Pace,1989-06-22,Lord's,England,1989,2,188,242,1,1,1092,2047,30,904,1805,29,36.4,>30,ENG,Home,Upto 2014
PW Jarvis,ENG,Pace,1989-07-06,Birmingham,England,1989,2,102,174,1,1,670,1413,17,568,1239,16,39.411764705882355,>30,ENG,Home,Upto 2014
PW Jarvis,ENG,Pace,1993-01-29,Eden Gardens,India,1993,2,95,194,2,1,387,856,9,292,662,7,43.0,>30,IND,Away,Upto 2014
PW Jarvis,ENG,Pace,1993-02-11,Chennai,India,1993,1,72,168,2,1,257,522,5,185,354,3,51.4,>30,IND,Away,Upto 2014
PW Jarvis,ENG,Pace,1993-03-13,Colombo (SSC),Sri Lanka,1993,2,90,203,3,1,382,857,11,292,654,8,34.72727272727273,>30,SL,Away,Upto 2014
PWA Mulder,SA,Pace,2019-02-21,Gqeberha,South Africa,2019,2,12,42,1,1,552,954,24,540,912,23,23.0,<=30,SA,Home,After 1965
PWA Mulder,SA,Pace,2020-12-26,Centurion,South Africa,2020,2,108,192,5,1,827,1226,23,719,1034,18,35.95652173913044,>30,SA,Home,After 1965
PWA Mulder,SA,Pace,2021-01-03,Johannesburg,South Africa,2021,2,77,120,4,1,660,1080,30,583,960,26,22.0,<=30,SA,Home,After 1965
PWA Mulder,SA,Pace,2021-02-04,Rawalpindi,Pakistan,2021,2,56,144,1,1,534,1105,24,478,961,23,22.25,<=30,PAK,Away,After 1965
PWA Mulder,SA,Pace,2021-06-10,Gros Islet,West Indies,2021,2,27,48,0,1,458,958,27,431,910,27,16.962962962962962,<=30,WI,Away,After 1965
PWA Mulder,SA,Pace,2021-06-18,Gros Islet,West Indies,2021,2,15,48,3,1,606,1318,31,591,1270,28,19.548387096774192,<=30,WI,Away,After 1965
PWA Mulder,SA,Pace,2021-12-26,Centurion,South Africa,2021,2,74,174,0,1,741,1479,38,667,1305,38,19.5,<=30,SA,Home,After 1965
PWA Mulder,SA,Pace,2022-02-25,Christchurch,New Zealand,2022,2,47,78,0,1,1098,2154,35,1051,2076,35,31.37142857142857,>30,NZ,Away,After 1965
PWA Mulder,SA,Pace,2022-03-31,Durban,South Africa,2022,1,23,24,1,1,457,911,16,434,887,15,28.5625,<=30,SA,Home,After 1965
PWA Mulder,SA,Pace,2022-04-08,Gqeberha,South Africa,2022,1,25,78,3,1,403,672,9,378,594,6,44.77777777777778,>30,SA,Home,After 1965
PWA Mulder,SA,Pace,2022-09-08,The Oval,England,2022,1,11,12,0,1,547,897,31,536,885,31,17.64516129032258,<=30,ENG,Away,After 1965
PWA Mulder,SA,Pace,2023-03-08,Johannesburg,South Africa,2023,1,40,90,1,1,575,1146,28,535,1056,27,20.535714285714285,<=30,SA,Home,After 1965
PWA Mulder,SA,Pace,2024-08-07,Port of Spain,West Indies,2024,2,43,84,0,1,444,843,12,401,759,12,37.0,>30,WI,Away,After 1965
PWA Mulder,SA,Pace,2024-08-15,Providence,West Indies,2024,2,67,138,6,1,482,1012,28,415,874,22,17.214285714285715,<=30,WI,Away,After 1965
PWA Mulder,SA,Pace,2024-10-21,Mirpur,Bangladesh,2024,2,62,126,4,1,212,443,16,150,317,12,13.25,<=30,BAN,Away,After 1965
PWA Mulder,SA,Pace,2024-10-29,Chattogram,Bangladesh,2024,2,10,24,0,1,267,480,9,257,456,9,29.666666666666668,<=30,BAN,Away,After 1965
PWA Mulder,SA,Pace,2025-01-03,Cape Town,South Africa,2025,2,82,138,1,1,862,1222,17,780,1084,16,50.705882352941174,>30,SA,Home,After 1965
Pankaj Singh,IND,Pace,2014-07-27,Southampton,England,2014,2,179,282,0,1,815,1573,15,636,1291,15,54.333333333333336,>30,ENG,Away,After 1965
Pankaj Singh,IND,Pace,2014-08-07,Manchester,England,2014,1,113,168,2,1,546,928,23,433,760,21,23.73913043478261,<=30,ENG,Away,After 1965
Pervez Sajjad,PAK,Spin,1964-10-24,Karachi,Pakistan,1964,2,69,180,1,1,840,2130,18,771,1950,17,46.666666666666664,>30,PAK,Home,Upto 2014
Pervez Sajjad,PAK,Spin,1965-01-22,Wellington,New Zealand,1965,2,109,294,3,1,356,1080,8,247,786,5,44.5,>30,NZ,Away,Upto 2014
Pervez Sajjad,PAK,Spin,1965-01-29,Auckland,New Zealand,1965,2,77,240,6,1,450,1734,24,373,1494,18,18.75,<=30,NZ,Away,Upto 2014
Pervez Sajjad,PAK,Spin,1965-02-12,Christchurch,New Zealand,1965,2,86,252,3,1,466,1098,16,380,846,13,29.125,<=30,NZ,Away,Upto 2014
Pervez Sajjad,PAK,Spin,1965-03-27,Rawalpindi,Pakistan,1965,2,47,168,8,1,362,890,18,315,722,10,20.11111111111111,<=30,PAK,Home,Upto 2014
Pervez Sajjad,PAK,Spin,1965-04-02,Lahore,Pakistan,1965,1,72,258,0,1,697,1836,15,625,1578,15,46.46666666666667,>30,PAK,Home,Upto 2014
Pervez Sajjad,PAK,Spin,1965-04-09,Karachi,Pakistan,1965,2,45,114,1,1,606,1528,19,561,1414,18,31.894736842105264,>30,PAK,Home,Upto 2014
Pervez Sajjad,PAK,Spin,1969-02-28,Dhaka,Bangladesh,1969,2,76,240,4,1,397,1246,15,321,1006,11,26.466666666666665,<=30,BAN,Away,Upto 2014
Pervez Sajjad,PAK,Spin,1969-10-24,Karachi,Pakistan,1969,2,104,330,7,1,665,1813,26,561,1483,19,25.576923076923077,<=30,PAK,Home,Upto 2014
Pervez Sajjad,PAK,Spin,1969-10-30,Lahore,Pakistan,1969,2,112,324,9,1,434,1339,23,322,1015,14,18.869565217391305,<=30,PAK,Home,Upto 2014
Pervez Sajjad,PAK,Spin,1969-11-08,Dhaka,Bangladesh,1969,2,126,492,6,1,498,1577,22,372,1085,16,22.636363636363637,<=30,BAN,Away,Upto 2014
Pervez Sajjad,PAK,Spin,1971-06-03,Birmingham,England,1971,2,73,179,3,1,451,1037,8,378,858,5,56.375,>30,ENG,Away,Upto 2014
Pervez Sajjad,PAK,Spin,1971-06-17,Lord's,England,1971,1,17,36,1,1,197,492,2,180,456,1,98.5,>30,ENG,Away,Upto 2014
Pervez Sajjad,PAK,Spin,1971-07-08,Leeds,England,1971,2,111,216,1,1,601,1757,16,490,1541,15,37.5625,>30,ENG,Away,Upto 2014
Pervez Sajjad,PAK,Spin,1973-02-02,Wellington,New Zealand,1973,2,24,72,0,1,304,776,6,280,704,6,50.666666666666664,>30,NZ,Away,Upto 2014
Pervez Sajjad,PAK,Spin,1973-02-07,Dunedin,New Zealand,1973,2,50,160,0,1,480,1145,19,430,985,19,25.263157894736842,<=30,NZ,Away,Upto 2014
Pervez Sajjad,PAK,Spin,1973-02-16,Auckland,New Zealand,1973,1,50,120,2,1,488,1070,18,438,950,16,27.11111111111111,<=30,NZ,Away,Upto 2014
Pervez Sajjad,PAK,Spin,1973-03-02,Lahore,Pakistan,1973,2,95,276,3,1,766,1787,23,671,1511,20,33.30434782608695,>30,PAK,Home,Upto 2014
Pervez Sajjad,PAK,Spin,1973-03-16,Hyderabad (Sind),Pakistan,1973,2,67,194,1,1,993,2402,21,926,2208,20,47.285714285714285,>30,PAK,Home,Upto 2014
Q McMillan,SA,Spin,1929-06-29,Lord's,England,1929,2,65,120,0,1,382,1002,11,317,882,11,34.72727272727273,>30,ENG,Away,Upto 2014
Q McMillan,SA,Spin,1929-08-17,The Oval,England,1929,2,117,228,3,1,557,1110,10,440,882,7,55.7,>30,ENG,Away,Upto 2014
Q McMillan,SA,Spin,1930-12-24,Johannesburg,South Africa,1930,2,72,78,1,1,386,746,13,314,668,12,29.692307692307693,<=30,SA,Home,Upto 2014
Q McMillan,SA,Spin,1931-01-01,Cape Town,South Africa,1931,2,175,390,5,1,731,1678,19,556,1288,14,38.473684210526315,>30,SA,Home,Upto 2014
Q McMillan,SA,Spin,1931-01-16,Durban,South Africa,1931,1,31,36,0,1,228,660,10,197,624,10,22.8,<=30,SA,Home,Upto 2014
Q McMillan,SA,Spin,1931-02-13,Johannesburg,South Africa,1931,2,74,112,2,1,443,1089,15,369,977,13,29.533333333333335,<=30,SA,Home,Upto 2014
Q McMillan,SA,Spin,1931-02-21,Durban,South Africa,1931,1,57,102,2,1,436,1147,20,379,1045,18,21.8,<=30,SA,Home,Upto 2014
Q McMillan,SA,Spin,1931-11-27,Brisbane,Australia,1931,1,52,60,0,1,332,1063,15,280,1003,15,22.133333333333333,<=30,AUS,Away,Upto 2014
Q McMillan,SA,Spin,1931-12-31,Melbourne,Australia,1931,2,172,210,4,1,678,1818,23,506,1608,19,29.47826086956522,<=30,AUS,Away,Upto 2014
Q McMillan,SA,Spin,1932-01-29,Adelaide,Australia,1932,2,76,98,0,1,610,1508,19,534,1410,19,32.10526315789474,>30,AUS,Away,Upto 2014
Q McMillan,SA,Spin,1932-02-12,Melbourne,Australia,1932,1,29,48,3,1,112,305,17,83,257,14,6.588235294117647,<=30,AUS,Away,Upto 2014
Q McMillan,SA,Spin,1932-02-27,Christchurch,New Zealand,1932,2,127,239,9,1,356,669,15,229,430,6,23.733333333333334,<=30,NZ,Away,Upto 2014
Q McMillan,SA,Spin,1932-03-04,Wellington,New Zealand,1932,2,196,300,7,1,627,1075,19,431,775,12,33.0,>30,NZ,Away,Upto 2014
Qais Ahmad,AFG,Spin,2019-09-05,Chattogram,Bangladesh,2019,2,28,54,1,1,903,1930,38,875,1876,37,23.763157894736842,<=30,BAN,Away,After 1965
Qais Ahmad,AFG,Spin,2024-02-02,Colombo (SSC),Sri Lanka,2024,2,106,134,2,1,432,854,10,326,720,8,43.2,>30,SL,Away,After 1965
Qaiser Abbas,PAK,Spin,2000-11-15,Lahore,Pakistan,2000,1,35,96,0,1,697,1762,20,662,1666,20,34.85,>30,PAK,Home,Upto 2014
Qasim Umar,PAK,Pace,1983-12-09,Adelaide,Australia,1983,1,0,6,0,1,947,1786,20,947,1780,20,47.35,>30,AUS,Away,Upto 2014
R Appleyard,ENG,Pace,1954-07-01,Nottingham,England,1954,2,123,286,7,1,686,1378,19,563,1092,12,36.10526315789474,>30,ENG,Home,Upto 2014
R Appleyard,ENG,Pace,1954-12-17,Sydney,Australia,1954,2,44,104,1,1,649,1696,33,605,1592,32,19.666666666666668,<=30,AUS,Away,Upto 2014
R Appleyard,ENG,Pace,1954-12-31,Melbourne,Australia,1954,2,55,120,3,1,538,1484,30,483,1364,27,17.933333333333334,<=30,AUS,Away,Upto 2014
R Appleyard,ENG,Pace,1955-01-28,Adelaide,Australia,1955,2,71,280,6,1,511,1397,23,440,1117,17,22.217391304347824,<=30,AUS,Away,Upto 2014
R Appleyard,ENG,Pace,1955-02-25,Sydney,Australia,1955,1,54,128,1,1,382,806,7,328,678,6,54.57142857142857,>30,AUS,Away,Upto 2014
R Appleyard,ENG,Pace,1955-03-11,Dunedin,New Zealand,1955,2,35,84,2,1,287,993,22,252,909,20,13.045454545454545,<=30,NZ,Away,Upto 2014
R Appleyard,ENG,Pace,1955-03-25,Auckland,New Zealand,1955,2,45,132,7,1,296,880,23,251,748,16,12.869565217391305,<=30,NZ,Away,Upto 2014
R Appleyard,ENG,Pace,1955-06-09,Nottingham,England,1955,2,78,282,2,1,443,1507,20,365,1225,18,22.15,<=30,ENG,Home,Upto 2014
R Appleyard,ENG,Pace,1956-06-07,Nottingham,England,1956,2,49,180,2,1,363,976,12,314,796,10,30.25,>30,ENG,Home,Upto 2014
R Ashwin,IND,Spin,2011-11-06,Delhi,India,2011,2,128,291,9,1,434,957,21,306,666,12,20.666666666666668,<=30,IND,Home,Upto 2014
R Ashwin,IND,Spin,2011-11-14,Eden Gardens,India,2011,2,186,324,4,1,689,1188,12,503,864,8,57.416666666666664,>30,IND,Home,Upto 2014
R Ashwin,IND,Spin,2011-11-22,Wankhede,India,2011,2,190,405,9,1,794,1593,24,604,1188,15,33.083333333333336,>30,IND,Home,Upto 2014
R Ashwin,IND,Spin,2011-12-26,Melbourne,Australia,2011,2,141,306,4,1,247,467,5,106,161,1,49.4,>30,AUS,Away,Upto 2014
R Ashwin,IND,Spin,2012-01-03,Sydney,Australia,2012,1,157,264,0,1,343,624,2,186,360,2,171.5,>30,AUS,Away,Upto 2014
R Ashwin,IND,Spin,2012-01-24,Adelaide,Australia,2012,2,267,438,5,1,465,838,10,198,400,5,46.5,>30,AUS,Away,Upto 2014
R Ashwin,IND,Spin,2012-08-23,Hyderabad,India,2012,2,85,260,12,1,326,884,22,241,624,10,14.818181818181818,<=30,IND,Home,Upto 2014
R Ashwin,IND,Spin,2012-08-31,Bengaluru,India,2012,2,151,276,6,1,445,783,16,294,507,10,27.8125,<=30,IND,Home,Upto 2014
R Ashwin,IND,Spin,2012-11-15,Ahmedabad,India,2012,2,191,420,4,1,729,1559,21,538,1139,17,34.714285714285715,>30,IND,Home,Upto 2014
R Ashwin,IND,Spin,2012-11-23,Wankhede,India,2012,2,167,277,2,1,747,1449,28,580,1172,26,26.678571428571427,<=30,IND,Home,Upto 2014
R Ashwin,IND,Spin,2012-12-05,Eden Gardens,India,2012,2,214,352,5,1,665,1360,18,451,1008,13,36.94444444444444,>30,IND,Home,Upto 2014
R Ashwin,IND,Spin,2012-12-13,Nagpur,India,2012,2,165,372,3,1,722,2045,15,557,1673,12,48.13333333333333,>30,IND,Home,Upto 2014
R Ashwin,IND,Spin,2013-02-22,Chennai,India,2013,2,198,444,12,1,771,1539,24,573,1095,12,32.125,>30,IND,Home,Upto 2014
R Ashwin,IND,Spin,2013-03-02,Hyderabad,India,2013,2,104,258,6,1,504,1093,21,400,835,15,24.0,<=30,IND,Home,Upto 2014
R Ashwin,IND,Spin,2013-03-14,Mohali,India,2013,2,169,449,4,1,752,1501,18,583,1052,14,41.77777777777778,>30,IND,Home,Upto 2014
R Ashwin,IND,Spin,2013-03-22,Delhi,India,2013,2,112,297,7,1,535,1112,29,423,815,22,18.448275862068964,<=30,IND,Home,Upto 2014
R Ashwin,IND,Spin,2013-11-06,Eden Gardens,India,2013,2,98,240,5,1,456,988,15,358,748,10,30.4,>30,IND,Home,Upto 2014
R Ashwin,IND,Spin,2013-11-14,Wankhede,India,2013,2,134,192,7,1,497,770,24,363,578,17,20.708333333333332,<=30,IND,Home,Upto 2014
R Ashwin,IND,Spin,2013-12-18,Johannesburg,South Africa,2013,2,108,252,0,1,344,574,4,236,322,4,86.0,>30,SA,Away,Upto 2014
R Ashwin,IND,Spin,2014-08-07,Manchester,England,2014,1,29,84,0,1,104,243,5,75,159,5,20.8,<=30,ENG,Away,After 1965
R Ashwin,IND,Spin,2014-08-15,The Oval,England,2014,1,72,129,3,1,73,135,3,1,6,0,24.333333333333332,<=30,ENG,Away,After 1965
R Ashwin,IND,Spin,2014-12-17,Brisbane,Australia,2014,1,128,202,2,1,289,440,7,161,238,5,41.285714285714285,>30,AUS,Away,After 1965
R Ashwin,IND,Spin,2014-12-26,Melbourne,Australia,2014,2,209,432,5,1,388,732,7,179,300,2,55.42857142857143,>30,AUS,Away,After 1965
R Ashwin,IND,Spin,2015-01-06,Sydney,Australia,2015,2,247,396,5,1,575,1013,9,328,617,4,63.888888888888886,>30,AUS,Away,After 1965
R Ashwin,IND,Spin,2015-06-10,Fatullah,Bangladesh,2015,2,95,186,5,1,528,806,14,433,620,9,37.714285714285715,>30,BAN,Away,After 1965
R Ashwin,IND,Spin,2015-08-12,Galle,Sri Lanka,2015,2,160,252,10,1,627,1167,31,467,915,21,20.225806451612904,<=30,SL,Away,After 1965
R Ashwin,IND,Spin,2015-08-20,Colombo (PSS),Sri Lanka,2015,2,118,270,7,1,596,1144,22,478,874,15,27.09090909090909,<=30,SL,Away,After 1965
R Ashwin,IND,Spin,2015-08-28,Colombo (SSC),Sri Lanka,2015,2,102,168,4,1,433,759,12,331,591,8,36.083333333333336,>30,SL,Away,After 1965
R Ashwin,IND,Spin,2015-11-05,Mohali,India,2015,2,90,228,8,1,466,1004,34,376,776,26,13.705882352941176,<=30,IND,Home,After 1965
R Ashwin,IND,Spin,2015-11-14,Bengaluru,India,2015,1,70,108,4,1,138,228,8,68,120,4,17.25,<=30,IND,Home,After 1965
R Ashwin,IND,Spin,2015-11-25,Nagpur,India,2015,2,98,276,12,1,483,1096,33,385,820,21,14.636363636363637,<=30,IND,Home,After 1965
R Ashwin,IND,Spin,2015-12-03,Delhi,India,2015,2,87,376,7,1,551,1517,20,464,1141,13,27.55,<=30,IND,Home,After 1965
R Ashwin,IND,Spin,2016-07-21,North Sound,West Indies,2016,2,126,252,7,1,560,1009,16,434,757,9,35.0,>30,WI,Away,After 1965
R Ashwin,IND,Spin,2016-07-30,Kingston,West Indies,2016,2,166,276,6,1,562,982,15,396,706,9,37.46666666666667,>30,WI,Away,After 1965
R Ashwin,IND,Spin,2016-08-09,Gros Islet,West Indies,2016,2,80,228,3,1,298,783,9,218,555,6,33.111111111111114,>30,WI,Away,After 1965
R Ashwin,IND,Spin,2016-08-18,Port of Spain,West Indies,2016,1,22,30,1,1,22,30,1,0,0,0,22.0,<=30,WI,Away,After 1965
R Ashwin,IND,Spin,2016-09-22,Kanpur,India,2016,2,225,398,10,1,859,1714,26,634,1316,16,33.03846153846154,>30,IND,Home,After 1965
R Ashwin,IND,Spin,2016-09-30,Eden Gardens,India,2016,2,115,234,4,1,455,834,14,340,600,10,32.5,>30,IND,Home,After 1965
R Ashwin,IND,Spin,2016-10-08,Indore,India,2016,2,140,247,13,1,676,1243,22,536,996,9,30.727272727272727,>30,IND,Home,After 1965
R Ashwin,IND,Spin,2016-11-09,Rajkot,India,2016,2,230,417,3,1,954,1677,22,724,1260,19,43.36363636363637,>30,IND,Home,After 1965
R Ashwin,IND,Spin,2016-11-17,Visakhapatnam,India,2016,2,119,359,8,1,632,1483,25,513,1124,17,25.28,<=30,IND,Home,After 1965
R Ashwin,IND,Spin,2016-11-26,Mohali,India,2016,2,124,266,4,1,572,1216,17,448,950,13,33.64705882352941,>30,IND,Home,After 1965
R Ashwin,IND,Spin,2016-12-08,Wankhede,India,2016,2,167,387,12,1,864,1639,27,697,1252,15,32.0,>30,IND,Home,After 1965
R Ashwin,IND,Spin,2016-12-16,Chennai,India,2016,2,207,414,1,1,966,1770,17,759,1356,16,56.8235294117647,>30,IND,Home,After 1965
R Ashwin,IND,Spin,2017-02-09,Hyderabad,India,2017,2,171,356,6,1,881,1634,19,710,1278,13,46.36842105263158,>30,IND,Home,After 1965
R Ashwin,IND,Spin,2017-02-23,Pune,India,2017,2,182,377,7,1,566,1181,31,384,804,24,18.258064516129032,<=30,IND,Home,After 1965
R Ashwin,IND,Spin,2017-03-04,Bengaluru,India,2017,2,125,370,8,1,406,1139,26,281,769,18,15.615384615384615,<=30,IND,Home,After 1965
R Ashwin,IND,Spin,2017-03-16,Ranchi,India,2017,2,185,384,2,1,755,1725,15,570,1341,13,50.333333333333336,>30,IND,Home,After 1965
R Ashwin,IND,Spin,2017-03-25,Dharamsala,India,2017,2,83,221,4,1,468,1025,18,385,804,14,26.0,<=30,IND,Home,After 1965
R Ashwin,IND,Spin,2017-07-26,Galle,Sri Lanka,2017,2,149,324,4,1,734,1244,13,585,920,9,56.46153846153846,>30,SL,Away,After 1965
R Ashwin,IND,Spin,2017-08-03,Colombo (SSC),Sri Lanka,2017,2,201,327,7,1,953,1487,21,752,1160,14,45.38095238095238,>30,SL,Away,After 1965
R Ashwin,IND,Spin,2017-08-12,Pallekele,Sri Lanka,2017,2,90,223,6,1,436,802,19,346,579,13,22.94736842105263,<=30,SL,Away,After 1965
R Ashwin,IND,Spin,2017-11-16,Eden Gardens,India,2017,1,13,48,0,1,123,228,3,110,180,3,41.0,>30,IND,Home,After 1965
R Ashwin,IND,Spin,2017-11-24,Nagpur,India,2017,2,130,274,8,1,497,970,17,367,696,9,29.235294117647058,<=30,IND,Home,After 1965
R Ashwin,IND,Spin,2017-12-02,Delhi,India,2017,2,216,420,4,1,881,1566,17,665,1146,13,51.8235294117647,>30,IND,Home,After 1965
R Ashwin,IND,Spin,2018-01-05,Cape Town,South Africa,2018,2,24,49,2,1,56,109,2,32,60,0,28.0,<=30,SA,Away,After 1965
R Ashwin,IND,Spin,2018-01-13,Centurion,South Africa,2018,2,191,410,5,1,284,566,6,93,156,1,47.333333333333336,>30,SA,Away,After 1965
R Ashwin,IND,Spin,2018-06-14,Bengaluru,India,2018,2,59,118,5,1,388,572,15,329,454,10,25.866666666666667,<=30,IND,Home,After 1965
R Ashwin,IND,Spin,2018-08-01,Birmingham,England,2018,2,121,282,7,1,161,354,10,40,72,3,16.1,<=30,ENG,Away,After 1965
R Ashwin,IND,Spin,2018-08-09,Lord's,England,2018,1,68,102,0,1,112,156,0,44,54,0,inf,>30,ENG,Away,After 1965
R Ashwin,IND,Spin,2018-08-18,Nottingham,England,2018,2,47,143,1,1,203,377,5,156,234,4,40.6,>30,ENG,Away,After 1965
R Ashwin,IND,Spin,2018-08-30,Southampton,England,2018,2,124,311,3,1,298,647,12,174,336,9,24.833333333333332,<=30,ENG,Away,After 1965
R Ashwin,IND,Spin,2018-10-04,Rajkot,India,2018,2,108,174,6,1,685,1000,22,577,826,16,31.136363636363637,>30,IND,Home,After 1965
R Ashwin,IND,Spin,2018-10-12,Hyderabad,India,2018,2,73,206,3,1,524,1095,12,451,889,9,43.666666666666664,>30,IND,Home,After 1965
R Ashwin,IND,Spin,2018-12-06,Adelaide,Australia,2018,2,149,521,6,1,390,1013,14,241,492,8,27.857142857142858,<=30,AUS,Away,After 1965
R Ashwin,IND,Spin,2019-10-02,Visakhapatnam,India,2019,2,189,398,8,1,1062,1652,22,873,1254,14,48.27272727272727,>30,IND,Home,After 1965
R Ashwin,IND,Spin,2019-10-10,Pune,India,2019,2,114,298,6,1,587,1113,12,473,815,6,48.916666666666664,>30,IND,Home,After 1965
R Ashwin,IND,Spin,2019-10-19,Ranchi,India,2019,2,76,132,1,1,405,692,13,329,560,12,31.153846153846153,>30,IND,Home,After 1965
R Ashwin,IND,Spin,2019-11-14,Indore,India,2019,2,85,182,5,1,411,632,6,326,450,1,68.5,>30,IND,Home,After 1965
R Ashwin,IND,Spin,2019-11-22,Eden Gardens,India,2019,1,19,30,0,1,112,192,1,93,162,1,112.0,>30,IND,Home,After 1965
R Ashwin,IND,Spin,2020-02-21,Wellington,New Zealand,2020,1,99,174,3,1,124,210,3,25,36,0,41.333333333333336,>30,NZ,Away,After 1965
R Ashwin,IND,Spin,2020-12-17,Adelaide,Australia,2020,2,71,144,5,1,142,276,6,71,132,1,23.666666666666668,<=30,AUS,Away,After 1965
R Ashwin,IND,Spin,2020-12-26,Melbourne,Australia,2020,2,106,367,5,1,235,670,11,129,303,6,21.363636363636363,<=30,AUS,Away,After 1965
R Ashwin,IND,Spin,2021-01-07,Sydney,Australia,2021,2,169,294,2,1,452,906,8,283,612,6,56.5,>30,AUS,Away,After 1965
R Ashwin,IND,Spin,2021-02-05,Chennai,India,2021,2,207,436,9,1,867,1480,24,660,1044,15,36.125,>30,IND,Home,After 1965
R Ashwin,IND,Spin,2021-02-13,Chennai,India,2021,2,96,251,8,1,686,1393,32,590,1142,24,21.4375,<=30,IND,Home,After 1965
R Ashwin,IND,Spin,2021-02-24,Ahmedabad,India,2021,2,74,186,7,1,247,614,28,173,428,21,8.821428571428571,<=30,IND,Home,After 1965
R Ashwin,IND,Spin,2021-03-04,Ahmedabad,India,2021,2,94,256,8,1,456,994,20,362,738,12,22.8,<=30,IND,Home,After 1965
R Ashwin,IND,Spin,2021-06-18,Southampton,England,2021,2,45,150,4,1,90,242,5,45,92,1,18.0,<=30,ENG,Away,After 1965
R Ashwin,IND,Spin,2021-11-25,Kanpur,India,2021,2,117,435,6,1,592,1744,20,475,1309,14,29.6,<=30,IND,Home,After 1965
R Ashwin,IND,Spin,2021-12-03,Wankhede,India,2021,2,42,183,8,1,600,1113,33,558,930,25,18.181818181818183,<=30,IND,Home,After 1965
R Ashwin,IND,Spin,2021-12-26,Centurion,South Africa,2021,2,55,132,2,1,113,240,2,58,108,0,56.5,>30,SA,Away,After 1965
R Ashwin,IND,Spin,2022-01-03,Johannesburg,South Africa,2022,2,61,130,1,1,75,142,1,14,12,0,75.0,>30,SA,Away,After 1965
R Ashwin,IND,Spin,2022-01-11,Cape Town,South Africa,2022,2,66,123,0,1,113,195,1,47,72,1,113.0,>30,SA,Away,After 1965
R Ashwin,IND,Spin,2022-03-04,Mohali,India,2022,2,96,246,6,1,500,927,18,404,681,12,27.77777777777778,<=30,IND,Home,After 1965
R Ashwin,IND,Spin,2022-03-12,Bengaluru,India,2022,2,85,170,6,1,625,968,26,540,798,20,24.03846153846154,<=30,IND,Home,After 1965
R Ashwin,IND,Spin,2022-12-14,Chattogram,Bangladesh,2022,2,109,222,1,1,800,1534,23,691,1312,22,34.78260869565217,>30,BAN,Away,After 1965
R Ashwin,IND,Spin,2022-12-22,Mirpur,Bangladesh,2022,2,137,263,6,1,578,1084,25,441,821,19,23.12,<=30,BAN,Away,After 1965
R Ashwin,IND,Spin,2023-02-09,Nagpur,India,2023,2,79,167,8,1,475,1061,24,396,894,16,19.791666666666668,<=30,IND,Home,After 1965
R Ashwin,IND,Spin,2023-02-17,Delhi,India,2023,2,116,222,6,1,582,1082,28,466,860,22,20.785714285714285,<=30,IND,Home,After 1965
R Ashwin,IND,Spin,2023-03-01,Indore,India,2023,2,88,182,4,1,438,973,26,350,791,22,16.846153846153847,<=30,IND,Home,After 1965
R Ashwin,IND,Spin,2023-03-09,Ahmedabad,India,2023,2,149,428,7,1,725,1892,17,576,1464,10,42.64705882352941,>30,IND,Home,After 1965
R Ashwin,IND,Spin,2023-07-12,Roseau,West Indies,2023,2,131,276,12,1,411,1014,20,280,738,8,20.55,<=30,WI,Away,After 1965
R Ashwin,IND,Spin,2023-07-20,Port of Spain,West Indies,2023,2,94,264,3,1,279,750,9,185,486,6,31.0,>30,WI,Away,After 1965
R Ashwin,IND,Spin,2023-12-26,Centurion,South Africa,2023,1,41,114,1,1,41,114,1,0,0,0,41.0,>30,SA,Away,After 1965
R Ashwin,IND,Spin,2024-01-25,Hyderabad,India,2024,2,194,300,6,1,1067,1778,32,873,1478,26,33.34375,>30,IND,Home,After 1965
R Ashwin,IND,Spin,2024-02-02,Visakhapatnam,India,2024,2,133,180,3,1,935,1413,24,802,1233,21,38.958333333333336,>30,IND,Home,After 1965
R Ashwin,IND,Spin,2024-02-15,Rajkot,India,2024,2,56,78,2,1,805,1288,20,749,1210,18,40.25,>30,IND,Home,After 1965
R Ashwin,IND,Spin,2024-02-23,Ranchi,India,2024,2,134,227,6,1,670,1494,28,536,1267,22,23.928571428571427,<=30,IND,Home,After 1965
R Ashwin,IND,Spin,2024-03-07,Dharamsala,India,2024,2,128,154,9,1,589,972,25,461,818,16,23.56,<=30,IND,Home,After 1965
R Ashwin,IND,Spin,2024-09-19,Chennai,India,2024,2,117,204,6,1,522,763,14,405,559,8,37.285714285714285,>30,IND,Home,After 1965
R Ashwin,IND,Spin,2024-09-27,Kanpur,India,2024,2,95,180,5,1,428,548,20,333,368,15,21.4,<=30,IND,Home,After 1965
R Ashwin,IND,Spin,2024-10-16,Bengaluru,India,2024,2,100,108,1,1,524,637,10,424,529,9,52.4,>30,IND,Home,After 1965
R Ashwin,IND,Spin,2024-10-24,Pune,India,2024,2,161,294,5,1,741,1336,37,580,1042,32,20.027027027027028,<=30,IND,Home,After 1965
R Ashwin,IND,Spin,2024-11-01,Wankhede,India,2024,2,110,186,3,1,671,1028,34,561,842,31,19.735294117647058,<=30,IND,Home,After 1965
R Ashwin,IND,Spin,2024-12-06,Adelaide,Australia,2024,1,53,108,1,1,178,252,2,125,144,1,89.0,>30,AUS,Away,After 1965
R Beaumont,SA,Spin,1913-12-26,Johannesburg,South Africa,1913,1,0,6,0,1,283,660,6,283,654,6,47.166666666666664,>30,SA,Home,Upto 2014
R Benaud,AUS,Spin,1952-01-25,Sydney,Australia,1952,1,14,35,1,1,474,1237,15,460,1202,14,31.6,>30,AUS,Home,Upto 2014
R Benaud,AUS,Spin,1952-12-24,Melbourne,Australia,1952,2,43,102,2,1,730,1899,24,687,1797,22,30.416666666666668,>30,AUS,Home,Upto 2014
R Benaud,AUS,Spin,1953-01-09,Sydney,Australia,1953,1,21,40,2,1,515,1280,12,494,1240,10,42.916666666666664,>30,AUS,Home,Upto 2014
R Benaud,AUS,Spin,1953-01-24,Adelaide,Australia,1953,2,146,464,5,1,857,2379,23,711,1915,18,37.26086956521739,>30,AUS,Home,Upto 2014
R Benaud,AUS,Spin,1953-02-06,Melbourne,Australia,1953,2,96,240,1,1,952,2221,20,856,1981,19,47.6,>30,AUS,Home,Upto 2014
R Benaud,AUS,Spin,1953-06-11,Nottingham,England,1953,1,15,30,0,1,277,894,8,262,864,8,34.625,>30,ENG,Away,Upto 2014
R Benaud,AUS,Spin,1953-06-25,Lord's,England,1953,2,121,216,2,1,753,1644,18,632,1428,16,41.833333333333336,>30,ENG,Away,Upto 2014
R Benaud,AUS,Spin,1953-07-23,Leeds,England,1953,2,38,162,0,1,195,432,3,157,270,3,65.0,>30,ENG,Away,Upto 2014
R Benaud,AUS,Spin,1954-11-26,Brisbane,Australia,1954,2,71,161,3,1,261,746,11,190,585,8,23.727272727272727,<=30,AUS,Home,Upto 2014
R Benaud,AUS,Spin,1954-12-17,Sydney,Australia,1954,1,42,152,1,1,179,446,7,137,294,6,25.571428571428573,<=30,AUS,Home,Upto 2014
R Benaud,AUS,Spin,1954-12-31,Melbourne,Australia,1954,2,55,120,1,1,232,621,10,177,501,9,23.2,<=30,AUS,Home,Upto 2014
R Benaud,AUS,Spin,1955-01-28,Adelaide,Australia,1955,2,130,342,4,1,330,1112,11,200,770,7,30.0,<=30,AUS,Home,Upto 2014
R Benaud,AUS,Spin,1955-02-25,Sydney,Australia,1955,1,79,160,1,1,313,666,14,234,506,13,22.357142857142858,<=30,AUS,Home,Upto 2014
R Benaud,AUS,Spin,1955-03-26,Kingston,West Indies,1955,2,73,252,2,1,550,1394,11,477,1142,9,50.0,>30,WI,Away,Upto 2014
R Benaud,AUS,Spin,1955-04-11,Port of Spain,West Indies,1955,2,95,174,3,1,545,1044,8,450,870,5,68.125,>30,WI,Away,Upto 2014
R Benaud,AUS,Spin,1955-04-26,Georgetown,West Indies,1955,2,58,107,5,1,484,1365,24,426,1258,19,20.166666666666668,<=30,WI,Away,Upto 2014
R Benaud,AUS,Spin,1955-05-14,Bridgetown,West Indies,1955,2,108,253,4,1,1042,2444,22,934,2191,18,47.36363636363637,>30,WI,Away,Upto 2014
R Benaud,AUS,Spin,1955-06-11,Kingston,West Indies,1955,2,151,323,4,1,758,1737,11,607,1414,7,68.9090909090909,>30,WI,Away,Upto 2014
R Benaud,AUS,Spin,1956-06-07,Nottingham,England,1956,1,41,108,0,1,279,1027,11,238,919,11,25.363636363636363,<=30,ENG,Away,Upto 2014
R Benaud,AUS,Spin,1956-06-21,Lord's,England,1956,2,46,222,3,1,172,625,7,126,403,4,24.571428571428573,<=30,ENG,Away,Upto 2014
R Benaud,AUS,Spin,1956-07-12,Leeds,England,1956,1,89,252,3,1,342,1252,22,253,1000,19,15.545454545454545,<=30,ENG,Away,Upto 2014
R Benaud,AUS,Spin,1956-07-26,Manchester,England,1956,1,123,282,2,1,491,1434,26,368,1152,24,18.884615384615383,<=30,ENG,Away,Upto 2014
R Benaud,AUS,Spin,1956-08-23,The Oval,England,1956,2,31,60,0,1,234,721,10,203,661,10,23.4,<=30,ENG,Away,Upto 2014
R Benaud,AUS,Spin,1956-10-11,Karachi,Pakistan,1956,1,36,102,1,1,132,398,5,96,296,4,26.4,<=30,PAK,Away,Upto 2014
R Benaud,AUS,Spin,1956-10-19,Chennai,India,1956,2,131,297,8,1,458,1218,19,327,921,11,24.105263157894736,<=30,IND,Away,Upto 2014
R Benaud,AUS,Spin,1956-10-26,Brabourne,India,1956,2,152,402,4,1,685,1650,12,533,1248,8,57.083333333333336,>30,IND,Away,Upto 2014
R Benaud,AUS,Spin,1956-11-02,Eden Gardens,India,1956,2,105,320,11,1,552,1533,35,447,1213,24,15.771428571428572,<=30,IND,Away,Upto 2014
R Benaud,AUS,Spin,1957-12-23,Johannesburg,South Africa,1957,2,130,232,1,1,467,1272,8,337,1040,7,58.375,>30,SA,Away,Upto 2014
R Benaud,AUS,Spin,1957-12-31,Cape Town,South Africa,1957,2,144,448,9,1,376,1269,21,232,821,12,17.904761904761905,<=30,SA,Away,Upto 2014
R Benaud,AUS,Spin,1958-01-24,Durban,South Africa,1958,1,114,407,5,1,339,1343,10,225,936,5,33.9,>30,SA,Away,Upto 2014
R Benaud,AUS,Spin,1958-02-07,Johannesburg,South Africa,1958,2,154,490,9,1,358,1230,15,204,740,6,23.866666666666667,<=30,SA,Away,Upto 2014
R Benaud,AUS,Spin,1958-02-28,Gqeberha,South Africa,1958,2,116,360,6,1,259,749,14,143,389,8,18.5,<=30,SA,Away,Upto 2014
R Benaud,AUS,Spin,1958-12-05,Brisbane,Australia,1958,2,112,462,7,1,271,1070,11,159,608,4,24.636363636363637,<=30,AUS,Home,Upto 2014
R Benaud,AUS,Spin,1958-12-31,Melbourne,Australia,1958,2,65,240,1,1,227,617,2,162,377,1,113.5,>30,AUS,Home,Upto 2014
R Benaud,AUS,Spin,1959-01-09,Sydney,Australia,1959,2,177,532,9,1,574,1742,24,397,1210,15,23.916666666666668,<=30,AUS,Home,Upto 2014
R Benaud,AUS,Spin,1959-01-30,Adelaide,Australia,1959,2,173,448,9,1,300,723,9,127,275,0,33.333333333333336,>30,AUS,Home,Upto 2014
R Benaud,AUS,Spin,1959-02-13,Melbourne,Australia,1959,2,57,184,5,1,191,517,10,134,333,5,19.1,<=30,AUS,Home,Upto 2014
R Benaud,AUS,Spin,1959-11-13,Dhaka,Bangladesh,1959,2,111,465,8,1,203,699,11,92,234,3,18.454545454545453,<=30,BAN,Away,Upto 2014
R Benaud,AUS,Spin,1959-11-21,Lahore,Pakistan,1959,2,128,424,4,1,563,1378,18,435,954,14,31.27777777777778,>30,PAK,Away,Upto 2014
R Benaud,AUS,Spin,1959-12-04,Karachi,Pakistan,1959,2,141,455,6,1,235,677,9,94,222,3,26.11111111111111,<=30,PAK,Away,Upto 2014
R Benaud,AUS,Spin,1959-12-12,Delhi,India,1959,2,76,298,8,1,348,919,18,272,621,10,19.333333333333332,<=30,IND,Away,Upto 2014
R Benaud,AUS,Spin,1959-12-19,Kanpur,India,1959,2,144,378,5,1,496,1305,26,352,927,21,19.076923076923077,<=30,IND,Away,Upto 2014
R Benaud,AUS,Spin,1960-01-01,Brabourne,India,1960,2,100,390,1,1,351,876,9,251,486,8,39.0,>30,IND,Away,Upto 2014
R Benaud,AUS,Spin,1960-01-13,Chennai,India,1960,2,86,403,8,1,351,1231,17,265,828,9,20.647058823529413,<=30,IND,Away,Upto 2014
R Benaud,AUS,Spin,1960-01-23,Eden Gardens,India,1960,2,162,465,7,1,425,1054,13,263,589,6,32.69230769230769,>30,IND,Away,Upto 2014
R Benaud,AUS,Spin,1960-12-09,Brisbane,Australia,1960,2,162,440,1,1,778,1958,13,616,1518,12,59.84615384615385,>30,AUS,Home,Upto 2014
R Benaud,AUS,Spin,1960-12-30,Melbourne,Australia,1960,2,107,378,4,1,443,1051,13,336,673,9,34.07692307692308,>30,AUS,Home,Upto 2014
R Benaud,AUS,Spin,1961-01-13,Sydney,Australia,1961,2,199,536,8,1,670,1732,26,471,1196,18,25.76923076923077,<=30,AUS,Home,Upto 2014
R Benaud,AUS,Spin,1961-01-27,Adelaide,Australia,1961,2,203,432,7,1,1001,2526,24,798,2094,17,41.708333333333336,>30,AUS,Home,Upto 2014
R Benaud,AUS,Spin,1961-02-10,Melbourne,Australia,1961,2,108,359,3,1,762,2498,25,654,2139,22,30.48,>30,AUS,Home,Upto 2014
R Benaud,AUS,Spin,1961-06-08,Birmingham,England,1961,2,82,207,3,1,367,819,8,285,612,5,45.875,>30,ENG,Away,Upto 2014
R Benaud,AUS,Spin,1961-07-06,Leeds,England,1961,2,108,270,2,1,330,840,7,222,570,5,47.142857142857146,>30,ENG,Away,Upto 2014
R Benaud,AUS,Spin,1961-07-27,Manchester,England,1961,2,150,402,6,1,285,796,15,135,394,9,19.0,<=30,ENG,Away,Upto 2014
R Benaud,AUS,Spin,1961-08-17,The Oval,England,1961,2,148,408,4,1,415,906,9,267,498,5,46.111111111111114,>30,ENG,Away,Upto 2014
R Benaud,AUS,Spin,1962-11-30,Brisbane,Australia,1962,2,186,552,7,1,507,1344,11,321,792,4,46.09090909090909,>30,AUS,Home,Upto 2014
R Benaud,AUS,Spin,1962-12-29,Melbourne,Australia,1962,2,151,256,1,1,341,714,6,190,458,5,56.833333333333336,>30,AUS,Home,Upto 2014
R Benaud,AUS,Spin,1963-01-11,Sydney,Australia,1963,2,89,280,2,1,280,848,15,191,568,13,18.666666666666668,<=30,AUS,Home,Upto 2014
R Benaud,AUS,Spin,1963-01-25,Adelaide,Australia,1963,2,120,264,2,1,524,1033,6,404,769,4,87.33333333333333,>30,AUS,Home,Upto 2014
R Benaud,AUS,Spin,1963-02-15,Sydney,Australia,1963,2,142,512,5,1,588,2042,17,446,1530,12,34.588235294117645,>30,AUS,Home,Upto 2014
R Benaud,AUS,Spin,1963-12-06,Brisbane,Australia,1963,2,72,280,5,1,346,1069,8,274,789,3,43.25,>30,AUS,Home,Upto 2014
R Benaud,AUS,Spin,1964-01-10,Sydney,Australia,1964,2,116,433,3,1,363,985,5,247,552,2,72.6,>30,AUS,Home,Upto 2014
R Benaud,AUS,Spin,1964-01-24,Adelaide,Australia,1964,2,118,184,0,1,269,512,2,151,328,2,134.5,>30,AUS,Home,Upto 2014
R Benaud,AUS,Spin,1964-02-07,Sydney,Australia,1964,2,143,456,4,1,341,1120,10,198,664,6,34.1,>30,AUS,Home,Upto 2014
R Berry,ENG,Spin,1950-06-08,Manchester,England,1950,2,116,347,9,1,787,2271,35,671,1924,26,22.485714285714284,<=30,ENG,Home,Upto 2014
R Berry,ENG,Spin,1950-06-24,Lord's,England,1950,2,112,306,0,1,844,2771,30,732,2465,30,28.133333333333333,<=30,ENG,Home,Upto 2014
R Clarke,ENG,Pace,2003-10-21,Dhaka,Bangladesh,2003,2,49,126,1,1,448,1151,23,399,1025,22,19.47826086956522,<=30,BAN,Away,Upto 2014
R Clarke,ENG,Pace,2003-10-29,Chattogram,Bangladesh,2003,2,11,48,3,1,551,1109,24,540,1061,21,22.958333333333332,<=30,BAN,Away,Upto 2014
R Dhanraj,WI,Spin,1994-11-18,Wankhede,India,1994,2,93,151,2,1,528,1096,17,435,945,15,31.058823529411764,>30,IND,Away,Upto 2014
R Dhanraj,WI,Spin,1995-02-10,Wellington,New Zealand,1995,2,146,270,4,1,377,624,4,231,354,0,94.25,>30,NZ,Away,Upto 2014
R Dhanraj,WI,Spin,1995-08-10,Nottingham,England,1995,2,191,330,0,1,465,1032,7,274,702,7,66.42857142857143,>30,ENG,Away,Upto 2014
R Dhanraj,WI,Spin,1996-04-27,St John's,West Indies,1996,2,165,336,2,1,371,702,4,206,366,2,92.75,>30,WI,Home,Upto 2014
R Dravid,IND,Spin,1997-08-02,Colombo (RPS),Sri Lanka,1997,1,4,12,0,1,1044,2082,8,1040,2070,8,130.5,>30,SL,Away,Upto 2014
R Dravid,IND,Spin,1997-08-09,Colombo (SSC),Sri Lanka,1997,1,2,6,0,1,450,1036,11,448,1030,11,40.90909090909091,>30,SL,Away,Upto 2014
R Dravid,IND,Spin,1999-10-29,Ahmedabad,India,1999,1,0,6,0,1,599,1348,12,599,1342,12,49.916666666666664,>30,IND,Home,Upto 2014
R Dravid,IND,Spin,2000-11-25,Nagpur,India,2000,1,15,42,0,1,810,1427,12,795,1385,12,67.5,>30,IND,Home,Upto 2014
R Dravid,IND,Spin,2002-05-10,St John's,West Indies,2002,1,18,54,1,1,261,672,7,243,618,6,37.285714285714285,>30,WI,Away,Upto 2014
R Dumbrill,SA,Pace,1965-07-22,Lord's,England,1965,2,61,252,7,1,689,1908,25,628,1656,18,27.56,<=30,ENG,Away,Upto 2014
R Dumbrill,SA,Pace,1965-08-05,Nottingham,England,1965,2,100,204,1,1,718,1736,30,618,1532,29,23.933333333333334,<=30,ENG,Away,Upto 2014
R Dumbrill,SA,Pace,1965-08-26,The Oval,England,1965,2,41,90,0,1,786,1848,27,745,1758,27,29.11111111111111,<=30,ENG,Away,Upto 2014
R Dumbrill,SA,Pace,1966-12-23,Johannesburg,South Africa,1966,2,98,204,1,1,809,1914,26,711,1710,25,31.115384615384617,>30,SA,Home,Upto 2014
R Dumbrill,SA,Pace,1966-12-31,Cape Town,South Africa,1966,1,36,66,0,1,762,1783,22,726,1717,22,34.63636363636363,>30,SA,Home,Upto 2014
R Edwards,AUS,Spin,1975-08-28,The Oval,England,1975,1,20,12,0,1,533,1243,6,513,1231,6,88.83333333333333,>30,ENG,Away,Upto 2014
R Gilchrist,WI,Pace,1957-05-30,Birmingham,England,1957,2,141,318,3,1,447,978,10,306,660,7,44.7,>30,ENG,Away,Upto 2014
R Gilchrist,WI,Pace,1957-06-20,Lord's,England,1957,1,115,219,4,1,433,973,23,318,754,19,18.82608695652174,<=30,ENG,Away,Upto 2014
R Gilchrist,WI,Pace,1957-07-04,Nottingham,England,1957,2,139,216,1,1,642,1416,17,503,1200,16,37.76470588235294,>30,ENG,Away,Upto 2014
R Gilchrist,WI,Pace,1957-07-25,Leeds,England,1957,1,71,162,2,1,268,663,16,197,501,14,16.75,<=30,ENG,Away,Upto 2014
R Gilchrist,WI,Pace,1958-01-17,Bridgetown,West Indies,1958,2,153,336,5,1,627,1370,15,474,1034,10,41.8,>30,WI,Home,Upto 2014
R Gilchrist,WI,Pace,1958-02-05,Port of Spain,West Indies,1958,2,128,240,7,1,632,1494,19,504,1254,12,33.26315789473684,>30,WI,Home,Upto 2014
R Gilchrist,WI,Pace,1958-02-26,Kingston,West Indies,1958,2,171,222,3,1,916,1594,17,745,1372,14,53.88235294117647,>30,WI,Home,Upto 2014
R Gilchrist,WI,Pace,1958-03-13,Georgetown,West Indies,1958,2,168,283,6,1,363,620,8,195,337,2,45.375,>30,WI,Home,Upto 2014
R Gilchrist,WI,Pace,1958-03-26,Port of Spain,West Indies,1958,1,16,42,0,1,413,869,16,397,827,16,25.8125,<=30,WI,Home,Upto 2014
R Gilchrist,WI,Pace,1958-11-28,Brabourne,India,1958,2,114,386,6,1,439,1262,18,325,876,12,24.38888888888889,<=30,IND,Away,Upto 2014
R Gilchrist,WI,Pace,1958-12-31,Eden Gardens,India,1958,2,73,264,9,1,327,738,17,254,474,8,19.235294117647058,<=30,IND,Away,Upto 2014
R Gilchrist,WI,Pace,1959-01-21,Chennai,India,1959,2,80,210,5,1,372,990,12,292,780,7,31.0,>30,IND,Away,Upto 2014
R Gilchrist,WI,Pace,1959-02-06,Delhi,India,1959,2,152,329,6,1,501,1007,14,349,678,8,35.785714285714285,>30,IND,Away,Upto 2014
R Graham,SA,Pace,1899-02-14,Johannesburg,South Africa,1899,2,60,135,2,1,218,395,7,158,260,5,31.142857142857142,>30,SA,Home,After 1965
R Graham,SA,Pace,1899-04-01,Cape Town,South Africa,1899,2,67,105,1,1,255,526,19,188,421,18,13.421052631578947,<=30,SA,Home,After 1965
R Howorth,ENG,Spin,1947-08-16,The Oval,England,1947,2,149,456,6,1,893,1980,23,744,1524,17,38.82608695652174,>30,ENG,Home,Upto 2014
R Howorth,ENG,Spin,1948-01-21,Bridgetown,West Indies,1948,2,192,426,7,1,610,1348,22,418,922,15,27.727272727272727,<=30,WI,Away,Upto 2014
R Howorth,ENG,Spin,1948-02-11,Port of Spain,West Indies,1948,2,78,198,2,1,644,1409,17,566,1211,15,37.88235294117647,>30,WI,Away,Upto 2014
R Howorth,ENG,Spin,1948-03-03,Georgetown,West Indies,1948,2,83,192,1,1,451,1064,19,368,872,18,23.736842105263158,<=30,WI,Away,Upto 2014
R Howorth,ENG,Spin,1948-03-27,Kingston,West Indies,1948,2,133,264,3,1,658,1636,13,525,1372,10,50.61538461538461,>30,WI,Away,Upto 2014
R Illingworth,ENG,Spin,1958-07-24,Manchester,England,1958,2,59,270,3,1,295,909,16,236,639,13,18.4375,<=30,ENG,Home,Upto 2014
R Illingworth,ENG,Spin,1959-07-23,Manchester,England,1959,2,79,330,3,1,721,1722,21,642,1392,18,34.333333333333336,>30,ENG,Home,Upto 2014
R Illingworth,ENG,Spin,1959-08-20,The Oval,England,1959,2,45,180,1,1,323,930,8,278,750,7,40.375,>30,ENG,Home,Upto 2014
R Illingworth,ENG,Spin,1960-01-06,Bridgetown,West Indies,1960,1,106,282,0,1,518,1446,6,412,1164,6,86.33333333333333,>30,WI,Away,Upto 2014
R Illingworth,ENG,Spin,1960-01-28,Port of Spain,West Indies,1960,2,46,210,0,1,448,1444,13,402,1234,13,34.46153846153846,>30,WI,Away,Upto 2014
R Illingworth,ENG,Spin,1960-02-17,Kingston,West Indies,1960,2,81,258,2,1,443,1323,11,362,1065,9,40.27272727272727,>30,WI,Away,Upto 2014
R Illingworth,ENG,Spin,1960-03-09,Georgetown,West Indies,1960,1,72,258,0,1,501,1694,13,429,1436,13,38.53846153846154,>30,WI,Away,Upto 2014
R Illingworth,ENG,Spin,1960-03-25,Port of Spain,West Indies,1960,2,78,168,2,1,649,1404,16,571,1236,14,40.5625,>30,WI,Away,Upto 2014
R Illingworth,ENG,Spin,1960-06-09,Birmingham,England,1960,2,72,246,6,1,303,864,14,231,618,8,21.642857142857142,<=30,ENG,Home,Upto 2014
R Illingworth,ENG,Spin,1960-06-23,Lord's,England,1960,1,0,6,0,1,64,168,0,64,162,0,inf,>30,ENG,Home,Upto 2014
R Illingworth,ENG,Spin,1960-07-07,Nottingham,England,1960,1,33,114,0,1,109,321,3,76,207,3,36.333333333333336,>30,ENG,Home,Upto 2014
R Illingworth,ENG,Spin,1960-07-21,Manchester,England,1960,2,41,96,0,1,183,377,4,142,281,4,45.75,>30,ENG,Home,Upto 2014
R Illingworth,ENG,Spin,1961-06-08,Birmingham,England,1961,1,110,264,2,1,367,819,8,257,555,6,45.875,>30,ENG,Home,Upto 2014
R Illingworth,ENG,Spin,1961-06-22,Lord's,England,1961,1,16,69,1,1,96,339,2,80,270,1,48.0,>30,ENG,Home,Upto 2014
R Illingworth,ENG,Spin,1962-08-16,The Oval,England,1962,2,81,204,1,1,452,1071,6,371,867,5,75.33333333333333,>30,ENG,Home,Upto 2014
R Illingworth,ENG,Spin,1963-01-25,Adelaide,Australia,1963,2,108,200,1,1,524,1033,6,416,833,5,87.33333333333333,>30,AUS,Away,Upto 2014
R Illingworth,ENG,Spin,1963-02-15,Sydney,Australia,1963,2,23,120,0,1,588,2042,17,565,1922,17,34.588235294117645,>30,AUS,Away,Upto 2014
R Illingworth,ENG,Spin,1963-02-23,Auckland,New Zealand,1963,2,39,114,4,1,567,1236,14,528,1122,10,40.5,>30,NZ,Away,Upto 2014
R Illingworth,ENG,Spin,1963-03-01,Wellington,New Zealand,1963,1,34,162,1,1,364,1047,13,330,885,12,28.0,<=30,NZ,Away,Upto 2014
R Illingworth,ENG,Spin,1965-07-08,Leeds,England,1965,2,70,210,4,1,275,702,9,205,492,5,30.555555555555557,>30,ENG,Home,Upto 2014
R Illingworth,ENG,Spin,1966-06-30,Nottingham,England,1966,2,103,198,0,1,501,1422,8,398,1224,8,62.625,>30,ENG,Home,Upto 2014
R Illingworth,ENG,Spin,1966-08-18,The Oval,England,1966,2,62,180,4,1,515,1218,14,453,1038,10,36.785714285714285,>30,ENG,Home,Upto 2014
R Illingworth,ENG,Spin,1967-06-08,Leeds,England,1967,2,131,480,7,1,861,2089,19,730,1609,12,45.31578947368421,>30,ENG,Home,Upto 2014
R Illingworth,ENG,Spin,1967-06-22,Lord's,England,1967,2,29,147,7,1,346,971,18,317,824,11,19.22222222222222,<=30,ENG,Home,Upto 2014
R Illingworth,ENG,Spin,1967-07-13,Birmingham,England,1967,2,106,300,6,1,686,1638,33,580,1338,27,20.78787878787879,<=30,ENG,Home,Upto 2014
R Illingworth,ENG,Spin,1967-07-27,Lord's,England,1967,2,58,276,3,1,583,1689,19,525,1413,16,30.68421052631579,>30,ENG,Home,Upto 2014
R Illingworth,ENG,Spin,1968-07-11,Birmingham,England,1968,2,41,164,3,1,212,680,8,171,516,5,26.5,<=30,ENG,Home,Upto 2014
R Illingworth,ENG,Spin,1968-07-25,Leeds,England,1968,2,134,480,7,1,396,1367,16,262,887,9,24.75,<=30,ENG,Home,Upto 2014
R Illingworth,ENG,Spin,1968-08-22,The Oval,England,1968,2,116,456,3,1,604,1754,22,488,1298,19,27.454545454545453,<=30,ENG,Home,Upto 2014
R Illingworth,ENG,Spin,1969-06-12,Manchester,England,1969,2,75,216,1,1,322,1014,6,247,798,5,53.666666666666664,>30,ENG,Home,Upto 2014
R Illingworth,ENG,Spin,1969-06-26,Lord's,England,1969,2,105,258,3,1,394,1024,8,289,766,5,49.25,>30,ENG,Home,Upto 2014
R Illingworth,ENG,Spin,1969-07-10,Leeds,England,1969,1,38,84,1,1,278,822,14,240,738,13,19.857142857142858,<=30,ENG,Home,Upto 2014
R Illingworth,ENG,Spin,1969-07-24,Lord's,England,1969,2,61,240,4,1,319,1131,22,258,891,18,14.5,<=30,ENG,Home,Upto 2014
R Illingworth,ENG,Spin,1969-08-07,Nottingham,England,1969,2,18,84,3,1,236,642,5,218,558,2,47.2,>30,ENG,Home,Upto 2014
R Illingworth,ENG,Spin,1969-08-21,The Oval,England,1969,2,75,285,3,1,310,1074,17,235,789,14,18.235294117647058,<=30,ENG,Home,Upto 2014
R Illingworth,ENG,Spin,1970-11-27,Brisbane,Australia,1970,2,66,232,1,1,461,1342,10,395,1110,9,46.1,>30,AUS,Away,Upto 2014
R Illingworth,ENG,Spin,1970-12-11,W.A.C.A,Australia,1970,2,55,136,1,1,317,920,6,262,784,5,52.833333333333336,>30,AUS,Away,Upto 2014
R Illingworth,ENG,Spin,1971-01-09,Sydney,Australia,1971,2,68,184,1,1,467,1239,15,399,1055,14,31.133333333333333,>30,AUS,Away,Upto 2014
R Illingworth,ENG,Spin,1971-01-21,Melbourne,Australia,1971,1,59,104,2,1,448,1245,9,389,1141,7,49.77777777777778,>30,AUS,Away,Upto 2014
R Illingworth,ENG,Spin,1971-01-29,Adelaide,Australia,1971,2,46,152,1,1,449,1176,4,403,1024,3,112.25,>30,AUS,Away,Upto 2014
R Illingworth,ENG,Spin,1971-02-12,Sydney,Australia,1971,2,55,248,4,1,385,1254,19,330,1006,15,20.263157894736842,<=30,AUS,Away,Upto 2014
R Illingworth,ENG,Spin,1971-02-25,Christchurch,New Zealand,1971,2,57,184,0,1,395,1134,21,338,950,21,18.80952380952381,<=30,NZ,Away,Upto 2014
R Illingworth,ENG,Spin,1971-03-05,Auckland,New Zealand,1971,1,45,144,0,1,315,824,7,270,680,7,45.0,>30,NZ,Away,Upto 2014
R Illingworth,ENG,Spin,1971-06-03,Birmingham,England,1971,1,72,156,3,1,451,1037,8,379,881,5,56.375,>30,ENG,Home,Upto 2014
R Illingworth,ENG,Spin,1971-06-17,Lord's,England,1971,1,1,42,0,1,197,492,2,196,450,2,98.5,>30,ENG,Home,Upto 2014
R Illingworth,ENG,Spin,1971-07-08,Leeds,England,1971,2,89,324,3,1,601,1757,16,512,1433,13,37.5625,>30,ENG,Home,Upto 2014
R Illingworth,ENG,Spin,1971-07-22,Lord's,England,1971,2,76,246,2,1,610,1919,28,534,1673,26,21.785714285714285,<=30,ENG,Home,Upto 2014
R Illingworth,ENG,Spin,1971-08-05,Manchester,England,1971,1,16,42,0,1,461,1050,7,445,1008,7,65.85714285714286,>30,ENG,Home,Upto 2014
R Illingworth,ENG,Spin,1971-08-19,The Oval,England,1971,2,110,423,5,1,621,1646,28,511,1223,23,22.178571428571427,<=30,ENG,Home,Upto 2014
R Illingworth,ENG,Spin,1972-06-22,Lord's,England,1972,1,13,42,1,1,154,359,2,141,317,1,77.0,>30,ENG,Home,Upto 2014
R Illingworth,ENG,Spin,1972-07-13,Nottingham,England,1972,1,41,90,1,1,374,904,5,333,814,4,74.8,>30,ENG,Home,Upto 2014
R Illingworth,ENG,Spin,1972-07-27,Leeds,England,1972,2,64,241,4,1,321,1171,22,257,930,18,14.590909090909092,<=30,ENG,Home,Upto 2014
R Illingworth,ENG,Spin,1972-08-10,The Oval,England,1972,2,79,155,1,1,544,1256,15,465,1101,14,36.266666666666666,>30,ENG,Home,Upto 2014
R Illingworth,ENG,Spin,1973-06-07,Nottingham,England,1973,1,31,126,0,1,224,617,9,193,491,9,24.88888888888889,<=30,ENG,Home,Upto 2014
R Illingworth,ENG,Spin,1973-06-21,Lord's,England,1973,1,87,234,0,1,444,1278,9,357,1044,9,49.333333333333336,>30,ENG,Home,Upto 2014
R Illingworth,ENG,Spin,1973-07-05,Leeds,England,1973,2,21,48,0,1,170,420,1,149,372,1,170.0,>30,ENG,Home,Upto 2014
R Illingworth,ENG,Spin,1973-07-26,The Oval,England,1973,2,93,234,3,1,563,1459,15,470,1225,12,37.53333333333333,>30,ENG,Home,Upto 2014
R Illingworth,ENG,Spin,1973-08-09,Birmingham,England,1973,2,104,348,2,1,511,1445,13,407,1097,11,39.30769230769231,>30,ENG,Home,Upto 2014
R Illingworth,ENG,Spin,1973-08-23,Lord's,England,1973,1,114,190,1,1,503,859,9,389,669,8,55.888888888888886,>30,ENG,Home,Upto 2014
R Kaia,ZIM,Spin,2021-04-29,Harare,Zimbabwe,2021,1,38,42,0,1,256,510,4,218,468,4,64.0,>30,ZIM,Home,After 1965
R Kaia,ZIM,Spin,2021-07-07,Harare,Zimbabwe,2021,2,127,138,0,1,544,1099,15,417,961,15,36.266666666666666,>30,ZIM,Home,After 1965
R Kilner,ENG,Spin,1924-06-14,Birmingham,England,1924,1,40,132,0,1,396,946,10,356,814,10,39.6,>30,ENG,Home,Upto 2014
R Kilner,ENG,Spin,1924-07-26,Manchester,England,1924,1,19,72,0,1,64,287,4,45,215,4,16.0,<=30,ENG,Home,Upto 2014
R Kilner,ENG,Spin,1925-01-16,Adelaide,Australia,1925,2,178,625,8,1,1079,2740,29,901,2115,21,37.206896551724135,>30,AUS,Away,Upto 2014
R Kilner,ENG,Spin,1925-02-13,Melbourne,Australia,1925,2,70,232,5,1,718,1606,23,648,1374,18,31.217391304347824,>30,AUS,Away,Upto 2014
R Kilner,ENG,Spin,1925-02-27,Sydney,Australia,1925,2,151,576,4,1,638,1899,28,487,1323,24,22.785714285714285,<=30,AUS,Away,Upto 2014
R Kilner,ENG,Spin,1926-06-26,Lord's,England,1926,2,119,341,4,1,556,1523,10,437,1182,6,55.6,>30,ENG,Home,Upto 2014
R Kilner,ENG,Spin,1926-07-10,Leeds,England,1926,1,106,222,2,1,810,1836,19,704,1614,17,42.63157894736842,>30,ENG,Home,Upto 2014
R Kilner,ENG,Spin,1926-07-24,Manchester,England,1926,1,51,168,1,1,479,1184,11,428,1016,10,43.54545454545455,>30,ENG,Home,Upto 2014
R McLaren,SA,Pace,2010-01-14,Johannesburg,South Africa,2010,2,43,78,1,1,644,1109,23,601,1031,22,28.0,<=30,SA,Home,Upto 2014
R McLaren,SA,Pace,2014-02-12,Centurion,South Africa,2014,2,119,186,2,1,767,1417,27,648,1231,25,28.40740740740741,<=30,SA,Home,After 1965
R Nanan,WI,Spin,1980-12-08,Faisalabad,Pakistan,1980,2,91,216,4,1,460,1075,25,369,859,21,18.4,<=30,PAK,Away,Upto 2014
R Ngarava,ZIM,Pace,2021-04-29,Harare,Zimbabwe,2021,1,104,174,2,1,469,921,23,365,747,21,20.391304347826086,<=30,ZIM,Home,After 1965
R Ngarava,ZIM,Pace,2021-05-07,Harare,Zimbabwe,2021,1,58,144,1,1,481,1050,18,423,906,17,26.72222222222222,<=30,ZIM,Home,After 1965
R Ngarava,ZIM,Pace,2021-07-07,Harare,Zimbabwe,2021,2,119,192,2,1,697,1302,16,578,1110,14,43.5625,>30,ZIM,Home,After 1965
R Ngarava,ZIM,Pace,2023-02-04,Bulawayo,Zimbabwe,2023,2,88,138,0,1,562,1122,8,474,984,8,70.25,>30,ZIM,Home,After 1965
R Ngarava,ZIM,Pace,2024-07-25,Belfast,Northern Ireland,2024,2,106,132,4,1,610,1116,26,504,984,22,23.46153846153846,<=30,Northern Ireland,Away,After 1965
R Ngarava,ZIM,Pace,2025-01-02,Bulawayo,Zimbabwe,2025,2,94,227,4,1,331,653,15,237,426,11,22.066666666666666,<=30,ZIM,Home,After 1965
R Peel,ENG,Spin,1884-12-12,Adelaide,Australia,1884,2,119,325,8,1,511,1330,22,392,1005,14,23.227272727272727,<=30,AUS,Away,After 1965
R Peel,ENG,Spin,1885-01-01,Melbourne,Australia,1885,2,123,585,6,1,372,1209,9,249,624,3,41.333333333333336,>30,AUS,Away,After 1965
R Peel,ENG,Spin,1885-02-20,Sydney,Australia,1885,2,75,208,1,1,276,897,19,201,689,18,14.526315789473685,<=30,AUS,Away,After 1965
R Peel,ENG,Spin,1885-03-14,Sydney,Australia,1885,2,69,160,2,1,238,508,7,169,348,5,34.0,>30,AUS,Away,After 1965
R Peel,ENG,Spin,1885-03-21,Melbourne,Australia,1885,2,65,284,4,1,142,528,10,77,244,6,14.2,<=30,AUS,Away,After 1965
R Peel,ENG,Spin,1888-02-10,Sydney,Australia,1888,2,58,207,9,1,161,459,15,103,252,6,10.733333333333333,<=30,AUS,Away,After 1965
R Peel,ENG,Spin,1888-07-16,Lord's,England,1888,2,50,126,8,1,134,420,21,84,294,13,6.380952380952381,<=30,ENG,Home,After 1965
R Peel,ENG,Spin,1888-08-13,The Oval,England,1888,2,63,146,5,1,208,504,11,145,358,6,18.90909090909091,<=30,ENG,Home,After 1965
R Peel,ENG,Spin,1888-08-30,Manchester,England,1888,2,68,170,11,1,144,395,16,76,225,5,9.0,<=30,ENG,Home,After 1965
R Peel,ENG,Spin,1890-07-21,Lord's,England,1890,2,87,335,6,1,250,845,14,163,510,8,17.857142857142858,<=30,ENG,Home,After 1965
R Peel,ENG,Spin,1892-01-01,Melbourne,Australia,1892,2,79,359,5,1,195,677,9,116,318,4,21.666666666666668,<=30,AUS,Away,After 1965
R Peel,ENG,Spin,1892-01-29,Sydney,Australia,1892,1,49,210,1,1,229,676,7,180,466,6,32.714285714285715,>30,AUS,Away,After 1965
R Peel,ENG,Spin,1893-07-17,Lord's,England,1893,1,36,110,0,1,216,425,2,180,315,2,108.0,>30,ENG,Home,After 1965
R Peel,ENG,Spin,1894-12-14,Sydney,Australia,1894,2,207,498,8,1,459,958,15,252,460,7,30.6,>30,AUS,Away,After 1965
R Peel,ENG,Spin,1894-12-29,Melbourne,Australia,1894,2,98,325,5,1,327,823,10,229,498,5,32.7,>30,AUS,Away,After 1965
R Peel,ENG,Spin,1895-01-11,Adelaide,Australia,1895,2,139,300,4,1,335,726,15,196,426,11,22.333333333333332,<=30,AUS,Away,After 1965
R Peel,ENG,Spin,1895-02-01,Sydney,Australia,1895,1,74,144,3,1,174,372,10,100,228,7,17.4,<=30,AUS,Away,After 1965
R Peel,ENG,Spin,1895-03-01,Melbourne,Australia,1895,2,203,564,7,1,689,1631,19,486,1067,12,36.26315789473684,>30,AUS,Away,After 1965
R Peel,ENG,Spin,1896-08-10,The Oval,England,1896,2,53,160,8,1,198,633,25,145,473,17,7.92,<=30,ENG,Home,After 1965
R Pollard,ENG,Pace,1946-07-20,Manchester,England,1946,2,87,312,7,1,495,1476,27,408,1164,20,18.333333333333332,<=30,ENG,Home,Upto 2014
R Pollard,ENG,Pace,1947-03-21,Christchurch,New Zealand,1947,1,73,178,3,1,372,820,16,299,642,13,23.25,<=30,NZ,Away,Upto 2014
R Pollard,ENG,Pace,1948-07-08,Manchester,England,1948,2,59,252,3,1,513,1476,16,454,1224,13,32.0625,>30,ENG,Home,Upto 2014
R Pollard,ENG,Pace,1948-07-22,Leeds,England,1948,2,159,360,2,1,942,2038,19,783,1678,17,49.578947368421055,>30,ENG,Home,Upto 2014
R Rampaul,WI,Pace,2009-11-26,Brisbane,Australia,2009,1,110,156,1,1,697,1123,21,587,967,20,33.19047619047619,>30,AUS,Away,Upto 2014
R Rampaul,WI,Pace,2009-12-04,Adelaide,Australia,2009,2,74,138,1,1,930,1567,26,856,1429,25,35.76923076923077,>30,AUS,Away,Upto 2014
R Rampaul,WI,Pace,2009-12-16,W.A.C.A,Australia,2009,2,106,168,2,1,927,1486,27,821,1318,25,34.333333333333336,>30,AUS,Away,Upto 2014
R Rampaul,WI,Pace,2010-06-10,Port of Spain,West Indies,2010,2,77,150,0,1,433,932,18,356,782,18,24.055555555555557,<=30,WI,Home,Upto 2014
R Rampaul,WI,Pace,2010-06-18,Basseterre,West Indies,2010,2,72,120,0,1,644,1267,9,572,1147,9,71.55555555555556,>30,WI,Home,Upto 2014
R Rampaul,WI,Pace,2011-05-12,Providence,West Indies,2011,2,75,228,7,1,310,796,18,235,568,11,17.22222222222222,<=30,WI,Home,Upto 2014
R Rampaul,WI,Pace,2011-05-20,Basseterre,West Indies,2011,2,155,302,4,1,547,1106,13,392,804,9,42.07692307692308,>30,WI,Home,Upto 2014
R Rampaul,WI,Pace,2011-06-20,Kingston,West Indies,2011,2,108,242,4,1,535,1130,25,427,888,21,21.4,<=30,WI,Home,Upto 2014
R Rampaul,WI,Pace,2011-06-28,Bridgetown,West Indies,2011,2,110,264,4,1,639,1424,28,529,1160,24,22.821428571428573,<=30,WI,Home,Upto 2014
R Rampaul,WI,Pace,2011-07-06,Roseau,West Indies,2011,1,31,66,2,1,449,995,20,418,929,18,22.45,<=30,WI,Home,Upto 2014
R Rampaul,WI,Pace,2011-10-21,Chattogram,Bangladesh,2011,2,68,204,2,1,310,664,6,242,460,4,51.666666666666664,>30,BAN,Away,Upto 2014
R Rampaul,WI,Pace,2011-11-06,Delhi,India,2011,2,78,149,2,1,494,839,13,416,690,11,38.0,>30,IND,Away,Upto 2014
R Rampaul,WI,Pace,2011-11-22,Wankhede,India,2011,2,151,244,6,1,622,1054,14,471,810,8,44.42857142857143,>30,IND,Away,Upto 2014
R Rampaul,WI,Pace,2012-04-23,Roseau,West Indies,2012,2,102,198,1,1,492,1142,12,390,944,11,41.0,>30,WI,Home,Upto 2014
R Rampaul,WI,Pace,2012-05-25,Nottingham,England,2012,2,87,228,3,1,765,1507,24,678,1279,21,31.875,>30,ENG,Away,Upto 2014
R Rampaul,WI,Pace,2012-06-07,Birmingham,England,2012,1,55,84,1,1,443,825,14,388,741,13,31.642857142857142,>30,ENG,Away,Upto 2014
R Rampaul,WI,Pace,2012-07-25,North Sound,West Indies,2012,2,96,241,4,1,734,1446,19,638,1205,15,38.63157894736842,>30,WI,Home,Upto 2014
R Rampaul,WI,Pace,2012-11-13,Mirpur,Bangladesh,2012,2,150,258,5,1,489,849,15,339,591,10,32.6,>30,BAN,Away,Upto 2014
R Ravindra,NZ,Spin,2021-11-25,Kanpur,India,2021,2,45,96,0,1,592,1744,20,547,1648,20,29.6,<=30,IND,Away,After 1965
R Ravindra,NZ,Spin,2021-12-03,Wankhede,India,2021,2,76,102,3,1,600,1113,33,524,1011,30,18.181818181818183,<=30,IND,Away,After 1965
R Ravindra,NZ,Spin,2022-01-01,Mount Maunganui,New Zealand,2022,1,67,168,0,1,219,557,6,152,389,6,36.5,>30,NZ,Home,After 1965
R Ravindra,NZ,Spin,2024-02-04,Mount Maunganui,New Zealand,2024,2,34,101,2,1,328,671,17,294,570,15,19.294117647058822,<=30,NZ,Home,After 1965
R Ravindra,NZ,Spin,2024-02-13,Hamilton,New Zealand,2024,2,83,204,4,1,415,855,14,332,651,10,29.642857142857142,<=30,NZ,Home,After 1965
R Ravindra,NZ,Spin,2024-02-29,Wellington,New Zealand,2024,2,26,48,1,1,189,379,17,163,331,16,11.117647058823529,<=30,NZ,Home,After 1965
R Ravindra,NZ,Spin,2024-09-18,Galle,Sri Lanka,2024,2,23,42,0,1,849,1559,29,826,1517,29,29.275862068965516,<=30,SL,Away,After 1965
R Ravindra,NZ,Spin,2024-09-26,Galle,Sri Lanka,2024,1,54,76,0,1,824,1411,22,770,1335,22,37.45454545454545,>30,SL,Away,After 1965
R Ravindra,NZ,Spin,2024-10-16,Bengaluru,India,2024,1,30,36,0,1,524,637,10,494,601,10,52.4,>30,IND,Away,After 1965
R Ravindra,NZ,Spin,2024-11-01,Wankhede,India,2024,1,8,6,0,1,671,1028,34,663,1022,34,19.735294117647058,<=30,IND,Away,After 1965
R Singh,IND,Pace,1999-01-02,Hamilton,New Zealand,1999,2,176,240,3,1,1002,1896,23,826,1656,20,43.56521739130435,>30,NZ,Away,Upto 2014
R Subba Row,ENG,Spin,1960-03-25,Port of Spain,West Indies,1960,1,2,6,0,1,649,1404,16,647,1398,16,40.5625,>30,WI,Away,Upto 2014
R Tattersall,ENG,Spin,1951-02-02,Adelaide,Australia,1951,2,211,421,4,1,793,1857,24,582,1436,20,33.041666666666664,>30,AUS,Away,Upto 2014
R Tattersall,ENG,Spin,1951-02-23,Melbourne,Australia,1951,2,46,128,0,1,462,1120,13,416,992,13,35.53846153846154,>30,AUS,Away,Upto 2014
R Tattersall,ENG,Spin,1951-03-17,Christchurch,New Zealand,1951,1,48,96,1,1,586,1337,15,538,1241,14,39.06666666666667,>30,NZ,Away,Upto 2014
R Tattersall,ENG,Spin,1951-03-24,Wellington,New Zealand,1951,2,60,216,7,1,366,1136,25,306,920,18,14.64,<=30,NZ,Away,Upto 2014
R Tattersall,ENG,Spin,1951-06-07,Nottingham,England,1951,2,136,420,4,1,552,1676,17,416,1256,13,32.470588235294116,>30,ENG,Home,Upto 2014
R Tattersall,ENG,Spin,1951-06-21,Lord's,England,1951,2,101,362,12,1,361,954,17,260,592,5,21.235294117647058,<=30,ENG,Home,Upto 2014
R Tattersall,ENG,Spin,1951-07-05,Manchester,England,1951,2,70,216,2,1,293,819,11,223,603,9,26.636363636363637,<=30,ENG,Home,Upto 2014
R Tattersall,ENG,Spin,1951-07-26,Leeds,England,1951,2,96,456,1,1,749,2072,16,653,1616,15,46.8125,>30,ENG,Home,Upto 2014
R Tattersall,ENG,Spin,1951-08-16,The Oval,England,1951,2,36,114,2,1,352,1033,18,316,919,16,19.555555555555557,<=30,ENG,Home,Upto 2014
R Tattersall,ENG,Spin,1951-11-02,Delhi,India,1951,1,95,318,2,1,589,1935,18,494,1617,16,32.72222222222222,>30,IND,Away,Upto 2014
R Tattersall,ENG,Spin,1951-12-14,Brabourne,India,1951,2,167,324,5,1,561,1297,11,394,973,6,51.0,>30,IND,Away,Upto 2014
R Tattersall,ENG,Spin,1951-12-30,Eden Gardens,India,1951,2,108,312,4,1,698,1841,19,590,1529,15,36.73684210526316,>30,IND,Away,Upto 2014
R Tattersall,ENG,Spin,1952-01-12,Kanpur,India,1952,2,125,293,8,1,484,1339,31,359,1046,23,15.612903225806452,<=30,IND,Away,Upto 2014
R Tattersall,ENG,Spin,1952-02-06,Chennai,India,1952,1,94,234,2,1,648,1564,25,554,1330,23,25.92,<=30,IND,Away,Upto 2014
R Tattersall,ENG,Spin,1953-06-11,Nottingham,England,1953,2,81,168,3,1,277,894,8,196,726,5,34.625,>30,ENG,Home,Upto 2014
R Tattersall,ENG,Spin,1954-06-10,Lord's,England,1954,2,39,150,1,1,153,655,8,114,505,7,19.125,<=30,ENG,Home,Upto 2014
R Vijay Bharadwaj,IND,Spin,1999-10-10,Mohali,India,1999,2,60,163,1,1,393,1249,10,333,1086,9,39.3,>30,IND,Home,Upto 2014
R Vijay Bharadwaj,IND,Spin,1999-10-22,Kanpur,India,1999,1,12,12,0,1,568,1375,24,556,1363,24,23.666666666666668,<=30,IND,Home,Upto 2014
R Vijay Bharadwaj,IND,Spin,2000-01-02,Sydney,Australia,2000,1,35,72,0,1,279,470,1,244,398,1,279.0,>30,AUS,Away,Upto 2014
R Vinay Kumar,IND,Pace,2012-01-13,W.A.C.A,Australia,2012,1,73,78,1,1,668,1156,29,595,1078,28,23.03448275862069,<=30,AUS,Away,Upto 2014
R de Swardt,SA,Pace,2024-02-04,Mount Maunganui,New Zealand,2024,2,109,222,3,1,753,1368,17,644,1146,14,44.294117647058826,>30,NZ,Away,After 1965
R de Swardt,SA,Pace,2024-02-13,Hamilton,New Zealand,2024,2,12,48,0,1,507,1179,18,495,1131,18,28.166666666666668,<=30,NZ,Away,After 1965
RA Austin,WI,Spin,1978-03-17,Bridgetown,West Indies,1978,1,5,6,0,1,226,371,4,221,365,4,56.5,>30,WI,Home,Upto 2014
RA Austin,WI,Spin,2009-07-09,Kingstown,West Indies,2009,2,113,260,2,1,504,1195,18,391,935,16,28.0,<=30,WI,Home,Upto 2014
RA Austin,WI,Spin,2009-07-17,St George's,West Indies,2009,2,42,66,1,1,462,930,22,420,864,21,21.0,<=30,WI,Home,Upto 2014
RA Duff,AUS,Pace,1905-05-29,Nottingham,England,1905,1,43,90,2,1,577,1196,21,534,1106,19,27.476190476190474,<=30,ENG,Away,Upto 2014
RA Duff,AUS,Pace,1905-06-15,Lord's,England,1905,1,14,42,1,1,344,822,16,330,780,15,21.5,<=30,ENG,Away,Upto 2014
RA Duff,AUS,Pace,1905-07-03,Leeds,England,1905,1,13,24,1,1,525,1232,17,512,1208,16,30.88235294117647,>30,ENG,Away,Upto 2014
RA Duff,AUS,Pace,1905-08-14,The Oval,England,1905,1,15,24,0,1,775,1333,24,760,1309,24,32.291666666666664,>30,ENG,Away,Upto 2014
RA Gaunt,AUS,Pace,1958-01-24,Durban,South Africa,1958,1,87,216,2,1,460,1804,17,373,1588,15,27.058823529411764,<=30,SA,Away,Upto 2014
RA Gaunt,AUS,Pace,1961-08-17,The Oval,England,1961,2,86,276,3,1,680,1860,19,594,1584,16,35.78947368421053,>30,ENG,Away,Upto 2014
RA Gaunt,AUS,Pace,1964-01-24,Adelaide,Australia,1964,2,137,224,2,1,1036,2074,26,899,1850,24,39.84615384615385,>30,AUS,Home,Upto 2014
RA Harper,WI,Spin,1983-12-10,Eden Gardens,India,1983,1,16,48,0,1,206,486,5,190,438,5,41.2,>30,IND,Away,Upto 2014
RA Harper,WI,Spin,1983-12-24,Chennai,India,1983,1,108,252,1,1,365,891,7,257,639,6,52.142857142857146,>30,IND,Away,Upto 2014
RA Harper,WI,Spin,1984-03-02,Georgetown,West Indies,1984,2,83,234,4,1,284,720,8,201,486,4,35.5,>30,WI,Home,Upto 2014
RA Harper,WI,Spin,1984-03-30,Bridgetown,West Indies,1984,2,87,270,2,1,192,492,2,105,222,0,96.0,>30,WI,Home,Upto 2014
RA Harper,WI,Spin,1984-04-07,St John's,West Indies,1984,2,82,150,2,1,154,360,2,72,210,0,77.0,>30,WI,Home,Upto 2014
RA Harper,WI,Spin,1984-04-28,Kingston,West Indies,1984,2,51,174,2,1,133,378,4,82,204,2,33.25,>30,WI,Home,Upto 2014
RA Harper,WI,Spin,1984-06-14,Birmingham,England,1984,2,56,102,2,1,266,420,4,210,318,2,66.5,>30,ENG,Away,Upto 2014
RA Harper,WI,Spin,1984-06-28,Lord's,England,1984,2,43,96,1,1,102,174,1,59,78,0,102.0,>30,ENG,Away,Upto 2014
RA Harper,WI,Spin,1984-07-12,Leeds,England,1984,2,77,210,4,1,133,318,7,56,108,3,19.0,<=30,ENG,Away,Upto 2014
RA Harper,WI,Spin,1984-07-26,Manchester,England,1984,2,90,310,6,1,327,823,11,237,513,5,29.727272727272727,<=30,ENG,Away,Upto 2014
RA Harper,WI,Spin,1984-08-09,The Oval,England,1984,2,10,54,0,1,34,102,0,24,48,0,inf,>30,ENG,Away,Upto 2014
RA Harper,WI,Spin,1984-12-07,Adelaide,Australia,1984,2,99,216,5,1,299,561,7,200,345,2,42.714285714285715,>30,AUS,Away,Upto 2014
RA Harper,WI,Spin,1984-12-22,Melbourne,Australia,1984,2,112,216,3,1,287,501,7,175,285,4,41.0,>30,AUS,Away,Upto 2014
RA Harper,WI,Spin,1985-03-29,Port of Spain,West Indies,1985,2,52,216,2,1,167,462,3,115,246,1,55.666666666666664,>30,WI,Home,Upto 2014
RA Harper,WI,Spin,1986-04-11,St John's,West Indies,1986,2,55,228,4,1,237,564,7,182,336,3,33.857142857142854,>30,WI,Home,Upto 2014
RA Harper,WI,Spin,1986-10-24,Faisalabad,Pakistan,1986,1,36,167,2,1,160,446,11,124,279,9,14.545454545454545,<=30,PAK,Away,Upto 2014
RA Harper,WI,Spin,1986-11-07,Lahore,Pakistan,1986,1,1,6,0,1,133,342,6,132,336,6,22.166666666666668,<=30,PAK,Away,Upto 2014
RA Harper,WI,Spin,1986-11-20,Karachi,Pakistan,1986,2,32,48,0,1,383,1055,15,351,1007,15,25.533333333333335,<=30,PAK,Away,Upto 2014
RA Harper,WI,Spin,1987-11-25,Delhi,India,1987,1,13,72,0,1,217,492,5,204,420,5,43.4,>30,IND,Away,Upto 2014
RA Harper,WI,Spin,1988-06-30,Manchester,England,1988,1,4,12,0,1,153,408,1,149,396,1,153.0,>30,ENG,Away,Upto 2014
RA Harper,WI,Spin,1988-08-04,The Oval,England,1988,2,59,162,5,1,151,444,7,92,282,2,21.571428571428573,<=30,ENG,Away,Upto 2014
RA Harper,WI,Spin,1989-01-26,Sydney,Australia,1989,1,86,222,0,1,632,1677,20,546,1455,20,31.6,>30,AUS,Away,Upto 2014
RA Harper,WI,Spin,1993-12-08,Moratuwa,Sri Lanka,1993,2,39,150,1,1,241,659,12,202,509,11,20.083333333333332,<=30,SL,Away,Upto 2014
RA Hutton,ENG,Pace,1971-06-17,Lord's,England,1971,1,36,96,2,1,276,712,9,240,616,7,30.666666666666668,>30,ENG,Home,Upto 2014
RA Hutton,ENG,Pace,1971-07-08,Leeds,England,1971,2,90,282,3,1,442,1309,24,352,1027,21,18.416666666666668,<=30,ENG,Home,Upto 2014
RA Hutton,ENG,Pace,1971-07-22,Lord's,England,1971,2,50,162,2,1,287,804,9,237,642,7,31.88888888888889,>30,ENG,Home,Upto 2014
RA Hutton,ENG,Pace,1971-08-05,Manchester,England,1971,2,51,126,2,1,409,1030,17,358,904,15,24.058823529411764,<=30,ENG,Home,Upto 2014
RA Hutton,ENG,Pace,1971-08-19,The Oval,England,1971,1,30,72,0,1,247,588,5,217,516,5,49.4,>30,ENG,Home,Upto 2014
RA Jadeja,IND,Spin,2012-12-13,Nagpur,India,2012,2,117,420,3,1,722,2045,15,605,1625,12,48.13333333333333,>30,IND,Home,Upto 2014
RA Jadeja,IND,Spin,2013-02-22,Chennai,India,2013,2,143,402,5,1,771,1539,24,628,1137,19,32.125,>30,IND,Home,Upto 2014
RA Jadeja,IND,Spin,2013-03-02,Hyderabad,India,2013,2,66,204,6,1,504,1093,21,438,889,15,24.0,<=30,IND,Home,Upto 2014
RA Jadeja,IND,Spin,2013-03-14,Mohali,India,2013,2,112,284,6,1,752,1501,18,640,1217,12,41.77777777777778,>30,IND,Home,Upto 2014
RA Jadeja,IND,Spin,2013-03-22,Delhi,India,2013,2,98,270,7,1,535,1112,29,437,842,22,18.448275862068964,<=30,IND,Home,Upto 2014
RA Jadeja,IND,Spin,2013-12-26,Durban,South Africa,2013,2,154,374,6,1,373,798,11,219,424,5,33.90909090909091,>30,SA,Away,Upto 2014
RA Jadeja,IND,Spin,2014-02-06,Auckland,New Zealand,2014,2,130,210,2,1,263,390,2,133,180,0,131.5,>30,NZ,Away,After 1965
RA Jadeja,IND,Spin,2014-02-14,Wellington,New Zealand,2014,2,127,324,1,1,170,396,1,43,72,0,170.0,>30,NZ,Away,After 1965
RA Jadeja,IND,Spin,2014-07-09,Nottingham,England,2014,1,80,210,0,1,324,594,5,244,384,5,64.8,>30,ENG,Away,After 1965
RA Jadeja,IND,Spin,2014-07-17,Lord's,England,2014,2,99,307,3,1,190,511,7,91,204,4,27.142857142857142,<=30,ENG,Away,After 1965
RA Jadeja,IND,Spin,2014-07-27,Southampton,England,2014,2,205,338,5,1,407,690,15,202,352,10,27.133333333333333,<=30,ENG,Away,After 1965
RA Jadeja,IND,Spin,2014-08-07,Manchester,England,2014,1,36,81,1,1,104,243,5,68,162,4,20.8,<=30,ENG,Away,After 1965
RA Jadeja,IND,Spin,2015-11-05,Mohali,India,2015,2,76,179,8,1,466,1004,34,390,825,26,13.705882352941176,<=30,IND,Home,After 1965
RA Jadeja,IND,Spin,2015-11-14,Bengaluru,India,2015,1,50,96,4,1,138,228,8,88,132,4,17.25,<=30,IND,Home,After 1965
RA Jadeja,IND,Spin,2015-11-25,Nagpur,India,2015,2,67,222,4,1,483,1096,33,416,874,29,14.636363636363637,<=30,IND,Home,After 1965
RA Jadeja,IND,Spin,2015-12-03,Delhi,India,2015,2,56,348,7,1,551,1517,20,495,1169,13,27.55,<=30,IND,Home,After 1965
RA Jadeja,IND,Spin,2016-08-09,Gros Islet,West Indies,2016,2,47,177,3,1,298,783,9,251,606,6,33.111111111111114,>30,WI,Away,After 1965
RA Jadeja,IND,Spin,2016-09-22,Kanpur,India,2016,2,131,408,6,1,859,1714,26,728,1306,20,33.03846153846154,>30,IND,Home,After 1965
RA Jadeja,IND,Spin,2016-09-30,Eden Gardens,India,2016,2,81,192,4,1,455,834,14,374,642,10,32.5,>30,IND,Home,After 1965
RA Jadeja,IND,Spin,2016-10-08,Indore,India,2016,2,125,264,4,1,676,1243,22,551,979,18,30.727272727272727,>30,IND,Home,After 1965
RA Jadeja,IND,Spin,2016-11-09,Rajkot,India,2016,2,133,270,3,1,954,1677,22,821,1407,19,43.36363636363637,>30,IND,Home,After 1965
RA Jadeja,IND,Spin,2016-11-17,Visakhapatnam,India,2016,2,92,378,3,1,632,1483,25,540,1105,22,25.28,<=30,IND,Home,After 1965
RA Jadeja,IND,Spin,2016-11-26,Mohali,India,2016,2,121,318,4,1,572,1216,17,451,898,13,33.64705882352941,>30,IND,Home,After 1965
RA Jadeja,IND,Spin,2016-12-08,Wankhede,India,2016,2,172,355,6,1,864,1639,27,692,1284,21,32.0,>30,IND,Home,After 1965
RA Jadeja,IND,Spin,2016-12-16,Chennai,India,2016,2,154,420,10,1,966,1770,17,812,1350,7,56.8235294117647,>30,IND,Home,After 1965
RA Jadeja,IND,Spin,2017-02-09,Hyderabad,India,2017,2,148,420,6,1,881,1634,19,733,1214,13,46.36842105263158,>30,IND,Home,After 1965
RA Jadeja,IND,Spin,2017-02-23,Pune,India,2017,2,139,342,5,1,566,1181,31,427,839,26,18.258064516129032,<=30,IND,Home,After 1965
RA Jadeja,IND,Spin,2017-03-04,Bengaluru,India,2017,2,66,178,7,1,406,1139,26,340,961,19,15.615384615384615,<=30,IND,Home,After 1965
RA Jadeja,IND,Spin,2017-03-16,Ranchi,India,2017,2,178,561,9,1,755,1725,15,577,1164,6,50.333333333333336,>30,IND,Home,After 1965
RA Jadeja,IND,Spin,2017-03-25,Dharamsala,India,2017,2,81,198,4,1,468,1025,18,387,827,14,26.0,<=30,IND,Home,After 1965
RA Jadeja,IND,Spin,2017-07-26,Galle,Sri Lanka,2017,2,138,284,6,1,734,1244,13,596,960,7,56.46153846153846,>30,SL,Away,After 1965
RA Jadeja,IND,Spin,2017-08-03,Colombo (SSC),Sri Lanka,2017,2,236,366,7,1,953,1487,21,717,1121,14,45.38095238095238,>30,SL,Away,After 1965
RA Jadeja,IND,Spin,2017-11-16,Eden Gardens,India,2017,2,8,12,0,1,123,228,3,115,216,3,41.0,>30,IND,Home,After 1965
RA Jadeja,IND,Spin,2017-11-24,Nagpur,India,2017,2,84,192,5,1,497,970,17,413,778,12,29.235294117647058,<=30,IND,Home,After 1965
RA Jadeja,IND,Spin,2017-12-02,Delhi,India,2017,2,167,498,5,1,881,1566,17,714,1068,12,51.8235294117647,>30,IND,Home,After 1965
RA Jadeja,IND,Spin,2018-06-14,Bengaluru,India,2018,2,35,77,6,1,388,572,15,353,495,9,25.866666666666667,<=30,IND,Home,After 1965
RA Jadeja,IND,Spin,2018-09-07,The Oval,England,2018,2,258,462,7,1,513,915,16,255,453,9,32.0625,>30,ENG,Away,After 1965
RA Jadeja,IND,Spin,2018-10-04,Rajkot,India,2018,2,57,119,4,1,685,1000,22,628,881,18,31.136363636363637,>30,IND,Home,After 1965
RA Jadeja,IND,Spin,2018-10-12,Hyderabad,India,2018,2,81,186,3,1,524,1095,12,443,909,9,43.666666666666664,>30,IND,Home,After 1965
RA Jadeja,IND,Spin,2018-12-26,Melbourne,Australia,2018,2,127,342,5,1,293,756,6,166,414,1,48.833333333333336,>30,AUS,Away,After 1965
RA Jadeja,IND,Spin,2019-01-03,Sydney,Australia,2019,1,73,192,2,1,448,853,11,375,661,9,40.72727272727273,>30,AUS,Away,After 1965
RA Jadeja,IND,Spin,2019-08-22,North Sound,West Indies,2019,2,106,146,2,1,347,560,8,241,414,6,43.375,>30,WI,Away,After 1965
RA Jadeja,IND,Spin,2019-08-30,Kingston,West Indies,2019,2,77,186,4,1,328,690,8,251,504,4,41.0,>30,WI,Away,After 1965
RA Jadeja,IND,Spin,2019-10-02,Visakhapatnam,India,2019,2,211,390,6,1,1062,1652,22,851,1262,16,48.27272727272727,>30,IND,Home,After 1965
RA Jadeja,IND,Spin,2019-10-10,Pune,India,2019,2,133,344,4,1,587,1113,12,454,769,8,48.916666666666664,>30,IND,Home,After 1965
RA Jadeja,IND,Spin,2019-10-19,Ranchi,India,2019,2,55,162,3,1,405,692,13,350,530,10,31.153846153846153,>30,IND,Home,After 1965
RA Jadeja,IND,Spin,2019-11-14,Indore,India,2019,2,57,102,0,1,411,632,6,354,530,6,68.5,>30,IND,Home,After 1965
RA Jadeja,IND,Spin,2019-11-22,Eden Gardens,India,2019,2,13,12,0,1,112,192,1,99,180,1,112.0,>30,IND,Home,After 1965
RA Jadeja,IND,Spin,2020-02-29,Christchurch,New Zealand,2020,2,46,90,2,1,46,90,2,0,0,0,23.0,<=30,NZ,Away,After 1965
RA Jadeja,IND,Spin,2020-12-26,Melbourne,Australia,2020,2,43,117,3,1,235,670,11,192,553,8,21.363636363636363,<=30,AUS,Away,After 1965
RA Jadeja,IND,Spin,2021-01-07,Sydney,Australia,2021,1,62,108,4,1,452,906,8,390,798,4,56.5,>30,AUS,Away,After 1965
RA Jadeja,IND,Spin,2021-06-18,Southampton,England,2021,2,45,92,1,1,90,242,5,45,150,4,18.0,<=30,ENG,Away,After 1965
RA Jadeja,IND,Spin,2021-08-04,Nottingham,England,2021,2,50,96,0,1,50,96,0,0,0,0,inf,>30,ENG,Away,After 1965
RA Jadeja,IND,Spin,2021-08-12,Lord's,England,2021,2,48,168,0,1,194,462,3,146,294,3,64.66666666666667,>30,ENG,Away,After 1965
RA Jadeja,IND,Spin,2021-08-25,Leeds,England,2021,1,88,192,2,1,147,324,3,59,132,1,49.0,>30,ENG,Away,After 1965
RA Jadeja,IND,Spin,2021-09-02,The Oval,England,2021,2,86,282,4,1,220,480,7,134,198,3,31.428571428571427,>30,ENG,Away,After 1965
RA Jadeja,IND,Spin,2021-11-25,Kanpur,India,2021,2,97,366,5,1,592,1744,20,495,1378,15,29.6,<=30,IND,Home,After 1965
RA Jadeja,IND,Spin,2022-03-04,Mohali,India,2022,2,87,174,9,1,500,927,18,413,753,9,27.77777777777778,<=30,IND,Home,After 1965
RA Jadeja,IND,Spin,2022-03-12,Bengaluru,India,2022,2,63,120,1,1,625,968,26,562,848,25,24.03846153846154,<=30,IND,Home,After 1965
RA Jadeja,IND,Spin,2022-07-01,Birmingham,England,2022,2,65,124,0,1,204,304,2,139,180,2,102.0,>30,ENG,Away,After 1965
RA Jadeja,IND,Spin,2023-02-09,Nagpur,India,2023,2,81,204,7,1,475,1061,24,394,857,17,19.791666666666668,<=30,IND,Home,After 1965
RA Jadeja,IND,Spin,2023-02-17,Delhi,India,2023,2,110,199,10,1,582,1082,28,472,883,18,20.785714285714285,<=30,IND,Home,After 1965
RA Jadeja,IND,Spin,2023-03-01,Indore,India,2023,2,101,234,4,1,438,973,26,337,739,22,16.846153846153847,<=30,IND,Home,After 1965
RA Jadeja,IND,Spin,2023-03-09,Ahmedabad,India,2023,2,123,330,1,1,725,1892,17,602,1562,16,42.64705882352941,>30,IND,Home,After 1965
RA Jadeja,IND,Spin,2023-06-07,The Oval,England,2023,2,114,246,4,1,174,363,9,60,117,5,19.333333333333332,<=30,ENG,Away,After 1965
RA Jadeja,IND,Spin,2023-07-12,Roseau,West Indies,2023,2,64,210,5,1,411,1014,20,347,804,15,20.55,<=30,WI,Away,After 1965
RA Jadeja,IND,Spin,2023-07-20,Port of Spain,West Indies,2023,2,47,180,2,1,279,750,9,232,570,7,31.0,>30,WI,Away,After 1965
RA Jadeja,IND,Spin,2024-01-25,Hyderabad,India,2024,2,219,312,5,1,1067,1778,32,848,1466,27,33.34375,>30,IND,Home,After 1965
RA Jadeja,IND,Spin,2024-02-15,Rajkot,India,2024,2,92,136,7,1,805,1288,20,713,1152,13,40.25,>30,IND,Home,After 1965
RA Jadeja,IND,Spin,2024-02-23,Ranchi,India,2024,2,123,317,5,1,670,1494,28,547,1177,23,23.928571428571427,<=30,IND,Home,After 1965
RA Jadeja,IND,Spin,2024-03-07,Dharamsala,India,2024,2,42,114,2,1,589,972,25,547,858,23,23.56,<=30,IND,Home,After 1965
RA Jadeja,IND,Spin,2024-09-19,Chennai,India,2024,2,77,139,5,1,522,763,14,445,624,9,37.285714285714285,>30,IND,Home,After 1965
RA Jadeja,IND,Spin,2024-09-27,Kanpur,India,2024,2,62,116,4,1,428,548,20,366,432,16,21.4,<=30,IND,Home,After 1965
RA Jadeja,IND,Spin,2024-10-16,Bengaluru,India,2024,2,100,166,3,1,524,637,10,424,471,7,52.4,>30,IND,Home,After 1965
RA Jadeja,IND,Spin,2024-10-24,Pune,India,2024,2,125,226,3,1,741,1336,37,616,1110,34,20.027027027027028,<=30,IND,Home,After 1965
RA Jadeja,IND,Spin,2024-11-01,Wankhede,India,2024,2,120,215,10,1,671,1028,34,551,813,24,19.735294117647058,<=30,IND,Home,After 1965
RA Jadeja,IND,Spin,2024-12-14,Brisbane,Australia,2024,1,95,138,0,1,218,365,3,123,227,3,72.66666666666667,>30,AUS,Away,After 1965
RA Jadeja,IND,Spin,2024-12-26,Melbourne,Australia,2024,2,111,222,4,1,350,730,11,239,508,7,31.818181818181817,>30,AUS,Away,After 1965
RA Jadeja,IND,Spin,2025-01-03,Sydney,Australia,2025,1,12,18,0,1,137,216,4,125,198,4,34.25,>30,AUS,Away,After 1965
RA McLean,SA,Spin,1958-02-07,Johannesburg,South Africa,1958,1,1,4,0,1,358,1230,15,357,1226,15,23.866666666666667,<=30,SA,Home,Upto 2014
RA Reifer,WI,Pace,2017-12-09,Hamilton,New Zealand,2017,2,88,180,2,1,876,1573,33,788,1393,31,26.545454545454547,<=30,NZ,Away,After 1965
RA Reifer,WI,Pace,2022-06-16,North Sound,West Indies,2022,1,17,30,0,1,515,1150,28,498,1120,28,18.392857142857142,<=30,WI,Home,After 1965
RA Reifer,WI,Pace,2022-06-24,Gros Islet,West Indies,2022,1,6,18,0,1,658,1090,26,652,1072,26,25.307692307692307,<=30,WI,Home,After 1965
RA Reifer,WI,Pace,2023-02-04,Bulawayo,Zimbabwe,2023,1,7,18,0,1,562,1122,8,555,1104,8,70.25,>30,ZIM,Away,After 1965
RA Reifer,WI,Pace,2023-03-08,Johannesburg,South Africa,2023,1,36,66,1,1,575,1146,28,539,1080,27,20.535714285714285,<=30,SA,Away,After 1965
RA Reifer,WI,Pace,2023-07-12,Roseau,West Indies,2023,1,16,24,0,1,260,590,5,244,566,5,52.0,>30,WI,Home,After 1965
RA Sinfield,ENG,Spin,1938-06-10,Nottingham,England,1938,2,123,378,2,1,958,2061,18,835,1683,16,53.22222222222222,>30,ENG,Home,Upto 2014
RA Smith,ENG,Spin,1992-01-18,Christchurch,New Zealand,1992,1,6,24,0,1,362,1021,13,356,997,13,27.846153846153847,<=30,NZ,Away,Upto 2014
RA Woolmer,ENG,Pace,1975-07-31,Lord's,England,1975,2,34,96,1,1,808,1552,18,774,1456,17,44.888888888888886,>30,ENG,Home,Upto 2014
RA Woolmer,ENG,Pace,1975-08-28,The Oval,England,1975,1,38,108,1,1,686,1764,24,648,1656,23,28.583333333333332,<=30,ENG,Home,Upto 2014
RA Woolmer,ENG,Pace,1976-06-03,Nottingham,England,1976,1,47,60,0,1,773,1761,21,726,1701,21,36.80952380952381,>30,ENG,Home,Upto 2014
RA Woolmer,ENG,Pace,1976-07-08,Manchester,England,1976,1,22,18,0,1,437,1066,29,415,1048,29,15.068965517241379,<=30,ENG,Home,Upto 2014
RA Woolmer,ENG,Pace,1976-07-22,Leeds,England,1976,2,51,78,1,1,969,1786,39,918,1708,38,24.846153846153847,<=30,ENG,Home,Upto 2014
RA Woolmer,ENG,Pace,1976-08-12,The Oval,England,1976,2,74,84,0,1,768,1323,20,694,1239,20,38.4,>30,ENG,Home,Upto 2014
RA Woolmer,ENG,Pace,1977-01-14,Chennai,India,1977,1,2,6,0,1,275,772,15,273,766,15,18.333333333333332,<=30,IND,Away,Upto 2014
RA Woolmer,ENG,Pace,1977-06-16,Lord's,England,1977,1,20,30,0,1,753,1756,32,733,1726,32,23.53125,<=30,ENG,Home,Upto 2014
RA Woolmer,ENG,Pace,1977-07-28,Nottingham,England,1977,1,3,18,0,1,788,1906,27,785,1888,27,29.185185185185187,<=30,ENG,Home,Upto 2014
RA Woolmer,ENG,Pace,1977-08-11,Leeds,England,1977,1,8,48,1,1,569,1338,25,561,1290,24,22.76,<=30,ENG,Home,Upto 2014
RAL Massie,AUS,Pace,1972-06-22,Lord's,England,1972,2,137,361,16,1,594,1418,30,457,1057,14,19.8,<=30,ENG,Away,Upto 2014
RAL Massie,AUS,Pace,1972-07-13,Nottingham,England,1972,2,92,396,5,1,670,1779,23,578,1383,18,29.130434782608695,<=30,ENG,Away,Upto 2014
RAL Massie,AUS,Pace,1972-07-27,Leeds,England,1972,1,34,84,0,1,173,528,9,139,444,9,19.22222222222222,<=30,ENG,Away,Upto 2014
RAL Massie,AUS,Pace,1972-08-10,The Oval,England,1972,2,146,354,2,1,662,1491,19,516,1137,17,34.8421052631579,>30,ENG,Away,Upto 2014
RAL Massie,AUS,Pace,1972-12-22,Adelaide,Australia,1972,2,96,264,4,1,517,1131,14,421,867,10,36.92857142857143,>30,AUS,Home,Upto 2014
RAL Massie,AUS,Pace,1973-01-06,Sydney,Australia,1973,2,142,280,4,1,767,1875,36,625,1595,32,21.305555555555557,<=30,AUS,Home,Upto 2014
RAP Nissanka,SL,Pace,2003-04-25,Colombo (PSS),Sri Lanka,2003,2,71,174,1,1,412,858,7,341,684,6,58.857142857142854,>30,SL,Home,Upto 2014
RAP Nissanka,SL,Pace,2003-05-03,Kandy,Sri Lanka,2003,2,59,161,3,1,352,866,14,293,705,11,25.142857142857142,<=30,SL,Home,Upto 2014
RAP Nissanka,SL,Pace,2003-06-20,Gros Islet,West Indies,2003,1,108,129,1,1,539,1047,9,431,918,8,59.888888888888886,>30,WI,Away,Upto 2014
RAP Nissanka,SL,Pace,2003-06-27,Kingston,West Indies,2003,2,128,123,5,1,610,1045,26,482,922,21,23.46153846153846,<=30,WI,Away,Upto 2014
RAS Lakmal,SL,Pace,2010-11-23,Colombo (RPS),Sri Lanka,2010,2,91,108,2,1,389,758,12,298,650,10,32.416666666666664,>30,SL,Home,Upto 2014
RAS Lakmal,SL,Pace,2010-12-01,Pallekele,Sri Lanka,2010,1,41,105,1,1,147,255,2,106,150,1,73.5,>30,SL,Home,Upto 2014
RAS Lakmal,SL,Pace,2011-05-26,Cardiff,England,2011,1,68,132,1,1,591,1108,14,523,976,13,42.214285714285715,>30,ENG,Away,Upto 2014
RAS Lakmal,SL,Pace,2011-06-03,Lord's,England,2011,2,196,252,3,1,1032,1597,21,836,1345,18,49.142857142857146,>30,ENG,Away,Upto 2014
RAS Lakmal,SL,Pace,2011-06-16,Southampton,England,2011,1,99,146,3,1,719,1308,21,620,1162,18,34.23809523809524,>30,ENG,Away,Upto 2014
RAS Lakmal,SL,Pace,2011-08-31,Galle,Sri Lanka,2011,2,78,150,4,1,381,906,20,303,756,16,19.05,<=30,SL,Home,Upto 2014
RAS Lakmal,SL,Pace,2011-09-08,Pallekele,Sri Lanka,2011,1,102,138,2,1,526,1180,17,424,1042,15,30.941176470588236,>30,SL,Home,Upto 2014
RAS Lakmal,SL,Pace,2011-09-16,Colombo (SSC),Sri Lanka,2011,2,146,258,2,1,825,1634,20,679,1376,18,41.25,>30,SL,Home,Upto 2014
RAS Lakmal,SL,Pace,2011-10-18,Abu Dhabi,UAE,2011,2,109,156,0,1,689,1303,17,580,1147,17,40.529411764705884,>30,UAE,Away,Upto 2014
RAS Lakmal,SL,Pace,2011-10-26,Dubai (DICS),UAE,2011,1,54,144,0,1,473,936,12,419,792,12,39.416666666666664,>30,UAE,Away,Upto 2014
RAS Lakmal,SL,Pace,2012-03-26,Galle,Sri Lanka,2012,2,67,114,1,1,355,636,9,288,522,8,39.44444444444444,>30,SL,Home,Upto 2014
RAS Lakmal,SL,Pace,2012-04-03,Colombo (PSS),Sri Lanka,2012,1,81,132,0,1,394,959,10,313,827,10,39.4,>30,SL,Home,Upto 2014
RAS Lakmal,SL,Pace,2013-01-03,Sydney,Australia,2013,2,113,180,1,1,729,1200,20,616,1020,19,36.45,>30,AUS,Away,Upto 2014
RAS Lakmal,SL,Pace,2013-03-16,Colombo (RPS),Sri Lanka,2013,2,70,150,0,1,510,982,14,440,832,14,36.42857142857143,>30,SL,Home,Upto 2014
RAS Lakmal,SL,Pace,2013-12-31,Abu Dhabi,UAE,2013,2,142,276,3,1,807,1581,20,665,1305,17,40.35,>30,UAE,Away,Upto 2014
RAS Lakmal,SL,Pace,2014-01-08,Dubai (DICS),UAE,2014,2,123,297,6,1,719,1539,21,596,1242,15,34.23809523809524,>30,UAE,Away,After 1965
RAS Lakmal,SL,Pace,2014-01-16,Sharjah,UAE,2014,2,140,210,3,1,610,1197,18,470,987,15,33.888888888888886,>30,UAE,Away,After 1965
RAS Lakmal,SL,Pace,2014-01-27,Mirpur,Bangladesh,2014,2,105,193,6,1,519,875,13,414,682,7,39.92307692307692,>30,BAN,Away,After 1965
RAS Lakmal,SL,Pace,2014-02-04,Chattogram,Bangladesh,2014,2,100,228,1,1,379,646,2,279,418,1,189.5,>30,BAN,Away,After 1965
RAS Lakmal,SL,Pace,2014-07-16,Galle,Sri Lanka,2014,2,110,252,3,1,420,962,20,310,710,17,21.0,<=30,SL,Home,After 1965
RAS Lakmal,SL,Pace,2014-07-24,Colombo (SSC),Sri Lanka,2014,2,65,162,1,1,394,782,12,329,620,11,32.833333333333336,>30,SL,Home,After 1965
RAS Lakmal,SL,Pace,2014-12-26,Christchurch,New Zealand,2014,2,106,155,3,1,757,1417,28,651,1262,25,27.035714285714285,<=30,NZ,Away,After 1965
RAS Lakmal,SL,Pace,2015-01-03,Wellington,New Zealand,2015,2,160,294,3,1,987,1835,28,827,1541,25,35.25,>30,NZ,Away,After 1965
RAS Lakmal,SL,Pace,2015-07-03,Pallekele,Sri Lanka,2015,2,112,198,1,1,740,1384,19,628,1186,18,38.94736842105263,>30,SL,Home,After 1965
RAS Lakmal,SL,Pace,2015-12-10,Dunedin,New Zealand,2015,2,109,174,2,1,942,1677,26,833,1503,24,36.23076923076923,>30,NZ,Away,After 1965
RAS Lakmal,SL,Pace,2015-12-18,Hamilton,New Zealand,2015,2,68,168,2,1,667,1250,30,599,1082,28,22.233333333333334,<=30,NZ,Away,After 1965
RAS Lakmal,SL,Pace,2016-05-27,Chester-le-Street,England,2016,2,124,192,2,1,773,1433,25,649,1241,23,30.92,>30,ENG,Away,After 1965
RAS Lakmal,SL,Pace,2016-06-09,Lord's,England,2016,2,135,240,3,1,770,1481,24,635,1241,21,32.083333333333336,>30,ENG,Away,After 1965
RAS Lakmal,SL,Pace,2016-08-13,Colombo (SSC),Sri Lanka,2016,1,54,78,1,1,336,652,8,282,574,7,42.0,>30,SL,Home,After 1965
RAS Lakmal,SL,Pace,2016-10-29,Harare,Zimbabwe,2016,2,112,275,5,1,716,1330,16,604,1055,11,44.75,>30,ZIM,Away,After 1965
RAS Lakmal,SL,Pace,2016-11-06,Harare,Zimbabwe,2016,2,113,217,2,1,650,1231,14,537,1014,12,46.42857142857143,>30,ZIM,Away,After 1965
RAS Lakmal,SL,Pace,2016-12-26,Gqeberha,South Africa,2016,2,127,270,6,1,798,1468,25,671,1198,19,31.92,>30,SA,Away,After 1965
RAS Lakmal,SL,Pace,2017-01-02,Cape Town,South Africa,2017,2,162,281,6,1,701,1233,30,539,952,24,23.366666666666667,<=30,SA,Away,After 1965
RAS Lakmal,SL,Pace,2017-01-12,Johannesburg,South Africa,2017,1,81,180,0,1,621,1136,30,540,956,30,20.7,<=30,SA,Away,After 1965
RAS Lakmal,SL,Pace,2017-03-07,Galle,Sri Lanka,2017,2,54,126,1,1,497,858,9,443,732,8,55.22222222222222,>30,SL,Home,After 1965
RAS Lakmal,SL,Pace,2017-03-15,Colombo (PSS),Sri Lanka,2017,2,97,162,2,1,356,675,9,259,513,7,39.55555555555556,>30,SL,Home,After 1965
RAS Lakmal,SL,Pace,2017-07-14,Colombo (RPS),Sri Lanka,2017,2,101,168,0,1,358,598,6,257,430,6,59.666666666666664,>30,SL,Home,After 1965
RAS Lakmal,SL,Pace,2017-09-28,Abu Dhabi,UAE,2017,2,54,162,3,1,437,1023,13,383,861,10,33.61538461538461,>30,UAE,Away,After 1965
RAS Lakmal,SL,Pace,2017-10-06,Dubai (DICS),UAE,2017,2,76,189,3,1,468,1044,16,392,855,13,29.25,<=30,UAE,Away,After 1965
RAS Lakmal,SL,Pace,2017-11-16,Eden Gardens,India,2017,2,119,262,7,1,743,1322,32,624,1060,25,23.21875,<=30,IND,Away,After 1965
RAS Lakmal,SL,Pace,2017-11-24,Nagpur,India,2017,1,111,174,0,1,472,859,9,361,685,9,52.44444444444444,>30,IND,Away,After 1965
RAS Lakmal,SL,Pace,2017-12-02,Delhi,India,2017,2,140,212,1,1,549,946,10,409,734,9,54.9,>30,IND,Away,After 1965
RAS Lakmal,SL,Pace,2018-01-31,Chattogram,Bangladesh,2018,2,93,197,3,1,301,515,4,208,318,1,75.25,>30,BAN,Away,After 1965
RAS Lakmal,SL,Pace,2018-02-08,Mirpur,Bangladesh,2018,2,36,90,3,1,102,258,8,66,168,5,12.75,<=30,BAN,Away,After 1965
RAS Lakmal,SL,Pace,2018-06-06,Port of Spain,West Indies,2018,2,87,246,3,1,624,1324,21,537,1078,18,29.714285714285715,<=30,WI,Away,After 1965
RAS Lakmal,SL,Pace,2018-06-14,Gros Islet,West Indies,2018,2,98,249,4,1,739,1498,33,641,1249,29,22.393939393939394,<=30,WI,Away,After 1965
RAS Lakmal,SL,Pace,2018-06-23,Bridgetown,West Indies,2018,2,77,183,5,1,501,1108,32,424,925,27,15.65625,<=30,WI,Away,After 1965
RAS Lakmal,SL,Pace,2018-07-12,Galle,Sri Lanka,2018,1,21,27,3,1,242,397,13,221,370,10,18.615384615384617,<=30,SL,Home,After 1965
RAS Lakmal,SL,Pace,2018-07-20,Colombo (SSC),Sri Lanka,2018,1,8,12,0,1,278,518,2,270,506,2,139.0,>30,SL,Home,After 1965
RAS Lakmal,SL,Pace,2018-11-06,Galle,Sri Lanka,2018,2,103,162,3,1,225,432,6,122,270,3,37.5,>30,SL,Home,After 1965
RAS Lakmal,SL,Pace,2018-11-14,Pallekele,Sri Lanka,2018,2,58,96,1,1,138,240,1,80,144,0,138.0,>30,SL,Home,After 1965
RAS Lakmal,SL,Pace,2018-11-23,Colombo (SSC),Sri Lanka,2018,2,40,84,0,1,145,276,4,105,192,4,36.25,>30,SL,Home,After 1965
RAS Lakmal,SL,Pace,2018-12-15,Wellington,New Zealand,2018,1,88,186,1,1,859,1641,18,771,1455,17,47.72222222222222,>30,NZ,Away,After 1965
RAS Lakmal,SL,Pace,2018-12-26,Christchurch,New Zealand,2018,2,150,294,5,1,838,1658,30,688,1364,25,27.933333333333334,<=30,NZ,Away,After 1965
RAS Lakmal,SL,Pace,2019-01-24,Brisbane,Australia,2019,1,75,162,5,1,398,892,24,323,730,19,16.583333333333332,<=30,AUS,Away,After 1965
RAS Lakmal,SL,Pace,2019-02-13,Durban,South Africa,2019,2,81,204,1,1,725,1312,28,644,1108,27,25.892857142857142,<=30,SA,Away,After 1965
RAS Lakmal,SL,Pace,2019-02-21,Gqeberha,South Africa,2019,2,72,177,4,1,552,954,24,480,777,20,23.0,<=30,SA,Away,After 1965
RAS Lakmal,SL,Pace,2019-08-14,Galle,Sri Lanka,2019,2,66,182,4,1,263,591,10,197,409,6,26.3,<=30,SL,Home,After 1965
RAS Lakmal,SL,Pace,2019-08-22,Colombo (PSS),Sri Lanka,2019,1,32,66,0,1,360,808,14,328,742,14,25.714285714285715,<=30,SL,Home,After 1965
RAS Lakmal,SL,Pace,2020-01-19,Harare,Zimbabwe,2020,2,80,282,7,1,521,1458,17,441,1176,10,30.647058823529413,>30,ZIM,Away,After 1965
RAS Lakmal,SL,Pace,2020-01-27,Harare,Zimbabwe,2020,2,71,240,3,1,441,1205,12,370,965,9,36.75,>30,ZIM,Away,After 1965
RAS Lakmal,SL,Pace,2021-01-22,Galle,Sri Lanka,2021,1,31,96,0,1,261,633,10,230,537,10,26.1,<=30,SL,Home,After 1965
RAS Lakmal,SL,Pace,2021-03-21,North Sound,West Indies,2021,2,80,300,5,1,742,1672,25,662,1372,20,29.68,<=30,WI,Away,After 1965
RAS Lakmal,SL,Pace,2021-03-29,North Sound,West Indies,2021,2,156,252,6,1,742,1513,23,586,1261,17,32.26086956521739,>30,WI,Away,After 1965
RAS Lakmal,SL,Pace,2021-04-21,Pallekele,Sri Lanka,2021,2,102,264,3,1,611,1140,12,509,876,9,50.916666666666664,>30,SL,Home,After 1965
RAS Lakmal,SL,Pace,2021-04-29,Pallekele,Sri Lanka,2021,2,44,84,2,1,391,680,8,347,596,6,48.875,>30,SL,Home,After 1965
RAS Lakmal,SL,Pace,2021-11-21,Galle,Sri Lanka,2021,1,10,36,1,1,180,408,3,170,372,2,60.0,>30,SL,Home,After 1965
RAS Lakmal,SL,Pace,2021-11-29,Galle,Sri Lanka,2021,1,22,54,0,1,123,256,1,101,202,1,123.0,>30,SL,Home,After 1965
RAS Lakmal,SL,Pace,2022-03-04,Mohali,India,2022,1,90,150,2,1,395,599,10,305,449,8,39.5,>30,IND,Away,After 1965
RAS Lakmal,SL,Pace,2022-03-12,Bengaluru,India,2022,2,46,108,1,1,203,372,12,157,264,11,16.916666666666668,<=30,IND,Away,After 1965
RB Desai,IND,Pace,1959-02-06,Delhi,India,1959,1,169,294,4,1,501,1007,14,332,713,10,35.785714285714285,>30,IND,Home,Upto 2014
RB Desai,IND,Pace,1959-06-04,Nottingham,England,1959,1,127,198,1,1,398,1106,18,271,908,17,22.11111111111111,<=30,ENG,Away,Upto 2014
RB Desai,IND,Pace,1959-06-18,Lord's,England,1959,2,118,232,6,1,428,1122,20,310,890,14,21.4,<=30,ENG,Away,Upto 2014
RB Desai,IND,Pace,1959-07-02,Leeds,England,1959,1,111,228,2,1,379,911,14,268,683,12,27.071428571428573,<=30,ENG,Away,Upto 2014
RB Desai,IND,Pace,1959-07-23,Manchester,England,1959,2,143,282,1,1,572,1208,15,429,926,14,38.13333333333333,>30,ENG,Away,Upto 2014
RB Desai,IND,Pace,1959-08-20,The Oval,England,1959,1,103,198,2,1,341,1038,21,238,840,19,16.238095238095237,<=30,ENG,Away,Upto 2014
RB Desai,IND,Pace,1959-12-12,Delhi,India,1959,1,123,207,1,1,410,963,10,287,756,9,41.0,>30,IND,Home,Upto 2014
RB Desai,IND,Pace,1960-01-13,Chennai,India,1960,1,93,246,4,1,260,780,12,167,534,8,21.666666666666668,<=30,IND,Home,Upto 2014
RB Desai,IND,Pace,1960-01-23,Eden Gardens,India,1960,2,129,282,4,1,523,1340,17,394,1058,13,30.764705882352942,>30,IND,Home,Upto 2014
RB Desai,IND,Pace,1960-12-02,Brabourne,India,1960,2,143,264,4,1,494,1042,13,351,778,9,38.0,>30,IND,Home,Upto 2014
RB Desai,IND,Pace,1960-12-16,Kanpur,India,1960,2,57,204,2,1,201,695,5,144,491,3,40.2,>30,IND,Home,Upto 2014
RB Desai,IND,Pace,1960-12-30,Eden Gardens,India,1960,2,155,306,3,1,412,1155,15,257,849,12,27.466666666666665,<=30,IND,Home,Upto 2014
RB Desai,IND,Pace,1961-01-13,Chennai,India,1961,2,80,191,4,1,342,929,6,262,738,2,57.0,>30,IND,Home,Upto 2014
RB Desai,IND,Pace,1961-02-08,Delhi,India,1961,2,190,330,8,1,579,1092,16,389,762,8,36.1875,>30,IND,Home,Upto 2014
RB Desai,IND,Pace,1961-11-11,Brabourne,India,1961,2,124,270,1,1,444,942,9,320,672,8,49.333333333333336,>30,IND,Home,Upto 2014
RB Desai,IND,Pace,1961-12-13,Delhi,India,1961,1,57,168,1,1,206,507,4,149,339,3,51.5,>30,IND,Home,Upto 2014
RB Desai,IND,Pace,1961-12-30,Eden Gardens,India,1961,2,66,162,2,1,412,930,9,346,768,7,45.77777777777778,>30,IND,Home,Upto 2014
RB Desai,IND,Pace,1962-01-10,Chennai,India,1962,2,72,96,2,1,203,330,6,131,234,4,33.833333333333336,>30,IND,Home,Upto 2014
RB Desai,IND,Pace,1962-02-16,Port of Spain,West Indies,1962,2,51,84,2,1,231,520,12,180,436,10,19.25,<=30,WI,Away,Upto 2014
RB Desai,IND,Pace,1962-03-07,Kingston,West Indies,1962,1,84,120,1,1,392,737,11,308,617,10,35.63636363636363,>30,WI,Away,Upto 2014
RB Desai,IND,Pace,1962-03-23,Bridgetown,West Indies,1962,1,25,114,0,1,296,666,7,271,552,7,42.285714285714285,>30,WI,Away,Upto 2014
RB Desai,IND,Pace,1964-01-29,Eden Gardens,India,1964,2,74,167,4,1,354,661,13,280,494,9,27.23076923076923,<=30,IND,Home,Upto 2014
RB Desai,IND,Pace,1964-02-08,Delhi,India,1964,1,23,54,0,1,223,360,2,200,306,2,111.5,>30,IND,Home,Upto 2014
RB Desai,IND,Pace,1965-03-05,Eden Gardens,India,1965,2,160,270,5,1,421,713,14,261,443,9,30.071428571428573,>30,IND,Home,Upto 2014
RB Desai,IND,Pace,1965-03-12,Brabourne,India,1965,2,74,204,7,1,334,847,20,260,643,13,16.7,<=30,IND,Home,Upto 2014
RB Desai,IND,Pace,1965-03-19,Delhi,India,1965,2,71,162,1,1,283,544,9,212,382,8,31.444444444444443,>30,IND,Home,Upto 2014
RB Desai,IND,Pace,1967-12-30,Melbourne,Australia,1967,1,63,96,0,1,704,1270,18,641,1174,18,39.111111111111114,>30,AUS,Away,Upto 2014
RB Desai,IND,Pace,1968-02-15,Dunedin,New Zealand,1968,2,76,168,2,1,426,1000,14,350,832,12,30.428571428571427,>30,NZ,Away,Upto 2014
RB Kanhai,WI,Pace,1960-01-06,Bridgetown,West Indies,1960,1,2,24,0,1,552,1376,10,550,1352,10,55.2,>30,WI,Home,Upto 2014
RB Kanhai,WI,Pace,1962-03-23,Bridgetown,West Indies,1962,1,5,12,0,1,296,666,7,291,654,7,42.285714285714285,>30,WI,Home,Upto 2014
RB Kanhai,WI,Pace,1965-05-14,Port of Spain,West Indies,1965,1,4,6,0,1,271,612,18,267,606,18,15.055555555555555,<=30,WI,Home,Upto 2014
RB Kanhai,WI,Pace,1969-01-03,Sydney,Australia,1969,1,10,8,0,1,677,1377,20,667,1369,20,33.85,>30,AUS,Away,Upto 2014
RB Kanhai,WI,Pace,1971-04-01,Bridgetown,West Indies,1971,1,1,6,0,1,478,1042,14,477,1036,14,34.142857142857146,>30,WI,Home,Upto 2014
RB Kanhai,WI,Pace,1973-03-09,Bridgetown,West Indies,1973,1,19,37,0,1,508,1217,11,489,1180,11,46.18181818181818,>30,WI,Home,Upto 2014
RB Kanhai,WI,Pace,1973-04-06,Georgetown,West Indies,1973,1,15,30,0,1,667,1551,23,652,1521,23,29.0,<=30,WI,Home,Upto 2014
RB Kanhai,WI,Pace,1973-08-09,Birmingham,England,1973,1,21,42,0,1,555,1416,18,534,1374,18,30.833333333333332,>30,ENG,Away,Upto 2014
RB Kanhai,WI,Pace,1974-02-16,Kingston,West Indies,1974,1,8,18,0,1,383,780,10,375,762,10,38.3,>30,WI,Home,Upto 2014
RB Minnett,AUS,Pace,1911-12-15,Sydney,Australia,1911,1,3,12,0,1,824,1814,23,821,1802,23,35.82608695652174,>30,AUS,Home,Upto 2014
RB Minnett,AUS,Pace,1911-12-30,Melbourne,Australia,1911,2,29,42,0,1,685,1483,24,656,1441,24,28.541666666666668,<=30,AUS,Home,Upto 2014
RB Minnett,AUS,Pace,1912-01-12,Adelaide,Australia,1912,2,66,126,2,1,730,1756,27,664,1630,25,27.037037037037038,<=30,AUS,Home,Upto 2014
RB Minnett,AUS,Pace,1912-02-09,Melbourne,Australia,1912,1,59,120,3,1,546,1146,23,487,1026,20,23.73913043478261,<=30,AUS,Home,Upto 2014
RB Minnett,AUS,Pace,1912-02-23,Sydney,Australia,1912,2,22,54,0,1,454,1009,16,432,955,16,28.375,<=30,AUS,Home,Upto 2014
RB Minnett,AUS,Pace,1912-05-27,Manchester,England,1912,1,16,36,0,1,239,566,12,223,530,12,19.916666666666668,<=30,ENG,Away,Upto 2014
RB Minnett,AUS,Pace,1912-07-15,Lord's,England,1912,1,49,90,2,1,300,697,11,251,607,9,27.272727272727273,<=30,ENG,Away,Upto 2014
RB Minnett,AUS,Pace,1912-08-05,Nottingham,England,1912,1,12,48,0,1,106,300,3,94,252,3,35.333333333333336,>30,ENG,Away,Upto 2014
RB Minnett,AUS,Pace,1912-08-19,The Oval,England,1912,1,34,61,4,1,291,877,20,257,816,16,14.55,<=30,ENG,Away,Upto 2014
RB Richardson,WI,Pace,1985-03-29,Port of Spain,West Indies,1985,1,0,6,0,1,784,1698,30,784,1692,30,26.133333333333333,<=30,WI,Home,Upto 2014
RB Richardson,WI,Pace,1985-05-04,Kingston,West Indies,1985,1,0,6,0,1,691,1483,26,691,1477,26,26.576923076923077,<=30,WI,Home,Upto 2014
RB Richardson,WI,Pace,1986-02-21,Kingston,West Indies,1986,1,5,6,0,1,543,1027,29,538,1021,29,18.724137931034484,<=30,WI,Home,Upto 2014
RB Richardson,WI,Pace,1987-02-20,Wellington,New Zealand,1987,1,4,24,0,1,656,1620,18,652,1596,18,36.44444444444444,>30,NZ,Away,Upto 2014
RB Richardson,WI,Pace,1990-04-05,Bridgetown,West Indies,1990,1,3,12,0,1,1177,2232,37,1174,2220,37,31.81081081081081,>30,WI,Home,Upto 2014
RB Richardson,WI,Pace,1991-04-05,Port of Spain,West Indies,1991,1,2,6,0,1,449,1209,20,447,1203,20,22.45,<=30,WI,Home,Upto 2014
RB Richardson,WI,Pace,1993-01-02,Sydney,Australia,1993,1,4,6,0,1,568,1162,8,564,1156,8,71.0,>30,AUS,Away,Upto 2014
RB Simpson,AUS,Spin,1960-12-09,Brisbane,Australia,1960,2,43,120,3,1,778,1958,13,735,1838,10,59.84615384615385,>30,AUS,Home,Upto 2014
RB Simpson,AUS,Spin,1960-12-30,Melbourne,Australia,1960,2,24,72,0,1,443,1051,13,419,979,13,34.07692307692308,>30,AUS,Home,Upto 2014
RB Simpson,AUS,Spin,1961-01-13,Sydney,Australia,1961,2,27,48,0,1,670,1732,26,643,1684,26,25.76923076923077,<=30,AUS,Home,Upto 2014
RB Simpson,AUS,Spin,1961-01-27,Adelaide,Australia,1961,1,17,40,0,1,1001,2526,24,984,2486,24,41.708333333333336,>30,AUS,Home,Upto 2014
RB Simpson,AUS,Spin,1961-02-10,Melbourne,Australia,1961,2,106,288,3,1,762,2498,25,656,2210,22,30.48,>30,AUS,Home,Upto 2014
RB Simpson,AUS,Spin,1961-06-08,Birmingham,England,1961,1,87,204,1,1,367,819,8,280,615,7,45.875,>30,ENG,Away,Upto 2014
RB Simpson,AUS,Spin,1961-06-22,Lord's,England,1961,1,32,114,1,1,96,339,2,64,225,1,48.0,>30,ENG,Away,Upto 2014
RB Simpson,AUS,Spin,1961-07-06,Leeds,England,1961,1,47,84,0,1,330,840,7,283,756,7,47.142857142857146,>30,ENG,Away,Upto 2014
RB Simpson,AUS,Spin,1961-07-27,Manchester,England,1961,2,44,118,5,1,285,796,15,241,678,10,19.0,<=30,ENG,Away,Upto 2014
RB Simpson,AUS,Spin,1961-08-17,The Oval,England,1961,2,19,36,0,1,415,906,9,396,870,9,46.111111111111114,>30,ENG,Away,Upto 2014
RB Simpson,AUS,Spin,1962-11-30,Brisbane,Australia,1962,2,100,200,1,1,507,1344,11,407,1144,10,46.09090909090909,>30,AUS,Home,Upto 2014
RB Simpson,AUS,Spin,1962-12-29,Melbourne,Australia,1962,2,44,72,0,1,341,714,6,297,642,6,56.833333333333336,>30,AUS,Home,Upto 2014
RB Simpson,AUS,Spin,1963-01-11,Sydney,Australia,1963,2,62,152,5,1,280,848,15,218,696,10,18.666666666666668,<=30,AUS,Home,Upto 2014
RB Simpson,AUS,Spin,1963-01-25,Adelaide,Australia,1963,2,90,144,1,1,524,1033,6,434,889,5,87.33333333333333,>30,AUS,Home,Upto 2014
RB Simpson,AUS,Spin,1963-02-15,Sydney,Australia,1963,2,73,176,1,1,588,2042,17,515,1866,16,34.588235294117645,>30,AUS,Home,Upto 2014
RB Simpson,AUS,Spin,1963-12-06,Brisbane,Australia,1963,1,52,149,1,1,346,1069,8,294,920,7,43.25,>30,AUS,Home,Upto 2014
RB Simpson,AUS,Spin,1964-01-01,Melbourne,Australia,1964,1,31,96,0,1,262,721,5,231,625,5,52.4,>30,AUS,Home,Upto 2014
RB Simpson,AUS,Spin,1964-01-10,Sydney,Australia,1964,2,80,256,1,1,363,985,5,283,729,4,72.6,>30,AUS,Home,Upto 2014
RB Simpson,AUS,Spin,1964-01-24,Adelaide,Australia,1964,1,59,80,1,1,269,512,2,210,432,1,134.5,>30,AUS,Home,Upto 2014
RB Simpson,AUS,Spin,1964-06-18,Lord's,England,1964,1,51,126,0,1,149,558,5,98,432,5,29.8,<=30,ENG,Away,Upto 2014
RB Simpson,AUS,Spin,1964-07-02,Leeds,England,1964,2,35,36,0,1,349,1116,11,314,1080,11,31.727272727272727,>30,ENG,Away,Upto 2014
RB Simpson,AUS,Spin,1964-07-23,Manchester,England,1964,1,59,114,0,1,477,1315,3,418,1201,3,159.0,>30,ENG,Away,Upto 2014
RB Simpson,AUS,Spin,1964-08-13,The Oval,England,1964,1,14,84,1,1,191,690,2,177,606,1,95.5,>30,ENG,Away,Upto 2014
RB Simpson,AUS,Spin,1964-10-02,Chennai,India,1964,2,32,102,0,1,735,1918,23,703,1816,23,31.956521739130434,>30,IND,Away,Upto 2014
RB Simpson,AUS,Spin,1964-10-10,Brabourne,India,1964,2,74,222,2,1,796,2173,26,722,1951,24,30.615384615384617,>30,IND,Away,Upto 2014
RB Simpson,AUS,Spin,1964-10-17,Eden Gardens,India,1964,1,45,168,4,1,407,1253,16,362,1085,12,25.4375,<=30,IND,Away,Upto 2014
RB Simpson,AUS,Spin,1964-10-24,Karachi,Pakistan,1964,2,116,300,1,1,840,2130,18,724,1830,17,46.666666666666664,>30,PAK,Away,Upto 2014
RB Simpson,AUS,Spin,1964-12-04,Melbourne,Australia,1964,1,21,72,0,1,473,1030,6,452,958,6,78.83333333333333,>30,AUS,Home,Upto 2014
RB Simpson,AUS,Spin,1965-03-03,Kingston,West Indies,1965,2,51,114,1,1,482,1161,15,431,1047,14,32.13333333333333,>30,WI,Away,Upto 2014
RB Simpson,AUS,Spin,1965-03-26,Port of Spain,West Indies,1965,2,111,269,4,1,736,1898,17,625,1629,13,43.294117647058826,>30,WI,Away,Upto 2014
RB Simpson,AUS,Spin,1965-04-14,Georgetown,West Indies,1965,2,42,144,0,1,385,975,21,343,831,21,18.333333333333332,<=30,WI,Away,Upto 2014
RB Simpson,AUS,Spin,1965-05-05,Bridgetown,West Indies,1965,2,59,144,0,1,856,1946,10,797,1802,10,85.6,>30,WI,Away,Upto 2014
RB Simpson,AUS,Spin,1965-12-30,Melbourne,Australia,1965,1,61,128,0,1,661,1476,9,600,1348,9,73.44444444444444,>30,AUS,Home,Upto 2014
RB Simpson,AUS,Spin,1966-02-11,Melbourne,Australia,1966,1,20,40,0,1,369,880,3,349,840,3,123.0,>30,AUS,Home,Upto 2014
RB Simpson,AUS,Spin,1966-12-23,Johannesburg,South Africa,1966,2,76,121,4,1,549,1041,11,473,920,7,49.90909090909091,>30,SA,Away,Upto 2014
RB Simpson,AUS,Spin,1966-12-31,Cape Town,South Africa,1966,2,158,378,4,1,643,1501,10,485,1123,6,64.3,>30,SA,Away,Upto 2014
RB Simpson,AUS,Spin,1967-01-20,Durban,South Africa,1967,1,21,24,0,1,209,570,4,188,546,4,52.25,>30,SA,Away,Upto 2014
RB Simpson,AUS,Spin,1967-02-03,Johannesburg,South Africa,1967,1,33,36,1,1,91,210,4,58,174,3,22.75,<=30,SA,Away,Upto 2014
RB Simpson,AUS,Spin,1967-02-24,Gqeberha,South Africa,1967,2,23,78,1,1,222,502,6,199,424,5,37.0,>30,SA,Away,Upto 2014
RB Simpson,AUS,Spin,1967-12-23,Adelaide,Australia,1967,2,67,136,1,1,620,1381,10,553,1245,9,62.0,>30,AUS,Home,Upto 2014
RB Simpson,AUS,Spin,1967-12-30,Melbourne,Australia,1967,2,49,128,4,1,312,712,11,263,584,7,28.363636363636363,<=30,AUS,Home,Upto 2014
RB Simpson,AUS,Spin,1968-01-26,Sydney,Australia,1968,2,97,344,8,1,552,1735,27,455,1391,19,20.444444444444443,<=30,AUS,Home,Upto 2014
RB Simpson,AUS,Spin,1977-12-02,Brisbane,Australia,1977,1,22,32,0,1,389,908,12,367,876,12,32.416666666666664,>30,AUS,Home,Upto 2014
RB Simpson,AUS,Spin,1977-12-16,W.A.C.A,Australia,1977,2,91,152,2,1,719,1592,15,628,1440,13,47.93333333333333,>30,AUS,Home,Upto 2014
RB Simpson,AUS,Spin,1977-12-30,Melbourne,Australia,1977,2,33,48,1,1,349,802,20,316,754,19,17.45,<=30,AUS,Home,Upto 2014
RB Simpson,AUS,Spin,1978-01-07,Sydney,Australia,1978,1,34,32,0,1,426,1124,16,392,1092,16,26.625,<=30,AUS,Home,Upto 2014
RB Simpson,AUS,Spin,1978-01-28,Adelaide,Australia,1978,2,103,260,1,1,820,1960,16,717,1700,15,51.25,>30,AUS,Home,Upto 2014
RB Simpson,AUS,Spin,1978-03-03,Port of Spain,West Indies,1978,1,65,96,0,1,269,461,9,204,365,9,29.88888888888889,<=30,WI,Away,Upto 2014
RB Simpson,AUS,Spin,1978-03-17,Bridgetown,West Indies,1978,1,30,42,1,1,226,371,4,196,329,3,56.5,>30,WI,Away,Upto 2014
RB Simpson,AUS,Spin,1978-03-31,Georgetown,West Indies,1978,2,104,162,2,1,414,708,7,310,546,5,59.142857142857146,>30,WI,Away,Upto 2014
RB Simpson,AUS,Spin,1978-04-15,Port of Spain,West Indies,1978,2,85,174,3,1,493,1205,23,408,1031,20,21.434782608695652,<=30,WI,Away,Upto 2014
RB Simpson,AUS,Spin,1978-04-28,Kingston,West Indies,1978,2,82,126,1,1,606,1484,19,524,1358,18,31.894736842105264,>30,WI,Away,Upto 2014
RC Blunt,NZ,Spin,1930-01-10,Christchurch,New Zealand,1930,2,34,109,5,1,139,270,9,105,161,4,15.444444444444445,<=30,NZ,Home,Upto 2014
RC Blunt,NZ,Spin,1930-01-24,Wellington,New Zealand,1930,2,56,102,1,1,379,753,13,323,651,12,29.153846153846153,<=30,NZ,Home,Upto 2014
RC Blunt,NZ,Spin,1930-02-14,Auckland,New Zealand,1930,1,16,36,0,1,274,396,3,258,360,3,91.33333333333333,>30,NZ,Home,Upto 2014
RC Blunt,NZ,Spin,1930-02-21,Auckland,New Zealand,1930,2,65,147,3,1,488,1141,10,423,994,7,48.8,>30,NZ,Home,Upto 2014
RC Blunt,NZ,Spin,1931-06-27,Lord's,England,1931,2,178,360,1,1,753,1396,20,575,1036,19,37.65,>30,ENG,Away,Upto 2014
RC Blunt,NZ,Spin,1931-07-29,The Oval,England,1931,1,2,6,0,1,591,1465,18,589,1459,18,32.833333333333336,>30,ENG,Away,Upto 2014
RC Blunt,NZ,Spin,1931-08-15,Manchester,England,1931,1,12,6,0,1,146,258,2,134,252,2,73.0,>30,ENG,Away,Upto 2014
RC Blunt,NZ,Spin,1932-02-27,Christchurch,New Zealand,1932,1,60,96,2,1,356,669,15,296,573,13,23.733333333333334,<=30,NZ,Home,Upto 2014
RC Blunt,NZ,Spin,1932-03-04,Wellington,New Zealand,1932,2,49,74,0,1,627,1075,19,578,1001,19,33.0,>30,NZ,Home,Upto 2014
RC Fredericks,WI,Spin,1971-03-19,Georgetown,West Indies,1971,1,9,24,0,1,785,2232,14,776,2208,14,56.07142857142857,>30,WI,Home,Upto 2014
RC Fredericks,WI,Spin,1971-04-01,Bridgetown,West Indies,1971,1,1,6,0,1,692,1614,11,691,1608,11,62.90909090909091,>30,WI,Home,Upto 2014
RC Fredericks,WI,Spin,1972-02-16,Kingston,West Indies,1972,2,19,48,0,1,653,1794,11,634,1746,11,59.36363636363637,>30,WI,Home,Upto 2014
RC Fredericks,WI,Spin,1972-03-09,Port of Spain,West Indies,1972,2,9,54,0,1,722,2183,14,713,2129,14,51.57142857142857,>30,WI,Home,Upto 2014
RC Fredericks,WI,Spin,1972-03-23,Bridgetown,West Indies,1972,1,7,12,0,1,454,1224,7,447,1212,7,64.85714285714286,>30,WI,Home,Upto 2014
RC Fredericks,WI,Spin,1972-04-20,Port of Spain,West Indies,1972,1,2,12,0,1,509,1648,17,507,1636,17,29.941176470588236,<=30,WI,Home,Upto 2014
RC Fredericks,WI,Spin,1973-02-16,Kingston,West Indies,1973,1,9,6,0,1,500,1086,7,491,1080,7,71.42857142857143,>30,WI,Home,Upto 2014
RC Fredericks,WI,Spin,1973-03-09,Bridgetown,West Indies,1973,1,3,6,0,1,470,1314,10,467,1308,10,47.0,>30,WI,Home,Upto 2014
RC Fredericks,WI,Spin,1973-04-21,Port of Spain,West Indies,1973,1,7,12,0,1,694,1730,21,687,1718,21,33.04761904761905,>30,WI,Home,Upto 2014
RC Fredericks,WI,Spin,1973-08-09,Birmingham,England,1973,1,23,24,0,1,511,1445,13,488,1421,13,39.30769230769231,>30,ENG,Away,Upto 2014
RC Fredericks,WI,Spin,1974-02-02,Port of Spain,West Indies,1974,1,24,60,0,1,671,1657,22,647,1597,22,30.5,>30,WI,Home,Upto 2014
RC Fredericks,WI,Spin,1974-02-16,Kingston,West Indies,1974,2,28,60,0,1,880,2436,16,852,2376,16,55.0,>30,WI,Home,Upto 2014
RC Fredericks,WI,Spin,1974-03-06,Bridgetown,West Indies,1974,2,29,54,0,1,534,1195,11,505,1141,11,48.54545454545455,>30,WI,Home,Upto 2014
RC Fredericks,WI,Spin,1974-03-22,Georgetown,West Indies,1974,1,12,30,1,1,367,917,8,355,887,7,45.875,>30,WI,Home,Upto 2014
RC Fredericks,WI,Spin,1974-12-11,Delhi,India,1974,1,12,12,0,1,662,1469,18,650,1457,18,36.77777777777778,>30,IND,Away,Upto 2014
RC Fredericks,WI,Spin,1974-12-27,Eden Gardens,India,1974,2,25,60,1,1,505,1382,15,480,1322,14,33.666666666666664,>30,IND,Away,Upto 2014
RC Fredericks,WI,Spin,1975-01-11,Chennai,India,1975,1,8,30,0,1,340,944,19,332,914,19,17.894736842105264,<=30,IND,Away,Upto 2014
RC Fredericks,WI,Spin,1975-01-23,Wankhede,India,1975,2,29,54,0,1,833,1734,13,804,1680,13,64.07692307692308,>30,IND,Away,Upto 2014
RC Fredericks,WI,Spin,1975-03-01,Karachi,Pakistan,1975,2,49,104,1,1,404,1072,11,355,968,10,36.72727272727273,>30,PAK,Away,Upto 2014
RC Fredericks,WI,Spin,1975-11-28,Brisbane,Australia,1975,1,12,16,0,1,448,1067,12,436,1051,12,37.333333333333336,>30,AUS,Away,Upto 2014
RC Fredericks,WI,Spin,1975-12-12,W.A.C.A,Australia,1975,1,2,8,0,1,157,364,1,155,356,1,157.0,>30,AUS,Away,Upto 2014
RC Fredericks,WI,Spin,1976-01-23,Adelaide,Australia,1976,1,5,8,0,1,343,701,9,338,693,9,38.111111111111114,>30,AUS,Away,Upto 2014
RC Fredericks,WI,Spin,1976-01-31,Melbourne,Australia,1976,2,43,72,1,1,294,648,6,251,576,5,49.0,>30,AUS,Away,Upto 2014
RC Fredericks,WI,Spin,1976-03-10,Bridgetown,West Indies,1976,1,1,6,0,1,501,996,16,500,990,16,31.3125,>30,WI,Home,Upto 2014
RC Fredericks,WI,Spin,1976-04-07,Port of Spain,West Indies,1976,1,1,12,0,1,858,2099,21,857,2087,21,40.857142857142854,>30,WI,Home,Upto 2014
RC Fredericks,WI,Spin,1976-04-21,Kingston,West Indies,1976,1,8,18,0,1,368,831,11,360,813,11,33.45454545454545,>30,WI,Home,Upto 2014
RC Fredericks,WI,Spin,1976-06-03,Nottingham,England,1976,2,45,106,1,1,293,652,6,248,546,5,48.833333333333336,>30,ENG,Away,Upto 2014
RC Fredericks,WI,Spin,1976-07-22,Leeds,England,1976,1,5,18,0,1,146,192,0,141,174,0,inf,>30,ENG,Away,Upto 2014
RC Fredericks,WI,Spin,1976-08-12,The Oval,England,1976,2,69,138,0,1,635,1217,8,566,1079,8,79.375,>30,ENG,Away,Upto 2014
RC Fredericks,WI,Spin,1977-02-18,Bridgetown,West Indies,1977,1,4,6,0,1,180,418,4,176,412,4,45.0,>30,WI,Home,Upto 2014
RC Fredericks,WI,Spin,1977-03-04,Port of Spain,West Indies,1977,1,14,36,1,1,450,1050,10,436,1014,9,45.0,>30,WI,Home,Upto 2014
RC Fredericks,WI,Spin,1977-03-18,Georgetown,West Indies,1977,1,33,69,1,1,174,438,6,141,369,5,29.0,<=30,WI,Home,Upto 2014
RC Fredericks,WI,Spin,1977-04-01,Port of Spain,West Indies,1977,1,1,6,0,1,392,967,20,391,961,20,19.6,<=30,WI,Home,Upto 2014
RC Irani,ENG,Pace,1996-06-06,Birmingham,England,1996,2,43,54,1,1,677,1326,30,634,1272,29,22.566666666666666,<=30,ENG,Home,Upto 2014
RC Irani,ENG,Pace,1996-06-20,Lord's,England,1996,1,31,72,1,1,826,2028,26,795,1956,25,31.76923076923077,>30,ENG,Home,Upto 2014
RC Irani,ENG,Pace,1999-08-19,The Oval,England,1999,1,38,66,1,1,501,1268,29,463,1202,28,17.275862068965516,<=30,ENG,Home,Upto 2014
RC Miller,WI,Pace,1953-03-11,Georgetown,West Indies,1953,1,28,96,0,1,150,444,4,122,348,4,37.5,>30,WI,Home,Upto 2014
RC Motz,NZ,Pace,1961-12-08,Durban,South Africa,1961,2,115,258,5,1,481,1242,23,366,984,18,20.91304347826087,<=30,SA,Away,Upto 2014
RC Motz,NZ,Pace,1961-12-26,Johannesburg,South Africa,1961,2,138,264,6,1,549,1269,21,411,1005,15,26.142857142857142,<=30,SA,Away,Upto 2014
RC Motz,NZ,Pace,1962-01-01,Cape Town,South Africa,1962,2,99,210,1,1,494,1176,15,395,966,14,32.93333333333333,>30,SA,Away,Upto 2014
RC Motz,NZ,Pace,1962-02-02,Johannesburg,South Africa,1962,1,86,158,3,1,533,1091,23,447,933,20,23.17391304347826,<=30,SA,Away,Upto 2014
RC Motz,NZ,Pace,1962-02-16,Gqeberha,South Africa,1962,2,67,204,4,1,563,1365,25,496,1161,21,22.52,<=30,SA,Away,Upto 2014
RC Motz,NZ,Pace,1963-02-23,Auckland,New Zealand,1963,1,98,252,0,1,301,863,11,203,611,11,27.363636363636363,<=30,NZ,Home,Upto 2014
RC Motz,NZ,Pace,1963-03-15,Christchurch,New Zealand,1963,2,101,239,3,1,462,1331,21,361,1092,18,22.0,<=30,NZ,Home,Upto 2014
RC Motz,NZ,Pace,1964-02-21,Wellington,New Zealand,1964,2,121,240,2,1,514,1667,18,393,1427,16,28.555555555555557,<=30,NZ,Home,Upto 2014
RC Motz,NZ,Pace,1964-02-28,Dunedin,New Zealand,1964,1,23,36,0,1,306,1085,13,283,1049,13,23.53846153846154,<=30,NZ,Home,Upto 2014
RC Motz,NZ,Pace,1965-01-22,Wellington,New Zealand,1965,2,79,210,7,1,362,972,24,283,762,17,15.083333333333334,<=30,NZ,Home,Upto 2014
RC Motz,NZ,Pace,1965-01-29,Auckland,New Zealand,1965,2,30,108,0,1,296,863,12,266,755,12,24.666666666666668,<=30,NZ,Home,Upto 2014
RC Motz,NZ,Pace,1965-02-12,Christchurch,New Zealand,1965,2,91,210,3,1,416,1052,17,325,842,14,24.470588235294116,<=30,NZ,Home,Upto 2014
RC Motz,NZ,Pace,1965-02-27,Chennai,India,1965,2,144,294,3,1,302,707,5,158,413,2,60.4,>30,IND,Away,Upto 2014
RC Motz,NZ,Pace,1965-03-05,Eden Gardens,India,1965,1,74,126,1,1,421,713,14,347,587,13,30.071428571428573,>30,IND,Away,Upto 2014
RC Motz,NZ,Pace,1965-03-12,Brabourne,India,1965,2,93,268,3,1,334,847,20,241,579,17,16.7,<=30,IND,Away,Upto 2014
RC Motz,NZ,Pace,1965-04-09,Karachi,Pakistan,1965,1,35,132,2,1,333,774,10,298,642,8,33.3,>30,PAK,Away,Upto 2014
RC Motz,NZ,Pace,1965-05-27,Birmingham,England,1965,2,142,336,5,1,468,1202,15,326,866,10,31.2,>30,ENG,Away,Upto 2014
RC Motz,NZ,Pace,1965-06-17,Lord's,England,1965,2,107,234,5,1,637,1471,22,530,1237,17,28.954545454545453,<=30,ENG,Away,Upto 2014
RC Motz,NZ,Pace,1965-07-08,Leeds,England,1965,1,140,246,1,1,607,1237,14,467,991,13,43.357142857142854,>30,ENG,Away,Upto 2014
RC Motz,NZ,Pace,1966-02-25,Christchurch,New Zealand,1966,2,121,306,4,1,629,1668,27,508,1362,23,23.296296296296298,<=30,NZ,Home,Upto 2014
RC Motz,NZ,Pace,1966-03-04,Dunedin,New Zealand,1966,1,76,192,2,1,364,1194,18,288,1002,16,20.22222222222222,<=30,NZ,Home,Upto 2014
RC Motz,NZ,Pace,1966-03-11,Auckland,New Zealand,1966,2,74,186,1,1,459,1620,21,385,1434,20,21.857142857142858,<=30,NZ,Home,Upto 2014
RC Motz,NZ,Pace,1968-02-15,Dunedin,New Zealand,1968,2,125,270,5,1,426,1000,14,301,730,9,30.428571428571427,>30,NZ,Home,Upto 2014
RC Motz,NZ,Pace,1968-02-22,Christchurch,New Zealand,1968,2,100,210,6,1,471,977,17,371,767,11,27.705882352941178,<=30,NZ,Home,Upto 2014
RC Motz,NZ,Pace,1968-02-29,Wellington,New Zealand,1968,2,83,138,0,1,330,661,9,247,523,9,36.666666666666664,>30,NZ,Home,Upto 2014
RC Motz,NZ,Pace,1968-03-07,Auckland,New Zealand,1968,2,95,256,4,1,377,874,14,282,618,10,26.928571428571427,<=30,NZ,Home,Upto 2014
RC Motz,NZ,Pace,1969-02-27,Auckland,New Zealand,1969,2,155,248,4,1,544,1153,15,389,905,11,36.266666666666666,>30,NZ,Home,Upto 2014
RC Motz,NZ,Pace,1969-03-07,Wellington,New Zealand,1969,2,113,248,8,1,575,1263,24,462,1015,16,23.958333333333332,<=30,NZ,Home,Upto 2014
RC Motz,NZ,Pace,1969-03-13,Christchurch,New Zealand,1969,1,113,216,5,1,436,944,10,323,728,5,43.6,>30,NZ,Home,Upto 2014
RC Motz,NZ,Pace,1969-07-24,Lord's,England,1969,2,124,352,4,1,463,1142,17,339,790,13,27.235294117647058,<=30,ENG,Away,Upto 2014
RC Motz,NZ,Pace,1969-08-07,Nottingham,England,1969,1,97,216,2,1,534,1193,14,437,977,12,38.142857142857146,>30,ENG,Away,Upto 2014
RC Motz,NZ,Pace,1969-08-21,The Oval,England,1969,2,89,171,1,1,397,1023,15,308,852,14,26.466666666666665,<=30,ENG,Away,Upto 2014
RC Saxena,IND,Spin,1967-06-08,Leeds,England,1967,1,11,12,0,1,861,2089,19,850,2077,19,45.31578947368421,>30,ENG,Away,Upto 2014
RC Shukla,IND,Spin,1982-09-17,Chennai,India,1982,2,152,294,2,1,682,1194,13,530,900,11,52.46153846153846,>30,IND,Home,Upto 2014
RD Jackman,ENG,Pace,1981-03-13,Bridgetown,West Indies,1981,2,141,282,5,1,801,1640,34,660,1358,29,23.558823529411764,<=30,WI,Away,Upto 2014
RD Jackman,ENG,Pace,1981-04-10,Kingston,West Indies,1981,1,57,158,1,1,705,1477,22,648,1319,21,32.04545454545455,>30,WI,Away,Upto 2014
RD Jackman,ENG,Pace,1982-08-12,Lord's,England,1982,2,132,240,4,1,700,1644,21,568,1404,17,33.333333333333336,>30,ENG,Home,Upto 2014
RD Jackman,ENG,Pace,1982-08-26,Leeds,England,1982,2,115,390,4,1,717,1887,34,602,1497,30,21.08823529411765,<=30,ENG,Home,Upto 2014
RD King,WI,Pace,1999-01-15,Centurion,South Africa,1999,2,130,168,0,1,776,1416,26,646,1248,26,29.846153846153847,<=30,SA,Away,Upto 2014
RD King,WI,Pace,1999-12-16,Hamilton,New Zealand,1999,1,81,158,4,1,615,1231,21,534,1073,17,29.285714285714285,<=30,NZ,Away,Upto 2014
RD King,WI,Pace,1999-12-26,Wellington,New Zealand,1999,1,96,216,4,1,571,1324,20,475,1108,16,28.55,<=30,NZ,Away,Upto 2014
RD King,WI,Pace,2000-03-16,Port of Spain,West Indies,2000,2,82,174,1,1,483,1518,30,401,1344,29,16.1,<=30,WI,Home,Upto 2014
RD King,WI,Pace,2000-03-24,Kingston,West Indies,2000,2,81,198,7,1,544,1582,25,463,1384,18,21.76,<=30,WI,Home,Upto 2014
RD King,WI,Pace,2000-05-05,Georgetown,West Indies,2000,1,57,156,2,1,344,903,13,287,747,11,26.46153846153846,<=30,WI,Home,Upto 2014
RD King,WI,Pace,2000-05-18,Bridgetown,West Indies,2000,2,138,276,5,1,788,1618,23,650,1342,18,34.26086956521739,>30,WI,Home,Upto 2014
RD King,WI,Pace,2000-05-25,St John's,West Indies,2000,2,96,234,5,1,652,1622,32,556,1388,27,20.375,<=30,WI,Home,Upto 2014
RD King,WI,Pace,2000-06-15,Birmingham,England,2000,2,88,139,5,1,606,1373,25,518,1234,20,24.24,<=30,ENG,Away,Upto 2014
RD King,WI,Pace,2000-06-29,Lord's,England,2000,2,41,108,1,1,573,1340,36,532,1232,35,15.916666666666666,<=30,ENG,Away,Upto 2014
RD King,WI,Pace,2000-08-03,Manchester,England,2000,2,67,90,2,1,672,1537,23,605,1447,21,29.217391304347824,<=30,ENG,Away,Upto 2014
RD King,WI,Pace,2000-08-17,Leeds,England,2000,1,48,66,0,1,405,817,24,357,751,24,16.875,<=30,ENG,Away,Upto 2014
RD King,WI,Pace,2001-07-19,Bulawayo,Zimbabwe,2001,2,98,244,6,1,603,1276,18,505,1032,12,33.5,>30,ZIM,Away,Upto 2014
RD King,WI,Pace,2001-07-27,Harare,Zimbabwe,2001,2,119,258,2,1,709,1347,18,590,1089,16,39.388888888888886,>30,ZIM,Away,Upto 2014
RD King,WI,Pace,2005-03-31,Georgetown,West Indies,2005,2,102,240,4,1,687,1530,15,585,1290,11,45.8,>30,WI,Home,Upto 2014
RD King,WI,Pace,2005-04-08,Port of Spain,West Indies,2005,2,78,227,1,1,854,1820,25,776,1593,24,34.16,>30,WI,Home,Upto 2014
RD King,WI,Pace,2005-04-21,Bridgetown,West Indies,2005,1,80,180,1,1,712,1449,24,632,1269,23,29.666666666666668,<=30,WI,Home,Upto 2014
RD King,WI,Pace,2005-05-26,Bridgetown,West Indies,2005,2,116,136,2,1,722,1198,25,606,1062,23,28.88,<=30,WI,Home,Upto 2014
RD King,WI,Pace,2005-06-03,Kingston,West Indies,2005,2,135,174,1,1,832,1351,29,697,1177,28,28.689655172413794,<=30,WI,Home,Upto 2014
RDB Croft,ENG,Spin,1996-08-22,The Oval,England,1996,2,125,286,2,1,418,892,11,293,606,9,38.0,>30,ENG,Home,Upto 2014
RDB Croft,ENG,Spin,1996-12-18,Bulawayo,Zimbabwe,1996,2,139,462,5,1,518,1335,18,379,873,13,28.77777777777778,<=30,ZIM,Away,Upto 2014
RDB Croft,ENG,Spin,1996-12-26,Harare,Zimbabwe,1996,1,39,90,3,1,217,642,8,178,552,5,27.125,<=30,ZIM,Away,Upto 2014
RDB Croft,ENG,Spin,1997-02-06,Wellington,New Zealand,1997,1,19,120,3,1,215,621,7,196,501,4,30.714285714285715,>30,NZ,Away,Upto 2014
RDB Croft,ENG,Spin,1997-02-14,Christchurch,New Zealand,1997,2,143,421,7,1,333,1099,15,190,678,8,22.2,<=30,NZ,Away,Upto 2014
RDB Croft,ENG,Spin,1997-06-05,Birmingham,England,1997,1,125,258,3,1,306,577,5,181,319,2,61.2,>30,ENG,Home,Upto 2014
RDB Croft,ENG,Spin,1997-06-19,Lord's,England,1997,1,30,72,1,1,115,246,3,85,174,2,38.333333333333336,>30,ENG,Home,Upto 2014
RDB Croft,ENG,Spin,1997-07-03,Manchester,England,1997,2,118,258,2,1,277,718,12,159,460,10,23.083333333333332,<=30,ENG,Home,Upto 2014
RDB Croft,ENG,Spin,1997-07-24,Leeds,England,1997,1,49,108,0,1,104,240,1,55,132,1,104.0,>30,ENG,Home,Upto 2014
RDB Croft,ENG,Spin,1997-08-07,Nottingham,England,1997,2,117,275,2,1,246,563,9,129,288,7,27.333333333333332,<=30,ENG,Home,Upto 2014
RDB Croft,ENG,Spin,1998-02-27,Georgetown,West Indies,1998,2,139,349,6,1,391,1045,18,252,696,12,21.72222222222222,<=30,WI,Away,Upto 2014
RDB Croft,ENG,Spin,1998-06-04,Birmingham,England,1998,1,85,162,0,1,204,487,5,119,325,5,40.8,>30,ENG,Home,Upto 2014
RDB Croft,ENG,Spin,1998-06-18,Lord's,England,1998,1,23,54,0,1,85,192,3,62,138,3,28.333333333333332,<=30,ENG,Home,Upto 2014
RDB Croft,ENG,Spin,1998-07-02,Manchester,England,1998,1,103,306,0,1,380,1050,6,277,744,6,63.333333333333336,>30,ENG,Home,Upto 2014
RDB Croft,ENG,Spin,1998-11-20,Brisbane,Australia,1998,2,126,258,2,1,328,690,9,202,432,7,36.44444444444444,>30,AUS,Away,Upto 2014
RDB Croft,ENG,Spin,2000-06-15,Birmingham,England,2000,1,53,174,2,1,62,210,4,9,36,2,15.5,<=30,ENG,Home,Upto 2014
RDB Croft,ENG,Spin,2000-08-03,Manchester,England,2000,1,124,282,1,1,254,606,4,130,324,3,63.5,>30,ENG,Home,Upto 2014
RDB Croft,ENG,Spin,2001-02-22,Galle,Sri Lanka,2001,1,96,192,1,1,636,1872,18,540,1680,17,35.333333333333336,>30,SL,Away,Upto 2014
RDB Croft,ENG,Spin,2001-03-07,Kandy,Sri Lanka,2001,2,88,252,3,1,679,1658,18,591,1406,15,37.72222222222222,>30,SL,Away,Upto 2014
RDB Croft,ENG,Spin,2001-03-15,Colombo (SSC),Sri Lanka,2001,2,74,222,5,1,375,1120,19,301,898,14,19.736842105263158,<=30,SL,Away,Upto 2014
RDB Croft,ENG,Spin,2001-08-02,Nottingham,England,2001,2,10,18,1,1,88,234,9,78,216,8,9.777777777777779,<=30,ENG,Home,Upto 2014
RE Marshall,WI,Spin,1951-12-22,Adelaide,Australia,1951,1,12,40,0,1,501,1145,26,489,1105,26,19.26923076923077,<=30,AUS,Away,Upto 2014
RE Marshall,WI,Spin,1952-02-08,Christchurch,New Zealand,1952,1,3,12,0,1,593,1754,25,590,1742,25,23.72,<=30,NZ,Away,Upto 2014
RES Wyatt,ENG,Pace,1927-12-24,Johannesburg,South Africa,1927,1,6,24,0,1,371,971,19,365,947,19,19.526315789473685,<=30,SA,Away,Upto 2014
RES Wyatt,ENG,Pace,1927-12-31,Cape Town,South Africa,1927,1,5,18,0,1,474,1145,15,469,1127,15,31.6,>30,SA,Away,Upto 2014
RES Wyatt,ENG,Pace,1928-01-21,Durban,South Africa,1928,2,35,168,3,1,482,1079,8,447,911,5,60.25,>30,SA,Away,Upto 2014
RES Wyatt,ENG,Pace,1928-01-28,Johannesburg,South Africa,1928,2,50,78,1,1,503,1258,23,453,1180,22,21.869565217391305,<=30,SA,Away,Upto 2014
RES Wyatt,ENG,Pace,1928-02-04,Durban,South Africa,1928,1,16,18,0,1,338,797,16,322,779,16,21.125,<=30,SA,Away,Upto 2014
RES Wyatt,ENG,Pace,1929-07-27,Manchester,England,1929,2,21,36,1,1,396,1059,11,375,1023,10,36.0,>30,ENG,Home,Upto 2014
RES Wyatt,ENG,Pace,1929-08-17,The Oval,England,1929,1,54,96,1,1,426,1011,9,372,915,8,47.333333333333336,>30,ENG,Home,Upto 2014
RES Wyatt,ENG,Pace,1930-02-21,Georgetown,West Indies,1930,1,56,54,2,1,688,1706,25,632,1652,23,27.52,<=30,WI,Away,Upto 2014
RES Wyatt,ENG,Pace,1930-04-03,Kingston,West Indies,1930,2,69,171,2,1,684,1474,14,615,1303,12,48.857142857142854,>30,WI,Away,Upto 2014
RES Wyatt,ENG,Pace,1930-08-16,The Oval,England,1930,1,58,84,1,1,505,1314,10,447,1230,9,50.5,>30,ENG,Home,Upto 2014
RES Wyatt,ENG,Pace,1930-12-24,Johannesburg,South Africa,1930,1,20,12,0,1,390,954,25,370,942,25,15.6,<=30,SA,Away,Upto 2014
RES Wyatt,ENG,Pace,1931-01-01,Cape Town,South Africa,1931,1,4,12,0,1,323,942,8,319,930,8,40.375,>30,SA,Away,Upto 2014
RES Wyatt,ENG,Pace,1931-02-13,Johannesburg,South Africa,1931,1,10,12,0,1,670,1471,21,660,1459,21,31.904761904761905,>30,SA,Away,Upto 2014
RES Wyatt,ENG,Pace,1931-02-21,Durban,South Africa,1931,1,6,24,1,1,308,822,11,302,798,10,28.0,<=30,SA,Away,Upto 2014
RES Wyatt,ENG,Pace,1933-02-23,Sydney,Australia,1933,1,12,12,0,1,693,1194,12,681,1182,12,57.75,>30,AUS,Away,Upto 2014
RES Wyatt,ENG,Pace,1933-07-22,Manchester,England,1933,2,25,66,1,1,416,958,13,391,892,12,32.0,>30,ENG,Home,Upto 2014
RES Wyatt,ENG,Pace,1934-08-18,The Oval,England,1934,1,28,24,0,1,874,1331,25,846,1307,25,34.96,>30,ENG,Home,Upto 2014
RES Wyatt,ENG,Pace,1935-01-24,Port of Spain,West Indies,1935,2,59,150,3,1,486,1307,22,427,1157,19,22.09090909090909,<=30,WI,Away,Upto 2014
RES Wyatt,ENG,Pace,1935-02-14,Georgetown,West Indies,1935,2,17,84,1,1,273,866,12,256,782,11,22.75,<=30,WI,Away,Upto 2014
RES Wyatt,ENG,Pace,1935-03-14,Kingston,West Indies,1935,1,12,30,0,1,412,902,15,400,872,15,27.466666666666665,<=30,WI,Away,Upto 2014
RES Wyatt,ENG,Pace,1935-06-29,Lord's,England,1935,2,11,48,0,1,344,844,15,333,796,15,22.933333333333334,<=30,ENG,Home,Upto 2014
RES Wyatt,ENG,Pace,1935-07-13,Leeds,England,1935,2,13,60,1,1,570,1397,20,557,1337,19,28.5,<=30,ENG,Home,Upto 2014
RES Wyatt,ENG,Pace,1935-07-27,Manchester,England,1935,1,12,24,0,1,592,1081,17,580,1057,17,34.8235294117647,>30,ENG,Home,Upto 2014
RES Wyatt,ENG,Pace,1935-08-17,The Oval,England,1935,2,28,30,0,1,741,1240,14,713,1210,14,52.92857142857143,>30,ENG,Home,Upto 2014
RES Wyatt,ENG,Pace,1936-06-27,Lord's,England,1936,2,15,60,0,1,273,772,20,258,712,20,13.65,<=30,ENG,Home,Upto 2014
RF Surti,IND,Pace,1960-12-02,Brabourne,India,1960,2,58,102,0,1,494,1042,13,436,940,13,38.0,>30,IND,Home,Upto 2014
RF Surti,IND,Pace,1961-02-08,Delhi,India,1961,2,72,108,0,1,579,1092,16,507,984,16,36.1875,>30,IND,Home,Upto 2014
RF Surti,IND,Pace,1962-02-16,Port of Spain,West Indies,1962,2,20,16,0,1,231,520,12,211,504,12,19.25,<=30,WI,Away,Upto 2014
RF Surti,IND,Pace,1962-03-07,Kingston,West Indies,1962,1,73,114,0,1,392,737,11,319,623,11,35.63636363636363,>30,WI,Away,Upto 2014
RF Surti,IND,Pace,1962-03-23,Bridgetown,West Indies,1962,1,80,174,1,1,296,666,7,216,492,6,42.285714285714285,>30,WI,Away,Upto 2014
RF Surti,IND,Pace,1962-04-04,Port of Spain,West Indies,1962,2,129,282,0,1,296,552,7,167,270,7,42.285714285714285,>30,WI,Away,Upto 2014
RF Surti,IND,Pace,1962-04-13,Kingston,West Indies,1962,2,81,144,3,1,371,811,20,290,667,17,18.55,<=30,WI,Away,Upto 2014
RF Surti,IND,Pace,1964-01-29,Eden Gardens,India,1964,1,8,36,0,1,354,661,13,346,625,13,27.23076923076923,<=30,IND,Home,Upto 2014
RF Surti,IND,Pace,1964-10-10,Brabourne,India,1964,2,147,234,2,1,329,735,10,182,501,8,32.9,>30,IND,Home,Upto 2014
RF Surti,IND,Pace,1964-10-17,Eden Gardens,India,1964,2,75,186,4,1,116,312,5,41,126,1,23.2,<=30,IND,Home,Upto 2014
RF Surti,IND,Pace,1965-02-27,Chennai,India,1965,2,65,204,1,1,302,707,5,237,503,4,60.4,>30,IND,Home,Upto 2014
RF Surti,IND,Pace,1966-12-31,Eden Gardens,India,1966,1,106,180,2,1,232,474,6,126,294,4,38.666666666666664,>30,IND,Home,Upto 2014
RF Surti,IND,Pace,1967-01-13,Chennai,India,1967,2,95,168,3,1,515,900,14,420,732,11,36.785714285714285,>30,IND,Home,Upto 2014
RF Surti,IND,Pace,1967-06-08,Leeds,England,1967,1,25,66,1,1,436,1074,7,411,1008,6,62.285714285714285,>30,ENG,Away,Upto 2014
RF Surti,IND,Pace,1967-06-22,Lord's,England,1967,1,67,186,1,1,257,628,10,190,442,9,25.7,<=30,ENG,Away,Upto 2014
RF Surti,IND,Pace,1967-12-23,Adelaide,Australia,1967,2,104,217,5,1,596,1119,26,492,902,21,22.923076923076923,<=30,AUS,Away,Upto 2014
RF Surti,IND,Pace,1967-12-30,Melbourne,Australia,1967,1,150,235,3,1,704,1270,18,554,1035,15,39.111111111111114,>30,AUS,Away,Upto 2014
RF Surti,IND,Pace,1968-01-19,Brisbane,Australia,1968,2,161,336,6,1,552,1226,17,391,890,11,32.470588235294116,>30,AUS,Away,Upto 2014
RF Surti,IND,Pace,1968-01-26,Sydney,Australia,1968,2,113,152,1,1,498,913,9,385,761,8,55.333333333333336,>30,AUS,Away,Upto 2014
RF Surti,IND,Pace,1968-02-15,Dunedin,New Zealand,1968,2,54,90,0,1,426,1000,14,372,910,14,30.428571428571427,>30,NZ,Away,Upto 2014
RF Surti,IND,Pace,1968-02-22,Christchurch,New Zealand,1968,2,68,136,0,1,471,977,17,403,841,17,27.705882352941178,<=30,NZ,Away,Upto 2014
RF Surti,IND,Pace,1968-02-29,Wellington,New Zealand,1968,2,75,180,3,1,330,661,9,255,481,6,36.666666666666664,>30,NZ,Away,Upto 2014
RF Surti,IND,Pace,1968-03-07,Auckland,New Zealand,1968,2,62,126,4,1,377,874,14,315,748,10,26.928571428571427,<=30,NZ,Away,Upto 2014
RF Surti,IND,Pace,1969-09-25,Brabourne,India,1969,2,12,48,0,1,336,982,18,324,934,18,18.666666666666668,<=30,IND,Home,Upto 2014
RF Surti,IND,Pace,1969-10-03,Nagpur,India,1969,2,30,72,0,1,171,432,3,141,360,3,57.0,>30,IND,Home,Upto 2014
RF Surti,IND,Pace,1969-11-04,Brabourne,India,1969,2,32,78,2,1,298,821,12,266,743,10,24.833333333333332,<=30,IND,Home,Upto 2014
RG Archer,AUS,Pace,1953-02-06,Melbourne,Australia,1953,2,120,304,1,1,486,1431,11,366,1127,10,44.18181818181818,>30,AUS,Home,Upto 2014
RG Archer,AUS,Pace,1953-07-09,Manchester,England,1953,1,12,90,1,1,352,924,14,340,834,13,25.142857142857142,<=30,ENG,Away,Upto 2014
RG Archer,AUS,Pace,1953-07-23,Leeds,England,1953,2,58,258,2,1,617,1986,30,559,1728,28,20.566666666666666,<=30,ENG,Away,Upto 2014
RG Archer,AUS,Pace,1953-08-15,The Oval,England,1953,2,25,69,1,1,504,1206,15,479,1137,14,33.6,>30,ENG,Away,Upto 2014
RG Archer,AUS,Pace,1954-11-26,Brisbane,Australia,1954,2,42,152,1,1,750,1616,15,708,1464,14,50.0,>30,AUS,Home,Upto 2014
RG Archer,AUS,Pace,1954-12-17,Sydney,Australia,1954,2,65,272,6,1,649,1696,33,584,1424,27,19.666666666666668,<=30,AUS,Home,Upto 2014
RG Archer,AUS,Pace,1954-12-31,Melbourne,Australia,1954,2,83,302,6,1,538,1484,30,455,1182,24,17.933333333333334,<=30,AUS,Home,Upto 2014
RG Archer,AUS,Pace,1955-01-28,Adelaide,Australia,1955,2,25,56,0,1,511,1397,23,486,1341,23,22.217391304347824,<=30,AUS,Home,Upto 2014
RG Archer,AUS,Pace,1955-03-26,Kingston,West Indies,1955,2,83,186,4,1,487,1027,18,404,841,14,27.055555555555557,<=30,WI,Away,Upto 2014
RG Archer,AUS,Pace,1955-04-11,Port of Spain,West Indies,1955,2,79,102,3,1,686,1163,14,607,1061,11,49.0,>30,WI,Away,Upto 2014
RG Archer,AUS,Pace,1955-04-26,Georgetown,West Indies,1955,2,89,132,2,1,285,510,7,196,378,5,40.714285714285715,>30,WI,Away,Upto 2014
RG Archer,AUS,Pace,1955-05-14,Bridgetown,West Indies,1955,2,55,132,1,1,574,1002,10,519,870,9,57.4,>30,WI,Away,Upto 2014
RG Archer,AUS,Pace,1955-06-11,Kingston,West Indies,1955,2,112,228,1,1,633,1010,16,521,782,15,39.5625,>30,WI,Away,Upto 2014
RG Archer,AUS,Pace,1956-06-07,Nottingham,England,1956,2,97,240,3,1,363,976,12,266,736,9,30.25,>30,ENG,Away,Upto 2014
RG Archer,AUS,Pace,1956-06-21,Lord's,England,1956,2,118,326,6,1,698,1897,33,580,1571,27,21.151515151515152,<=30,ENG,Away,Upto 2014
RG Archer,AUS,Pace,1956-07-12,Leeds,England,1956,1,68,300,3,1,232,778,8,164,478,5,29.0,<=30,ENG,Away,Upto 2014
RG Archer,AUS,Pace,1956-07-26,Manchester,England,1956,1,73,132,1,1,233,663,3,160,531,2,77.66666666666667,>30,ENG,Away,Upto 2014
RG Archer,AUS,Pace,1956-08-23,The Oval,England,1956,2,95,248,5,1,409,1082,18,314,834,13,22.72222222222222,<=30,ENG,Away,Upto 2014
RG Archer,AUS,Pace,1956-10-11,Karachi,Pakistan,1956,2,19,47,1,1,382,1421,26,363,1374,25,14.692307692307692,<=30,PAK,Away,Upto 2014
RG Barlow,ENG,Pace,1881-12-31,Melbourne,Australia,1881,1,22,92,0,1,185,448,5,163,356,5,37.0,>30,AUS,Away,After 1965
RG Barlow,ENG,Pace,1882-02-17,Sydney,Australia,1882,2,14,48,0,1,195,434,9,181,386,9,21.666666666666668,<=30,AUS,Away,After 1965
RG Barlow,ENG,Pace,1882-03-10,Melbourne,Australia,1882,1,25,60,0,1,399,909,9,374,849,9,44.333333333333336,>30,AUS,Away,After 1965
RG Barlow,ENG,Pace,1882-08-28,The Oval,England,1882,2,46,176,5,1,213,651,23,167,475,18,9.26086956521739,<=30,ENG,Home,After 1965
RG Barlow,ENG,Pace,1882-12-30,Melbourne,Australia,1882,2,43,96,0,1,380,1024,17,337,928,17,22.352941176470587,<=30,AUS,Away,After 1965
RG Barlow,ENG,Pace,1883-01-19,Melbourne,Australia,1883,2,76,212,4,1,335,900,10,259,688,6,33.5,>30,AUS,Away,After 1965
RG Barlow,ENG,Pace,1883-01-26,Sydney,Australia,1883,2,92,327,8,1,439,1288,28,347,961,20,15.678571428571429,<=30,AUS,Away,After 1965
RG Barlow,ENG,Pace,1883-02-17,Sydney,Australia,1883,2,132,341,3,1,382,973,10,250,632,7,38.2,>30,AUS,Away,After 1965
RG Barlow,ENG,Pace,1884-07-10,Manchester,England,1884,1,18,32,0,1,208,652,12,190,620,12,17.333333333333332,<=30,ENG,Home,After 1965
RG Barlow,ENG,Pace,1884-07-21,Lord's,England,1884,2,75,164,1,1,404,842,13,329,678,12,31.076923076923077,>30,ENG,Home,After 1965
RG Barlow,ENG,Pace,1884-08-11,The Oval,England,1884,1,72,200,0,1,468,1104,7,396,904,7,66.85714285714286,>30,ENG,Home,After 1965
RG Barlow,ENG,Pace,1886-07-05,Manchester,England,1886,2,63,300,8,1,434,1426,26,371,1126,18,16.692307692307693,<=30,ENG,Home,After 1965
RG Barlow,ENG,Pace,1886-07-19,Lord's,England,1886,2,19,124,2,1,322,1023,13,303,899,11,24.76923076923077,<=30,ENG,Home,After 1965
RG Barlow,ENG,Pace,1886-08-12,The Oval,England,1886,1,13,56,0,1,385,1143,19,372,1087,19,20.263157894736842,<=30,ENG,Home,After 1965
RG Barlow,ENG,Pace,1887-01-28,Sydney,Australia,1887,2,45,192,3,1,241,1003,28,196,811,25,8.607142857142858,<=30,AUS,Away,After 1965
RG Barlow,ENG,Pace,1887-02-25,Sydney,Australia,1887,1,12,36,0,1,222,846,20,210,810,20,11.1,<=30,AUS,Away,After 1965
RG Gregory,AUS,Spin,1937-01-29,Adelaide,Australia,1937,1,14,24,0,1,554,1660,17,540,1636,17,32.588235294117645,>30,AUS,Home,Upto 2014
RG Holland,AUS,Spin,1984-11-23,Brisbane,Australia,1984,1,97,162,2,1,123,198,2,26,36,0,61.5,>30,AUS,Home,Upto 2014
RG Holland,AUS,Spin,1984-12-07,Adelaide,Australia,1984,2,163,291,2,1,299,561,7,136,270,5,42.714285714285715,>30,AUS,Home,Upto 2014
RG Holland,AUS,Spin,1984-12-30,Sydney,Australia,1984,2,144,330,10,1,308,779,16,164,449,6,19.25,<=30,AUS,Home,Upto 2014
RG Holland,AUS,Spin,1985-06-27,Lord's,England,1985,2,110,330,5,1,311,742,9,201,412,4,34.55555555555556,>30,ENG,Away,Upto 2014
RG Holland,AUS,Spin,1985-07-11,Nottingham,England,1985,2,159,324,1,1,443,1050,6,284,726,5,73.83333333333333,>30,ENG,Away,Upto 2014
RG Holland,AUS,Spin,1985-08-01,Manchester,England,1985,1,101,228,0,1,424,1147,11,323,919,11,38.54545454545455,>30,ENG,Away,Upto 2014
RG Holland,AUS,Spin,1985-08-15,Birmingham,England,1985,1,95,150,0,1,208,528,4,113,378,4,52.0,>30,ENG,Away,Upto 2014
RG Holland,AUS,Spin,1985-11-08,Brisbane,Australia,1985,1,106,132,0,1,336,547,4,230,415,4,84.0,>30,AUS,Home,Upto 2014
RG Holland,AUS,Spin,1985-11-22,Sydney,Australia,1985,2,174,528,10,1,694,1882,25,520,1354,15,27.76,<=30,AUS,Home,Upto 2014
RG Holland,AUS,Spin,1985-11-30,W.A.C.A,Australia,1985,2,90,288,3,1,164,587,6,74,299,3,27.333333333333332,<=30,AUS,Home,Upto 2014
RG Holland,AUS,Spin,1986-01-02,Sydney,Australia,1986,1,113,126,1,1,700,1797,15,587,1671,14,46.666666666666664,>30,AUS,Home,Upto 2014
RG Nadkarni,IND,Spin,1955-12-16,Delhi,India,1955,2,142,342,0,1,540,1398,4,398,1056,4,135.0,>30,IND,Home,Upto 2014
RG Nadkarni,IND,Spin,1958-11-28,Brabourne,India,1958,2,69,217,2,1,512,1219,9,443,1002,7,56.888888888888886,>30,IND,Home,Upto 2014
RG Nadkarni,IND,Spin,1959-06-04,Nottingham,England,1959,1,48,169,2,1,354,956,10,306,787,8,35.4,>30,ENG,Away,Upto 2014
RG Nadkarni,IND,Spin,1959-07-02,Leeds,England,1959,1,64,132,2,1,383,883,14,319,751,12,27.357142857142858,<=30,ENG,Away,Upto 2014
RG Nadkarni,IND,Spin,1959-07-23,Manchester,England,1959,2,140,348,3,1,721,1722,21,581,1374,18,34.333333333333336,>30,ENG,Away,Upto 2014
RG Nadkarni,IND,Spin,1959-08-20,The Oval,England,1959,1,52,150,2,1,323,930,8,271,780,6,40.375,>30,ENG,Away,Upto 2014
RG Nadkarni,IND,Spin,1959-12-12,Delhi,India,1959,1,62,120,1,1,348,919,18,286,799,17,19.333333333333332,<=30,IND,Home,Upto 2014
RG Nadkarni,IND,Spin,1959-12-19,Kanpur,India,1959,1,7,12,0,1,496,1305,26,489,1293,26,19.076923076923077,<=30,IND,Home,Upto 2014
RG Nadkarni,IND,Spin,1960-01-01,Brabourne,India,1960,1,105,306,6,1,351,876,9,246,570,3,39.0,>30,IND,Home,Upto 2014
RG Nadkarni,IND,Spin,1960-01-13,Chennai,India,1960,1,75,264,3,1,351,1231,17,276,967,14,20.647058823529413,<=30,IND,Home,Upto 2014
RG Nadkarni,IND,Spin,1960-01-23,Eden Gardens,India,1960,2,46,174,0,1,425,1054,13,379,880,13,32.69230769230769,>30,IND,Home,Upto 2014
RG Nadkarni,IND,Spin,1960-12-02,Brabourne,India,1960,2,84,316,4,1,412,1324,9,328,1008,5,45.77777777777778,>30,IND,Home,Upto 2014
RG Nadkarni,IND,Spin,1960-12-16,Kanpur,India,1960,2,29,234,0,1,619,1984,16,590,1750,16,38.6875,>30,IND,Home,Upto 2014
RG Nadkarni,IND,Spin,1960-12-30,Eden Gardens,India,1960,2,40,78,0,1,295,842,11,255,764,11,26.818181818181817,<=30,IND,Home,Upto 2014
RG Nadkarni,IND,Spin,1961-02-08,Delhi,India,1961,2,67,520,5,1,386,1389,14,319,869,9,27.571428571428573,<=30,IND,Home,Upto 2014
RG Nadkarni,IND,Spin,1962-01-10,Chennai,India,1962,2,25,109,2,1,866,2320,33,841,2211,31,26.242424242424242,<=30,IND,Home,Upto 2014
RG Nadkarni,IND,Spin,1962-02-16,Port of Spain,West Indies,1962,1,1,18,0,1,339,916,17,338,898,17,19.941176470588236,<=30,WI,Away,Upto 2014
RG Nadkarni,IND,Spin,1962-03-07,Kingston,West Indies,1962,1,57,154,1,1,783,1924,16,726,1770,15,48.9375,>30,WI,Away,Upto 2014
RG Nadkarni,IND,Spin,1962-03-23,Bridgetown,West Indies,1962,1,92,402,2,1,596,2431,22,504,2029,20,27.09090909090909,<=30,WI,Away,Upto 2014
RG Nadkarni,IND,Spin,1962-04-04,Port of Spain,West Indies,1962,2,103,378,2,1,911,2452,24,808,2074,22,37.958333333333336,>30,WI,Away,Upto 2014
RG Nadkarni,IND,Spin,1962-04-13,Kingston,West Indies,1962,2,63,156,4,1,527,1208,20,464,1052,16,26.35,<=30,WI,Away,Upto 2014
RG Nadkarni,IND,Spin,1964-01-10,Chennai,India,1964,2,11,228,2,1,876,2493,27,865,2265,25,32.44444444444444,>30,IND,Home,Upto 2014
RG Nadkarni,IND,Spin,1964-01-21,Brabourne,India,1964,2,11,108,0,1,560,2208,16,549,2100,16,35.0,>30,IND,Home,Upto 2014
RG Nadkarni,IND,Spin,1964-01-29,Eden Gardens,India,1964,1,38,252,2,1,555,1794,16,517,1542,14,34.6875,>30,IND,Home,Upto 2014
RG Nadkarni,IND,Spin,1964-02-08,Delhi,India,1964,1,97,342,3,1,1001,2631,20,904,2289,17,50.05,>30,IND,Home,Upto 2014
RG Nadkarni,IND,Spin,1964-02-15,Kanpur,India,1964,1,121,342,2,1,987,2874,18,866,2532,16,54.833333333333336,>30,IND,Home,Upto 2014
RG Nadkarni,IND,Spin,1964-10-02,Chennai,India,1964,2,122,436,11,1,735,1918,23,613,1482,12,31.956521739130434,>30,IND,Home,Upto 2014
RG Nadkarni,IND,Spin,1964-10-10,Brabourne,India,1964,2,98,273,6,1,796,2173,26,698,1900,20,30.615384615384617,>30,IND,Home,Upto 2014
RG Nadkarni,IND,Spin,1964-10-17,Eden Gardens,India,1964,2,13,60,0,1,407,1253,16,394,1193,16,25.4375,<=30,IND,Home,Upto 2014
RG Nadkarni,IND,Spin,1965-02-27,Chennai,India,1965,1,42,216,2,1,616,1705,17,574,1489,15,36.23529411764706,>30,IND,Home,Upto 2014
RG Nadkarni,IND,Spin,1965-03-05,Eden Gardens,India,1965,2,73,252,2,1,632,1531,17,559,1279,15,37.1764705882353,>30,IND,Home,Upto 2014
RG Nadkarni,IND,Spin,1965-03-12,Brabourne,India,1965,1,22,72,0,1,545,1316,11,523,1244,11,49.54545454545455,>30,IND,Home,Upto 2014
RG Nadkarni,IND,Spin,1965-03-19,Delhi,India,1965,2,31,210,0,1,716,1840,21,685,1630,21,34.095238095238095,>30,IND,Home,Upto 2014
RG Nadkarni,IND,Spin,1966-12-13,Brabourne,India,1966,1,47,90,0,1,1023,2319,28,976,2229,28,36.535714285714285,>30,IND,Home,Upto 2014
RG Nadkarni,IND,Spin,1967-12-23,Adelaide,Australia,1967,2,92,212,0,1,620,1381,10,528,1169,10,62.0,>30,AUS,Away,Upto 2014
RG Nadkarni,IND,Spin,1968-01-19,Brisbane,Australia,1968,2,81,232,2,1,711,2018,22,630,1786,20,32.31818181818182,>30,AUS,Away,Upto 2014
RG Nadkarni,IND,Spin,1968-01-26,Sydney,Australia,1968,1,38,128,1,1,552,1735,27,514,1607,26,20.444444444444443,<=30,AUS,Away,Upto 2014
RG Nadkarni,IND,Spin,1968-02-15,Dunedin,New Zealand,1968,2,44,291,3,1,642,1761,17,598,1470,14,37.76470588235294,>30,NZ,Away,Upto 2014
RG Nadkarni,IND,Spin,1968-02-22,Christchurch,New Zealand,1968,2,125,444,2,1,599,1533,16,474,1089,14,37.4375,>30,NZ,Away,Upto 2014
RG Nadkarni,IND,Spin,1968-02-29,Wellington,New Zealand,1968,2,65,282,7,1,408,1093,20,343,811,13,20.4,<=30,NZ,Away,Upto 2014
RG Nadkarni,IND,Spin,1968-03-07,Auckland,New Zealand,1968,2,17,96,2,1,303,1079,19,286,983,17,15.947368421052632,<=30,NZ,Away,Upto 2014
RG Pollock,SA,Spin,1964-03-13,Auckland,New Zealand,1964,1,16,18,0,1,351,809,9,335,791,9,39.0,>30,NZ,Away,Upto 2014
RG Pollock,SA,Spin,1964-12-04,Durban,South Africa,1964,1,32,60,0,1,464,1264,16,432,1204,16,29.0,<=30,SA,Home,Upto 2014
RG Pollock,SA,Spin,1964-12-23,Johannesburg,South Africa,1964,1,50,66,2,1,545,1457,14,495,1391,12,38.92857142857143,>30,SA,Home,Upto 2014
RG Pollock,SA,Spin,1965-01-01,Cape Town,South Africa,1965,1,5,12,0,1,605,1499,14,600,1487,14,43.214285714285715,>30,SA,Home,Upto 2014
RG Pollock,SA,Spin,1965-01-22,Johannesburg,South Africa,1965,2,47,90,0,1,443,1146,10,396,1056,10,44.3,>30,SA,Home,Upto 2014
RG Pollock,SA,Spin,1965-02-12,Gqeberha,South Africa,1965,1,14,42,0,1,437,1309,10,423,1267,10,43.7,>30,SA,Home,Upto 2014
RG Pollock,SA,Spin,1965-07-22,Lord's,England,1965,2,21,54,1,1,281,779,9,260,725,8,31.22222222222222,>30,ENG,Away,Upto 2014
RG Pollock,SA,Spin,1965-08-05,Nottingham,England,1965,2,6,36,1,1,259,688,8,253,652,7,32.375,>30,ENG,Away,Upto 2014
RG Pollock,SA,Spin,1966-12-23,Johannesburg,South Africa,1966,1,5,18,0,1,549,1041,11,544,1023,11,49.90909090909091,>30,SA,Home,Upto 2014
RG Pollock,SA,Spin,1970-02-05,Durban,South Africa,1970,1,8,18,0,1,348,698,8,340,680,8,43.5,>30,SA,Home,Upto 2014
RG Sharma,IND,Spin,2013-12-26,Durban,South Africa,2013,2,39,70,0,1,373,798,11,334,728,11,33.90909090909091,>30,SA,Away,Upto 2014
RG Sharma,IND,Spin,2014-02-06,Auckland,New Zealand,2014,2,15,24,0,1,263,390,2,248,366,2,131.5,>30,NZ,Away,After 1965
RG Sharma,IND,Spin,2014-02-14,Wellington,New Zealand,2014,1,40,66,0,1,170,396,1,130,330,1,170.0,>30,NZ,Away,After 1965
RG Sharma,IND,Spin,2014-07-27,Southampton,England,2014,2,58,84,1,1,407,690,15,349,606,14,27.133333333333333,<=30,ENG,Away,After 1965
RG Sharma,IND,Spin,2014-12-09,Adelaide,Australia,2014,1,35,72,1,1,652,937,17,617,865,16,38.35294117647059,>30,AUS,Away,After 1965
RG Sharma,IND,Spin,2014-12-17,Brisbane,Australia,2014,1,10,12,0,1,289,440,7,279,428,7,41.285714285714285,>30,AUS,Away,After 1965
RG Sharma,IND,Spin,2016-09-22,Kanpur,India,2016,1,5,6,0,1,859,1714,26,854,1708,26,33.03846153846154,>30,IND,Home,After 1965
RG Sharma,IND,Spin,2019-10-02,Visakhapatnam,India,2019,2,10,18,0,1,1062,1652,22,1052,1634,22,48.27272727272727,>30,IND,Home,After 1965
RG Sharma,IND,Spin,2019-10-10,Pune,India,2019,2,4,18,0,1,587,1113,12,583,1095,12,48.916666666666664,>30,IND,Home,After 1965
RG Sharma,IND,Spin,2021-01-15,Brisbane,Australia,2021,1,1,1,0,1,324,661,7,323,660,7,46.285714285714285,>30,AUS,Away,After 1965
RG Sharma,IND,Spin,2021-02-05,Chennai,India,2021,1,7,12,0,1,867,1480,24,860,1468,24,36.125,>30,IND,Home,After 1965
RG Twose,NZ,Pace,1995-11-08,Cuttack,India,1995,1,5,6,0,1,240,497,7,235,491,7,34.285714285714285,>30,IND,Away,Upto 2014
RG Twose,NZ,Pace,1996-01-13,Hamilton,New Zealand,1996,2,50,108,2,1,657,1344,21,607,1236,19,31.285714285714285,>30,NZ,Home,Upto 2014
RG Twose,NZ,Pace,1996-01-20,Auckland,New Zealand,1996,1,5,18,1,1,908,2025,23,903,2007,22,39.47826086956522,>30,NZ,Home,Upto 2014
RG Twose,NZ,Pace,1996-04-19,Bridgetown,West Indies,1996,1,20,24,0,1,918,1755,25,898,1731,25,36.72,>30,WI,Away,Upto 2014
RG Twose,NZ,Pace,1999-01-02,Hamilton,New Zealand,1999,1,50,55,0,1,1002,1896,23,952,1841,23,43.56521739130435,>30,NZ,Home,Upto 2014
RGCE Wijesuriya,SL,Spin,1982-03-22,Lahore,Pakistan,1982,1,105,144,0,1,386,750,7,281,606,7,55.142857142857146,>30,PAK,Away,Upto 2014
RGCE Wijesuriya,SL,Spin,1985-10-16,Faisalabad,Pakistan,1985,1,102,264,0,1,278,675,3,176,411,3,92.66666666666667,>30,PAK,Away,Upto 2014
RGCE Wijesuriya,SL,Spin,1985-10-27,Sialkot,Pakistan,1985,1,10,24,0,1,11,31,0,1,7,0,inf,>30,PAK,Away,Upto 2014
RGCE Wijesuriya,SL,Spin,1985-11-07,Karachi,Pakistan,1985,2,77,154,1,1,327,706,13,250,552,12,25.153846153846153,<=30,PAK,Away,Upto 2014
RGD Willis,ENG,Pace,1971-01-09,Sydney,Australia,1971,2,27,96,1,1,480,1339,18,453,1243,17,26.666666666666668,<=30,AUS,Away,Upto 2014
RGD Willis,ENG,Pace,1971-01-21,Melbourne,Australia,1971,2,115,240,4,1,660,1712,13,545,1472,9,50.76923076923077,>30,AUS,Away,Upto 2014
RGD Willis,ENG,Pace,1971-01-29,Adelaide,Australia,1971,2,97,200,3,1,768,1851,22,671,1651,19,34.90909090909091,>30,AUS,Away,Upto 2014
RGD Willis,ENG,Pace,1971-02-12,Sydney,Australia,1971,2,90,168,4,1,479,1333,21,389,1165,17,22.80952380952381,<=30,AUS,Away,Upto 2014
RGD Willis,ENG,Pace,1971-03-05,Auckland,New Zealand,1971,2,69,160,2,1,561,1413,20,492,1253,18,28.05,<=30,NZ,Away,Upto 2014
RGD Willis,ENG,Pace,1973-08-23,Lord's,England,1973,1,118,210,4,1,497,984,19,379,774,15,26.157894736842106,<=30,ENG,Home,Upto 2014
RGD Willis,ENG,Pace,1974-02-02,Port of Spain,West Indies,1974,2,58,138,1,1,308,634,10,250,496,9,30.8,>30,WI,Away,Upto 2014
RGD Willis,ENG,Pace,1974-02-16,Kingston,West Indies,1974,1,97,144,3,1,383,780,10,286,636,7,38.3,>30,WI,Away,Upto 2014
RGD Willis,ENG,Pace,1974-03-06,Bridgetown,West Indies,1974,1,100,156,1,1,627,1356,14,527,1200,13,44.785714285714285,>30,WI,Away,Upto 2014
RGD Willis,ENG,Pace,1974-06-06,Manchester,England,1974,2,97,216,5,1,464,1137,20,367,921,15,23.2,<=30,ENG,Home,Upto 2014
RGD Willis,ENG,Pace,1974-08-22,The Oval,England,1974,2,129,210,2,1,675,1389,8,546,1179,6,84.375,>30,ENG,Home,Upto 2014
RGD Willis,ENG,Pace,1974-11-29,Brisbane,Australia,1974,2,101,293,7,1,649,1743,27,548,1450,20,24.037037037037038,<=30,AUS,Away,Upto 2014
RGD Willis,ENG,Pace,1974-12-13,W.A.C.A,Australia,1974,2,99,192,2,1,728,1672,24,629,1480,22,30.333333333333332,>30,AUS,Away,Upto 2014
RGD Willis,ENG,Pace,1974-12-26,Melbourne,Australia,1974,2,117,287,6,1,489,1257,19,372,970,13,25.736842105263158,<=30,AUS,Away,Upto 2014
RGD Willis,ENG,Pace,1975-01-04,Sydney,Australia,1975,2,132,232,1,1,724,1665,23,592,1433,22,31.47826086956522,>30,AUS,Away,Upto 2014
RGD Willis,ENG,Pace,1975-01-25,Adelaide,Australia,1975,2,73,120,1,1,469,911,17,396,791,16,27.58823529411765,<=30,AUS,Away,Upto 2014
RGD Willis,ENG,Pace,1976-07-22,Leeds,England,1976,2,113,213,8,1,969,1786,39,856,1573,31,24.846153846153847,<=30,ENG,Home,Upto 2014
RGD Willis,ENG,Pace,1976-08-12,The Oval,England,1976,2,121,132,1,1,768,1323,20,647,1191,19,38.4,>30,ENG,Home,Upto 2014
RGD Willis,ENG,Pace,1976-12-17,Delhi,India,1976,2,45,96,1,1,217,567,13,172,471,12,16.692307692307693,<=30,IND,Away,Upto 2014
RGD Willis,ENG,Pace,1977-01-01,Eden Gardens,India,1977,2,59,198,7,1,233,654,15,174,456,8,15.533333333333333,<=30,IND,Away,Upto 2014
RGD Willis,ENG,Pace,1977-01-14,Chennai,India,1977,2,64,192,4,1,275,772,15,211,580,11,18.333333333333332,<=30,IND,Away,Upto 2014
RGD Willis,ENG,Pace,1977-01-28,Bengaluru,India,1977,2,100,210,8,1,275,606,12,175,396,4,22.916666666666668,<=30,IND,Away,Upto 2014
RGD Willis,ENG,Pace,1977-02-11,Wankhede,India,1977,2,67,114,0,1,299,578,10,232,464,10,29.9,<=30,IND,Away,Upto 2014
RGD Willis,ENG,Pace,1977-03-12,Melbourne,Australia,1977,2,124,240,2,1,769,1725,30,645,1485,28,25.633333333333333,<=30,AUS,Away,Upto 2014
RGD Willis,ENG,Pace,1977-06-16,Lord's,England,1977,2,118,241,9,1,753,1756,32,635,1515,23,23.53125,<=30,ENG,Home,Upto 2014
RGD Willis,ENG,Pace,1977-07-07,Manchester,England,1977,2,101,222,4,1,525,1242,14,424,1020,10,37.5,>30,ENG,Home,Upto 2014
RGD Willis,ENG,Pace,1977-07-28,Nottingham,England,1977,2,146,246,6,1,788,1906,27,642,1660,21,29.185185185185187,<=30,ENG,Home,Upto 2014
RGD Willis,ENG,Pace,1977-08-11,Leeds,England,1977,2,67,114,3,1,569,1338,25,502,1224,22,22.76,<=30,ENG,Home,Upto 2014
RGD Willis,ENG,Pace,1977-08-25,The Oval,England,1977,1,102,177,5,1,507,1259,20,405,1082,15,25.35,<=30,ENG,Home,Upto 2014
RGD Willis,ENG,Pace,1977-12-14,Lahore,Pakistan,1977,2,101,192,2,1,359,1064,11,258,872,9,32.63636363636363,>30,PAK,Away,Upto 2014
RGD Willis,ENG,Pace,1978-01-02,Hyderabad (Sind),Pakistan,1978,2,66,216,4,1,260,806,5,194,590,1,52.0,>30,PAK,Away,Upto 2014
RGD Willis,ENG,Pace,1978-01-18,Karachi,Pakistan,1978,1,23,64,1,1,226,792,5,203,728,4,45.2,>30,PAK,Away,Upto 2014
RGD Willis,ENG,Pace,1978-02-10,Wellington,New Zealand,1978,2,97,320,7,1,523,1920,38,426,1600,31,13.763157894736842,<=30,NZ,Away,Upto 2014
RGD Willis,ENG,Pace,1978-02-24,Christchurch,New Zealand,1978,2,59,216,5,1,664,1812,24,605,1596,19,27.666666666666668,<=30,NZ,Away,Upto 2014
RGD Willis,ENG,Pace,1978-03-04,Auckland,New Zealand,1978,2,99,294,2,1,754,2126,17,655,1832,15,44.35294117647059,>30,NZ,Away,Upto 2014
RGD Willis,ENG,Pace,1978-06-01,Birmingham,England,1978,2,112,238,4,1,618,1454,19,506,1216,15,32.526315789473685,>30,ENG,Home,Upto 2014
RGD Willis,ENG,Pace,1978-06-15,Lord's,England,1978,2,73,138,7,1,397,739,22,324,601,15,18.045454545454547,<=30,ENG,Home,Upto 2014
RGD Willis,ENG,Pace,1978-06-29,Leeds,England,1978,1,48,156,2,1,225,754,16,177,598,14,14.0625,<=30,ENG,Home,Upto 2014
RGD Willis,ENG,Pace,1978-07-27,The Oval,England,1978,2,81,200,6,1,503,1390,19,422,1190,13,26.473684210526315,<=30,ENG,Home,Upto 2014
RGD Willis,ENG,Pace,1978-08-10,Nottingham,England,1978,2,53,126,1,1,554,1523,20,501,1397,19,27.7,<=30,ENG,Home,Upto 2014
RGD Willis,ENG,Pace,1978-08-24,Lord's,England,1978,2,95,270,5,1,614,1515,29,519,1245,24,21.17241379310345,<=30,ENG,Home,Upto 2014
RGD Willis,ENG,Pace,1978-12-01,Brisbane,Australia,1978,2,113,334,7,1,633,1750,28,520,1416,21,22.607142857142858,<=30,AUS,Away,Upto 2014
RGD Willis,ENG,Pace,1978-12-15,W.A.C.A,Australia,1978,2,80,245,6,1,652,1878,31,572,1633,25,21.032258064516128,<=30,AUS,Away,Upto 2014
RGD Willis,ENG,Pace,1978-12-29,Melbourne,Australia,1978,2,68,160,0,1,456,1463,27,388,1303,27,16.88888888888889,<=30,AUS,Away,Upto 2014
RGD Willis,ENG,Pace,1979-01-06,Sydney,Australia,1979,2,41,88,2,1,452,1414,19,411,1326,17,23.789473684210527,<=30,AUS,Away,Upto 2014
RGD Willis,ENG,Pace,1979-01-27,Adelaide,Australia,1979,2,96,184,4,1,561,1654,30,465,1470,26,18.7,<=30,AUS,Away,Upto 2014
RGD Willis,ENG,Pace,1979-02-10,Sydney,Australia,1979,2,63,112,1,1,293,735,11,230,623,10,26.636363636363637,<=30,AUS,Away,Upto 2014
RGD Willis,ENG,Pace,1979-07-12,Birmingham,England,1979,2,114,228,4,1,689,1489,22,575,1261,18,31.318181818181817,>30,ENG,Home,Upto 2014
RGD Willis,ENG,Pace,1979-08-16,Leeds,England,1979,1,42,108,2,1,293,690,9,251,582,7,32.55555555555556,>30,ENG,Home,Upto 2014
RGD Willis,ENG,Pace,1979-08-30,The Oval,England,1979,2,142,276,4,1,700,1610,24,558,1334,20,29.166666666666668,<=30,ENG,Home,Upto 2014
RGD Willis,ENG,Pace,1979-12-14,W.A.C.A,Australia,1979,2,99,294,1,1,716,1874,34,617,1580,33,21.058823529411764,<=30,AUS,Away,Upto 2014
RGD Willis,ENG,Pace,1980-01-04,Sydney,Australia,1980,2,56,138,2,1,548,1437,28,492,1299,26,19.571428571428573,<=30,AUS,Away,Upto 2014
RGD Willis,ENG,Pace,1980-02-01,Melbourne,Australia,1980,2,69,156,0,1,694,1833,26,625,1677,26,26.692307692307693,<=30,AUS,Away,Upto 2014
RGD Willis,ENG,Pace,1980-06-05,Nottingham,England,1980,2,147,277,9,1,897,2129,36,750,1852,27,24.916666666666668,<=30,ENG,Home,Upto 2014
RGD Willis,ENG,Pace,1980-06-19,Lord's,England,1980,1,103,186,3,1,667,1407,18,564,1221,15,37.05555555555556,>30,ENG,Home,Upto 2014
RGD Willis,ENG,Pace,1980-07-10,Manchester,England,1980,1,99,84,1,1,678,1412,23,579,1328,22,29.47826086956522,<=30,ENG,Home,Upto 2014
RGD Willis,ENG,Pace,1980-07-24,The Oval,England,1980,1,58,114,1,1,630,1595,25,572,1481,24,25.2,<=30,ENG,Home,Upto 2014
RGD Willis,ENG,Pace,1981-06-18,Nottingham,England,1981,2,75,258,4,1,571,1418,36,496,1160,32,15.86111111111111,<=30,ENG,Home,Upto 2014
RGD Willis,ENG,Pace,1981-07-02,Lord's,England,1981,2,85,238,4,1,755,1760,25,670,1522,21,30.2,>30,ENG,Home,Upto 2014
RGD Willis,ENG,Pace,1981-07-16,Leeds,England,1981,2,115,271,8,1,892,1859,38,777,1588,30,23.473684210526315,<=30,ENG,Home,Upto 2014
RGD Willis,ENG,Pace,1981-07-30,Birmingham,England,1981,2,100,234,2,1,525,1321,25,425,1087,23,21.0,<=30,ENG,Home,Upto 2014
RGD Willis,ENG,Pace,1981-08-13,Manchester,England,1981,2,159,269,7,1,887,1850,35,728,1581,28,25.34285714285714,<=30,ENG,Home,Upto 2014
RGD Willis,ENG,Pace,1981-08-27,The Oval,England,1981,2,132,246,4,1,972,2088,35,840,1842,31,27.771428571428572,<=30,ENG,Home,Upto 2014
RGD Willis,ENG,Pace,1981-11-27,Wankhede,India,1981,2,64,150,2,1,460,1013,28,396,863,26,16.428571428571427,<=30,IND,Away,Upto 2014
RGD Willis,ENG,Pace,1981-12-23,Delhi,India,1981,1,99,156,2,1,608,1217,15,509,1061,13,40.53333333333333,>30,IND,Away,Upto 2014
RGD Willis,ENG,Pace,1982-01-01,Eden Gardens,India,1982,2,49,120,2,1,453,960,12,404,840,10,37.75,>30,IND,Away,Upto 2014
RGD Willis,ENG,Pace,1982-01-13,Chennai,India,1982,2,94,211,3,1,631,1176,8,537,965,5,78.875,>30,IND,Away,Upto 2014
RGD Willis,ENG,Pace,1982-01-30,Kanpur,India,1982,1,75,138,3,1,435,720,7,360,582,4,62.142857142857146,>30,IND,Away,Upto 2014
RGD Willis,ENG,Pace,1982-02-17,Colombo (PSS),Sri Lanka,1982,2,70,168,3,1,292,600,11,222,432,8,26.545454545454547,<=30,SL,Away,Upto 2014
RGD Willis,ENG,Pace,1982-06-10,Lord's,England,1982,2,142,264,9,1,701,1384,31,559,1120,22,22.612903225806452,<=30,ENG,Home,Upto 2014
RGD Willis,ENG,Pace,1982-06-24,Manchester,England,1982,1,94,102,2,1,426,732,7,332,630,5,60.857142857142854,>30,ENG,Home,Upto 2014
RGD Willis,ENG,Pace,1982-07-08,The Oval,England,1982,2,94,162,4,1,668,1272,12,574,1110,8,55.666666666666664,>30,ENG,Home,Upto 2014
RGD Willis,ENG,Pace,1982-07-29,Birmingham,England,1982,2,91,174,4,1,641,1313,30,550,1139,26,21.366666666666667,<=30,ENG,Home,Upto 2014
RGD Willis,ENG,Pace,1982-08-26,Leeds,England,1982,2,131,270,6,1,717,1887,34,586,1617,28,21.08823529411765,<=30,ENG,Home,Upto 2014
RGD Willis,ENG,Pace,1982-11-12,W.A.C.A,Australia,1982,2,118,227,5,1,850,1760,19,732,1533,14,44.73684210526316,>30,AUS,Away,Upto 2014
RGD Willis,ENG,Pace,1982-11-26,Brisbane,Australia,1982,2,90,202,5,1,686,1313,27,596,1111,22,25.40740740740741,<=30,AUS,Away,Upto 2014
RGD Willis,ENG,Pace,1982-12-10,Adelaide,Australia,1982,2,93,198,3,1,666,1305,27,573,1107,24,24.666666666666668,<=30,AUS,Away,Upto 2014
RGD Willis,ENG,Pace,1982-12-26,Melbourne,Australia,1982,2,95,192,3,1,837,1586,32,742,1394,29,26.15625,<=30,AUS,Away,Upto 2014
RGD Willis,ENG,Pace,1983-01-02,Sydney,Australia,1983,2,90,180,2,1,595,1175,21,505,995,19,28.333333333333332,<=30,AUS,Away,Upto 2014
RGD Willis,ENG,Pace,1983-07-14,The Oval,England,1983,2,69,192,6,1,726,1662,20,657,1470,14,36.3,>30,ENG,Home,Upto 2014
RGD Willis,ENG,Pace,1983-07-28,Leeds,England,1983,2,92,225,9,1,786,1782,32,694,1557,23,24.5625,<=30,ENG,Home,Upto 2014
RGD Willis,ENG,Pace,1983-08-11,Lord's,England,1983,2,52,150,4,1,667,1618,29,615,1468,25,23.0,<=30,ENG,Home,Upto 2014
RGD Willis,ENG,Pace,1983-08-25,Nottingham,England,1983,2,60,174,1,1,763,1600,21,703,1426,20,36.333333333333336,>30,ENG,Home,Upto 2014
RGD Willis,ENG,Pace,1984-01-20,Wellington,New Zealand,1984,2,139,336,5,1,1002,2037,24,863,1701,19,41.75,>30,NZ,Away,Upto 2014
RGD Willis,ENG,Pace,1984-02-03,Christchurch,New Zealand,1984,1,51,133,4,1,404,927,25,353,794,21,16.16,<=30,NZ,Away,Upto 2014
RGD Willis,ENG,Pace,1984-02-10,Auckland,New Zealand,1984,2,116,222,3,1,656,1758,12,540,1536,9,54.666666666666664,>30,NZ,Away,Upto 2014
RGD Willis,ENG,Pace,1984-03-02,Karachi,Pakistan,1984,2,46,114,2,1,284,740,10,238,626,8,28.4,<=30,PAK,Away,Upto 2014
RGD Willis,ENG,Pace,1984-06-14,Birmingham,England,1984,1,108,150,2,1,672,1256,23,564,1106,21,29.217391304347824,<=30,ENG,Home,Upto 2014
RGD Willis,ENG,Pace,1984-06-28,Lord's,England,1984,2,96,204,2,1,986,1843,27,890,1639,25,36.51851851851852,>30,ENG,Home,Upto 2014
RGD Willis,ENG,Pace,1984-07-12,Leeds,England,1984,2,163,156,2,1,659,1294,24,496,1138,22,27.458333333333332,<=30,ENG,Home,Upto 2014
RGM Patel,IND,Pace,1988-11-24,Wankhede,India,1988,2,51,84,0,1,384,842,15,333,758,15,25.6,<=30,IND,Home,Upto 2014
RH Catterall,SA,Pace,1924-06-28,Lord's,England,1924,1,19,18,0,1,434,750,7,415,732,7,62.0,>30,ENG,Away,Upto 2014
RH Catterall,SA,Pace,1928-01-21,Durban,South Africa,1928,1,15,12,0,1,482,1079,8,467,1067,8,60.25,>30,SA,Home,Upto 2014
RH Catterall,SA,Pace,1929-08-17,The Oval,England,1929,1,18,18,0,1,426,1011,9,408,993,9,47.333333333333336,>30,ENG,Away,Upto 2014
RH Catterall,SA,Pace,1930-12-24,Johannesburg,South Africa,1930,1,12,30,2,1,390,954,25,378,924,23,15.6,<=30,SA,Home,Upto 2014
RH Catterall,SA,Pace,1931-01-01,Cape Town,South Africa,1931,2,17,102,3,1,323,942,8,306,840,5,40.375,>30,SA,Home,Upto 2014
RH Catterall,SA,Pace,1931-01-16,Durban,South Africa,1931,1,37,60,0,1,276,836,9,239,776,9,30.666666666666668,>30,SA,Home,Upto 2014
RH Catterall,SA,Pace,1931-02-13,Johannesburg,South Africa,1931,2,44,102,2,1,670,1471,21,626,1369,19,31.904761904761905,>30,SA,Home,Upto 2014
RH Scott,NZ,Pace,1947-03-21,Christchurch,New Zealand,1947,1,74,138,1,1,372,820,16,298,682,15,23.25,<=30,NZ,Home,Upto 2014
RH Shodhan,IND,Pace,1952-12-12,Eden Gardens,India,1952,1,6,12,0,1,409,1086,14,403,1074,14,29.214285714285715,<=30,IND,Home,Upto 2014
RH Shodhan,IND,Pace,1953-01-21,Port of Spain,West Indies,1953,2,20,48,0,1,431,1261,9,411,1213,9,47.888888888888886,>30,WI,Away,Upto 2014
RHD Sellers,AUS,Spin,1964-10-17,Eden Gardens,India,1964,1,17,30,0,1,407,1253,16,390,1223,16,25.4375,<=30,IND,Away,Upto 2014
RJ Bright,AUS,Spin,1977-07-07,Manchester,England,1977,2,75,241,3,1,431,1095,17,356,854,14,25.352941176470587,<=30,ENG,Away,Upto 2014
RJ Bright,AUS,Spin,1977-08-11,Leeds,England,1977,1,66,156,2,1,146,324,4,80,168,2,36.5,>30,ENG,Away,Upto 2014
RJ Bright,AUS,Spin,1977-08-25,The Oval,England,1977,2,6,36,0,1,125,294,2,119,258,2,62.5,>30,ENG,Away,Upto 2014
RJ Bright,AUS,Spin,1979-12-01,Brisbane,Australia,1979,2,105,216,1,1,171,384,1,66,168,0,171.0,>30,AUS,Home,Upto 2014
RJ Bright,AUS,Spin,1979-12-14,W.A.C.A,Australia,1979,2,36,150,1,1,247,666,5,211,516,4,49.4,>30,AUS,Home,Upto 2014
RJ Bright,AUS,Spin,1980-02-27,Karachi,Pakistan,1980,2,111,347,10,1,432,1328,28,321,981,18,15.428571428571429,<=30,PAK,Away,Upto 2014
RJ Bright,AUS,Spin,1980-03-06,Faisalabad,Pakistan,1980,1,71,198,0,1,592,1272,6,521,1074,6,98.66666666666667,>30,PAK,Away,Upto 2014
RJ Bright,AUS,Spin,1980-03-18,Lahore,Pakistan,1980,1,172,336,5,1,686,1374,15,514,1038,10,45.733333333333334,>30,PAK,Away,Upto 2014
RJ Bright,AUS,Spin,1980-08-28,Lord's,England,1980,2,94,276,0,1,326,734,3,232,458,3,108.66666666666667,>30,ENG,Away,Upto 2014
RJ Bright,AUS,Spin,1981-07-02,Lord's,England,1981,2,98,306,4,1,157,582,6,59,276,2,26.166666666666668,<=30,ENG,Away,Upto 2014
RJ Bright,AUS,Spin,1981-07-16,Leeds,England,1981,1,15,24,0,1,50,120,1,35,96,1,50.0,>30,ENG,Away,Upto 2014
RJ Bright,AUS,Spin,1981-07-30,Birmingham,England,1981,2,88,276,7,1,171,569,13,83,293,6,13.153846153846153,<=30,ENG,Away,Upto 2014
RJ Bright,AUS,Spin,1981-08-13,Manchester,England,1981,2,98,256,1,1,221,574,4,123,318,3,55.25,>30,ENG,Away,Upto 2014
RJ Bright,AUS,Spin,1981-08-27,The Oval,England,1981,2,91,288,0,1,225,564,1,134,276,1,225.0,>30,ENG,Away,Upto 2014
RJ Bright,AUS,Spin,1982-09-22,Karachi,Pakistan,1982,2,110,246,3,1,480,981,15,370,735,12,32.0,>30,PAK,Away,Upto 2014
RJ Bright,AUS,Spin,1982-09-30,Faisalabad,Pakistan,1982,1,107,246,0,1,662,1534,17,555,1288,17,38.94117647058823,>30,PAK,Away,Upto 2014
RJ Bright,AUS,Spin,1985-11-22,Sydney,Australia,1985,2,126,311,5,1,694,1882,25,568,1571,20,27.76,<=30,AUS,Home,Upto 2014
RJ Bright,AUS,Spin,1985-12-13,Adelaide,Australia,1985,1,80,264,1,1,282,786,3,202,522,2,94.0,>30,AUS,Home,Upto 2014
RJ Bright,AUS,Spin,1985-12-26,Melbourne,Australia,1985,2,81,228,0,1,583,1474,19,502,1246,19,30.68421052631579,>30,AUS,Home,Upto 2014
RJ Bright,AUS,Spin,1986-01-02,Sydney,Australia,1986,1,121,246,0,1,700,1797,15,579,1551,15,46.666666666666664,>30,AUS,Home,Upto 2014
RJ Bright,AUS,Spin,1986-02-28,Christchurch,New Zealand,1986,1,51,108,0,1,196,528,6,145,420,6,32.666666666666664,>30,NZ,Away,Upto 2014
RJ Bright,AUS,Spin,1986-03-13,Auckland,New Zealand,1986,2,87,270,2,1,300,1053,17,213,783,15,17.647058823529413,<=30,NZ,Away,Upto 2014
RJ Bright,AUS,Spin,1986-09-18,Chennai,India,1986,2,182,288,7,1,1032,1788,27,850,1500,20,38.22222222222222,>30,IND,Away,Upto 2014
RJ Bright,AUS,Spin,1986-10-15,Wankhede,India,1986,1,109,228,1,1,676,1768,13,567,1540,12,52.0,>30,IND,Away,Upto 2014
RJ Christiani,WI,Spin,1948-11-10,Delhi,India,1948,2,58,162,3,1,804,1710,13,746,1548,10,61.84615384615385,>30,IND,Away,Upto 2014
RJ Christiani,WI,Spin,1948-12-09,Brabourne,India,1948,1,30,36,0,1,780,1868,11,750,1832,11,70.9090909090909,>30,IND,Away,Upto 2014
RJ Christiani,WI,Spin,1948-12-31,Eden Gardens,India,1948,2,18,30,0,1,677,1523,19,659,1493,19,35.63157894736842,>30,IND,Away,Upto 2014
RJ Christiani,WI,Spin,1954-02-24,Georgetown,West Indies,1954,1,2,6,0,1,666,2079,21,664,2073,21,31.714285714285715,>30,WI,Home,Upto 2014
RJ Crisp,SA,Pace,1935-06-15,Nottingham,England,1935,1,49,108,2,1,248,671,10,199,563,8,24.8,<=30,ENG,Away,Upto 2014
RJ Crisp,SA,Pace,1935-06-29,Lord's,England,1935,2,62,138,2,1,344,844,15,282,706,13,22.933333333333334,<=30,ENG,Away,Upto 2014
RJ Crisp,SA,Pace,1935-07-13,Leeds,England,1935,2,78,149,2,1,570,1397,20,492,1248,18,28.5,<=30,ENG,Away,Upto 2014
RJ Crisp,SA,Pace,1935-07-27,Manchester,England,1935,2,142,223,6,1,592,1081,17,450,858,11,34.8235294117647,>30,ENG,Away,Upto 2014
RJ Crisp,SA,Pace,1935-08-17,The Oval,England,1935,1,113,168,1,1,741,1240,14,628,1072,13,52.92857142857143,>30,ENG,Away,Upto 2014
RJ Crisp,SA,Pace,1935-12-14,Durban,South Africa,1935,2,97,252,3,1,348,794,8,251,542,5,43.5,>30,SA,Home,Upto 2014
RJ Crisp,SA,Pace,1935-12-24,Johannesburg,South Africa,1935,2,111,192,1,1,547,996,13,436,804,12,42.07692307692308,>30,SA,Home,Upto 2014
RJ Crisp,SA,Pace,1936-01-01,Cape Town,South Africa,1936,1,30,84,1,1,144,300,3,114,216,2,48.0,>30,SA,Home,Upto 2014
RJ Crisp,SA,Pace,1936-02-28,Durban,South Africa,1936,1,65,114,2,1,320,685,7,255,571,5,45.714285714285715,>30,SA,Home,Upto 2014
RJ Harris,AUS,Pace,2010-03-19,Wellington,New Zealand,2010,2,119,246,6,1,767,1410,18,648,1164,12,42.611111111111114,>30,NZ,Away,Upto 2014
RJ Harris,AUS,Pace,2010-03-27,Hamilton,New Zealand,2010,2,88,177,3,1,795,1294,27,707,1117,24,29.444444444444443,<=30,NZ,Away,Upto 2014
RJ Harris,AUS,Pace,2010-12-03,Adelaide,Australia,2010,1,84,174,2,1,745,1313,14,661,1139,12,53.214285714285715,>30,AUS,Home,Upto 2014
RJ Harris,AUS,Pace,2010-12-16,W.A.C.A,Australia,2010,2,106,156,9,1,755,1419,38,649,1263,29,19.86842105263158,<=30,AUS,Home,Upto 2014
RJ Harris,AUS,Pace,2010-12-26,Melbourne,Australia,2010,1,91,172,0,1,704,1424,26,613,1252,26,27.076923076923077,<=30,AUS,Home,Upto 2014
RJ Harris,AUS,Pace,2011-08-31,Galle,Sri Lanka,2011,2,68,168,5,1,381,906,20,313,738,15,19.05,<=30,SL,Away,Upto 2014
RJ Harris,AUS,Pace,2011-09-08,Pallekele,Sri Lanka,2011,2,92,228,6,1,526,1180,17,434,952,11,30.941176470588236,>30,SL,Away,Upto 2014
RJ Harris,AUS,Pace,2011-11-09,Cape Town,South Africa,2011,2,100,147,4,1,597,929,31,497,782,27,19.258064516129032,<=30,SA,Away,Upto 2014
RJ Harris,AUS,Pace,2012-01-13,W.A.C.A,Australia,2012,2,67,204,2,1,668,1156,29,601,952,27,23.03448275862069,<=30,AUS,Home,Upto 2014
RJ Harris,AUS,Pace,2012-01-24,Adelaide,Australia,2012,2,112,264,4,1,749,1369,20,637,1105,16,37.45,>30,AUS,Home,Upto 2014
RJ Harris,AUS,Pace,2012-04-07,Bridgetown,West Indies,2012,2,114,226,5,1,725,1642,25,611,1416,20,29.0,<=30,WI,Away,Upto 2014
RJ Harris,AUS,Pace,2012-04-23,Roseau,West Indies,2012,2,70,150,1,1,492,1142,12,422,992,11,41.0,>30,WI,Away,Upto 2014
RJ Harris,AUS,Pace,2013-07-18,Lord's,England,2013,2,103,265,7,1,669,1424,21,566,1159,14,31.857142857142858,>30,ENG,Away,Upto 2014
RJ Harris,AUS,Pace,2013-08-01,Manchester,England,2013,2,95,228,4,1,710,1434,19,615,1206,15,37.36842105263158,>30,ENG,Away,Upto 2014
RJ Harris,AUS,Pace,2013-08-09,Chester-le-Street,England,2013,2,187,282,9,1,823,1578,29,636,1296,20,28.379310344827587,<=30,ENG,Away,Upto 2014
RJ Harris,AUS,Pace,2013-08-21,The Oval,England,2013,2,85,198,4,1,836,1443,25,751,1245,21,33.44,>30,ENG,Away,Upto 2014
RJ Harris,AUS,Pace,2013-11-21,Brisbane,Australia,2013,2,77,204,5,1,625,1326,30,548,1122,25,20.833333333333332,<=30,AUS,Home,Upto 2014
RJ Harris,AUS,Pace,2013-12-05,Adelaide,Australia,2013,2,85,202,3,1,606,1290,25,521,1088,22,24.24,<=30,AUS,Home,Upto 2014
RJ Harris,AUS,Pace,2013-12-13,W.A.C.A,Australia,2013,2,121,246,4,1,995,1739,27,874,1493,23,36.851851851851855,>30,AUS,Home,Upto 2014
RJ Harris,AUS,Pace,2013-12-26,Melbourne,Australia,2013,2,81,204,2,1,653,1410,24,572,1206,22,27.208333333333332,<=30,AUS,Home,Upto 2014
RJ Harris,AUS,Pace,2014-01-03,Sydney,Australia,2014,2,61,142,8,1,663,1122,33,602,980,25,20.09090909090909,<=30,AUS,Home,After 1965
RJ Harris,AUS,Pace,2014-02-12,Centurion,South Africa,2014,2,86,178,2,1,767,1417,27,681,1239,25,28.40740740740741,<=30,SA,Away,After 1965
RJ Harris,AUS,Pace,2014-02-20,Gqeberha,South Africa,2014,2,137,240,1,1,800,1419,22,663,1179,21,36.36363636363637,>30,SA,Away,After 1965
RJ Harris,AUS,Pace,2014-03-01,Cape Town,South Africa,2014,2,95,279,7,1,924,1728,25,829,1449,18,36.96,>30,SA,Away,After 1965
RJ Harris,AUS,Pace,2014-12-09,Adelaide,Australia,2014,2,104,240,2,1,885,1420,15,781,1180,13,59.0,>30,AUS,Home,After 1965
RJ Harris,AUS,Pace,2014-12-26,Melbourne,Australia,2014,2,100,252,6,1,1069,1880,27,969,1628,21,39.592592592592595,>30,AUS,Home,After 1965
RJ Harris,AUS,Pace,2015-01-06,Sydney,Australia,2015,2,130,264,2,1,942,1653,21,812,1389,19,44.857142857142854,>30,AUS,Home,After 1965
RJ Inverarity,AUS,Spin,1968-07-25,Leeds,England,1968,1,3,6,0,1,396,1367,16,393,1361,16,24.75,<=30,ENG,Away,Upto 2014
RJ Inverarity,AUS,Spin,1972-06-08,Manchester,England,1972,1,13,54,0,1,177,420,8,164,366,8,22.125,<=30,ENG,Away,Upto 2014
RJ Inverarity,AUS,Spin,1972-07-27,Leeds,England,1972,1,26,198,3,1,321,1171,22,295,973,19,14.590909090909092,<=30,ENG,Away,Upto 2014
RJ Inverarity,AUS,Spin,1972-08-10,The Oval,England,1972,2,51,114,1,1,544,1256,15,493,1142,14,36.266666666666666,>30,ENG,Away,Upto 2014
RJ Kennedy,NZ,Pace,1996-01-13,Hamilton,New Zealand,1996,2,47,102,3,1,657,1344,21,610,1242,18,31.285714285714285,>30,NZ,Home,Upto 2014
RJ Kennedy,NZ,Pace,1996-01-20,Auckland,New Zealand,1996,2,134,252,2,1,908,2025,23,774,1773,21,39.47826086956522,>30,NZ,Home,Upto 2014
RJ Kennedy,NZ,Pace,1996-04-19,Bridgetown,West Indies,1996,2,110,144,1,1,918,1755,25,808,1611,24,36.72,>30,WI,Away,Upto 2014
RJ Kennedy,NZ,Pace,1996-04-27,St John's,West Indies,1996,2,89,138,0,1,915,1920,26,826,1782,26,35.19230769230769,>30,WI,Away,Upto 2014
RJ Kirtley,ENG,Pace,2003-08-14,Nottingham,England,2003,2,114,284,8,1,935,1991,38,821,1707,30,24.605263157894736,<=30,ENG,Home,Upto 2014
RJ Kirtley,ENG,Pace,2003-08-21,Leeds,England,2003,2,145,309,5,1,1130,2145,39,985,1836,34,28.974358974358974,<=30,ENG,Home,Upto 2014
RJ Kirtley,ENG,Pace,2003-12-10,Kandy,Sri Lanka,2003,2,171,300,4,1,489,1010,13,318,710,9,37.61538461538461,>30,SL,Away,Upto 2014
RJ Kirtley,ENG,Pace,2003-12-18,Colombo (SSC),Sri Lanka,2003,1,131,186,2,1,444,738,12,313,552,10,37.0,>30,SL,Away,Upto 2014
RJ Nicol,NZ,Spin,2012-03-07,Dunedin,New Zealand,2012,2,9,12,0,1,209,528,4,200,516,4,52.25,>30,NZ,Home,Upto 2014
RJ Nicol,NZ,Spin,2012-03-15,Hamilton,New Zealand,2012,1,4,5,0,1,143,280,4,139,275,4,35.75,>30,NZ,Home,Upto 2014
RJ Peterson,SA,Spin,2003-05-01,Dhaka,Bangladesh,2003,2,68,215,5,1,312,727,15,244,512,10,20.8,<=30,BAN,Away,Upto 2014
RJ Peterson,SA,Spin,2003-07-24,Birmingham,England,2003,2,90,210,1,1,314,558,6,224,348,5,52.333333333333336,>30,ENG,Away,Upto 2014
RJ Peterson,SA,Spin,2003-10-24,Faisalabad,Pakistan,2003,2,61,138,1,1,613,1195,9,552,1057,8,68.11111111111111,>30,PAK,Away,Upto 2014
RJ Peterson,SA,Spin,2003-12-12,Johannesburg,South Africa,2003,2,94,96,0,1,214,258,1,120,162,1,214.0,>30,SA,Home,Upto 2014
RJ Peterson,SA,Spin,2004-11-20,Kanpur,India,2004,1,90,126,1,1,586,1360,13,496,1234,12,45.07692307692308,>30,IND,Away,Upto 2014
RJ Peterson,SA,Spin,2008-02-29,Chattogram,Bangladesh,2008,2,94,174,6,1,550,943,13,456,769,7,42.30769230769231,>30,BAN,Away,Upto 2014
RJ Peterson,SA,Spin,2012-11-30,W.A.C.A,Australia,2012,2,171,169,6,1,376,409,9,205,240,3,41.77777777777778,>30,AUS,Away,Upto 2014
RJ Peterson,SA,Spin,2013-01-02,Cape Town,South Africa,2013,1,42,96,1,1,102,198,1,60,102,0,102.0,>30,SA,Home,Upto 2014
RJ Peterson,SA,Spin,2013-01-11,Gqeberha,South Africa,2013,2,67,198,4,1,217,449,5,150,251,1,43.4,>30,SA,Home,Upto 2014
RJ Peterson,SA,Spin,2013-02-01,Johannesburg,South Africa,2013,1,24,60,0,1,230,410,6,206,350,6,38.333333333333336,>30,SA,Home,Upto 2014
RJ Peterson,SA,Spin,2013-02-14,Cape Town,South Africa,2013,2,167,314,5,1,363,754,16,196,440,11,22.6875,<=30,SA,Home,Upto 2014
RJ Peterson,SA,Spin,2013-02-22,Centurion,South Africa,2013,2,38,66,1,1,179,318,2,141,252,1,89.5,>30,SA,Home,Upto 2014
RJ Peterson,SA,Spin,2013-10-14,Abu Dhabi,UAE,2013,2,125,173,0,1,474,946,13,349,773,13,36.46153846153846,>30,UAE,Away,Upto 2014
RJ Peterson,SA,Spin,2013-12-26,Durban,South Africa,2013,2,149,276,4,1,373,798,11,224,522,7,33.90909090909091,>30,SA,Home,Upto 2014
RJ Peterson,SA,Spin,2014-02-12,Centurion,South Africa,2014,2,136,204,3,1,266,474,6,130,270,3,44.333333333333336,>30,SA,Home,After 1965
RJ Quiney,AUS,Pace,2012-11-09,Brisbane,Australia,2012,2,13,66,0,1,917,1756,14,904,1690,14,65.5,>30,AUS,Home,Upto 2014
RJ Quiney,AUS,Pace,2012-11-22,Adelaide,Australia,2012,2,16,84,0,1,863,1649,28,847,1565,28,30.821428571428573,>30,AUS,Home,Upto 2014
RJ Ratnayake,SL,Pace,1983-03-04,Christchurch,New Zealand,1983,1,125,186,2,1,557,1256,25,432,1070,23,22.28,<=30,NZ,Away,Upto 2014
RJ Ratnayake,SL,Pace,1983-03-11,Wellington,New Zealand,1983,2,127,234,5,1,592,1490,31,465,1256,26,19.096774193548388,<=30,NZ,Away,Upto 2014
RJ Ratnayake,SL,Pace,1983-04-22,Kandy,Sri Lanka,1983,1,108,168,0,1,440,696,7,332,528,7,62.857142857142854,>30,SL,Home,Upto 2014
RJ Ratnayake,SL,Pace,1984-03-09,Kandy,Sri Lanka,1984,1,45,90,1,1,359,767,20,314,677,19,17.95,<=30,SL,Home,Upto 2014
RJ Ratnayake,SL,Pace,1985-08-30,Colombo (SSC),Sri Lanka,1985,2,149,392,8,1,634,1521,27,485,1129,19,23.48148148148148,<=30,SL,Home,Upto 2014
RJ Ratnayake,SL,Pace,1985-09-06,Colombo (PSS),Sri Lanka,1985,2,125,291,9,1,740,1533,28,615,1242,19,26.428571428571427,<=30,SL,Home,Upto 2014
RJ Ratnayake,SL,Pace,1985-09-14,Kandy,Sri Lanka,1985,2,185,294,3,1,808,1515,25,623,1221,22,32.32,>30,SL,Home,Upto 2014
RJ Ratnayake,SL,Pace,1985-10-16,Faisalabad,Pakistan,1985,1,93,192,2,1,718,1505,9,625,1313,7,79.77777777777777,>30,PAK,Away,Upto 2014
RJ Ratnayake,SL,Pace,1985-10-27,Sialkot,Pakistan,1985,2,101,144,2,1,662,1204,31,561,1060,29,21.35483870967742,<=30,PAK,Away,Upto 2014
RJ Ratnayake,SL,Pace,1985-11-07,Karachi,Pakistan,1985,2,81,114,2,1,402,787,17,321,673,15,23.647058823529413,<=30,PAK,Away,Upto 2014
RJ Ratnayake,SL,Pace,1986-02-23,Kandy,Sri Lanka,1986,1,57,138,3,1,238,611,14,181,473,11,17.0,<=30,SL,Home,Upto 2014
RJ Ratnayake,SL,Pace,1986-12-27,Nagpur,India,1986,1,139,210,2,1,372,581,7,233,371,5,53.142857142857146,>30,IND,Away,Upto 2014
RJ Ratnayake,SL,Pace,1987-01-04,Cuttack,India,1987,1,98,180,1,1,333,711,12,235,531,11,27.75,<=30,IND,Away,Upto 2014
RJ Ratnayake,SL,Pace,1987-04-16,Colombo (CCC),Sri Lanka,1987,1,79,192,1,1,574,1325,10,495,1133,9,57.4,>30,SL,Home,Upto 2014
RJ Ratnayake,SL,Pace,1989-12-16,Hobart,Australia,1989,2,189,328,8,1,998,1920,27,809,1592,19,36.96296296296296,>30,AUS,Away,Upto 2014
RJ Ratnayake,SL,Pace,1990-11-23,Chandigarh,India,1990,1,60,131,3,1,244,603,12,184,472,9,20.333333333333332,<=30,IND,Away,Upto 2014
RJ Ratnayake,SL,Pace,1991-01-31,Wellington,New Zealand,1991,2,146,290,4,1,940,1788,23,794,1498,19,40.869565217391305,>30,NZ,Away,Upto 2014
RJ Ratnayake,SL,Pace,1991-02-22,Hamilton,New Zealand,1991,2,147,346,6,1,916,2000,25,769,1654,19,36.64,>30,NZ,Away,Upto 2014
RJ Ratnayake,SL,Pace,1991-03-01,Auckland,New Zealand,1991,2,127,324,3,1,890,1772,29,763,1448,26,30.689655172413794,>30,NZ,Away,Upto 2014
RJ Ratnayake,SL,Pace,1991-08-22,Lord's,England,1991,2,160,318,5,1,770,1537,23,610,1219,18,33.47826086956522,>30,ENG,Away,Upto 2014
RJ Ratnayake,SL,Pace,1991-12-12,Sialkot,Pakistan,1991,1,100,186,1,1,611,1329,14,511,1143,13,43.642857142857146,>30,PAK,Away,Upto 2014
RJ Ratnayake,SL,Pace,1991-12-20,Gujranwala,Pakistan,1991,1,39,78,1,1,97,210,2,58,132,1,48.5,>30,PAK,Away,Upto 2014
RJ Ratnayake,SL,Pace,1992-01-02,Faisalabad,Pakistan,1992,2,83,135,1,1,743,1706,36,660,1571,35,20.63888888888889,<=30,PAK,Away,Upto 2014
RJ Shastri,IND,Spin,1981-02-21,Wellington,New Zealand,1981,2,63,186,6,1,68,192,6,5,6,0,11.333333333333334,<=30,NZ,Away,Upto 2014
RJ Shastri,IND,Spin,1981-03-06,Christchurch,New Zealand,1981,1,65,252,2,1,157,612,3,92,360,1,52.333333333333336,>30,NZ,Away,Upto 2014
RJ Shastri,IND,Spin,1981-03-13,Auckland,New Zealand,1981,2,149,444,7,1,519,1803,22,370,1359,15,23.59090909090909,<=30,NZ,Away,Upto 2014
RJ Shastri,IND,Spin,1981-11-27,Wankhede,India,1981,1,27,114,1,1,162,553,10,135,439,9,16.2,<=30,IND,Home,Upto 2014
RJ Shastri,IND,Spin,1981-12-09,Bengaluru,India,1981,2,114,378,5,1,405,1140,11,291,762,6,36.81818181818182,>30,IND,Home,Upto 2014
RJ Shastri,IND,Spin,1981-12-23,Delhi,India,1981,1,109,162,0,1,331,798,4,222,636,4,82.75,>30,IND,Home,Upto 2014
RJ Shastri,IND,Spin,1982-01-01,Eden Gardens,India,1982,2,57,228,1,1,396,1328,13,339,1100,12,30.46153846153846,>30,IND,Home,Upto 2014
RJ Shastri,IND,Spin,1982-01-13,Chennai,India,1982,1,104,378,3,1,285,972,8,181,594,5,35.625,>30,IND,Home,Upto 2014
RJ Shastri,IND,Spin,1982-01-30,Kanpur,India,1982,1,51,138,2,1,274,704,7,223,566,5,39.142857142857146,>30,IND,Home,Upto 2014
RJ Shastri,IND,Spin,1982-06-10,Lord's,England,1982,2,82,216,0,1,261,594,2,179,378,2,130.5,>30,ENG,Away,Upto 2014
RJ Shastri,IND,Spin,1982-06-24,Manchester,England,1982,1,44,138,1,1,341,811,11,297,673,10,31.0,>30,ENG,Away,Upto 2014
RJ Shastri,IND,Spin,1982-07-08,The Oval,England,1982,2,149,345,3,1,576,1184,12,427,839,9,48.0,>30,ENG,Away,Upto 2014
RJ Shastri,IND,Spin,1982-12-10,Lahore,Pakistan,1982,2,114,216,0,1,261,509,6,147,293,6,43.5,>30,PAK,Away,Upto 2014
RJ Shastri,IND,Spin,1983-01-30,Karachi,Pakistan,1983,1,62,132,1,1,287,546,2,225,414,1,143.5,>30,PAK,Away,Upto 2014
RJ Shastri,IND,Spin,1983-02-23,Kingston,West Indies,1983,1,43,144,4,1,239,624,5,196,480,1,47.8,>30,WI,Away,Upto 2014
RJ Shastri,IND,Spin,1983-03-11,Port of Spain,West Indies,1983,1,71,126,2,1,280,699,7,209,573,5,40.0,>30,WI,Away,Upto 2014
RJ Shastri,IND,Spin,1983-03-31,Georgetown,West Indies,1983,1,84,132,1,1,357,630,4,273,498,3,89.25,>30,WI,Away,Upto 2014
RJ Shastri,IND,Spin,1983-04-15,Bridgetown,West Indies,1983,1,133,300,2,1,302,625,5,169,325,3,60.4,>30,WI,Away,Upto 2014
RJ Shastri,IND,Spin,1983-04-28,St John's,West Indies,1983,1,141,280,1,1,460,934,5,319,654,4,92.0,>30,WI,Away,Upto 2014
RJ Shastri,IND,Spin,1983-09-24,Jalandhar,India,1983,2,64,242,3,1,262,937,8,198,695,5,32.75,>30,IND,Home,Upto 2014
RJ Shastri,IND,Spin,1983-10-05,Nagpur,India,1983,1,75,184,5,1,396,1114,18,321,930,13,22.0,<=30,IND,Home,Upto 2014
RJ Shastri,IND,Spin,1983-10-21,Kanpur,India,1983,1,103,228,1,1,219,474,3,116,246,2,73.0,>30,IND,Home,Upto 2014
RJ Shastri,IND,Spin,1983-10-29,Delhi,India,1983,2,142,329,4,1,373,864,8,231,535,4,46.625,>30,IND,Home,Upto 2014
RJ Shastri,IND,Spin,1983-11-12,Ahmedabad,India,1983,2,54,111,1,1,250,501,5,196,390,4,50.0,>30,IND,Home,Upto 2014
RJ Shastri,IND,Spin,1983-11-24,Wankhede,India,1983,2,130,288,4,1,386,913,10,256,625,6,38.6,>30,IND,Home,Upto 2014
RJ Shastri,IND,Spin,1983-12-10,Eden Gardens,India,1983,1,56,108,0,1,206,486,5,150,378,5,41.2,>30,IND,Home,Upto 2014
RJ Shastri,IND,Spin,1983-12-24,Chennai,India,1983,2,82,204,2,1,365,891,7,283,687,5,52.142857142857146,>30,IND,Home,Upto 2014
RJ Shastri,IND,Spin,1984-10-17,Lahore,Pakistan,1984,1,90,276,3,1,362,1073,9,272,797,6,40.22222222222222,>30,PAK,Away,Upto 2014
RJ Shastri,IND,Spin,1984-10-24,Faisalabad,Pakistan,1984,1,99,301,1,1,475,1147,7,376,846,6,67.85714285714286,>30,PAK,Away,Upto 2014
RJ Shastri,IND,Spin,1984-11-28,Wankhede,India,1984,2,73,276,2,1,629,1557,23,556,1281,21,27.347826086956523,<=30,IND,Home,Upto 2014
RJ Shastri,IND,Spin,1984-12-12,Delhi,India,1984,2,64,198,0,1,622,1733,22,558,1535,22,28.272727272727273,<=30,IND,Home,Upto 2014
RJ Shastri,IND,Spin,1984-12-31,Eden Gardens,India,1984,1,44,138,0,1,444,1182,10,400,1044,10,44.4,>30,IND,Home,Upto 2014
RJ Shastri,IND,Spin,1985-01-13,Chennai,India,1985,2,145,258,2,1,779,1355,9,634,1097,7,86.55555555555556,>30,IND,Home,Upto 2014
RJ Shastri,IND,Spin,1985-01-31,Kanpur,India,1985,2,64,234,3,1,695,1644,9,631,1410,6,77.22222222222223,>30,IND,Home,Upto 2014
RJ Shastri,IND,Spin,1985-08-30,Colombo (SSC),Sri Lanka,1985,1,70,204,2,1,225,696,4,155,492,2,56.25,>30,SL,Away,Upto 2014
RJ Shastri,IND,Spin,1985-09-06,Colombo (PSS),Sri Lanka,1985,2,115,351,4,1,268,693,4,153,342,0,67.0,>30,SL,Away,Upto 2014
RJ Shastri,IND,Spin,1985-09-14,Kandy,Sri Lanka,1985,2,85,180,0,1,249,489,4,164,309,4,62.25,>30,SL,Away,Upto 2014
RJ Shastri,IND,Spin,1985-12-13,Adelaide,Australia,1985,2,70,234,0,1,282,786,3,212,552,3,94.0,>30,AUS,Away,Upto 2014
RJ Shastri,IND,Spin,1985-12-26,Melbourne,Australia,1985,2,179,504,8,1,583,1474,19,404,970,11,30.68421052631579,>30,AUS,Away,Upto 2014
RJ Shastri,IND,Spin,1986-01-02,Sydney,Australia,1986,2,137,492,6,1,700,1797,15,563,1305,9,46.666666666666664,>30,AUS,Away,Upto 2014
RJ Shastri,IND,Spin,1986-06-05,Lord's,England,1986,2,51,180,1,1,225,844,8,174,664,7,28.125,<=30,ENG,Away,Upto 2014
RJ Shastri,IND,Spin,1986-06-19,Leeds,England,1986,2,26,78,2,1,106,321,7,80,243,5,15.142857142857142,<=30,ENG,Away,Upto 2014
RJ Shastri,IND,Spin,1986-07-03,Birmingham,England,1986,2,84,222,2,1,336,971,13,252,749,11,25.846153846153847,<=30,ENG,Away,Upto 2014
RJ Shastri,IND,Spin,1986-09-18,Chennai,India,1986,2,211,366,3,1,1032,1788,27,821,1422,24,38.22222222222222,>30,IND,Home,Upto 2014
RJ Shastri,IND,Spin,1986-09-26,Delhi,India,1986,1,44,130,2,1,149,340,2,105,210,0,74.5,>30,IND,Home,Upto 2014
RJ Shastri,IND,Spin,1986-10-15,Wankhede,India,1986,2,128,432,2,1,676,1768,13,548,1336,11,52.0,>30,IND,Home,Upto 2014
RJ Shastri,IND,Spin,1986-12-17,Kanpur,India,1986,1,37,102,1,1,263,540,3,226,438,2,87.66666666666667,>30,IND,Home,Upto 2014
RJ Shastri,IND,Spin,1986-12-27,Nagpur,India,1986,2,44,66,0,1,408,845,19,364,779,19,21.473684210526315,<=30,IND,Home,Upto 2014
RJ Shastri,IND,Spin,1987-01-04,Cuttack,India,1987,2,33,96,4,1,354,865,18,321,769,14,19.666666666666668,<=30,IND,Home,Upto 2014
RJ Shastri,IND,Spin,1987-02-03,Chennai,India,1987,2,147,336,1,1,827,1860,14,680,1524,13,59.07142857142857,>30,IND,Home,Upto 2014
RJ Shastri,IND,Spin,1987-02-11,Eden Gardens,India,1987,2,59,269,2,1,258,750,5,199,481,3,51.6,>30,IND,Home,Upto 2014
RJ Shastri,IND,Spin,1987-02-21,Jaipur,India,1987,1,79,216,1,1,591,1283,13,512,1067,12,45.46153846153846,>30,IND,Home,Upto 2014
RJ Shastri,IND,Spin,1987-03-04,Ahmedabad,India,1987,2,49,174,0,1,616,1851,11,567,1677,11,56.0,>30,IND,Home,Upto 2014
RJ Shastri,IND,Spin,1987-03-13,Bengaluru,India,1987,2,88,210,5,1,527,1530,35,439,1320,30,15.057142857142857,<=30,IND,Home,Upto 2014
RJ Shastri,IND,Spin,1987-11-25,Delhi,India,1987,1,30,54,0,1,217,492,5,187,438,5,43.4,>30,IND,Home,Upto 2014
RJ Shastri,IND,Spin,1987-12-11,Wankhede,India,1987,1,71,171,4,1,252,507,7,181,336,3,36.0,>30,IND,Home,Upto 2014
RJ Shastri,IND,Spin,1987-12-26,Eden Gardens,India,1987,2,73,192,3,1,615,1451,5,542,1259,2,123.0,>30,IND,Home,Upto 2014
RJ Shastri,IND,Spin,1988-01-11,Chennai,India,1988,2,54,108,1,1,536,1127,23,482,1019,22,23.304347826086957,<=30,IND,Home,Upto 2014
RJ Shastri,IND,Spin,1988-11-12,Bengaluru,India,1988,2,32,126,0,1,620,1702,21,588,1576,21,29.523809523809526,<=30,IND,Home,Upto 2014
RJ Shastri,IND,Spin,1988-11-24,Wankhede,India,1988,2,80,168,4,1,479,1162,25,399,994,21,19.16,<=30,IND,Home,Upto 2014
RJ Shastri,IND,Spin,1988-12-02,Hyderabad (Deccan),India,1988,2,25,57,1,1,319,748,13,294,691,12,24.53846153846154,<=30,IND,Home,Upto 2014
RJ Shastri,IND,Spin,1989-03-25,Georgetown,West Indies,1989,1,87,198,0,1,322,618,6,235,420,6,53.666666666666664,>30,WI,Away,Upto 2014
RJ Shastri,IND,Spin,1989-04-07,Bridgetown,West Indies,1989,2,119,234,4,1,380,726,8,261,492,4,47.5,>30,WI,Away,Upto 2014
RJ Shastri,IND,Spin,1989-04-15,Port of Spain,West Indies,1989,2,90,270,2,1,406,1089,11,316,819,9,36.90909090909091,>30,WI,Away,Upto 2014
RJ Shastri,IND,Spin,1989-04-28,Kingston,West Indies,1989,2,43,120,1,1,262,519,4,219,399,3,65.5,>30,WI,Away,Upto 2014
RJ Shastri,IND,Spin,1989-11-15,Karachi,Pakistan,1989,2,52,90,0,1,349,576,2,297,486,2,174.5,>30,PAK,Away,Upto 2014
RJ Shastri,IND,Spin,1989-11-23,Faisalabad,Pakistan,1989,1,29,54,0,1,216,414,1,187,360,1,216.0,>30,PAK,Away,Upto 2014
RJ Shastri,IND,Spin,1989-12-01,Lahore,Pakistan,1989,1,104,160,2,1,665,1174,7,561,1014,5,95.0,>30,PAK,Away,Upto 2014
RJ Shastri,IND,Spin,1990-07-26,Lord's,England,1990,2,137,174,0,1,488,672,6,351,498,6,81.33333333333333,>30,ENG,Away,Upto 2014
RJ Shastri,IND,Spin,1990-08-09,Manchester,England,1990,2,89,161,1,1,724,1465,14,635,1304,13,51.714285714285715,>30,ENG,Away,Upto 2014
RJ Shastri,IND,Spin,1990-08-23,The Oval,England,1990,2,115,240,1,1,500,1062,6,385,822,5,83.33333333333333,>30,ENG,Away,Upto 2014
RJ Shastri,IND,Spin,1991-12-26,Melbourne,Australia,1991,2,32,60,1,1,193,372,3,161,312,2,64.33333333333333,>30,AUS,Away,Upto 2014
RJ Shastri,IND,Spin,1992-01-02,Sydney,Australia,1992,2,82,228,4,1,301,666,6,219,438,2,50.166666666666664,>30,AUS,Away,Upto 2014
RJ Shastri,IND,Spin,1992-10-18,Harare,Zimbabwe,1992,2,84,174,1,1,383,1070,9,299,896,8,42.55555555555556,>30,ZIM,Away,Upto 2014
RJ Shastri,IND,Spin,1992-11-13,Durban,South Africa,1992,2,60,150,2,1,210,547,7,150,397,5,30.0,<=30,SA,Away,Upto 2014
RJ Shastri,IND,Spin,1992-11-26,Johannesburg,South Africa,1992,1,10,24,0,1,138,480,8,128,456,8,17.25,<=30,SA,Away,Upto 2014
RJ Shastri,IND,Spin,1992-12-26,Gqeberha,South Africa,1992,1,4,12,0,1,329,957,7,325,945,7,47.0,>30,SA,Away,Upto 2014
RJ Sidebottom,ENG,Pace,2001-05-17,Lord's,England,2001,2,64,120,0,1,714,1443,30,650,1323,30,23.8,<=30,ENG,Home,Upto 2014
RJ Sidebottom,ENG,Pace,2007-05-25,Leeds,England,2007,2,86,162,8,1,714,1084,23,628,922,15,31.043478260869566,>30,ENG,Home,Upto 2014
RJ Sidebottom,ENG,Pace,2007-06-07,Manchester,England,2007,2,101,234,3,1,901,1654,29,800,1420,26,31.06896551724138,>30,ENG,Home,Upto 2014
RJ Sidebottom,ENG,Pace,2007-06-15,Chester-le-Street,England,2007,2,128,264,5,1,807,1380,26,679,1116,21,31.03846153846154,>30,ENG,Home,Upto 2014
RJ Sidebottom,ENG,Pace,2007-07-19,Lord's,England,2007,2,107,246,6,1,762,1573,34,655,1327,28,22.41176470588235,<=30,ENG,Home,Upto 2014
RJ Sidebottom,ENG,Pace,2007-07-27,Nottingham,England,2007,2,103,264,1,1,762,1633,23,659,1369,22,33.130434782608695,>30,ENG,Home,Upto 2014
RJ Sidebottom,ENG,Pace,2007-08-09,The Oval,England,2007,1,93,192,1,1,888,1674,23,795,1482,22,38.608695652173914,>30,ENG,Home,Upto 2014
RJ Sidebottom,ENG,Pace,2007-12-01,Kandy,Sri Lanka,2007,2,123,240,1,1,767,1367,21,644,1127,20,36.523809523809526,>30,SL,Away,Upto 2014
RJ Sidebottom,ENG,Pace,2007-12-09,Colombo (SSC),Sri Lanka,2007,1,100,216,3,1,676,1421,13,576,1205,10,52.0,>30,SL,Away,Upto 2014
RJ Sidebottom,ENG,Pace,2007-12-18,Galle,Sri Lanka,2007,1,95,204,1,1,606,1192,16,511,988,15,37.875,>30,SL,Away,Upto 2014
RJ Sidebottom,ENG,Pace,2008-03-05,Hamilton,New Zealand,2008,2,139,309,10,1,672,1450,27,533,1141,17,24.88888888888889,<=30,NZ,Away,Upto 2014
RJ Sidebottom,ENG,Pace,2008-03-13,Wellington,New Zealand,2008,2,141,288,6,1,966,1899,38,825,1611,32,25.42105263157895,<=30,NZ,Away,Upto 2014
RJ Sidebottom,ENG,Pace,2008-03-22,Napier,New Zealand,2008,2,130,249,8,1,793,1402,23,663,1153,15,34.47826086956522,>30,NZ,Away,Upto 2014
RJ Sidebottom,ENG,Pace,2008-05-15,Lord's,England,2008,2,120,298,6,1,640,1330,19,520,1032,13,33.68421052631579,>30,ENG,Home,Upto 2014
RJ Sidebottom,ENG,Pace,2008-05-23,Manchester,England,2008,2,112,236,4,1,614,1172,16,502,936,12,38.375,>30,ENG,Home,Upto 2014
RJ Sidebottom,ENG,Pace,2008-06-05,Nottingham,England,2008,2,116,246,7,1,579,1236,29,463,990,22,19.96551724137931,<=30,ENG,Home,Upto 2014
RJ Sidebottom,ENG,Pace,2008-07-10,Lord's,England,2008,2,87,294,3,1,845,1704,13,758,1410,10,65.0,>30,ENG,Home,Upto 2014
RJ Sidebottom,ENG,Pace,2008-07-30,Birmingham,England,2008,2,107,210,3,1,903,1618,29,796,1408,26,31.137931034482758,>30,ENG,Home,Upto 2014
RJ Sidebottom,ENG,Pace,2009-02-04,Kingston,West Indies,2009,1,35,144,0,1,444,1066,20,409,922,20,22.2,<=30,WI,Away,Upto 2014
RJ Sidebottom,ENG,Pace,2009-02-26,Bridgetown,West Indies,2009,1,146,210,1,1,977,1508,9,831,1298,8,108.55555555555556,>30,WI,Away,Upto 2014
RJ Sidebottom,ENG,Pace,2010-01-14,Johannesburg,South Africa,2010,1,98,186,2,1,644,1109,23,546,923,21,28.0,<=30,SA,Away,Upto 2014
RJ Westcott,SA,Pace,1957-12-31,Cape Town,South Africa,1957,1,22,32,0,1,357,1102,8,335,1070,8,44.625,>30,SA,Home,Upto 2014
RJD Jamshedji,IND,Spin,1933-12-15,Mumbai,India,1933,1,137,210,3,1,373,858,11,236,648,8,33.90909090909091,>30,IND,Home,Upto 2014
RK Chauhan,IND,Spin,1993-01-29,Eden Gardens,India,1993,2,109,445,5,1,470,1482,23,361,1037,18,20.434782608695652,<=30,IND,Home,Upto 2014
RK Chauhan,IND,Spin,1993-02-11,Chennai,India,1993,2,128,363,3,1,792,1720,20,664,1357,17,39.6,>30,IND,Home,Upto 2014
RK Chauhan,IND,Spin,1993-02-19,Wankhede,India,1993,2,86,210,1,1,804,1796,20,718,1586,19,40.2,>30,IND,Home,Upto 2014
RK Chauhan,IND,Spin,1993-03-13,Delhi,India,1993,2,98,253,2,1,645,1548,21,547,1295,19,30.714285714285715,>30,IND,Home,Upto 2014
RK Chauhan,IND,Spin,1993-07-27,Colombo (SSC),Sri Lanka,1993,2,62,204,1,1,544,1136,16,482,932,15,34.0,>30,SL,Away,Upto 2014
RK Chauhan,IND,Spin,1993-08-04,Colombo (PSS),Sri Lanka,1993,2,135,354,3,1,715,1623,16,580,1269,13,44.6875,>30,SL,Away,Upto 2014
RK Chauhan,IND,Spin,1994-01-18,Lucknow,India,1994,2,84,216,2,1,633,1538,23,549,1322,21,27.52173913043478,<=30,IND,Home,Upto 2014
RK Chauhan,IND,Spin,1994-01-26,Bengaluru,India,1994,1,44,96,2,1,625,1188,15,581,1092,13,41.666666666666664,>30,IND,Home,Upto 2014
RK Chauhan,IND,Spin,1994-02-08,Ahmedabad,India,1994,2,53,246,6,1,473,1433,26,420,1187,20,18.192307692307693,<=30,IND,Home,Upto 2014
RK Chauhan,IND,Spin,1994-03-19,Hamilton,New Zealand,1994,2,138,300,5,1,491,1160,14,353,860,9,35.07142857142857,>30,NZ,Away,Upto 2014
RK Chauhan,IND,Spin,1994-11-18,Wankhede,India,1994,2,102,216,2,1,528,1096,17,426,880,15,31.058823529411764,>30,IND,Home,Upto 2014
RK Chauhan,IND,Spin,1994-12-01,Nagpur,India,1994,2,112,234,1,1,761,1735,22,649,1501,21,34.59090909090909,>30,IND,Home,Upto 2014
RK Chauhan,IND,Spin,1995-10-18,Bengaluru,India,1995,2,38,120,1,1,388,811,15,350,691,14,25.866666666666667,<=30,IND,Home,Upto 2014
RK Chauhan,IND,Spin,1997-08-02,Colombo (RPS),Sri Lanka,1997,1,276,468,1,1,1044,2082,8,768,1614,7,130.5,>30,SL,Away,Upto 2014
RK Chauhan,IND,Spin,1997-11-19,Mohali,India,1997,2,57,204,1,1,502,1356,8,445,1152,7,62.75,>30,IND,Home,Upto 2014
RK Chauhan,IND,Spin,1997-12-03,Wankhede,India,1997,2,107,360,7,1,533,1312,21,426,952,14,25.38095238095238,<=30,IND,Home,Upto 2014
RK Chauhan,IND,Spin,1998-03-06,Chennai,India,1998,2,156,282,3,1,809,1753,28,653,1471,25,28.892857142857142,<=30,IND,Home,Upto 2014
RK Chauhan,IND,Spin,1998-03-18,Eden Gardens,India,1998,2,72,178,1,1,634,1306,12,562,1128,11,52.833333333333336,>30,IND,Home,Upto 2014
RK Illingworth,ENG,Spin,1991-07-04,Nottingham,England,1991,2,115,210,3,1,144,282,3,29,72,0,48.0,>30,ENG,Home,Upto 2014
RK Illingworth,ENG,Spin,1991-07-25,Birmingham,England,1991,2,98,130,1,1,126,226,1,28,96,0,126.0,>30,ENG,Home,Upto 2014
RK Illingworth,ENG,Spin,1995-06-08,Leeds,England,1995,2,81,162,1,1,96,186,2,15,24,1,48.0,>30,ENG,Home,Upto 2014
RK Illingworth,ENG,Spin,1995-06-22,Lord's,England,1995,2,27,84,0,1,98,234,2,71,150,2,49.0,>30,ENG,Home,Upto 2014
RK Illingworth,ENG,Spin,1995-07-06,Birmingham,England,1995,1,11,48,1,1,11,48,1,0,0,0,11.0,<=30,ENG,Home,Upto 2014
RK Illingworth,ENG,Spin,1995-08-10,Nottingham,England,1995,1,96,306,4,1,465,1032,7,369,726,3,66.42857142857143,>30,ENG,Home,Upto 2014
RK Illingworth,ENG,Spin,1995-12-14,Durban,South Africa,1995,1,37,174,3,1,42,186,3,5,12,0,14.0,<=30,SA,Away,Upto 2014
RK Illingworth,ENG,Spin,1995-12-26,Gqeberha,South Africa,1995,2,150,371,6,1,309,845,10,159,474,4,30.9,>30,SA,Away,Upto 2014
RK Kleinveldt,SA,Pace,2012-11-09,Brisbane,Australia,2012,1,97,126,0,1,917,1756,14,820,1630,14,65.5,>30,AUS,Away,Upto 2014
RK Kleinveldt,SA,Pace,2012-11-22,Adelaide,Australia,2012,2,146,235,4,1,863,1649,28,717,1414,24,30.821428571428573,>30,AUS,Away,Upto 2014
RK Kleinveldt,SA,Pace,2013-01-11,Gqeberha,South Africa,2013,2,97,156,4,1,619,1262,23,522,1106,19,26.91304347826087,<=30,SA,Home,Upto 2014
RK Kleinveldt,SA,Pace,2013-02-22,Centurion,South Africa,2013,2,82,150,2,1,578,1050,26,496,900,24,22.23076923076923,<=30,SA,Home,Upto 2014
RK Oxenham,AUS,Pace,1928-12-29,Melbourne,Australia,1928,2,111,378,1,1,730,1882,14,619,1504,13,52.142857142857146,>30,AUS,Home,Upto 2014
RK Oxenham,AUS,Pace,1929-02-01,Adelaide,Australia,1929,2,118,496,4,1,620,1906,12,502,1410,8,51.666666666666664,>30,AUS,Home,Upto 2014
RK Oxenham,AUS,Pace,1929-03-08,Melbourne,Australia,1929,2,120,334,2,1,826,2351,25,706,2017,23,33.04,>30,AUS,Home,Upto 2014
RK Oxenham,AUS,Pace,1931-01-16,Brisbane,Australia,1931,2,76,288,6,1,443,984,16,367,696,10,27.6875,<=30,AUS,Home,Upto 2014
RK Oxenham,AUS,Pace,1931-02-13,Melbourne,Australia,1931,1,14,36,0,1,238,438,7,224,402,7,34.0,>30,AUS,Home,Upto 2014
RK Oxenham,AUS,Pace,1931-02-27,Sydney,Australia,1931,2,65,204,1,1,407,995,14,342,791,13,29.071428571428573,<=30,AUS,Home,Upto 2014
RK Oxenham,AUS,Pace,1931-11-27,Brisbane,Australia,1931,1,18,66,0,1,377,952,14,359,886,14,26.928571428571427,<=30,AUS,Home,Upto 2014
RK Tyldesley,ENG,Spin,1924-06-28,Lord's,England,1924,2,102,360,6,1,563,1396,14,461,1036,8,40.214285714285715,>30,ENG,Home,Upto 2014
RK Tyldesley,ENG,Spin,1924-07-12,Leeds,England,1924,2,100,222,3,1,557,1271,20,457,1049,17,27.85,<=30,ENG,Home,Upto 2014
RK Tyldesley,ENG,Spin,1924-07-26,Manchester,England,1924,1,11,71,1,1,64,287,4,53,216,3,16.0,<=30,ENG,Home,Upto 2014
RK Tyldesley,ENG,Spin,1924-08-16,The Oval,England,1924,1,36,132,2,1,425,954,15,389,822,13,28.333333333333332,<=30,ENG,Home,Upto 2014
RK Tyldesley,ENG,Spin,1925-01-01,Melbourne,Australia,1925,2,136,296,0,1,988,2427,24,852,2131,24,41.166666666666664,>30,AUS,Away,Upto 2014
RK Tyldesley,ENG,Spin,1930-06-13,Nottingham,England,1930,2,130,336,5,1,620,1484,29,490,1148,24,21.379310344827587,<=30,ENG,Home,Upto 2014
RK Tyldesley,ENG,Spin,1930-07-11,Leeds,England,1930,1,104,198,2,1,548,1255,15,444,1057,13,36.53333333333333,>30,ENG,Home,Upto 2014
RKJ Dawson,ENG,Spin,2001-12-03,Mohali,India,2001,1,134,258,4,1,507,1147,21,373,889,17,24.142857142857142,<=30,IND,Away,Upto 2014
RKJ Dawson,ENG,Spin,2001-12-11,Ahmedabad,India,2001,2,145,282,2,1,727,1868,25,582,1586,23,29.08,<=30,IND,Away,Upto 2014
RKJ Dawson,ENG,Spin,2002-11-21,Adelaide,Australia,2002,1,143,222,2,1,378,744,13,235,522,11,29.076923076923077,<=30,AUS,Away,Upto 2014
RKJ Dawson,ENG,Spin,2002-11-29,W.A.C.A,Australia,2002,1,21,30,0,1,250,379,8,229,349,8,31.25,>30,AUS,Away,Upto 2014
RKJ Dawson,ENG,Spin,2002-12-26,Melbourne,Australia,2002,1,121,168,2,1,514,870,12,393,702,10,42.833333333333336,>30,AUS,Away,Upto 2014
RKJ Dawson,ENG,Spin,2003-01-02,Sydney,Australia,2003,2,113,156,1,1,339,666,6,226,510,5,56.5,>30,AUS,Away,Upto 2014
RL Chase,WI,Spin,2016-07-21,North Sound,West Indies,2016,1,102,204,0,1,560,1009,16,458,805,16,35.0,>30,WI,Home,After 1965
RL Chase,WI,Spin,2016-07-30,Kingston,West Indies,2016,1,121,217,5,1,562,982,15,441,765,10,37.46666666666667,>30,WI,Home,After 1965
RL Chase,WI,Spin,2016-08-09,Gros Islet,West Indies,2016,2,111,264,3,1,298,783,9,187,519,6,33.111111111111114,>30,WI,Home,After 1965
RL Chase,WI,Spin,2016-10-13,Dubai (DICS),UAE,2016,1,109,198,1,1,657,1312,22,548,1114,21,29.863636363636363,<=30,UAE,Away,After 1965
RL Chase,WI,Spin,2016-10-21,Abu Dhabi,UAE,2016,2,106,150,0,1,703,1324,15,597,1174,15,46.86666666666667,>30,UAE,Away,After 1965
RL Chase,WI,Spin,2016-10-30,Sharjah,UAE,2016,2,94,210,2,1,457,972,14,363,762,12,32.642857142857146,>30,UAE,Away,After 1965
RL Chase,WI,Spin,2017-04-21,Kingston,West Indies,2017,1,37,52,1,1,338,583,11,301,531,10,30.727272727272727,>30,WI,Home,After 1965
RL Chase,WI,Spin,2017-04-30,Bridgetown,West Indies,2017,1,74,114,0,1,516,1000,13,442,886,13,39.69230769230769,>30,WI,Home,After 1965
RL Chase,WI,Spin,2017-05-10,Roseau,West Indies,2017,2,134,246,5,1,500,993,18,366,747,13,27.77777777777778,<=30,WI,Home,After 1965
RL Chase,WI,Spin,2017-08-17,Birmingham,England,2017,1,113,158,4,1,188,290,7,75,132,3,26.857142857142858,<=30,ENG,Away,After 1965
RL Chase,WI,Spin,2017-08-25,Leeds,England,2017,2,145,264,3,1,415,774,7,270,510,4,59.285714285714285,>30,ENG,Away,After 1965
RL Chase,WI,Spin,2017-09-07,Lord's,England,2017,1,25,30,0,1,84,138,1,59,108,1,84.0,>30,ENG,Away,After 1965
RL Chase,WI,Spin,2017-10-21,Bulawayo,Zimbabwe,2017,2,67,88,2,1,674,1311,28,607,1223,26,24.071428571428573,<=30,ZIM,Away,After 1965
RL Chase,WI,Spin,2017-10-29,Bulawayo,Zimbabwe,2017,2,81,186,1,1,706,1640,15,625,1454,14,47.06666666666667,>30,ZIM,Away,After 1965
RL Chase,WI,Spin,2017-12-01,Wellington,New Zealand,2017,1,95,168,2,1,166,328,3,71,160,1,55.333333333333336,>30,NZ,Away,After 1965
RL Chase,WI,Spin,2017-12-09,Hamilton,New Zealand,2017,2,141,184,2,1,199,291,4,58,107,2,49.75,>30,NZ,Away,After 1965
RL Chase,WI,Spin,2018-06-06,Port of Spain,West Indies,2018,1,15,50,4,1,353,866,12,338,816,8,29.416666666666668,<=30,WI,Home,After 1965
RL Chase,WI,Spin,2018-06-14,Gros Islet,West Indies,2018,2,40,66,0,1,246,492,2,206,426,2,123.0,>30,WI,Home,After 1965
RL Chase,WI,Spin,2018-07-04,North Sound,West Indies,2018,1,4,6,0,1,218,480,6,214,474,6,36.333333333333336,>30,WI,Home,After 1965
RL Chase,WI,Spin,2018-07-12,Kingston,West Indies,2018,2,42,96,2,1,399,810,18,357,714,16,22.166666666666668,<=30,WI,Home,After 1965
RL Chase,WI,Spin,2018-10-04,Rajkot,India,2018,1,137,156,1,1,685,1000,22,548,844,21,31.136363636363637,>30,IND,Away,After 1965
RL Chase,WI,Spin,2018-10-12,Hyderabad,India,2018,2,36,78,0,1,524,1095,12,488,1017,12,43.666666666666664,>30,IND,Away,After 1965
RL Chase,WI,Spin,2018-11-22,Chattogram,Bangladesh,2018,2,60,107,3,1,618,1097,34,558,990,31,18.176470588235293,<=30,BAN,Away,After 1965
RL Chase,WI,Spin,2018-11-30,Mirpur,Bangladesh,2018,1,111,168,1,1,676,1230,27,565,1062,26,25.037037037037038,<=30,BAN,Away,After 1965
RL Chase,WI,Spin,2019-01-23,Bridgetown,West Indies,2019,1,60,130,8,1,371,593,12,311,463,4,30.916666666666668,>30,WI,Home,After 1965
RL Chase,WI,Spin,2019-01-31,North Sound,West Indies,2019,1,31,48,0,1,94,204,3,63,156,3,31.333333333333332,>30,WI,Home,After 1965
RL Chase,WI,Spin,2019-02-09,Gros Islet,West Indies,2019,2,132,246,0,1,312,576,7,180,330,7,44.57142857142857,>30,WI,Home,After 1965
RL Chase,WI,Spin,2019-08-22,North Sound,West Indies,2019,2,190,324,6,1,347,560,8,157,236,2,43.375,>30,WI,Home,After 1965
RL Chase,WI,Spin,2019-08-30,Kingston,West Indies,2019,2,67,102,0,1,328,690,8,261,588,8,41.0,>30,WI,Home,After 1965
RL Chase,WI,Spin,2019-11-27,Lucknow,India,2019,2,20,48,3,1,473,932,25,453,884,22,18.92,<=30,IND,Away,After 1965
RL Chase,WI,Spin,2020-07-08,Southampton,England,2020,1,71,150,2,1,162,342,4,91,192,2,40.5,>30,ENG,Away,After 1965
RL Chase,WI,Spin,2020-07-16,Manchester,England,2020,1,172,264,5,1,307,518,8,135,254,3,38.375,>30,ENG,Away,After 1965
RL Chase,WI,Spin,2020-07-24,Manchester,England,2020,2,97,150,3,1,261,426,3,164,276,0,87.0,>30,ENG,Away,After 1965
RL Chase,WI,Spin,2020-12-03,Hamilton,New Zealand,2020,1,109,150,0,1,123,168,0,14,18,0,inf,>30,NZ,Away,After 1965
RL Chase,WI,Spin,2020-12-11,Wellington,New Zealand,2020,1,54,78,2,1,54,78,2,0,0,0,27.0,<=30,NZ,Away,After 1965
RL Chase,WI,Spin,2021-06-10,Gros Islet,West Indies,2021,1,14,54,0,1,104,252,3,90,198,3,34.666666666666664,>30,WI,Home,After 1965
RL Chase,WI,Spin,2021-06-18,Gros Islet,West Indies,2021,1,26,90,0,1,133,351,8,107,261,8,16.625,<=30,WI,Home,After 1965
RL Chase,WI,Spin,2021-08-12,Kingston,West Indies,2021,2,45,84,0,1,139,246,0,94,162,0,inf,>30,WI,Home,After 1965
RL Chase,WI,Spin,2021-08-20,Kingston,West Indies,2021,1,32,48,0,1,122,240,4,90,192,4,30.5,>30,WI,Home,After 1965
RL Chase,WI,Spin,2021-11-21,Galle,Sri Lanka,2021,2,111,209,5,1,748,1629,31,637,1420,26,24.129032258064516,<=30,SL,Away,After 1965
RL Chase,WI,Spin,2021-11-29,Galle,Sri Lanka,2021,2,146,246,3,1,790,1806,36,644,1560,33,21.944444444444443,<=30,SL,Away,After 1965
RL Chase,WI,Spin,2022-11-30,Perth,Australia,2022,2,171,222,1,1,497,783,13,326,561,12,38.23076923076923,>30,AUS,Away,After 1965
RL Chase,WI,Spin,2022-12-08,Adelaide,Australia,2022,2,142,204,2,1,274,456,7,132,252,5,39.142857142857146,>30,AUS,Away,After 1965
RL Chase,WI,Spin,2023-02-04,Bulawayo,Zimbabwe,2023,2,54,156,2,1,573,1170,18,519,1014,16,31.833333333333332,>30,ZIM,Away,After 1965
RL Chase,WI,Spin,2023-02-12,Bulawayo,Zimbabwe,2023,2,34,78,1,1,284,566,18,250,488,17,15.777777777777779,<=30,ZIM,Away,After 1965
RL Chase,WI,Spin,2023-02-28,Centurion,South Africa,2023,1,33,84,0,1,47,138,0,14,54,0,inf,>30,SA,Away,After 1965
RL Chase,WI,Spin,2023-03-08,Johannesburg,South Africa,2023,2,99,168,0,1,406,700,11,307,532,11,36.90909090909091,>30,SA,Away,After 1965
RL Dias,SL,Spin,1987-04-16,Colombo (CCC),Sri Lanka,1987,1,17,24,0,1,223,696,4,206,672,4,55.75,>30,SL,Home,Upto 2014
RL Fuller,WI,Pace,1935-03-14,Kingston,West Indies,1935,2,12,48,0,1,412,902,15,400,854,15,27.466666666666665,<=30,WI,Home,Upto 2014
RL Johnson,ENG,Pace,2003-06-05,Chester-le-Street,England,2003,2,100,204,6,1,554,1098,27,454,894,21,20.51851851851852,<=30,ENG,Home,Upto 2014
RL Johnson,ENG,Pace,2003-10-29,Chattogram,Bangladesh,2003,2,93,199,9,1,551,1109,24,458,910,15,22.958333333333332,<=30,BAN,Away,Upto 2014
RL Johnson,ENG,Pace,2003-12-02,Galle,Sri Lanka,2003,2,82,144,1,1,348,780,10,266,636,9,34.8,>30,SL,Away,Upto 2014
RL Park,AUS,Spin,1920-12-31,Melbourne,Australia,1920,1,9,6,0,1,436,860,13,427,854,13,33.53846153846154,>30,AUS,Home,Upto 2014
RL Powell,WI,Spin,1999-12-16,Hamilton,New Zealand,1999,1,13,30,0,1,276,775,8,263,745,8,34.5,>30,NZ,Away,Upto 2014
RL Powell,WI,Spin,2004-04-10,St John's,West Indies,2004,1,36,48,0,1,477,993,7,441,945,7,68.14285714285714,>30,WI,Home,Upto 2014
RL Sanghvi,IND,Spin,2001-02-27,Wankhede,India,2001,2,78,74,2,1,392,686,14,314,612,12,28.0,<=30,IND,Home,Upto 2014
RM Cowper,AUS,Spin,1964-10-10,Brabourne,India,1964,2,42,102,0,1,796,2173,26,754,2071,26,30.615384615384617,>30,IND,Away,Upto 2014
RM Cowper,AUS,Spin,1964-10-17,Eden Gardens,India,1964,1,14,36,0,1,407,1253,16,393,1217,16,25.4375,<=30,IND,Away,Upto 2014
RM Cowper,AUS,Spin,1964-10-24,Karachi,Pakistan,1964,1,36,66,1,1,840,2130,18,804,2064,17,46.666666666666664,>30,PAK,Away,Upto 2014
RM Cowper,AUS,Spin,1965-03-03,Kingston,West Indies,1965,1,27,54,0,1,482,1161,15,455,1107,15,32.13333333333333,>30,WI,Away,Upto 2014
RM Cowper,AUS,Spin,1965-03-26,Port of Spain,West Indies,1965,2,53,78,1,1,736,1898,17,683,1820,16,43.294117647058826,>30,WI,Away,Upto 2014
RM Cowper,AUS,Spin,1965-04-14,Georgetown,West Indies,1965,1,1,6,0,1,385,975,21,384,969,21,18.333333333333332,<=30,WI,Away,Upto 2014
RM Cowper,AUS,Spin,1965-05-05,Bridgetown,West Indies,1965,2,83,174,0,1,856,1946,10,773,1772,10,85.6,>30,WI,Away,Upto 2014
RM Cowper,AUS,Spin,1965-05-14,Port of Spain,West Indies,1965,1,26,36,1,1,396,885,11,370,849,10,36.0,>30,WI,Away,Upto 2014
RM Cowper,AUS,Spin,1965-12-10,Brisbane,Australia,1965,2,27,104,1,1,514,1281,8,487,1177,7,64.25,>30,AUS,Home,Upto 2014
RM Cowper,AUS,Spin,1965-12-30,Melbourne,Australia,1965,1,16,24,1,1,661,1476,9,645,1452,8,73.44444444444444,>30,AUS,Home,Upto 2014
RM Cowper,AUS,Spin,1966-01-07,Sydney,Australia,1966,1,33,48,0,1,404,1124,13,371,1076,13,31.076923076923077,>30,AUS,Home,Upto 2014
RM Cowper,AUS,Spin,1966-12-23,Johannesburg,South Africa,1966,2,77,132,1,1,549,1041,11,472,909,10,49.90909090909091,>30,SA,Away,Upto 2014
RM Cowper,AUS,Spin,1966-12-31,Cape Town,South Africa,1966,2,49,96,1,1,643,1501,10,594,1405,9,64.3,>30,SA,Away,Upto 2014
RM Cowper,AUS,Spin,1967-01-20,Durban,South Africa,1967,2,86,324,4,1,209,570,4,123,246,0,52.25,>30,SA,Away,Upto 2014
RM Cowper,AUS,Spin,1967-02-03,Johannesburg,South Africa,1967,1,36,90,1,1,91,210,4,55,120,3,22.75,<=30,SA,Away,Upto 2014
RM Cowper,AUS,Spin,1967-02-24,Gqeberha,South Africa,1967,2,53,189,3,1,222,502,6,169,313,3,37.0,>30,SA,Away,Upto 2014
RM Cowper,AUS,Spin,1967-12-23,Adelaide,Australia,1967,1,14,24,0,1,620,1381,10,606,1357,10,62.0,>30,AUS,Home,Upto 2014
RM Cowper,AUS,Spin,1967-12-30,Melbourne,Australia,1967,1,20,64,1,1,312,712,11,292,648,10,28.363636363636363,<=30,AUS,Home,Upto 2014
RM Cowper,AUS,Spin,1968-01-19,Brisbane,Australia,1968,2,135,438,7,1,711,2018,22,576,1580,15,32.31818181818182,>30,AUS,Home,Upto 2014
RM Cowper,AUS,Spin,1968-01-26,Sydney,Australia,1968,2,70,302,5,1,552,1735,27,482,1433,22,20.444444444444443,<=30,AUS,Home,Upto 2014
RM Cowper,AUS,Spin,1968-06-06,Manchester,England,1968,2,130,390,6,1,456,1101,19,326,711,13,24.0,<=30,ENG,Away,Upto 2014
RM Cowper,AUS,Spin,1968-06-20,Lord's,England,1968,1,40,48,0,1,103,330,4,63,282,4,25.75,<=30,ENG,Away,Upto 2014
RM Cowper,AUS,Spin,1968-07-11,Birmingham,England,1968,1,25,42,0,1,212,680,8,187,638,8,26.5,<=30,ENG,Away,Upto 2014
RM Cowper,AUS,Spin,1968-07-25,Leeds,England,1968,2,46,138,2,1,396,1367,16,350,1229,14,24.75,<=30,ENG,Away,Upto 2014
RM Edwards,WI,Pace,1968-12-26,Melbourne,Australia,1968,1,128,208,1,1,513,1176,14,385,968,13,36.642857142857146,>30,AUS,Away,Upto 2014
RM Edwards,WI,Pace,1969-01-03,Sydney,Australia,1969,2,146,208,2,1,677,1377,20,531,1169,18,33.85,>30,AUS,Away,Upto 2014
RM Edwards,WI,Pace,1969-02-27,Auckland,New Zealand,1969,2,129,320,6,1,544,1153,15,415,833,9,36.266666666666666,>30,NZ,Away,Upto 2014
RM Edwards,WI,Pace,1969-03-07,Wellington,New Zealand,1969,2,126,287,7,1,575,1263,24,449,976,17,23.958333333333332,<=30,NZ,Away,Upto 2014
RM Edwards,WI,Pace,1969-03-13,Christchurch,New Zealand,1969,2,97,288,2,1,436,944,10,339,656,8,43.6,>30,NZ,Away,Upto 2014
RM Ellison,ENG,Pace,1984-08-09,The Oval,England,1984,2,94,264,5,1,809,1686,40,715,1422,35,20.225,<=30,ENG,Home,Upto 2014
RM Ellison,ENG,Pace,1984-08-23,Lord's,England,1984,2,106,210,1,1,850,1633,19,744,1423,18,44.73684210526316,>30,ENG,Home,Upto 2014
RM Ellison,ENG,Pace,1984-11-28,Wankhede,India,1984,1,85,108,0,1,378,744,6,293,636,6,63.0,>30,IND,Away,Upto 2014
RM Ellison,ENG,Pace,1984-12-12,Delhi,India,1984,2,86,198,4,1,406,798,8,320,600,4,50.75,>30,IND,Away,Upto 2014
RM Ellison,ENG,Pace,1984-12-31,Eden Gardens,India,1984,2,118,324,0,1,288,729,8,170,405,8,36.0,>30,IND,Away,Upto 2014
RM Ellison,ENG,Pace,1985-08-15,Birmingham,England,1985,2,104,245,10,1,829,1344,20,725,1099,10,41.45,>30,ENG,Home,Upto 2014
RM Ellison,ENG,Pace,1985-08-29,The Oval,England,1985,2,81,210,7,1,567,1067,25,486,857,18,22.68,<=30,ENG,Home,Upto 2014
RM Ellison,ENG,Pace,1986-02-21,Kingston,West Indies,1986,1,78,198,5,1,543,1027,29,465,829,24,18.724137931034484,<=30,WI,Away,Upto 2014
RM Ellison,ENG,Pace,1986-03-07,Port of Spain,West Indies,1986,2,70,126,0,1,694,1180,22,624,1054,22,31.545454545454547,>30,WI,Away,Upto 2014
RM Ellison,ENG,Pace,1986-04-11,St John's,West Indies,1986,2,146,171,2,1,906,1622,22,760,1451,20,41.18181818181818,>30,WI,Away,Upto 2014
RM Ellison,ENG,Pace,1986-06-05,Lord's,England,1986,2,80,210,1,1,690,1580,26,610,1370,25,26.53846153846154,<=30,ENG,Home,Upto 2014
RM Hogg,AUS,Pace,1978-12-01,Brisbane,Australia,1978,2,109,325,7,1,633,1750,28,524,1425,21,22.607142857142858,<=30,AUS,Home,Upto 2014
RM Hogg,AUS,Pace,1978-12-15,W.A.C.A,Australia,1978,2,122,381,10,1,652,1878,31,530,1497,21,21.032258064516128,<=30,AUS,Home,Upto 2014
RM Hogg,AUS,Pace,1978-12-29,Melbourne,Australia,1978,2,66,272,10,1,456,1463,27,390,1191,17,16.88888888888889,<=30,AUS,Home,Upto 2014
RM Hogg,AUS,Pace,1979-01-06,Sydney,Australia,1979,2,103,312,6,1,452,1414,19,349,1102,13,23.789473684210527,<=30,AUS,Home,Upto 2014
RM Hogg,AUS,Pace,1979-01-27,Adelaide,Australia,1979,2,85,306,7,1,561,1654,30,476,1348,23,18.7,<=30,AUS,Home,Upto 2014
RM Hogg,AUS,Pace,1979-02-10,Sydney,Australia,1979,1,42,144,1,1,293,735,11,251,591,10,26.636363636363637,<=30,AUS,Home,Upto 2014
RM Hogg,AUS,Pace,1979-03-10,Melbourne,Australia,1979,2,124,288,7,1,679,1863,29,555,1575,22,23.413793103448278,<=30,AUS,Home,Upto 2014
RM Hogg,AUS,Pace,1979-03-24,W.A.C.A,Australia,1979,2,133,312,3,1,924,2172,25,791,1860,22,36.96,>30,AUS,Home,Upto 2014
RM Hogg,AUS,Pace,1979-09-11,Chennai,India,1979,1,85,132,2,1,448,938,6,363,806,4,74.66666666666667,>30,IND,Away,Upto 2014
RM Hogg,AUS,Pace,1979-09-19,Bengaluru,India,1979,1,118,192,0,1,384,678,4,266,486,4,96.0,>30,IND,Away,Upto 2014
RM Hogg,AUS,Pace,1979-10-02,Kanpur,India,1979,2,115,270,5,1,482,1119,27,367,849,22,17.85185185185185,<=30,IND,Away,Upto 2014
RM Hogg,AUS,Pace,1979-10-13,Delhi,India,1979,1,91,198,0,1,509,1106,14,418,908,14,36.357142857142854,>30,IND,Away,Upto 2014
RM Hogg,AUS,Pace,1979-10-26,Eden Gardens,India,1979,2,129,206,2,1,481,1011,15,352,805,13,32.06666666666667,>30,IND,Away,Upto 2014
RM Hogg,AUS,Pace,1979-11-03,Wankhede,India,1979,1,53,168,2,1,295,643,9,242,475,7,32.77777777777778,>30,IND,Away,Upto 2014
RM Hogg,AUS,Pace,1979-12-01,Brisbane,Australia,1979,2,66,180,2,1,937,2006,27,871,1826,25,34.7037037037037,>30,AUS,Home,Upto 2014
RM Hogg,AUS,Pace,1979-12-29,Melbourne,Australia,1979,1,59,36,0,1,659,1369,27,600,1333,27,24.40740740740741,<=30,AUS,Home,Upto 2014
RM Hogg,AUS,Pace,1980-12-12,W.A.C.A,Australia,1980,2,54,156,4,1,516,1220,27,462,1064,23,19.11111111111111,<=30,AUS,Home,Upto 2014
RM Hogg,AUS,Pace,1980-12-26,Melbourne,Australia,1980,2,74,206,6,1,683,1801,29,609,1595,23,23.551724137931036,<=30,AUS,Home,Upto 2014
RM Hogg,AUS,Pace,1981-01-02,Sydney,Australia,1981,2,75,138,2,1,622,1071,25,547,933,23,24.88,<=30,AUS,Home,Upto 2014
RM Hogg,AUS,Pace,1981-01-23,Adelaide,Australia,1981,2,111,186,2,1,673,1308,18,562,1122,16,37.388888888888886,>30,AUS,Home,Upto 2014
RM Hogg,AUS,Pace,1981-06-18,Nottingham,England,1981,2,55,88,3,1,571,1418,36,516,1330,33,15.86111111111111,<=30,ENG,Away,Upto 2014
RM Hogg,AUS,Pace,1981-07-30,Birmingham,England,1981,2,68,156,1,1,525,1321,25,457,1165,24,21.0,<=30,ENG,Away,Upto 2014
RM Hogg,AUS,Pace,1982-12-10,Adelaide,Australia,1982,2,94,198,3,1,666,1305,27,572,1107,24,24.666666666666668,<=30,AUS,Home,Upto 2014
RM Hogg,AUS,Pace,1982-12-26,Melbourne,Australia,1982,2,133,273,7,1,837,1586,32,704,1313,25,26.15625,<=30,AUS,Home,Upto 2014
RM Hogg,AUS,Pace,1983-01-02,Sydney,Australia,1983,2,75,174,1,1,595,1175,21,520,1001,20,28.333333333333332,<=30,AUS,Home,Upto 2014
RM Hogg,AUS,Pace,1983-04-22,Kandy,Sri Lanka,1983,2,38,90,1,1,440,696,7,402,606,6,62.857142857142854,>30,SL,Away,Upto 2014
RM Hogg,AUS,Pace,1983-11-11,W.A.C.A,Australia,1983,2,92,199,4,1,628,1218,24,536,1019,20,26.166666666666668,<=30,AUS,Home,Upto 2014
RM Hogg,AUS,Pace,1983-11-25,Brisbane,Australia,1983,2,54,108,2,1,428,757,16,374,649,14,26.75,<=30,AUS,Home,Upto 2014
RM Hogg,AUS,Pace,1983-12-09,Adelaide,Australia,1983,1,123,204,1,1,947,1786,20,824,1582,19,47.35,>30,AUS,Home,Upto 2014
RM Hogg,AUS,Pace,1984-01-02,Sydney,Australia,1984,2,114,192,2,1,768,1631,25,654,1439,23,30.72,>30,AUS,Home,Upto 2014
RM Hogg,AUS,Pace,1984-03-02,Georgetown,West Indies,1984,2,104,150,2,1,692,1314,20,588,1164,18,34.6,>30,WI,Away,Upto 2014
RM Hogg,AUS,Pace,1984-03-16,Port of Spain,West Indies,1984,1,103,186,1,1,693,1381,19,590,1195,18,36.473684210526315,>30,WI,Away,Upto 2014
RM Hogg,AUS,Pace,1984-03-30,Bridgetown,West Indies,1984,1,77,196,6,1,810,1566,27,733,1370,21,30.0,<=30,WI,Away,Upto 2014
RM Hogg,AUS,Pace,1984-04-28,Kingston,West Indies,1984,2,85,128,0,1,537,1132,24,452,1004,24,22.375,<=30,WI,Away,Upto 2014
RM Hogg,AUS,Pace,1984-11-09,W.A.C.A,Australia,1984,1,101,192,4,1,700,1337,30,599,1145,26,23.333333333333332,<=30,AUS,Home,Upto 2014
RM Hogg,AUS,Pace,1984-11-23,Brisbane,Australia,1984,2,85,151,1,1,749,1407,30,664,1256,29,24.966666666666665,<=30,AUS,Home,Upto 2014
RM Hogg,AUS,Pace,1984-12-07,Adelaide,Australia,1984,2,152,294,4,1,771,1535,30,619,1241,26,25.7,<=30,AUS,Home,Upto 2014
RM Hogg,AUS,Pace,1984-12-22,Melbourne,Australia,1984,2,136,246,2,1,827,1673,26,691,1427,24,31.807692307692307,>30,AUS,Home,Upto 2014
RM Poore,SA,Spin,1896-02-13,Gqeberha,South Africa,1896,1,4,9,1,1,134,318,10,130,309,9,13.4,<=30,SA,Home,After 1965
RM Prideaux,ENG,Pace,1969-02-21,Lahore,Pakistan,1969,1,0,12,0,1,347,758,16,347,746,16,21.6875,<=30,PAK,Away,Upto 2014
RMH Binny,IND,Pace,1979-11-21,Bengaluru,India,1979,2,50,78,0,1,355,754,9,305,676,9,39.44444444444444,>30,IND,Home,Upto 2014
RMH Binny,IND,Pace,1979-12-04,Delhi,India,1979,2,88,162,4,1,647,1401,30,559,1239,26,21.566666666666666,<=30,IND,Home,Upto 2014
RMH Binny,IND,Pace,1979-12-16,Wankhede,India,1979,2,55,84,3,1,330,772,18,275,688,15,18.333333333333332,<=30,IND,Home,Upto 2014
RMH Binny,IND,Pace,1979-12-25,Kanpur,India,1979,1,76,113,2,1,450,1133,20,374,1020,18,22.5,<=30,IND,Home,Upto 2014
RMH Binny,IND,Pace,1980-01-15,Chennai,India,1980,2,75,138,0,1,708,1186,22,633,1048,22,32.18181818181818,>30,IND,Home,Upto 2014
RMH Binny,IND,Pace,1980-01-29,Eden Gardens,India,1980,2,55,150,2,1,644,1456,21,589,1306,19,30.666666666666668,>30,IND,Home,Upto 2014
RMH Binny,IND,Pace,1980-02-15,Wankhede,India,1980,1,70,114,1,1,555,1195,28,485,1081,27,19.821428571428573,<=30,IND,Home,Upto 2014
RMH Binny,IND,Pace,1981-01-02,Sydney,Australia,1981,1,70,90,0,1,622,1071,25,552,981,25,24.88,<=30,AUS,Away,Upto 2014
RMH Binny,IND,Pace,1981-02-21,Wellington,New Zealand,1981,2,93,204,3,1,725,1705,33,632,1501,30,21.96969696969697,<=30,NZ,Away,Upto 2014
RMH Binny,IND,Pace,1983-09-14,Bengaluru,India,1983,1,42,108,0,1,497,1170,18,455,1062,18,27.61111111111111,<=30,IND,Home,Upto 2014
RMH Binny,IND,Pace,1983-09-24,Jalandhar,India,1983,1,69,96,2,1,450,936,11,381,840,9,40.90909090909091,>30,IND,Home,Upto 2014
RMH Binny,IND,Pace,1983-10-21,Kanpur,India,1983,1,74,102,1,1,584,1065,26,510,963,25,22.46153846153846,<=30,IND,Home,Upto 2014
RMH Binny,IND,Pace,1983-10-29,Delhi,India,1983,2,51,108,0,1,784,1399,23,733,1291,23,34.08695652173913,>30,IND,Home,Upto 2014
RMH Binny,IND,Pace,1983-11-12,Ahmedabad,India,1983,1,18,36,3,1,524,1257,33,506,1221,30,15.878787878787879,<=30,IND,Home,Upto 2014
RMH Binny,IND,Pace,1983-11-24,Wankhede,India,1983,1,11,24,0,1,698,1403,16,687,1379,16,43.625,>30,IND,Home,Upto 2014
RMH Binny,IND,Pace,1983-12-10,Eden Gardens,India,1983,1,62,78,1,1,475,988,25,413,910,24,19.0,<=30,IND,Home,Upto 2014
RMH Binny,IND,Pace,1983-12-24,Chennai,India,1983,2,62,84,2,1,443,882,12,381,798,10,36.916666666666664,>30,IND,Home,Upto 2014
RMH Binny,IND,Pace,1984-10-17,Lahore,Pakistan,1984,1,20,48,0,1,564,1248,16,544,1200,16,35.25,>30,PAK,Away,Upto 2014
RMH Binny,IND,Pace,1985-09-14,Kandy,Sri Lanka,1985,1,49,72,2,1,808,1515,25,759,1443,23,32.32,>30,SL,Away,Upto 2014
RMH Binny,IND,Pace,1985-12-13,Adelaide,Australia,1985,1,56,144,1,1,620,1368,17,564,1224,16,36.470588235294116,>30,AUS,Away,Upto 2014
RMH Binny,IND,Pace,1985-12-26,Melbourne,Australia,1985,1,11,18,0,1,429,932,13,418,914,13,33.0,>30,AUS,Away,Upto 2014
RMH Binny,IND,Pace,1986-06-05,Lord's,England,1986,2,99,200,4,1,690,1580,26,591,1380,22,26.53846153846154,<=30,ENG,Away,Upto 2014
RMH Binny,IND,Pace,1986-06-19,Leeds,England,1986,2,58,126,7,1,608,1416,31,550,1290,24,19.612903225806452,<=30,ENG,Away,Upto 2014
RMH Binny,IND,Pace,1986-07-03,Birmingham,England,1986,2,94,198,1,1,804,1599,21,710,1401,20,38.285714285714285,>30,ENG,Away,Upto 2014
RMH Binny,IND,Pace,1987-02-11,Eden Gardens,India,1987,2,101,277,8,1,698,1442,20,597,1165,12,34.9,>30,IND,Home,Upto 2014
RMH Binny,IND,Pace,1987-03-13,Bengaluru,India,1987,1,25,18,0,1,134,282,5,109,264,5,26.8,<=30,IND,Home,Upto 2014
RMH Cottam,ENG,Pace,1969-02-21,Lahore,Pakistan,1969,2,85,212,6,1,347,758,16,262,546,10,21.6875,<=30,PAK,Away,Upto 2014
RMH Cottam,ENG,Pace,1969-02-28,Dhaka,Bangladesh,1969,2,95,343,3,1,300,937,11,205,594,8,27.272727272727273,<=30,BAN,Away,Upto 2014
RMH Cottam,ENG,Pace,1972-12-20,Delhi,India,1972,2,84,180,2,1,207,536,11,123,356,9,18.818181818181817,<=30,IND,Away,Upto 2014
RMH Cottam,ENG,Pace,1972-12-30,Eden Gardens,India,1972,2,63,168,3,1,194,522,10,131,354,7,19.4,<=30,IND,Away,Upto 2014
RMMP Rathnayake,SL,Pace,2024-08-21,Manchester,England,2024,2,97,150,2,1,733,1160,25,636,1010,23,29.32,<=30,ENG,Away,After 1965
RMMP Rathnayake,SL,Pace,2024-08-29,Lord's,England,2024,2,125,192,4,1,781,1252,34,656,1060,30,22.970588235294116,<=30,ENG,Away,After 1965
RMMP Rathnayake,SL,Pace,2024-09-06,The Oval,England,2024,2,99,121,4,1,809,1069,28,710,948,24,28.892857142857142,<=30,ENG,Away,After 1965
RMMP Rathnayake,SL,Pace,2024-09-26,Galle,Sri Lanka,2024,1,7,12,0,1,205,300,2,198,288,2,102.5,>30,SL,Home,After 1965
RMS Eranga,SL,Pace,2011-09-16,Colombo (SSC),Sri Lanka,2011,2,127,254,5,1,825,1634,20,698,1380,15,41.25,>30,SL,Home,Upto 2014
RMS Eranga,SL,Pace,2012-11-17,Galle,Sri Lanka,2012,2,61,120,3,1,371,706,14,310,586,11,26.5,<=30,SL,Home,Upto 2014
RMS Eranga,SL,Pace,2012-11-25,Colombo (PSS),Sri Lanka,2012,2,130,192,2,1,530,1109,22,400,917,20,24.09090909090909,<=30,SL,Home,Upto 2014
RMS Eranga,SL,Pace,2012-12-14,Hobart,Australia,2012,2,143,216,2,1,927,1883,26,784,1667,24,35.65384615384615,>30,AUS,Away,Upto 2014
RMS Eranga,SL,Pace,2012-12-26,Melbourne,Australia,2012,1,109,162,3,1,518,864,21,409,702,18,24.666666666666668,<=30,AUS,Away,Upto 2014
RMS Eranga,SL,Pace,2013-03-08,Galle,Sri Lanka,2013,2,132,222,3,1,420,696,6,288,474,3,70.0,>30,SL,Home,Upto 2014
RMS Eranga,SL,Pace,2013-03-16,Colombo (RPS),Sri Lanka,2013,2,79,178,3,1,510,982,14,431,804,11,36.42857142857143,>30,SL,Home,Upto 2014
RMS Eranga,SL,Pace,2013-12-31,Abu Dhabi,UAE,2013,2,118,246,3,1,807,1581,20,689,1335,17,40.35,>30,UAE,Away,Upto 2014
RMS Eranga,SL,Pace,2014-01-08,Dubai (DICS),UAE,2014,2,99,300,4,1,719,1539,21,620,1239,17,34.23809523809524,>30,UAE,Away,After 1965
RMS Eranga,SL,Pace,2014-01-16,Sharjah,UAE,2014,2,128,237,5,1,610,1197,18,482,960,13,33.888888888888886,>30,UAE,Away,After 1965
RMS Eranga,SL,Pace,2014-01-27,Mirpur,Bangladesh,2014,2,75,142,5,1,519,875,13,444,733,8,39.92307692307692,>30,BAN,Away,After 1965
RMS Eranga,SL,Pace,2014-06-12,Lord's,England,2014,2,226,288,6,1,1099,1996,30,873,1708,24,36.63333333333333,>30,ENG,Away,After 1965
RMS Eranga,SL,Pace,2014-06-20,Leeds,England,2014,2,131,340,5,1,1059,2060,34,928,1720,29,31.147058823529413,>30,ENG,Away,After 1965
RMS Eranga,SL,Pace,2014-07-16,Galle,Sri Lanka,2014,1,32,54,0,1,420,962,20,388,908,20,21.0,<=30,SL,Home,After 1965
RMS Eranga,SL,Pace,2014-08-06,Galle,Sri Lanka,2014,2,122,270,1,1,513,974,10,391,704,9,51.3,>30,SL,Home,After 1965
RMS Eranga,SL,Pace,2014-12-26,Christchurch,New Zealand,2014,2,102,150,2,1,757,1417,28,655,1267,26,27.035714285714285,<=30,NZ,Away,After 1965
RMS Eranga,SL,Pace,2016-05-19,Leeds,England,2016,1,68,114,1,1,468,901,27,400,787,26,17.333333333333332,<=30,ENG,Away,After 1965
RMS Eranga,SL,Pace,2016-05-27,Chester-le-Street,England,2016,2,104,168,0,1,773,1433,25,669,1265,25,30.92,>30,ENG,Away,After 1965
RMS Eranga,SL,Pace,2016-06-09,Lord's,England,2016,2,152,238,4,1,770,1481,24,618,1243,20,32.083333333333336,>30,ENG,Away,After 1965
RN Harvey,AUS,Spin,1949-12-31,Cape Town,South Africa,1949,1,5,24,0,1,803,1732,19,798,1708,19,42.26315789473684,>30,SA,Away,Upto 2014
RN Harvey,AUS,Spin,1950-02-10,Johannesburg,South Africa,1950,1,6,24,0,1,517,1176,4,511,1152,4,129.25,>30,SA,Away,Upto 2014
RN Harvey,AUS,Spin,1952-12-05,Brisbane,Australia,1952,1,0,8,0,1,592,1609,17,592,1601,17,34.8235294117647,>30,AUS,Home,Upto 2014
RN Harvey,AUS,Spin,1953-01-24,Adelaide,Australia,1953,1,9,56,1,1,857,2379,23,848,2323,22,37.26086956521739,>30,AUS,Home,Upto 2014
RN Harvey,AUS,Spin,1953-07-09,Manchester,England,1953,1,2,18,0,1,250,603,14,248,585,14,17.857142857142858,<=30,ENG,Away,Upto 2014
RN Harvey,AUS,Spin,1955-03-26,Kingston,West Indies,1955,1,2,6,0,1,550,1394,11,548,1388,11,50.0,>30,WI,Away,Upto 2014
RN Harvey,AUS,Spin,1955-05-14,Bridgetown,West Indies,1955,1,16,24,0,1,1042,2444,22,1026,2420,22,47.36363636363637,>30,WI,Away,Upto 2014
RN Harvey,AUS,Spin,1956-11-02,Eden Gardens,India,1956,1,0,6,0,1,552,1533,35,552,1527,35,15.771428571428572,<=30,IND,Away,Upto 2014
RN Harvey,AUS,Spin,1959-11-21,Lahore,Pakistan,1959,1,8,30,0,1,563,1378,18,555,1348,18,31.27777777777778,>30,PAK,Away,Upto 2014
RN Harvey,AUS,Spin,1959-12-12,Delhi,India,1959,1,0,6,0,1,348,919,18,348,913,18,19.333333333333332,<=30,IND,Away,Upto 2014
RN Harvey,AUS,Spin,1959-12-19,Kanpur,India,1959,1,31,72,1,1,496,1305,26,465,1233,25,19.076923076923077,<=30,IND,Away,Upto 2014
RN Harvey,AUS,Spin,1960-01-01,Brabourne,India,1960,1,11,18,0,1,351,876,9,340,858,9,39.0,>30,IND,Away,Upto 2014
RN Harvey,AUS,Spin,1960-01-13,Chennai,India,1960,2,17,84,1,1,351,1231,17,334,1147,16,20.647058823529413,<=30,IND,Away,Upto 2014
RN Harvey,AUS,Spin,1961-08-17,The Oval,England,1961,1,0,6,0,1,415,906,9,415,900,9,46.111111111111114,>30,ENG,Away,Upto 2014
RN Harvey,AUS,Spin,1963-01-25,Adelaide,Australia,1963,1,0,8,0,1,524,1033,6,524,1025,6,87.33333333333333,>30,AUS,Home,Upto 2014
RN Harvey,AUS,Spin,1963-02-15,Sydney,Australia,1963,1,13,24,0,1,588,2042,17,575,2018,17,34.588235294117645,>30,AUS,Home,Upto 2014
RN Lewis,WI,Spin,1997-11-17,Peshawar,Pakistan,1997,1,93,144,0,1,271,573,12,178,429,12,22.583333333333332,<=30,PAK,Away,Upto 2014
RN Lewis,WI,Spin,1998-11-26,Johannesburg,South Africa,1998,2,112,245,1,1,205,491,4,93,246,3,51.25,>30,SA,Away,Upto 2014
RN Lewis,WI,Spin,1998-12-26,Durban,South Africa,1998,2,113,196,0,1,241,454,1,128,258,1,241.0,>30,SA,Away,Upto 2014
RN Lewis,WI,Spin,2006-03-17,Wellington,New Zealand,2006,1,70,174,0,1,176,438,2,106,264,2,88.0,>30,NZ,Away,Upto 2014
RN Lewis,WI,Spin,2008-01-02,Cape Town,South Africa,2008,2,68,124,3,1,172,365,4,104,241,1,43.0,>30,SA,Away,Upto 2014
RNS Hobbs,ENG,Spin,1967-06-08,Leeds,England,1967,2,145,406,4,1,861,2089,19,716,1683,15,45.31578947368421,>30,ENG,Home,Upto 2014
RNS Hobbs,ENG,Spin,1967-06-22,Lord's,England,1967,1,16,36,0,1,346,971,18,330,935,18,19.22222222222222,<=30,ENG,Home,Upto 2014
RNS Hobbs,ENG,Spin,1967-07-13,Birmingham,England,1967,2,98,231,5,1,686,1638,33,588,1407,28,20.78787878787879,<=30,ENG,Home,Upto 2014
RNS Hobbs,ENG,Spin,1967-07-27,Lord's,England,1967,2,74,306,1,1,583,1689,19,509,1383,18,30.68421052631579,>30,ENG,Home,Upto 2014
RNS Hobbs,ENG,Spin,1968-01-19,Port of Spain,West Indies,1968,2,78,168,2,1,688,1548,12,610,1380,10,57.333333333333336,>30,WI,Away,Upto 2014
RNS Hobbs,ENG,Spin,1971-07-08,Leeds,England,1971,2,70,144,0,1,601,1757,16,531,1613,16,37.5625,>30,ENG,Home,Upto 2014
RO Collinge,NZ,Pace,1965-01-22,Wellington,New Zealand,1965,2,94,180,5,1,362,972,24,268,792,19,15.083333333333334,<=30,NZ,Home,Upto 2014
RO Collinge,NZ,Pace,1965-01-29,Auckland,New Zealand,1965,2,98,301,5,1,296,863,12,198,562,7,24.666666666666668,<=30,NZ,Home,Upto 2014
RO Collinge,NZ,Pace,1965-02-12,Christchurch,New Zealand,1965,2,73,174,5,1,416,1052,17,343,878,12,24.470588235294116,<=30,NZ,Home,Upto 2014
RO Collinge,NZ,Pace,1965-02-27,Chennai,India,1965,2,84,191,1,1,302,707,5,218,516,4,60.4,>30,IND,Away,Upto 2014
RO Collinge,NZ,Pace,1965-03-19,Delhi,India,1965,1,89,124,4,1,283,544,9,194,420,5,31.444444444444443,>30,IND,Away,Upto 2014
RO Collinge,NZ,Pace,1965-03-27,Rawalpindi,Pakistan,1965,1,36,126,2,1,167,432,11,131,306,9,15.181818181818182,<=30,PAK,Away,Upto 2014
RO Collinge,NZ,Pace,1965-04-02,Lahore,Pakistan,1965,2,96,228,0,1,328,882,6,232,654,6,54.666666666666664,>30,PAK,Away,Upto 2014
RO Collinge,NZ,Pace,1965-05-27,Birmingham,England,1965,2,77,208,3,1,468,1202,15,391,994,12,31.2,>30,ENG,Away,Upto 2014
RO Collinge,NZ,Pace,1965-06-17,Lord's,England,1965,2,128,260,4,1,637,1471,22,509,1211,18,28.954545454545453,<=30,ENG,Away,Upto 2014
RO Collinge,NZ,Pace,1965-07-08,Leeds,England,1965,1,87,192,1,1,607,1237,14,520,1045,13,43.357142857142854,>30,ENG,Away,Upto 2014
RO Collinge,NZ,Pace,1968-02-22,Christchurch,New Zealand,1968,2,122,242,3,1,471,977,17,349,735,14,27.705882352941178,<=30,NZ,Home,Upto 2014
RO Collinge,NZ,Pace,1968-02-29,Wellington,New Zealand,1968,2,72,120,3,1,330,661,9,258,541,6,36.666666666666664,>30,NZ,Home,Upto 2014
RO Collinge,NZ,Pace,1969-08-07,Nottingham,England,1969,1,88,174,1,1,534,1193,14,446,1019,13,38.142857142857146,>30,ENG,Away,Upto 2014
RO Collinge,NZ,Pace,1971-02-25,Christchurch,New Zealand,1971,2,59,152,4,1,205,688,11,146,536,7,18.636363636363637,<=30,NZ,Home,Upto 2014
RO Collinge,NZ,Pace,1971-03-05,Auckland,New Zealand,1971,2,92,302,6,1,561,1413,20,469,1111,14,28.05,<=30,NZ,Home,Upto 2014
RO Collinge,NZ,Pace,1973-02-02,Wellington,New Zealand,1973,2,113,264,3,1,687,1320,19,574,1056,16,36.1578947368421,>30,NZ,Home,Upto 2014
RO Collinge,NZ,Pace,1973-02-16,Auckland,New Zealand,1973,2,91,248,4,1,643,1420,15,552,1172,11,42.86666666666667,>30,NZ,Home,Upto 2014
RO Collinge,NZ,Pace,1973-06-07,Nottingham,England,1973,2,105,306,3,1,817,1990,27,712,1684,24,30.25925925925926,>30,ENG,Away,Upto 2014
RO Collinge,NZ,Pace,1973-06-21,Lord's,England,1973,2,110,300,4,1,777,1763,19,667,1463,15,40.89473684210526,>30,ENG,Away,Upto 2014
RO Collinge,NZ,Pace,1973-07-05,Leeds,England,1973,1,74,204,5,1,624,1466,29,550,1262,24,21.517241379310345,<=30,ENG,Away,Upto 2014
RO Collinge,NZ,Pace,1974-03-01,Wellington,New Zealand,1974,2,163,344,3,1,960,1997,18,797,1653,15,53.333333333333336,>30,NZ,Home,Upto 2014
RO Collinge,NZ,Pace,1974-03-08,Christchurch,New Zealand,1974,2,107,240,5,1,814,2050,32,707,1810,27,25.4375,<=30,NZ,Home,Upto 2014
RO Collinge,NZ,Pace,1974-03-22,Auckland,New Zealand,1974,2,166,276,9,1,628,1262,29,462,986,20,21.655172413793103,<=30,NZ,Home,Upto 2014
RO Collinge,NZ,Pace,1975-02-20,Auckland,New Zealand,1975,1,75,192,0,1,616,1261,8,541,1069,8,77.0,>30,NZ,Home,Upto 2014
RO Collinge,NZ,Pace,1975-02-28,Christchurch,New Zealand,1975,1,63,152,0,1,449,1000,7,386,848,7,64.14285714285714,>30,NZ,Home,Upto 2014
RO Collinge,NZ,Pace,1976-01-24,Auckland,New Zealand,1976,2,75,168,1,1,264,671,8,189,503,7,33.0,>30,NZ,Home,Upto 2014
RO Collinge,NZ,Pace,1976-02-05,Christchurch,New Zealand,1976,2,99,246,7,1,616,1431,23,517,1185,16,26.782608695652176,<=30,NZ,Home,Upto 2014
RO Collinge,NZ,Pace,1976-02-13,Wellington,New Zealand,1976,2,54,136,2,1,457,1252,22,403,1116,20,20.772727272727273,<=30,NZ,Home,Upto 2014
RO Collinge,NZ,Pace,1976-10-09,Lahore,Pakistan,1976,2,111,160,1,1,496,904,17,385,744,16,29.176470588235293,<=30,PAK,Away,Upto 2014
RO Collinge,NZ,Pace,1976-10-30,Karachi,Pakistan,1976,2,229,264,3,1,1003,1506,20,774,1242,17,50.15,>30,PAK,Away,Upto 2014
RO Collinge,NZ,Pace,1976-11-10,Wankhede,India,1976,2,86,162,2,1,455,894,10,369,732,8,45.5,>30,IND,Away,Upto 2014
RO Collinge,NZ,Pace,1978-02-10,Wellington,New Zealand,1978,2,77,248,6,1,523,1920,38,446,1672,32,13.763157894736842,<=30,NZ,Home,Upto 2014
RO Collinge,NZ,Pace,1978-02-24,Christchurch,New Zealand,1978,2,118,285,5,1,664,1812,24,546,1527,19,27.666666666666668,<=30,NZ,Home,Upto 2014
RO Collinge,NZ,Pace,1978-03-04,Auckland,New Zealand,1978,1,98,304,4,1,754,2126,17,656,1822,13,44.35294117647059,>30,NZ,Home,Upto 2014
RO Collinge,NZ,Pace,1978-08-24,Lord's,England,1978,2,84,216,2,1,614,1515,29,530,1299,27,21.17241379310345,<=30,ENG,Away,Upto 2014
RO Hinds,WI,Spin,2002-01-31,Sharjah,UAE,2002,1,31,24,0,1,403,857,9,372,833,9,44.77777777777778,>30,UAE,Away,Upto 2014
RO Hinds,WI,Spin,2002-02-07,Sharjah,UAE,2002,2,39,102,0,1,492,929,10,453,827,10,49.2,>30,UAE,Away,Upto 2014
RO Hinds,WI,Spin,2002-10-09,Wankhede,India,2002,1,40,60,0,1,416,1045,19,376,985,19,21.894736842105264,<=30,IND,Away,Upto 2014
RO Hinds,WI,Spin,2002-10-17,Chennai,India,2002,1,9,30,0,1,464,965,17,455,935,17,27.294117647058822,<=30,IND,Away,Upto 2014
RO Hinds,WI,Spin,2004-03-11,Kingston,West Indies,2004,2,29,77,1,1,110,185,4,81,108,3,27.5,<=30,WI,Home,Upto 2014
RO Hinds,WI,Spin,2004-04-01,Bridgetown,West Indies,2004,1,7,24,0,1,60,156,0,53,132,0,inf,>30,WI,Home,Upto 2014
RO Hinds,WI,Spin,2004-04-10,St John's,West Indies,2004,2,112,333,3,1,477,993,7,365,660,4,68.14285714285714,>30,WI,Home,Upto 2014
RO Hinds,WI,Spin,2005-03-31,Georgetown,West Indies,2005,2,56,240,1,1,281,750,4,225,510,3,70.25,>30,WI,Home,Upto 2014
RO Hinds,WI,Spin,2005-04-21,Bridgetown,West Indies,2005,1,67,108,0,1,288,498,4,221,390,4,72.0,>30,WI,Home,Upto 2014
RO Hinds,WI,Spin,2008-03-22,Providence,West Indies,2008,1,10,18,0,1,634,1374,12,624,1356,12,52.833333333333336,>30,WI,Home,Upto 2014
RO Hinds,WI,Spin,2009-02-15,St John's,West Indies,2009,2,131,200,4,1,563,1022,15,432,822,11,37.53333333333333,>30,WI,Home,Upto 2014
RO Hinds,WI,Spin,2009-02-26,Bridgetown,West Indies,2009,2,118,168,0,1,611,1066,8,493,898,8,76.375,>30,WI,Home,Upto 2014
RO Hinds,WI,Spin,2009-03-06,Port of Spain,West Indies,2009,2,183,287,3,1,578,1262,14,395,975,11,41.285714285714285,>30,WI,Home,Upto 2014
RO Hinds,WI,Spin,2009-07-17,St George's,West Indies,2009,2,38,72,1,1,462,930,22,424,858,21,21.0,<=30,WI,Home,Upto 2014
RO Jenkins,ENG,Spin,1948-12-16,Durban,South Africa,1948,2,114,291,4,1,426,1415,21,312,1124,17,20.285714285714285,<=30,SA,Away,Upto 2014
RO Jenkins,ENG,Spin,1948-12-27,Johannesburg,South Africa,1948,2,142,324,3,1,725,1588,13,583,1264,10,55.76923076923077,>30,SA,Away,Upto 2014
RO Jenkins,ENG,Spin,1949-01-01,Cape Town,South Africa,1949,2,94,160,5,1,568,1444,18,474,1284,13,31.555555555555557,>30,SA,Away,Upto 2014
RO Jenkins,ENG,Spin,1949-02-12,Johannesburg,South Africa,1949,2,65,136,1,1,470,1288,10,405,1152,9,47.0,>30,SA,Away,Upto 2014
RO Jenkins,ENG,Spin,1949-03-05,Gqeberha,South Africa,1949,2,80,152,3,1,750,1935,20,670,1783,17,37.5,>30,SA,Away,Upto 2014
RO Jenkins,ENG,Spin,1950-06-24,Lord's,England,1950,2,290,566,9,1,844,2771,30,554,2205,21,28.133333333333333,<=30,ENG,Home,Upto 2014
RO Jenkins,ENG,Spin,1950-07-20,Nottingham,England,1950,2,119,144,1,1,728,2103,19,609,1959,18,38.31578947368421,>30,ENG,Home,Upto 2014
RO Jenkins,ENG,Spin,1952-06-05,Leeds,England,1952,2,128,240,5,1,495,1359,19,367,1119,14,26.05263157894737,<=30,ENG,Home,Upto 2014
RO Jenkins,ENG,Spin,1952-06-19,Lord's,England,1952,2,66,105,1,1,669,1629,14,603,1524,13,47.785714285714285,>30,ENG,Home,Upto 2014
RO Scarlett,WI,Spin,1960-01-06,Bridgetown,West Indies,1960,2,58,216,1,1,518,1446,6,460,1230,5,86.33333333333333,>30,WI,Home,Upto 2014
RO Scarlett,WI,Spin,1960-02-17,Kingston,West Indies,1960,2,64,228,1,1,443,1323,11,379,1095,10,40.27272727272727,>30,WI,Home,Upto 2014
RO Scarlett,WI,Spin,1960-03-09,Georgetown,West Indies,1960,2,87,360,0,1,501,1694,13,414,1334,13,38.53846153846154,>30,WI,Home,Upto 2014
RO Schwarz,SA,Spin,1906-01-02,Johannesburg,South Africa,1906,2,96,174,3,1,455,1132,23,359,958,20,19.782608695652176,<=30,SA,Home,Upto 2014
RO Schwarz,SA,Spin,1906-03-06,Johannesburg,South Africa,1906,2,46,121,6,1,287,726,15,241,605,9,19.133333333333333,<=30,SA,Home,Upto 2014
RO Schwarz,SA,Spin,1906-03-10,Johannesburg,South Africa,1906,2,98,210,5,1,622,1254,10,524,1044,5,62.2,>30,SA,Home,Upto 2014
RO Schwarz,SA,Spin,1906-03-24,Cape Town,South Africa,1906,2,40,84,0,1,339,907,20,299,823,20,16.95,<=30,SA,Home,Upto 2014
RO Schwarz,SA,Spin,1906-03-30,Cape Town,South Africa,1906,2,30,92,4,1,364,776,15,334,684,11,24.266666666666666,<=30,SA,Home,Upto 2014
RO Schwarz,SA,Spin,1907-07-01,Lord's,England,1907,1,90,204,2,1,478,962,15,388,758,13,31.866666666666667,>30,ENG,Away,Upto 2014
RO Schwarz,SA,Spin,1907-07-29,Leeds,England,1907,2,36,76,1,1,289,661,31,253,585,30,9.32258064516129,<=30,ENG,Away,Upto 2014
RO Schwarz,SA,Spin,1907-08-19,The Oval,England,1907,2,66,246,6,1,462,1059,21,396,813,15,22.0,<=30,ENG,Away,Upto 2014
RO Schwarz,SA,Spin,1910-01-01,Johannesburg,South Africa,1910,2,12,18,0,1,593,1077,29,581,1059,29,20.448275862068964,<=30,SA,Home,Upto 2014
RO Schwarz,SA,Spin,1910-01-21,Durban,South Africa,1910,1,12,12,0,1,565,1312,24,553,1300,24,23.541666666666668,<=30,SA,Home,Upto 2014
RO Schwarz,SA,Spin,1910-03-11,Cape Town,South Africa,1910,1,10,18,0,1,488,932,19,478,914,19,25.68421052631579,<=30,SA,Home,Upto 2014
RO Schwarz,SA,Spin,1910-12-09,Sydney,Australia,1910,1,102,150,5,1,388,570,5,286,420,0,77.6,>30,AUS,Away,Upto 2014
RO Schwarz,SA,Spin,1910-12-31,Melbourne,Australia,1910,2,142,210,5,1,675,1063,21,533,853,16,32.142857142857146,>30,AUS,Away,Upto 2014
RO Schwarz,SA,Spin,1911-01-07,Adelaide,Australia,1911,2,116,204,6,1,814,1502,20,698,1298,14,40.7,>30,AUS,Away,Upto 2014
RO Schwarz,SA,Spin,1911-02-17,Melbourne,Australia,1911,2,202,318,2,1,844,1322,23,642,1004,21,36.69565217391305,>30,AUS,Away,Upto 2014
RO Schwarz,SA,Spin,1911-03-03,Sydney,Australia,1911,2,89,124,7,1,638,1067,19,549,943,12,33.578947368421055,>30,AUS,Away,Upto 2014
RO Schwarz,SA,Spin,1912-05-27,Manchester,England,1912,1,142,192,3,1,525,1035,18,383,843,15,29.166666666666668,<=30,ENG,Away,Upto 2014
RO Schwarz,SA,Spin,1912-06-10,Lord's,England,1912,1,44,120,0,1,275,582,7,231,462,7,39.285714285714285,>30,ENG,Away,Upto 2014
RO Schwarz,SA,Spin,1912-07-15,Lord's,England,1912,1,44,66,0,1,501,1026,19,457,960,19,26.36842105263158,<=30,ENG,Away,Upto 2014
RP Arnold,SL,Spin,1997-04-19,Colombo (RPS),Sri Lanka,1997,1,3,12,0,1,757,2006,23,754,1994,23,32.91304347826087,>30,SL,Home,Upto 2014
RP Arnold,SL,Spin,1997-04-26,Colombo (SSC),Sri Lanka,1997,2,28,66,0,1,882,1775,14,854,1709,14,63.0,>30,SL,Home,Upto 2014
RP Arnold,SL,Spin,1999-02-24,Colombo (SSC),Sri Lanka,1999,2,148,291,3,1,484,1002,12,336,711,9,40.333333333333336,>30,SL,Home,Upto 2014
RP Arnold,SL,Spin,1999-03-12,Dhaka,Bangladesh,1999,1,80,224,2,1,550,1176,20,470,952,18,27.5,<=30,BAN,Away,Upto 2014
RP Arnold,SL,Spin,1999-09-30,Colombo (SSC),Sri Lanka,1999,1,3,42,1,1,278,654,6,275,612,5,46.333333333333336,>30,SL,Home,Upto 2014
RP Arnold,SL,Spin,1999-11-18,Bulawayo,Zimbabwe,1999,2,17,48,0,1,248,534,3,231,486,3,82.66666666666667,>30,ZIM,Away,Upto 2014
RP Arnold,SL,Spin,1999-11-26,Harare,Zimbabwe,1999,2,13,36,0,1,215,630,10,202,594,10,21.5,<=30,ZIM,Away,Upto 2014
RP Arnold,SL,Spin,2000-02-26,Rawalpindi,Pakistan,2000,1,0,6,0,1,401,1058,12,401,1052,12,33.416666666666664,>30,PAK,Away,Upto 2014
RP Arnold,SL,Spin,2000-03-12,Karachi,Pakistan,2000,1,15,24,0,1,344,671,14,329,647,14,24.571428571428573,<=30,PAK,Away,Upto 2014
RP Arnold,SL,Spin,2000-06-14,Colombo (SSC),Sri Lanka,2000,1,2,6,0,1,317,840,16,315,834,16,19.8125,<=30,SL,Home,Upto 2014
RP Arnold,SL,Spin,2000-06-21,Galle,Sri Lanka,2000,1,71,120,1,1,434,852,7,363,732,6,62.0,>30,SL,Home,Upto 2014
RP Arnold,SL,Spin,2000-07-20,Galle,Sri Lanka,2000,1,2,6,0,1,705,1392,24,703,1386,24,29.375,<=30,SL,Home,Upto 2014
RP Arnold,SL,Spin,2000-08-06,Colombo (SSC),Sri Lanka,2000,2,9,31,0,1,525,1357,18,516,1326,18,29.166666666666668,<=30,SL,Home,Upto 2014
RP Arnold,SL,Spin,2000-12-26,Durban,South Africa,2000,1,39,84,0,1,274,753,15,235,669,15,18.266666666666666,<=30,SA,Away,Upto 2014
RP Arnold,SL,Spin,2001-01-02,Cape Town,South Africa,2001,1,76,146,3,1,231,506,8,155,360,5,28.875,<=30,SA,Away,Upto 2014
RP Arnold,SL,Spin,2001-01-20,Centurion,South Africa,2001,1,50,84,1,1,110,198,2,60,114,1,55.0,>30,SA,Away,Upto 2014
RP Arnold,SL,Spin,2001-02-22,Galle,Sri Lanka,2001,1,2,6,0,1,636,1872,18,634,1866,18,35.333333333333336,>30,SL,Home,Upto 2014
RP Arnold,SL,Spin,2001-08-22,Kandy,Sri Lanka,2001,1,7,12,0,1,215,370,5,208,358,5,43.0,>30,SL,Home,Upto 2014
RP Arnold,SL,Spin,2001-11-13,Galle,Sri Lanka,2001,1,4,12,0,1,681,1597,17,677,1585,17,40.05882352941177,>30,SL,Home,Upto 2014
RP Arnold,SL,Spin,2001-11-29,Colombo (SSC),Sri Lanka,2001,1,8,18,0,1,542,1074,5,534,1056,5,108.4,>30,SL,Home,Upto 2014
RP Arnold,SL,Spin,2002-05-16,Lord's,England,2002,1,7,24,0,1,171,426,1,164,402,1,171.0,>30,ENG,Away,Upto 2014
RP Arnold,SL,Spin,2002-11-15,Centurion,South Africa,2002,1,5,30,0,1,191,489,4,186,459,4,47.75,>30,SA,Away,Upto 2014
RP Arnold,SL,Spin,2004-07-01,Darwin,Australia,2004,1,9,6,0,1,223,419,7,214,413,7,31.857142857142858,>30,AUS,Away,Upto 2014
RP Burl,ZIM,Spin,2021-03-02,Abu Dhabi,UAE,2021,2,22,84,1,1,274,533,12,252,449,11,22.833333333333332,<=30,UAE,Away,After 1965
RP Burl,ZIM,Spin,2021-03-10,Abu Dhabi,UAE,2021,2,85,144,3,1,842,1766,20,757,1622,17,42.1,>30,UAE,Away,After 1965
RP Singh,IND,Pace,2006-01-21,Faisalabad,Pakistan,2006,2,164,282,5,1,888,1366,17,724,1084,12,52.23529411764706,>30,PAK,Away,Upto 2014
RP Singh,IND,Pace,2006-01-29,Karachi,Pakistan,2006,2,181,240,4,1,991,1398,31,810,1158,27,31.967741935483872,>30,PAK,Away,Upto 2014
RP Singh,IND,Pace,2007-05-18,Chattogram,Bangladesh,2007,2,74,138,4,1,364,589,13,290,451,9,28.0,<=30,BAN,Away,Upto 2014
RP Singh,IND,Pace,2007-05-25,Mirpur,Bangladesh,2007,2,56,90,2,1,511,762,11,455,672,9,46.45454545454545,>30,BAN,Away,Upto 2014
RP Singh,IND,Pace,2007-07-19,Lord's,England,2007,2,117,201,7,1,762,1573,34,645,1372,27,22.41176470588235,<=30,ENG,Away,Upto 2014
RP Singh,IND,Pace,2007-07-27,Nottingham,England,2007,2,108,168,3,1,762,1633,23,654,1465,20,33.130434782608695,>30,ENG,Away,Upto 2014
RP Singh,IND,Pace,2007-08-09,The Oval,England,2007,2,122,186,2,1,888,1674,23,766,1488,21,38.608695652173914,>30,ENG,Away,Upto 2014
RP Singh,IND,Pace,2007-12-26,Melbourne,Australia,2007,2,132,216,2,1,517,1047,21,385,831,19,24.61904761904762,<=30,AUS,Away,Upto 2014
RP Singh,IND,Pace,2008-01-02,Sydney,Australia,2008,2,198,252,5,1,803,1292,17,605,1040,12,47.23529411764706,>30,AUS,Away,Upto 2014
RP Singh,IND,Pace,2008-01-16,W.A.C.A,Australia,2008,2,163,215,6,1,844,1397,31,681,1182,25,27.225806451612904,<=30,AUS,Away,Upto 2014
RP Singh,IND,Pace,2008-01-24,Adelaide,Australia,2008,1,14,24,0,1,710,1457,17,696,1433,17,41.76470588235294,>30,AUS,Away,Upto 2014
RP Singh,IND,Pace,2008-03-26,Chennai,India,2008,2,154,192,0,1,691,1044,8,537,852,8,86.375,>30,IND,Home,Upto 2014
RP Singh,IND,Pace,2008-04-03,Ahmedabad,India,2008,1,81,126,0,1,574,946,21,493,820,21,27.333333333333332,<=30,IND,Home,Upto 2014
RP Singh,IND,Pace,2011-08-18,The Oval,England,2011,1,118,204,0,1,633,1206,15,515,1002,15,42.2,>30,ENG,Away,Upto 2014
RP Snell,SA,Pace,1992-04-18,Bridgetown,West Indies,1992,2,157,204,8,1,919,1991,34,762,1787,26,27.029411764705884,<=30,WI,Away,Upto 2014
RP Snell,SA,Pace,1993-09-06,Colombo (SSC),Sri Lanka,1993,2,89,186,5,1,464,972,21,375,786,16,22.095238095238095,<=30,SL,Away,Upto 2014
RP Snell,SA,Pace,1993-09-14,Colombo (PSS),Sri Lanka,1993,1,44,150,0,1,422,1175,13,378,1025,13,32.46153846153846,>30,SL,Away,Upto 2014
RP Snell,SA,Pace,1994-01-28,Adelaide,Australia,1994,2,82,186,2,1,661,1638,23,579,1452,21,28.73913043478261,<=30,AUS,Away,Upto 2014
RP Snell,SA,Pace,1994-11-25,Johannesburg,South Africa,1994,2,166,299,4,1,787,1709,30,621,1410,26,26.233333333333334,<=30,SA,Home,Upto 2014
RP de Groen,NZ,Pace,1993-11-26,Hobart,Australia,1993,1,113,216,2,1,577,1014,7,464,798,5,82.42857142857143,>30,AUS,Away,Upto 2014
RP de Groen,NZ,Pace,1993-12-03,Brisbane,Australia,1993,1,120,276,1,1,683,1440,13,563,1164,12,52.53846153846154,>30,AUS,Away,Upto 2014
RP de Groen,NZ,Pace,1994-02-10,Auckland,New Zealand,1994,2,88,184,5,1,582,1070,31,494,886,26,18.774193548387096,<=30,NZ,Home,Upto 2014
RP de Groen,NZ,Pace,1994-02-17,Wellington,New Zealand,1994,1,104,186,0,1,832,1382,22,728,1196,22,37.81818181818182,>30,NZ,Home,Upto 2014
RP de Groen,NZ,Pace,1994-11-25,Johannesburg,South Africa,1994,2,80,198,3,1,787,1709,30,707,1511,27,26.233333333333334,<=30,SA,Away,Upto 2014
RPW Guneratne,SL,Spin,1983-04-22,Kandy,Sri Lanka,1983,1,84,102,0,1,499,919,15,415,817,15,33.266666666666666,>30,SL,Home,Upto 2014
RR Jumadeen,WI,Spin,1972-04-20,Port of Spain,West Indies,1972,2,64,384,1,1,509,1648,17,445,1264,16,29.941176470588236,<=30,WI,Home,Upto 2014
RR Jumadeen,WI,Spin,1973-04-21,Port of Spain,West Indies,1973,2,121,348,2,1,694,1730,21,573,1382,19,33.04761904761905,>30,WI,Home,Upto 2014
RR Jumadeen,WI,Spin,1976-03-10,Bridgetown,West Indies,1976,2,69,174,3,1,501,996,16,432,822,13,31.3125,>30,WI,Home,Upto 2014
RR Jumadeen,WI,Spin,1976-03-24,Port of Spain,West Indies,1976,1,79,252,2,1,529,1608,16,450,1356,14,33.0625,>30,WI,Home,Upto 2014
RR Jumadeen,WI,Spin,1976-04-07,Port of Spain,West Indies,1976,2,103,342,2,1,858,2099,21,755,1757,19,40.857142857142854,>30,WI,Home,Upto 2014
RR Jumadeen,WI,Spin,1976-04-21,Kingston,West Indies,1976,2,27,60,2,1,368,831,11,341,771,9,33.45454545454545,>30,WI,Home,Upto 2014
RR Jumadeen,WI,Spin,1976-06-17,Lord's,England,1976,2,64,168,1,1,283,691,11,219,523,10,25.727272727272727,<=30,ENG,Away,Upto 2014
RR Jumadeen,WI,Spin,1977-03-04,Port of Spain,West Indies,1977,2,127,306,2,1,450,1050,10,323,744,8,45.0,>30,WI,Home,Upto 2014
RR Jumadeen,WI,Spin,1978-04-15,Port of Spain,West Indies,1978,2,117,234,5,1,493,1205,23,376,971,18,21.434782608695652,<=30,WI,Home,Upto 2014
RR Jumadeen,WI,Spin,1978-04-28,Kingston,West Indies,1978,2,162,370,6,1,606,1484,19,444,1114,13,31.894736842105264,>30,WI,Home,Upto 2014
RR Jumadeen,WI,Spin,1978-12-01,Wankhede,India,1978,2,71,228,0,1,556,1295,9,485,1067,9,61.77777777777778,>30,IND,Away,Upto 2014
RR Jumadeen,WI,Spin,1979-02-02,Kanpur,India,1979,1,137,274,3,1,445,1037,7,308,763,4,63.57142857142857,>30,IND,Away,Upto 2014
RR Kulkarni,IND,Pace,1986-10-15,Wankhede,India,1986,2,114,174,3,1,351,666,3,237,492,0,117.0,>30,IND,Home,Upto 2014
RR Kulkarni,IND,Pace,1987-02-03,Chennai,India,1987,2,56,72,2,1,341,600,5,285,528,3,68.2,>30,IND,Home,Upto 2014
RR Kulkarni,IND,Pace,1987-02-11,Eden Gardens,India,1987,2,57,120,0,1,698,1442,20,641,1322,20,34.9,>30,IND,Home,Upto 2014
RR Lindwall,AUS,Pace,1946-03-29,Wellington,New Zealand,1946,2,29,102,2,1,212,690,16,183,588,14,13.25,<=30,NZ,Away,Upto 2014
RR Lindwall,AUS,Pace,1946-11-29,Brisbane,Australia,1946,1,23,96,0,1,604,1516,23,581,1420,23,26.26086956521739,<=30,AUS,Home,Upto 2014
RR Lindwall,AUS,Pace,1947-01-01,Melbourne,Australia,1947,2,123,288,3,1,922,1990,21,799,1702,18,43.904761904761905,>30,AUS,Home,Upto 2014
RR Lindwall,AUS,Pace,1947-01-31,Adelaide,Australia,1947,2,112,321,6,1,774,1993,20,662,1672,14,38.7,>30,AUS,Home,Upto 2014
RR Lindwall,AUS,Pace,1947-02-28,Sydney,Australia,1947,2,109,272,9,1,392,1131,16,283,859,7,24.5,<=30,AUS,Home,Upto 2014
RR Lindwall,AUS,Pace,1947-11-28,Brisbane,Australia,1947,2,30,127,4,1,345,994,21,315,867,17,16.428571428571427,<=30,AUS,Home,Upto 2014
RR Lindwall,AUS,Pace,1947-12-12,Sydney,Australia,1947,2,43,136,2,1,133,474,10,90,338,8,13.3,<=30,AUS,Home,Upto 2014
RR Lindwall,AUS,Pace,1948-01-01,Melbourne,Australia,1948,2,57,120,1,1,380,833,9,323,713,8,42.22222222222222,>30,AUS,Home,Upto 2014
RR Lindwall,AUS,Pace,1948-01-23,Adelaide,Australia,1948,2,99,301,8,1,583,1360,19,484,1059,11,30.68421052631579,>30,AUS,Home,Upto 2014
RR Lindwall,AUS,Pace,1948-02-06,Melbourne,Australia,1948,2,75,224,3,1,469,1146,14,394,922,11,33.5,>30,AUS,Home,Upto 2014
RR Lindwall,AUS,Pace,1948-06-10,Nottingham,England,1948,1,30,78,1,1,600,1427,17,570,1349,16,35.294117647058826,>30,ENG,Away,Upto 2014
RR Lindwall,AUS,Pace,1948-06-24,Lord's,England,1948,2,131,304,8,1,703,1601,26,572,1297,18,27.03846153846154,<=30,ENG,Away,Upto 2014
RR Lindwall,AUS,Pace,1948-07-08,Manchester,England,1948,2,136,324,5,1,513,1476,16,377,1152,11,32.0625,>30,ENG,Away,Upto 2014
RR Lindwall,AUS,Pace,1948-07-22,Leeds,England,1948,2,163,384,4,1,942,2038,19,779,1654,15,49.578947368421055,>30,ENG,Away,Upto 2014
RR Lindwall,AUS,Pace,1948-08-14,The Oval,England,1948,2,70,247,9,1,239,753,15,169,506,6,15.933333333333334,<=30,ENG,Away,Upto 2014
RR Lindwall,AUS,Pace,1949-12-24,Johannesburg,South Africa,1949,2,47,144,0,1,273,736,9,226,592,9,30.333333333333332,>30,SA,Away,Upto 2014
RR Lindwall,AUS,Pace,1949-12-31,Cape Town,South Africa,1949,2,65,220,5,1,378,860,10,313,640,5,37.8,>30,SA,Away,Upto 2014
RR Lindwall,AUS,Pace,1950-01-20,Durban,South Africa,1950,2,54,184,4,1,229,704,5,175,520,1,45.8,>30,SA,Away,Upto 2014
RR Lindwall,AUS,Pace,1950-02-10,Johannesburg,South Africa,1950,1,82,208,3,1,524,1232,15,442,1024,12,34.93333333333333,>30,SA,Away,Upto 2014
RR Lindwall,AUS,Pace,1950-12-01,Brisbane,Australia,1950,2,22,64,2,1,176,538,19,154,474,17,9.263157894736842,<=30,AUS,Home,Upto 2014
RR Lindwall,AUS,Pace,1950-12-22,Melbourne,Australia,1950,2,75,200,5,1,311,916,19,236,716,14,16.36842105263158,<=30,AUS,Home,Upto 2014
RR Lindwall,AUS,Pace,1951-01-05,Sydney,Australia,1951,2,72,160,2,1,385,1007,10,313,847,8,38.5,>30,AUS,Home,Upto 2014
RR Lindwall,AUS,Pace,1951-02-02,Adelaide,Australia,1951,2,86,187,3,1,424,1099,11,338,912,8,38.54545454545455,>30,AUS,Home,Upto 2014
RR Lindwall,AUS,Pace,1951-02-23,Melbourne,Australia,1951,2,89,184,3,1,340,912,18,251,728,15,18.88888888888889,<=30,AUS,Home,Upto 2014
RR Lindwall,AUS,Pace,1951-11-09,Brisbane,Australia,1951,2,98,240,4,1,179,501,9,81,261,5,19.88888888888889,<=30,AUS,Home,Upto 2014
RR Lindwall,AUS,Pace,1951-11-30,Sydney,Australia,1951,2,125,344,6,1,387,1058,13,262,714,7,29.76923076923077,<=30,AUS,Home,Upto 2014
RR Lindwall,AUS,Pace,1951-12-22,Adelaide,Australia,1951,2,58,136,1,1,142,445,7,84,309,6,20.285714285714285,<=30,AUS,Home,Upto 2014
RR Lindwall,AUS,Pace,1951-12-31,Melbourne,Australia,1951,2,131,280,3,1,342,918,16,211,638,13,21.375,<=30,AUS,Home,Upto 2014
RR Lindwall,AUS,Pace,1952-01-25,Sydney,Australia,1952,2,72,232,7,1,268,736,24,196,504,17,11.166666666666666,<=30,AUS,Home,Upto 2014
RR Lindwall,AUS,Pace,1952-12-05,Brisbane,Australia,1952,2,108,336,6,1,408,1189,22,300,853,16,18.545454545454547,<=30,AUS,Home,Upto 2014
RR Lindwall,AUS,Pace,1952-12-24,Melbourne,Australia,1952,2,116,365,5,1,390,1037,14,274,672,9,27.857142857142858,<=30,AUS,Home,Upto 2014
RR Lindwall,AUS,Pace,1953-01-09,Sydney,Australia,1953,2,112,274,8,1,307,834,15,195,560,7,20.466666666666665,<=30,AUS,Home,Upto 2014
RR Lindwall,AUS,Pace,1953-01-24,Adelaide,Australia,1953,1,47,104,0,1,427,785,5,380,681,5,85.4,>30,AUS,Home,Upto 2014
RR Lindwall,AUS,Pace,1953-06-11,Nottingham,England,1953,2,94,220,5,1,325,969,23,231,749,18,14.130434782608695,<=30,ENG,Away,Upto 2014
RR Lindwall,AUS,Pace,1953-06-25,Lord's,England,1953,2,92,252,7,1,553,1514,19,461,1262,12,29.105263157894736,<=30,ENG,Away,Upto 2014
RR Lindwall,AUS,Pace,1953-07-09,Manchester,England,1953,1,30,120,2,1,352,924,14,322,804,12,25.142857142857142,<=30,ENG,Away,Upto 2014
RR Lindwall,AUS,Pace,1953-07-23,Leeds,England,1953,2,158,534,8,1,617,1986,30,459,1452,22,20.566666666666666,<=30,ENG,Away,Upto 2014
RR Lindwall,AUS,Pace,1953-08-15,The Oval,England,1953,2,116,318,4,1,504,1206,15,388,888,11,33.6,>30,ENG,Away,Upto 2014
RR Lindwall,AUS,Pace,1954-11-26,Brisbane,Australia,1954,2,77,248,5,1,750,1616,15,673,1368,10,50.0,>30,AUS,Home,Upto 2014
RR Lindwall,AUS,Pace,1954-12-17,Sydney,Australia,1954,2,116,384,5,1,649,1696,33,533,1312,28,19.666666666666668,<=30,AUS,Home,Upto 2014
RR Lindwall,AUS,Pace,1954-12-31,Melbourne,Australia,1954,2,111,248,1,1,538,1484,30,427,1236,29,17.933333333333334,<=30,AUS,Home,Upto 2014
RR Lindwall,AUS,Pace,1955-02-25,Sydney,Australia,1955,1,77,166,3,1,382,806,7,305,640,4,54.57142857142857,>30,AUS,Home,Upto 2014
RR Lindwall,AUS,Pace,1955-03-26,Kingston,West Indies,1955,2,124,241,6,1,487,1027,18,363,786,12,27.055555555555557,<=30,WI,Away,Upto 2014
RR Lindwall,AUS,Pace,1955-04-11,Port of Spain,West Indies,1955,2,165,251,6,1,686,1163,14,521,912,8,49.0,>30,WI,Away,Upto 2014
RR Lindwall,AUS,Pace,1955-04-26,Georgetown,West Indies,1955,2,98,180,2,1,285,510,7,187,330,5,40.714285714285715,>30,WI,Away,Upto 2014
RR Lindwall,AUS,Pace,1955-05-14,Bridgetown,West Indies,1955,2,135,198,2,1,574,1002,10,439,804,8,57.4,>30,WI,Away,Upto 2014
RR Lindwall,AUS,Pace,1955-06-11,Kingston,West Indies,1955,2,115,186,4,1,633,1010,16,518,824,12,39.5625,>30,WI,Away,Upto 2014
RR Lindwall,AUS,Pace,1956-06-07,Nottingham,England,1956,1,43,90,0,1,363,976,12,320,886,12,30.25,>30,ENG,Away,Upto 2014
RR Lindwall,AUS,Pace,1956-07-12,Leeds,England,1956,1,67,202,3,1,232,778,8,165,576,5,29.0,<=30,ENG,Away,Upto 2014
RR Lindwall,AUS,Pace,1956-07-26,Manchester,England,1956,1,63,129,2,1,233,663,3,170,534,1,77.66666666666667,>30,ENG,Away,Upto 2014
RR Lindwall,AUS,Pace,1956-08-23,The Oval,England,1956,2,65,180,2,1,409,1082,18,344,902,16,22.72222222222222,<=30,ENG,Away,Upto 2014
RR Lindwall,AUS,Pace,1956-10-11,Karachi,Pakistan,1956,2,64,258,1,1,382,1421,26,318,1163,25,14.692307692307692,<=30,PAK,Away,Upto 2014
RR Lindwall,AUS,Pace,1956-10-19,Chennai,India,1956,2,58,191,7,1,145,569,11,87,378,4,13.181818181818182,<=30,IND,Away,Upto 2014
RR Lindwall,AUS,Pace,1956-10-26,Brabourne,India,1956,2,100,270,2,1,321,854,10,221,584,8,32.1,>30,IND,Away,Upto 2014
RR Lindwall,AUS,Pace,1956-11-02,Eden Gardens,India,1956,2,41,224,3,1,49,278,4,8,54,1,12.25,<=30,IND,Away,Upto 2014
RR Lindwall,AUS,Pace,1959-01-30,Adelaide,Australia,1959,2,136,328,3,1,681,1789,20,545,1461,17,34.05,>30,AUS,Home,Upto 2014
RR Lindwall,AUS,Pace,1959-02-13,Melbourne,Australia,1959,2,73,200,4,1,613,1344,20,540,1144,16,30.65,>30,AUS,Home,Upto 2014
RR Lindwall,AUS,Pace,1959-11-13,Dhaka,Bangladesh,1959,2,36,102,0,1,428,1301,20,392,1199,20,21.4,<=30,BAN,Away,Upto 2014
RR Lindwall,AUS,Pace,1959-12-04,Karachi,Pakistan,1959,2,86,252,3,1,568,1464,19,482,1212,16,29.894736842105264,<=30,PAK,Away,Upto 2014
RR Lindwall,AUS,Pace,1960-01-01,Brabourne,India,1960,2,112,276,3,1,552,1475,15,440,1199,12,36.8,>30,IND,Away,Upto 2014
RR Lindwall,AUS,Pace,1960-01-23,Eden Gardens,India,1960,2,110,216,3,1,523,1340,17,413,1124,14,30.764705882352942,>30,IND,Away,Upto 2014
RR Powar,IND,Spin,2007-05-18,Chattogram,Bangladesh,2007,2,82,144,3,1,447,726,13,365,582,10,34.38461538461539,>30,BAN,Away,Upto 2014
RR Powar,IND,Spin,2007-05-25,Mirpur,Bangladesh,2007,2,36,108,3,1,453,725,12,417,617,9,37.75,>30,BAN,Away,Upto 2014
RR Sarwan,WI,Spin,2000-05-25,St John's,West Indies,2000,1,16,12,0,1,289,648,4,273,636,4,72.25,>30,WI,Home,Upto 2014
RR Sarwan,WI,Spin,2001-03-09,Georgetown,West Indies,2001,1,4,6,0,1,353,904,9,349,898,9,39.22222222222222,>30,WI,Home,Upto 2014
RR Sarwan,WI,Spin,2001-11-29,Colombo (SSC),Sri Lanka,2001,1,7,12,0,1,542,1074,5,535,1062,5,108.4,>30,SL,Away,Upto 2014
RR Sarwan,WI,Spin,2002-04-19,Port of Spain,West Indies,2002,1,6,18,0,1,184,491,4,178,473,4,46.0,>30,WI,Home,Upto 2014
RR Sarwan,WI,Spin,2002-05-02,Bridgetown,West Indies,2002,1,1,6,2,1,125,277,5,124,271,3,25.0,<=30,WI,Home,Upto 2014
RR Sarwan,WI,Spin,2002-05-10,St John's,West Indies,2002,1,23,54,0,1,261,672,7,238,618,7,37.285714285714285,>30,WI,Home,Upto 2014
RR Sarwan,WI,Spin,2002-05-18,Kingston,West Indies,2002,1,5,18,0,1,212,410,9,207,392,9,23.555555555555557,<=30,WI,Home,Upto 2014
RR Sarwan,WI,Spin,2002-06-21,Bridgetown,West Indies,2002,1,1,6,0,1,133,433,9,132,427,9,14.777777777777779,<=30,WI,Home,Upto 2014
RR Sarwan,WI,Spin,2002-06-28,St George's,West Indies,2002,1,26,36,1,1,457,1176,9,431,1140,8,50.77777777777778,>30,WI,Home,Upto 2014
RR Sarwan,WI,Spin,2002-10-09,Wankhede,India,2002,1,6,6,0,1,416,1045,19,410,1039,19,21.894736842105264,<=30,IND,Away,Upto 2014
RR Sarwan,WI,Spin,2002-10-30,Eden Gardens,India,2002,2,43,54,0,1,592,1269,12,549,1215,12,49.333333333333336,>30,IND,Away,Upto 2014
RR Sarwan,WI,Spin,2003-04-19,Port of Spain,West Indies,2003,1,7,12,0,1,510,828,7,503,816,7,72.85714285714286,>30,WI,Home,Upto 2014
RR Sarwan,WI,Spin,2003-05-01,Bridgetown,West Indies,2003,1,1,6,0,1,500,956,13,499,950,13,38.46153846153846,>30,WI,Home,Upto 2014
RR Sarwan,WI,Spin,2003-06-20,Gros Islet,West Indies,2003,2,5,30,0,1,398,848,9,393,818,9,44.22222222222222,>30,WI,Home,Upto 2014
RR Sarwan,WI,Spin,2003-11-04,Harare,Zimbabwe,2003,2,47,60,0,1,313,784,11,266,724,11,28.454545454545453,<=30,ZIM,Away,Upto 2014
RR Sarwan,WI,Spin,2003-11-12,Bulawayo,Zimbabwe,2003,2,37,54,0,1,453,841,14,416,787,14,32.357142857142854,>30,ZIM,Away,Upto 2014
RR Sarwan,WI,Spin,2003-12-12,Johannesburg,South Africa,2003,2,77,114,1,1,214,258,1,137,144,0,214.0,>30,SA,Away,Upto 2014
RR Sarwan,WI,Spin,2003-12-26,Durban,South Africa,2003,1,65,126,2,1,190,312,3,125,186,1,63.333333333333336,>30,SA,Away,Upto 2014
RR Sarwan,WI,Spin,2004-01-02,Cape Town,South Africa,2004,1,69,114,1,1,458,726,4,389,612,3,114.5,>30,SA,Away,Upto 2014
RR Sarwan,WI,Spin,2004-01-16,Centurion,South Africa,2004,1,55,84,2,1,187,304,2,132,220,0,93.5,>30,SA,Away,Upto 2014
RR Sarwan,WI,Spin,2004-03-11,Kingston,West Indies,2004,1,6,24,1,1,110,185,4,104,161,3,27.5,<=30,WI,Home,Upto 2014
RR Sarwan,WI,Spin,2004-03-19,Port of Spain,West Indies,2004,1,3,6,0,1,72,167,2,69,161,2,36.0,>30,WI,Home,Upto 2014
RR Sarwan,WI,Spin,2004-04-10,St John's,West Indies,2004,2,44,114,2,1,477,993,7,433,879,5,68.14285714285714,>30,WI,Home,Upto 2014
RR Sarwan,WI,Spin,2004-05-28,Gros Islet,West Indies,2004,2,96,258,7,1,308,824,12,212,566,5,25.666666666666668,<=30,WI,Home,Upto 2014
RR Sarwan,WI,Spin,2004-06-04,Kingston,West Indies,2004,2,9,30,1,1,393,750,8,384,720,7,49.125,>30,WI,Home,Upto 2014
RR Sarwan,WI,Spin,2004-07-22,Lord's,England,2004,2,48,78,0,1,526,874,12,478,796,12,43.833333333333336,>30,ENG,Away,Upto 2014
RR Sarwan,WI,Spin,2004-07-29,Birmingham,England,2004,1,49,72,0,1,350,688,15,301,616,15,23.333333333333332,<=30,ENG,Away,Upto 2014
RR Sarwan,WI,Spin,2004-08-12,Manchester,England,2004,1,15,24,0,1,277,526,4,262,502,4,69.25,>30,ENG,Away,Upto 2014
RR Sarwan,WI,Spin,2004-08-19,The Oval,England,2004,1,22,42,0,1,104,218,2,82,176,2,52.0,>30,ENG,Away,Upto 2014
RR Sarwan,WI,Spin,2005-04-08,Port of Spain,West Indies,2005,1,17,30,0,1,187,617,7,170,587,7,26.714285714285715,<=30,WI,Home,Upto 2014
RR Sarwan,WI,Spin,2005-04-21,Bridgetown,West Indies,2005,1,7,6,0,1,288,498,4,281,492,4,72.0,>30,WI,Home,Upto 2014
RR Sarwan,WI,Spin,2005-04-29,St John's,West Indies,2005,2,5,12,0,1,410,840,3,405,828,3,136.66666666666666,>30,WI,Home,Upto 2014
RR Sarwan,WI,Spin,2005-06-03,Kingston,West Indies,2005,1,11,12,0,1,374,708,11,363,696,11,34.0,>30,WI,Home,Upto 2014
RR Sarwan,WI,Spin,2005-11-17,Hobart,Australia,2005,1,4,7,0,1,310,697,10,306,690,10,31.0,>30,AUS,Away,Upto 2014
RR Sarwan,WI,Spin,2005-11-25,Adelaide,Australia,2005,1,35,72,0,1,347,668,10,312,596,10,34.7,>30,AUS,Away,Upto 2014
RR Sarwan,WI,Spin,2006-06-02,St John's,West Indies,2006,1,15,24,0,1,672,1196,20,657,1172,20,33.6,>30,WI,Home,Upto 2014
RR Sarwan,WI,Spin,2006-06-10,Gros Islet,West Indies,2006,1,83,108,1,1,473,1177,17,390,1069,16,27.823529411764707,<=30,WI,Home,Upto 2014
RR Sarwan,WI,Spin,2006-11-11,Lahore,Pakistan,2006,1,2,6,0,1,296,600,9,294,594,9,32.888888888888886,>30,PAK,Away,Upto 2014
RR Sarwan,WI,Spin,2006-11-27,Karachi,Pakistan,2006,1,70,107,2,1,303,725,10,233,618,8,30.3,>30,PAK,Away,Upto 2014
RR Sarwan,WI,Spin,2007-05-17,Lord's,England,2007,1,33,36,0,1,293,462,9,260,426,9,32.55555555555556,>30,ENG,Away,Upto 2014
RR Sarwan,WI,Spin,2008-05-30,North Sound,West Indies,2008,2,45,60,0,1,298,516,3,253,456,3,99.33333333333333,>30,WI,Home,Upto 2014
RR Sarwan,WI,Spin,2008-06-12,Bridgetown,West Indies,2008,1,9,30,0,1,440,864,10,431,834,10,44.0,>30,WI,Home,Upto 2014
RR Sarwan,WI,Spin,2009-02-26,Bridgetown,West Indies,2009,2,27,30,0,1,611,1066,8,584,1036,8,76.375,>30,WI,Home,Upto 2014
RR Sarwan,WI,Spin,2009-05-14,Chester-le-Street,England,2009,1,7,6,0,1,248,450,4,241,444,4,62.0,>30,ENG,Away,Upto 2014
RR Singh,IND,Pace,1998-10-07,Harare,Zimbabwe,1998,2,32,60,0,1,643,1431,26,611,1371,26,24.73076923076923,<=30,ZIM,Away,Upto 2014
RRS Cornwall,WI,Spin,2019-08-30,Kingston,West Indies,2019,2,173,384,3,1,328,690,8,155,306,5,41.0,>30,WI,Home,After 1965
RRS Cornwall,WI,Spin,2019-11-27,Lucknow,India,2019,2,121,261,10,1,473,932,25,352,671,15,18.92,<=30,IND,Away,After 1965
RRS Cornwall,WI,Spin,2020-07-24,Manchester,England,2020,2,164,276,0,1,261,426,3,97,150,3,87.0,>30,ENG,Away,After 1965
RRS Cornwall,WI,Spin,2021-02-03,Chattogram,Bangladesh,2021,2,195,416,5,1,955,2045,28,760,1629,23,34.107142857142854,>30,BAN,Away,After 1965
RRS Cornwall,WI,Spin,2021-02-11,Mirpur,Bangladesh,2021,2,179,372,9,1,665,1522,28,486,1150,19,23.75,<=30,BAN,Away,After 1965
RRS Cornwall,WI,Spin,2021-03-21,North Sound,West Indies,2021,2,162,341,4,1,363,863,7,201,522,3,51.857142857142854,>30,WI,Home,After 1965
RRS Cornwall,WI,Spin,2021-03-29,North Sound,West Indies,2021,2,78,250,0,1,313,706,3,235,456,3,104.33333333333333,>30,WI,Home,After 1965
RRS Cornwall,WI,Spin,2021-06-10,Gros Islet,West Indies,2021,1,61,108,1,1,104,252,3,43,144,2,34.666666666666664,>30,WI,Home,After 1965
RRS Cornwall,WI,Spin,2021-11-21,Galle,Sri Lanka,2021,2,151,257,2,1,748,1629,31,597,1372,29,24.129032258064516,<=30,SL,Away,After 1965
RRS Cornwall,WI,Spin,2023-07-12,Roseau,West Indies,2023,1,32,96,1,1,411,1014,20,379,918,19,20.55,<=30,WI,Home,After 1965
RS Bopara,ENG,Pace,2007-12-01,Kandy,Sri Lanka,2007,2,24,54,0,1,767,1367,21,743,1313,21,36.523809523809526,>30,SL,Away,Upto 2014
RS Bopara,ENG,Pace,2007-12-09,Colombo (SSC),Sri Lanka,2007,1,18,42,0,1,676,1421,13,658,1379,13,52.0,>30,SL,Away,Upto 2014
RS Bopara,ENG,Pace,2007-12-18,Galle,Sri Lanka,2007,1,39,60,1,1,606,1192,16,567,1132,15,37.875,>30,SL,Away,Upto 2014
RS Bopara,ENG,Pace,2009-02-26,Bridgetown,West Indies,2009,1,66,78,0,1,977,1508,9,911,1430,9,108.55555555555556,>30,WI,Away,Upto 2014
RS Bopara,ENG,Pace,2009-05-06,Lord's,England,2009,1,8,12,0,1,625,1023,22,617,1011,22,28.40909090909091,<=30,ENG,Home,Upto 2014
RS Bopara,ENG,Pace,2009-07-30,Birmingham,England,2009,1,44,50,0,1,806,1353,22,762,1303,22,36.63636363636363,>30,ENG,Home,Upto 2014
RS Bopara,ENG,Pace,2011-08-18,The Oval,England,2011,2,13,30,0,1,633,1206,15,620,1176,15,42.2,>30,ENG,Home,Upto 2014
RS Bopara,ENG,Pace,2012-07-19,The Oval,England,2012,1,78,108,0,1,900,1787,18,822,1679,18,50.0,>30,ENG,Home,Upto 2014
RS Cunis,NZ,Pace,1964-03-13,Auckland,New Zealand,1964,2,127,232,2,1,606,1729,24,479,1497,22,25.25,<=30,NZ,Home,Upto 2014
RS Cunis,NZ,Pace,1966-02-25,Christchurch,New Zealand,1966,2,121,300,3,1,629,1668,27,508,1368,24,23.296296296296298,<=30,NZ,Home,Upto 2014
RS Cunis,NZ,Pace,1966-03-04,Dunedin,New Zealand,1966,1,49,168,2,1,364,1194,18,315,1026,16,20.22222222222222,<=30,NZ,Home,Upto 2014
RS Cunis,NZ,Pace,1966-03-11,Auckland,New Zealand,1966,2,78,263,2,1,459,1620,21,381,1357,19,21.857142857142858,<=30,NZ,Home,Upto 2014
RS Cunis,NZ,Pace,1969-02-27,Auckland,New Zealand,1969,2,116,232,1,1,544,1153,15,428,921,14,36.266666666666666,>30,NZ,Home,Upto 2014
RS Cunis,NZ,Pace,1969-03-07,Wellington,New Zealand,1969,2,112,240,5,1,575,1263,24,463,1023,19,23.958333333333332,<=30,NZ,Home,Upto 2014
RS Cunis,NZ,Pace,1969-03-13,Christchurch,New Zealand,1969,1,93,176,0,1,436,944,10,343,768,10,43.6,>30,NZ,Home,Upto 2014
RS Cunis,NZ,Pace,1969-08-21,The Oval,England,1969,2,85,180,5,1,397,1023,15,312,843,10,26.466666666666665,<=30,ENG,Away,Upto 2014
RS Cunis,NZ,Pace,1969-09-25,Brabourne,India,1969,2,81,216,2,1,336,982,18,255,766,16,18.666666666666668,<=30,IND,Away,Upto 2014
RS Cunis,NZ,Pace,1969-10-03,Nagpur,India,1969,2,53,114,1,1,171,432,3,118,318,2,57.0,>30,IND,Away,Upto 2014
RS Cunis,NZ,Pace,1969-10-15,Hyderabad (Deccan),India,1969,2,24,156,6,1,198,715,20,174,559,14,9.9,<=30,IND,Away,Upto 2014
RS Cunis,NZ,Pace,1969-10-24,Karachi,Pakistan,1969,2,56,160,2,1,167,468,6,111,308,4,27.833333333333332,<=30,PAK,Away,Upto 2014
RS Cunis,NZ,Pace,1969-11-08,Dhaka,Bangladesh,1969,2,86,180,4,1,262,729,8,176,549,4,32.75,>30,BAN,Away,Upto 2014
RS Cunis,NZ,Pace,1971-02-25,Christchurch,New Zealand,1971,2,61,168,1,1,205,688,11,144,520,10,18.636363636363637,<=30,NZ,Home,Upto 2014
RS Cunis,NZ,Pace,1971-03-05,Auckland,New Zealand,1971,2,128,367,9,1,561,1413,20,433,1046,11,28.05,<=30,NZ,Home,Upto 2014
RS Cunis,NZ,Pace,1972-02-16,Kingston,West Indies,1972,2,205,328,1,1,643,1221,11,438,893,10,58.45454545454545,>30,WI,Away,Upto 2014
RS Cunis,NZ,Pace,1972-03-09,Port of Spain,West Indies,1972,2,100,162,0,1,314,919,14,214,757,14,22.428571428571427,<=30,WI,Away,Upto 2014
RS Cunis,NZ,Pace,1972-03-23,Bridgetown,West Indies,1972,2,156,288,2,1,605,1337,20,449,1049,18,30.25,>30,WI,Away,Upto 2014
RS Cunis,NZ,Pace,1972-04-06,Georgetown,West Indies,1972,2,74,174,1,1,457,1170,6,383,996,5,76.16666666666667,>30,WI,Away,Upto 2014
RS Cunis,NZ,Pace,1972-04-20,Port of Spain,West Indies,1972,2,82,146,2,1,397,954,17,315,808,15,23.352941176470587,<=30,WI,Away,Upto 2014
RS Grant,WI,Spin,1935-01-08,Bridgetown,West Indies,1935,1,18,42,1,1,82,234,6,64,192,5,13.666666666666666,<=30,WI,Home,Upto 2014
RS Grant,WI,Spin,1935-01-24,Port of Spain,West Indies,1935,2,86,240,4,1,418,1002,12,332,762,8,34.833333333333336,>30,WI,Home,Upto 2014
RS Grant,WI,Spin,1935-02-14,Georgetown,West Indies,1935,2,74,288,3,1,339,996,16,265,708,13,21.1875,<=30,WI,Home,Upto 2014
RS Grant,WI,Spin,1935-03-14,Kingston,West Indies,1935,2,67,150,1,1,453,1026,10,386,876,9,45.3,>30,WI,Home,Upto 2014
RS Grant,WI,Spin,1939-06-24,Lord's,England,1939,1,23,24,0,1,311,784,11,288,760,11,28.272727272727273,<=30,ENG,Away,Upto 2014
RS Grant,WI,Spin,1939-07-22,Manchester,England,1939,1,16,106,2,1,184,368,9,168,262,7,20.444444444444443,<=30,ENG,Away,Upto 2014
RS Grant,WI,Spin,1939-08-19,The Oval,England,1939,2,69,136,0,1,434,768,4,365,632,4,108.5,>30,ENG,Away,Upto 2014
RS Kalpage,SL,Spin,1993-07-27,Colombo (SSC),Sri Lanka,1993,2,131,276,3,1,544,1136,16,413,860,13,34.0,>30,SL,Home,Upto 2014
RS Kalpage,SL,Spin,1993-08-25,Moratuwa,Sri Lanka,1993,2,44,155,1,1,610,1439,14,566,1284,13,43.57142857142857,>30,SL,Home,Upto 2014
RS Kalpage,SL,Spin,1993-12-08,Moratuwa,Sri Lanka,1993,1,27,60,2,1,241,659,12,214,599,10,20.083333333333332,<=30,SL,Home,Upto 2014
RS Kalpage,SL,Spin,1994-01-18,Lucknow,India,1994,1,59,132,0,1,633,1538,23,574,1406,23,27.52173913043478,<=30,IND,Away,Upto 2014
RS Kalpage,SL,Spin,1994-01-26,Bengaluru,India,1994,1,54,114,0,1,625,1188,15,571,1074,15,41.666666666666664,>30,IND,Away,Upto 2014
RS Kalpage,SL,Spin,1994-02-08,Ahmedabad,India,1994,1,9,42,0,1,473,1433,26,464,1391,26,18.192307692307693,<=30,IND,Away,Upto 2014
RS Kalpage,SL,Spin,1994-08-26,Kandy,Sri Lanka,1994,1,50,66,0,1,159,284,7,109,218,7,22.714285714285715,<=30,SL,Home,Upto 2014
RS Kalpage,SL,Spin,1994-10-26,Harare,Zimbabwe,1994,1,31,72,0,1,179,444,4,148,372,4,44.75,>30,ZIM,Away,Upto 2014
RS Kalpage,SL,Spin,1997-04-26,Colombo (SSC),Sri Lanka,1997,2,102,258,0,1,882,1775,14,780,1517,14,63.0,>30,SL,Home,Upto 2014
RS Kalpage,SL,Spin,1998-05-27,Colombo (RPS),Sri Lanka,1998,2,100,180,2,1,939,2077,27,839,1897,25,34.77777777777778,>30,SL,Home,Upto 2014
RS Kalpage,SL,Spin,1999-03-04,Lahore,Pakistan,1999,2,167,221,4,1,525,960,12,358,739,8,43.75,>30,PAK,Away,Upto 2014
RS Madugalle,SL,Spin,1984-03-16,Colombo (SSC),Sri Lanka,1984,1,0,6,0,1,166,567,3,166,561,3,55.333333333333336,>30,SL,Home,Upto 2014
RS Madugalle,SL,Spin,1984-08-23,Lord's,England,1984,1,4,18,0,1,242,726,5,238,708,5,48.4,>30,ENG,Away,Upto 2014
RS Madugalle,SL,Spin,1985-09-14,Kandy,Sri Lanka,1985,1,10,6,0,1,249,489,4,239,483,4,62.25,>30,SL,Home,Upto 2014
RS Madugalle,SL,Spin,1985-10-16,Faisalabad,Pakistan,1985,1,18,42,0,1,278,675,3,260,633,3,92.66666666666667,>30,PAK,Away,Upto 2014
RS Madugalle,SL,Spin,1987-04-16,Colombo (CCC),Sri Lanka,1987,1,6,12,0,1,223,696,4,217,684,4,55.75,>30,SL,Home,Upto 2014
RS Mahanama,SL,Spin,1989-12-08,Brisbane,Australia,1989,1,3,6,0,1,218,426,2,215,420,2,109.0,>30,AUS,Away,Upto 2014
RS Mahanama,SL,Spin,1992-09-08,Moratuwa,Sri Lanka,1992,1,27,30,0,1,347,775,4,320,745,4,86.75,>30,SL,Home,Upto 2014
RS Modi,IND,Pace,1951-11-02,Delhi,India,1951,1,14,30,0,1,354,1056,2,340,1026,2,177.0,>30,IND,Home,Upto 2014
RS Morton,WI,Spin,2005-07-22,Kandy,Sri Lanka,2005,1,15,30,0,1,292,585,15,277,555,15,19.466666666666665,<=30,SL,Away,Upto 2014
RS Morton,WI,Spin,2006-03-17,Wellington,New Zealand,2006,1,7,6,0,1,176,438,2,169,432,2,88.0,>30,NZ,Away,Upto 2014
RS Morton,WI,Spin,2006-11-19,Multan,Pakistan,2006,2,24,24,0,1,610,1072,9,586,1048,9,67.77777777777777,>30,PAK,Away,Upto 2014
RS Morton,WI,Spin,2007-05-17,Lord's,England,2007,1,4,6,0,1,293,462,9,289,456,9,32.55555555555556,>30,ENG,Away,Upto 2014
RT Latham,NZ,Pace,1992-11-01,Bulawayo,Zimbabwe,1992,1,6,18,0,1,481,878,7,475,860,7,68.71428571428571,>30,ZIM,Away,Upto 2014
RT Ponting,AUS,Pace,1995-12-26,Melbourne,Australia,1995,1,8,24,1,1,608,1377,17,600,1353,16,35.76470588235294,>30,AUS,Home,Upto 2014
RT Ponting,AUS,Pace,1996-11-22,Brisbane,Australia,1996,1,0,11,1,1,925,1944,28,925,1933,27,33.035714285714285,>30,AUS,Home,Upto 2014
RT Ponting,AUS,Pace,1998-10-15,Peshawar,Pakistan,1998,1,13,30,1,1,690,1183,11,677,1153,10,62.72727272727273,>30,PAK,Away,Upto 2014
RT Ponting,AUS,Pace,1998-11-20,Brisbane,Australia,1998,2,10,24,0,1,919,1808,20,909,1784,20,45.95,>30,AUS,Home,Upto 2014
RT Ponting,AUS,Pace,1999-03-26,Bridgetown,West Indies,1999,1,12,24,1,1,815,1748,29,803,1724,28,28.103448275862068,<=30,WI,Away,Upto 2014
RT Ponting,AUS,Pace,1999-09-22,Galle,Sri Lanka,1999,1,7,24,0,1,252,497,5,245,473,5,50.4,>30,SL,Away,Upto 2014
RT Ponting,AUS,Pace,1999-10-14,Harare,Zimbabwe,1999,2,0,12,0,1,535,1322,16,535,1310,16,33.4375,>30,ZIM,Away,Upto 2014
RT Ponting,AUS,Pace,1999-11-05,Brisbane,Australia,1999,2,24,54,0,1,895,1510,23,871,1456,23,38.91304347826087,>30,AUS,Home,Upto 2014
RT Ponting,AUS,Pace,1999-11-18,Hobart,Australia,1999,1,7,12,0,1,857,1577,19,850,1565,19,45.10526315789474,>30,AUS,Home,Upto 2014
RT Ponting,AUS,Pace,2000-01-02,Sydney,Australia,2000,1,8,6,0,1,643,1127,22,635,1121,22,29.227272727272727,<=30,AUS,Home,Upto 2014
RT Ponting,AUS,Pace,2000-12-15,Adelaide,Australia,2000,1,0,6,0,1,620,1329,20,620,1323,20,31.0,>30,AUS,Home,Upto 2014
RT Ponting,AUS,Pace,2001-03-11,Eden Gardens,India,2001,1,41,72,0,1,800,1488,16,759,1416,16,50.0,>30,IND,Away,Upto 2014
RT Ponting,AUS,Pace,2001-03-18,Chennai,India,2001,1,2,12,0,1,331,733,10,329,721,10,33.1,>30,IND,Away,Upto 2014
RT Ponting,AUS,Pace,2001-08-23,The Oval,England,2001,2,8,24,0,1,586,1029,9,578,1005,9,65.11111111111111,>30,ENG,Away,Upto 2014
RT Ponting,AUS,Pace,2001-11-08,Brisbane,Australia,2001,1,8,18,0,1,871,1428,20,863,1410,20,43.55,>30,AUS,Home,Upto 2014
RT Ponting,AUS,Pace,2001-11-30,W.A.C.A,Australia,2001,1,1,24,0,1,1026,1787,22,1025,1763,22,46.63636363636363,>30,AUS,Home,Upto 2014
RT Ponting,AUS,Pace,2002-01-02,Sydney,Australia,2002,1,11,6,0,1,596,1002,11,585,996,11,54.18181818181818,>30,AUS,Home,Upto 2014
RT Ponting,AUS,Pace,2002-10-19,Sharjah,UAE,2002,1,5,6,0,1,365,713,15,360,707,15,24.333333333333332,<=30,UAE,Away,Upto 2014
RT Ponting,AUS,Pace,2003-05-01,Bridgetown,West Indies,2003,1,6,12,0,1,652,1455,15,646,1443,15,43.46666666666667,>30,WI,Away,Upto 2014
RT Ponting,AUS,Pace,2003-10-09,W.A.C.A,Australia,2003,1,15,30,0,1,658,1277,15,643,1247,15,43.86666666666667,>30,AUS,Home,Upto 2014
RT Ponting,AUS,Pace,2003-12-12,Adelaide,Australia,2003,1,4,6,0,1,872,1501,19,868,1495,19,45.89473684210526,>30,AUS,Home,Upto 2014
RT Ponting,AUS,Pace,2004-12-16,W.A.C.A,Australia,2004,1,15,18,0,1,677,1213,30,662,1195,30,22.566666666666666,<=30,AUS,Home,Upto 2014
RT Ponting,AUS,Pace,2005-03-26,Auckland,New Zealand,2005,1,10,24,0,1,759,1379,20,749,1355,20,37.95,>30,NZ,Away,Upto 2014
RT Ponting,AUS,Pace,2005-08-25,Nottingham,England,2005,1,9,36,1,1,944,1543,26,935,1507,25,36.30769230769231,>30,ENG,Away,Upto 2014
RT Ponting,AUS,Pace,2006-03-31,Johannesburg,South Africa,2006,1,7,12,0,1,824,1490,30,817,1478,30,27.466666666666665,<=30,SA,Away,Upto 2014
RT Ponting,AUS,Pace,2008-10-29,Delhi,India,2008,1,11,12,0,1,697,1278,10,686,1266,10,69.7,>30,IND,Away,Upto 2014
RT Ponting,AUS,Pace,2011-08-31,Galle,Sri Lanka,2011,1,5,12,0,1,381,906,20,376,894,20,19.05,<=30,SL,Away,Upto 2014
RT Ponting,AUS,Pace,2011-09-16,Colombo (SSC),Sri Lanka,2011,1,14,12,0,1,825,1634,20,811,1622,20,41.25,>30,SL,Away,Upto 2014
RT Ponting,AUS,Pace,2011-11-17,Johannesburg,South Africa,2011,1,8,6,0,1,938,1680,27,930,1674,27,34.74074074074074,>30,SA,Away,Upto 2014
RT Ponting,AUS,Pace,2011-12-09,Hobart,Australia,2011,1,4,6,0,1,648,1341,37,644,1335,37,17.513513513513512,<=30,AUS,Home,Upto 2014
RT Ponting,AUS,Pace,2012-11-22,Adelaide,Australia,2012,1,0,6,0,1,863,1649,28,863,1643,28,30.821428571428573,>30,AUS,Home,Upto 2014
RT Ponting,AUS,Pace,2012-11-30,W.A.C.A,Australia,2012,1,3,6,0,1,885,1522,30,882,1516,30,29.5,<=30,AUS,Home,Upto 2014
RT Robinson,ENG,Pace,1984-12-31,Eden Gardens,India,1984,1,0,6,0,1,288,729,8,288,723,8,36.0,>30,IND,Away,Upto 2014
RT Simpson,ENG,Spin,1949-07-23,Manchester,England,1949,1,9,12,0,1,586,1224,13,577,1212,13,45.07692307692308,>30,ENG,Home,Upto 2014
RT Simpson,ENG,Spin,1950-07-20,Nottingham,England,1950,1,9,9,0,1,728,2103,19,719,2094,19,38.31578947368421,>30,ENG,Home,Upto 2014
RT Simpson,ENG,Spin,1951-03-17,Christchurch,New Zealand,1951,1,4,24,2,1,586,1337,15,582,1313,13,39.06666666666667,>30,NZ,Away,Upto 2014
RTD Perks,ENG,Pace,1939-03-03,Durban,South Africa,1939,2,199,584,6,1,1100,3449,18,901,2865,12,61.111111111111114,>30,SA,Away,Upto 2014
RTD Perks,ENG,Pace,1939-08-19,The Oval,England,1939,1,156,245,5,1,751,1240,17,595,995,12,44.1764705882353,>30,ENG,Home,Upto 2014
RTM Mendis,SL,Spin,2021-01-22,Galle,Sri Lanka,2021,2,96,156,2,1,734,1377,23,638,1221,21,31.91304347826087,>30,SL,Home,After 1965
RTM Mendis,SL,Spin,2021-04-29,Pallekele,Sri Lanka,2021,2,189,354,6,1,753,1454,28,564,1100,22,26.892857142857142,<=30,SL,Home,After 1965
RTM Mendis,SL,Spin,2021-11-21,Galle,Sri Lanka,2021,2,139,288,7,1,748,1629,31,609,1341,24,24.129032258064516,<=30,SL,Home,After 1965
RTM Mendis,SL,Spin,2021-11-29,Galle,Sri Lanka,2021,2,136,356,11,1,790,1806,36,654,1450,25,21.944444444444443,<=30,SL,Home,After 1965
RTM Mendis,SL,Spin,2022-05-15,Chattogram,Bangladesh,2022,1,119,270,0,1,772,1873,17,653,1603,17,45.411764705882355,>30,BAN,Away,After 1965
RTM Mendis,SL,Spin,2022-05-23,Mirpur,Bangladesh,2022,2,73,150,1,1,553,1141,6,480,991,5,92.16666666666667,>30,BAN,Away,After 1965
RTM Mendis,SL,Spin,2022-06-29,Galle,Sri Lanka,2022,2,122,196,4,1,491,729,25,369,533,21,19.64,<=30,SL,Home,After 1965
RTM Mendis,SL,Spin,2022-07-08,Galle,Sri Lanka,2022,2,164,288,3,1,757,1422,23,593,1134,20,32.91304347826087,>30,SL,Home,After 1965
RTM Mendis,SL,Spin,2022-07-16,Galle,Sri Lanka,2022,2,120,276,3,1,840,1795,26,720,1519,23,32.30769230769231,>30,SL,Home,After 1965
RTM Mendis,SL,Spin,2022-07-24,Galle,Sri Lanka,2022,2,148,307,9,1,907,1657,29,759,1350,20,31.275862068965516,>30,SL,Home,After 1965
RTM Mendis,SL,Spin,2023-04-16,Galle,Sri Lanka,2023,2,116,207,5,1,643,1027,18,527,820,13,35.72222222222222,>30,SL,Home,After 1965
RTM Mendis,SL,Spin,2023-04-24,Galle,Sri Lanka,2023,2,172,324,6,1,963,1611,14,791,1287,8,68.78571428571429,>30,SL,Home,After 1965
RTM Mendis,SL,Spin,2023-07-16,Galle,Sri Lanka,2023,2,198,338,6,1,731,1336,25,533,998,19,29.24,<=30,SL,Home,After 1965
RTM Mendis,SL,Spin,2023-07-24,Colombo (SSC),Sri Lanka,2023,1,139,216,0,1,535,922,13,396,706,13,41.15384615384615,>30,SL,Home,After 1965
RTM Mendis,SL,Spin,2024-09-18,Galle,Sri Lanka,2024,2,184,293,6,1,849,1559,29,665,1266,23,29.275862068965516,<=30,SL,Home,After 1965
RV Divecha,IND,Spin,1951-12-30,Eden Gardens,India,1951,2,115,348,4,1,698,1841,19,583,1493,15,36.73684210526316,>30,IND,Home,Upto 2014
RV Divecha,IND,Spin,1952-02-06,Chennai,India,1952,2,48,114,1,1,648,1564,25,600,1450,24,25.92,<=30,IND,Home,Upto 2014
RV Divecha,IND,Spin,1952-07-17,Manchester,England,1952,1,102,270,3,1,285,693,12,183,423,9,23.75,<=30,ENG,Away,Upto 2014
RV Divecha,IND,Spin,1952-08-14,The Oval,England,1952,1,60,198,1,1,267,870,5,207,672,4,53.4,>30,ENG,Away,Upto 2014
RV Divecha,IND,Spin,1952-11-28,Chennai,India,1952,1,36,114,2,1,261,594,8,225,480,6,32.625,>30,IND,Home,Upto 2014
RW Barber,ENG,Spin,1960-06-09,Birmingham,England,1960,2,55,96,1,1,303,864,14,248,768,13,21.642857142857142,<=30,ENG,Home,Upto 2014
RW Barber,ENG,Spin,1961-10-21,Lahore,Pakistan,1961,2,178,365,6,1,702,1631,18,524,1266,12,39.0,>30,PAK,Away,Upto 2014
RW Barber,ENG,Spin,1961-11-11,Brabourne,India,1961,2,116,210,1,1,727,1890,18,611,1680,17,40.388888888888886,>30,IND,Away,Upto 2014
RW Barber,ENG,Spin,1961-12-13,Delhi,India,1961,1,103,150,1,1,505,1242,8,402,1092,7,63.125,>30,IND,Away,Upto 2014
RW Barber,ENG,Spin,1961-12-30,Eden Gardens,India,1961,2,26,30,0,1,632,1788,29,606,1758,29,21.79310344827586,<=30,IND,Away,Upto 2014
RW Barber,ENG,Spin,1962-01-10,Chennai,India,1962,1,70,84,2,1,866,2320,33,796,2236,31,26.242424242424242,<=30,IND,Away,Upto 2014
RW Barber,ENG,Spin,1962-01-19,Dhaka,Bangladesh,1962,1,12,66,0,1,862,2494,25,850,2428,25,34.48,>30,BAN,Away,Upto 2014
RW Barber,ENG,Spin,1962-02-02,Karachi,Pakistan,1962,2,161,330,4,1,769,2063,17,608,1733,13,45.23529411764706,>30,PAK,Away,Upto 2014
RW Barber,ENG,Spin,1964-08-13,The Oval,England,1964,1,23,36,0,1,191,690,2,168,654,2,95.5,>30,ENG,Home,Upto 2014
RW Barber,ENG,Spin,1964-12-04,Durban,South Africa,1964,2,56,120,2,1,464,1264,16,408,1144,14,29.0,<=30,SA,Away,Upto 2014
RW Barber,ENG,Spin,1964-12-23,Johannesburg,South Africa,1964,2,45,96,1,1,545,1457,14,500,1361,13,38.92857142857143,>30,SA,Away,Upto 2014
RW Barber,ENG,Spin,1965-01-01,Cape Town,South Africa,1965,1,2,6,0,1,605,1499,14,603,1493,14,43.214285714285715,>30,SA,Away,Upto 2014
RW Barber,ENG,Spin,1965-05-27,Birmingham,England,1965,2,139,288,6,1,528,1355,15,389,1067,9,35.2,>30,ENG,Home,Upto 2014
RW Barber,ENG,Spin,1965-06-17,Lord's,England,1965,2,81,216,3,1,329,839,9,248,623,6,36.55555555555556,>30,ENG,Home,Upto 2014
RW Barber,ENG,Spin,1965-07-08,Leeds,England,1965,2,16,96,0,1,275,702,9,259,606,9,30.555555555555557,>30,ENG,Home,Upto 2014
RW Barber,ENG,Spin,1965-07-22,Lord's,England,1965,2,90,213,3,1,281,779,9,191,566,6,31.22222222222222,>30,ENG,Home,Upto 2014
RW Barber,ENG,Spin,1965-08-05,Nottingham,England,1965,2,59,72,0,1,259,688,8,200,616,8,32.375,>30,ENG,Home,Upto 2014
RW Barber,ENG,Spin,1965-08-26,The Oval,England,1965,1,44,78,0,1,295,744,6,251,666,6,49.166666666666664,>30,ENG,Home,Upto 2014
RW Barber,ENG,Spin,1965-12-10,Brisbane,Australia,1965,1,42,40,0,1,514,1281,8,472,1241,8,64.25,>30,AUS,Away,Upto 2014
RW Barber,ENG,Spin,1965-12-30,Melbourne,Australia,1965,2,111,184,1,1,661,1476,9,550,1292,8,73.44444444444444,>30,AUS,Away,Upto 2014
RW Barber,ENG,Spin,1966-01-07,Sydney,Australia,1966,2,18,57,1,1,404,1124,13,386,1067,12,31.076923076923077,>30,AUS,Away,Upto 2014
RW Barber,ENG,Spin,1966-01-28,Adelaide,Australia,1966,1,30,32,0,1,423,991,7,393,959,7,60.42857142857143,>30,AUS,Away,Upto 2014
RW Barber,ENG,Spin,1966-02-11,Melbourne,Australia,1966,1,60,128,1,1,369,880,3,309,752,2,123.0,>30,AUS,Away,Upto 2014
RW Barber,ENG,Spin,1966-08-04,Leeds,England,1966,1,55,84,1,1,445,946,16,390,862,15,27.8125,<=30,ENG,Home,Upto 2014
RW Barber,ENG,Spin,1966-08-18,The Oval,England,1966,2,127,223,5,1,515,1218,14,388,995,9,36.785714285714285,>30,ENG,Home,Upto 2014
RW Barber,ENG,Spin,1968-06-06,Manchester,England,1968,2,87,126,3,1,456,1101,19,369,975,16,24.0,<=30,ENG,Home,Upto 2014
RW Blair,NZ,Pace,1953-03-06,Wellington,New Zealand,1953,1,98,216,4,1,299,1005,14,201,789,10,21.357142857142858,<=30,NZ,Home,Upto 2014
RW Blair,NZ,Pace,1953-03-13,Auckland,New Zealand,1953,2,90,246,2,1,316,1056,6,226,810,4,52.666666666666664,>30,NZ,Home,Upto 2014
RW Blair,NZ,Pace,1953-12-11,Durban,South Africa,1953,1,104,176,2,1,403,1104,13,299,928,11,31.0,>30,SA,Away,Upto 2014
RW Blair,NZ,Pace,1953-12-24,Johannesburg,South Africa,1953,2,64,176,2,1,463,1350,29,399,1174,27,15.96551724137931,<=30,SA,Away,Upto 2014
RW Blair,NZ,Pace,1954-01-29,Johannesburg,South Africa,1954,2,48,176,3,1,358,1413,20,310,1237,17,17.9,<=30,SA,Away,Upto 2014
RW Blair,NZ,Pace,1954-02-05,Gqeberha,South Africa,1954,2,54,184,2,1,339,985,18,285,801,16,18.833333333333332,<=30,SA,Away,Upto 2014
RW Blair,NZ,Pace,1955-03-11,Dunedin,New Zealand,1955,2,49,72,1,1,287,993,22,238,921,21,13.045454545454545,<=30,NZ,Home,Upto 2014
RW Blair,NZ,Pace,1956-02-03,Dunedin,New Zealand,1956,1,90,137,4,1,148,341,6,58,204,2,24.666666666666668,<=30,NZ,Home,Upto 2014
RW Blair,NZ,Pace,1956-02-18,Christchurch,New Zealand,1956,1,66,162,1,1,198,504,4,132,342,3,49.5,>30,NZ,Home,Upto 2014
RW Blair,NZ,Pace,1958-06-19,Lord's,England,1958,1,57,150,0,1,233,706,14,176,556,14,16.642857142857142,<=30,ENG,Away,Upto 2014
RW Blair,NZ,Pace,1958-07-24,Manchester,England,1958,1,68,162,1,1,389,953,12,321,791,11,32.416666666666664,>30,ENG,Away,Upto 2014
RW Blair,NZ,Pace,1958-08-21,The Oval,England,1958,1,85,156,2,1,285,708,12,200,552,10,23.75,<=30,ENG,Away,Upto 2014
RW Blair,NZ,Pace,1959-02-27,Christchurch,New Zealand,1959,1,89,186,2,1,293,707,12,204,521,10,24.416666666666668,<=30,NZ,Home,Upto 2014
RW Blair,NZ,Pace,1959-03-14,Auckland,New Zealand,1959,1,69,162,0,1,267,780,10,198,618,10,26.7,<=30,NZ,Home,Upto 2014
RW Blair,NZ,Pace,1963-03-01,Wellington,New Zealand,1963,1,81,198,2,1,394,894,13,313,696,11,30.307692307692307,>30,NZ,Home,Upto 2014
RW Blair,NZ,Pace,1963-03-15,Christchurch,New Zealand,1963,2,76,216,3,1,462,1331,21,386,1115,18,22.0,<=30,NZ,Home,Upto 2014
RW Blair,NZ,Pace,1964-02-21,Wellington,New Zealand,1964,2,134,312,3,1,514,1667,18,380,1355,15,28.555555555555557,<=30,NZ,Home,Upto 2014
RW Blair,NZ,Pace,1964-02-28,Dunedin,New Zealand,1964,2,51,96,2,1,306,1085,13,255,989,11,23.53846153846154,<=30,NZ,Home,Upto 2014
RW Blair,NZ,Pace,1964-03-13,Auckland,New Zealand,1964,2,142,342,7,1,606,1729,24,464,1387,17,25.25,<=30,NZ,Home,Upto 2014
RW Marsh,AUS,Spin,1980-03-06,Faisalabad,Pakistan,1980,1,51,60,0,1,592,1272,6,541,1212,6,98.66666666666667,>30,PAK,Away,Upto 2014
RW Marsh,AUS,Spin,1983-12-26,Melbourne,Australia,1983,1,3,12,0,1,391,853,9,388,841,9,43.44444444444444,>30,AUS,Home,Upto 2014
RW McLeod,AUS,Pace,1892-01-01,Melbourne,Australia,1892,2,92,310,6,1,677,2425,30,585,2115,24,22.566666666666666,<=30,AUS,Home,After 1965
RW McLeod,AUS,Pace,1892-01-29,Sydney,Australia,1892,1,55,108,2,1,735,2292,31,680,2184,29,23.70967741935484,<=30,AUS,Home,After 1965
RW McLeod,AUS,Pace,1892-03-24,Adelaide,Australia,1892,1,78,246,2,1,529,1333,15,451,1087,13,35.266666666666666,>30,AUS,Home,After 1965
RW McLeod,AUS,Pace,1893-07-17,Lord's,England,1893,2,79,230,1,1,548,1355,26,469,1125,25,21.076923076923077,<=30,ENG,Away,After 1965
RW McLeod,AUS,Pace,1893-08-14,The Oval,England,1893,1,57,115,0,1,575,1100,17,518,985,17,33.8235294117647,>30,ENG,Away,After 1965
RW McLeod,AUS,Pace,1893-08-24,Manchester,England,1893,1,21,80,1,1,557,1484,22,536,1404,21,25.318181818181817,<=30,ENG,Away,After 1965
RW Morgan,NZ,Spin,1965-01-29,Auckland,New Zealand,1965,1,24,42,0,1,450,1734,24,426,1692,24,18.75,<=30,NZ,Home,Upto 2014
RW Morgan,NZ,Spin,1965-02-27,Chennai,India,1965,2,34,72,0,1,616,1705,17,582,1633,17,36.23529411764706,>30,IND,Away,Upto 2014
RW Morgan,NZ,Spin,1965-03-12,Brabourne,India,1965,1,54,108,0,1,545,1316,11,491,1208,11,49.54545454545455,>30,IND,Away,Upto 2014
RW Morgan,NZ,Spin,1965-03-19,Delhi,India,1965,1,68,90,1,1,716,1840,21,648,1750,20,34.095238095238095,>30,IND,Away,Upto 2014
RW Morgan,NZ,Spin,1965-03-27,Rawalpindi,Pakistan,1965,1,34,51,1,1,362,890,18,328,839,17,20.11111111111111,<=30,PAK,Away,Upto 2014
RW Morgan,NZ,Spin,1965-04-02,Lahore,Pakistan,1965,2,78,150,0,1,697,1836,15,619,1686,15,46.46666666666667,>30,PAK,Away,Upto 2014
RW Morgan,NZ,Spin,1965-04-09,Karachi,Pakistan,1965,2,62,120,0,1,606,1528,19,544,1408,19,31.894736842105264,>30,PAK,Away,Upto 2014
RW Morgan,NZ,Spin,1965-05-27,Birmingham,England,1965,1,18,11,1,1,528,1355,15,510,1344,14,35.2,>30,ENG,Away,Upto 2014
RW Morgan,NZ,Spin,1965-06-17,Lord's,England,1965,2,44,66,0,1,329,839,9,285,773,9,36.55555555555556,>30,ENG,Away,Upto 2014
RW Morgan,NZ,Spin,1965-07-08,Leeds,England,1965,1,28,36,0,1,275,702,9,247,666,9,30.555555555555557,>30,ENG,Away,Upto 2014
RW Morgan,NZ,Spin,1969-03-07,Wellington,New Zealand,1969,1,19,32,0,1,243,621,7,224,589,7,34.714285714285715,>30,NZ,Home,Upto 2014
RW Morgan,NZ,Spin,1971-03-05,Auckland,New Zealand,1971,1,16,48,1,1,315,824,7,299,776,6,45.0,>30,NZ,Home,Upto 2014
RW Morgan,NZ,Spin,1972-03-23,Bridgetown,West Indies,1972,1,78,180,0,1,454,1224,7,376,1044,7,64.85714285714286,>30,WI,Away,Upto 2014
RW Morgan,NZ,Spin,1972-04-06,Georgetown,West Indies,1972,1,10,54,0,1,489,1488,3,479,1434,3,163.0,>30,WI,Away,Upto 2014
RW Morgan,NZ,Spin,1972-04-20,Port of Spain,West Indies,1972,2,42,54,1,1,509,1648,17,467,1594,16,29.941176470588236,<=30,WI,Away,Upto 2014
RW Price,ZIM,Spin,1999-12-04,Harare,Zimbabwe,1999,1,22,48,0,1,143,474,2,121,426,2,71.5,>30,ZIM,Home,Upto 2014
RW Price,ZIM,Spin,2001-04-26,Harare,Zimbabwe,2001,2,165,360,7,1,348,861,12,183,501,5,29.0,<=30,ZIM,Home,Upto 2014
RW Price,ZIM,Spin,2001-07-19,Bulawayo,Zimbabwe,2001,1,157,264,2,1,317,696,7,160,432,5,45.285714285714285,>30,ZIM,Home,Upto 2014
RW Price,ZIM,Spin,2001-07-27,Harare,Zimbabwe,2001,2,90,260,2,1,386,944,10,296,684,8,38.6,>30,ZIM,Home,Upto 2014
RW Price,ZIM,Spin,2001-09-07,Harare,Zimbabwe,2001,2,211,272,0,1,406,782,4,195,510,4,101.5,>30,ZIM,Home,Upto 2014
RW Price,ZIM,Spin,2001-09-14,Bulawayo,Zimbabwe,2001,1,181,474,5,1,460,1130,12,279,656,7,38.333333333333336,>30,ZIM,Home,Upto 2014
RW Price,ZIM,Spin,2002-02-21,Nagpur,India,2002,1,182,408,5,1,556,1425,18,374,1017,13,30.88888888888889,>30,IND,Away,Upto 2014
RW Price,ZIM,Spin,2002-02-28,Delhi,India,2002,2,132,414,5,1,467,1232,22,335,818,17,21.227272727272727,<=30,IND,Away,Upto 2014
RW Price,ZIM,Spin,2002-11-09,Harare,Zimbabwe,2002,2,122,240,4,1,290,546,9,168,306,5,32.22222222222222,>30,ZIM,Home,Upto 2014
RW Price,ZIM,Spin,2002-11-16,Bulawayo,Zimbabwe,2002,2,137,333,4,1,335,808,14,198,475,10,23.928571428571427,<=30,ZIM,Home,Upto 2014
RW Price,ZIM,Spin,2003-05-22,Lord's,England,2003,1,44,120,1,1,157,306,4,113,186,3,39.25,>30,ENG,Away,Upto 2014
RW Price,ZIM,Spin,2003-06-05,Chester-le-Street,England,2003,1,105,240,1,1,179,420,2,74,180,1,89.5,>30,ENG,Away,Upto 2014
RW Price,ZIM,Spin,2003-10-09,W.A.C.A,Australia,2003,1,187,216,0,1,603,903,11,416,687,11,54.81818181818182,>30,AUS,Away,Upto 2014
RW Price,ZIM,Spin,2003-10-17,Sydney,Australia,2003,2,184,322,6,1,468,933,15,284,611,9,31.2,>30,AUS,Away,Upto 2014
RW Price,ZIM,Spin,2003-11-04,Harare,Zimbabwe,2003,2,161,452,10,1,313,784,11,152,332,1,28.454545454545453,<=30,ZIM,Home,Upto 2014
RW Price,ZIM,Spin,2003-11-12,Bulawayo,Zimbabwe,2003,2,235,384,9,1,453,841,14,218,457,5,32.357142857142854,>30,ZIM,Home,Upto 2014
RW Price,ZIM,Spin,2004-02-19,Harare,Zimbabwe,2004,2,140,275,5,1,538,1129,14,398,854,9,38.42857142857143,>30,ZIM,Home,Upto 2014
RW Price,ZIM,Spin,2004-02-26,Bulawayo,Zimbabwe,2004,1,20,53,3,1,156,307,6,136,254,3,26.0,<=30,ZIM,Home,Upto 2014
RW Price,ZIM,Spin,2011-08-04,Harare,Zimbabwe,2011,2,54,98,2,1,318,704,9,264,606,7,35.333333333333336,>30,ZIM,Home,Upto 2014
RW Price,ZIM,Spin,2011-09-01,Bulawayo,Zimbabwe,2011,2,104,365,4,1,525,1193,17,421,828,13,30.88235294117647,>30,ZIM,Home,Upto 2014
RW Price,ZIM,Spin,2011-11-01,Bulawayo,Zimbabwe,2011,2,205,429,4,1,535,1222,13,330,793,9,41.15384615384615,>30,ZIM,Home,Upto 2014
RW Price,ZIM,Spin,2013-03-12,Bridgetown,West Indies,2013,1,47,108,1,1,270,496,14,223,388,13,19.285714285714285,<=30,WI,Away,Upto 2014
RW Taylor,ENG,Pace,1982-01-13,Chennai,India,1982,1,6,12,0,1,631,1176,8,625,1164,8,78.875,>30,IND,Away,Upto 2014
RWG Emery,NZ,Pace,1952-02-15,Auckland,New Zealand,1952,1,52,46,2,1,254,466,5,202,420,3,50.8,>30,NZ,Home,Upto 2014
RWV Robins,ENG,Spin,1929-06-29,Lord's,England,1929,2,79,258,5,1,382,1002,11,303,744,6,34.72727272727273,>30,ENG,Home,Upto 2014
RWV Robins,ENG,Spin,1930-06-13,Nottingham,England,1930,2,132,206,7,1,620,1484,29,488,1278,22,21.379310344827587,<=30,ENG,Home,Upto 2014
RWV Robins,ENG,Spin,1930-06-27,Lord's,England,1930,2,206,306,3,1,960,1932,18,754,1626,15,53.333333333333336,>30,ENG,Home,Upto 2014
RWV Robins,ENG,Spin,1931-06-27,Lord's,England,1931,2,164,300,5,1,753,1396,20,589,1096,15,37.65,>30,ENG,Home,Upto 2014
RWV Robins,ENG,Spin,1932-06-25,Lord's,England,1932,2,96,186,3,1,320,726,9,224,540,6,35.55555555555556,>30,ENG,Home,Upto 2014
RWV Robins,ENG,Spin,1933-06-24,Lord's,England,1933,2,68,143,7,1,304,786,19,236,643,12,16.0,<=30,ENG,Home,Upto 2014
RWV Robins,ENG,Spin,1933-07-22,Manchester,England,1933,2,152,239,4,1,521,1061,15,369,822,11,34.733333333333334,>30,ENG,Home,Upto 2014
RWV Robins,ENG,Spin,1935-06-15,Nottingham,England,1935,1,65,114,1,1,343,876,8,278,762,7,42.875,>30,ENG,Home,Upto 2014
RWV Robins,ENG,Spin,1935-07-27,Manchester,England,1935,2,65,174,3,1,449,1029,11,384,855,8,40.81818181818182,>30,ENG,Home,Upto 2014
RWV Robins,ENG,Spin,1935-08-17,The Oval,England,1935,2,134,234,5,1,498,864,8,364,630,3,62.25,>30,ENG,Home,Upto 2014
RWV Robins,ENG,Spin,1936-06-27,Lord's,England,1936,2,67,108,4,1,182,439,11,115,331,7,16.545454545454547,<=30,ENG,Home,Upto 2014
RWV Robins,ENG,Spin,1936-07-25,Manchester,England,1936,2,137,229,5,1,479,775,14,342,546,9,34.214285714285715,>30,ENG,Home,Upto 2014
RWV Robins,ENG,Spin,1936-12-04,Brisbane,Australia,1936,1,48,136,0,1,566,1790,14,518,1654,14,40.42857142857143,>30,AUS,Away,Upto 2014
RWV Robins,ENG,Spin,1936-12-18,Sydney,Australia,1936,2,31,64,0,1,468,1160,7,437,1096,7,66.85714285714286,>30,AUS,Away,Upto 2014
RWV Robins,ENG,Spin,1937-01-01,Melbourne,Australia,1937,2,77,144,2,1,614,1405,21,537,1261,19,29.238095238095237,<=30,AUS,Away,Upto 2014
RWV Robins,ENG,Spin,1937-01-29,Adelaide,Australia,1937,2,64,104,2,1,554,1660,17,490,1556,15,32.588235294117645,>30,AUS,Away,Upto 2014
RWV Robins,ENG,Spin,1937-06-26,Lord's,England,1937,2,109,222,4,1,512,1098,11,403,876,7,46.54545454545455,>30,ENG,Home,Upto 2014
RWV Robins,ENG,Spin,1937-08-14,The Oval,England,1937,2,64,151,4,1,331,715,12,267,564,8,27.583333333333332,<=30,ENG,Home,Upto 2014
Rahat Ali,PAK,Pace,2013-02-01,Johannesburg,South Africa,2013,2,100,150,0,1,592,1253,26,492,1103,26,22.76923076923077,<=30,SA,Away,Upto 2014
Rahat Ali,PAK,Pace,2013-02-22,Centurion,South Africa,2013,1,127,164,6,1,578,1050,26,451,886,20,22.23076923076923,<=30,SA,Away,Upto 2014
Rahat Ali,PAK,Pace,2013-09-03,Harare,Zimbabwe,2013,2,105,180,1,1,657,1465,18,552,1285,17,36.5,>30,ZIM,Away,Upto 2014
Rahat Ali,PAK,Pace,2013-09-10,Harare,Zimbabwe,2013,2,100,263,7,1,558,1504,28,458,1241,21,19.928571428571427,<=30,ZIM,Away,Upto 2014
Rahat Ali,PAK,Pace,2013-12-31,Abu Dhabi,UAE,2013,2,133,327,0,1,807,1581,20,674,1254,20,40.35,>30,UAE,Away,Upto 2014
Rahat Ali,PAK,Pace,2014-01-08,Dubai (DICS),UAE,2014,2,160,282,2,1,719,1539,21,559,1257,19,34.23809523809524,>30,UAE,Away,After 1965
Rahat Ali,PAK,Pace,2014-10-22,Dubai (DICS),UAE,2014,2,91,192,2,1,384,954,8,293,762,6,48.0,>30,UAE,Away,After 1965
Rahat Ali,PAK,Pace,2014-10-30,Abu Dhabi,UAE,2014,2,44,102,2,1,549,1024,11,505,922,9,49.90909090909091,>30,UAE,Away,After 1965
Rahat Ali,PAK,Pace,2014-11-09,Abu Dhabi,UAE,2014,2,70,168,6,1,447,927,10,377,759,4,44.7,>30,UAE,Away,After 1965
Rahat Ali,PAK,Pace,2014-11-17,Dubai (DICS),UAE,2014,2,108,240,1,1,426,1086,12,318,846,11,35.5,>30,UAE,Away,After 1965
Rahat Ali,PAK,Pace,2014-11-26,Sharjah,UAE,2014,1,99,174,4,1,429,804,9,330,630,5,47.666666666666664,>30,UAE,Away,After 1965
Rahat Ali,PAK,Pace,2015-07-03,Pallekele,Sri Lanka,2015,2,156,252,5,1,740,1384,19,584,1132,14,38.94736842105263,>30,SL,Away,After 1965
Rahat Ali,PAK,Pace,2015-10-13,Abu Dhabi,UAE,2015,1,86,168,1,1,582,1249,16,496,1081,15,36.375,>30,UAE,Away,After 1965
Rahat Ali,PAK,Pace,2015-11-01,Sharjah,UAE,2015,2,71,162,3,1,278,841,14,207,679,11,19.857142857142858,<=30,UAE,Away,After 1965
Rahat Ali,PAK,Pace,2016-07-14,Lord's,England,2016,2,115,168,4,1,760,1521,27,645,1353,23,28.14814814814815,<=30,ENG,Away,After 1965
Rahat Ali,PAK,Pace,2016-07-22,Manchester,England,2016,2,155,222,2,1,705,1279,22,550,1057,20,32.04545454545455,>30,ENG,Away,After 1965
Rahat Ali,PAK,Pace,2016-08-03,Birmingham,England,2016,2,137,246,2,1,912,1860,29,775,1614,27,31.448275862068964,>30,ENG,Away,After 1965
Rahat Ali,PAK,Pace,2016-10-21,Abu Dhabi,UAE,2016,2,114,264,4,1,485,1009,16,371,745,12,30.3125,>30,UAE,Away,After 1965
Rahat Ali,PAK,Pace,2016-11-17,Christchurch,New Zealand,2016,2,86,131,4,1,500,1232,31,414,1101,27,16.129032258064516,<=30,NZ,Away,After 1965
Rahat Ali,PAK,Pace,2016-12-15,Brisbane,Australia,2016,2,114,192,2,1,820,1566,28,706,1374,26,29.285714285714285,<=30,AUS,Away,After 1965
Rahat Ali,PAK,Pace,2018-05-11,Dublin (Malahide),Ireland,2018,2,93,180,0,1,792,1625,28,699,1445,28,28.285714285714285,<=30,IRE,Away,After 1965
Rahmat Shah,AFG,Spin,2021-03-10,Abu Dhabi,UAE,2021,1,9,18,0,1,842,1766,20,833,1748,20,42.1,>30,UAE,Away,After 1965
Rahmat Shah,AFG,Spin,2023-06-14,Mirpur,Bangladesh,2023,2,34,48,1,1,497,697,11,463,649,10,45.18181818181818,>30,BAN,Away,After 1965
Rahmat Shah,AFG,Spin,2024-02-02,Colombo (SSC),Sri Lanka,2024,1,10,18,0,1,432,854,10,422,836,10,43.2,>30,SL,Away,After 1965
Rajin Saleh,BAN,Spin,2003-08-20,Karachi,Pakistan,2003,2,21,42,1,1,435,1074,13,414,1032,12,33.46153846153846,>30,PAK,Away,Upto 2014
Rajin Saleh,BAN,Spin,2003-08-27,Peshawar,Pakistan,2003,1,13,42,0,1,404,889,11,391,847,11,36.72727272727273,>30,PAK,Away,Upto 2014
Rajin Saleh,BAN,Spin,2003-10-21,Dhaka,Bangladesh,2003,2,11,24,0,1,443,953,10,432,929,10,44.3,>30,BAN,Home,Upto 2014
Rajin Saleh,BAN,Spin,2003-10-29,Chattogram,Bangladesh,2003,2,16,18,0,1,331,702,7,315,684,7,47.285714285714285,>30,BAN,Home,Upto 2014
Rajin Saleh,BAN,Spin,2004-05-28,Gros Islet,West Indies,2004,1,12,36,0,1,308,824,12,296,788,12,25.666666666666668,<=30,WI,Away,Upto 2014
Rajin Saleh,BAN,Spin,2004-06-04,Kingston,West Indies,2004,1,24,42,0,1,393,750,8,369,708,8,49.125,>30,WI,Away,Upto 2014
Rajin Saleh,BAN,Spin,2004-10-19,Dhaka,Bangladesh,2004,1,4,6,0,1,383,1134,20,379,1128,20,19.15,<=30,BAN,Home,Upto 2014
Rajin Saleh,BAN,Spin,2004-10-26,Chattogram,Bangladesh,2004,1,81,114,1,1,719,1390,23,638,1276,22,31.26086956521739,>30,BAN,Home,Upto 2014
Rajin Saleh,BAN,Spin,2005-01-06,Chattogram,Bangladesh,2005,1,25,24,0,1,450,957,14,425,933,14,32.142857142857146,>30,BAN,Home,Upto 2014
Rajin Saleh,BAN,Spin,2006-04-09,Fatullah,Bangladesh,2006,1,5,6,0,1,739,1451,25,734,1445,25,29.56,<=30,BAN,Home,Upto 2014
Rajin Saleh,BAN,Spin,2006-04-16,Chattogram,Bangladesh,2006,1,32,48,0,1,796,1393,18,764,1345,18,44.22222222222222,>30,BAN,Home,Upto 2014
Rajin Saleh,BAN,Spin,2007-05-18,Chattogram,Bangladesh,2007,1,12,18,0,1,447,726,13,435,708,13,34.38461538461539,>30,BAN,Home,Upto 2014
Rajin Saleh,BAN,Spin,2007-06-25,Colombo (SSC),Sri Lanka,2007,1,12,18,0,1,605,1005,14,593,987,14,43.214285714285715,>30,SL,Away,Upto 2014
Rajinder Pal,IND,Pace,1964-01-21,Brabourne,India,1964,2,22,78,0,1,366,747,11,344,669,11,33.27272727272727,>30,IND,Home,Upto 2014
Ranjan Das,BAN,Pace,2000-11-10,Dhaka,Bangladesh,2000,2,72,132,1,1,382,888,12,310,756,11,31.833333333333332,>30,BAN,Home,Upto 2014
Raqibul Hasan,BAN,Spin,2008-12-26,Mirpur,Bangladesh,2008,1,2,6,0,1,727,1408,21,725,1402,21,34.61904761904762,>30,BAN,Home,Upto 2014
Raqibul Hasan,BAN,Spin,2009-01-03,Chattogram,Bangladesh,2009,1,3,6,0,1,931,1570,27,928,1564,27,34.48148148148148,>30,BAN,Home,Upto 2014
Raqibul Hasan,BAN,Spin,2010-01-24,Mirpur,Bangladesh,2010,1,0,6,1,1,600,1045,11,600,1039,10,54.54545454545455,>30,BAN,Home,Upto 2014
Raqibul Hasan,BAN,Spin,2011-10-29,Mirpur,Bangladesh,2011,1,12,24,0,1,846,1669,23,834,1645,23,36.78260869565217,>30,BAN,Home,Upto 2014
Rashid Khan,AFG,Spin,2018-06-14,Bengaluru,India,2018,1,154,209,2,1,388,572,15,234,363,13,25.866666666666667,<=30,IND,Away,After 1965
Rashid Khan,AFG,Spin,2019-03-15,Dehradun,India,2019,2,102,276,7,1,656,1295,22,554,1019,15,29.818181818181817,<=30,IND,Away,After 1965
Rashid Khan,AFG,Spin,2019-09-05,Chattogram,Bangladesh,2019,2,104,249,11,1,903,1930,38,799,1681,27,23.763157894736842,<=30,BAN,Away,After 1965
Rashid Khan,AFG,Spin,2019-11-27,Lucknow,India,2019,2,125,204,3,1,473,932,25,348,728,22,18.92,<=30,IND,Away,After 1965
Rashid Khan,AFG,Spin,2021-03-10,Abu Dhabi,UAE,2021,2,275,596,11,1,842,1766,20,567,1170,9,42.1,>30,UAE,Away,After 1965
Rashid Khan,AFG,Spin,2025-01-02,Bulawayo,Zimbabwe,2025,2,160,330,11,1,588,1149,23,428,819,12,25.565217391304348,<=30,ZIM,Away,After 1965
Rashid Khan,PAK,Spin,1982-03-05,Karachi,Pakistan,1982,2,78,204,3,1,669,1411,22,591,1207,19,30.40909090909091,>30,PAK,Home,Upto 2014
Rashid Khan,PAK,Spin,1982-03-14,Faisalabad,Pakistan,1982,2,56,84,0,1,699,1740,27,643,1656,27,25.88888888888889,<=30,PAK,Home,Upto 2014
Rashid Khan,PAK,Spin,1983-11-25,Brisbane,Australia,1983,1,129,258,3,1,302,612,4,173,354,1,75.5,>30,AUS,Away,Upto 2014
Rashid Khan,PAK,Spin,1985-02-09,Dunedin,New Zealand,1985,2,97,192,2,1,97,192,2,0,0,0,48.5,>30,NZ,Away,Upto 2014
Rashid Latif,PAK,Spin,1994-10-05,Rawalpindi,Pakistan,1994,1,10,12,0,1,440,796,6,430,784,6,73.33333333333333,>30,PAK,Home,Upto 2014
Rehan Ahmed,ENG,Spin,2022-12-17,Karachi,Pakistan,2022,2,137,221,7,1,895,1264,27,758,1043,20,33.148148148148145,>30,PAK,Away,After 1965
Rehan Ahmed,ENG,Spin,2024-01-25,Hyderabad,India,2024,2,138,180,2,1,1067,1778,32,929,1598,30,33.34375,>30,IND,Away,After 1965
Rehan Ahmed,ENG,Spin,2024-02-02,Visakhapatnam,India,2024,2,153,249,6,1,935,1413,24,782,1164,18,38.958333333333336,>30,IND,Away,After 1965
Rehan Ahmed,ENG,Spin,2024-02-15,Rajkot,India,2024,2,193,282,3,1,805,1288,20,612,1006,17,40.25,>30,IND,Away,After 1965
Rehan Ahmed,ENG,Spin,2024-10-24,Rawalpindi,Pakistan,2024,1,66,106,4,1,719,1161,29,653,1055,25,24.79310344827586,<=30,PAK,Away,After 1965
Riaz Afridi,PAK,Pace,2004-10-28,Karachi,Pakistan,2004,2,87,186,2,1,689,1333,19,602,1147,17,36.26315789473684,>30,PAK,Home,Upto 2014
Rizwan-uz-Zaman,PAK,Spin,1982-03-14,Faisalabad,Pakistan,1982,2,39,102,3,1,699,1740,27,660,1638,24,25.88888888888889,<=30,PAK,Home,Upto 2014
Rizwan-uz-Zaman,PAK,Spin,1987-02-21,Jaipur,India,1987,1,7,30,1,1,591,1283,13,584,1253,12,45.46153846153846,>30,IND,Away,Upto 2014
Robiul Islam,BAN,Pace,2010-05-27,Lord's,England,2010,2,119,138,0,1,777,1274,20,658,1136,20,38.85,>30,ENG,Away,Upto 2014
Robiul Islam,BAN,Pace,2011-08-04,Harare,Zimbabwe,2011,2,154,258,3,1,850,1557,26,696,1299,23,32.69230769230769,>30,ZIM,Away,Upto 2014
Robiul Islam,BAN,Pace,2011-12-17,Mirpur,Bangladesh,2011,2,86,144,1,1,436,810,14,350,666,13,31.142857142857142,>30,BAN,Home,Upto 2014
Robiul Islam,BAN,Pace,2013-03-16,Colombo (RPS),Sri Lanka,2013,2,94,156,4,1,510,982,14,416,826,10,36.42857142857143,>30,SL,Away,Upto 2014
Robiul Islam,BAN,Pace,2013-04-17,Harare,Zimbabwe,2013,2,155,342,9,1,550,1165,26,395,823,17,21.153846153846153,<=30,ZIM,Away,Upto 2014
Robiul Islam,BAN,Pace,2013-04-25,Harare,Zimbabwe,2013,2,138,318,6,1,755,1568,25,617,1250,19,30.2,>30,ZIM,Away,Upto 2014
Robiul Islam,BAN,Pace,2013-10-09,Chattogram,Bangladesh,2013,2,32,102,0,1,333,720,8,301,618,8,41.625,>30,BAN,Home,Upto 2014
Robiul Islam,BAN,Pace,2014-01-27,Mirpur,Bangladesh,2014,1,109,174,0,1,519,875,13,410,701,13,39.92307692307692,>30,BAN,Home,After 1965
Robiul Islam,BAN,Pace,2014-09-13,Gros Islet,West Indies,2014,2,105,228,2,1,563,1240,21,458,1012,19,26.80952380952381,<=30,WI,Away,After 1965
Rubel Hossain,BAN,Pace,2009-07-09,Kingstown,West Indies,2009,2,121,150,3,1,537,1048,20,416,898,17,26.85,<=30,WI,Away,Upto 2014
Rubel Hossain,BAN,Pace,2009-07-17,St George's,West Indies,2009,2,61,90,0,1,424,759,14,363,669,14,30.285714285714285,>30,WI,Away,Upto 2014
Rubel Hossain,BAN,Pace,2010-01-17,Chattogram,Bangladesh,2010,2,134,150,1,1,609,842,14,475,692,13,43.5,>30,BAN,Home,Upto 2014
Rubel Hossain,BAN,Pace,2010-01-24,Mirpur,Bangladesh,2010,1,115,168,0,1,466,741,17,351,573,17,27.41176470588235,<=30,BAN,Home,Upto 2014
Rubel Hossain,BAN,Pace,2010-02-15,Hamilton,New Zealand,2010,2,210,246,5,1,762,1104,17,552,858,12,44.8235294117647,>30,NZ,Away,Upto 2014
Rubel Hossain,BAN,Pace,2010-03-12,Chattogram,Bangladesh,2010,2,125,150,1,1,497,924,10,372,774,9,49.7,>30,BAN,Home,Upto 2014
Rubel Hossain,BAN,Pace,2010-03-20,Mirpur,Bangladesh,2010,2,114,180,1,1,503,828,9,389,648,8,55.888888888888886,>30,BAN,Home,Upto 2014
Rubel Hossain,BAN,Pace,2010-05-27,Lord's,England,2010,2,117,144,1,1,777,1274,20,660,1130,19,38.85,>30,ENG,Away,Upto 2014
Rubel Hossain,BAN,Pace,2011-08-04,Harare,Zimbabwe,2011,2,159,276,4,1,850,1557,26,691,1281,22,32.69230769230769,>30,ZIM,Away,Upto 2014
Rubel Hossain,BAN,Pace,2011-10-21,Chattogram,Bangladesh,2011,2,55,102,0,1,310,664,6,255,562,6,51.666666666666664,>30,BAN,Home,Upto 2014
Rubel Hossain,BAN,Pace,2011-10-29,Mirpur,Bangladesh,2011,2,107,216,1,1,378,650,10,271,434,9,37.8,>30,BAN,Home,Upto 2014
Rubel Hossain,BAN,Pace,2011-12-09,Chattogram,Bangladesh,2011,1,97,150,0,1,250,417,6,153,267,6,41.666666666666664,>30,BAN,Home,Upto 2014
Rubel Hossain,BAN,Pace,2012-11-13,Mirpur,Bangladesh,2012,2,142,222,2,1,489,849,15,347,627,13,32.6,>30,BAN,Home,Upto 2014
Rubel Hossain,BAN,Pace,2012-11-21,Khulna,Bangladesh,2012,2,100,198,2,1,562,872,18,462,674,16,31.22222222222222,>30,BAN,Home,Upto 2014
Rubel Hossain,BAN,Pace,2013-03-16,Colombo (RPS),Sri Lanka,2013,2,61,120,2,1,510,982,14,449,862,12,36.42857142857143,>30,SL,Away,Upto 2014
Rubel Hossain,BAN,Pace,2013-04-17,Harare,Zimbabwe,2013,2,131,240,2,1,550,1165,26,419,925,24,21.153846153846153,<=30,ZIM,Away,Upto 2014
Rubel Hossain,BAN,Pace,2013-10-09,Chattogram,Bangladesh,2013,2,98,156,1,1,333,720,8,235,564,7,41.625,>30,BAN,Home,Upto 2014
Rubel Hossain,BAN,Pace,2013-10-21,Mirpur,Bangladesh,2013,1,81,108,0,1,508,858,10,427,750,10,50.8,>30,BAN,Home,Upto 2014
Rubel Hossain,BAN,Pace,2014-01-27,Mirpur,Bangladesh,2014,1,84,120,0,1,519,875,13,435,755,13,39.92307692307692,>30,BAN,Home,After 1965
Rubel Hossain,BAN,Pace,2014-09-05,Kingstown,West Indies,2014,1,110,180,1,1,442,907,11,332,727,10,40.18181818181818,>30,WI,Away,After 1965
Rubel Hossain,BAN,Pace,2014-11-03,Khulna,Bangladesh,2014,2,63,156,2,1,338,810,9,275,654,7,37.55555555555556,>30,BAN,Home,After 1965
Rubel Hossain,BAN,Pace,2014-11-12,Chattogram,Bangladesh,2014,2,62,78,3,1,456,862,15,394,784,12,30.4,>30,BAN,Home,After 1965
Rubel Hossain,BAN,Pace,2015-04-28,Khulna,Bangladesh,2015,1,82,132,0,1,401,750,6,319,618,6,66.83333333333333,>30,BAN,Home,After 1965
Rubel Hossain,BAN,Pace,2017-01-20,Christchurch,New Zealand,2017,1,65,102,0,1,735,1238,24,670,1136,24,30.625,>30,NZ,Away,After 1965
Rubel Hossain,BAN,Pace,2017-10-06,Bloemfontein,South Africa,2017,1,113,132,1,1,638,933,23,525,801,22,27.73913043478261,<=30,SA,Away,After 1965
Rubel Hossain,BAN,Pace,2018-07-04,North Sound,West Indies,2018,1,44,102,0,1,363,699,24,319,597,24,15.125,<=30,WI,Away,After 1965
Rubel Hossain,BAN,Pace,2020-02-07,Rawalpindi,Pakistan,2020,1,113,155,3,1,527,1060,20,414,905,17,26.35,<=30,PAK,Away,After 1965
S Abid Ali,IND,Pace,1967-12-23,Adelaide,Australia,1967,2,116,264,7,1,596,1119,26,480,855,19,22.923076923076923,<=30,AUS,Away,Upto 2014
S Abid Ali,IND,Pace,1967-12-30,Melbourne,Australia,1967,1,106,160,0,1,704,1270,18,598,1110,18,39.111111111111114,>30,AUS,Away,Upto 2014
S Abid Ali,IND,Pace,1968-01-19,Brisbane,Australia,1968,2,15,24,0,1,552,1226,17,537,1202,17,32.470588235294116,>30,AUS,Away,Upto 2014
S Abid Ali,IND,Pace,1968-01-26,Sydney,Australia,1968,2,65,136,1,1,498,913,9,433,777,8,55.333333333333336,>30,AUS,Away,Upto 2014
S Abid Ali,IND,Pace,1968-02-15,Dunedin,New Zealand,1968,2,48,204,4,1,426,1000,14,378,796,10,30.428571428571427,>30,NZ,Away,Upto 2014
S Abid Ali,IND,Pace,1968-02-22,Christchurch,New Zealand,1968,2,53,126,2,1,471,977,17,418,851,15,27.705882352941178,<=30,NZ,Away,Upto 2014
S Abid Ali,IND,Pace,1968-02-29,Wellington,New Zealand,1968,1,31,48,0,1,330,661,9,299,613,9,36.666666666666664,>30,NZ,Away,Upto 2014
S Abid Ali,IND,Pace,1969-09-25,Brabourne,India,1969,2,24,78,1,1,336,982,18,312,904,17,18.666666666666668,<=30,IND,Home,Upto 2014
S Abid Ali,IND,Pace,1969-10-03,Nagpur,India,1969,2,38,126,2,1,171,432,3,133,306,1,57.0,>30,IND,Home,Upto 2014
S Abid Ali,IND,Pace,1969-10-15,Hyderabad (Deccan),India,1969,2,64,235,4,1,198,715,20,134,480,16,9.9,<=30,IND,Home,Upto 2014
S Abid Ali,IND,Pace,1969-11-04,Brabourne,India,1969,2,66,126,0,1,298,821,12,232,695,12,24.833333333333332,<=30,IND,Home,Upto 2014
S Abid Ali,IND,Pace,1971-02-18,Kingston,West Indies,1971,2,41,84,0,1,178,430,6,137,346,6,29.666666666666668,<=30,WI,Away,Upto 2014
S Abid Ali,IND,Pace,1971-03-06,Port of Spain,West Indies,1971,2,57,150,2,1,181,456,3,124,306,1,60.333333333333336,>30,WI,Away,Upto 2014
S Abid Ali,IND,Pace,1971-03-19,Georgetown,West Indies,1971,2,97,164,0,1,313,504,3,216,340,3,104.33333333333333,>30,WI,Away,Upto 2014
S Abid Ali,IND,Pace,1971-04-01,Bridgetown,West Indies,1971,2,197,312,5,1,478,1042,14,281,730,9,34.142857142857146,>30,WI,Away,Upto 2014
S Abid Ali,IND,Pace,1971-04-13,Port of Spain,West Indies,1971,2,131,276,4,1,448,1056,11,317,780,7,40.72727272727273,>30,WI,Away,Upto 2014
S Abid Ali,IND,Pace,1971-07-22,Lord's,England,1971,2,58,144,1,1,287,804,9,229,660,8,31.88888888888889,>30,ENG,Away,Upto 2014
S Abid Ali,IND,Pace,1971-08-05,Manchester,England,1971,2,159,352,4,1,409,1030,17,250,678,13,24.058823529411764,<=30,ENG,Away,Upto 2014
S Abid Ali,IND,Pace,1971-08-19,The Oval,England,1971,2,52,90,0,1,247,588,5,195,498,5,49.4,>30,ENG,Away,Upto 2014
S Abid Ali,IND,Pace,1972-12-20,Delhi,India,1972,2,19,78,0,1,207,536,11,188,458,11,18.818181818181817,<=30,IND,Home,Upto 2014
S Abid Ali,IND,Pace,1972-12-30,Eden Gardens,India,1972,2,16,72,1,1,194,522,10,178,450,9,19.4,<=30,IND,Home,Upto 2014
S Abid Ali,IND,Pace,1973-01-25,Kanpur,India,1973,1,55,132,1,1,253,624,7,198,492,6,36.142857142857146,>30,IND,Home,Upto 2014
S Abid Ali,IND,Pace,1973-02-06,Brabourne,India,1973,1,60,90,1,1,226,386,7,166,296,6,32.285714285714285,>30,IND,Home,Upto 2014
S Abid Ali,IND,Pace,1974-06-06,Manchester,England,1974,2,110,249,4,1,464,1137,20,354,888,16,23.2,<=30,ENG,Away,Upto 2014
S Abid Ali,IND,Pace,1974-06-20,Lord's,England,1974,1,79,132,2,1,408,797,19,329,665,17,21.473684210526315,<=30,ENG,Away,Upto 2014
S Abid Ali,IND,Pace,1974-07-04,Birmingham,England,1974,1,63,108,0,1,333,648,16,270,540,16,20.8125,<=30,ENG,Away,Upto 2014
S Abid Ali,IND,Pace,1974-11-22,Bengaluru,India,1974,2,113,162,1,1,351,694,15,238,532,14,23.4,<=30,IND,Home,Upto 2014
S Abid Ali,IND,Pace,1974-12-11,Delhi,India,1974,1,47,42,0,1,263,477,8,216,435,8,32.875,>30,IND,Home,Upto 2014
S Amarnath,IND,Pace,1978-10-16,Faisalabad,Pakistan,1978,1,5,11,1,1,508,904,5,503,893,4,101.6,>30,PAK,Away,Upto 2014
S Chanderpaul,WI,Spin,1994-03-17,Georgetown,West Indies,1994,1,49,96,0,1,318,558,4,269,462,4,79.5,>30,WI,Home,Upto 2014
S Chanderpaul,WI,Spin,1994-03-25,Port of Spain,West Indies,1994,1,13,30,0,1,162,288,3,149,258,3,54.0,>30,WI,Home,Upto 2014
S Chanderpaul,WI,Spin,1994-04-08,Bridgetown,West Indies,1994,2,53,120,0,1,263,593,6,210,473,6,43.833333333333336,>30,WI,Home,Upto 2014
S Chanderpaul,WI,Spin,1994-04-16,St John's,West Indies,1994,1,94,144,1,1,364,732,3,270,588,2,121.33333333333333,>30,WI,Home,Upto 2014
S Chanderpaul,WI,Spin,1994-12-01,Nagpur,India,1994,1,63,120,1,1,761,1735,22,698,1615,21,34.59090909090909,>30,IND,Away,Upto 2014
S Chanderpaul,WI,Spin,1995-02-03,Christchurch,New Zealand,1995,2,10,30,0,1,170,372,2,160,342,2,85.0,>30,NZ,Away,Upto 2014
S Chanderpaul,WI,Spin,1995-08-24,The Oval,England,1995,1,22,36,0,1,255,528,1,233,492,1,255.0,>30,ENG,Away,Upto 2014
S Chanderpaul,WI,Spin,1996-04-19,Bridgetown,West Indies,1996,2,18,30,0,1,67,120,5,49,90,5,13.4,<=30,WI,Home,Upto 2014
S Chanderpaul,WI,Spin,1996-04-27,St John's,West Indies,1996,1,10,12,0,1,371,702,4,361,690,4,92.75,>30,WI,Home,Upto 2014
S Chanderpaul,WI,Spin,1997-01-25,Adelaide,Australia,1997,1,2,18,1,1,334,663,19,332,645,18,17.57894736842105,<=30,AUS,Away,Upto 2014
S Chanderpaul,WI,Spin,1997-03-06,Kingston,West Indies,1997,2,40,102,0,1,464,982,9,424,880,9,51.55555555555556,>30,WI,Home,Upto 2014
S Chanderpaul,WI,Spin,1997-03-14,Port of Spain,West Indies,1997,1,20,48,0,1,443,1095,13,423,1047,13,34.07692307692308,>30,WI,Home,Upto 2014
S Chanderpaul,WI,Spin,1997-04-04,St John's,West Indies,1997,1,40,66,0,1,268,532,5,228,466,5,53.6,>30,WI,Home,Upto 2014
S Chanderpaul,WI,Spin,1997-04-17,Georgetown,West Indies,1997,1,56,174,1,1,131,336,6,75,162,5,21.833333333333332,<=30,WI,Home,Upto 2014
S Chanderpaul,WI,Spin,1997-12-06,Karachi,Pakistan,1997,1,34,42,1,1,300,618,11,266,576,10,27.272727272727273,<=30,PAK,Away,Upto 2014
S Chanderpaul,WI,Spin,1998-02-05,Port of Spain,West Indies,1998,1,2,6,0,1,159,524,3,157,518,3,53.0,>30,WI,Home,Upto 2014
S Chanderpaul,WI,Spin,1998-03-12,Bridgetown,West Indies,1998,2,33,54,0,1,286,824,8,253,770,8,35.75,>30,WI,Home,Upto 2014
S Chanderpaul,WI,Spin,1999-01-02,Cape Town,South Africa,1999,2,56,108,0,1,319,696,6,263,588,6,53.166666666666664,>30,SA,Away,Upto 2014
S Chanderpaul,WI,Spin,1999-01-15,Centurion,South Africa,1999,2,39,78,0,1,279,568,9,240,490,9,31.0,>30,SA,Away,Upto 2014
S Chanderpaul,WI,Spin,1999-12-26,Wellington,New Zealand,1999,1,15,36,1,1,335,762,4,320,726,3,83.75,>30,NZ,Away,Upto 2014
S Chanderpaul,WI,Spin,2000-03-24,Kingston,West Indies,2000,1,12,12,0,1,234,532,3,222,520,3,78.0,>30,WI,Home,Upto 2014
S Chanderpaul,WI,Spin,2000-05-18,Bridgetown,West Indies,2000,2,16,24,0,1,391,966,10,375,942,10,39.1,>30,WI,Home,Upto 2014
S Chanderpaul,WI,Spin,2002-06-28,St George's,West Indies,2002,2,12,36,1,1,457,1176,9,445,1140,8,50.77777777777778,>30,WI,Home,Upto 2014
S Chanderpaul,WI,Spin,2002-10-30,Eden Gardens,India,2002,1,9,18,1,1,592,1269,12,583,1251,11,49.333333333333336,>30,IND,Away,Upto 2014
S Chanderpaul,WI,Spin,2003-11-04,Harare,Zimbabwe,2003,1,7,6,0,1,313,784,11,306,778,11,28.454545454545453,<=30,ZIM,Away,Upto 2014
S Chanderpaul,WI,Spin,2004-05-28,Gros Islet,West Indies,2004,1,0,6,0,1,308,824,12,308,818,12,25.666666666666668,<=30,WI,Home,Upto 2014
S Chanderpaul,WI,Spin,2005-03-31,Georgetown,West Indies,2005,1,25,78,0,1,281,750,4,256,672,4,70.25,>30,WI,Home,Upto 2014
S Chanderpaul,WI,Spin,2005-04-08,Port of Spain,West Indies,2005,1,6,12,0,1,187,617,7,181,605,7,26.714285714285715,<=30,WI,Home,Upto 2014
S Chanderpaul,WI,Spin,2005-07-22,Kandy,Sri Lanka,2005,1,13,18,0,1,292,585,15,279,567,15,19.466666666666665,<=30,SL,Away,Upto 2014
S Chanderpaul,WI,Spin,2006-06-30,Kingston,West Indies,2006,1,17,30,0,1,275,517,14,258,487,14,19.642857142857142,<=30,WI,Home,Upto 2014
S Chanderpaul,WI,Spin,2006-11-19,Multan,Pakistan,2006,1,9,12,0,1,610,1072,9,601,1060,9,67.77777777777777,>30,PAK,Away,Upto 2014
S Chanderpaul,WI,Spin,2006-11-27,Karachi,Pakistan,2006,1,7,12,0,1,303,725,10,296,713,10,30.3,>30,PAK,Away,Upto 2014
S Chanderpaul,WI,Spin,2007-06-07,Manchester,England,2007,1,43,66,0,1,304,603,11,261,537,11,27.636363636363637,<=30,ENG,Away,Upto 2014
S Chanderpaul,WI,Spin,2011-07-06,Roseau,West Indies,2011,1,38,60,1,1,478,1095,12,440,1035,11,39.833333333333336,>30,WI,Home,Upto 2014
S Christopherson,ENG,Pace,1884-07-21,Lord's,England,1884,2,69,136,1,1,404,842,13,335,706,12,31.076923076923077,>30,ENG,Home,After 1965
S Dhawan,IND,Spin,2014-02-14,Wellington,New Zealand,2014,1,3,6,0,1,170,396,1,167,390,1,170.0,>30,NZ,Away,After 1965
S Dhawan,IND,Spin,2014-07-17,Lord's,England,2014,1,2,12,0,1,190,511,7,188,499,7,27.142857142857142,<=30,ENG,Away,After 1965
S Dhawan,IND,Spin,2014-07-27,Southampton,England,2014,1,4,12,0,1,407,690,15,403,678,15,27.133333333333333,<=30,ENG,Away,After 1965
S Dhawan,IND,Spin,2015-06-10,Fatullah,Bangladesh,2015,1,0,6,0,1,528,806,14,528,800,14,37.714285714285715,>30,BAN,Away,After 1965
S Dhawan,IND,Spin,2015-12-03,Delhi,India,2015,1,9,18,0,1,551,1517,20,542,1499,20,27.55,<=30,IND,Home,After 1965
S Elworthy,SA,Pace,1998-07-23,Nottingham,England,1998,2,79,186,1,1,995,2152,32,916,1966,31,31.09375,>30,ENG,Away,Upto 2014
S Elworthy,SA,Pace,1999-03-18,Wellington,New Zealand,1999,2,159,330,8,1,742,1762,20,583,1432,12,37.1,>30,NZ,Away,Upto 2014
S Elworthy,SA,Pace,2002-11-08,Johannesburg,South Africa,2002,2,81,153,3,1,582,1139,26,501,986,23,22.384615384615383,<=30,SA,Home,Upto 2014
S Elworthy,SA,Pace,2002-11-15,Centurion,South Africa,2002,2,125,198,1,1,905,1840,32,780,1642,31,28.28125,<=30,SA,Home,Upto 2014
S Guha,IND,Pace,1967-06-08,Leeds,England,1967,2,115,288,0,1,436,1074,7,321,786,7,62.285714285714285,>30,ENG,Away,Upto 2014
S Guha,IND,Pace,1969-11-15,Kanpur,India,1969,2,62,158,2,1,379,992,12,317,834,10,31.583333333333332,>30,IND,Home,Upto 2014
S Guha,IND,Pace,1969-11-28,Delhi,India,1969,2,54,96,1,1,173,466,3,119,370,2,57.666666666666664,>30,IND,Home,Upto 2014
S Guha,IND,Pace,1969-12-12,Eden Gardens,India,1969,2,80,132,0,1,336,899,15,256,767,15,22.4,<=30,IND,Home,Upto 2014
S Haigh,ENG,Pace,1899-02-14,Johannesburg,South Africa,1899,2,121,210,5,1,218,395,7,97,185,2,31.142857142857142,>30,SA,Away,After 1965
S Haigh,ENG,Pace,1899-04-01,Cape Town,South Africa,1899,2,99,194,9,1,255,526,19,156,332,10,13.421052631578947,<=30,SA,Away,After 1965
S Haigh,ENG,Pace,1905-06-15,Lord's,England,1905,1,40,72,2,1,344,822,16,304,750,14,21.5,<=30,ENG,Home,Upto 2014
S Haigh,ENG,Pace,1905-07-03,Leeds,England,1905,2,55,150,2,1,525,1232,17,470,1082,15,30.88235294117647,>30,ENG,Home,Upto 2014
S Haigh,ENG,Pace,1906-01-02,Johannesburg,South Africa,1906,1,9,6,0,1,225,553,14,216,547,14,16.071428571428573,<=30,SA,Away,Upto 2014
S Haigh,ENG,Pace,1906-03-06,Johannesburg,South Africa,1906,1,64,116,4,1,275,764,15,211,648,11,18.333333333333332,<=30,SA,Away,Upto 2014
S Haigh,ENG,Pace,1906-03-10,Johannesburg,South Africa,1906,2,122,234,1,1,542,1143,25,420,909,24,21.68,<=30,SA,Away,Upto 2014
S Haigh,ENG,Pace,1906-03-24,Cape Town,South Africa,1906,2,50,126,1,1,316,931,16,266,805,15,19.75,<=30,SA,Away,Upto 2014
S Haigh,ENG,Pace,1906-03-30,Cape Town,South Africa,1906,1,18,36,0,1,242,576,14,224,540,14,17.285714285714285,<=30,SA,Away,Upto 2014
S Haigh,ENG,Pace,1909-06-14,Lord's,England,1909,1,41,114,0,1,465,1001,12,424,887,12,38.75,>30,ENG,Home,Upto 2014
S Haigh,ENG,Pace,1912-07-29,Manchester,England,1912,1,3,36,0,1,68,240,4,65,204,4,17.0,<=30,ENG,Home,Upto 2014
S Jeganathan,SL,Spin,1983-03-04,Christchurch,New Zealand,1983,1,12,30,0,1,53,167,1,41,137,1,53.0,>30,NZ,Away,Upto 2014
S Joseph,WI,Pace,2024-01-17,Adelaide,Australia,2024,2,101,130,5,1,512,947,27,411,817,22,18.962962962962962,<=30,AUS,Away,After 1965
S Joseph,WI,Pace,2024-01-25,Brisbane,Australia,2024,2,124,137,8,1,777,1334,30,653,1197,22,25.9,<=30,AUS,Away,After 1965
S Joseph,WI,Pace,2024-07-10,Lord's,England,2024,1,68,94,0,1,552,962,27,484,868,27,20.444444444444443,<=30,ENG,Away,After 1965
S Joseph,WI,Pace,2024-07-18,Nottingham,England,2024,2,119,183,2,1,1038,1453,27,919,1270,25,38.44444444444444,>30,ENG,Away,After 1965
S Joseph,WI,Pace,2024-07-26,Birmingham,England,2024,2,72,84,2,1,712,994,27,640,910,25,26.37037037037037,<=30,ENG,Away,After 1965
S Joseph,WI,Pace,2024-08-15,Providence,West Indies,2024,2,86,192,5,1,482,1012,28,396,820,23,17.214285714285715,<=30,WI,Home,After 1965
S Joseph,WI,Pace,2024-11-22,North Sound,West Indies,2024,2,77,138,2,1,670,1327,30,593,1189,28,22.333333333333332,<=30,WI,Home,After 1965
S Joseph,WI,Pace,2024-11-30,Kingston,West Indies,2024,2,129,162,5,1,598,1162,33,469,1000,28,18.12121212121212,<=30,WI,Home,After 1965
S Madan Lal,IND,Pace,1974-06-06,Manchester,England,1974,2,95,258,2,1,464,1137,20,369,879,18,23.2,<=30,ENG,Away,Upto 2014
S Madan Lal,IND,Pace,1974-06-20,Lord's,England,1974,1,93,180,0,1,408,797,19,315,617,19,21.473684210526315,<=30,ENG,Away,Upto 2014
S Madan Lal,IND,Pace,1974-12-27,Eden Gardens,India,1974,2,45,133,5,1,424,954,21,379,821,16,20.19047619047619,<=30,IND,Home,Upto 2014
S Madan Lal,IND,Pace,1975-01-11,Chennai,India,1975,2,12,24,0,1,381,795,19,369,771,19,20.05263157894737,<=30,IND,Home,Upto 2014
S Madan Lal,IND,Pace,1976-01-24,Auckland,New Zealand,1976,2,14,72,0,1,264,671,8,250,599,8,33.0,>30,NZ,Away,Upto 2014
S Madan Lal,IND,Pace,1976-02-05,Christchurch,New Zealand,1976,1,134,344,5,1,616,1431,23,482,1087,18,26.782608695652176,<=30,NZ,Away,Upto 2014
S Madan Lal,IND,Pace,1976-02-13,Wellington,New Zealand,1976,1,116,304,3,1,457,1252,22,341,948,19,20.772727272727273,<=30,NZ,Away,Upto 2014
S Madan Lal,IND,Pace,1976-03-10,Bridgetown,West Indies,1976,1,61,96,0,1,313,600,12,252,504,12,26.083333333333332,<=30,WI,Away,Upto 2014
S Madan Lal,IND,Pace,1976-03-24,Port of Spain,West Indies,1976,2,18,78,1,1,260,654,5,242,576,4,52.0,>30,WI,Away,Upto 2014
S Madan Lal,IND,Pace,1976-04-07,Port of Spain,West Indies,1976,2,36,102,0,1,338,682,7,302,580,7,48.285714285714285,>30,WI,Away,Upto 2014
S Madan Lal,IND,Pace,1976-04-21,Kingston,West Indies,1976,2,30,48,0,1,382,807,9,352,759,9,42.44444444444444,>30,WI,Away,Upto 2014
S Madan Lal,IND,Pace,1976-11-10,Wankhede,India,1976,2,40,90,1,1,455,894,10,415,804,9,45.5,>30,IND,Home,Upto 2014
S Madan Lal,IND,Pace,1977-01-01,Eden Gardens,India,1977,2,28,108,1,1,233,654,15,205,546,14,15.533333333333333,<=30,IND,Home,Upto 2014
S Madan Lal,IND,Pace,1977-01-14,Chennai,India,1977,2,58,180,2,1,275,772,15,217,592,13,18.333333333333332,<=30,IND,Home,Upto 2014
S Madan Lal,IND,Pace,1977-12-02,Brisbane,Australia,1977,2,99,232,6,1,540,1279,27,441,1047,21,20.0,<=30,AUS,Away,Upto 2014
S Madan Lal,IND,Pace,1977-12-16,W.A.C.A,Australia,1977,2,98,208,3,1,682,1283,21,584,1075,18,32.476190476190474,>30,AUS,Away,Upto 2014
S Madan Lal,IND,Pace,1981-11-27,Wankhede,India,1981,2,47,144,6,1,460,1013,28,413,869,22,16.428571428571427,<=30,IND,Home,Upto 2014
S Madan Lal,IND,Pace,1981-12-09,Bengaluru,India,1981,2,60,168,1,1,557,1122,12,497,954,11,46.416666666666664,>30,IND,Home,Upto 2014
S Madan Lal,IND,Pace,1981-12-23,Delhi,India,1981,2,89,210,5,1,608,1217,15,519,1007,10,40.53333333333333,>30,IND,Home,Upto 2014
S Madan Lal,IND,Pace,1982-01-01,Eden Gardens,India,1982,2,116,234,2,1,453,960,12,337,726,10,37.75,>30,IND,Home,Upto 2014
S Madan Lal,IND,Pace,1982-01-13,Chennai,India,1982,1,41,54,0,1,631,1176,8,590,1122,8,78.875,>30,IND,Home,Upto 2014
S Madan Lal,IND,Pace,1982-01-30,Kanpur,India,1982,1,79,144,0,1,435,720,7,356,576,7,62.142857142857146,>30,IND,Home,Upto 2014
S Madan Lal,IND,Pace,1982-06-10,Lord's,England,1982,2,101,181,3,1,701,1384,31,600,1203,28,22.612903225806452,<=30,ENG,Away,Upto 2014
S Madan Lal,IND,Pace,1982-06-24,Manchester,England,1982,1,104,210,3,1,426,732,7,322,522,4,60.857142857142854,>30,ENG,Away,Upto 2014
S Madan Lal,IND,Pace,1982-07-08,The Oval,England,1982,2,86,222,0,1,668,1272,12,582,1050,12,55.666666666666664,>30,ENG,Away,Upto 2014
S Madan Lal,IND,Pace,1982-09-17,Chennai,India,1982,2,115,138,2,1,686,896,18,571,758,16,38.111111111111114,>30,IND,Home,Upto 2014
S Madan Lal,IND,Pace,1982-12-10,Lahore,Pakistan,1982,2,111,192,3,1,700,1379,14,589,1187,11,50.0,>30,PAK,Away,Upto 2014
S Madan Lal,IND,Pace,1982-12-23,Karachi,Pakistan,1982,1,129,138,3,1,510,865,22,381,727,19,23.181818181818183,<=30,PAK,Away,Upto 2014
S Madan Lal,IND,Pace,1983-01-03,Faisalabad,Pakistan,1983,1,109,168,2,1,934,1450,28,825,1282,26,33.357142857142854,>30,PAK,Away,Upto 2014
S Madan Lal,IND,Pace,1983-04-15,Bridgetown,West Indies,1983,1,96,162,2,1,618,1146,24,522,984,22,25.75,<=30,WI,Away,Upto 2014
S Madan Lal,IND,Pace,1983-04-28,St John's,West Indies,1983,1,105,210,3,1,719,1355,18,614,1145,15,39.94444444444444,>30,WI,Away,Upto 2014
S Madan Lal,IND,Pace,1983-09-14,Bengaluru,India,1983,1,72,144,3,1,497,1170,18,425,1026,15,27.61111111111111,<=30,IND,Home,Upto 2014
S Madan Lal,IND,Pace,1983-09-24,Jalandhar,India,1983,2,62,126,0,1,450,936,11,388,810,11,40.90909090909091,>30,IND,Home,Upto 2014
S Madan Lal,IND,Pace,1983-10-05,Nagpur,India,1983,1,44,78,0,1,439,897,10,395,819,10,43.9,>30,IND,Home,Upto 2014
S Madan Lal,IND,Pace,1983-10-21,Kanpur,India,1983,1,50,102,0,1,584,1065,26,534,963,26,22.46153846153846,<=30,IND,Home,Upto 2014
S Madan Lal,IND,Pace,1983-10-29,Delhi,India,1983,2,74,132,0,1,784,1399,23,710,1267,23,34.08695652173913,>30,IND,Home,Upto 2014
S Madan Lal,IND,Pace,1983-11-24,Wankhede,India,1983,2,37,96,0,1,698,1403,16,661,1307,16,43.625,>30,IND,Home,Upto 2014
S Madan Lal,IND,Pace,1984-10-24,Faisalabad,Pakistan,1984,1,94,162,1,1,679,1180,8,585,1018,7,84.875,>30,PAK,Away,Upto 2014
S Madan Lal,IND,Pace,1986-06-19,Leeds,England,1986,2,48,125,3,1,608,1416,31,560,1291,28,19.612903225806452,<=30,ENG,Away,Upto 2014
S Mahmood,ENG,Pace,2022-03-16,Bridgetown,West Indies,2022,2,79,210,4,1,744,1535,17,665,1325,13,43.76470588235294,>30,WI,Away,After 1965
S Mahmood,ENG,Pace,2022-03-24,St George's,West Indies,2022,2,58,156,2,1,518,1435,27,460,1279,25,19.185185185185187,<=30,WI,Away,After 1965
S Matsikenyeri,ZIM,Spin,2003-11-04,Harare,Zimbabwe,2003,2,16,24,0,1,313,784,11,297,760,11,28.454545454545453,<=30,ZIM,Home,Upto 2014
S Matsikenyeri,ZIM,Spin,2004-05-06,Harare,Zimbabwe,2004,1,58,90,1,1,203,375,10,145,285,9,20.3,<=30,ZIM,Home,Upto 2014
S Matsikenyeri,ZIM,Spin,2004-05-14,Bulawayo,Zimbabwe,2004,1,112,141,0,1,302,532,8,190,391,8,37.75,>30,ZIM,Home,Upto 2014
S Matsikenyeri,ZIM,Spin,2005-01-06,Chattogram,Bangladesh,2005,2,112,174,1,1,450,957,14,338,783,13,32.142857142857146,>30,BAN,Away,Upto 2014
S Matsikenyeri,ZIM,Spin,2005-01-14,Dhaka,Bangladesh,2005,1,41,48,0,1,497,1234,18,456,1186,18,27.61111111111111,<=30,BAN,Away,Upto 2014
S Matsikenyeri,ZIM,Spin,2005-03-04,Cape Town,South Africa,2005,1,6,6,0,1,206,230,7,200,224,7,29.428571428571427,<=30,SA,Away,Upto 2014
S Morris,AUS,Pace,1885-01-01,Melbourne,Australia,1885,1,73,136,2,1,410,1218,21,337,1082,19,19.523809523809526,<=30,AUS,Home,After 1965
S Mushtaq Ali,IND,Spin,1934-01-05,Eden Gardens,India,1934,1,45,114,1,1,342,922,15,297,808,14,22.8,<=30,IND,Home,Upto 2014
S Mushtaq Ali,IND,Spin,1934-02-10,Chennai,India,1934,2,80,174,1,1,484,943,18,404,769,17,26.88888888888889,<=30,IND,Home,Upto 2014
S Mushtaq Ali,IND,Spin,1936-07-25,Manchester,England,1936,1,64,78,1,1,479,775,14,415,697,13,34.214285714285715,>30,ENG,Away,Upto 2014
S Mushtaq Ali,IND,Spin,1936-08-15,The Oval,England,1936,1,13,12,0,1,349,695,12,336,683,12,29.083333333333332,<=30,ENG,Away,Upto 2014
S Muthusamy,SA,Spin,2019-10-02,Visakhapatnam,India,2019,2,83,108,1,1,1062,1652,22,979,1544,21,48.27272727272727,>30,IND,Away,After 1965
S Muthusamy,SA,Spin,2019-10-10,Pune,India,2019,1,97,117,1,1,587,1113,12,490,996,11,48.916666666666664,>30,IND,Away,After 1965
S Muthusamy,SA,Spin,2023-02-28,Centurion,South Africa,2023,1,10,48,0,1,47,138,0,37,90,0,inf,>30,SA,Home,After 1965
S Muthusamy,SA,Spin,2024-10-29,Chattogram,Bangladesh,2024,2,55,96,5,1,583,920,17,528,824,12,34.294117647058826,>30,BAN,Away,After 1965
S Nadeem,IND,Spin,2019-10-19,Ranchi,India,2019,2,40,104,4,1,405,692,13,365,588,9,31.153846153846153,>30,IND,Home,After 1965
S Nadeem,IND,Spin,2021-02-05,Chennai,India,2021,2,233,354,4,1,867,1480,24,634,1126,20,36.125,>30,IND,Home,After 1965
S Nazir Ali,IND,Pace,1934-02-10,Chennai,India,1934,1,83,138,4,1,459,1077,17,376,939,13,27.0,<=30,IND,Home,Upto 2014
S Nyalchand,IND,Pace,1952-10-23,Lucknow,India,1952,1,97,384,3,1,415,1291,25,318,907,22,16.6,<=30,IND,Home,Upto 2014
S Prasanna,SL,Spin,2011-09-08,Pallekele,Sri Lanka,2011,1,80,138,0,1,335,684,6,255,546,6,55.833333333333336,>30,SL,Home,Upto 2014
S Ramadhin,WI,Spin,1950-06-08,Manchester,England,1950,2,167,489,4,1,787,2271,35,620,1782,31,22.485714285714284,<=30,ENG,Away,Upto 2014
S Ramadhin,WI,Spin,1950-06-24,Lord's,England,1950,2,152,690,11,1,844,2771,30,692,2081,19,28.133333333333333,<=30,ENG,Away,Upto 2014
S Ramadhin,WI,Spin,1950-07-20,Nottingham,England,1950,2,184,662,7,1,728,2103,19,544,1441,12,38.31578947368421,>30,ENG,Away,Upto 2014
S Ramadhin,WI,Spin,1950-08-12,The Oval,England,1950,2,101,426,4,1,654,1981,25,553,1555,21,26.16,<=30,ENG,Away,Upto 2014
S Ramadhin,WI,Spin,1951-11-09,Brisbane,Australia,1951,2,165,512,6,1,714,1815,27,549,1303,21,26.444444444444443,<=30,AUS,Away,Upto 2014
S Ramadhin,WI,Spin,1951-11-30,Sydney,Australia,1951,2,196,427,1,1,842,1964,19,646,1537,18,44.31578947368421,>30,AUS,Away,Upto 2014
S Ramadhin,WI,Spin,1951-12-22,Adelaide,Australia,1951,1,76,200,1,1,501,1145,26,425,945,25,19.26923076923077,<=30,AUS,Away,Upto 2014
S Ramadhin,WI,Spin,1951-12-31,Melbourne,Australia,1951,2,156,448,5,1,557,1523,18,401,1075,13,30.944444444444443,>30,AUS,Away,Upto 2014
S Ramadhin,WI,Spin,1952-01-25,Sydney,Australia,1952,1,102,272,1,1,474,1237,15,372,965,14,31.6,>30,AUS,Away,Upto 2014
S Ramadhin,WI,Spin,1952-02-08,Christchurch,New Zealand,1952,2,125,450,9,1,593,1754,25,468,1304,16,23.72,<=30,NZ,Away,Upto 2014
S Ramadhin,WI,Spin,1952-02-15,Auckland,New Zealand,1952,1,41,150,3,1,442,1192,12,401,1042,9,36.833333333333336,>30,NZ,Away,Upto 2014
S Ramadhin,WI,Spin,1953-01-21,Port of Spain,West Indies,1953,2,165,371,4,1,842,2177,19,677,1806,15,44.31578947368421,>30,WI,Home,Upto 2014
S Ramadhin,WI,Spin,1953-02-07,Bridgetown,West Indies,1953,2,85,329,7,1,692,2028,31,607,1699,24,22.322580645161292,<=30,WI,Home,Upto 2014
S Ramadhin,WI,Spin,1953-02-19,Port of Spain,West Indies,1953,2,108,294,0,1,777,2186,14,669,1892,14,55.5,>30,WI,Home,Upto 2014
S Ramadhin,WI,Spin,1953-03-11,Georgetown,West Indies,1953,2,113,402,2,1,639,1831,18,526,1429,16,35.5,>30,WI,Home,Upto 2014
S Ramadhin,WI,Spin,1954-01-15,Kingston,West Indies,1954,2,153,423,6,1,426,1149,15,273,726,9,28.4,<=30,WI,Home,Upto 2014
S Ramadhin,WI,Spin,1954-02-06,Bridgetown,West Indies,1954,2,121,540,7,1,772,2250,20,651,1710,13,38.6,>30,WI,Home,Upto 2014
S Ramadhin,WI,Spin,1954-02-24,Georgetown,West Indies,1954,2,120,426,6,1,666,2079,21,546,1653,15,31.714285714285715,>30,WI,Home,Upto 2014
S Ramadhin,WI,Spin,1954-03-17,Port of Spain,West Indies,1954,2,80,246,2,1,1025,1930,13,945,1684,11,78.84615384615384,>30,WI,Home,Upto 2014
S Ramadhin,WI,Spin,1954-03-30,Kingston,West Indies,1954,2,85,192,2,1,581,1630,14,496,1438,12,41.5,>30,WI,Home,Upto 2014
S Ramadhin,WI,Spin,1955-03-26,Kingston,West Indies,1955,1,112,276,1,1,550,1394,11,438,1118,10,50.0,>30,WI,Home,Upto 2014
S Ramadhin,WI,Spin,1955-04-11,Port of Spain,West Indies,1955,1,90,192,2,1,545,1044,8,455,852,6,68.125,>30,WI,Home,Upto 2014
S Ramadhin,WI,Spin,1955-04-26,Georgetown,West Indies,1955,2,84,210,2,1,484,1365,24,400,1155,22,20.166666666666668,<=30,WI,Home,Upto 2014
S Ramadhin,WI,Spin,1955-05-14,Bridgetown,West Indies,1955,2,94,156,0,1,1042,2444,22,948,2288,22,47.36363636363637,>30,WI,Home,Upto 2014
S Ramadhin,WI,Spin,1956-02-03,Dunedin,New Zealand,1956,2,81,346,9,1,439,1372,20,358,1026,11,21.95,<=30,NZ,Away,Upto 2014
S Ramadhin,WI,Spin,1956-02-18,Christchurch,New Zealand,1956,2,72,210,6,1,464,1136,24,392,926,18,19.333333333333332,<=30,NZ,Away,Upto 2014
S Ramadhin,WI,Spin,1956-03-03,Wellington,New Zealand,1956,2,96,306,3,1,421,1506,19,325,1200,16,22.157894736842106,<=30,NZ,Away,Upto 2014
S Ramadhin,WI,Spin,1956-03-09,Auckland,New Zealand,1956,2,67,246,2,1,420,1482,16,353,1236,14,26.25,<=30,NZ,Away,Upto 2014
S Ramadhin,WI,Spin,1957-05-30,Birmingham,England,1957,2,228,774,9,1,809,2558,20,581,1784,11,40.45,>30,ENG,Away,Upto 2014
S Ramadhin,WI,Spin,1957-06-20,Lord's,England,1957,1,83,132,1,1,343,654,7,260,522,6,49.0,>30,ENG,Away,Upto 2014
S Ramadhin,WI,Spin,1957-07-04,Nottingham,England,1957,1,95,228,0,1,731,1812,9,636,1584,9,81.22222222222223,>30,ENG,Away,Upto 2014
S Ramadhin,WI,Spin,1957-07-25,Leeds,England,1957,1,34,114,0,1,269,814,12,235,700,12,22.416666666666668,<=30,ENG,Away,Upto 2014
S Ramadhin,WI,Spin,1957-08-22,The Oval,England,1957,1,107,321,4,1,485,1435,24,378,1114,20,20.208333333333332,<=30,ENG,Away,Upto 2014
S Ramadhin,WI,Spin,1958-11-28,Brabourne,India,1958,2,50,120,0,1,512,1219,9,462,1099,9,56.888888888888886,>30,IND,Away,Upto 2014
S Ramadhin,WI,Spin,1958-12-31,Eden Gardens,India,1958,2,41,149,2,1,513,906,7,472,757,5,73.28571428571429,>30,IND,Away,Upto 2014
S Ramadhin,WI,Spin,1959-03-06,Dhaka,Bangladesh,1959,2,55,231,5,1,170,591,9,115,360,4,18.88888888888889,<=30,BAN,Away,Upto 2014
S Ramadhin,WI,Spin,1959-03-26,Lahore,Pakistan,1959,2,66,192,4,1,360,902,15,294,710,11,24.0,<=30,PAK,Away,Upto 2014
S Ramadhin,WI,Spin,1960-01-06,Bridgetown,West Indies,1960,2,120,366,3,1,518,1446,6,398,1080,3,86.33333333333333,>30,WI,Home,Upto 2014
S Ramadhin,WI,Spin,1960-01-28,Port of Spain,West Indies,1960,2,115,378,4,1,448,1444,13,333,1066,9,34.46153846153846,>30,WI,Home,Upto 2014
S Ramadhin,WI,Spin,1960-02-17,Kingston,West Indies,1960,2,116,339,5,1,443,1323,11,327,984,6,40.27272727272727,>30,WI,Home,Upto 2014
S Ramadhin,WI,Spin,1960-03-25,Port of Spain,West Indies,1960,2,140,408,5,1,649,1404,16,509,996,11,40.5625,>30,WI,Home,Upto 2014
S Ramadhin,WI,Spin,1960-12-09,Brisbane,Australia,1960,2,117,256,2,1,778,1958,13,661,1702,11,59.84615384615385,>30,AUS,Away,Upto 2014
S Ramadhin,WI,Spin,1960-12-30,Melbourne,Australia,1960,1,21,40,1,1,443,1051,13,422,1011,12,34.07692307692308,>30,AUS,Away,Upto 2014
S Ramesh,IND,Spin,1999-02-16,Eden Gardens,India,1999,1,5,6,0,1,375,758,8,370,752,8,46.875,>30,IND,Home,Upto 2014
S Ramesh,IND,Spin,2000-11-25,Nagpur,India,2000,1,14,18,0,1,810,1427,12,796,1409,12,67.5,>30,IND,Home,Upto 2014
S Ramesh,IND,Spin,2001-08-29,Colombo (SSC),Sri Lanka,2001,1,24,30,0,1,579,1257,16,555,1227,16,36.1875,>30,SL,Away,Upto 2014
S Randiv,SL,Spin,2010-07-26,Colombo (SSC),Sri Lanka,2010,1,222,438,2,1,926,1870,14,704,1432,12,66.14285714285714,>30,SL,Home,Upto 2014
S Randiv,SL,Spin,2010-08-03,Colombo (PSS),Sri Lanka,2010,2,162,325,9,1,813,1539,26,651,1214,17,31.26923076923077,>30,SL,Home,Upto 2014
S Randiv,SL,Spin,2010-11-15,Galle,Sri Lanka,2010,1,183,290,3,1,572,1048,14,389,758,11,40.857142857142854,>30,SL,Home,Upto 2014
S Randiv,SL,Spin,2011-08-31,Galle,Sri Lanka,2011,2,137,210,2,1,441,845,19,304,635,17,23.210526315789473,<=30,SL,Home,Upto 2014
S Randiv,SL,Spin,2011-09-08,Pallekele,Sri Lanka,2011,1,103,258,3,1,335,684,6,232,426,3,55.833333333333336,>30,SL,Home,Upto 2014
S Randiv,SL,Spin,2011-11-03,Sharjah,UAE,2011,2,95,264,2,1,589,1524,15,494,1260,13,39.266666666666666,>30,UAE,Away,Upto 2014
S Randiv,SL,Spin,2012-03-26,Galle,Sri Lanka,2012,2,100,202,6,1,607,1324,28,507,1122,22,21.678571428571427,<=30,SL,Home,Upto 2014
S Randiv,SL,Spin,2012-04-03,Colombo (PSS),Sri Lanka,2012,2,123,225,1,1,698,1454,22,575,1229,21,31.727272727272727,>30,SL,Home,Upto 2014
S Randiv,SL,Spin,2012-06-22,Galle,Sri Lanka,2012,2,99,237,7,1,621,1409,23,522,1172,16,27.0,<=30,SL,Home,Upto 2014
S Randiv,SL,Spin,2012-06-30,Colombo (SSC),Sri Lanka,2012,2,159,210,3,1,609,1048,13,450,838,10,46.84615384615385,>30,SL,Home,Upto 2014
S Randiv,SL,Spin,2012-11-17,Galle,Sri Lanka,2012,2,99,187,2,1,290,649,16,191,462,14,18.125,<=30,SL,Home,Upto 2014
S Randiv,SL,Spin,2012-11-25,Colombo (PSS),Sri Lanka,2012,2,131,300,3,1,489,1212,15,358,912,12,32.6,>30,SL,Home,Upto 2014
S Shillingford,WI,Spin,2010-06-10,Port of Spain,West Indies,2010,2,162,336,4,1,480,983,16,318,647,12,30.0,<=30,WI,Home,Upto 2014
S Shillingford,WI,Spin,2010-06-18,Basseterre,West Indies,2010,2,273,492,5,1,665,1266,8,392,774,3,83.125,>30,WI,Home,Upto 2014
S Shillingford,WI,Spin,2010-06-26,Bridgetown,West Indies,2010,1,85,150,0,1,347,891,14,262,741,14,24.785714285714285,<=30,WI,Home,Upto 2014
S Shillingford,WI,Spin,2010-11-15,Galle,Sri Lanka,2010,2,202,380,5,1,572,1048,14,370,668,9,40.857142857142854,>30,SL,Away,Upto 2014
S Shillingford,WI,Spin,2010-11-23,Colombo (RPS),Sri Lanka,2010,1,73,90,0,1,280,519,10,207,429,10,28.0,<=30,SL,Away,Upto 2014
S Shillingford,WI,Spin,2012-04-15,Port of Spain,West Indies,2012,2,147,437,4,1,339,951,13,192,514,9,26.076923076923077,<=30,WI,Home,Upto 2014
S Shillingford,WI,Spin,2012-04-23,Roseau,West Indies,2012,2,219,491,10,1,565,1160,26,346,669,16,21.73076923076923,<=30,WI,Home,Upto 2014
S Shillingford,WI,Spin,2012-05-25,Nottingham,England,2012,2,138,204,1,1,256,436,7,118,232,6,36.57142857142857,>30,ENG,Away,Upto 2014
S Shillingford,WI,Spin,2013-03-12,Bridgetown,West Indies,2013,2,107,228,9,1,270,496,14,163,268,5,19.285714285714285,<=30,WI,Home,Upto 2014
S Shillingford,WI,Spin,2013-03-20,Roseau,West Indies,2013,2,93,221,10,1,314,673,21,221,452,11,14.952380952380953,<=30,WI,Home,Upto 2014
S Shillingford,WI,Spin,2013-11-06,Eden Gardens,India,2013,1,167,330,6,1,456,988,15,289,658,9,30.4,>30,IND,Away,Upto 2014
S Shillingford,WI,Spin,2013-11-14,Wankhede,India,2013,1,179,258,5,1,497,770,24,318,512,19,20.708333333333332,<=30,IND,Away,Upto 2014
S Shillingford,WI,Spin,2013-12-03,Dunedin,New Zealand,2013,2,164,366,5,1,483,925,11,319,559,6,43.90909090909091,>30,NZ,Away,Upto 2014
S Shillingford,WI,Spin,2013-12-11,Wellington,New Zealand,2013,1,92,168,1,1,170,312,2,78,144,1,85.0,>30,NZ,Away,Upto 2014
S Shillingford,WI,Spin,2014-06-08,Kingston,West Indies,2014,2,184,357,5,1,767,1332,22,583,975,17,34.86363636363637,>30,WI,Home,After 1965
S Shillingford,WI,Spin,2014-06-26,Bridgetown,West Indies,2014,2,134,186,0,1,522,806,9,388,620,9,58.0,>30,WI,Home,After 1965
S Shivnarine,WI,Spin,1978-03-31,Georgetown,West Indies,1978,2,106,156,0,1,414,708,7,308,552,7,59.142857142857146,>30,WI,Home,Upto 2014
S Shivnarine,WI,Spin,1978-04-15,Port of Spain,West Indies,1978,1,12,36,0,1,493,1205,23,481,1169,23,21.434782608695652,<=30,WI,Home,Upto 2014
S Shivnarine,WI,Spin,1978-04-28,Kingston,West Indies,1978,2,21,72,1,1,606,1484,19,585,1412,18,31.894736842105264,>30,WI,Home,Upto 2014
S Shivnarine,WI,Spin,1978-12-15,Bengaluru,India,1978,1,2,18,0,1,411,996,8,409,978,8,51.375,>30,IND,Away,Upto 2014
S Shivnarine,WI,Spin,1978-12-29,Eden Gardens,India,1978,2,2,12,0,1,375,1048,13,373,1036,13,28.846153846153847,<=30,IND,Away,Upto 2014
S Shivnarine,WI,Spin,1979-01-12,Chennai,India,1979,1,16,30,0,1,234,496,9,218,466,9,26.0,<=30,IND,Away,Upto 2014
S Shivnarine,WI,Spin,1979-01-24,Delhi,India,1979,1,8,12,0,1,226,544,8,218,532,8,28.25,<=30,IND,Away,Upto 2014
S Sreesanth,IND,Pace,2006-03-01,Nagpur,India,2006,2,131,233,4,1,629,1284,22,498,1051,18,28.59090909090909,<=30,IND,Home,Upto 2014
S Sreesanth,IND,Pace,2006-03-18,Wankhede,India,2006,2,100,210,5,1,416,973,19,316,763,14,21.894736842105264,<=30,IND,Home,Upto 2014
S Sreesanth,IND,Pace,2006-06-02,St John's,West Indies,2006,2,145,210,2,1,716,1427,15,571,1217,13,47.733333333333334,>30,WI,Away,Upto 2014
S Sreesanth,IND,Pace,2006-06-22,Basseterre,West Indies,2006,2,118,222,3,1,636,1116,17,518,894,14,37.411764705882355,>30,WI,Away,Upto 2014
S Sreesanth,IND,Pace,2006-06-30,Kingston,West Indies,2006,2,72,144,5,1,405,1019,25,333,875,20,16.2,<=30,WI,Away,Upto 2014
S Sreesanth,IND,Pace,2006-12-15,Johannesburg,South Africa,2006,2,99,210,8,1,728,1389,33,629,1179,25,22.060606060606062,<=30,SA,Away,Upto 2014
S Sreesanth,IND,Pace,2006-12-26,Durban,South Africa,2006,2,188,258,8,1,879,1470,33,691,1212,25,26.636363636363637,<=30,SA,Away,Upto 2014
S Sreesanth,IND,Pace,2007-01-02,Cape Town,South Africa,2007,2,108,222,2,1,634,1285,20,526,1063,18,31.7,>30,SA,Away,Upto 2014
S Sreesanth,IND,Pace,2007-07-19,Lord's,England,2007,2,129,228,3,1,762,1573,34,633,1345,31,22.41176470588235,<=30,ENG,Away,Upto 2014
S Sreesanth,IND,Pace,2007-07-27,Nottingham,England,2007,2,76,198,1,1,762,1633,23,686,1435,22,33.130434782608695,>30,ENG,Away,Upto 2014
S Sreesanth,IND,Pace,2007-08-09,The Oval,England,2007,2,133,252,5,1,888,1674,23,755,1422,18,38.608695652173914,>30,ENG,Away,Upto 2014
S Sreesanth,IND,Pace,2008-03-26,Chennai,India,2008,2,146,228,1,1,691,1044,8,545,816,7,86.375,>30,IND,Home,Upto 2014
S Sreesanth,IND,Pace,2008-04-03,Ahmedabad,India,2008,1,87,138,2,1,574,946,21,487,808,19,27.333333333333332,<=30,IND,Home,Upto 2014
S Sreesanth,IND,Pace,2008-04-11,Kanpur,India,2008,2,41,120,1,1,346,693,14,305,573,13,24.714285714285715,<=30,IND,Home,Upto 2014
S Sreesanth,IND,Pace,2009-11-24,Kanpur,India,2009,2,122,198,6,1,388,624,8,266,426,2,48.5,>30,IND,Home,Upto 2014
S Sreesanth,IND,Pace,2009-12-02,Brabourne,India,2009,2,118,174,2,1,532,750,10,414,576,8,53.2,>30,IND,Home,Upto 2014
S Sreesanth,IND,Pace,2010-01-17,Chattogram,Bangladesh,2010,2,108,140,2,1,609,842,14,501,702,12,43.5,>30,BAN,Away,Upto 2014
S Sreesanth,IND,Pace,2010-10-09,Bengaluru,India,2010,2,127,210,2,1,635,1166,15,508,956,13,42.333333333333336,>30,IND,Home,Upto 2014
S Sreesanth,IND,Pace,2010-11-04,Ahmedabad,India,2010,2,92,162,2,1,415,862,12,323,700,10,34.583333333333336,>30,IND,Home,Upto 2014
S Sreesanth,IND,Pace,2010-11-12,Hyderabad,India,2010,2,209,288,4,1,606,1065,12,397,777,8,50.5,>30,IND,Home,Upto 2014
S Sreesanth,IND,Pace,2010-11-20,Nagpur,India,2010,2,53,114,2,1,407,788,13,354,674,11,31.307692307692307,>30,IND,Home,Upto 2014
S Sreesanth,IND,Pace,2010-12-16,Centurion,South Africa,2010,1,97,144,0,1,795,1278,19,698,1134,19,41.8421052631579,>30,SA,Away,Upto 2014
S Sreesanth,IND,Pace,2010-12-26,Durban,South Africa,2010,2,86,132,4,1,613,1119,31,527,987,27,19.774193548387096,<=30,SA,Away,Upto 2014
S Sreesanth,IND,Pace,2011-01-02,Cape Town,South Africa,2011,2,193,318,5,1,846,1680,22,653,1362,17,38.45454545454545,>30,SA,Away,Upto 2014
S Sreesanth,IND,Pace,2011-07-29,Nottingham,England,2011,2,212,276,5,1,899,1645,37,687,1369,32,24.2972972972973,<=30,ENG,Away,Upto 2014
S Sreesanth,IND,Pace,2011-08-10,Birmingham,England,2011,1,158,216,0,1,731,1272,20,573,1056,20,36.55,>30,ENG,Away,Upto 2014
S Sreesanth,IND,Pace,2011-08-18,The Oval,England,2011,1,123,174,3,1,633,1206,15,510,1032,12,42.2,>30,ENG,Away,Upto 2014
S Venkataraghavan,IND,Spin,1965-02-27,Chennai,India,1965,1,90,288,2,1,616,1705,17,526,1417,15,36.23529411764706,>30,IND,Home,Upto 2014
S Venkataraghavan,IND,Spin,1965-03-05,Eden Gardens,India,1965,2,101,348,6,1,632,1531,17,531,1183,11,37.1764705882353,>30,IND,Home,Upto 2014
S Venkataraghavan,IND,Spin,1965-03-12,Brabourne,India,1965,2,56,234,1,1,545,1316,11,489,1082,10,49.54545454545455,>30,IND,Home,Upto 2014
S Venkataraghavan,IND,Spin,1965-03-19,Delhi,India,1965,2,152,675,12,1,716,1840,21,564,1165,9,34.095238095238095,>30,IND,Home,Upto 2014
S Venkataraghavan,IND,Spin,1966-12-13,Brabourne,India,1966,2,185,426,2,1,1023,2319,28,838,1893,26,36.535714285714285,>30,IND,Home,Upto 2014
S Venkataraghavan,IND,Spin,1966-12-31,Eden Gardens,India,1966,1,43,84,0,1,445,1335,20,402,1251,20,22.25,<=30,IND,Home,Upto 2014
S Venkataraghavan,IND,Spin,1967-07-13,Birmingham,England,1967,2,30,90,1,1,686,1638,33,656,1548,32,20.78787878787879,<=30,ENG,Away,Upto 2014
S Venkataraghavan,IND,Spin,1969-10-03,Nagpur,India,1969,2,133,367,9,1,677,1910,37,544,1543,28,18.2972972972973,<=30,IND,Home,Upto 2014
S Venkataraghavan,IND,Spin,1969-10-15,Hyderabad (Deccan),India,1969,2,73,198,2,1,301,978,13,228,780,11,23.153846153846153,<=30,IND,Home,Upto 2014
S Venkataraghavan,IND,Spin,1969-11-04,Brabourne,India,1969,2,69,192,2,1,483,1714,20,414,1522,18,24.15,<=30,IND,Home,Upto 2014
S Venkataraghavan,IND,Spin,1969-11-15,Kanpur,India,1969,2,87,246,3,1,657,2057,13,570,1811,10,50.53846153846154,>30,IND,Home,Upto 2014
S Venkataraghavan,IND,Spin,1969-11-28,Delhi,India,1969,2,37,132,1,1,604,1737,30,567,1605,29,20.133333333333333,<=30,IND,Home,Upto 2014
S Venkataraghavan,IND,Spin,1969-12-12,Eden Gardens,India,1969,1,30,96,0,1,380,1033,12,350,937,12,31.666666666666668,>30,IND,Home,Upto 2014
S Venkataraghavan,IND,Spin,1969-12-24,Chennai,India,1969,2,97,281,6,1,490,1347,28,393,1066,22,17.5,<=30,IND,Home,Upto 2014
S Venkataraghavan,IND,Spin,1971-02-18,Kingston,West Indies,1971,2,140,330,4,1,757,1901,17,617,1571,13,44.529411764705884,>30,WI,Away,Upto 2014
S Venkataraghavan,IND,Spin,1971-03-06,Port of Spain,West Indies,1971,2,130,294,6,1,708,1890,29,578,1596,23,24.413793103448278,<=30,WI,Away,Upto 2014
S Venkataraghavan,IND,Spin,1971-03-19,Georgetown,West Indies,1971,2,175,474,3,1,785,2232,14,610,1758,11,56.07142857142857,>30,WI,Away,Upto 2014
S Venkataraghavan,IND,Spin,1971-04-01,Bridgetown,West Indies,1971,2,188,384,3,1,692,1614,11,504,1230,8,62.90909090909091,>30,WI,Away,Upto 2014
S Venkataraghavan,IND,Spin,1971-04-13,Port of Spain,West Indies,1971,2,111,255,6,1,963,2470,24,852,2215,18,40.125,>30,WI,Away,Upto 2014
S Venkataraghavan,IND,Spin,1971-07-22,Lord's,England,1971,2,96,353,6,1,610,1919,28,514,1566,22,21.785714285714285,<=30,ENG,Away,Upto 2014
S Venkataraghavan,IND,Spin,1971-08-05,Manchester,England,1971,2,147,306,3,1,461,1050,7,314,744,4,65.85714285714286,>30,ENG,Away,Upto 2014
S Venkataraghavan,IND,Spin,1971-08-19,The Oval,England,1971,2,107,244,4,1,621,1646,28,514,1402,24,22.178571428571427,<=30,ENG,Away,Upto 2014
S Venkataraghavan,IND,Spin,1972-12-20,Delhi,India,1972,2,64,144,0,1,561,1750,23,497,1606,23,24.391304347826086,<=30,IND,Home,Upto 2014
S Venkataraghavan,IND,Spin,1973-02-06,Brabourne,India,1973,2,94,180,1,1,967,2173,20,873,1993,19,48.35,>30,IND,Home,Upto 2014
S Venkataraghavan,IND,Spin,1974-06-06,Manchester,England,1974,2,25,84,0,1,468,1159,11,443,1075,11,42.54545454545455,>30,ENG,Away,Upto 2014
S Venkataraghavan,IND,Spin,1974-07-04,Birmingham,England,1974,1,71,138,0,1,474,954,5,403,816,5,94.8,>30,ENG,Away,Upto 2014
S Venkataraghavan,IND,Spin,1974-11-22,Bengaluru,India,1974,2,154,306,6,1,592,1136,16,438,830,10,37.0,>30,IND,Home,Upto 2014
S Venkataraghavan,IND,Spin,1974-12-11,Delhi,India,1974,1,107,204,1,1,662,1469,18,555,1265,17,36.77777777777778,>30,IND,Home,Upto 2014
S Venkataraghavan,IND,Spin,1976-01-24,Auckland,New Zealand,1976,2,91,344,1,1,633,1676,24,542,1332,23,26.375,<=30,NZ,Away,Upto 2014
S Venkataraghavan,IND,Spin,1976-03-24,Port of Spain,West Indies,1976,2,124,414,2,1,529,1608,16,405,1194,14,33.0625,>30,WI,Away,Upto 2014
S Venkataraghavan,IND,Spin,1976-04-07,Port of Spain,West Indies,1976,2,134,345,3,1,858,2099,21,724,1754,18,40.857142857142854,>30,WI,Away,Upto 2014
S Venkataraghavan,IND,Spin,1976-04-21,Kingston,West Indies,1976,1,112,309,2,1,368,831,11,256,522,9,33.45454545454545,>30,WI,Away,Upto 2014
S Venkataraghavan,IND,Spin,1976-11-10,Wankhede,India,1976,2,108,336,5,1,560,1714,23,452,1378,18,24.347826086956523,<=30,IND,Home,Upto 2014
S Venkataraghavan,IND,Spin,1976-11-18,Kanpur,India,1976,2,166,492,5,1,806,2159,22,640,1667,17,36.63636363636363,>30,IND,Home,Upto 2014
S Venkataraghavan,IND,Spin,1976-11-26,Chennai,India,1976,2,34,96,1,1,433,1077,20,399,981,19,21.65,<=30,IND,Home,Upto 2014
S Venkataraghavan,IND,Spin,1976-12-17,Delhi,India,1976,1,94,204,2,1,485,1319,16,391,1115,14,30.3125,>30,IND,Home,Upto 2014
S Venkataraghavan,IND,Spin,1977-12-16,W.A.C.A,Australia,1977,2,141,408,2,1,719,1592,15,578,1184,13,47.93333333333333,>30,AUS,Away,Upto 2014
S Venkataraghavan,IND,Spin,1978-12-01,Wankhede,India,1978,1,77,204,1,1,556,1295,9,479,1091,8,61.77777777777778,>30,IND,Home,Upto 2014
S Venkataraghavan,IND,Spin,1978-12-15,Bengaluru,India,1978,2,113,342,1,1,411,996,8,298,654,7,51.375,>30,IND,Home,Upto 2014
S Venkataraghavan,IND,Spin,1978-12-29,Eden Gardens,India,1978,2,102,378,7,1,375,1048,13,273,670,6,28.846153846153847,<=30,IND,Home,Upto 2014
S Venkataraghavan,IND,Spin,1979-01-12,Chennai,India,1979,2,103,226,7,1,234,496,9,131,270,2,26.0,<=30,IND,Home,Upto 2014
S Venkataraghavan,IND,Spin,1979-01-24,Delhi,India,1979,2,40,148,3,1,226,544,8,186,396,5,28.25,<=30,IND,Home,Upto 2014
S Venkataraghavan,IND,Spin,1979-02-02,Kanpur,India,1979,1,60,277,1,1,445,1037,7,385,760,6,63.57142857142857,>30,IND,Home,Upto 2014
S Venkataraghavan,IND,Spin,1979-07-12,Birmingham,England,1979,1,107,186,0,1,393,774,2,286,588,2,196.5,>30,ENG,Away,Upto 2014
S Venkataraghavan,IND,Spin,1979-08-02,Lord's,England,1979,1,79,132,1,1,266,749,5,187,617,4,53.2,>30,ENG,Away,Upto 2014
S Venkataraghavan,IND,Spin,1979-08-16,Leeds,England,1979,1,25,42,1,1,162,455,6,137,413,5,27.0,<=30,ENG,Away,Upto 2014
S Venkataraghavan,IND,Spin,1979-08-30,The Oval,England,1979,2,134,330,4,1,489,1222,10,355,892,6,48.9,>30,ENG,Away,Upto 2014
S Venkataraghavan,IND,Spin,1979-09-11,Chennai,India,1979,2,178,546,4,1,518,1389,19,340,843,15,27.263157894736842,<=30,IND,Home,Upto 2014
S Venkataraghavan,IND,Spin,1979-09-19,Bengaluru,India,1979,2,61,168,1,1,418,1101,14,357,933,13,29.857142857142858,<=30,IND,Home,Upto 2014
S Venkataraghavan,IND,Spin,1979-10-02,Kanpur,India,1979,2,69,162,1,1,449,1116,12,380,954,11,37.416666666666664,>30,IND,Home,Upto 2014
S Venkataraghavan,IND,Spin,1983-02-23,Kingston,West Indies,1983,2,105,192,1,1,239,624,5,134,432,4,47.8,>30,WI,Away,Upto 2014
S Venkataraghavan,IND,Spin,1983-03-11,Port of Spain,West Indies,1983,1,97,246,2,1,280,699,7,183,453,5,40.0,>30,WI,Away,Upto 2014
S Venkataraghavan,IND,Spin,1983-03-31,Georgetown,West Indies,1983,1,124,228,2,1,357,630,4,233,402,2,89.25,>30,WI,Away,Upto 2014
S Venkataraghavan,IND,Spin,1983-04-15,Bridgetown,West Indies,1983,1,146,258,3,1,302,625,5,156,367,2,60.4,>30,WI,Away,Upto 2014
S Venkataraghavan,IND,Spin,1983-04-28,St John's,West Indies,1983,1,114,216,2,1,460,934,5,346,718,3,92.0,>30,WI,Away,Upto 2014
S Venkataraghavan,IND,Spin,1983-09-14,Bengaluru,India,1983,1,49,127,1,1,224,589,2,175,462,1,112.0,>30,IND,Home,Upto 2014
S Venkataraghavan,IND,Spin,1983-09-24,Jalandhar,India,1983,1,55,168,0,1,262,937,8,207,769,8,32.75,>30,IND,Home,Upto 2014
S Wazir Ali,IND,Pace,1932-06-25,Lord's,England,1932,1,9,6,0,1,543,1480,28,534,1474,28,19.392857142857142,<=30,ENG,Away,Upto 2014
S Wazir Ali,IND,Pace,1934-02-10,Chennai,India,1934,2,16,24,0,1,459,1077,17,443,1053,17,27.0,<=30,IND,Home,Upto 2014
S Wettimuny,SL,Pace,1982-03-05,Karachi,Pakistan,1982,1,21,12,0,1,440,708,10,419,696,10,44.0,>30,PAK,Away,Upto 2014
S Wettimuny,SL,Pace,1986-12-17,Kanpur,India,1986,1,16,12,0,1,810,1291,13,794,1279,13,62.30769230769231,>30,IND,Away,Upto 2014
S Young,AUS,Pace,1997-08-21,The Oval,England,1997,2,13,48,0,1,435,825,24,422,777,24,18.125,<=30,ENG,Away,Upto 2014
S van Zyl,SA,Pace,2014-12-17,Centurion,South Africa,2014,1,22,60,0,1,587,1007,20,565,947,20,29.35,<=30,SA,Home,After 1965
S van Zyl,SA,Pace,2015-01-02,Cape Town,South Africa,2015,2,19,60,1,1,670,1234,16,651,1174,15,41.875,>30,SA,Home,After 1965
S van Zyl,SA,Pace,2015-07-21,Chattogram,Bangladesh,2015,1,23,78,1,1,297,719,10,274,641,9,29.7,<=30,BAN,Away,After 1965
S van Zyl,SA,Pace,2015-07-30,Mirpur,Bangladesh,2015,1,5,12,0,1,105,259,4,100,247,4,26.25,<=30,BAN,Away,After 1965
S van Zyl,SA,Pace,2015-11-05,Mohali,India,2015,1,5,24,1,1,185,504,6,180,480,5,30.833333333333332,>30,IND,Away,After 1965
S van Zyl,SA,Pace,2015-12-26,Durban,South Africa,2015,2,22,73,3,1,593,1392,27,571,1319,24,21.962962962962962,<=30,SA,Home,After 1965
S van Zyl,SA,Pace,2016-01-02,Cape Town,South Africa,2016,1,43,60,0,1,994,1661,14,951,1601,14,71.0,>30,SA,Home,After 1965
S van Zyl,SA,Pace,2016-01-14,Johannesburg,South Africa,2016,1,4,18,0,1,692,1271,29,688,1253,29,23.862068965517242,<=30,SA,Home,After 1965
S van Zyl,SA,Pace,2016-08-27,Centurion,South Africa,2016,1,5,18,0,1,829,1709,31,824,1691,31,26.741935483870968,<=30,SA,Home,After 1965
S von Berg,SA,Spin,2024-02-13,Hamilton,New Zealand,2024,2,100,174,0,1,415,855,14,315,681,14,29.642857142857142,<=30,NZ,Away,After 1965
SA Ankola,IND,Pace,1989-11-15,Karachi,Pakistan,1989,2,128,180,2,1,875,1711,26,747,1531,24,33.65384615384615,>30,PAK,Away,Upto 2014
SA Banerjee,IND,Pace,1948-12-31,Eden Gardens,India,1948,2,181,306,5,1,577,1272,12,396,966,7,48.083333333333336,>30,IND,Home,Upto 2014
SA Durani,IND,Spin,1960-01-01,Brabourne,India,1960,1,9,6,0,1,351,876,9,342,870,9,39.0,>30,IND,Home,Upto 2014
SA Durani,IND,Spin,1961-11-11,Brabourne,India,1961,2,119,246,3,1,727,1890,18,608,1644,15,40.388888888888886,>30,IND,Home,Upto 2014
SA Durani,IND,Spin,1961-12-01,Kanpur,India,1961,2,175,414,2,1,792,2016,16,617,1602,14,49.5,>30,IND,Home,Upto 2014
SA Durani,IND,Spin,1961-12-13,Delhi,India,1961,1,38,78,0,1,505,1242,8,467,1164,8,63.125,>30,IND,Home,Upto 2014
SA Durani,IND,Spin,1961-12-30,Eden Gardens,India,1961,2,113,340,8,1,632,1788,29,519,1448,21,21.79310344827586,<=30,IND,Home,Upto 2014
SA Durani,IND,Spin,1962-01-10,Chennai,India,1962,2,177,420,10,1,866,2320,33,689,1900,23,26.242424242424242,<=30,IND,Home,Upto 2014
SA Durani,IND,Spin,1962-02-16,Port of Spain,West Indies,1962,1,82,212,4,1,339,916,17,257,704,13,19.941176470588236,<=30,WI,Away,Upto 2014
SA Durani,IND,Spin,1962-03-07,Kingston,West Indies,1962,1,173,420,2,1,783,1924,16,610,1504,14,48.9375,>30,WI,Away,Upto 2014
SA Durani,IND,Spin,1962-03-23,Bridgetown,West Indies,1962,1,123,270,2,1,596,2431,22,473,2161,20,27.09090909090909,<=30,WI,Away,Upto 2014
SA Durani,IND,Spin,1962-04-04,Port of Spain,West Indies,1962,2,118,294,4,1,911,2452,24,793,2158,20,37.958333333333336,>30,WI,Away,Upto 2014
SA Durani,IND,Spin,1962-04-13,Kingston,West Indies,1962,2,104,180,5,1,527,1208,20,423,1028,15,26.35,<=30,WI,Away,Upto 2014
SA Durani,IND,Spin,1964-01-10,Chennai,India,1964,2,161,384,3,1,876,2493,27,715,2109,24,32.44444444444444,>30,IND,Home,Upto 2014
SA Durani,IND,Spin,1964-01-21,Brabourne,India,1964,2,94,402,4,1,560,2208,16,466,1806,12,35.0,>30,IND,Home,Upto 2014
SA Durani,IND,Spin,1964-01-29,Eden Gardens,India,1964,2,74,180,3,1,555,1794,16,481,1614,13,34.6875,>30,IND,Home,Upto 2014
SA Durani,IND,Spin,1964-02-08,Delhi,India,1964,1,93,198,1,1,1001,2631,20,908,2433,19,50.05,>30,IND,Home,Upto 2014
SA Durani,IND,Spin,1964-02-15,Kanpur,India,1964,1,49,150,0,1,987,2874,18,938,2724,18,54.833333333333336,>30,IND,Home,Upto 2014
SA Durani,IND,Spin,1964-10-02,Chennai,India,1964,2,170,366,3,1,735,1918,23,565,1552,20,31.956521739130434,>30,IND,Home,Upto 2014
SA Durani,IND,Spin,1964-10-10,Brabourne,India,1964,2,126,210,1,1,796,2173,26,670,1963,25,30.615384615384617,>30,IND,Home,Upto 2014
SA Durani,IND,Spin,1964-10-17,Eden Gardens,India,1964,2,132,276,6,1,407,1253,16,275,977,10,25.4375,<=30,IND,Home,Upto 2014
SA Durani,IND,Spin,1965-02-27,Chennai,India,1965,2,57,276,3,1,616,1705,17,559,1429,14,36.23529411764706,>30,IND,Home,Upto 2014
SA Durani,IND,Spin,1965-03-05,Eden Gardens,India,1965,2,83,198,2,1,632,1531,17,549,1333,15,37.1764705882353,>30,IND,Home,Upto 2014
SA Durani,IND,Spin,1965-03-12,Brabourne,India,1965,2,42,164,4,1,545,1316,11,503,1152,7,49.54545454545455,>30,IND,Home,Upto 2014
SA Durani,IND,Spin,1966-12-13,Brabourne,India,1966,2,125,258,1,1,1023,2319,28,898,2061,27,36.535714285714285,>30,IND,Home,Upto 2014
SA Durani,IND,Spin,1971-02-18,Kingston,West Indies,1971,1,42,84,0,1,757,1901,17,715,1817,17,44.529411764705884,>30,WI,Away,Upto 2014
SA Durani,IND,Spin,1971-03-06,Port of Spain,West Indies,1971,1,21,102,2,1,708,1890,29,687,1788,27,24.413793103448278,<=30,WI,Away,Upto 2014
SA Durani,IND,Spin,1971-03-19,Georgetown,West Indies,1971,2,98,180,1,1,785,2232,14,687,2052,13,56.07142857142857,>30,WI,Away,Upto 2014
SA Durani,IND,Spin,1972-12-30,Eden Gardens,India,1972,1,14,24,0,1,461,1469,28,447,1445,28,16.464285714285715,<=30,IND,Home,Upto 2014
SA Durani,IND,Spin,1973-01-12,Chennai,India,1973,1,24,90,1,1,632,1828,31,608,1738,30,20.387096774193548,<=30,IND,Home,Upto 2014
SA Durani,IND,Spin,1973-02-06,Brabourne,India,1973,1,21,24,0,1,967,2173,20,946,2149,20,48.35,>30,IND,Home,Upto 2014
SA Muller,AUS,Pace,1999-11-05,Brisbane,Australia,1999,2,127,174,3,1,895,1510,23,768,1336,20,38.91304347826087,>30,AUS,Home,Upto 2014
SA Muller,AUS,Pace,1999-11-18,Hobart,Australia,1999,2,131,174,4,1,857,1577,19,726,1403,15,45.10526315789474,>30,AUS,Home,Upto 2014
SA Thomson,NZ,Spin,1990-02-22,Auckland,New Zealand,1990,2,122,165,2,1,382,711,6,260,546,4,63.666666666666664,>30,NZ,Home,Upto 2014
SA Thomson,NZ,Spin,1991-02-22,Hamilton,New Zealand,1991,2,28,84,1,1,304,672,6,276,588,5,50.666666666666664,>30,NZ,Home,Upto 2014
SA Thomson,NZ,Spin,1991-03-01,Auckland,New Zealand,1991,2,85,187,3,1,346,733,6,261,546,3,57.666666666666664,>30,NZ,Home,Upto 2014
SA Thomson,NZ,Spin,1992-01-18,Christchurch,New Zealand,1992,1,47,90,0,1,362,1021,13,315,931,13,27.846153846153847,<=30,NZ,Home,Upto 2014
SA Thomson,NZ,Spin,1994-02-10,Auckland,New Zealand,1994,1,17,24,1,1,96,126,4,79,102,3,24.0,<=30,NZ,Home,Upto 2014
SA Thomson,NZ,Spin,1994-02-17,Wellington,New Zealand,1994,1,80,102,1,1,228,416,2,148,314,1,114.0,>30,NZ,Home,Upto 2014
SA Thomson,NZ,Spin,1994-02-24,Christchurch,New Zealand,1994,2,32,60,1,1,187,378,5,155,318,4,37.4,>30,NZ,Home,Upto 2014
SA Thomson,NZ,Spin,1994-03-19,Hamilton,New Zealand,1994,2,85,132,2,1,491,1160,14,406,1028,12,35.07142857142857,>30,NZ,Home,Upto 2014
SA Thomson,NZ,Spin,1994-06-02,Nottingham,England,1994,1,73,228,1,1,324,936,7,251,708,6,46.285714285714285,>30,ENG,Away,Upto 2014
SA Thomson,NZ,Spin,1994-06-16,Lord's,England,1994,2,67,204,1,1,425,1219,7,358,1015,6,60.714285714285715,>30,ENG,Away,Upto 2014
SA Thomson,NZ,Spin,1994-06-30,Manchester,England,1994,1,23,42,0,1,174,423,5,151,381,5,34.8,>30,ENG,Away,Upto 2014
SA Thomson,NZ,Spin,1994-11-25,Johannesburg,South Africa,1994,1,18,66,0,1,233,640,10,215,574,10,23.3,<=30,SA,Away,Upto 2014
SA Thomson,NZ,Spin,1994-12-26,Durban,South Africa,1994,1,10,12,0,1,116,208,3,106,196,3,38.666666666666664,>30,SA,Away,Upto 2014
SA Thomson,NZ,Spin,1995-01-02,Cape Town,South Africa,1995,2,98,258,4,1,383,1034,9,285,776,5,42.55555555555556,>30,SA,Away,Upto 2014
SA Thomson,NZ,Spin,1995-02-03,Christchurch,New Zealand,1995,1,61,108,2,1,170,372,2,109,264,0,85.0,>30,NZ,Home,Upto 2014
SA Thomson,NZ,Spin,1995-03-11,Napier,New Zealand,1995,1,10,36,0,1,74,252,5,64,216,5,14.8,<=30,NZ,Home,Upto 2014
SA Thomson,NZ,Spin,1995-10-18,Bengaluru,India,1995,2,78,138,0,1,388,811,15,310,673,15,25.866666666666667,<=30,IND,Away,Upto 2014
SA Thomson,NZ,Spin,1995-10-25,Chennai,India,1995,1,19,54,0,1,69,157,0,50,103,0,inf,>30,IND,Away,Upto 2014
SB Bangar,IND,Pace,2001-12-03,Mohali,India,2001,1,17,30,0,1,398,794,9,381,764,9,44.22222222222222,>30,IND,Home,Upto 2014
SB Bangar,IND,Pace,2002-02-21,Nagpur,India,2002,1,20,48,0,1,439,839,7,419,791,7,62.714285714285715,>30,IND,Home,Upto 2014
SB Bangar,IND,Pace,2002-02-28,Delhi,India,2002,1,25,42,0,1,446,889,10,421,847,10,44.6,>30,IND,Home,Upto 2014
SB Bangar,IND,Pace,2002-04-11,Georgetown,West Indies,2002,1,63,162,1,1,506,1071,12,443,909,11,42.166666666666664,>30,WI,Away,Upto 2014
SB Bangar,IND,Pace,2002-04-19,Port of Spain,West Indies,2002,1,11,12,0,1,849,1915,33,838,1903,33,25.727272727272727,<=30,WI,Away,Upto 2014
SB Bangar,IND,Pace,2002-08-22,Leeds,England,2002,2,63,102,2,1,769,1387,15,706,1285,13,51.266666666666666,>30,ENG,Away,Upto 2014
SB Bangar,IND,Pace,2002-09-05,The Oval,England,2002,2,54,156,2,1,664,1200,10,610,1044,8,66.4,>30,ENG,Away,Upto 2014
SB Bangar,IND,Pace,2002-10-09,Wankhede,India,2002,1,20,36,0,1,351,798,10,331,762,10,35.1,>30,IND,Home,Upto 2014
SB Bangar,IND,Pace,2002-10-17,Chennai,India,2002,1,29,36,0,1,288,754,13,259,718,13,22.153846153846153,<=30,IND,Home,Upto 2014
SB Bangar,IND,Pace,2002-10-30,Eden Gardens,India,2002,1,14,36,0,1,701,1322,15,687,1286,15,46.733333333333334,>30,IND,Home,Upto 2014
SB Bangar,IND,Pace,2002-12-12,Wellington,New Zealand,2002,1,23,90,2,1,505,1071,28,482,981,26,18.035714285714285,<=30,NZ,Away,Upto 2014
SB Bangar,IND,Pace,2002-12-19,Hamilton,New Zealand,2002,1,4,12,0,1,426,959,32,422,947,32,13.3125,<=30,NZ,Away,Upto 2014
SB Doull,NZ,Pace,1992-11-01,Bulawayo,Zimbabwe,1992,2,37,114,1,1,481,878,7,444,764,6,68.71428571428571,>30,ZIM,Away,Upto 2014
SB Doull,NZ,Pace,1993-11-26,Hobart,Australia,1993,1,99,126,1,1,577,1014,7,478,888,6,82.42857142857143,>30,AUS,Away,Upto 2014
SB Doull,NZ,Pace,1993-12-03,Brisbane,Australia,1993,1,105,198,2,1,683,1440,13,578,1242,11,52.53846153846154,>30,AUS,Away,Upto 2014
SB Doull,NZ,Pace,1994-02-10,Auckland,New Zealand,1994,2,114,186,7,1,582,1070,31,468,884,24,18.774193548387096,<=30,NZ,Home,Upto 2014
SB Doull,NZ,Pace,1994-02-17,Wellington,New Zealand,1994,1,112,162,0,1,832,1382,22,720,1220,22,37.81818181818182,>30,NZ,Home,Upto 2014
SB Doull,NZ,Pace,1994-02-24,Christchurch,New Zealand,1994,2,106,180,5,1,835,1575,27,729,1395,22,30.925925925925927,>30,NZ,Home,Upto 2014
SB Doull,NZ,Pace,1994-11-25,Johannesburg,South Africa,1994,2,103,216,6,1,787,1709,30,684,1493,24,26.233333333333334,<=30,SA,Away,Upto 2014
SB Doull,NZ,Pace,1994-12-26,Durban,South Africa,1994,2,99,269,6,1,610,1681,28,511,1412,22,21.785714285714285,<=30,SA,Away,Upto 2014
SB Doull,NZ,Pace,1995-01-02,Cape Town,South Africa,1995,1,55,206,2,1,639,1598,22,584,1392,20,29.045454545454547,<=30,SA,Away,Upto 2014
SB Doull,NZ,Pace,1995-02-03,Christchurch,New Zealand,1995,1,85,132,1,1,515,1143,17,430,1011,16,30.294117647058822,>30,NZ,Home,Upto 2014
SB Doull,NZ,Pace,1995-02-10,Wellington,New Zealand,1995,1,162,224,2,1,598,1142,20,436,918,18,29.9,<=30,NZ,Home,Upto 2014
SB Doull,NZ,Pace,1996-11-21,Lahore,Pakistan,1996,2,85,192,8,1,507,953,23,422,761,15,22.043478260869566,<=30,PAK,Away,Upto 2014
SB Doull,NZ,Pace,1996-11-28,Rawalpindi,Pakistan,1996,1,86,186,2,1,614,1126,22,528,940,20,27.90909090909091,<=30,PAK,Away,Upto 2014
SB Doull,NZ,Pace,1997-01-24,Auckland,New Zealand,1997,1,118,234,2,1,815,1797,20,697,1563,18,40.75,>30,NZ,Home,Upto 2014
SB Doull,NZ,Pace,1997-02-06,Wellington,New Zealand,1997,1,75,168,5,1,457,1115,23,382,947,18,19.869565217391305,<=30,NZ,Home,Upto 2014
SB Doull,NZ,Pace,1997-02-14,Christchurch,New Zealand,1997,2,106,232,2,1,695,1595,19,589,1363,17,36.578947368421055,>30,NZ,Home,Upto 2014
SB Doull,NZ,Pace,1997-03-07,Dunedin,New Zealand,1997,2,140,251,8,1,739,1295,21,599,1044,13,35.19047619047619,>30,NZ,Home,Upto 2014
SB Doull,NZ,Pace,1997-03-14,Hamilton,New Zealand,1997,2,53,168,4,1,399,988,18,346,820,14,22.166666666666668,<=30,NZ,Home,Upto 2014
SB Doull,NZ,Pace,1997-11-07,Brisbane,Australia,1997,2,114,294,4,1,809,1711,25,695,1417,21,32.36,>30,AUS,Away,Upto 2014
SB Doull,NZ,Pace,1997-11-20,W.A.C.A,Australia,1997,1,78,126,1,1,605,1158,21,527,1032,20,28.80952380952381,<=30,AUS,Away,Upto 2014
SB Doull,NZ,Pace,1997-11-27,Hobart,Australia,1997,2,115,246,3,1,691,1411,18,576,1165,15,38.388888888888886,>30,AUS,Away,Upto 2014
SB Doull,NZ,Pace,1998-02-19,Wellington,New Zealand,1998,2,65,180,3,1,429,1062,17,364,882,14,25.235294117647058,<=30,NZ,Home,Upto 2014
SB Doull,NZ,Pace,1998-02-26,Auckland,New Zealand,1998,2,85,238,8,1,557,1155,25,472,917,17,22.28,<=30,NZ,Home,Upto 2014
SB Doull,NZ,Pace,1998-05-27,Colombo (RPS),Sri Lanka,1998,2,58,92,0,1,355,626,8,297,534,8,44.375,>30,SL,Away,Upto 2014
SB Doull,NZ,Pace,1998-12-26,Wellington,New Zealand,1998,2,114,294,9,1,632,1417,22,518,1123,13,28.727272727272727,<=30,NZ,Home,Upto 2014
SB Doull,NZ,Pace,1999-01-02,Hamilton,New Zealand,1999,2,81,240,3,1,1002,1896,23,921,1656,20,43.56521739130435,>30,NZ,Home,Upto 2014
SB Doull,NZ,Pace,1999-02-27,Auckland,New Zealand,1999,1,90,198,1,1,841,1949,13,751,1751,12,64.6923076923077,>30,NZ,Home,Upto 2014
SB Doull,NZ,Pace,1999-03-11,Christchurch,New Zealand,1999,1,48,155,0,1,581,1404,8,533,1249,8,72.625,>30,NZ,Home,Upto 2014
SB Doull,NZ,Pace,1999-03-18,Wellington,New Zealand,1999,1,77,144,0,1,742,1762,20,665,1618,20,37.1,>30,NZ,Home,Upto 2014
SB Doull,NZ,Pace,1999-07-01,Birmingham,England,1999,2,65,114,1,1,580,1146,27,515,1032,26,21.48148148148148,<=30,ENG,Away,Upto 2014
SB Doull,NZ,Pace,2000-03-11,Auckland,New Zealand,2000,2,29,114,0,1,234,565,12,205,451,12,19.5,<=30,NZ,Home,Upto 2014
SB Doull,NZ,Pace,2000-03-24,Wellington,New Zealand,2000,2,113,174,1,1,802,1476,20,689,1302,19,40.1,>30,NZ,Home,Upto 2014
SB Joshi,IND,Spin,1996-10-10,Delhi,India,1996,2,88,258,2,1,528,1278,19,440,1020,17,27.789473684210527,<=30,IND,Home,Upto 2014
SB Joshi,IND,Spin,1996-11-20,Ahmedabad,India,1996,2,71,192,5,1,390,956,20,319,764,15,19.5,<=30,IND,Home,Upto 2014
SB Joshi,IND,Spin,1996-11-27,Eden Gardens,India,1996,2,98,138,0,1,508,781,6,410,643,6,84.66666666666667,>30,IND,Home,Upto 2014
SB Joshi,IND,Spin,1996-12-08,Kanpur,India,1996,2,79,219,3,1,503,1168,19,424,949,16,26.473684210526315,<=30,IND,Home,Upto 2014
SB Joshi,IND,Spin,1997-03-06,Kingston,West Indies,1997,2,108,198,1,1,464,982,9,356,784,8,51.55555555555556,>30,WI,Away,Upto 2014
SB Joshi,IND,Spin,1997-03-14,Port of Spain,West Indies,1997,2,136,351,6,1,443,1095,13,307,744,7,34.07692307692308,>30,WI,Away,Upto 2014
SB Joshi,IND,Spin,1997-04-04,St John's,West Indies,1997,1,76,142,3,1,268,532,5,192,390,2,53.6,>30,WI,Away,Upto 2014
SB Joshi,IND,Spin,1997-04-17,Georgetown,West Indies,1997,1,11,30,1,1,131,336,6,120,306,5,21.833333333333332,<=30,WI,Away,Upto 2014
SB Joshi,IND,Spin,1999-01-28,Chennai,India,1999,2,78,210,1,1,572,1226,24,494,1016,23,23.833333333333332,<=30,IND,Home,Upto 2014
SB Joshi,IND,Spin,1999-10-10,Mohali,India,1999,2,60,270,3,1,393,1249,10,333,979,7,39.3,>30,IND,Home,Upto 2014
SB Joshi,IND,Spin,1999-10-22,Kanpur,India,1999,2,90,240,2,1,568,1375,24,478,1135,22,23.666666666666668,<=30,IND,Home,Upto 2014
SB Joshi,IND,Spin,2000-11-10,Dhaka,Bangladesh,2000,2,169,381,8,1,558,1251,19,389,870,11,29.36842105263158,<=30,BAN,Away,Upto 2014
SB Joshi,IND,Spin,2000-11-18,Delhi,India,2000,2,184,426,4,1,622,1309,9,438,883,5,69.11111111111111,>30,IND,Home,Upto 2014
SB Joshi,IND,Spin,2000-11-25,Nagpur,India,2000,2,222,396,2,1,810,1427,12,588,1031,10,67.5,>30,IND,Home,Upto 2014
SB O'Connor,NZ,Pace,1997-09-18,Harare,Zimbabwe,1997,2,177,312,4,1,808,1794,25,631,1482,21,32.32,>30,ZIM,Away,Upto 2014
SB O'Connor,NZ,Pace,1997-09-25,Bulawayo,Zimbabwe,1997,2,114,192,3,1,606,1326,9,492,1134,6,67.33333333333333,>30,ZIM,Away,Upto 2014
SB O'Connor,NZ,Pace,1997-11-20,W.A.C.A,Australia,1997,1,109,190,3,1,605,1158,21,496,968,18,28.80952380952381,<=30,AUS,Away,Upto 2014
SB O'Connor,NZ,Pace,1997-11-27,Hobart,Australia,1997,2,133,258,4,1,691,1411,18,558,1153,14,38.388888888888886,>30,AUS,Away,Upto 2014
SB O'Connor,NZ,Pace,1998-02-19,Wellington,New Zealand,1998,2,91,195,4,1,429,1062,17,338,867,13,25.235294117647058,<=30,NZ,Home,Upto 2014
SB O'Connor,NZ,Pace,1998-06-03,Galle,Sri Lanka,1998,1,13,24,0,1,157,358,1,144,334,1,157.0,>30,SL,Away,Upto 2014
SB O'Connor,NZ,Pace,1999-03-18,Wellington,New Zealand,1999,2,98,169,1,1,742,1762,20,644,1593,19,37.1,>30,NZ,Home,Upto 2014
SB O'Connor,NZ,Pace,1999-08-19,The Oval,England,1999,2,62,144,3,1,501,1268,29,439,1124,26,17.275862068965516,<=30,ENG,Away,Upto 2014
SB O'Connor,NZ,Pace,1999-10-10,Mohali,India,1999,2,93,150,2,1,577,1368,20,484,1218,18,28.85,<=30,IND,Away,Upto 2014
SB O'Connor,NZ,Pace,1999-12-26,Wellington,New Zealand,1999,2,75,210,0,1,571,1324,20,496,1114,20,28.55,<=30,NZ,Home,Upto 2014
SB O'Connor,NZ,Pace,2000-03-24,Wellington,New Zealand,2000,2,120,222,4,1,802,1476,20,682,1254,16,40.1,>30,NZ,Home,Upto 2014
SB O'Connor,NZ,Pace,2000-03-31,Hamilton,New Zealand,2000,2,104,161,7,1,633,1061,24,529,900,17,26.375,<=30,NZ,Home,Upto 2014
SB O'Connor,NZ,Pace,2000-09-12,Bulawayo,Zimbabwe,2000,2,71,234,2,1,470,1291,13,399,1057,11,36.15384615384615,>30,ZIM,Away,Upto 2014
SB O'Connor,NZ,Pace,2000-09-19,Harare,Zimbabwe,2000,2,116,438,7,1,838,2129,25,722,1691,18,33.52,>30,ZIM,Away,Upto 2014
SB O'Connor,NZ,Pace,2000-11-17,Bloemfontein,South Africa,2000,2,115,222,4,1,906,1955,31,791,1733,27,29.225806451612904,<=30,SA,Away,Upto 2014
SB O'Connor,NZ,Pace,2000-11-30,Gqeberha,South Africa,2000,2,77,208,3,1,698,1864,30,621,1656,27,23.266666666666666,<=30,SA,Away,Upto 2014
SB O'Connor,NZ,Pace,2000-12-08,Johannesburg,South Africa,2000,1,52,90,1,1,417,1127,13,365,1037,12,32.07692307692308,>30,SA,Away,Upto 2014
SB O'Connor,NZ,Pace,2000-12-26,Wellington,New Zealand,2000,2,37,144,1,1,550,1397,13,513,1253,12,42.30769230769231,>30,NZ,Home,Upto 2014
SB O'Connor,NZ,Pace,2001-11-08,Brisbane,Australia,2001,1,67,104,0,1,871,1428,20,804,1324,20,43.55,>30,AUS,Away,Upto 2014
SB Styris,NZ,Pace,2002-06-28,St George's,West Indies,2002,1,88,150,2,1,623,1356,15,535,1206,13,41.53333333333333,>30,WI,Away,Upto 2014
SB Styris,NZ,Pace,2002-12-12,Wellington,New Zealand,2002,2,44,60,3,1,505,1071,28,461,1011,25,18.035714285714285,<=30,NZ,Home,Upto 2014
SB Styris,NZ,Pace,2002-12-19,Hamilton,New Zealand,2002,1,10,12,0,1,426,959,32,416,947,32,13.3125,<=30,NZ,Home,Upto 2014
SB Styris,NZ,Pace,2003-04-25,Colombo (PSS),Sri Lanka,2003,1,28,18,0,1,412,858,7,384,840,7,58.857142857142854,>30,SL,Away,Upto 2014
SB Styris,NZ,Pace,2003-10-08,Ahmedabad,India,2003,1,83,156,1,1,553,1086,9,470,930,8,61.44444444444444,>30,IND,Away,Upto 2014
SB Styris,NZ,Pace,2003-10-16,Mohali,India,2003,2,44,138,1,1,470,1014,9,426,876,8,52.22222222222222,>30,IND,Away,Upto 2014
SB Styris,NZ,Pace,2003-12-19,Hamilton,New Zealand,2003,1,27,72,0,1,863,1591,23,836,1519,23,37.52173913043478,>30,NZ,Home,Upto 2014
SB Styris,NZ,Pace,2003-12-26,Wellington,New Zealand,2003,2,27,48,0,1,696,1646,29,669,1598,29,24.0,<=30,NZ,Home,Upto 2014
SB Styris,NZ,Pace,2004-03-10,Hamilton,New Zealand,2004,2,75,174,2,1,760,1661,15,685,1487,13,50.666666666666664,>30,NZ,Home,Upto 2014
SB Styris,NZ,Pace,2004-03-18,Auckland,New Zealand,2004,2,76,162,0,1,1016,1973,29,940,1811,29,35.03448275862069,>30,NZ,Home,Upto 2014
SB Styris,NZ,Pace,2004-03-26,Wellington,New Zealand,2004,2,70,114,1,1,820,1651,25,750,1537,24,32.8,>30,NZ,Home,Upto 2014
SB Styris,NZ,Pace,2004-05-20,Lord's,England,2004,2,48,105,2,1,1118,2072,26,1070,1967,24,43.0,>30,ENG,Away,Upto 2014
SB Styris,NZ,Pace,2004-06-03,Leeds,England,2004,1,88,162,3,1,915,1695,27,827,1533,24,33.888888888888886,>30,ENG,Away,Upto 2014
SB Styris,NZ,Pace,2004-06-10,Nottingham,England,2004,2,88,150,1,1,1015,1836,30,927,1686,29,33.833333333333336,>30,ENG,Away,Upto 2014
SB Styris,NZ,Pace,2004-10-19,Dhaka,Bangladesh,2004,1,4,12,0,1,301,659,9,297,647,9,33.44444444444444,>30,BAN,Away,Upto 2014
SB Styris,NZ,Pace,2004-11-18,Brisbane,Australia,2004,1,33,48,0,1,723,1283,17,690,1235,17,42.529411764705884,>30,AUS,Away,Upto 2014
SB Styris,NZ,Pace,2005-08-07,Harare,Zimbabwe,2005,2,12,54,0,1,432,774,20,420,720,20,21.6,<=30,ZIM,Away,Upto 2014
SB Styris,NZ,Pace,2005-08-15,Bulawayo,Zimbabwe,2005,2,29,42,0,1,584,919,19,555,877,19,30.736842105263158,>30,ZIM,Away,Upto 2014
SB Styris,NZ,Pace,2006-03-09,Auckland,New Zealand,2006,1,23,42,2,1,867,1612,27,844,1570,25,32.111111111111114,>30,NZ,Home,Upto 2014
SB Styris,NZ,Pace,2006-03-25,Napier,New Zealand,2006,1,27,79,0,1,242,421,3,215,342,3,80.66666666666667,>30,NZ,Home,Upto 2014
SB Styris,NZ,Pace,2006-04-15,Centurion,South Africa,2006,1,3,12,1,1,858,1550,38,855,1538,37,22.57894736842105,<=30,SA,Away,Upto 2014
SB Styris,NZ,Pace,2006-04-27,Cape Town,South Africa,2006,1,33,60,0,1,739,1386,13,706,1326,13,56.84615384615385,>30,SA,Away,Upto 2014
SB Styris,NZ,Pace,2006-05-05,Johannesburg,South Africa,2006,2,13,30,1,1,757,1280,36,744,1250,35,21.02777777777778,<=30,SA,Away,Upto 2014
SB Styris,NZ,Pace,2007-11-08,Johannesburg,South Africa,2007,1,25,36,0,1,740,1372,29,715,1336,29,25.517241379310345,<=30,SA,Away,Upto 2014
SB Styris,NZ,Pace,2007-11-16,Centurion,South Africa,2007,1,17,24,0,1,609,994,26,592,970,26,23.423076923076923,<=30,SA,Away,Upto 2014
SC Cook,SA,Pace,2016-11-03,W.A.C.A,Australia,2016,1,16,12,0,1,937,1726,29,921,1714,29,32.310344827586206,>30,AUS,Away,After 1965
SC Ganguly,IND,Pace,1996-06-20,Lord's,England,1996,2,54,108,3,1,826,2028,26,772,1920,23,31.76923076923077,>30,ENG,Away,Upto 2014
SC Ganguly,IND,Pace,1996-07-04,Nottingham,England,1996,1,71,119,3,1,859,1781,24,788,1662,21,35.791666666666664,>30,ENG,Away,Upto 2014
SC Ganguly,IND,Pace,1996-11-27,Eden Gardens,India,1996,1,10,18,0,1,704,1315,23,694,1297,23,30.608695652173914,>30,IND,Home,Upto 2014
SC Ganguly,IND,Pace,1996-12-26,Durban,South Africa,1996,2,20,66,1,1,537,1172,37,517,1106,36,14.513513513513514,<=30,SA,Away,Upto 2014
SC Ganguly,IND,Pace,1997-01-02,Cape Town,South Africa,1997,2,29,66,0,1,897,1609,22,868,1543,22,40.77272727272727,>30,SA,Away,Upto 2014
SC Ganguly,IND,Pace,1997-01-16,Johannesburg,South Africa,1997,2,36,84,2,1,895,1774,26,859,1690,24,34.42307692307692,>30,SA,Away,Upto 2014
SC Ganguly,IND,Pace,1997-03-06,Kingston,West Indies,1997,1,17,42,0,1,612,1409,17,595,1367,17,36.0,>30,WI,Away,Upto 2014
SC Ganguly,IND,Pace,1997-03-14,Port of Spain,West Indies,1997,2,9,48,1,1,527,1480,12,518,1432,11,43.916666666666664,>30,WI,Away,Upto 2014
SC Ganguly,IND,Pace,1997-03-27,Bridgetown,West Indies,1997,1,9,12,0,1,738,1569,38,729,1557,38,19.42105263157895,<=30,WI,Away,Upto 2014
SC Ganguly,IND,Pace,1997-04-04,St John's,West Indies,1997,1,24,18,0,1,268,546,4,244,528,4,67.0,>30,WI,Away,Upto 2014
SC Ganguly,IND,Pace,1997-08-02,Colombo (RPS),Sri Lanka,1997,1,53,54,2,1,398,549,5,345,495,3,79.6,>30,SL,Away,Upto 2014
SC Ganguly,IND,Pace,1997-08-09,Colombo (SSC),Sri Lanka,1997,2,41,42,1,1,927,1577,19,886,1535,18,48.78947368421053,>30,SL,Away,Upto 2014
SC Ganguly,IND,Pace,1997-11-19,Mohali,India,1997,2,0,24,0,1,565,1196,16,565,1172,16,35.3125,>30,IND,Home,Upto 2014
SC Ganguly,IND,Pace,1997-12-03,Wankhede,India,1997,1,19,18,0,1,639,1269,12,620,1251,12,53.25,>30,IND,Home,Upto 2014
SC Ganguly,IND,Pace,1998-03-18,Eden Gardens,India,1998,2,37,106,3,1,398,718,11,361,612,8,36.18181818181818,>30,IND,Home,Upto 2014
SC Ganguly,IND,Pace,1998-03-25,Bengaluru,India,1998,1,10,12,0,1,319,612,10,309,600,10,31.9,>30,IND,Home,Upto 2014
SC Ganguly,IND,Pace,1998-10-07,Harare,Zimbabwe,1998,2,31,54,1,1,643,1431,26,612,1377,25,24.73076923076923,<=30,ZIM,Away,Upto 2014
SC Ganguly,IND,Pace,1998-12-26,Wellington,New Zealand,1998,1,13,36,0,1,632,1417,22,619,1381,22,28.727272727272727,<=30,NZ,Away,Upto 2014
SC Ganguly,IND,Pace,1999-01-02,Hamilton,New Zealand,1999,2,52,66,0,1,1002,1896,23,950,1830,23,43.56521739130435,>30,NZ,Away,Upto 2014
SC Ganguly,IND,Pace,1999-02-16,Eden Gardens,India,1999,1,9,30,0,1,539,1227,30,530,1197,30,17.966666666666665,<=30,IND,Home,Upto 2014
SC Ganguly,IND,Pace,1999-02-24,Colombo (SSC),Sri Lanka,1999,1,0,6,0,1,790,1434,9,790,1428,9,87.77777777777777,>30,SL,Away,Upto 2014
SC Ganguly,IND,Pace,1999-10-10,Mohali,India,1999,1,1,6,0,1,577,1368,20,576,1362,20,28.85,<=30,IND,Home,Upto 2014
SC Ganguly,IND,Pace,1999-10-22,Kanpur,India,1999,2,17,30,1,1,214,642,8,197,612,7,26.75,<=30,IND,Home,Upto 2014
SC Ganguly,IND,Pace,1999-10-29,Ahmedabad,India,1999,2,22,36,0,1,649,1266,11,627,1230,11,59.0,>30,IND,Home,Upto 2014
SC Ganguly,IND,Pace,1999-12-10,Adelaide,Australia,1999,1,34,42,1,1,755,1459,27,721,1417,26,27.962962962962962,<=30,AUS,Away,Upto 2014
SC Ganguly,IND,Pace,1999-12-26,Melbourne,Australia,1999,1,10,12,0,1,715,1451,26,705,1439,26,27.5,<=30,AUS,Away,Upto 2014
SC Ganguly,IND,Pace,2000-01-02,Sydney,Australia,2000,1,46,72,1,1,643,1127,22,597,1055,21,29.227272727272727,<=30,AUS,Away,Upto 2014
SC Ganguly,IND,Pace,2000-03-02,Bengaluru,India,2000,1,18,36,0,1,357,999,12,339,963,12,29.75,<=30,IND,Home,Upto 2014
SC Ganguly,IND,Pace,2000-11-18,Delhi,India,2000,1,26,48,0,1,620,1261,15,594,1213,15,41.333333333333336,>30,IND,Home,Upto 2014
SC Ganguly,IND,Pace,2000-11-25,Nagpur,India,2000,1,3,6,0,1,629,1195,8,626,1189,8,78.625,>30,IND,Home,Upto 2014
SC Ganguly,IND,Pace,2001-03-11,Eden Gardens,India,2001,2,46,86,1,1,800,1488,16,754,1402,15,50.0,>30,IND,Home,Upto 2014
SC Ganguly,IND,Pace,2001-03-18,Chennai,India,2001,2,19,18,0,1,331,733,10,312,715,10,33.1,>30,IND,Home,Upto 2014
SC Ganguly,IND,Pace,2001-06-07,Bulawayo,Zimbabwe,2001,1,3,6,0,1,658,1325,23,655,1319,23,28.608695652173914,<=30,ZIM,Away,Upto 2014
SC Ganguly,IND,Pace,2001-08-22,Kandy,Sri Lanka,2001,2,90,162,2,1,745,1357,27,655,1195,25,27.59259259259259,<=30,SL,Away,Upto 2014
SC Ganguly,IND,Pace,2001-08-29,Colombo (SSC),Sri Lanka,2001,1,44,75,0,1,542,1005,7,498,930,7,77.42857142857143,>30,SL,Away,Upto 2014
SC Ganguly,IND,Pace,2001-11-16,Gqeberha,South Africa,2001,2,38,42,0,1,644,1436,22,606,1394,22,29.272727272727273,<=30,SA,Away,Upto 2014
SC Ganguly,IND,Pace,2001-12-19,Bengaluru,India,2001,2,51,96,0,1,273,609,12,222,513,12,22.75,<=30,IND,Home,Upto 2014
SC Ganguly,IND,Pace,2002-04-11,Georgetown,West Indies,2002,1,2,12,0,1,506,1071,12,504,1059,12,42.166666666666664,>30,WI,Away,Upto 2014
SC Ganguly,IND,Pace,2002-05-02,Bridgetown,West Indies,2002,1,9,42,0,1,655,1356,22,646,1314,22,29.772727272727273,<=30,WI,Away,Upto 2014
SC Ganguly,IND,Pace,2002-05-10,St John's,West Indies,2002,1,44,72,0,1,856,1992,11,812,1920,11,77.81818181818181,>30,WI,Away,Upto 2014
SC Ganguly,IND,Pace,2002-05-18,Kingston,West Indies,2002,1,12,48,0,1,844,1737,30,832,1689,30,28.133333333333333,<=30,WI,Away,Upto 2014
SC Ganguly,IND,Pace,2002-07-25,Lord's,England,2002,1,16,18,0,1,837,1449,22,821,1431,22,38.04545454545455,>30,ENG,Away,Upto 2014
SC Ganguly,IND,Pace,2002-08-08,Nottingham,England,2002,1,42,30,0,1,996,1602,22,954,1572,22,45.27272727272727,>30,ENG,Away,Upto 2014
SC Ganguly,IND,Pace,2002-09-05,The Oval,England,2002,1,6,24,0,1,664,1200,10,658,1176,10,66.4,>30,ENG,Away,Upto 2014
SC Ganguly,IND,Pace,2002-12-12,Wellington,New Zealand,2002,1,11,12,0,1,505,1071,28,494,1059,28,18.035714285714285,<=30,NZ,Away,Upto 2014
SC Ganguly,IND,Pace,2003-12-04,Brisbane,Australia,2003,1,8,6,0,1,735,1213,18,727,1207,18,40.833333333333336,>30,AUS,Away,Upto 2014
SC Ganguly,IND,Pace,2004-01-02,Sydney,Australia,2004,1,0,6,0,1,876,1379,11,876,1373,11,79.63636363636364,>30,AUS,Away,Upto 2014
SC Ganguly,IND,Pace,2004-04-13,Rawalpindi,Pakistan,2004,2,27,36,0,1,687,1266,18,660,1230,18,38.166666666666664,>30,PAK,Away,Upto 2014
SC Ganguly,IND,Pace,2004-10-14,Chennai,India,2004,1,2,18,0,1,378,888,4,376,870,4,94.5,>30,IND,Home,Upto 2014
SC Ganguly,IND,Pace,2004-11-20,Kanpur,India,2004,1,45,72,1,1,487,976,10,442,904,9,48.7,>30,IND,Home,Upto 2014
SC Ganguly,IND,Pace,2004-11-28,Eden Gardens,India,2004,1,14,54,1,1,537,1338,17,523,1284,16,31.58823529411765,>30,IND,Home,Upto 2014
SC Ganguly,IND,Pace,2004-12-10,Dhaka,Bangladesh,2004,1,16,24,0,1,566,884,20,550,860,20,28.3,<=30,BAN,Away,Upto 2014
SC Ganguly,IND,Pace,2005-03-08,Mohali,India,2005,1,3,12,0,1,866,1468,17,863,1456,17,50.94117647058823,>30,IND,Home,Upto 2014
SC Ganguly,IND,Pace,2005-03-16,Eden Gardens,India,2005,1,12,12,0,1,678,1069,14,666,1057,14,48.42857142857143,>30,IND,Home,Upto 2014
SC Ganguly,IND,Pace,2005-03-24,Bengaluru,India,2005,1,13,24,0,1,604,960,8,591,936,8,75.5,>30,IND,Home,Upto 2014
SC Ganguly,IND,Pace,2005-09-13,Bulawayo,Zimbabwe,2005,1,0,6,0,1,492,794,18,492,788,18,27.333333333333332,<=30,ZIM,Away,Upto 2014
SC Ganguly,IND,Pace,2005-09-20,Harare,Zimbabwe,2005,2,18,30,0,1,559,997,27,541,967,27,20.703703703703702,<=30,ZIM,Away,Upto 2014
SC Ganguly,IND,Pace,2005-12-02,Chennai,India,2005,1,16,12,0,1,166,336,6,150,324,6,27.666666666666668,<=30,IND,Home,Upto 2014
SC Ganguly,IND,Pace,2006-01-13,Lahore,Pakistan,2006,1,14,36,0,1,476,638,4,462,602,4,119.0,>30,PAK,Away,Upto 2014
SC Ganguly,IND,Pace,2006-01-29,Karachi,Pakistan,2006,2,77,108,1,1,991,1398,31,914,1290,30,31.967741935483872,>30,PAK,Away,Upto 2014
SC Ganguly,IND,Pace,2006-12-15,Johannesburg,South Africa,2006,1,11,6,0,1,728,1389,33,717,1383,33,22.060606060606062,<=30,SA,Away,Upto 2014
SC Ganguly,IND,Pace,2006-12-26,Durban,South Africa,2006,1,11,18,0,1,879,1470,33,868,1452,33,26.636363636363637,<=30,SA,Away,Upto 2014
SC Ganguly,IND,Pace,2007-07-19,Lord's,England,2007,1,24,54,1,1,762,1573,34,738,1519,33,22.41176470588235,<=30,ENG,Away,Upto 2014
SC Ganguly,IND,Pace,2007-07-27,Nottingham,England,2007,2,33,84,1,1,762,1633,23,729,1549,22,33.130434782608695,>30,ENG,Away,Upto 2014
SC Ganguly,IND,Pace,2007-08-09,The Oval,England,2007,1,8,30,0,1,888,1674,23,880,1644,23,38.608695652173914,>30,ENG,Away,Upto 2014
SC Ganguly,IND,Pace,2007-11-22,Delhi,India,2007,2,48,138,3,1,485,979,16,437,841,13,30.3125,>30,IND,Home,Upto 2014
SC Ganguly,IND,Pace,2007-11-30,Eden Gardens,India,2007,1,9,24,0,1,574,936,5,565,912,5,114.8,>30,IND,Home,Upto 2014
SC Ganguly,IND,Pace,2007-12-08,Bengaluru,India,2007,1,20,60,1,1,758,1372,19,738,1312,18,39.89473684210526,>30,IND,Home,Upto 2014
SC Ganguly,IND,Pace,2007-12-26,Melbourne,Australia,2007,1,15,18,0,1,517,1047,21,502,1029,21,24.61904761904762,<=30,AUS,Away,Upto 2014
SC Ganguly,IND,Pace,2008-01-02,Sydney,Australia,2008,1,13,36,0,1,803,1292,17,790,1256,17,47.23529411764706,>30,AUS,Away,Upto 2014
SC Ganguly,IND,Pace,2008-01-24,Adelaide,Australia,2008,1,6,18,0,1,710,1457,17,704,1439,17,41.76470588235294,>30,AUS,Away,Upto 2014
SC Ganguly,IND,Pace,2008-03-26,Chennai,India,2008,2,13,30,0,1,691,1044,8,678,1014,8,86.375,>30,IND,Home,Upto 2014
SC Ganguly,IND,Pace,2008-04-03,Ahmedabad,India,2008,1,12,18,0,1,574,946,21,562,928,21,27.333333333333332,<=30,IND,Home,Upto 2014
SC Ganguly,IND,Pace,2008-07-23,Colombo (SSC),Sri Lanka,2008,1,24,48,0,1,421,648,5,397,600,5,84.2,>30,SL,Away,Upto 2014
SC Ganguly,IND,Pace,2008-08-08,Colombo (PSS),Sri Lanka,2008,2,15,19,0,1,381,610,11,366,591,11,34.63636363636363,>30,SL,Away,Upto 2014
SC Joseph,WI,Spin,2004-08-12,Manchester,England,2004,1,8,12,0,1,277,526,4,269,514,4,69.25,>30,ENG,Away,Upto 2014
SC Kerrigan,ENG,Spin,2013-08-21,The Oval,England,2013,1,53,48,0,1,310,576,4,257,528,4,77.5,>30,ENG,Home,Upto 2014
SC Kuggeleijn,NZ,Pace,2023-02-16,Mount Maunganui,New Zealand,2023,2,161,162,4,1,901,1216,34,740,1054,30,26.5,<=30,NZ,Home,After 1965
SC Kuggeleijn,NZ,Pace,2024-02-29,Wellington,New Zealand,2024,2,93,138,2,1,689,1266,22,596,1128,20,31.318181818181817,>30,NZ,Home,After 1965
SC Kuggeleijn,NZ,Pace,2024-03-08,Christchurch,New Zealand,2024,2,40,54,0,1,918,1490,33,878,1436,33,27.818181818181817,<=30,NZ,Home,After 1965
SC Stayers,WI,Pace,1962-02-16,Port of Spain,West Indies,1962,2,85,156,4,1,231,520,12,146,364,8,19.25,<=30,WI,Home,Upto 2014
SC Stayers,WI,Pace,1962-03-07,Kingston,West Indies,1962,2,101,198,1,1,392,737,11,291,539,10,35.63636363636363,>30,WI,Home,Upto 2014
SC Stayers,WI,Pace,1962-03-23,Bridgetown,West Indies,1962,2,105,174,3,1,296,666,7,191,492,4,42.285714285714285,>30,WI,Home,Upto 2014
SC Stayers,WI,Pace,1962-04-04,Port of Spain,West Indies,1962,2,73,108,1,1,296,552,7,223,444,6,42.285714285714285,>30,WI,Home,Upto 2014
SC Williams,WI,Spin,1997-04-04,St John's,West Indies,1997,1,19,18,0,1,268,532,5,249,514,5,53.6,>30,WI,Home,Upto 2014
SC Williams,ZIM,Spin,2013-03-20,Roseau,West Indies,2013,1,9,6,0,1,314,673,21,305,667,21,14.952380952380953,<=30,WI,Away,Upto 2014
SC Williams,ZIM,Spin,2014-08-09,Harare,Zimbabwe,2014,2,104,166,2,1,495,865,15,391,699,13,33.0,>30,ZIM,Home,After 1965
SC Williams,ZIM,Spin,2016-08-06,Bulawayo,Zimbabwe,2016,1,62,78,1,1,624,1160,15,562,1082,14,41.6,>30,ZIM,Home,After 1965
SC Williams,ZIM,Spin,2016-10-29,Harare,Zimbabwe,2016,2,59,108,1,1,573,1161,19,514,1053,18,30.157894736842106,>30,ZIM,Home,After 1965
SC Williams,ZIM,Spin,2016-11-06,Harare,Zimbabwe,2016,2,52,88,1,1,564,968,25,512,880,24,22.56,<=30,ZIM,Home,After 1965
SC Williams,ZIM,Spin,2017-07-14,Colombo (RPS),Sri Lanka,2017,2,208,401,4,1,1059,1917,28,851,1516,24,37.82142857142857,>30,SL,Away,After 1965
SC Williams,ZIM,Spin,2017-10-21,Bulawayo,Zimbabwe,2017,2,111,288,6,1,674,1311,28,563,1023,22,24.071428571428573,<=30,ZIM,Home,After 1965
SC Williams,ZIM,Spin,2018-11-03,Sylhet,Bangladesh,2018,2,18,72,1,1,549,1328,32,531,1256,31,17.15625,<=30,BAN,Away,After 1965
SC Williams,ZIM,Spin,2018-11-11,Mirpur,Bangladesh,2018,2,149,276,1,1,819,1414,17,670,1138,16,48.1764705882353,>30,BAN,Away,After 1965
SC Williams,ZIM,Spin,2020-01-19,Harare,Zimbabwe,2020,1,104,194,2,1,523,1058,12,419,864,10,43.583333333333336,>30,ZIM,Home,After 1965
SC Williams,ZIM,Spin,2020-01-27,Harare,Zimbabwe,2020,1,49,96,0,1,658,1179,17,609,1083,17,38.705882352941174,>30,ZIM,Home,After 1965
SC Williams,ZIM,Spin,2021-03-02,Abu Dhabi,UAE,2021,2,32,54,2,1,274,533,12,242,479,10,22.833333333333332,<=30,UAE,Away,After 1965
SC Williams,ZIM,Spin,2021-03-10,Abu Dhabi,UAE,2021,2,115,198,0,1,842,1766,20,727,1568,20,42.1,>30,UAE,Away,After 1965
SC Williams,ZIM,Spin,2024-07-25,Belfast,Northern Ireland,2024,2,32,61,2,1,127,307,10,95,246,8,12.7,<=30,Northern Ireland,Away,After 1965
SC Williams,ZIM,Spin,2024-12-26,Bulawayo,Zimbabwe,2024,1,145,270,2,1,1189,1856,20,1044,1586,18,59.45,>30,ZIM,Home,After 1965
SCG MacGill,AUS,Spin,1998-01-30,Adelaide,Australia,1998,2,134,216,5,1,384,731,9,250,515,4,42.666666666666664,>30,AUS,Home,Upto 2014
SCG MacGill,AUS,Spin,1998-10-01,Rawalpindi,Pakistan,1998,2,113,258,9,1,561,1319,19,448,1061,10,29.526315789473685,<=30,PAK,Away,Upto 2014
SCG MacGill,AUS,Spin,1998-10-15,Peshawar,Pakistan,1998,1,169,252,2,1,751,1422,7,582,1170,5,107.28571428571429,>30,PAK,Away,Upto 2014
SCG MacGill,AUS,Spin,1998-10-22,Karachi,Pakistan,1998,2,130,256,4,1,832,1892,24,702,1636,20,34.666666666666664,>30,PAK,Away,Upto 2014
SCG MacGill,AUS,Spin,1998-11-20,Brisbane,Australia,1998,2,121,276,4,1,328,690,9,207,414,5,36.44444444444444,>30,AUS,Home,Upto 2014
SCG MacGill,AUS,Spin,1998-12-11,Adelaide,Australia,1998,2,108,318,4,1,473,1152,14,365,834,10,33.785714285714285,>30,AUS,Home,Upto 2014
SCG MacGill,AUS,Spin,1998-12-26,Melbourne,Australia,1998,2,142,276,7,1,148,294,7,6,18,0,21.142857142857142,<=30,AUS,Home,Upto 2014
SCG MacGill,AUS,Spin,1999-01-02,Sydney,Australia,1999,2,107,242,12,1,526,1105,23,419,863,11,22.869565217391305,<=30,AUS,Home,Upto 2014
SCG MacGill,AUS,Spin,1999-03-05,Port of Spain,West Indies,1999,1,41,96,3,1,146,312,5,105,216,2,29.2,<=30,WI,Away,Upto 2014
SCG MacGill,AUS,Spin,1999-03-13,Kingston,West Indies,1999,1,84,135,3,1,346,591,10,262,456,7,34.6,>30,WI,Away,Upto 2014
SCG MacGill,AUS,Spin,1999-03-26,Bridgetown,West Indies,1999,2,95,246,1,1,408,819,7,313,573,6,58.285714285714285,>30,WI,Away,Upto 2014
SCG MacGill,AUS,Spin,1999-04-03,St John's,West Indies,1999,2,132,240,5,1,396,930,13,264,690,8,30.46153846153846,>30,WI,Away,Upto 2014
SCG MacGill,AUS,Spin,2000-11-23,Brisbane,Australia,2000,2,52,126,3,1,60,156,3,8,30,0,20.0,<=30,AUS,Home,Upto 2014
SCG MacGill,AUS,Spin,2000-12-01,W.A.C.A,Australia,2000,2,84,192,4,1,104,252,4,20,60,0,26.0,<=30,AUS,Home,Upto 2014
SCG MacGill,AUS,Spin,2000-12-15,Adelaide,Australia,2000,2,173,216,2,1,394,779,14,221,563,12,28.142857142857142,<=30,AUS,Home,Upto 2014
SCG MacGill,AUS,Spin,2001-01-02,Sydney,Australia,2001,2,192,402,7,1,641,1329,18,449,927,11,35.611111111111114,>30,AUS,Home,Upto 2014
SCG MacGill,AUS,Spin,2002-01-02,Sydney,Australia,2002,2,174,392,7,1,581,1150,17,407,758,10,34.1764705882353,>30,AUS,Home,Upto 2014
SCG MacGill,AUS,Spin,2002-12-26,Melbourne,Australia,2002,2,260,504,7,1,514,870,12,254,366,5,42.833333333333336,>30,AUS,Home,Upto 2014
SCG MacGill,AUS,Spin,2003-01-02,Sydney,Australia,2003,2,226,510,5,1,339,666,6,113,156,1,56.5,>30,AUS,Home,Upto 2014
SCG MacGill,AUS,Spin,2003-04-10,Georgetown,West Indies,2003,2,189,258,5,1,403,631,9,214,373,4,44.77777777777778,>30,WI,Away,Upto 2014
SCG MacGill,AUS,Spin,2003-04-19,Port of Spain,West Indies,2003,2,151,282,4,1,510,828,7,359,546,3,72.85714285714286,>30,WI,Away,Upto 2014
SCG MacGill,AUS,Spin,2003-05-01,Bridgetown,West Indies,2003,2,182,455,9,1,500,956,13,318,501,4,38.46153846153846,>30,WI,Away,Upto 2014
SCG MacGill,AUS,Spin,2003-05-09,St John's,West Indies,2003,2,156,230,2,1,401,650,6,245,420,4,66.83333333333333,>30,WI,Away,Upto 2014
SCG MacGill,AUS,Spin,2003-07-18,Darwin,Australia,2003,2,86,157,7,1,161,283,8,75,126,1,20.125,<=30,AUS,Home,Upto 2014
SCG MacGill,AUS,Spin,2003-07-25,Cairns,Australia,2003,2,133,264,10,1,356,572,12,223,308,2,29.666666666666668,<=30,AUS,Home,Upto 2014
SCG MacGill,AUS,Spin,2003-10-09,W.A.C.A,Australia,2003,2,64,148,2,1,603,903,11,539,755,9,54.81818181818182,>30,AUS,Home,Upto 2014
SCG MacGill,AUS,Spin,2003-12-04,Brisbane,Australia,2003,2,118,181,4,1,333,445,5,215,264,1,66.6,>30,AUS,Home,Upto 2014
SCG MacGill,AUS,Spin,2003-12-12,Adelaide,Australia,2003,2,244,412,4,1,609,1006,16,365,594,12,38.0625,>30,AUS,Home,Upto 2014
SCG MacGill,AUS,Spin,2003-12-26,Melbourne,Australia,2003,2,138,251,5,1,455,739,13,317,488,8,35.0,>30,AUS,Home,Upto 2014
SCG MacGill,AUS,Spin,2004-01-02,Sydney,Australia,2004,2,211,324,1,1,831,1277,14,620,953,13,59.357142857142854,>30,AUS,Home,Upto 2014
SCG MacGill,AUS,Spin,2004-03-08,Galle,Sri Lanka,2004,2,143,230,5,1,953,1791,32,810,1561,27,29.78125,<=30,SL,Away,Upto 2014
SCG MacGill,AUS,Spin,2004-03-16,Kandy,Sri Lanka,2004,2,89,102,0,1,537,881,19,448,779,19,28.263157894736842,<=30,SL,Away,Upto 2014
SCG MacGill,AUS,Spin,2005-01-02,Sydney,Australia,2005,2,170,282,8,1,684,1068,21,514,786,13,32.57142857142857,>30,AUS,Home,Upto 2014
SCG MacGill,AUS,Spin,2005-10-14,Sydney,Australia,2005,2,82,145,9,1,421,817,21,339,672,12,20.047619047619047,<=30,AUS,Home,Upto 2014
SCG MacGill,AUS,Spin,2005-11-17,Hobart,Australia,2005,2,87,222,5,1,310,697,10,223,475,5,31.0,>30,AUS,Home,Upto 2014
SCG MacGill,AUS,Spin,2005-11-25,Adelaide,Australia,2005,2,102,174,2,1,347,668,10,245,494,8,34.7,>30,AUS,Home,Upto 2014
SCG MacGill,AUS,Spin,2005-12-26,Melbourne,Australia,2005,2,69,186,2,1,426,859,14,357,673,12,30.428571428571427,>30,AUS,Home,Upto 2014
SCG MacGill,AUS,Spin,2006-01-02,Sydney,Australia,2006,2,135,210,4,1,507,813,9,372,603,5,56.333333333333336,>30,AUS,Home,Upto 2014
SCG MacGill,AUS,Spin,2006-04-09,Fatullah,Bangladesh,2006,2,138,279,9,1,739,1451,25,601,1172,16,29.56,<=30,BAN,Away,Upto 2014
SCG MacGill,AUS,Spin,2006-04-16,Chattogram,Bangladesh,2006,2,163,266,7,1,796,1393,18,633,1127,11,44.22222222222222,>30,BAN,Away,Upto 2014
SCG MacGill,AUS,Spin,2007-11-08,Brisbane,Australia,2007,2,143,300,2,1,370,696,6,227,396,4,61.666666666666664,>30,AUS,Home,Upto 2014
SCG MacGill,AUS,Spin,2007-11-16,Hobart,Australia,2007,2,183,270,3,1,453,768,6,270,498,3,75.5,>30,AUS,Home,Upto 2014
SCG MacGill,AUS,Spin,2008-05-22,Kingston,West Indies,2008,2,143,216,4,1,254,420,5,111,204,1,50.8,>30,WI,Away,Upto 2014
SCG MacGill,AUS,Spin,2008-05-30,North Sound,West Indies,2008,2,182,240,1,1,298,516,3,116,276,2,99.33333333333333,>30,WI,Away,Upto 2014
SCJ Broad,ENG,Pace,2007-12-09,Colombo (SSC),Sri Lanka,2007,1,95,216,1,1,676,1421,13,581,1205,12,52.0,>30,SL,Away,Upto 2014
SCJ Broad,ENG,Pace,2008-03-13,Wellington,New Zealand,2008,2,118,210,3,1,966,1899,38,848,1689,35,25.42105263157895,<=30,NZ,Away,Upto 2014
SCJ Broad,ENG,Pace,2008-03-22,Napier,New Zealand,2008,2,132,294,5,1,793,1402,23,661,1108,18,34.47826086956522,>30,NZ,Away,Upto 2014
SCJ Broad,ENG,Pace,2008-05-15,Lord's,England,2008,2,139,246,3,1,640,1330,19,501,1084,16,33.68421052631579,>30,ENG,Home,Upto 2014
SCJ Broad,ENG,Pace,2008-05-23,Manchester,England,2008,2,79,144,0,1,614,1172,16,535,1028,16,38.375,>30,ENG,Home,Upto 2014
SCJ Broad,ENG,Pace,2008-06-05,Nottingham,England,2008,2,87,162,4,1,579,1236,29,492,1074,25,19.96551724137931,<=30,ENG,Home,Upto 2014
SCJ Broad,ENG,Pace,2008-07-10,Lord's,England,2008,2,166,294,2,1,845,1704,13,679,1410,11,65.0,>30,ENG,Home,Upto 2014
SCJ Broad,ENG,Pace,2008-07-18,Leeds,England,2008,2,122,180,1,1,905,1732,27,783,1552,26,33.51851851851852,>30,ENG,Home,Upto 2014
SCJ Broad,ENG,Pace,2008-08-07,The Oval,England,2008,2,104,182,5,1,862,1540,26,758,1358,21,33.15384615384615,>30,ENG,Home,Upto 2014
SCJ Broad,ENG,Pace,2008-12-19,Mohali,India,2008,2,134,240,2,1,522,1070,12,388,830,10,43.5,>30,IND,Away,Upto 2014
SCJ Broad,ENG,Pace,2009-02-04,Kingston,West Indies,2009,1,85,174,5,1,444,1066,20,359,892,15,22.2,<=30,WI,Away,Upto 2014
SCJ Broad,ENG,Pace,2009-02-15,St John's,West Indies,2009,2,93,210,4,1,803,1574,19,710,1364,15,42.26315789473684,>30,WI,Away,Upto 2014
SCJ Broad,ENG,Pace,2009-02-26,Bridgetown,West Indies,2009,1,113,192,0,1,977,1508,9,864,1316,9,108.55555555555556,>30,WI,Away,Upto 2014
SCJ Broad,ENG,Pace,2009-03-06,Port of Spain,West Indies,2009,2,76,210,3,1,770,1390,15,694,1180,12,51.333333333333336,>30,WI,Away,Upto 2014
SCJ Broad,ENG,Pace,2009-05-06,Lord's,England,2009,2,120,182,5,1,625,1023,22,505,841,17,28.40909090909091,<=30,ENG,Home,Upto 2014
SCJ Broad,ENG,Pace,2009-05-14,Chester-le-Street,England,2009,2,83,126,3,1,746,1203,21,663,1077,18,35.523809523809526,>30,ENG,Home,Upto 2014
SCJ Broad,ENG,Pace,2009-07-08,Cardiff,England,2009,1,129,192,1,1,832,1434,18,703,1242,17,46.22222222222222,>30,ENG,Home,Upto 2014
SCJ Broad,ENG,Pace,2009-07-16,Lord's,England,2009,2,127,204,3,1,1009,1590,27,882,1386,24,37.370370370370374,>30,ENG,Home,Upto 2014
SCJ Broad,ENG,Pace,2009-07-30,Birmingham,England,2009,2,89,174,2,1,806,1353,22,717,1179,20,36.63636363636363,>30,ENG,Home,Upto 2014
SCJ Broad,ENG,Pace,2009-08-07,Leeds,England,2009,1,91,151,6,1,700,1101,30,609,950,24,23.333333333333332,<=30,ENG,Home,Upto 2014
SCJ Broad,ENG,Pace,2009-08-20,The Oval,England,2009,2,108,204,6,1,842,1408,23,734,1204,17,36.608695652173914,>30,ENG,Home,Upto 2014
SCJ Broad,ENG,Pace,2009-12-16,Centurion,South Africa,2009,2,132,288,3,1,848,1757,22,716,1469,19,38.54545454545455,>30,SA,Away,Upto 2014
SCJ Broad,ENG,Pace,2009-12-26,Durban,South Africa,2009,2,87,222,6,1,616,1251,15,529,1029,9,41.06666666666667,>30,SA,Away,Upto 2014
SCJ Broad,ENG,Pace,2010-01-03,Cape Town,South Africa,2010,2,133,246,1,1,868,1767,26,735,1521,25,33.38461538461539,>30,SA,Away,Upto 2014
SCJ Broad,ENG,Pace,2010-01-14,Johannesburg,South Africa,2010,1,83,174,3,1,644,1109,23,561,935,20,28.0,<=30,SA,Away,Upto 2014
SCJ Broad,ENG,Pace,2010-03-12,Chattogram,Bangladesh,2010,2,135,270,3,1,497,924,10,362,654,7,49.7,>30,BAN,Away,Upto 2014
SCJ Broad,ENG,Pace,2010-03-20,Mirpur,Bangladesh,2010,2,141,204,3,1,503,828,9,362,624,6,55.888888888888886,>30,BAN,Away,Upto 2014
SCJ Broad,ENG,Pace,2010-07-29,Nottingham,England,2010,2,82,150,3,1,558,1225,33,476,1075,30,16.90909090909091,<=30,ENG,Home,Upto 2014
SCJ Broad,ENG,Pace,2010-08-06,Birmingham,England,2010,2,104,275,6,1,468,1160,20,364,885,14,23.4,<=30,ENG,Home,Upto 2014
SCJ Broad,ENG,Pace,2010-08-18,The Oval,England,2010,2,107,186,2,1,645,1152,22,538,966,20,29.318181818181817,<=30,ENG,Home,Upto 2014
SCJ Broad,ENG,Pace,2010-08-26,Lord's,England,2010,2,34,72,3,1,413,794,18,379,722,15,22.944444444444443,<=30,ENG,Home,Upto 2014
SCJ Broad,ENG,Pace,2010-11-25,Brisbane,Australia,2010,2,90,240,1,1,947,1750,17,857,1510,16,55.705882352941174,>30,AUS,Away,Upto 2014
SCJ Broad,ENG,Pace,2010-12-03,Adelaide,Australia,2010,2,71,179,1,1,745,1313,14,674,1134,13,53.214285714285715,>30,AUS,Away,Upto 2014
SCJ Broad,ENG,Pace,2011-05-26,Cardiff,England,2011,2,134,244,4,1,591,1108,14,457,864,10,42.214285714285715,>30,ENG,Home,Upto 2014
SCJ Broad,ENG,Pace,2011-06-03,Lord's,England,2011,2,154,246,2,1,1032,1597,21,878,1351,19,49.142857142857146,>30,ENG,Home,Upto 2014
SCJ Broad,ENG,Pace,2011-06-16,Southampton,England,2011,2,102,224,2,1,719,1308,21,617,1084,19,34.23809523809524,>30,ENG,Home,Upto 2014
SCJ Broad,ENG,Pace,2011-07-21,Lord's,England,2011,2,94,255,7,1,813,1712,30,719,1457,23,27.1,<=30,ENG,Home,Upto 2014
SCJ Broad,ENG,Pace,2011-07-29,Nottingham,England,2011,2,76,233,8,1,899,1645,37,823,1412,29,24.2972972972973,<=30,ENG,Home,Upto 2014
SCJ Broad,ENG,Pace,2011-08-10,Birmingham,England,2011,2,81,174,6,1,731,1272,20,650,1098,14,36.55,>30,ENG,Home,Upto 2014
SCJ Broad,ENG,Pace,2011-08-18,The Oval,England,2011,2,95,246,4,1,633,1206,15,538,960,11,42.2,>30,ENG,Home,Upto 2014
SCJ Broad,ENG,Pace,2012-01-17,Dubai (DICS),UAE,2012,2,92,196,3,1,389,864,11,297,668,8,35.36363636363637,>30,UAE,Away,Upto 2014
SCJ Broad,ENG,Pace,2012-01-25,Abu Dhabi,UAE,2012,2,83,264,5,1,271,622,9,188,358,4,30.11111111111111,>30,UAE,Away,Upto 2014
SCJ Broad,ENG,Pace,2012-02-03,Dubai (DICS),UAE,2012,2,91,240,5,1,298,715,15,207,475,10,19.866666666666667,<=30,UAE,Away,Upto 2014
SCJ Broad,ENG,Pace,2012-03-26,Galle,Sri Lanka,2012,2,104,192,2,1,355,636,9,251,444,7,39.44444444444444,>30,SL,Away,Upto 2014
SCJ Broad,ENG,Pace,2012-05-17,Lord's,England,2012,2,165,353,11,1,939,1916,29,774,1563,18,32.37931034482759,>30,ENG,Home,Upto 2014
SCJ Broad,ENG,Pace,2012-05-25,Nottingham,England,2012,2,139,264,3,1,765,1507,24,626,1243,21,31.875,>30,ENG,Home,Upto 2014
SCJ Broad,ENG,Pace,2012-07-19,The Oval,England,2012,1,118,204,0,1,900,1787,18,782,1583,18,50.0,>30,ENG,Home,Upto 2014
SCJ Broad,ENG,Pace,2012-08-02,Leeds,England,2012,2,165,310,8,1,982,1920,23,817,1610,15,42.69565217391305,>30,ENG,Home,Upto 2014
SCJ Broad,ENG,Pace,2012-08-16,Lord's,England,2012,2,154,270,3,1,927,1840,33,773,1570,30,28.09090909090909,<=30,ENG,Home,Upto 2014
SCJ Broad,ENG,Pace,2012-11-15,Ahmedabad,India,2012,1,97,144,0,1,421,867,8,324,723,8,52.625,>30,IND,Away,Upto 2014
SCJ Broad,ENG,Pace,2012-11-23,Wankhede,India,2012,1,60,72,0,1,167,294,1,107,222,1,167.0,>30,IND,Away,Upto 2014
SCJ Broad,ENG,Pace,2013-03-06,Dunedin,New Zealand,2013,1,118,168,3,1,764,1468,18,646,1300,15,42.44444444444444,>30,NZ,Away,Upto 2014
SCJ Broad,ENG,Pace,2013-03-14,Wellington,New Zealand,2013,2,83,188,6,1,612,1184,15,529,996,9,40.8,>30,NZ,Away,Upto 2014
SCJ Broad,ENG,Pace,2013-03-22,Auckland,New Zealand,2013,2,148,282,2,1,822,1793,28,674,1511,26,29.357142857142858,<=30,NZ,Away,Upto 2014
SCJ Broad,ENG,Pace,2013-05-16,Lord's,England,2013,2,108,192,8,1,569,1283,36,461,1091,28,15.805555555555555,<=30,ENG,Home,Upto 2014
SCJ Broad,ENG,Pace,2013-05-24,Leeds,England,2013,2,83,156,4,1,701,1279,21,618,1123,17,33.38095238095238,>30,ENG,Home,Upto 2014
SCJ Broad,ENG,Pace,2013-07-10,Nottingham,England,2013,2,94,179,3,1,827,1665,33,733,1486,30,25.060606060606062,<=30,ENG,Home,Upto 2014
SCJ Broad,ENG,Pace,2013-07-18,Lord's,England,2013,2,80,192,1,1,669,1424,21,589,1232,20,31.857142857142858,>30,ENG,Home,Upto 2014
SCJ Broad,ENG,Pace,2013-08-01,Manchester,England,2013,2,138,240,2,1,710,1434,19,572,1194,17,37.36842105263158,>30,ENG,Home,Upto 2014
SCJ Broad,ENG,Pace,2013-08-09,Chester-le-Street,England,2013,2,121,258,11,1,823,1578,29,702,1320,18,28.379310344827587,<=30,ENG,Home,Upto 2014
SCJ Broad,ENG,Pace,2013-08-21,The Oval,England,2013,2,171,246,5,1,836,1443,25,665,1197,20,33.44,>30,ENG,Home,Upto 2014
SCJ Broad,ENG,Pace,2013-11-21,Brisbane,Australia,2013,2,136,240,8,1,625,1326,30,489,1086,22,20.833333333333332,<=30,AUS,Away,Upto 2014
SCJ Broad,ENG,Pace,2013-12-05,Adelaide,Australia,2013,2,117,216,3,1,606,1290,25,489,1074,22,24.24,<=30,AUS,Away,Upto 2014
SCJ Broad,ENG,Pace,2013-12-13,W.A.C.A,Australia,2013,1,100,132,3,1,995,1739,27,895,1607,24,36.851851851851855,>30,AUS,Away,Upto 2014
SCJ Broad,ENG,Pace,2013-12-26,Melbourne,Australia,2013,2,103,180,3,1,653,1410,24,550,1230,21,27.208333333333332,<=30,AUS,Away,Upto 2014
SCJ Broad,ENG,Pace,2014-01-03,Sydney,Australia,2014,2,122,203,4,1,663,1122,33,541,919,29,20.09090909090909,<=30,AUS,Away,After 1965
SCJ Broad,ENG,Pace,2014-06-12,Lord's,England,2014,2,110,300,4,1,1099,1996,30,989,1696,26,36.63333333333333,>30,ENG,Home,After 1965
SCJ Broad,ENG,Pace,2014-06-20,Leeds,England,2014,2,132,264,3,1,1059,2060,34,927,1796,31,31.147058823529413,>30,ENG,Home,After 1965
SCJ Broad,ENG,Pace,2014-07-09,Nottingham,England,2014,2,103,324,4,1,984,1979,23,881,1655,19,42.78260869565217,>30,ENG,Home,After 1965
SCJ Broad,ENG,Pace,2014-07-17,Lord's,England,2014,2,172,270,3,1,890,1823,32,718,1553,29,27.8125,<=30,ENG,Home,After 1965
SCJ Broad,ENG,Pace,2014-07-27,Southampton,England,2014,2,88,228,3,1,815,1573,15,727,1345,12,54.333333333333336,>30,ENG,Home,After 1965
SCJ Broad,ENG,Pace,2014-08-07,Manchester,England,2014,1,25,82,6,1,546,928,23,521,846,17,23.73913043478261,<=30,ENG,Home,After 1965
SCJ Broad,ENG,Pace,2014-08-15,The Oval,England,2014,2,49,151,3,1,613,1107,25,564,956,22,24.52,<=30,ENG,Home,After 1965
SCJ Broad,ENG,Pace,2015-04-13,North Sound,West Indies,2015,2,128,258,3,1,886,1696,22,758,1438,19,40.27272727272727,>30,WI,Away,After 1965
SCJ Broad,ENG,Pace,2015-04-21,St George's,West Indies,2015,2,132,270,5,1,731,1499,18,599,1229,13,40.611111111111114,>30,WI,Away,After 1965
SCJ Broad,ENG,Pace,2015-05-01,Bridgetown,West Indies,2015,2,60,138,2,1,388,896,26,328,758,24,14.923076923076923,<=30,WI,Away,After 1965
SCJ Broad,ENG,Pace,2015-05-21,Lord's,England,2015,2,127,257,6,1,1185,2044,33,1058,1787,27,35.90909090909091,>30,ENG,Home,After 1965
SCJ Broad,ENG,Pace,2015-05-29,Leeds,England,2015,2,203,199,7,1,1058,1587,28,855,1388,21,37.785714285714285,>30,ENG,Home,After 1965
SCJ Broad,ENG,Pace,2015-07-08,Cardiff,England,2015,2,99,186,5,1,901,1488,27,802,1302,22,33.370370370370374,>30,ENG,Home,After 1965
SCJ Broad,ENG,Pace,2015-07-16,Lord's,England,2015,2,125,210,4,1,791,1369,21,666,1159,17,37.666666666666664,>30,ENG,Home,After 1965
SCJ Broad,ENG,Pace,2015-07-29,Birmingham,England,2015,2,105,192,3,1,619,1035,28,514,843,25,22.107142857142858,<=30,ENG,Home,After 1965
SCJ Broad,ENG,Pace,2015-08-06,Nottingham,England,2015,2,51,153,9,1,542,945,29,491,792,20,18.689655172413794,<=30,ENG,Home,After 1965
SCJ Broad,ENG,Pace,2015-08-20,The Oval,England,2015,1,59,120,0,1,638,1293,22,579,1173,22,29.0,<=30,ENG,Home,After 1965
SCJ Broad,ENG,Pace,2015-10-13,Abu Dhabi,UAE,2015,2,52,174,1,1,582,1249,16,530,1075,15,36.375,>30,UAE,Away,After 1965
SCJ Broad,ENG,Pace,2015-10-22,Dubai (DICS),UAE,2015,2,82,162,1,1,554,1207,19,472,1045,18,29.157894736842106,<=30,UAE,Away,After 1965
SCJ Broad,ENG,Pace,2015-11-01,Sharjah,UAE,2015,2,57,216,5,1,278,841,14,221,625,9,19.857142857142858,<=30,UAE,Away,After 1965
SCJ Broad,ENG,Pace,2015-12-26,Durban,South Africa,2015,2,54,168,5,1,593,1392,27,539,1224,22,21.962962962962962,<=30,SA,Away,After 1965
SCJ Broad,ENG,Pace,2016-01-02,Cape Town,South Africa,2016,1,94,204,2,1,994,1661,14,900,1457,12,71.0,>30,SA,Away,After 1965
SCJ Broad,ENG,Pace,2016-01-14,Johannesburg,South Africa,2016,2,99,205,8,1,692,1271,29,593,1066,21,23.862068965517242,<=30,SA,Away,After 1965
SCJ Broad,ENG,Pace,2016-01-22,Centurion,South Africa,2016,2,124,258,3,1,827,1592,31,703,1334,28,26.677419354838708,<=30,SA,Away,After 1965
SCJ Broad,ENG,Pace,2016-05-19,Leeds,England,2016,2,78,138,5,1,468,901,27,390,763,22,17.333333333333332,<=30,ENG,Home,After 1965
SCJ Broad,ENG,Pace,2016-05-27,Chester-le-Street,England,2016,2,111,222,5,1,773,1433,25,662,1211,20,30.92,>30,ENG,Home,After 1965
SCJ Broad,ENG,Pace,2016-06-09,Lord's,England,2016,2,106,204,2,1,770,1481,24,664,1277,22,32.083333333333336,>30,ENG,Home,After 1965
SCJ Broad,ENG,Pace,2016-07-14,Lord's,England,2016,2,109,279,6,1,760,1521,27,651,1242,21,28.14814814814815,<=30,ENG,Home,After 1965
SCJ Broad,ENG,Pace,2016-07-22,Manchester,England,2016,2,57,156,1,1,705,1279,22,648,1123,21,32.04545454545455,>30,ENG,Home,After 1965
SCJ Broad,ENG,Pace,2016-08-03,Birmingham,England,2016,2,107,270,5,1,912,1860,29,805,1590,24,31.448275862068964,>30,ENG,Home,After 1965
SCJ Broad,ENG,Pace,2016-08-11,The Oval,England,2016,1,99,174,1,1,784,1374,21,685,1200,20,37.333333333333336,>30,ENG,Home,After 1965
SCJ Broad,ENG,Pace,2016-10-20,Chattogram,Bangladesh,2016,2,43,138,2,1,222,543,9,179,405,7,24.666666666666668,<=30,BAN,Away,After 1965
SCJ Broad,ENG,Pace,2016-11-09,Rajkot,India,2016,2,86,192,1,1,455,1020,7,369,828,6,65.0,>30,IND,Away,After 1965
SCJ Broad,ENG,Pace,2016-11-17,Visakhapatnam,India,2016,2,82,180,5,1,406,876,14,324,696,9,29.0,<=30,IND,Away,After 1965
SCJ Broad,ENG,Pace,2016-12-16,Chennai,India,2016,1,80,162,2,1,437,846,9,357,684,7,48.55555555555556,>30,IND,Away,After 1965
SCJ Broad,ENG,Pace,2017-07-06,Lord's,England,2017,2,67,126,2,1,720,1257,22,653,1131,20,32.72727272727273,>30,ENG,Home,After 1965
SCJ Broad,ENG,Pace,2017-07-14,Nottingham,England,2017,2,124,246,3,1,739,1395,28,615,1149,25,26.392857142857142,<=30,ENG,Home,After 1965
SCJ Broad,ENG,Pace,2017-07-27,The Oval,England,2017,2,91,186,2,1,850,1584,29,759,1398,27,29.310344827586206,<=30,ENG,Home,After 1965
SCJ Broad,ENG,Pace,2017-08-04,Manchester,England,2017,2,70,169,4,1,698,1268,30,628,1099,26,23.266666666666666,<=30,ENG,Home,After 1965
SCJ Broad,ENG,Pace,2017-08-17,Birmingham,England,2017,2,81,156,5,1,610,1081,19,529,925,14,32.10526315789474,>30,ENG,Home,After 1965
SCJ Broad,ENG,Pace,2017-08-25,Leeds,England,2017,2,186,294,2,1,1027,1807,24,841,1513,22,42.791666666666664,>30,ENG,Home,After 1965
SCJ Broad,ENG,Pace,2017-09-07,Lord's,England,2017,2,59,186,2,1,490,1083,30,431,897,28,16.333333333333332,<=30,ENG,Home,After 1965
SCJ Broad,ENG,Pace,2017-11-23,Brisbane,Australia,2017,2,69,210,3,1,713,1568,21,644,1358,18,33.95238095238095,>30,AUS,Away,After 1965
SCJ Broad,ENG,Pace,2017-12-02,Adelaide,Australia,2017,2,98,258,2,1,779,1712,31,681,1454,29,25.129032258064516,<=30,AUS,Away,After 1965
SCJ Broad,ENG,Pace,2017-12-14,W.A.C.A,Australia,2017,1,142,210,0,1,965,1713,24,823,1503,24,40.208333333333336,>30,AUS,Away,After 1965
SCJ Broad,ENG,Pace,2017-12-26,Melbourne,Australia,2017,2,95,312,5,1,816,1807,20,721,1495,15,40.8,>30,AUS,Away,After 1965
SCJ Broad,ENG,Pace,2018-01-04,Sydney,Australia,2018,1,121,180,1,1,630,1294,17,509,1114,16,37.05882352941177,>30,AUS,Away,After 1965
SCJ Broad,ENG,Pace,2018-03-22,Auckland,New Zealand,2018,1,78,204,3,1,669,1504,24,591,1300,21,27.875,<=30,NZ,Away,After 1965
SCJ Broad,ENG,Pace,2018-03-30,Christchurch,New Zealand,2018,2,126,279,8,1,933,2022,34,807,1743,26,27.441176470588236,<=30,NZ,Away,After 1965
SCJ Broad,ENG,Pace,2018-05-24,Lord's,England,2018,2,74,168,1,1,631,1332,28,557,1164,27,22.535714285714285,<=30,ENG,Home,After 1965
SCJ Broad,ENG,Pace,2018-06-01,Leeds,England,2018,2,66,162,6,1,552,1035,26,486,873,20,21.23076923076923,<=30,ENG,Home,After 1965
SCJ Broad,ENG,Pace,2018-08-01,Birmingham,England,2018,2,83,144,2,1,700,1284,29,617,1140,27,24.137931034482758,<=30,ENG,Home,After 1965
SCJ Broad,ENG,Pace,2018-08-09,Lord's,England,2018,2,81,156,5,1,483,867,26,402,711,21,18.576923076923077,<=30,ENG,Home,After 1965
SCJ Broad,ENG,Pace,2018-08-18,Nottingham,England,2018,2,132,246,3,1,905,1711,32,773,1465,29,28.28125,<=30,ENG,Home,After 1965
SCJ Broad,ENG,Pace,2018-08-30,Southampton,England,2018,2,86,173,4,1,624,1317,26,538,1144,22,24.0,<=30,ENG,Home,After 1965
SCJ Broad,ENG,Pace,2018-09-07,The Oval,England,2018,2,93,192,2,1,781,1629,21,688,1437,19,37.19047619047619,>30,ENG,Home,After 1965
SCJ Broad,ENG,Pace,2018-11-23,Colombo (SSC),Sri Lanka,2018,2,50,84,0,1,145,276,4,95,192,4,36.25,>30,SL,Away,After 1965
SCJ Broad,ENG,Pace,2019-01-31,North Sound,West Indies,2019,2,59,222,3,1,523,1214,27,464,992,24,19.37037037037037,<=30,WI,Away,After 1965
SCJ Broad,ENG,Pace,2019-02-09,Gros Islet,West Indies,2019,2,64,174,1,1,684,1370,27,620,1196,26,25.333333333333332,<=30,WI,Away,After 1965
SCJ Broad,ENG,Pace,2019-07-24,Lord's,England,2019,2,79,162,7,1,515,949,38,436,787,31,13.552631578947368,<=30,ENG,Home,After 1965
SCJ Broad,ENG,Pace,2019-08-01,Birmingham,England,2019,2,177,268,6,1,758,1453,25,581,1185,19,30.32,>30,ENG,Home,After 1965
SCJ Broad,ENG,Pace,2019-08-14,Lord's,England,2019,2,94,207,4,1,589,1275,24,495,1068,20,24.541666666666668,<=30,ENG,Home,After 1965
SCJ Broad,ENG,Pace,2019-08-22,Leeds,England,2019,2,84,180,4,1,629,1344,34,545,1164,30,18.5,<=30,ENG,Home,After 1965
SCJ Broad,ENG,Pace,2019-09-04,Manchester,England,2019,2,151,234,5,1,783,1519,27,632,1285,22,29.0,<=30,ENG,Home,After 1965
SCJ Broad,ENG,Pace,2019-09-12,The Oval,England,2019,2,107,162,4,1,856,1530,30,749,1368,26,28.533333333333335,<=30,ENG,Home,After 1965
SCJ Broad,ENG,Pace,2019-11-21,Mount Maunganui,New Zealand,2019,1,64,198,0,1,805,1856,23,741,1658,23,35.0,>30,NZ,Away,After 1965
SCJ Broad,ENG,Pace,2019-11-29,Hamilton,New Zealand,2019,2,101,222,4,1,881,1878,20,780,1656,16,44.05,>30,NZ,Away,After 1965
SCJ Broad,ENG,Pace,2019-12-26,Centurion,South Africa,2019,2,100,177,5,1,888,1593,38,788,1416,33,23.36842105263158,<=30,SA,Away,After 1965
SCJ Broad,ENG,Pace,2020-01-03,Cape Town,South Africa,2020,2,75,246,3,1,689,1635,31,614,1389,28,22.225806451612904,<=30,SA,Away,After 1965
SCJ Broad,ENG,Pace,2020-01-16,Gqeberha,South Africa,2020,2,44,142,4,1,517,1029,13,473,887,9,39.76923076923077,>30,SA,Away,After 1965
SCJ Broad,ENG,Pace,2020-01-24,Johannesburg,South Africa,2020,2,53,144,2,1,1022,1773,39,969,1629,37,26.205128205128204,<=30,SA,Away,After 1965
SCJ Broad,ENG,Pace,2020-07-16,Manchester,England,2020,2,108,228,6,1,747,1583,23,639,1355,17,32.47826086956522,>30,ENG,Home,After 1965
SCJ Broad,ENG,Pace,2020-07-24,Manchester,England,2020,2,67,133,10,1,625,1206,27,558,1073,17,23.14814814814815,<=30,ENG,Home,After 1965
SCJ Broad,ENG,Pace,2020-08-05,Manchester,England,2020,2,91,195,6,1,609,1268,24,518,1073,18,25.375,<=30,ENG,Home,After 1965
SCJ Broad,ENG,Pace,2020-08-13,Southampton,England,2020,1,56,164,4,1,292,740,12,236,576,8,24.333333333333332,<=30,ENG,Home,After 1965
SCJ Broad,ENG,Pace,2020-08-21,Southampton,England,2020,2,67,205,3,1,619,1361,14,552,1156,11,44.214285714285715,>30,ENG,Home,After 1965
SCJ Broad,ENG,Pace,2021-01-14,Galle,Sri Lanka,2021,2,34,156,3,1,215,534,7,181,378,4,30.714285714285715,>30,SL,Away,After 1965
SCJ Broad,ENG,Pace,2021-02-13,Chennai,India,2021,2,62,120,0,1,192,382,7,130,262,7,27.428571428571427,<=30,IND,Away,After 1965
SCJ Broad,ENG,Pace,2021-02-24,Ahmedabad,India,2021,1,16,36,0,1,124,228,2,108,192,2,62.0,>30,IND,Away,After 1965
SCJ Broad,ENG,Pace,2021-06-02,Lord's,England,2021,2,113,234,1,1,792,1822,27,679,1588,26,29.333333333333332,<=30,ENG,Home,After 1965
SCJ Broad,ENG,Pace,2021-06-10,Birmingham,England,2021,2,61,163,5,1,672,1387,27,611,1224,22,24.88888888888889,<=30,ENG,Home,After 1965
SCJ Broad,ENG,Pace,2021-08-04,Nottingham,England,2021,2,88,150,1,1,737,1406,30,649,1256,29,24.566666666666666,<=30,ENG,Home,After 1965
SCJ Broad,ENG,Pace,2021-12-16,Adelaide,Australia,2021,2,100,216,2,1,845,1824,27,745,1608,25,31.296296296296298,>30,AUS,Away,After 1965
SCJ Broad,ENG,Pace,2022-01-05,Sydney,Australia,2022,2,132,240,5,1,798,1621,23,666,1381,18,34.69565217391305,>30,AUS,Away,After 1965
SCJ Broad,ENG,Pace,2022-01-14,Hobart,Australia,2022,2,110,256,6,1,700,1252,39,590,996,33,17.94871794871795,<=30,AUS,Away,After 1965
SCJ Broad,ENG,Pace,2022-06-02,Lord's,England,2022,2,121,234,4,1,722,1408,33,601,1174,29,21.87878787878788,<=30,ENG,Home,After 1965
SCJ Broad,ENG,Pace,2022-06-10,Nottingham,England,2022,2,177,276,5,1,1254,1921,26,1077,1645,21,48.23076923076923,>30,ENG,Home,After 1965
SCJ Broad,ENG,Pace,2022-06-23,Leeds,England,2022,2,125,282,3,1,862,1428,19,737,1146,16,45.36842105263158,>30,ENG,Home,After 1965
SCJ Broad,ENG,Pace,2022-07-01,Birmingham,England,2022,2,147,204,3,1,1049,1525,30,902,1321,27,34.96666666666667,>30,ENG,Home,After 1965
SCJ Broad,ENG,Pace,2022-08-17,Lord's,England,2022,1,71,115,3,1,531,875,27,460,760,24,19.666666666666668,<=30,ENG,Home,After 1965
SCJ Broad,ENG,Pace,2022-08-25,Manchester,England,2022,2,61,144,4,1,514,991,25,453,847,21,20.56,<=30,ENG,Home,After 1965
SCJ Broad,ENG,Pace,2022-09-08,The Oval,England,2022,2,86,152,7,1,547,897,31,461,745,24,17.64516129032258,<=30,ENG,Home,After 1965
SCJ Broad,ENG,Pace,2023-02-16,Mount Maunganui,New Zealand,2023,2,121,192,5,1,901,1216,34,780,1024,29,26.5,<=30,NZ,Away,After 1965
SCJ Broad,ENG,Pace,2023-02-24,Wellington,New Zealand,2023,2,140,230,5,1,965,1553,25,825,1323,20,38.6,>30,NZ,Away,After 1965
SCJ Broad,ENG,Pace,2023-06-01,Lord's,England,2023,2,113,188,6,1,757,1010,16,644,822,10,47.3125,>30,ENG,Home,After 1965
SCJ Broad,ENG,Pace,2023-06-16,Birmingham,England,2023,2,132,264,6,1,808,1386,24,676,1122,18,33.666666666666664,>30,ENG,Home,After 1965
SCJ Broad,ENG,Pace,2023-06-28,Lord's,England,2023,2,164,287,5,1,1187,1964,35,1023,1677,30,33.91428571428571,>30,ENG,Home,After 1965
SCJ Broad,ENG,Pace,2023-07-06,Leeds,England,2023,2,103,155,5,1,803,1163,34,700,1008,29,23.61764705882353,<=30,ENG,Home,After 1965
SCJ Broad,ENG,Pace,2023-07-19,Manchester,England,2023,2,115,156,2,1,889,1350,23,774,1194,21,38.65217391304348,>30,ENG,Home,After 1965
SCJ Broad,ENG,Pace,2023-07-27,The Oval,England,2023,2,111,244,4,1,971,1598,29,860,1354,25,33.48275862068966,>30,ENG,Home,After 1965
SD Anurasiri,SL,Spin,1986-03-14,Colombo (CCC),Sri Lanka,1986,2,12,24,0,1,54,96,0,42,72,0,inf,>30,SL,Home,Upto 2014
SD Anurasiri,SL,Spin,1986-03-22,Colombo (PSS),Sri Lanka,1986,1,9,90,0,1,135,371,2,126,281,2,67.5,>30,SL,Home,Upto 2014
SD Anurasiri,SL,Spin,1987-01-04,Cuttack,India,1987,1,71,156,4,1,354,865,18,283,709,14,19.666666666666668,<=30,IND,Away,Upto 2014
SD Anurasiri,SL,Spin,1987-04-16,Colombo (CCC),Sri Lanka,1987,1,67,216,1,1,223,696,4,156,480,3,55.75,>30,SL,Home,Upto 2014
SD Anurasiri,SL,Spin,1991-08-22,Lord's,England,1991,2,180,319,5,1,298,574,10,118,255,5,29.8,<=30,ENG,Away,Upto 2014
SD Anurasiri,SL,Spin,1991-12-12,Sialkot,Pakistan,1991,1,106,366,3,1,197,606,6,91,240,3,32.833333333333336,>30,PAK,Away,Upto 2014
SD Anurasiri,SL,Spin,1991-12-20,Gujranwala,Pakistan,1991,1,2,6,0,1,2,6,0,0,0,0,inf,>30,PAK,Away,Upto 2014
SD Anurasiri,SL,Spin,1992-01-02,Faisalabad,Pakistan,1992,2,46,96,0,1,46,96,0,0,0,0,inf,>30,PAK,Away,Upto 2014
SD Anurasiri,SL,Spin,1992-08-17,Colombo (SSC),Sri Lanka,1992,2,149,282,5,1,598,1075,17,449,793,12,35.1764705882353,>30,SL,Home,Upto 2014
SD Anurasiri,SL,Spin,1992-08-28,Colombo (RPS),Sri Lanka,1992,2,83,312,3,1,357,918,7,274,606,4,51.0,>30,SL,Home,Upto 2014
SD Anurasiri,SL,Spin,1992-09-08,Moratuwa,Sri Lanka,1992,2,106,306,2,1,347,775,4,241,469,2,86.75,>30,SL,Home,Upto 2014
SD Anurasiri,SL,Spin,1992-11-27,Moratuwa,Sri Lanka,1992,2,87,360,4,1,176,750,7,89,390,3,25.142857142857142,<=30,SL,Home,Upto 2014
SD Anurasiri,SL,Spin,1992-12-06,Colombo (SSC),Sri Lanka,1992,2,67,168,2,1,505,1022,18,438,854,16,28.055555555555557,<=30,SL,Home,Upto 2014
SD Anurasiri,SL,Spin,1993-12-08,Moratuwa,Sri Lanka,1993,1,77,210,3,1,241,659,12,164,449,9,20.083333333333332,<=30,SL,Home,Upto 2014
SD Anurasiri,SL,Spin,1994-01-18,Lucknow,India,1994,1,147,348,2,1,633,1538,23,486,1190,21,27.52173913043478,<=30,IND,Away,Upto 2014
SD Anurasiri,SL,Spin,1994-01-26,Bengaluru,India,1994,1,158,270,1,1,625,1188,15,467,918,14,41.666666666666664,>30,IND,Away,Upto 2014
SD Anurasiri,SL,Spin,1994-02-08,Ahmedabad,India,1994,1,75,168,2,1,473,1433,26,398,1265,24,18.192307692307693,<=30,IND,Away,Upto 2014
SD Anurasiri,SL,Spin,1998-01-14,Colombo (SSC),Sri Lanka,1998,2,106,276,4,1,688,1695,18,582,1419,14,38.22222222222222,>30,SL,Home,Upto 2014
SD Jack,SA,Pace,1994-12-26,Durban,South Africa,1994,2,77,186,3,1,610,1681,28,533,1495,25,21.785714285714285,<=30,SA,Home,Upto 2014
SD Jack,SA,Pace,1995-01-02,Cape Town,South Africa,1995,2,119,276,5,1,639,1598,22,520,1322,17,29.045454545454547,<=30,SA,Home,Upto 2014
SD Udal,ENG,Spin,2005-11-12,Multan,Pakistan,2005,2,94,174,1,1,438,798,8,344,624,7,54.75,>30,PAK,Away,Upto 2014
SD Udal,ENG,Spin,2005-11-20,Faisalabad,Pakistan,2005,2,91,162,1,1,496,897,7,405,735,6,70.85714285714286,>30,PAK,Away,Upto 2014
SD Udal,ENG,Spin,2005-11-29,Lahore,Pakistan,2005,1,92,108,1,1,258,469,10,166,361,9,25.8,<=30,PAK,Away,Upto 2014
SD Udal,ENG,Spin,2006-03-18,Wankhede,India,2006,2,67,152,5,1,517,1300,19,450,1148,14,27.210526315789473,<=30,IND,Away,Upto 2014
SE Bond,NZ,Pace,2001-11-22,Hobart,Australia,2001,1,135,168,1,1,554,972,8,419,804,7,69.25,>30,AUS,Away,Upto 2014
SE Bond,NZ,Pace,2001-11-30,W.A.C.A,Australia,2001,2,154,234,2,1,1026,1787,22,872,1553,20,46.63636363636363,>30,AUS,Away,Upto 2014
SE Bond,NZ,Pace,2001-12-18,Hamilton,New Zealand,2001,2,75,169,6,1,586,928,27,511,759,21,21.703703703703702,<=30,NZ,Home,Upto 2014
SE Bond,NZ,Pace,2001-12-26,Wellington,New Zealand,2001,2,75,168,5,1,447,846,18,372,678,13,24.833333333333332,<=30,NZ,Home,Upto 2014
SE Bond,NZ,Pace,2002-06-21,Bridgetown,West Indies,2002,2,112,198,7,1,787,1616,30,675,1418,23,26.233333333333334,<=30,WI,Away,Upto 2014
SE Bond,NZ,Pace,2002-06-28,St George's,West Indies,2002,1,104,181,5,1,623,1356,15,519,1175,10,41.53333333333333,>30,WI,Away,Upto 2014
SE Bond,NZ,Pace,2002-12-12,Wellington,New Zealand,2002,2,99,191,7,1,505,1071,28,406,880,21,18.035714285714285,<=30,NZ,Home,Upto 2014
SE Bond,NZ,Pace,2002-12-19,Hamilton,New Zealand,2002,2,97,146,5,1,426,959,32,329,813,27,13.3125,<=30,NZ,Home,Upto 2014
SE Bond,NZ,Pace,2003-04-25,Colombo (PSS),Sri Lanka,2003,1,97,168,3,1,412,858,7,315,690,4,58.857142857142854,>30,SL,Away,Upto 2014
SE Bond,NZ,Pace,2003-05-03,Kandy,Sri Lanka,2003,2,97,186,2,1,352,866,14,255,680,12,25.142857142857142,<=30,SL,Away,Upto 2014
SE Bond,NZ,Pace,2005-08-07,Harare,Zimbabwe,2005,2,21,96,3,1,432,774,20,411,678,17,21.6,<=30,ZIM,Away,Upto 2014
SE Bond,NZ,Pace,2005-08-15,Bulawayo,Zimbabwe,2005,2,99,186,10,1,584,919,19,485,733,9,30.736842105263158,>30,ZIM,Away,Upto 2014
SE Bond,NZ,Pace,2006-03-09,Auckland,New Zealand,2006,2,126,279,7,1,867,1612,27,741,1333,20,32.111111111111114,>30,NZ,Home,Upto 2014
SE Bond,NZ,Pace,2006-03-25,Napier,New Zealand,2006,1,87,108,1,1,242,421,3,155,313,2,80.66666666666667,>30,NZ,Home,Upto 2014
SE Bond,NZ,Pace,2006-12-07,Christchurch,New Zealand,2006,2,106,193,7,1,515,1047,25,409,854,18,20.6,<=30,NZ,Home,Upto 2014
SE Bond,NZ,Pace,2006-12-15,Wellington,New Zealand,2006,2,152,210,3,1,700,1140,20,548,930,17,35.0,>30,NZ,Home,Upto 2014
SE Bond,NZ,Pace,2007-11-08,Johannesburg,South Africa,2007,2,133,198,5,1,740,1372,29,607,1174,24,25.517241379310345,<=30,SA,Away,Upto 2014
SE Bond,NZ,Pace,2009-11-24,Dunedin,New Zealand,2009,2,153,293,8,1,862,1655,33,709,1362,25,26.12121212121212,<=30,NZ,Home,Upto 2014
SE Gregory,AUS,Spin,1903-12-11,Sydney,Australia,1903,1,8,12,0,1,839,1769,19,831,1757,19,44.1578947368421,>30,AUS,Home,Upto 2014
SE Gregory,AUS,Spin,1909-08-09,The Oval,England,1909,2,25,18,0,1,627,1104,11,602,1086,11,57.0,>30,ENG,Away,Upto 2014
SF Barnes,ENG,Pace,1901-12-13,Sydney,Australia,1901,2,139,307,6,1,416,1027,14,277,720,8,29.714285714285715,<=30,AUS,Away,Upto 2014
SF Barnes,ENG,Pace,1902-01-01,Melbourne,Australia,1902,2,163,481,13,1,229,661,13,66,180,0,17.615384615384617,<=30,AUS,Away,Upto 2014
SF Barnes,ENG,Pace,1902-01-17,Adelaide,Australia,1902,1,21,42,0,1,342,876,5,321,834,5,68.4,>30,AUS,Away,Upto 2014
SF Barnes,ENG,Pace,1902-07-03,Sheffield,England,1902,2,99,192,7,1,311,559,11,212,367,4,28.272727272727273,<=30,ENG,Home,Upto 2014
SF Barnes,ENG,Pace,1907-12-13,Sydney,Australia,1907,2,137,312,3,1,509,946,20,372,634,17,25.45,<=30,AUS,Away,Upto 2014
SF Barnes,ENG,Pace,1908-01-01,Melbourne,Australia,1908,2,102,268,5,1,477,963,14,375,695,9,34.07142857142857,>30,AUS,Away,Upto 2014
SF Barnes,ENG,Pace,1908-01-10,Adelaide,Australia,1908,2,143,414,6,1,493,1139,20,350,725,14,24.65,<=30,AUS,Away,Upto 2014
SF Barnes,ENG,Pace,1908-02-07,Melbourne,Australia,1908,2,106,348,2,1,373,840,14,267,492,12,26.642857142857142,<=30,AUS,Away,Upto 2014
SF Barnes,ENG,Pace,1908-02-21,Sydney,Australia,1908,2,138,298,8,1,203,454,8,65,156,0,25.375,<=30,AUS,Away,Upto 2014
SF Barnes,ENG,Pace,1909-07-01,Leeds,England,1909,2,100,360,7,1,393,1142,20,293,782,13,19.65,<=30,ENG,Home,Upto 2014
SF Barnes,ENG,Pace,1909-07-26,Manchester,England,1909,2,122,297,6,1,310,803,19,188,506,13,16.31578947368421,<=30,ENG,Home,Upto 2014
SF Barnes,ENG,Pace,1909-08-09,The Oval,England,1909,2,118,276,4,1,457,871,15,339,595,11,30.466666666666665,>30,ENG,Home,Upto 2014
SF Barnes,ENG,Pace,1911-12-15,Sydney,Australia,1911,2,179,390,4,1,824,1814,23,645,1424,19,35.82608695652174,>30,AUS,Away,Upto 2014
SF Barnes,ENG,Pace,1911-12-30,Melbourne,Australia,1911,2,140,331,8,1,685,1483,24,545,1152,16,28.541666666666668,<=30,AUS,Away,Upto 2014
SF Barnes,ENG,Pace,1912-01-12,Adelaide,Australia,1912,2,176,418,8,1,730,1756,27,554,1338,19,27.037037037037038,<=30,AUS,Away,Upto 2014
SF Barnes,ENG,Pace,1912-02-09,Melbourne,Australia,1912,2,121,295,7,1,546,1146,23,425,851,16,23.73913043478261,<=30,AUS,Away,Upto 2014
SF Barnes,ENG,Pace,1912-02-23,Sydney,Australia,1912,2,162,348,7,1,454,1009,16,292,661,9,28.375,<=30,AUS,Away,Upto 2014
SF Barnes,ENG,Pace,1912-06-10,Lord's,England,1912,2,110,282,11,1,280,781,22,170,499,11,12.727272727272727,<=30,ENG,Home,Upto 2014
SF Barnes,ENG,Pace,1912-06-24,Lord's,England,1912,1,74,186,0,1,300,774,7,226,588,7,42.857142857142854,>30,ENG,Home,Upto 2014
SF Barnes,ENG,Pace,1912-07-08,Leeds,England,1912,2,115,260,10,1,355,954,24,240,694,14,14.791666666666666,<=30,ENG,Home,Upto 2014
SF Barnes,ENG,Pace,1912-08-12,The Oval,England,1912,2,57,226,13,1,101,319,14,44,93,1,7.214285714285714,<=30,ENG,Home,Upto 2014
SF Barnes,ENG,Pace,1912-08-19,The Oval,England,1912,2,48,186,5,1,291,877,20,243,691,15,14.55,<=30,ENG,Home,Upto 2014
SF Barnes,ENG,Pace,1913-12-13,Durban,South Africa,1913,2,105,268,10,1,479,1054,20,374,786,10,23.95,<=30,SA,Away,Upto 2014
SF Barnes,ENG,Pace,1913-12-26,Johannesburg,South Africa,1913,2,159,393,17,1,455,1029,24,296,636,7,18.958333333333332,<=30,SA,Away,Upto 2014
SF Barnes,ENG,Pace,1914-01-01,Johannesburg,South Africa,1914,2,128,324,8,1,545,1214,22,417,890,14,24.772727272727273,<=30,SA,Away,Upto 2014
SF Barnes,ENG,Pace,1914-02-14,Durban,South Africa,1914,2,144,371,14,1,410,971,20,266,600,6,20.5,<=30,SA,Away,Upto 2014
SF Burke,SA,Pace,1962-01-01,Cape Town,South Africa,1962,2,196,486,11,1,494,1176,15,298,690,4,32.93333333333333,>30,SA,Home,Upto 2014
SF Burke,SA,Pace,1965-01-01,Cape Town,South Africa,1965,1,61,174,0,1,647,1572,12,586,1398,12,53.916666666666664,>30,SA,Home,Upto 2014
SF Mire,ZIM,Pace,2017-10-21,Bulawayo,Zimbabwe,2017,2,27,54,1,1,377,855,10,350,801,9,37.7,>30,ZIM,Home,After 1965
SF Mire,ZIM,Pace,2017-10-29,Bulawayo,Zimbabwe,2017,1,5,30,0,1,339,949,11,334,919,11,30.818181818181817,>30,ZIM,Home,After 1965
SF Rehman,PAK,Spin,1958-03-13,Georgetown,West Indies,1958,2,99,204,1,1,1032,2327,20,933,2123,19,51.6,>30,WI,Away,Upto 2014
SFAF Bacchus,WI,Pace,1980-07-10,Manchester,England,1980,1,3,6,0,1,678,1412,23,675,1406,23,29.47826086956522,<=30,ENG,Away,Upto 2014
SG Barnes,AUS,Spin,1938-08-20,The Oval,England,1938,1,84,228,1,1,776,1827,9,692,1599,8,86.22222222222223,>30,ENG,Away,Upto 2014
SG Barnes,AUS,Spin,1946-11-29,Brisbane,Australia,1946,1,1,8,0,1,284,598,7,283,590,7,40.57142857142857,>30,AUS,Home,Upto 2014
SG Barnes,AUS,Spin,1946-12-13,Sydney,Australia,1946,1,11,24,0,1,831,1933,19,820,1909,19,43.73684210526316,>30,AUS,Home,Upto 2014
SG Barnes,AUS,Spin,1947-02-28,Sydney,Australia,1947,1,11,24,0,1,494,1134,15,483,1110,15,32.93333333333333,>30,AUS,Home,Upto 2014
SG Barnes,AUS,Spin,1948-01-01,Melbourne,Australia,1948,1,25,48,2,1,660,1199,23,635,1151,21,28.695652173913043,<=30,AUS,Home,Upto 2014
SG Barnes,AUS,Spin,1948-01-23,Adelaide,Australia,1948,2,74,216,1,1,689,1465,10,615,1249,9,68.9,>30,AUS,Home,Upto 2014
SG Barnes,AUS,Spin,1948-02-06,Melbourne,Australia,1948,1,1,16,0,1,478,1056,12,477,1040,12,39.833333333333336,>30,AUS,Home,Upto 2014
SG Barnes,AUS,Spin,1948-06-10,Nottingham,England,1948,1,11,30,0,1,552,1614,15,541,1584,15,36.8,>30,ENG,Away,Upto 2014
SG Borthwick,ENG,Spin,2014-01-03,Sydney,Australia,2014,2,82,78,4,1,226,246,7,144,168,3,32.285714285714285,>30,AUS,Away,After 1965
SG Law,AUS,Spin,1995-12-08,W.A.C.A,Australia,1995,1,9,18,0,1,558,1018,9,549,1000,9,62.0,>30,AUS,Home,Upto 2014
SG Peall,ZIM,Spin,1993-12-01,Karachi,Pakistan,1993,1,89,246,2,1,291,834,6,202,588,4,48.5,>30,PAK,Away,Upto 2014
SG Peall,ZIM,Spin,1993-12-09,Rawalpindi,Pakistan,1993,2,22,84,0,1,59,150,0,37,66,0,inf,>30,PAK,Away,Upto 2014
SG Peall,ZIM,Spin,1994-10-11,Harare,Zimbabwe,1994,1,114,300,0,1,210,576,2,96,276,2,105.0,>30,ZIM,Home,Upto 2014
SG Peall,ZIM,Spin,1994-10-20,Bulawayo,Zimbabwe,1994,2,78,258,2,1,318,948,5,240,690,3,63.6,>30,ZIM,Home,Upto 2014
SG Shinde,IND,Spin,1946-06-22,Lord's,England,1946,1,66,138,1,1,376,791,8,310,653,7,47.0,>30,ENG,Away,Upto 2014
SG Shinde,IND,Spin,1948-12-09,Brabourne,India,1948,1,68,96,0,1,780,1868,11,712,1772,11,70.9090909090909,>30,IND,Home,Upto 2014
SG Shinde,IND,Spin,1951-11-02,Delhi,India,1951,2,253,651,8,1,589,1935,18,336,1284,10,32.72222222222222,>30,IND,Home,Upto 2014
SG Shinde,IND,Spin,1951-12-14,Brabourne,India,1951,2,162,348,1,1,561,1297,11,399,949,10,51.0,>30,IND,Home,Upto 2014
SG Shinde,IND,Spin,1952-01-12,Kanpur,India,1952,1,46,102,1,1,484,1339,31,438,1237,30,15.612903225806452,<=30,IND,Home,Upto 2014
SG Shinde,IND,Spin,1952-06-05,Leeds,England,1952,2,79,144,1,1,495,1359,19,416,1215,18,26.05263157894737,<=30,ENG,Away,Upto 2014
SG Shinde,IND,Spin,1952-06-19,Lord's,England,1952,1,43,36,0,1,669,1629,14,626,1593,14,47.785714285714285,>30,ENG,Away,Upto 2014
SH Cook,AUS,Pace,1997-11-20,W.A.C.A,Australia,1997,2,75,122,7,1,605,1158,21,530,1036,14,28.80952380952381,<=30,AUS,Home,Upto 2014
SH Cook,AUS,Pace,1997-11-27,Hobart,Australia,1997,2,67,102,0,1,691,1411,18,624,1309,18,38.388888888888886,>30,AUS,Home,Upto 2014
SH Emery,AUS,Spin,1912-05-27,Manchester,England,1912,1,94,222,1,1,525,1035,18,431,813,17,29.166666666666668,<=30,ENG,Away,Upto 2014
SH Emery,AUS,Spin,1912-06-24,Lord's,England,1912,1,46,72,2,1,243,530,6,197,458,4,40.5,>30,ENG,Away,Upto 2014
SH Emery,AUS,Spin,1912-07-29,Manchester,England,1912,1,22,42,0,1,128,395,6,106,353,6,21.333333333333332,<=30,ENG,Away,Upto 2014
SH Emery,AUS,Spin,1912-08-05,Nottingham,England,1912,1,87,126,2,1,399,1038,15,312,912,13,26.6,<=30,ENG,Away,Upto 2014
SH Lewis,WI,Pace,2018-10-04,Rajkot,India,2018,1,93,120,2,1,307,492,6,214,372,4,51.166666666666664,>30,IND,Away,After 1965
SH Lewis,WI,Pace,2018-11-30,Mirpur,Bangladesh,2018,1,69,120,1,1,130,270,3,61,150,2,43.333333333333336,>30,BAN,Away,After 1965
SI Mahmood,ENG,Pace,2006-05-11,Lord's,England,2006,2,168,288,5,1,982,1899,19,814,1611,14,51.68421052631579,>30,ENG,Home,Upto 2014
SI Mahmood,ENG,Pace,2006-05-25,Birmingham,England,2006,2,44,108,2,1,504,1093,20,460,985,18,25.2,<=30,ENG,Home,Upto 2014
SI Mahmood,ENG,Pace,2006-07-27,Manchester,England,2006,2,55,72,0,1,487,865,18,432,793,18,27.055555555555557,<=30,ENG,Home,Upto 2014
SI Mahmood,ENG,Pace,2006-08-04,Leeds,England,2006,2,130,192,6,1,1053,1569,26,923,1377,20,40.5,>30,ENG,Home,Upto 2014
SI Mahmood,ENG,Pace,2006-08-17,The Oval,England,2006,1,101,162,2,1,700,1093,21,599,931,19,33.333333333333336,>30,ENG,Home,Upto 2014
SI Mahmood,ENG,Pace,2006-12-14,W.A.C.A,Australia,2006,2,87,102,0,1,846,1471,19,759,1369,19,44.526315789473685,>30,AUS,Away,Upto 2014
SI Mahmood,ENG,Pace,2006-12-26,Melbourne,Australia,2006,1,100,129,4,1,551,1154,23,451,1025,19,23.956521739130434,<=30,AUS,Away,Upto 2014
SI Mahmood,ENG,Pace,2007-01-02,Sydney,Australia,2007,2,77,77,1,1,646,1259,24,569,1182,23,26.916666666666668,<=30,AUS,Away,Upto 2014
SJ Benn,WI,Spin,2008-03-22,Providence,West Indies,2008,2,179,318,3,1,634,1374,12,455,1056,9,52.833333333333336,>30,WI,Home,Upto 2014
SJ Benn,WI,Spin,2008-06-12,Bridgetown,West Indies,2008,2,187,318,4,1,440,864,10,253,546,6,44.0,>30,WI,Home,Upto 2014
SJ Benn,WI,Spin,2008-12-19,Napier,New Zealand,2008,2,103,246,1,1,472,1254,11,369,1008,10,42.90909090909091,>30,NZ,Away,Upto 2014
SJ Benn,WI,Spin,2009-02-04,Kingston,West Indies,2009,2,108,352,8,1,286,814,10,178,462,2,28.6,<=30,WI,Home,Upto 2014
SJ Benn,WI,Spin,2009-02-15,St John's,West Indies,2009,2,201,318,2,1,563,1022,15,362,704,13,37.53333333333333,>30,WI,Home,Upto 2014
SJ Benn,WI,Spin,2009-02-26,Bridgetown,West Indies,2009,2,170,306,2,1,611,1066,8,441,760,6,76.375,>30,WI,Home,Upto 2014
SJ Benn,WI,Spin,2009-05-06,Lord's,England,2009,1,84,162,2,1,150,312,8,66,150,6,18.75,<=30,ENG,Away,Upto 2014
SJ Benn,WI,Spin,2009-05-14,Chester-le-Street,England,2009,1,146,258,2,1,248,450,4,102,192,2,62.0,>30,ENG,Away,Upto 2014
SJ Benn,WI,Spin,2009-11-26,Brisbane,Australia,2009,1,86,204,2,1,179,378,7,93,174,5,25.571428571428573,<=30,AUS,Away,Upto 2014
SJ Benn,WI,Spin,2009-12-04,Adelaide,Australia,2009,2,206,480,5,1,454,1020,7,248,540,2,64.85714285714286,>30,AUS,Away,Upto 2014
SJ Benn,WI,Spin,2009-12-16,W.A.C.A,Australia,2009,2,116,234,4,1,338,660,10,222,426,6,33.8,>30,AUS,Away,Upto 2014
SJ Benn,WI,Spin,2010-06-10,Port of Spain,West Indies,2010,2,194,431,8,1,480,983,16,286,552,8,30.0,<=30,WI,Home,Upto 2014
SJ Benn,WI,Spin,2010-06-18,Basseterre,West Indies,2010,2,185,348,1,1,665,1266,8,480,918,7,83.125,>30,WI,Home,Upto 2014
SJ Benn,WI,Spin,2010-06-26,Bridgetown,West Indies,2010,1,81,280,6,1,347,891,14,266,611,8,24.785714285714285,<=30,WI,Home,Upto 2014
SJ Benn,WI,Spin,2010-11-23,Colombo (RPS),Sri Lanka,2010,2,66,126,1,1,280,519,10,214,393,9,28.0,<=30,SL,Away,Upto 2014
SJ Benn,WI,Spin,2014-06-08,Kingston,West Indies,2014,2,189,419,4,1,767,1332,22,578,913,18,34.86363636363637,>30,WI,Home,After 1965
SJ Benn,WI,Spin,2014-06-16,Port of Spain,West Indies,2014,2,151,520,5,1,468,1009,10,317,489,5,46.8,>30,WI,Home,After 1965
SJ Benn,WI,Spin,2014-06-26,Bridgetown,West Indies,2014,2,187,314,5,1,522,806,9,335,492,4,58.0,>30,WI,Home,After 1965
SJ Benn,WI,Spin,2014-09-05,Kingstown,West Indies,2014,2,83,316,7,1,510,1180,16,427,864,9,31.875,>30,WI,Home,After 1965
SJ Benn,WI,Spin,2014-09-13,Gros Islet,West Indies,2014,2,91,243,7,1,411,807,13,320,564,6,31.615384615384617,>30,WI,Home,After 1965
SJ Benn,WI,Spin,2014-12-17,Centurion,South Africa,2014,1,148,276,2,1,274,453,3,126,177,1,91.33333333333333,>30,SA,Away,After 1965
SJ Benn,WI,Spin,2014-12-26,Gqeberha,South Africa,2014,1,102,168,1,1,215,336,4,113,168,3,53.75,>30,SA,Away,After 1965
SJ Benn,WI,Spin,2015-01-02,Cape Town,South Africa,2015,2,139,372,3,1,390,806,12,251,434,9,32.5,>30,SA,Away,After 1965
SJ Benn,WI,Spin,2015-04-13,North Sound,West Indies,2015,2,200,312,2,1,466,940,10,266,628,8,46.6,>30,WI,Home,After 1965
SJ Harmison,ENG,Pace,2002-08-08,Nottingham,England,2002,2,120,294,5,1,996,1602,22,876,1308,17,45.27272727272727,>30,ENG,Home,Upto 2014
SJ Harmison,ENG,Pace,2002-11-21,Adelaide,Australia,2002,1,106,170,2,1,643,1143,16,537,973,14,40.1875,>30,AUS,Away,Upto 2014
SJ Harmison,ENG,Pace,2002-11-29,W.A.C.A,Australia,2002,1,86,168,1,1,590,1095,16,504,927,15,36.875,>30,AUS,Away,Upto 2014
SJ Harmison,ENG,Pace,2002-12-26,Melbourne,Australia,2002,2,151,283,2,1,740,1406,19,589,1123,17,38.94736842105263,>30,AUS,Away,Upto 2014
SJ Harmison,ENG,Pace,2003-01-02,Sydney,Australia,2003,2,112,174,4,1,1004,1656,32,892,1482,28,31.375,>30,AUS,Away,Upto 2014
SJ Harmison,ENG,Pace,2003-05-22,Lord's,England,2003,2,71,168,3,1,641,1236,26,570,1068,23,24.653846153846153,<=30,ENG,Home,Upto 2014
SJ Harmison,ENG,Pace,2003-06-05,Chester-le-Street,England,2003,2,77,185,6,1,554,1098,27,477,913,21,20.51851851851852,<=30,ENG,Home,Upto 2014
SJ Harmison,ENG,Pace,2003-07-24,Birmingham,England,2003,2,138,198,2,1,873,1408,14,735,1210,12,62.357142857142854,>30,ENG,Home,Upto 2014
SJ Harmison,ENG,Pace,2003-07-31,Lord's,England,2003,1,103,132,1,1,967,1600,24,864,1468,23,40.291666666666664,>30,ENG,Home,Upto 2014
SJ Harmison,ENG,Pace,2003-08-14,Nottingham,England,2003,2,66,168,2,1,935,1991,38,869,1823,36,24.605263157894736,<=30,ENG,Home,Upto 2014
SJ Harmison,ENG,Pace,2003-09-04,The Oval,England,2003,2,106,278,4,1,1075,1870,24,969,1592,20,44.791666666666664,>30,ENG,Home,Upto 2014
SJ Harmison,ENG,Pace,2003-10-21,Dhaka,Bangladesh,2003,2,79,281,9,1,448,1151,23,369,870,14,19.47826086956522,<=30,BAN,Away,Upto 2014
SJ Harmison,ENG,Pace,2004-03-11,Kingston,West Indies,2004,2,73,201,9,1,561,1123,25,488,922,16,22.44,<=30,WI,Away,Upto 2014
SJ Harmison,ENG,Pace,2004-03-19,Port of Spain,West Indies,2004,2,101,217,7,1,720,1489,29,619,1272,22,24.82758620689655,<=30,WI,Away,Upto 2014
SJ Harmison,ENG,Pace,2004-04-01,Bridgetown,West Indies,2004,2,76,199,6,1,550,1209,31,474,1010,25,17.741935483870968,<=30,WI,Away,Upto 2014
SJ Harmison,ENG,Pace,2004-04-10,St John's,West Indies,2004,1,92,222,1,1,955,1635,13,863,1413,12,73.46153846153847,>30,WI,Away,Upto 2014
SJ Harmison,ENG,Pace,2004-05-20,Lord's,England,2004,2,202,360,8,1,1118,2072,26,916,1712,18,43.0,>30,ENG,Home,Upto 2014
SJ Harmison,ENG,Pace,2004-06-03,Leeds,England,2004,2,131,314,7,1,915,1695,27,784,1381,20,33.888888888888886,>30,ENG,Home,Upto 2014
SJ Harmison,ENG,Pace,2004-06-10,Nottingham,England,2004,2,131,342,6,1,1015,1836,30,884,1494,24,33.833333333333336,>30,ENG,Home,Upto 2014
SJ Harmison,ENG,Pace,2004-07-22,Lord's,England,2004,2,150,252,2,1,966,1493,22,816,1241,20,43.90909090909091,>30,ENG,Home,Upto 2014
SJ Harmison,ENG,Pace,2004-07-29,Birmingham,England,2004,2,93,114,1,1,971,1389,23,878,1275,22,42.21739130434783,>30,ENG,Home,Upto 2014
SJ Harmison,ENG,Pace,2004-08-12,Manchester,England,2004,2,138,238,5,1,785,1467,28,647,1229,23,28.035714285714285,<=30,ENG,Home,Upto 2014
SJ Harmison,ENG,Pace,2004-08-19,The Oval,England,2004,2,121,186,9,1,794,1252,26,673,1066,17,30.53846153846154,>30,ENG,Home,Upto 2014
SJ Harmison,ENG,Pace,2004-12-17,Gqeberha,South Africa,2004,2,142,234,1,1,915,1720,27,773,1486,26,33.888888888888886,>30,SA,Away,Upto 2014
SJ Harmison,ENG,Pace,2004-12-26,Durban,South Africa,2004,2,153,282,5,1,968,1978,29,815,1696,24,33.37931034482759,>30,SA,Away,Upto 2014
SJ Harmison,ENG,Pace,2005-01-02,Cape Town,South Africa,2005,2,137,270,1,1,830,1832,29,693,1562,28,28.620689655172413,<=30,SA,Away,Upto 2014
SJ Harmison,ENG,Pace,2005-01-13,Johannesburg,South Africa,2005,2,89,161,0,1,1212,2062,34,1123,1901,34,35.64705882352941,>30,SA,Away,Upto 2014
SJ Harmison,ENG,Pace,2005-01-21,Centurion,South Africa,2005,2,138,198,2,1,788,1589,28,650,1391,26,28.142857142857142,<=30,SA,Away,Upto 2014
SJ Harmison,ENG,Pace,2005-05-26,Lord's,England,2005,2,77,144,4,1,522,823,21,445,679,17,24.857142857142858,<=30,ENG,Home,Upto 2014
SJ Harmison,ENG,Pace,2005-06-03,Chester-le-Street,England,2005,2,124,179,6,1,697,946,22,573,767,16,31.681818181818183,>30,ENG,Home,Upto 2014
SJ Harmison,ENG,Pace,2005-07-21,Lord's,England,2005,2,97,234,8,1,726,1256,32,629,1022,24,22.6875,<=30,ENG,Home,Upto 2014
SJ Harmison,ENG,Pace,2005-08-04,Birmingham,England,2005,2,110,171,2,1,817,1095,24,707,924,22,34.041666666666664,>30,ENG,Home,Upto 2014
SJ Harmison,ENG,Pace,2005-08-11,Manchester,England,2005,2,114,192,2,1,929,1432,27,815,1240,25,34.407407407407405,>30,ENG,Home,Upto 2014
SJ Harmison,ENG,Pace,2005-08-25,Nottingham,England,2005,2,141,234,4,1,944,1543,26,803,1309,22,36.30769230769231,>30,ENG,Home,Upto 2014
SJ Harmison,ENG,Pace,2005-09-08,The Oval,England,2005,2,87,136,1,1,707,1205,18,620,1069,17,39.27777777777778,>30,ENG,Home,Upto 2014
SJ Harmison,ENG,Pace,2005-11-12,Multan,Pakistan,2005,2,89,217,6,1,730,1407,32,641,1190,26,22.8125,<=30,PAK,Away,Upto 2014
SJ Harmison,ENG,Pace,2005-11-20,Faisalabad,Pakistan,2005,2,146,262,5,1,802,1439,26,656,1177,21,30.846153846153847,>30,PAK,Away,Upto 2014
SJ Harmison,ENG,Pace,2005-11-29,Lahore,Pakistan,2005,1,154,258,1,1,870,1496,17,716,1238,16,51.1764705882353,>30,PAK,Away,Upto 2014
SJ Harmison,ENG,Pace,2006-03-01,Nagpur,India,2006,2,123,266,3,1,629,1284,22,506,1018,19,28.59090909090909,<=30,IND,Away,Upto 2014
SJ Harmison,ENG,Pace,2006-03-09,Mohali,India,2006,2,70,192,2,1,422,800,12,352,608,10,35.166666666666664,>30,IND,Away,Upto 2014
SJ Harmison,ENG,Pace,2006-07-13,Lord's,England,2006,2,137,267,4,1,919,1514,18,782,1247,14,51.05555555555556,>30,ENG,Home,Upto 2014
SJ Harmison,ENG,Pace,2006-07-27,Manchester,England,2006,2,76,187,11,1,487,865,18,411,678,7,27.055555555555557,<=30,ENG,Home,Upto 2014
SJ Harmison,ENG,Pace,2006-08-04,Leeds,England,2006,2,204,270,1,1,1053,1569,26,849,1299,25,40.5,>30,ENG,Home,Upto 2014
SJ Harmison,ENG,Pace,2006-08-17,The Oval,England,2006,1,125,185,4,1,700,1093,21,575,908,17,33.333333333333336,>30,ENG,Home,Upto 2014
SJ Harmison,ENG,Pace,2006-11-23,Brisbane,Australia,2006,2,177,253,1,1,985,1659,24,808,1406,23,41.041666666666664,>30,AUS,Away,Upto 2014
SJ Harmison,ENG,Pace,2006-12-01,Adelaide,Australia,2006,2,111,174,0,1,876,1646,21,765,1472,21,41.714285714285715,>30,AUS,Away,Upto 2014
SJ Harmison,ENG,Pace,2006-12-14,W.A.C.A,Australia,2006,2,164,258,5,1,846,1471,19,682,1213,14,44.526315789473685,>30,AUS,Away,Upto 2014
SJ Harmison,ENG,Pace,2006-12-26,Melbourne,Australia,2006,1,69,168,2,1,551,1154,23,482,986,21,23.956521739130434,<=30,AUS,Away,Upto 2014
SJ Harmison,ENG,Pace,2007-01-02,Sydney,Australia,2007,2,93,168,2,1,646,1259,24,553,1091,22,26.916666666666668,<=30,AUS,Away,Upto 2014
SJ Harmison,ENG,Pace,2007-05-17,Lord's,England,2007,2,138,216,1,1,1013,1620,14,875,1404,13,72.35714285714286,>30,ENG,Home,Upto 2014
SJ Harmison,ENG,Pace,2007-05-25,Leeds,England,2007,2,92,151,5,1,714,1084,23,622,933,18,31.043478260869566,>30,ENG,Home,Upto 2014
SJ Harmison,ENG,Pace,2007-06-07,Manchester,England,2007,2,148,264,6,1,901,1654,29,753,1390,23,31.06896551724138,>30,ENG,Home,Upto 2014
SJ Harmison,ENG,Pace,2007-06-15,Chester-le-Street,England,2007,2,170,270,4,1,807,1380,26,637,1110,22,31.03846153846154,>30,ENG,Home,Upto 2014
SJ Harmison,ENG,Pace,2007-12-09,Colombo (SSC),Sri Lanka,2007,1,111,251,3,1,676,1421,13,565,1170,10,52.0,>30,SL,Away,Upto 2014
SJ Harmison,ENG,Pace,2007-12-18,Galle,Sri Lanka,2007,1,104,204,3,1,606,1192,16,502,988,13,37.875,>30,SL,Away,Upto 2014
SJ Harmison,ENG,Pace,2008-03-05,Hamilton,New Zealand,2008,2,121,162,1,1,672,1450,27,551,1288,26,24.88888888888889,<=30,NZ,Away,Upto 2014
SJ Harmison,ENG,Pace,2008-08-07,The Oval,England,2008,2,133,258,4,1,862,1540,26,729,1282,22,33.15384615384615,>30,ENG,Home,Upto 2014
SJ Harmison,ENG,Pace,2008-12-11,Chennai,India,2008,2,90,126,1,1,452,1045,16,362,919,15,28.25,<=30,IND,Away,Upto 2014
SJ Harmison,ENG,Pace,2009-02-04,Kingston,West Indies,2009,1,49,124,2,1,444,1066,20,395,942,18,22.2,<=30,WI,Away,Upto 2014
SJ Harmison,ENG,Pace,2009-02-15,St John's,West Indies,2009,2,98,204,2,1,803,1574,19,705,1370,17,42.26315789473684,>30,WI,Away,Upto 2014
SJ Harmison,ENG,Pace,2009-08-07,Leeds,England,2009,1,98,138,2,1,700,1101,30,602,963,28,23.333333333333332,<=30,ENG,Home,Upto 2014
SJ Harmison,ENG,Pace,2009-08-20,The Oval,England,2009,2,69,120,3,1,842,1408,23,773,1288,20,36.608695652173914,>30,ENG,Home,Upto 2014
SJ Harmison,ICC,Pace,2005-10-14,Sydney,Australia,2005,2,101,183,4,1,422,699,17,321,516,13,24.823529411764707,<=30,AUS,Away,Upto 2014
SJ McCabe,AUS,Pace,1930-06-13,Nottingham,England,1930,2,65,126,2,1,383,898,10,318,772,8,38.3,>30,ENG,Away,Upto 2014
SJ McCabe,AUS,Pace,1930-06-27,Lord's,England,1930,2,40,72,0,1,579,1102,10,539,1030,10,57.9,>30,ENG,Away,Upto 2014
SJ McCabe,AUS,Pace,1930-07-11,Leeds,England,1930,2,24,72,1,1,460,1116,6,436,1044,5,76.66666666666667,>30,ENG,Away,Upto 2014
SJ McCabe,AUS,Pace,1930-07-25,Manchester,England,1930,1,41,102,4,1,183,630,11,142,528,7,16.636363636363637,<=30,ENG,Away,Upto 2014
SJ McCabe,AUS,Pace,1930-08-16,The Oval,England,1930,2,51,150,1,1,505,1314,10,454,1164,9,50.5,>30,ENG,Away,Upto 2014
SJ McCabe,AUS,Pace,1930-12-12,Adelaide,Australia,1930,2,47,120,0,1,453,957,5,406,837,5,90.6,>30,AUS,Home,Upto 2014
SJ McCabe,AUS,Pace,1931-01-01,Sydney,Australia,1931,1,20,42,1,1,284,648,9,264,606,8,31.555555555555557,>30,AUS,Home,Upto 2014
SJ McCabe,AUS,Pace,1931-01-16,Brisbane,Australia,1931,1,16,42,1,1,443,984,16,427,942,15,27.6875,<=30,AUS,Home,Upto 2014
SJ McCabe,AUS,Pace,1931-02-27,Sydney,Australia,1931,2,43,132,1,1,407,995,14,364,863,13,29.071428571428573,<=30,AUS,Home,Upto 2014
SJ McCabe,AUS,Pace,1931-11-27,Brisbane,Australia,1931,1,16,66,0,1,377,952,14,361,886,14,26.928571428571427,<=30,AUS,Home,Upto 2014
SJ McCabe,AUS,Pace,1931-12-18,Sydney,Australia,1931,2,38,90,4,1,383,911,14,345,821,10,27.357142857142858,<=30,AUS,Home,Upto 2014
SJ McCabe,AUS,Pace,1931-12-31,Melbourne,Australia,1931,2,62,189,2,1,596,1454,16,534,1265,14,37.25,>30,AUS,Home,Upto 2014
SJ McCabe,AUS,Pace,1932-01-29,Adelaide,Australia,1932,2,85,186,2,1,508,1020,9,423,834,7,56.44444444444444,>30,AUS,Home,Upto 2014
SJ McCabe,AUS,Pace,1932-02-12,Melbourne,Australia,1932,1,4,24,1,1,107,351,12,103,327,11,8.916666666666666,<=30,AUS,Home,Upto 2014
SJ McCabe,AUS,Pace,1932-12-02,Sydney,Australia,1932,2,43,91,1,1,694,1474,26,651,1383,25,26.692307692307693,<=30,AUS,Home,Upto 2014
SJ McCabe,AUS,Pace,1933-01-13,Adelaide,Australia,1933,2,70,180,0,1,549,1333,23,479,1153,23,23.869565217391305,<=30,AUS,Home,Upto 2014
SJ McCabe,AUS,Pace,1933-02-10,Brisbane,Australia,1933,2,65,184,2,1,508,1171,18,443,987,16,28.22222222222222,<=30,AUS,Home,Upto 2014
SJ McCabe,AUS,Pace,1933-02-23,Sydney,Australia,1933,2,37,102,0,1,693,1194,12,656,1092,12,57.75,>30,AUS,Home,Upto 2014
SJ McCabe,AUS,Pace,1934-06-08,Nottingham,England,1934,2,14,54,0,1,503,1268,16,489,1214,16,31.4375,>30,ENG,Away,Upto 2014
SJ McCabe,AUS,Pace,1934-06-22,Lord's,England,1934,1,38,108,1,1,436,1038,10,398,930,9,43.6,>30,ENG,Away,Upto 2014
SJ McCabe,AUS,Pace,1934-07-06,Manchester,England,1934,2,133,270,1,1,754,1551,6,621,1281,5,125.66666666666667,>30,ENG,Away,Upto 2014
SJ McCabe,AUS,Pace,1934-07-20,Leeds,England,1934,2,8,54,0,1,418,900,7,410,846,7,59.714285714285715,>30,ENG,Away,Upto 2014
SJ McCabe,AUS,Pace,1934-08-18,The Oval,England,1934,2,26,66,2,1,874,1331,25,848,1265,23,34.96,>30,ENG,Away,Upto 2014
SJ McCabe,AUS,Pace,1935-12-14,Durban,South Africa,1935,2,33,72,0,1,348,794,8,315,722,8,43.5,>30,SA,Away,Upto 2014
SJ McCabe,AUS,Pace,1935-12-24,Johannesburg,South Africa,1935,2,41,90,2,1,547,996,13,506,906,11,42.07692307692308,>30,SA,Away,Upto 2014
SJ McCabe,AUS,Pace,1936-01-01,Cape Town,South Africa,1936,1,9,12,1,1,144,300,3,135,288,2,48.0,>30,SA,Away,Upto 2014
SJ McCabe,AUS,Pace,1936-02-15,Johannesburg,South Africa,1936,2,22,42,0,1,303,592,11,281,550,11,27.545454545454547,<=30,SA,Away,Upto 2014
SJ McCabe,AUS,Pace,1936-02-28,Durban,South Africa,1936,2,31,54,0,1,320,685,7,289,631,7,45.714285714285715,>30,SA,Away,Upto 2014
SJ McCabe,AUS,Pace,1936-12-04,Brisbane,Australia,1936,2,24,64,1,1,297,839,25,273,775,24,11.88,<=30,AUS,Home,Upto 2014
SJ McCabe,AUS,Pace,1936-12-18,Sydney,Australia,1936,1,31,72,1,1,331,936,17,300,864,16,19.470588235294116,<=30,AUS,Home,Upto 2014
SJ McCabe,AUS,Pace,1937-01-01,Melbourne,Australia,1937,2,39,80,1,1,510,1173,17,471,1093,16,30.0,<=30,AUS,Home,Upto 2014
SJ McCabe,AUS,Pace,1937-01-29,Adelaide,Australia,1937,2,33,112,1,1,675,1448,20,642,1336,19,33.75,>30,AUS,Home,Upto 2014
SJ McCabe,AUS,Pace,1937-02-26,Melbourne,Australia,1937,1,1,8,0,1,632,1154,16,631,1146,16,39.5,>30,AUS,Home,Upto 2014
SJ McCabe,AUS,Pace,1938-06-10,Nottingham,England,1938,1,64,126,0,1,464,954,6,400,828,6,77.33333333333333,>30,ENG,Away,Upto 2014
SJ McCabe,AUS,Pace,1938-06-24,Lord's,England,1938,2,144,258,2,1,661,1148,17,517,890,15,38.88235294117647,>30,ENG,Away,Upto 2014
SJ McCabe,AUS,Pace,1938-07-22,Leeds,England,1938,1,0,6,0,1,285,715,10,285,709,10,28.5,<=30,ENG,Away,Upto 2014
SJ McCabe,AUS,Pace,1938-08-20,The Oval,England,1938,1,85,228,0,1,391,703,13,306,475,13,30.076923076923077,>30,ENG,Away,Upto 2014
SJ Pegler,SA,Spin,1910-02-26,Johannesburg,South Africa,1910,2,55,82,2,1,662,1226,24,607,1144,22,27.583333333333332,<=30,SA,Home,Upto 2014
SJ Pegler,SA,Spin,1910-12-31,Melbourne,Australia,1910,2,67,99,2,1,675,1063,21,608,964,19,32.142857142857146,>30,AUS,Away,Upto 2014
SJ Pegler,SA,Spin,1911-01-07,Adelaide,Australia,1911,2,150,184,1,1,814,1502,20,664,1318,19,40.7,>30,AUS,Away,Upto 2014
SJ Pegler,SA,Spin,1911-02-17,Melbourne,Australia,1911,2,128,208,4,1,844,1322,23,716,1114,19,36.69565217391305,>30,AUS,Away,Upto 2014
SJ Pegler,SA,Spin,1911-03-03,Sydney,Australia,1911,2,53,60,0,1,638,1067,19,585,1007,19,33.578947368421055,>30,AUS,Away,Upto 2014
SJ Pegler,SA,Spin,1912-05-27,Manchester,England,1912,1,105,273,6,1,525,1035,18,420,762,12,29.166666666666668,<=30,ENG,Away,Upto 2014
SJ Pegler,SA,Spin,1912-06-10,Lord's,England,1912,1,65,186,7,1,275,582,7,210,396,0,39.285714285714285,>30,ENG,Away,Upto 2014
SJ Pegler,SA,Spin,1912-07-08,Leeds,England,1912,2,222,396,6,1,384,746,14,162,350,8,27.428571428571427,<=30,ENG,Away,Upto 2014
SJ Pegler,SA,Spin,1912-07-15,Lord's,England,1912,2,94,203,4,1,501,1026,19,407,823,15,26.36842105263158,<=30,ENG,Away,Upto 2014
SJ Pegler,SA,Spin,1912-08-05,Nottingham,England,1912,1,80,216,4,1,399,1038,15,319,822,11,26.6,<=30,ENG,Away,Upto 2014
SJ Pegler,SA,Spin,1912-08-12,The Oval,England,1912,1,53,114,2,1,234,496,16,181,382,14,14.625,<=30,ENG,Away,Upto 2014
SJ Pegler,SA,Spin,1924-06-14,Birmingham,England,1924,1,106,216,2,1,396,946,10,290,730,8,39.6,>30,ENG,Away,Upto 2014
SJ Pegler,SA,Spin,1924-06-28,Lord's,England,1924,1,120,186,0,1,563,1396,14,443,1210,14,40.214285714285715,>30,ENG,Away,Upto 2014
SJ Pegler,SA,Spin,1924-07-12,Leeds,England,1924,2,146,278,4,1,557,1271,20,411,993,16,27.85,<=30,ENG,Away,Upto 2014
SJ Pegler,SA,Spin,1924-08-16,The Oval,England,1924,1,128,288,3,1,425,954,15,297,666,12,28.333333333333332,<=30,ENG,Away,Upto 2014
SJ Snooke,SA,Pace,1906-01-02,Johannesburg,South Africa,1906,1,38,72,2,1,225,553,14,187,481,12,16.071428571428573,<=30,SA,Home,Upto 2014
SJ Snooke,SA,Pace,1906-03-06,Johannesburg,South Africa,1906,2,55,132,4,1,275,764,15,220,632,11,18.333333333333332,<=30,SA,Home,Upto 2014
SJ Snooke,SA,Pace,1906-03-10,Johannesburg,South Africa,1906,2,127,318,12,1,542,1143,25,415,825,13,21.68,<=30,SA,Home,Upto 2014
SJ Snooke,SA,Pace,1906-03-24,Cape Town,South Africa,1906,2,82,222,3,1,316,931,16,234,709,13,19.75,<=30,SA,Home,Upto 2014
SJ Snooke,SA,Pace,1906-03-30,Cape Town,South Africa,1906,2,67,126,3,1,242,576,14,175,450,11,17.285714285714285,<=30,SA,Home,Upto 2014
SJ Snooke,SA,Pace,1907-08-19,The Oval,England,1907,1,8,30,1,1,261,564,14,253,534,13,18.642857142857142,<=30,ENG,Away,Upto 2014
SJ Snooke,SA,Pace,1910-01-01,Johannesburg,South Africa,1910,2,38,54,0,1,440,846,11,402,792,11,40.0,>30,SA,Home,Upto 2014
SJ Snooke,SA,Pace,1910-01-21,Durban,South Africa,1910,2,20,42,0,1,379,1058,15,359,1016,15,25.266666666666666,<=30,SA,Home,Upto 2014
SJ Snooke,SA,Pace,1910-02-26,Johannesburg,South Africa,1910,1,8,36,0,1,366,667,10,358,631,10,36.6,>30,SA,Home,Upto 2014
SJ Snooke,SA,Pace,1910-03-07,Cape Town,South Africa,1910,2,58,96,4,1,321,621,18,263,525,14,17.833333333333332,<=30,SA,Home,Upto 2014
SJ Snooke,SA,Pace,1910-03-11,Cape Town,South Africa,1910,2,17,42,0,1,301,570,12,284,528,12,25.083333333333332,<=30,SA,Home,Upto 2014
SJ Snooke,SA,Pace,1910-12-31,Melbourne,Australia,1910,2,43,78,0,1,540,1002,17,497,924,17,31.764705882352942,>30,AUS,Away,Upto 2014
SJ Snooke,SA,Pace,1911-01-07,Adelaide,Australia,1911,1,21,30,0,1,771,1501,18,750,1471,18,42.833333333333336,>30,AUS,Away,Upto 2014
SJ Snooke,SA,Pace,1911-02-17,Melbourne,Australia,1911,1,12,12,0,1,399,623,10,387,611,10,39.9,>30,AUS,Away,Upto 2014
SJ Snooke,SA,Pace,1923-01-18,Durban,South Africa,1923,2,29,66,1,1,496,1373,16,467,1307,15,31.0,>30,SA,Home,Upto 2014
SJ Snooke,SA,Pace,1923-02-09,Johannesburg,South Africa,1923,2,21,54,0,1,723,1725,22,702,1671,22,32.86363636363637,>30,SA,Home,Upto 2014
SJ Snooke,SA,Pace,1923-02-16,Durban,South Africa,1923,2,58,210,5,1,724,2332,33,666,2122,28,21.939393939393938,<=30,SA,Home,Upto 2014
SJ Staples,ENG,Spin,1928-01-21,Durban,South Africa,1928,2,161,498,5,1,719,1581,22,558,1083,17,32.68181818181818,>30,SA,Away,Upto 2014
SJ Staples,ENG,Spin,1928-01-28,Johannesburg,South Africa,1928,2,148,321,6,1,407,779,13,259,458,7,31.307692307692307,>30,SA,Away,Upto 2014
SJ Staples,ENG,Spin,1928-02-04,Durban,South Africa,1928,2,126,330,4,1,423,969,13,297,639,9,32.53846153846154,>30,SA,Away,Upto 2014
SJE Brown,ENG,Pace,1996-07-25,Lord's,England,1996,2,138,198,2,1,850,1771,26,712,1573,24,32.69230769230769,>30,ENG,Home,Upto 2014
SJE Loxton,AUS,Pace,1948-02-06,Melbourne,Australia,1948,2,71,184,3,1,469,1146,14,398,962,11,33.5,>30,AUS,Home,Upto 2014
SJE Loxton,AUS,Pace,1948-07-08,Manchester,England,1948,2,47,90,0,1,513,1476,16,466,1386,16,32.0625,>30,ENG,Away,Upto 2014
SJE Loxton,AUS,Pace,1948-07-22,Leeds,England,1948,2,84,216,3,1,942,2038,19,858,1822,16,49.578947368421055,>30,ENG,Away,Upto 2014
SJE Loxton,AUS,Pace,1948-08-14,The Oval,England,1948,2,17,72,0,1,239,753,15,222,681,15,15.933333333333334,<=30,ENG,Away,Upto 2014
SJE Loxton,AUS,Pace,1949-12-24,Johannesburg,South Africa,1949,2,13,32,0,1,273,736,9,260,704,9,30.333333333333332,>30,SA,Away,Upto 2014
SJE Loxton,AUS,Pace,1949-12-31,Cape Town,South Africa,1949,2,31,80,1,1,378,860,10,347,780,9,37.8,>30,SA,Away,Upto 2014
SJE Loxton,AUS,Pace,1950-01-20,Durban,South Africa,1950,1,31,48,0,1,229,704,5,198,656,5,45.8,>30,SA,Away,Upto 2014
SJE Loxton,AUS,Pace,1950-02-10,Johannesburg,South Africa,1950,1,22,80,0,1,524,1232,15,502,1152,15,34.93333333333333,>30,SA,Away,Upto 2014
SJE Loxton,AUS,Pace,1950-03-03,Gqeberha,South Africa,1950,1,7,32,1,1,363,833,11,356,801,10,33.0,>30,SA,Away,Upto 2014
SJE Loxton,AUS,Pace,1950-12-22,Melbourne,Australia,1950,1,14,32,0,1,311,916,19,297,884,19,16.36842105263158,<=30,AUS,Home,Upto 2014
SJE Loxton,AUS,Pace,1951-01-05,Sydney,Australia,1951,1,12,40,0,1,385,1007,10,373,967,10,38.5,>30,AUS,Home,Upto 2014
SK Coen,SA,Spin,1927-12-24,Johannesburg,South Africa,1927,1,7,12,0,1,312,867,11,305,855,11,28.363636363636363,<=30,SA,Home,Upto 2014
SK Raina,IND,Spin,2010-07-26,Colombo (SSC),Sri Lanka,2010,1,21,30,0,1,926,1870,14,905,1840,14,66.14285714285714,>30,SL,Away,Upto 2014
SK Raina,IND,Spin,2010-10-09,Bengaluru,India,2010,1,19,48,1,1,696,1271,17,677,1223,16,40.94117647058823,>30,IND,Home,Upto 2014
SK Raina,IND,Spin,2010-11-04,Ahmedabad,India,2010,2,43,78,1,1,781,1719,18,738,1641,17,43.388888888888886,>30,IND,Home,Upto 2014
SK Raina,IND,Spin,2010-11-12,Hyderabad,India,2010,2,53,120,2,1,691,1414,15,638,1294,13,46.06666666666667,>30,IND,Home,Upto 2014
SK Raina,IND,Spin,2010-11-20,Nagpur,India,2010,1,1,12,2,1,493,909,15,492,897,13,32.86666666666667,>30,IND,Home,Upto 2014
SK Raina,IND,Spin,2010-12-16,Centurion,South Africa,2010,1,77,42,0,1,391,504,4,314,462,4,97.75,>30,SA,Away,Upto 2014
SK Raina,IND,Spin,2011-06-20,Kingston,West Indies,2011,1,9,38,1,1,367,624,15,358,586,14,24.466666666666665,<=30,WI,Away,Upto 2014
SK Raina,IND,Spin,2011-06-28,Bridgetown,West Indies,2011,1,5,24,0,1,187,468,5,182,444,5,37.4,>30,WI,Away,Upto 2014
SK Raina,IND,Spin,2011-07-06,Roseau,West Indies,2011,2,45,117,2,1,478,1095,12,433,978,10,39.833333333333336,>30,WI,Away,Upto 2014
SK Raina,IND,Spin,2011-07-21,Lord's,England,2011,2,68,52,1,1,415,658,4,347,606,3,103.75,>30,ENG,Away,Upto 2014
SK Raina,IND,Spin,2011-07-29,Nottingham,England,2011,1,42,48,0,1,280,322,2,238,274,2,140.0,>30,ENG,Away,Upto 2014
SK Raina,IND,Spin,2011-08-10,Birmingham,England,2011,1,83,168,1,1,372,564,6,289,396,5,62.0,>30,ENG,Away,Upto 2014
SK Raina,IND,Spin,2011-08-18,The Oval,England,2011,1,58,114,2,1,491,822,11,433,708,9,44.63636363636363,>30,ENG,Away,Upto 2014
SK Raina,IND,Spin,2012-08-23,Hyderabad,India,2012,2,8,24,0,1,326,884,22,318,860,22,14.818181818181818,<=30,IND,Home,Upto 2014
SK Raina,IND,Spin,2012-08-31,Bengaluru,India,2012,1,0,6,0,1,445,783,16,445,777,16,27.8125,<=30,IND,Home,Upto 2014
SK Raina,IND,Spin,2015-01-06,Sydney,Australia,2015,2,71,120,0,1,575,1013,9,504,893,9,63.888888888888886,>30,AUS,Away,After 1965
SK Sharma,IND,Pace,1988-12-02,Hyderabad (Deccan),India,1988,2,50,126,3,1,410,867,17,360,741,14,24.11764705882353,<=30,IND,Home,Upto 2014
SK Sharma,IND,Pace,1990-07-26,Lord's,England,1990,2,197,288,3,1,1076,1683,21,879,1395,18,51.23809523809524,>30,ENG,Away,Upto 2014
SK Warne,AUS,Spin,1992-01-02,Sydney,Australia,1992,1,150,270,1,1,301,666,6,151,396,5,50.166666666666664,>30,AUS,Home,Upto 2014
SK Warne,AUS,Spin,1992-01-25,Adelaide,Australia,1992,2,78,138,0,1,316,796,8,238,658,8,39.5,>30,AUS,Home,Upto 2014
SK Warne,AUS,Spin,1992-08-17,Colombo (SSC),Sri Lanka,1992,2,118,163,3,1,598,1075,17,480,912,14,35.1764705882353,>30,SL,Away,Upto 2014
SK Warne,AUS,Spin,1992-09-08,Moratuwa,Sri Lanka,1992,1,40,66,0,1,347,775,4,307,709,4,86.75,>30,SL,Away,Upto 2014
SK Warne,AUS,Spin,1992-12-26,Melbourne,Australia,1992,2,117,284,8,1,262,558,8,145,274,0,32.75,>30,AUS,Home,Upto 2014
SK Warne,AUS,Spin,1993-01-02,Sydney,Australia,1993,1,116,246,1,1,617,1258,8,501,1012,7,77.125,>30,AUS,Home,Upto 2014
SK Warne,AUS,Spin,1993-01-23,Adelaide,Australia,1993,2,29,48,1,1,119,287,11,90,239,10,10.818181818181818,<=30,AUS,Home,Upto 2014
SK Warne,AUS,Spin,1993-01-30,W.A.C.A,Australia,1993,1,51,72,0,1,72,108,2,21,36,2,36.0,>30,AUS,Home,Upto 2014
SK Warne,AUS,Spin,1993-02-25,Christchurch,New Zealand,1993,2,86,288,7,1,243,504,9,157,216,2,27.0,<=30,NZ,Away,Upto 2014
SK Warne,AUS,Spin,1993-03-04,Wellington,New Zealand,1993,2,108,414,4,1,142,558,5,34,144,1,28.4,<=30,NZ,Away,Upto 2014
SK Warne,AUS,Spin,1993-03-12,Auckland,New Zealand,1993,2,62,252,6,1,187,516,12,125,264,6,15.583333333333334,<=30,NZ,Away,Upto 2014
SK Warne,AUS,Spin,1993-06-03,Manchester,England,1993,2,137,438,8,1,496,1275,19,359,837,11,26.105263157894736,<=30,ENG,Away,Upto 2014
SK Warne,AUS,Spin,1993-06-17,Lord's,England,1993,2,159,503,8,1,634,1745,17,475,1242,9,37.294117647058826,>30,ENG,Away,Upto 2014
SK Warne,AUS,Spin,1993-07-01,Nottingham,England,1993,2,182,540,6,1,460,1186,11,278,646,5,41.81818181818182,>30,ENG,Away,Upto 2014
SK Warne,AUS,Spin,1993-07-22,Leeds,England,1993,2,106,378,1,1,214,660,6,108,282,5,35.666666666666664,>30,ENG,Away,Upto 2014
SK Warne,AUS,Spin,1993-08-05,Birmingham,England,1993,2,145,420,6,1,613,1738,21,468,1318,15,29.19047619047619,<=30,ENG,Away,Upto 2014
SK Warne,AUS,Spin,1993-08-19,The Oval,England,1993,2,148,360,5,1,310,756,7,162,396,2,44.285714285714285,>30,ENG,Away,Upto 2014
SK Warne,AUS,Spin,1993-11-12,W.A.C.A,Australia,1993,2,113,301,1,1,339,721,5,226,420,4,67.8,>30,AUS,Home,Upto 2014
SK Warne,AUS,Spin,1993-11-26,Hobart,Australia,1993,2,67,227,9,1,270,782,19,203,555,10,14.210526315789474,<=30,AUS,Home,Upto 2014
SK Warne,AUS,Spin,1993-12-03,Brisbane,Australia,1993,2,125,381,8,1,392,909,12,267,528,4,32.666666666666664,>30,AUS,Home,Upto 2014
SK Warne,AUS,Spin,1993-12-26,Melbourne,Australia,1993,1,63,186,1,1,190,527,4,127,341,3,47.5,>30,AUS,Home,Upto 2014
SK Warne,AUS,Spin,1994-01-02,Sydney,Australia,1994,2,128,414,12,1,327,960,14,199,546,2,23.357142857142858,<=30,AUS,Home,Upto 2014
SK Warne,AUS,Spin,1994-01-28,Adelaide,Australia,1994,2,116,451,5,1,289,1015,8,173,564,3,36.125,>30,AUS,Home,Upto 2014
SK Warne,AUS,Spin,1994-03-04,Johannesburg,South Africa,1994,2,128,353,5,1,318,779,9,190,426,4,35.333333333333336,>30,SA,Away,Upto 2014
SK Warne,AUS,Spin,1994-03-17,Cape Town,South Africa,1994,2,116,462,6,1,182,607,6,66,145,0,30.333333333333332,>30,SA,Away,Upto 2014
SK Warne,AUS,Spin,1994-03-25,Durban,South Africa,1994,1,92,330,4,1,158,468,4,66,138,0,39.5,>30,SA,Away,Upto 2014
SK Warne,AUS,Spin,1994-09-28,Karachi,Pakistan,1994,2,150,379,8,1,538,1117,15,388,738,7,35.86666666666667,>30,PAK,Away,Upto 2014
SK Warne,AUS,Spin,1994-10-05,Rawalpindi,Pakistan,1994,2,114,280,1,1,440,796,6,326,516,5,73.33333333333333,>30,PAK,Away,Upto 2014
SK Warne,AUS,Spin,1994-11-01,Lahore,Pakistan,1994,2,240,431,9,1,660,1368,20,420,937,11,33.0,>30,PAK,Away,Upto 2014
SK Warne,AUS,Spin,1994-11-25,Brisbane,Australia,1994,2,110,430,11,1,405,1216,16,295,786,5,25.3125,<=30,AUS,Home,Upto 2014
SK Warne,AUS,Spin,1994-12-24,Melbourne,Australia,1994,2,80,244,9,1,290,880,14,210,636,5,20.714285714285715,<=30,AUS,Home,Upto 2014
SK Warne,AUS,Spin,1995-01-01,Sydney,Australia,1995,2,136,312,1,1,330,790,1,194,478,0,330.0,>30,AUS,Home,Upto 2014
SK Warne,AUS,Spin,1995-01-26,Adelaide,Australia,1995,2,154,371,4,1,395,872,12,241,501,8,32.916666666666664,>30,AUS,Home,Upto 2014
SK Warne,AUS,Spin,1995-02-03,W.A.C.A,Australia,1995,2,69,180,2,1,185,366,5,116,186,3,37.0,>30,AUS,Home,Upto 2014
SK Warne,AUS,Spin,1995-03-31,Bridgetown,West Indies,1995,2,121,231,5,1,198,315,6,77,84,1,33.0,>30,WI,Away,Upto 2014
SK Warne,AUS,Spin,1995-04-08,St John's,West Indies,1995,2,101,210,3,1,167,342,4,66,132,1,41.75,>30,WI,Away,Upto 2014
SK Warne,AUS,Spin,1995-04-21,Port of Spain,West Indies,1995,2,42,95,1,1,51,107,2,9,12,1,25.5,<=30,WI,Away,Upto 2014
SK Warne,AUS,Spin,1995-04-29,Kingston,West Indies,1995,2,142,292,6,1,303,676,8,161,384,2,37.875,>30,WI,Away,Upto 2014
SK Warne,AUS,Spin,1995-11-09,Brisbane,Australia,1995,2,77,264,11,1,256,659,16,179,395,5,16.0,<=30,AUS,Home,Upto 2014
SK Warne,AUS,Spin,1995-11-30,Sydney,Australia,1995,2,121,426,8,1,467,1214,20,346,788,12,23.35,<=30,AUS,Home,Upto 2014
SK Warne,AUS,Spin,1995-12-08,W.A.C.A,Australia,1995,2,171,340,6,1,558,1018,9,387,678,3,62.0,>30,AUS,Home,Upto 2014
SK Warne,AUS,Spin,1995-12-26,Melbourne,Australia,1995,2,120,330,5,1,439,892,9,319,562,4,48.77777777777778,>30,AUS,Home,Upto 2014
SK Warne,AUS,Spin,1996-01-25,Adelaide,Australia,1996,2,142,318,1,1,356,732,3,214,414,2,118.66666666666667,>30,AUS,Home,Upto 2014
SK Warne,AUS,Spin,1996-11-22,Brisbane,Australia,1996,2,180,408,4,1,313,642,7,133,234,3,44.714285714285715,>30,AUS,Home,Upto 2014
SK Warne,AUS,Spin,1996-11-29,Sydney,Australia,1996,2,160,378,7,1,372,857,10,212,479,3,37.2,>30,AUS,Home,Upto 2014
SK Warne,AUS,Spin,1996-12-26,Melbourne,Australia,1996,2,89,187,3,1,107,223,3,18,36,0,35.666666666666664,>30,AUS,Home,Upto 2014
SK Warne,AUS,Spin,1997-01-25,Adelaide,Australia,1997,2,110,216,6,1,334,663,19,224,447,13,17.57894736842105,<=30,AUS,Home,Upto 2014
SK Warne,AUS,Spin,1997-02-01,W.A.C.A,Australia,1997,1,55,114,2,1,142,252,3,87,138,1,47.333333333333336,>30,AUS,Home,Upto 2014
SK Warne,AUS,Spin,1997-02-28,Johannesburg,South Africa,1997,2,111,334,6,1,374,844,13,263,510,7,28.76923076923077,<=30,SA,Away,Upto 2014
SK Warne,AUS,Spin,1997-03-14,Gqeberha,South Africa,1997,2,82,248,5,1,179,488,11,97,240,6,16.272727272727273,<=30,SA,Away,Upto 2014
SK Warne,AUS,Spin,1997-03-21,Centurion,South Africa,1997,1,89,216,0,1,288,600,4,199,384,4,72.0,>30,SA,Away,Upto 2014
SK Warne,AUS,Spin,1997-06-05,Birmingham,England,1997,2,137,255,1,1,306,577,5,169,322,4,61.2,>30,ENG,Away,Upto 2014
SK Warne,AUS,Spin,1997-06-19,Lord's,England,1997,2,56,126,2,1,115,246,3,59,120,1,38.333333333333336,>30,ENG,Away,Upto 2014
SK Warne,AUS,Spin,1997-07-03,Manchester,England,1997,2,111,364,9,1,277,718,12,166,354,3,23.083333333333332,<=30,ENG,Away,Upto 2014
SK Warne,AUS,Spin,1997-07-24,Leeds,England,1997,2,55,132,1,1,104,240,1,49,108,0,104.0,>30,ENG,Away,Upto 2014
SK Warne,AUS,Spin,1997-08-07,Nottingham,England,1997,2,129,288,7,1,246,563,9,117,275,2,27.333333333333332,<=30,ENG,Away,Upto 2014
SK Warne,AUS,Spin,1997-08-21,The Oval,England,1997,2,89,258,4,1,198,586,16,109,328,12,12.375,<=30,ENG,Away,Upto 2014
SK Warne,AUS,Spin,1997-11-07,Brisbane,Australia,1997,2,160,402,7,1,311,786,10,151,384,3,31.1,>30,AUS,Home,Upto 2014
SK Warne,AUS,Spin,1997-11-20,W.A.C.A,Australia,1997,2,147,292,6,1,231,466,7,84,174,1,33.0,>30,AUS,Home,Upto 2014
SK Warne,AUS,Spin,1997-11-27,Hobart,Australia,1997,2,169,330,6,1,298,570,8,129,240,2,37.25,>30,AUS,Home,Upto 2014
SK Warne,AUS,Spin,1997-12-26,Melbourne,Australia,1997,2,161,516,6,1,373,1058,13,212,542,7,28.692307692307693,<=30,AUS,Home,Upto 2014
SK Warne,AUS,Spin,1998-01-02,Sydney,Australia,1998,2,109,319,11,1,392,1015,16,283,696,5,24.5,<=30,AUS,Home,Upto 2014
SK Warne,AUS,Spin,1998-01-30,Adelaide,Australia,1998,2,147,288,3,1,384,731,9,237,443,6,42.666666666666664,>30,AUS,Home,Upto 2014
SK Warne,AUS,Spin,1998-03-06,Chennai,India,1998,2,207,390,5,1,809,1753,28,602,1363,23,28.892857142857142,<=30,IND,Away,Upto 2014
SK Warne,AUS,Spin,1998-03-18,Eden Gardens,India,1998,1,147,252,0,1,634,1306,12,487,1054,12,52.833333333333336,>30,IND,Away,Upto 2014
SK Warne,AUS,Spin,1998-03-25,Bengaluru,India,1998,2,186,360,5,1,817,1511,22,631,1151,17,37.13636363636363,>30,IND,Away,Upto 2014
SK Warne,AUS,Spin,1999-01-02,Sydney,Australia,1999,2,110,234,2,1,526,1105,23,416,871,21,22.869565217391305,<=30,AUS,Home,Upto 2014
SK Warne,AUS,Spin,1999-03-05,Port of Spain,West Indies,1999,1,35,84,0,1,146,312,5,111,228,5,29.2,<=30,WI,Away,Upto 2014
SK Warne,AUS,Spin,1999-03-13,Kingston,West Indies,1999,1,94,180,1,1,346,591,10,252,411,9,34.6,>30,WI,Away,Upto 2014
SK Warne,AUS,Spin,1999-03-26,Bridgetown,West Indies,1999,2,139,239,1,1,408,819,7,269,580,6,58.285714285714285,>30,WI,Away,Upto 2014
SK Warne,AUS,Spin,1999-09-09,Kandy,Sri Lanka,1999,2,70,137,5,1,373,779,20,303,642,15,18.65,<=30,SL,Away,Upto 2014
SK Warne,AUS,Spin,1999-09-22,Galle,Sri Lanka,1999,2,34,170,3,1,307,827,13,273,657,10,23.615384615384617,<=30,SL,Away,Upto 2014
SK Warne,AUS,Spin,1999-09-30,Colombo (SSC),Sri Lanka,1999,1,11,30,0,1,278,654,6,267,624,6,46.333333333333336,>30,SL,Away,Upto 2014
SK Warne,AUS,Spin,1999-10-14,Harare,Zimbabwe,1999,2,137,319,6,1,296,763,10,159,444,4,29.6,<=30,ZIM,Away,Upto 2014
SK Warne,AUS,Spin,1999-11-05,Brisbane,Australia,1999,2,153,319,3,1,367,559,6,214,240,3,61.166666666666664,>30,AUS,Home,Upto 2014
SK Warne,AUS,Spin,1999-11-18,Hobart,Australia,1999,2,155,371,8,1,337,796,16,182,425,8,21.0625,<=30,AUS,Home,Upto 2014
SK Warne,AUS,Spin,1999-11-26,W.A.C.A,Australia,1999,2,62,90,1,1,137,252,3,75,162,2,45.666666666666664,>30,AUS,Home,Upto 2014
SK Warne,AUS,Spin,1999-12-10,Adelaide,Australia,1999,2,113,312,6,1,301,744,9,188,432,3,33.44444444444444,>30,AUS,Home,Upto 2014
SK Warne,AUS,Spin,1999-12-26,Melbourne,Australia,1999,2,140,300,2,1,307,606,6,167,306,4,51.166666666666664,>30,AUS,Home,Upto 2014
SK Warne,AUS,Spin,2000-01-02,Sydney,Australia,2000,2,82,150,0,1,279,470,1,197,320,1,279.0,>30,AUS,Home,Upto 2014
SK Warne,AUS,Spin,2000-03-11,Auckland,New Zealand,2000,2,148,255,5,1,549,1142,28,401,887,23,19.607142857142858,<=30,NZ,Away,Upto 2014
SK Warne,AUS,Spin,2000-03-24,Wellington,New Zealand,2000,2,160,251,7,1,361,635,13,201,384,6,27.76923076923077,<=30,NZ,Away,Upto 2014
SK Warne,AUS,Spin,2000-03-31,Hamilton,New Zealand,2000,2,106,270,3,1,265,576,9,159,306,6,29.444444444444443,<=30,NZ,Away,Upto 2014
SK Warne,AUS,Spin,2001-02-27,Wankhede,India,2001,2,107,300,5,1,392,686,14,285,386,9,28.0,<=30,IND,Away,Upto 2014
SK Warne,AUS,Spin,2001-03-11,Eden Gardens,India,2001,2,217,325,3,1,625,1131,20,408,806,17,31.25,>30,IND,Away,Upto 2014
SK Warne,AUS,Spin,2001-03-18,Chennai,India,2001,2,181,288,2,1,924,1783,26,743,1495,24,35.53846153846154,>30,IND,Away,Upto 2014
SK Warne,AUS,Spin,2001-07-05,Birmingham,England,2001,2,100,175,8,1,315,491,10,215,316,2,31.5,>30,ENG,Away,Upto 2014
SK Warne,AUS,Spin,2001-07-19,Lord's,England,2001,2,74,153,3,1,166,273,3,92,120,0,55.333333333333336,>30,ENG,Away,Upto 2014
SK Warne,AUS,Spin,2001-08-02,Nottingham,England,2001,2,70,204,8,1,88,234,9,18,30,1,9.777777777777779,<=30,ENG,Away,Upto 2014
SK Warne,AUS,Spin,2001-08-16,Leeds,England,2001,2,107,206,1,1,126,236,1,19,30,0,126.0,>30,ENG,Away,Upto 2014
SK Warne,AUS,Spin,2001-08-23,The Oval,England,2001,2,229,434,11,1,630,1004,15,401,570,4,42.0,>30,ENG,Away,Upto 2014
SK Warne,AUS,Spin,2001-11-08,Brisbane,Australia,2001,2,150,216,3,1,231,316,3,81,100,0,77.0,>30,AUS,Home,Upto 2014
SK Warne,AUS,Spin,2001-11-22,Hobart,Australia,2001,1,70,146,1,1,238,404,7,168,258,6,34.0,>30,AUS,Home,Upto 2014
SK Warne,AUS,Spin,2001-11-30,W.A.C.A,Australia,2001,2,210,384,2,1,465,898,10,255,514,8,46.5,>30,AUS,Home,Upto 2014
SK Warne,AUS,Spin,2001-12-14,Adelaide,Australia,2001,2,170,412,8,1,425,803,15,255,391,7,28.333333333333332,<=30,AUS,Home,Upto 2014
SK Warne,AUS,Spin,2001-12-26,Melbourne,Australia,2001,2,124,258,3,1,251,480,5,127,222,2,50.2,>30,AUS,Home,Upto 2014
SK Warne,AUS,Spin,2002-01-02,Sydney,Australia,2002,2,179,371,6,1,581,1150,17,402,779,11,34.1764705882353,>30,AUS,Home,Upto 2014
SK Warne,AUS,Spin,2002-02-22,Johannesburg,South Africa,2002,2,70,126,6,1,223,336,7,153,210,1,31.857142857142858,>30,SA,Away,Upto 2014
SK Warne,AUS,Spin,2002-03-08,Cape Town,South Africa,2002,2,231,588,8,1,472,895,14,241,307,6,33.714285714285715,>30,SA,Away,Upto 2014
SK Warne,AUS,Spin,2002-03-15,Durban,South Africa,2002,2,141,258,6,1,268,461,12,127,203,6,22.333333333333332,<=30,SA,Away,Upto 2014
SK Warne,AUS,Spin,2002-10-03,Colombo (PSS),Sri Lanka,2002,2,188,330,11,1,409,724,19,221,394,8,21.526315789473685,<=30,SL,Away,Upto 2014
SK Warne,AUS,Spin,2002-10-11,Sharjah,UAE,2002,2,24,107,8,1,223,467,13,199,360,5,17.153846153846153,<=30,UAE,Away,Upto 2014
SK Warne,AUS,Spin,2002-10-19,Sharjah,UAE,2002,2,130,307,8,1,467,889,13,337,582,5,35.92307692307692,>30,UAE,Away,Upto 2014
SK Warne,AUS,Spin,2002-11-07,Brisbane,Australia,2002,2,116,223,4,1,484,801,12,368,578,8,40.333333333333336,>30,AUS,Home,Upto 2014
SK Warne,AUS,Spin,2002-11-21,Adelaide,Australia,2002,2,129,354,7,1,378,744,13,249,390,6,29.076923076923077,<=30,AUS,Home,Upto 2014
SK Warne,AUS,Spin,2002-11-29,W.A.C.A,Australia,2002,2,102,210,3,1,250,379,8,148,169,5,31.25,>30,AUS,Home,Upto 2014
SK Warne,AUS,Spin,2004-03-08,Galle,Sri Lanka,2004,2,159,346,10,1,953,1791,32,794,1445,22,29.78125,<=30,SL,Away,Upto 2014
SK Warne,AUS,Spin,2004-03-16,Kandy,Sri Lanka,2004,2,155,248,10,1,537,881,19,382,633,9,28.263157894736842,<=30,SL,Away,Upto 2014
SK Warne,AUS,Spin,2004-03-24,Colombo (SSC),Sri Lanka,2004,2,207,414,6,1,844,1656,26,637,1242,20,32.46153846153846,>30,SL,Away,Upto 2014
SK Warne,AUS,Spin,2004-07-01,Darwin,Australia,2004,2,81,155,3,1,223,419,7,142,264,4,31.857142857142858,>30,AUS,Home,Upto 2014
SK Warne,AUS,Spin,2004-07-09,Cairns,Australia,2004,2,199,450,7,1,552,988,20,353,538,13,27.6,<=30,AUS,Home,Upto 2014
SK Warne,AUS,Spin,2004-10-06,Bengaluru,India,2004,2,193,360,4,1,685,1243,20,492,883,16,34.25,>30,IND,Away,Upto 2014
SK Warne,AUS,Spin,2004-10-14,Chennai,India,2004,1,125,255,6,1,557,1169,24,432,914,18,23.208333333333332,<=30,IND,Away,Upto 2014
SK Warne,AUS,Spin,2004-10-26,Nagpur,India,2004,2,103,225,4,1,469,867,12,366,642,8,39.083333333333336,>30,IND,Away,Upto 2014
SK Warne,AUS,Spin,2004-11-18,Brisbane,Australia,2004,2,112,239,8,1,278,563,12,166,324,4,23.166666666666668,<=30,AUS,Home,Upto 2014
SK Warne,AUS,Spin,2004-11-26,Adelaide,Australia,2004,2,144,333,3,1,578,1205,15,434,872,12,38.53333333333333,>30,AUS,Home,Upto 2014
SK Warne,AUS,Spin,2004-12-16,W.A.C.A,Australia,2004,1,38,126,3,1,275,498,5,237,372,2,55.0,>30,AUS,Home,Upto 2014
SK Warne,AUS,Spin,2004-12-26,Melbourne,Australia,2004,2,169,321,6,1,412,701,11,243,380,5,37.45454545454545,>30,AUS,Home,Upto 2014
SK Warne,AUS,Spin,2005-01-02,Sydney,Australia,2005,2,195,300,5,1,684,1068,21,489,768,16,32.57142857142857,>30,AUS,Home,Upto 2014
SK Warne,AUS,Spin,2005-03-10,Christchurch,New Zealand,2005,2,151,324,7,1,328,677,14,177,353,7,23.428571428571427,<=30,NZ,Away,Upto 2014
SK Warne,AUS,Spin,2005-03-18,Wellington,New Zealand,2005,2,83,189,3,1,261,489,6,178,300,3,43.5,>30,NZ,Away,Upto 2014
SK Warne,AUS,Spin,2005-03-26,Auckland,New Zealand,2005,2,140,276,7,1,283,621,8,143,345,1,35.375,>30,NZ,Away,Upto 2014
SK Warne,AUS,Spin,2005-07-21,Lord's,England,2005,2,83,162,6,1,139,228,6,56,66,0,23.166666666666668,<=30,ENG,Away,Upto 2014
SK Warne,AUS,Spin,2005-08-04,Birmingham,England,2005,2,162,291,10,1,308,537,15,146,246,5,20.533333333333335,<=30,ENG,Away,Upto 2014
SK Warne,AUS,Spin,2005-08-11,Manchester,England,2005,2,173,350,4,1,423,776,8,250,426,4,52.875,>30,ENG,Away,Upto 2014
SK Warne,AUS,Spin,2005-08-25,Nottingham,England,2005,2,133,258,8,1,240,426,10,107,168,2,24.0,<=30,ENG,Away,Upto 2014
SK Warne,AUS,Spin,2005-09-08,The Oval,England,2005,2,246,456,12,1,342,624,12,96,168,0,28.5,<=30,ENG,Away,Upto 2014
SK Warne,AUS,Spin,2005-10-14,Sydney,Australia,2005,2,71,186,6,1,421,817,21,350,631,15,20.047619047619047,<=30,AUS,Home,Upto 2014
SK Warne,AUS,Spin,2005-11-03,Brisbane,Australia,2005,2,49,180,5,1,248,570,7,199,390,2,35.42857142857143,>30,AUS,Home,Upto 2014
SK Warne,AUS,Spin,2005-11-17,Hobart,Australia,2005,2,160,300,4,1,310,697,10,150,397,6,31.0,>30,AUS,Home,Upto 2014
SK Warne,AUS,Spin,2005-11-25,Adelaide,Australia,2005,2,157,314,7,1,347,668,10,190,354,3,34.7,>30,AUS,Home,Upto 2014
SK Warne,AUS,Spin,2005-12-16,W.A.C.A,Australia,2005,2,175,456,6,1,218,526,6,43,70,0,36.333333333333336,>30,AUS,Home,Upto 2014
SK Warne,AUS,Spin,2005-12-26,Melbourne,Australia,2005,2,136,294,6,1,426,859,14,290,565,8,30.428571428571427,>30,AUS,Home,Upto 2014
SK Warne,AUS,Spin,2006-01-02,Sydney,Australia,2006,2,151,282,2,1,507,813,9,356,531,7,56.333333333333336,>30,AUS,Home,Upto 2014
SK Warne,AUS,Spin,2006-03-16,Cape Town,South Africa,2006,2,118,167,3,1,224,354,5,106,187,2,44.8,>30,SA,Away,Upto 2014
SK Warne,AUS,Spin,2006-03-24,Durban,South Africa,2006,2,166,365,8,1,362,753,11,196,388,3,32.90909090909091,>30,SA,Away,Upto 2014
SK Warne,AUS,Spin,2006-03-31,Johannesburg,South Africa,2006,2,139,234,4,1,258,450,7,119,216,3,36.857142857142854,>30,SA,Away,Upto 2014
SK Warne,AUS,Spin,2006-04-09,Fatullah,Bangladesh,2006,2,140,198,3,1,739,1451,25,599,1253,22,29.56,<=30,BAN,Away,Upto 2014
SK Warne,AUS,Spin,2006-04-16,Chattogram,Bangladesh,2006,2,160,326,8,1,796,1393,18,636,1067,10,44.22222222222222,>30,BAN,Away,Upto 2014
SK Warne,AUS,Spin,2006-11-23,Brisbane,Australia,2006,2,149,258,4,1,304,510,5,155,252,1,60.8,>30,AUS,Home,Upto 2014
SK Warne,AUS,Spin,2006-12-01,Adelaide,Australia,2006,2,216,510,5,1,457,990,7,241,480,2,65.28571428571429,>30,AUS,Home,Upto 2014
SK Warne,AUS,Spin,2006-12-14,W.A.C.A,Australia,2006,2,156,290,5,1,460,746,15,304,456,10,30.666666666666668,>30,AUS,Home,Upto 2014
SK Warne,AUS,Spin,2006-12-26,Melbourne,Australia,2006,2,85,218,7,1,167,338,7,82,120,0,23.857142857142858,<=30,AUS,Home,Upto 2014
SK Warne,AUS,Spin,2007-01-02,Sydney,Australia,2007,2,92,172,2,1,208,355,4,116,183,2,52.0,>30,AUS,Home,Upto 2014
SL Boock,NZ,Spin,1978-02-10,Wellington,New Zealand,1978,1,21,80,1,1,32,112,1,11,32,0,32.0,>30,NZ,Home,Upto 2014
SL Boock,NZ,Spin,1978-02-24,Christchurch,New Zealand,1978,1,41,168,1,1,101,488,7,60,320,6,14.428571428571429,<=30,NZ,Home,Upto 2014
SL Boock,NZ,Spin,1978-03-04,Auckland,New Zealand,1978,1,67,227,5,1,296,915,11,229,688,6,26.90909090909091,<=30,NZ,Home,Upto 2014
SL Boock,NZ,Spin,1978-07-27,The Oval,England,1978,2,116,330,3,1,243,991,11,127,661,8,22.09090909090909,<=30,ENG,Away,Upto 2014
SL Boock,NZ,Spin,1978-08-10,Nottingham,England,1978,1,29,168,2,1,118,533,8,89,365,6,14.75,<=30,ENG,Away,Upto 2014
SL Boock,NZ,Spin,1978-08-24,Lord's,England,1978,2,44,180,1,1,103,427,3,59,247,2,34.333333333333336,>30,ENG,Away,Upto 2014
SL Boock,NZ,Spin,1979-02-02,Christchurch,New Zealand,1979,2,92,270,2,1,329,962,17,237,692,15,19.352941176470587,<=30,NZ,Home,Upto 2014
SL Boock,NZ,Spin,1979-02-16,Napier,New Zealand,1979,2,118,336,2,1,237,587,3,119,251,1,79.0,>30,NZ,Home,Upto 2014
SL Boock,NZ,Spin,1979-02-23,Auckland,New Zealand,1979,1,28,48,0,1,67,144,1,39,96,1,67.0,>30,NZ,Home,Upto 2014
SL Boock,NZ,Spin,1980-02-08,Dunedin,New Zealand,1980,2,46,144,1,1,109,276,3,63,132,2,36.333333333333336,>30,NZ,Home,Upto 2014
SL Boock,NZ,Spin,1980-02-22,Christchurch,New Zealand,1980,1,69,108,1,1,117,178,4,48,70,3,29.25,<=30,NZ,Home,Upto 2014
SL Boock,NZ,Spin,1980-02-29,Auckland,New Zealand,1980,2,35,48,0,1,35,72,1,0,24,1,35.0,>30,NZ,Home,Upto 2014
SL Boock,NZ,Spin,1984-02-03,Christchurch,New Zealand,1984,2,37,114,4,1,37,114,4,0,0,0,9.25,<=30,NZ,Home,Upto 2014
SL Boock,NZ,Spin,1984-02-10,Auckland,New Zealand,1984,1,103,369,3,1,236,653,6,133,284,3,39.333333333333336,>30,NZ,Home,Upto 2014
SL Boock,NZ,Spin,1984-03-09,Kandy,Sri Lanka,1984,2,91,195,7,1,410,807,17,319,612,10,24.11764705882353,<=30,SL,Away,Upto 2014
SL Boock,NZ,Spin,1984-03-16,Colombo (SSC),Sri Lanka,1984,2,83,318,1,1,166,567,3,83,249,2,55.333333333333336,>30,SL,Away,Upto 2014
SL Boock,NZ,Spin,1984-03-24,Colombo (CCC),Sri Lanka,1984,2,83,216,3,1,342,828,8,259,612,5,42.75,>30,SL,Away,Upto 2014
SL Boock,NZ,Spin,1984-11-16,Lahore,Pakistan,1984,2,109,246,3,1,445,1036,19,336,790,16,23.42105263157895,<=30,PAK,Away,Upto 2014
SL Boock,NZ,Spin,1984-11-25,Hyderabad (Sind),Pakistan,1984,2,156,364,8,1,706,1491,27,550,1127,19,26.14814814814815,<=30,PAK,Away,Upto 2014
SL Boock,NZ,Spin,1984-12-10,Karachi,Pakistan,1984,2,166,426,6,1,562,1340,12,396,914,6,46.833333333333336,>30,PAK,Away,Upto 2014
SL Boock,NZ,Spin,1985-01-18,Wellington,New Zealand,1985,1,117,270,5,1,422,1002,10,305,732,5,42.2,>30,NZ,Home,Upto 2014
SL Boock,NZ,Spin,1985-01-25,Auckland,New Zealand,1985,1,10,24,1,1,99,212,2,89,188,1,49.5,>30,NZ,Home,Upto 2014
SL Boock,NZ,Spin,1985-03-29,Port of Spain,West Indies,1985,2,104,198,1,1,167,462,3,63,264,2,55.666666666666664,>30,WI,Away,Upto 2014
SL Boock,NZ,Spin,1985-04-06,Georgetown,West Indies,1985,2,159,366,0,1,331,798,0,172,432,0,inf,>30,WI,Away,Upto 2014
SL Boock,NZ,Spin,1985-04-26,Bridgetown,West Indies,1985,2,76,96,1,1,111,198,1,35,102,0,111.0,>30,WI,Away,Upto 2014
SL Boock,NZ,Spin,1985-11-22,Sydney,Australia,1985,2,102,311,3,1,694,1882,25,592,1571,22,27.76,<=30,AUS,Away,Upto 2014
SL Boock,NZ,Spin,1987-02-20,Wellington,New Zealand,1987,2,84,252,5,1,313,876,9,229,624,4,34.77777777777778,>30,NZ,Home,Upto 2014
SL Boock,NZ,Spin,1987-02-27,Auckland,New Zealand,1987,1,96,150,2,1,278,540,5,182,390,3,55.6,>30,NZ,Home,Upto 2014
SL Boock,NZ,Spin,1988-03-03,Wellington,New Zealand,1988,1,53,156,1,1,303,839,2,250,683,1,151.5,>30,NZ,Home,Upto 2014
SL Boock,NZ,Spin,1989-02-24,Auckland,New Zealand,1989,1,229,420,1,1,705,1609,10,476,1189,9,70.5,>30,NZ,Home,Upto 2014
SL Malinga,SL,Pace,2004-07-01,Darwin,Australia,2004,2,92,175,6,1,425,1034,30,333,859,24,14.166666666666666,<=30,AUS,Away,Upto 2014
SL Malinga,SL,Pace,2004-07-09,Cairns,Australia,2004,2,172,206,4,1,844,1536,15,672,1330,11,56.266666666666666,>30,AUS,Away,Upto 2014
SL Malinga,SL,Pace,2004-08-11,Colombo (SSC),Sri Lanka,2004,2,105,156,4,1,548,1014,21,443,858,17,26.095238095238095,<=30,SL,Home,Upto 2014
SL Malinga,SL,Pace,2004-10-20,Faisalabad,Pakistan,2004,2,63,96,1,1,726,1252,21,663,1156,20,34.57142857142857,>30,PAK,Away,Upto 2014
SL Malinga,SL,Pace,2005-04-04,Napier,New Zealand,2005,2,210,352,9,1,832,1538,21,622,1186,12,39.61904761904762,>30,NZ,Away,Upto 2014
SL Malinga,SL,Pace,2005-04-11,Wellington,New Zealand,2005,1,124,204,2,1,716,1428,28,592,1224,26,25.571428571428573,<=30,NZ,Away,Upto 2014
SL Malinga,SL,Pace,2005-07-13,Colombo (SSC),Sri Lanka,2005,2,93,156,4,1,469,856,25,376,700,21,18.76,<=30,SL,Home,Upto 2014
SL Malinga,SL,Pace,2005-07-22,Kandy,Sri Lanka,2005,2,70,126,1,1,490,931,20,420,805,19,24.5,<=30,SL,Home,Upto 2014
SL Malinga,SL,Pace,2005-09-12,Colombo (RPS),Sri Lanka,2005,2,76,84,4,1,228,320,8,152,236,4,28.5,<=30,SL,Home,Upto 2014
SL Malinga,SL,Pace,2005-09-20,Colombo (PSS),Sri Lanka,2005,2,63,96,2,1,387,537,17,324,441,15,22.764705882352942,<=30,SL,Home,Upto 2014
SL Malinga,SL,Pace,2005-12-18,Ahmedabad,India,2005,2,176,264,4,1,356,678,10,180,414,6,35.6,>30,IND,Away,Upto 2014
SL Malinga,SL,Pace,2006-02-28,Chattogram,Bangladesh,2006,2,98,179,4,1,293,539,9,195,360,5,32.55555555555556,>30,BAN,Away,Upto 2014
SL Malinga,SL,Pace,2006-03-08,Bogra,Bangladesh,2006,2,124,205,5,1,292,547,11,168,342,6,26.545454545454547,<=30,BAN,Away,Upto 2014
SL Malinga,SL,Pace,2006-03-26,Colombo (SSC),Sri Lanka,2006,2,74,150,3,1,568,1044,16,494,894,13,35.5,>30,SL,Home,Upto 2014
SL Malinga,SL,Pace,2006-04-03,Kandy,Sri Lanka,2006,2,52,74,1,1,524,943,20,472,869,19,26.2,<=30,SL,Home,Upto 2014
SL Malinga,SL,Pace,2006-05-25,Birmingham,England,2006,2,97,123,2,1,504,1093,20,407,970,18,25.2,<=30,ENG,Away,Upto 2014
SL Malinga,SL,Pace,2006-06-02,Nottingham,England,2006,2,86,181,2,1,634,1203,19,548,1022,17,33.36842105263158,>30,ENG,Away,Upto 2014
SL Malinga,SL,Pace,2006-07-27,Colombo (SSC),Sri Lanka,2006,2,123,158,1,1,781,1191,14,658,1033,13,55.785714285714285,>30,SL,Home,Upto 2014
SL Malinga,SL,Pace,2006-08-04,Colombo (PSS),Sri Lanka,2006,2,136,180,3,1,843,1453,20,707,1273,17,42.15,>30,SL,Home,Upto 2014
SL Malinga,SL,Pace,2006-12-07,Christchurch,New Zealand,2006,2,78,142,2,1,515,1047,25,437,905,23,20.6,<=30,NZ,Away,Upto 2014
SL Malinga,SL,Pace,2006-12-15,Wellington,New Zealand,2006,2,130,204,7,1,700,1140,20,570,936,13,35.0,>30,NZ,Away,Upto 2014
SL Malinga,SL,Pace,2007-06-25,Colombo (SSC),Sri Lanka,2007,2,111,144,5,1,288,528,11,177,384,6,26.181818181818183,<=30,SL,Home,Upto 2014
SL Malinga,SL,Pace,2007-07-03,Colombo (PSS),Sri Lanka,2007,2,111,144,4,1,411,758,15,300,614,11,27.4,<=30,SL,Home,Upto 2014
SL Malinga,SL,Pace,2007-07-11,Kandy,Sri Lanka,2007,2,87,120,3,1,437,738,11,350,618,8,39.72727272727273,>30,SL,Home,Upto 2014
SL Malinga,SL,Pace,2007-11-16,Hobart,Australia,2007,2,217,282,2,1,932,1457,19,715,1175,17,49.05263157894737,>30,AUS,Away,Upto 2014
SL Malinga,SL,Pace,2007-12-01,Kandy,Sri Lanka,2007,2,125,210,2,1,767,1367,21,642,1157,19,36.523809523809526,>30,SL,Home,Upto 2014
SL Malinga,SL,Pace,2007-12-09,Colombo (SSC),Sri Lanka,2007,2,115,192,3,1,676,1421,13,561,1229,10,52.0,>30,SL,Home,Upto 2014
SL Malinga,SL,Pace,2007-12-18,Galle,Sri Lanka,2007,2,68,174,1,1,606,1192,16,538,1018,15,37.875,>30,SL,Home,Upto 2014
SL Malinga,SL,Pace,2010-07-18,Galle,Sri Lanka,2010,2,105,180,7,1,560,768,16,455,588,9,35.0,>30,SL,Home,Upto 2014
SL Malinga,SL,Pace,2010-08-03,Colombo (PSS),Sri Lanka,2010,2,168,252,3,1,534,849,8,366,597,5,66.75,>30,SL,Home,Upto 2014
SL Watkin,ENG,Pace,1991-06-06,Leeds,England,1991,2,93,126,5,1,749,1729,37,656,1603,32,20.243243243243242,<=30,ENG,Home,Upto 2014
SL Watkin,ENG,Pace,1991-06-20,Lord's,England,1991,1,60,90,0,1,685,1326,19,625,1236,19,36.05263157894737,>30,ENG,Home,Upto 2014
SL Watkin,ENG,Pace,1993-08-19,The Oval,England,1993,2,152,318,6,1,872,1626,33,720,1308,27,26.424242424242426,<=30,ENG,Home,Upto 2014
SLV Raju,IND,Spin,1990-02-02,Christchurch,New Zealand,1990,1,86,210,3,1,205,522,7,119,312,4,29.285714285714285,<=30,NZ,Away,Upto 2014
SLV Raju,IND,Spin,1990-02-09,Napier,New Zealand,1990,1,27,66,0,1,117,306,0,90,240,0,inf,>30,NZ,Away,Upto 2014
SLV Raju,IND,Spin,1990-11-23,Chandigarh,India,1990,2,37,323,8,1,286,1097,16,249,774,8,17.875,<=30,IND,Home,Upto 2014
SLV Raju,IND,Spin,1991-11-29,Brisbane,Australia,1991,2,103,204,1,1,182,335,1,79,131,0,182.0,>30,AUS,Away,Upto 2014
SLV Raju,IND,Spin,1991-12-26,Melbourne,Australia,1991,2,69,138,1,1,193,372,3,124,234,2,64.33333333333333,>30,AUS,Away,Upto 2014
SLV Raju,IND,Spin,1992-01-25,Adelaide,Australia,1992,2,132,406,5,1,316,796,8,184,390,3,39.5,>30,AUS,Away,Upto 2014
SLV Raju,IND,Spin,1992-02-01,W.A.C.A,Australia,1992,2,134,282,2,1,143,312,2,9,30,0,71.5,>30,AUS,Away,Upto 2014
SLV Raju,IND,Spin,1992-10-18,Harare,Zimbabwe,1992,2,96,276,0,1,383,1070,9,287,794,9,42.55555555555556,>30,ZIM,Away,Upto 2014
SLV Raju,IND,Spin,1992-12-26,Gqeberha,South Africa,1992,2,123,384,3,1,329,957,7,206,573,4,47.0,>30,SA,Away,Upto 2014
SLV Raju,IND,Spin,1993-01-02,Cape Town,South Africa,1993,2,119,402,1,1,326,1020,6,207,618,5,54.333333333333336,>30,SA,Away,Upto 2014
SLV Raju,IND,Spin,1993-01-29,Eden Gardens,India,1993,2,119,372,6,1,470,1482,23,351,1110,17,20.434782608695652,<=30,IND,Home,Upto 2014
SLV Raju,IND,Spin,1993-02-11,Chennai,India,1993,2,179,463,6,1,792,1720,20,613,1257,14,39.6,>30,IND,Home,Upto 2014
SLV Raju,IND,Spin,1993-02-19,Wankhede,India,1993,2,170,425,4,1,804,1796,20,634,1371,16,40.2,>30,IND,Home,Upto 2014
SLV Raju,IND,Spin,1993-08-04,Colombo (PSS),Sri Lanka,1993,2,121,312,2,1,715,1623,16,594,1311,14,44.6875,>30,SL,Away,Upto 2014
SLV Raju,IND,Spin,1994-01-18,Lucknow,India,1994,2,53,204,3,1,633,1538,23,580,1334,20,27.52173913043478,<=30,IND,Home,Upto 2014
SLV Raju,IND,Spin,1994-01-26,Bengaluru,India,1994,2,50,96,2,1,625,1188,15,575,1092,13,41.666666666666664,>30,IND,Home,Upto 2014
SLV Raju,IND,Spin,1994-02-08,Ahmedabad,India,1994,2,125,338,11,1,473,1433,26,348,1095,15,18.192307692307693,<=30,IND,Home,Upto 2014
SLV Raju,IND,Spin,1994-03-19,Hamilton,New Zealand,1994,2,67,224,3,1,491,1160,14,424,936,11,35.07142857142857,>30,NZ,Away,Upto 2014
SLV Raju,IND,Spin,1994-11-18,Wankhede,India,1994,2,145,298,8,1,528,1096,17,383,798,9,31.058823529411764,>30,IND,Home,Upto 2014
SLV Raju,IND,Spin,1994-12-01,Nagpur,India,1994,2,185,462,7,1,761,1735,22,576,1273,15,34.59090909090909,>30,IND,Home,Upto 2014
SLV Raju,IND,Spin,1994-12-10,Mohali,India,1994,2,133,277,5,1,470,841,10,337,564,5,47.0,>30,IND,Home,Upto 2014
SLV Raju,IND,Spin,1995-10-18,Bengaluru,India,1995,2,90,180,3,1,388,811,15,298,631,12,25.866666666666667,<=30,IND,Home,Upto 2014
SLV Raju,IND,Spin,1996-07-04,Nottingham,England,1996,1,76,258,1,1,381,828,3,305,570,2,127.0,>30,ENG,Away,Upto 2014
SLV Raju,IND,Spin,1998-03-06,Chennai,India,1998,2,85,282,6,1,809,1753,28,724,1471,22,28.892857142857142,<=30,IND,Home,Upto 2014
SLV Raju,IND,Spin,1998-03-18,Eden Gardens,India,1998,2,62,198,0,1,634,1306,12,572,1108,12,52.833333333333336,>30,IND,Home,Upto 2014
SLV Raju,IND,Spin,1998-03-25,Bengaluru,India,1998,2,155,312,1,1,817,1511,22,662,1199,21,37.13636363636363,>30,IND,Home,Upto 2014
SLV Raju,IND,Spin,2001-03-11,Eden Gardens,India,2001,2,116,210,1,1,625,1131,20,509,921,19,31.25,>30,IND,Home,Upto 2014
SM Boland,AUS,Pace,2021-12-26,Melbourne,Australia,2021,2,55,102,7,1,423,909,26,368,807,19,16.26923076923077,<=30,AUS,Home,After 1965
SM Boland,AUS,Pace,2022-01-05,Sydney,Australia,2022,2,66,229,7,1,798,1621,23,732,1392,16,34.69565217391305,>30,AUS,Home,After 1965
SM Boland,AUS,Pace,2022-01-14,Hobart,Australia,2022,2,51,156,4,1,700,1252,39,649,1096,35,17.94871794871795,<=30,AUS,Home,After 1965
SM Boland,AUS,Pace,2022-12-08,Adelaide,Australia,2022,2,45,156,3,1,712,1214,23,667,1058,20,30.956521739130434,>30,AUS,Home,After 1965
SM Boland,AUS,Pace,2022-12-17,Brisbane,Australia,2022,2,42,114,4,1,432,770,30,390,656,26,14.4,<=30,AUS,Home,After 1965
SM Boland,AUS,Pace,2022-12-26,Melbourne,Australia,2022,2,83,174,3,1,684,1223,19,601,1049,16,36.0,>30,AUS,Home,After 1965
SM Boland,AUS,Pace,2023-02-09,Nagpur,India,2023,1,34,102,0,1,173,354,6,139,252,6,28.833333333333332,<=30,IND,Away,After 1965
SM Boland,AUS,Pace,2023-06-07,The Oval,England,2023,2,105,216,5,1,1032,1672,28,927,1456,23,36.857142857142854,>30,ENG,Away,After 1965
SM Boland,AUS,Pace,2023-06-16,Birmingham,England,2023,2,147,156,2,1,808,1386,24,661,1230,22,33.666666666666664,>30,ENG,Away,After 1965
SM Boland,AUS,Pace,2023-07-06,Leeds,England,2023,2,84,126,0,1,803,1163,34,719,1037,34,23.61764705882353,<=30,ENG,Away,After 1965
SM Boland,AUS,Pace,2024-12-06,Adelaide,Australia,2024,2,105,131,5,1,507,779,28,402,648,23,18.107142857142858,<=30,AUS,Home,After 1965
SM Boland,AUS,Pace,2024-12-26,Melbourne,Australia,2024,2,96,258,6,1,849,1700,27,753,1442,21,31.444444444444443,>30,AUS,Home,After 1965
SM Boland,AUS,Pace,2025-01-03,Sydney,Australia,2025,2,76,221,10,1,502,925,30,426,704,20,16.733333333333334,<=30,AUS,Home,After 1965
SM Curran,ENG,Pace,2018-06-01,Leeds,England,2018,2,43,85,2,1,552,1035,26,509,950,24,21.23076923076923,<=30,ENG,Home,After 1965
SM Curran,ENG,Pace,2018-08-01,Birmingham,England,2018,2,92,138,5,1,700,1284,29,608,1146,24,24.137931034482758,<=30,ENG,Home,After 1965
SM Curran,ENG,Pace,2018-08-09,Lord's,England,2018,2,53,90,1,1,483,867,26,430,777,25,18.576923076923077,<=30,ENG,Home,After 1965
SM Curran,ENG,Pace,2018-08-30,Southampton,England,2018,2,42,118,2,1,624,1317,26,582,1199,24,24.0,<=30,ENG,Home,After 1965
SM Curran,ENG,Pace,2018-09-07,The Oval,England,2018,2,72,120,3,1,781,1629,21,709,1509,18,37.19047619047619,>30,ENG,Home,After 1965
SM Curran,ENG,Pace,2018-11-06,Galle,Sri Lanka,2018,2,31,66,1,1,225,432,6,194,366,5,37.5,>30,SL,Away,After 1965
SM Curran,ENG,Pace,2018-11-14,Pallekele,Sri Lanka,2018,1,19,24,0,1,138,240,1,119,216,1,138.0,>30,SL,Away,After 1965
SM Curran,ENG,Pace,2019-01-23,Bridgetown,West Indies,2019,2,123,174,1,1,635,1301,24,512,1127,23,26.458333333333332,<=30,WI,Away,After 1965
SM Curran,ENG,Pace,2019-01-31,North Sound,West Indies,2019,1,38,78,0,1,523,1214,27,485,1136,27,19.37037037037037,<=30,WI,Away,After 1965
SM Curran,ENG,Pace,2019-07-24,Lord's,England,2019,1,28,60,3,1,515,949,38,487,889,35,13.552631578947368,<=30,ENG,Home,After 1965
SM Curran,ENG,Pace,2019-09-12,The Oval,England,2019,2,68,150,3,1,856,1530,30,788,1380,27,28.533333333333335,<=30,ENG,Home,After 1965
SM Curran,ENG,Pace,2019-11-21,Mount Maunganui,New Zealand,2019,1,119,210,3,1,805,1856,23,686,1646,20,35.0,>30,NZ,Away,After 1965
SM Curran,ENG,Pace,2019-11-29,Hamilton,New Zealand,2019,2,119,235,3,1,881,1878,20,762,1643,17,44.05,>30,NZ,Away,After 1965
SM Curran,ENG,Pace,2019-12-26,Centurion,South Africa,2019,2,109,196,5,1,888,1593,38,779,1397,33,23.36842105263158,<=30,SA,Away,After 1965
SM Curran,ENG,Pace,2020-01-03,Cape Town,South Africa,2020,2,76,174,3,1,689,1635,31,613,1461,28,22.225806451612904,<=30,SA,Away,After 1965
SM Curran,ENG,Pace,2020-01-16,Gqeberha,South Africa,2020,2,78,102,1,1,517,1029,13,439,927,12,39.76923076923077,>30,SA,Away,After 1965
SM Curran,ENG,Pace,2020-01-24,Johannesburg,South Africa,2020,2,63,138,1,1,1022,1773,39,959,1635,38,26.205128205128204,<=30,SA,Away,After 1965
SM Curran,ENG,Pace,2020-07-16,Manchester,England,2020,2,100,168,3,1,747,1583,23,647,1415,20,32.47826086956522,>30,ENG,Home,After 1965
SM Curran,ENG,Pace,2020-08-13,Southampton,England,2020,1,44,108,1,1,292,740,12,248,632,11,24.333333333333332,<=30,ENG,Home,After 1965
SM Curran,ENG,Pace,2021-01-14,Galle,Sri Lanka,2021,2,45,90,2,1,215,534,7,170,444,5,30.714285714285715,>30,SL,Away,After 1965
SM Curran,ENG,Pace,2021-01-22,Galle,Sri Lanka,2021,2,69,123,1,1,261,633,10,192,510,9,26.1,<=30,SL,Away,After 1965
SM Curran,ENG,Pace,2021-08-04,Nottingham,England,2021,1,57,90,0,1,737,1406,30,680,1316,30,24.566666666666666,<=30,ENG,Home,After 1965
SM Curran,ENG,Pace,2021-08-12,Lord's,England,2021,2,114,240,1,1,917,2031,34,803,1791,33,26.970588235294116,<=30,ENG,Home,After 1965
SM Curran,ENG,Pace,2021-08-25,Leeds,England,2021,2,67,114,2,1,610,1311,27,543,1197,25,22.59259259259259,<=30,ENG,Home,After 1965
SM Ervine,ZIM,Spin,2003-05-22,Lord's,England,2003,1,95,132,2,1,157,306,4,62,174,2,39.25,>30,ENG,Away,Upto 2014
SM Ervine,ZIM,Spin,2003-06-05,Chester-le-Street,England,2003,1,17,18,0,1,179,420,2,162,402,2,89.5,>30,ENG,Away,Upto 2014
SM Ervine,ZIM,Spin,2003-10-09,W.A.C.A,Australia,2003,1,146,186,4,1,603,903,11,457,717,7,54.81818181818182,>30,AUS,Away,Upto 2014
SM Ervine,ZIM,Spin,2004-02-19,Harare,Zimbabwe,2004,2,86,144,0,1,538,1129,14,452,985,14,38.42857142857143,>30,ZIM,Home,Upto 2014
SM Ervine,ZIM,Spin,2004-02-26,Bulawayo,Zimbabwe,2004,1,44,90,3,1,156,307,6,112,217,3,26.0,<=30,ZIM,Home,Upto 2014
SM Gavaskar,IND,Spin,1971-03-06,Port of Spain,West Indies,1971,1,9,6,0,1,708,1890,29,699,1884,29,24.413793103448278,<=30,WI,Away,Upto 2014
SM Gavaskar,IND,Spin,1971-08-05,Manchester,England,1971,2,41,84,0,1,461,1050,7,420,966,7,65.85714285714286,>30,ENG,Away,Upto 2014
SM Gavaskar,IND,Spin,1971-08-19,The Oval,England,1971,1,1,6,0,1,621,1646,28,620,1640,28,22.178571428571427,<=30,ENG,Away,Upto 2014
SM Gavaskar,IND,Spin,1972-12-20,Delhi,India,1972,1,1,6,0,1,561,1750,23,560,1744,23,24.391304347826086,<=30,IND,Home,Upto 2014
SM Gavaskar,IND,Spin,1973-01-12,Chennai,India,1973,1,6,6,0,1,632,1828,31,626,1822,31,20.387096774193548,<=30,IND,Home,Upto 2014
SM Gavaskar,IND,Spin,1973-02-06,Brabourne,India,1973,1,0,12,0,1,967,2173,20,967,2161,20,48.35,>30,IND,Home,Upto 2014
SM Gavaskar,IND,Spin,1974-07-04,Birmingham,England,1974,1,5,6,0,1,474,954,5,469,948,5,94.8,>30,ENG,Away,Upto 2014
SM Gavaskar,IND,Spin,1977-01-28,Bengaluru,India,1977,1,0,12,0,1,552,1373,26,552,1361,26,21.23076923076923,<=30,IND,Home,Upto 2014
SM Gavaskar,IND,Spin,1977-02-11,Wankhede,India,1977,2,2,18,0,1,658,1830,25,656,1812,25,26.32,<=30,IND,Home,Upto 2014
SM Gavaskar,IND,Spin,1977-12-30,Melbourne,Australia,1977,1,7,16,0,1,349,802,20,342,786,20,17.45,<=30,AUS,Away,Upto 2014
SM Gavaskar,IND,Spin,1978-10-16,Faisalabad,Pakistan,1978,1,34,30,1,1,700,1410,15,666,1380,14,46.666666666666664,>30,PAK,Away,Upto 2014
SM Gavaskar,IND,Spin,1978-10-27,Lahore,Pakistan,1978,1,10,24,0,1,591,988,6,581,964,6,98.5,>30,PAK,Away,Upto 2014
SM Gavaskar,IND,Spin,1979-10-13,Delhi,India,1979,1,10,24,0,1,604,1308,12,594,1284,12,50.333333333333336,>30,IND,Home,Upto 2014
SM Gavaskar,IND,Spin,1979-11-21,Bengaluru,India,1979,1,8,6,0,1,552,1383,11,544,1377,11,50.18181818181818,>30,IND,Home,Upto 2014
SM Gavaskar,IND,Spin,1980-02-15,Wankhede,India,1980,1,4,6,0,1,158,297,1,154,291,1,158.0,>30,IND,Home,Upto 2014
SM Gavaskar,IND,Spin,1981-03-06,Christchurch,New Zealand,1981,1,11,18,0,1,157,612,3,146,594,3,52.333333333333336,>30,NZ,Away,Upto 2014
SM Gavaskar,IND,Spin,1981-12-23,Delhi,India,1981,1,12,18,0,1,331,798,4,319,780,4,82.75,>30,IND,Home,Upto 2014
SM Gavaskar,IND,Spin,1982-01-13,Chennai,India,1982,1,2,6,0,1,285,972,8,283,966,8,35.625,>30,IND,Home,Upto 2014
SM Gavaskar,IND,Spin,1982-12-10,Lahore,Pakistan,1982,1,0,6,0,1,261,509,6,261,503,6,43.5,>30,PAK,Away,Upto 2014
SM Gavaskar,IND,Spin,1983-01-03,Faisalabad,Pakistan,1983,1,10,12,0,1,324,501,2,314,489,2,162.0,>30,PAK,Away,Upto 2014
SM Gavaskar,IND,Spin,1983-09-24,Jalandhar,India,1983,1,3,6,0,1,262,937,8,259,931,8,32.75,>30,IND,Home,Upto 2014
SM Gavaskar,IND,Spin,1983-10-05,Nagpur,India,1983,1,0,6,0,1,396,1114,18,396,1108,18,22.0,<=30,IND,Home,Upto 2014
SM Gavaskar,IND,Spin,1983-10-29,Delhi,India,1983,1,1,6,0,1,373,864,8,372,858,8,46.625,>30,IND,Home,Upto 2014
SM Gavaskar,IND,Spin,1983-11-24,Wankhede,India,1983,1,0,6,0,1,386,913,10,386,907,10,38.6,>30,IND,Home,Upto 2014
SM Gavaskar,IND,Spin,1984-12-12,Delhi,India,1984,1,10,4,0,1,622,1733,22,612,1729,22,28.272727272727273,<=30,IND,Home,Upto 2014
SM Gavaskar,IND,Spin,1987-02-03,Chennai,India,1987,1,4,6,0,1,827,1860,14,823,1854,14,59.07142857142857,>30,IND,Home,Upto 2014
SM Gavaskar,IND,Spin,1987-03-04,Ahmedabad,India,1987,1,15,24,0,1,616,1851,11,601,1827,11,56.0,>30,IND,Home,Upto 2014
SM Katich,AUS,Spin,2003-10-17,Sydney,Australia,2003,2,90,197,6,1,468,933,15,378,736,9,31.2,>30,AUS,Home,Upto 2014
SM Katich,AUS,Spin,2003-12-04,Brisbane,Australia,2003,1,16,12,0,1,333,445,5,317,433,5,66.6,>30,AUS,Home,Upto 2014
SM Katich,AUS,Spin,2003-12-12,Adelaide,Australia,2003,2,81,144,4,1,609,1006,16,528,862,12,38.0625,>30,AUS,Home,Upto 2014
SM Katich,AUS,Spin,2003-12-26,Melbourne,Australia,2003,2,34,48,1,1,455,739,13,421,691,12,35.0,>30,AUS,Home,Upto 2014
SM Katich,AUS,Spin,2004-01-02,Sydney,Australia,2004,1,84,102,0,1,831,1277,14,747,1175,14,59.357142857142854,>30,AUS,Home,Upto 2014
SM Katich,AUS,Spin,2004-03-24,Colombo (SSC),Sri Lanka,2004,2,44,72,0,1,844,1656,26,800,1584,26,32.46153846153846,>30,SL,Away,Upto 2014
SM Katich,AUS,Spin,2004-10-14,Chennai,India,2004,1,7,12,0,1,557,1169,24,550,1157,24,23.208333333333332,<=30,IND,Away,Upto 2014
SM Katich,AUS,Spin,2005-08-11,Manchester,England,2005,1,36,54,1,1,423,776,8,387,722,7,52.875,>30,ENG,Away,Upto 2014
SM Katich,AUS,Spin,2005-09-08,The Oval,England,2005,1,14,18,0,1,342,624,12,328,606,12,28.5,<=30,ENG,Away,Upto 2014
SM Katich,AUS,Spin,2008-10-29,Delhi,India,2008,2,65,96,1,1,668,1278,12,603,1182,11,55.666666666666664,>30,IND,Away,Upto 2014
SM Katich,AUS,Spin,2008-11-06,Nagpur,India,2008,1,8,18,0,1,751,1259,24,743,1241,24,31.291666666666668,>30,IND,Away,Upto 2014
SM Katich,AUS,Spin,2009-03-06,Durban,South Africa,2009,1,45,68,3,1,264,614,7,219,546,4,37.714285714285715,>30,SA,Away,Upto 2014
SM Katich,AUS,Spin,2009-03-19,Cape Town,South Africa,2009,1,9,18,2,1,333,503,11,324,485,9,30.272727272727273,>30,SA,Away,Upto 2014
SM Katich,AUS,Spin,2009-07-08,Cardiff,England,2009,2,18,30,0,1,464,923,7,446,893,7,66.28571428571429,>30,ENG,Away,Upto 2014
SM Katich,AUS,Spin,2009-08-20,The Oval,England,2009,1,9,30,0,1,318,638,12,309,608,12,26.5,<=30,ENG,Away,Upto 2014
SM Katich,AUS,Spin,2009-12-26,Melbourne,Australia,2009,1,13,12,0,1,412,721,8,399,709,8,51.5,>30,AUS,Home,Upto 2014
SM Katich,AUS,Spin,2010-01-14,Hobart,Australia,2010,2,44,78,3,1,458,793,15,414,715,12,30.533333333333335,>30,AUS,Home,Upto 2014
SM Katich,AUS,Spin,2010-10-09,Bengaluru,India,2010,1,18,30,0,1,696,1271,17,678,1241,17,40.94117647058823,>30,IND,Away,Upto 2014
SM Nurse,WI,Spin,1966-12-31,Eden Gardens,India,1966,1,7,24,0,1,445,1335,20,438,1311,20,22.25,<=30,IND,Away,Upto 2014
SM Nurse,WI,Spin,1968-02-29,Bridgetown,West Indies,1968,1,0,6,0,1,405,1049,8,405,1043,8,50.625,>30,WI,Home,Upto 2014
SM Nurse,WI,Spin,1968-03-14,Port of Spain,West Indies,1968,1,0,12,0,1,721,1580,15,721,1568,15,48.06666666666667,>30,WI,Home,Upto 2014
SM Patil,IND,Pace,1980-02-15,Wankhede,India,1980,1,8,18,0,1,555,1195,28,547,1177,28,19.821428571428573,<=30,IND,Home,Upto 2014
SM Patil,IND,Pace,1981-02-07,Melbourne,Australia,1981,2,33,87,2,1,509,1262,25,476,1175,23,20.36,<=30,AUS,Away,Upto 2014
SM Patil,IND,Pace,1981-02-21,Wellington,New Zealand,1981,2,52,198,3,1,725,1705,33,673,1507,30,21.96969696969697,<=30,NZ,Away,Upto 2014
SM Patil,IND,Pace,1981-03-06,Christchurch,New Zealand,1981,1,14,72,1,1,349,1020,11,335,948,10,31.727272727272727,>30,NZ,Away,Upto 2014
SM Patil,IND,Pace,1981-03-13,Auckland,New Zealand,1981,2,10,60,1,1,366,1193,11,356,1133,10,33.27272727272727,>30,NZ,Away,Upto 2014
SM Patil,IND,Pace,1981-11-27,Wankhede,India,1981,1,9,18,0,1,460,1013,28,451,995,28,16.428571428571427,<=30,IND,Home,Upto 2014
SM Patil,IND,Pace,1981-12-23,Delhi,India,1981,2,38,66,1,1,608,1217,15,570,1151,14,40.53333333333333,>30,IND,Home,Upto 2014
SM Patil,IND,Pace,1982-01-01,Eden Gardens,India,1982,1,13,18,0,1,453,960,12,440,942,12,37.75,>30,IND,Home,Upto 2014
SM Patil,IND,Pace,1982-07-08,The Oval,England,1982,1,48,84,1,1,668,1272,12,620,1188,11,55.666666666666664,>30,ENG,Away,Upto 2014
SM Patil,IND,Pace,1982-09-17,Chennai,India,1982,1,13,12,0,1,686,896,18,673,884,18,38.111111111111114,>30,IND,Home,Upto 2014
SM Patil,IND,Pace,1983-09-24,Jalandhar,India,1983,1,2,12,0,1,450,936,11,448,924,11,40.90909090909091,>30,IND,Home,Upto 2014
SM Pollock,SA,Pace,1995-11-16,Centurion,South Africa,1995,1,98,174,3,1,364,846,9,266,672,6,40.44444444444444,>30,SA,Home,Upto 2014
SM Pollock,SA,Pace,1995-11-30,Johannesburg,South Africa,1995,2,109,264,3,1,999,2058,30,890,1794,27,33.3,>30,SA,Home,Upto 2014
SM Pollock,SA,Pace,1995-12-14,Durban,South Africa,1995,1,39,90,0,1,320,703,12,281,613,12,26.666666666666668,<=30,SA,Home,Upto 2014
SM Pollock,SA,Pace,1995-12-26,Gqeberha,South Africa,1995,2,73,192,3,1,681,1783,21,608,1591,18,32.42857142857143,>30,SA,Home,Upto 2014
SM Pollock,SA,Pace,1996-01-02,Cape Town,South Africa,1996,2,58,179,7,1,418,1109,22,360,930,15,19.0,<=30,SA,Home,Upto 2014
SM Pollock,SA,Pace,1996-12-26,Durban,South Africa,1996,2,43,120,5,1,537,1172,37,494,1052,32,14.513513513513514,<=30,SA,Home,Upto 2014
SM Pollock,SA,Pace,1997-01-02,Cape Town,South Africa,1997,2,105,210,4,1,897,1609,22,792,1399,18,40.77272727272727,>30,SA,Home,Upto 2014
SM Pollock,SA,Pace,1997-01-16,Johannesburg,South Africa,1997,2,83,246,1,1,895,1774,26,812,1528,25,34.42307692307692,>30,SA,Home,Upto 2014
SM Pollock,SA,Pace,1997-02-28,Johannesburg,South Africa,1997,1,105,192,2,1,660,1282,14,555,1090,12,47.142857142857146,>30,SA,Home,Upto 2014
SM Pollock,SA,Pace,1997-03-14,Gqeberha,South Africa,1997,1,6,36,2,1,528,1387,24,522,1351,22,22.0,<=30,SA,Home,Upto 2014
SM Pollock,SA,Pace,1997-10-06,Rawalpindi,Pakistan,1997,2,96,270,3,1,556,1227,14,460,957,11,39.714285714285715,>30,PAK,Away,Upto 2014
SM Pollock,SA,Pace,1997-10-17,Sheikhupura,Pakistan,1997,1,35,42,0,1,127,240,3,92,198,3,42.333333333333336,>30,PAK,Away,Upto 2014
SM Pollock,SA,Pace,1997-10-24,Faisalabad,Pakistan,1997,2,101,186,7,1,482,896,25,381,710,18,19.28,<=30,PAK,Away,Upto 2014
SM Pollock,SA,Pace,1997-12-26,Melbourne,Australia,1997,2,132,296,4,1,627,1621,23,495,1325,19,27.26086956521739,<=30,AUS,Away,Upto 2014
SM Pollock,SA,Pace,1998-01-02,Sydney,Australia,1998,1,71,198,3,1,405,1054,13,334,856,10,31.153846153846153,>30,AUS,Away,Upto 2014
SM Pollock,SA,Pace,1998-01-30,Adelaide,Australia,1998,2,148,430,9,1,879,2002,24,731,1572,15,36.625,>30,AUS,Away,Upto 2014
SM Pollock,SA,Pace,1998-02-14,Johannesburg,South Africa,1998,1,55,145,2,1,551,982,15,496,837,13,36.733333333333334,>30,SA,Home,Upto 2014
SM Pollock,SA,Pace,1998-02-26,Durban,South Africa,1998,2,105,243,8,1,733,1519,29,628,1276,21,25.275862068965516,<=30,SA,Home,Upto 2014
SM Pollock,SA,Pace,1998-03-06,Gqeberha,South Africa,1998,2,79,198,1,1,625,1400,33,546,1202,32,18.939393939393938,<=30,SA,Home,Upto 2014
SM Pollock,SA,Pace,1998-03-19,Cape Town,South Africa,1998,2,160,294,6,1,757,1378,22,597,1084,16,34.40909090909091,>30,SA,Home,Upto 2014
SM Pollock,SA,Pace,1998-03-27,Centurion,South Africa,1998,1,9,43,0,1,463,1134,19,454,1091,19,24.36842105263158,<=30,SA,Home,Upto 2014
SM Pollock,SA,Pace,1998-06-04,Birmingham,England,1998,2,135,324,3,1,706,1575,23,571,1251,20,30.695652173913043,>30,ENG,Away,Upto 2014
SM Pollock,SA,Pace,1998-06-18,Lord's,England,1998,2,71,270,4,1,618,1463,26,547,1193,22,23.76923076923077,<=30,ENG,Away,Upto 2014
SM Pollock,SA,Pace,1998-07-23,Nottingham,England,1998,2,154,371,3,1,995,2152,32,841,1781,29,31.09375,>30,ENG,Away,Upto 2014
SM Pollock,SA,Pace,1998-08-06,Leeds,England,1998,2,104,354,8,1,826,2084,40,722,1730,32,20.65,<=30,ENG,Away,Upto 2014
SM Pollock,SA,Pace,1998-11-26,Johannesburg,South Africa,1998,2,103,261,9,1,642,1519,31,539,1258,22,20.70967741935484,<=30,SA,Home,Upto 2014
SM Pollock,SA,Pace,1998-12-10,Gqeberha,South Africa,1998,2,89,159,7,1,639,1208,36,550,1049,29,17.75,<=30,SA,Home,Upto 2014
SM Pollock,SA,Pace,1998-12-26,Durban,South Africa,1998,2,128,302,6,1,645,1347,28,517,1045,22,23.035714285714285,<=30,SA,Home,Upto 2014
SM Pollock,SA,Pace,1999-01-02,Cape Town,South Africa,1999,2,84,282,4,1,785,1771,27,701,1489,23,29.074074074074073,<=30,SA,Home,Upto 2014
SM Pollock,SA,Pace,1999-01-15,Centurion,South Africa,1999,2,79,180,3,1,776,1416,26,697,1236,23,29.846153846153847,<=30,SA,Home,Upto 2014
SM Pollock,SA,Pace,1999-02-27,Auckland,New Zealand,1999,2,72,246,2,1,841,1949,13,769,1703,11,64.6923076923077,>30,NZ,Away,Upto 2014
SM Pollock,SA,Pace,1999-03-11,Christchurch,New Zealand,1999,2,57,174,4,1,581,1404,8,524,1230,4,72.625,>30,NZ,Away,Upto 2014
SM Pollock,SA,Pace,1999-03-18,Wellington,New Zealand,1999,2,87,321,7,1,742,1762,20,655,1441,13,37.1,>30,NZ,Away,Upto 2014
SM Pollock,SA,Pace,1999-10-29,Bloemfontein,South Africa,1999,2,101,240,7,1,728,1549,24,627,1309,17,30.333333333333332,>30,SA,Home,Upto 2014
SM Pollock,SA,Pace,1999-11-11,Harare,Zimbabwe,1999,2,55,198,7,1,560,1277,25,505,1079,18,22.4,<=30,ZIM,Away,Upto 2014
SM Pollock,SA,Pace,1999-11-25,Johannesburg,South Africa,1999,2,80,236,8,1,668,1442,28,588,1206,20,23.857142857142858,<=30,SA,Home,Upto 2014
SM Pollock,SA,Pace,1999-12-09,Gqeberha,South Africa,1999,2,130,306,5,1,939,2119,25,809,1813,20,37.56,>30,SA,Home,Upto 2014
SM Pollock,SA,Pace,1999-12-26,Durban,South Africa,1999,1,55,198,1,1,784,1865,22,729,1667,21,35.63636363636363,>30,SA,Home,Upto 2014
SM Pollock,SA,Pace,2000-01-02,Cape Town,South Africa,2000,2,78,246,2,1,594,1440,24,516,1194,22,24.75,<=30,SA,Home,Upto 2014
SM Pollock,SA,Pace,2000-01-14,Centurion,South Africa,2000,1,53,120,3,1,437,835,14,384,715,11,31.214285714285715,>30,SA,Home,Upto 2014
SM Pollock,SA,Pace,2000-02-24,Wankhede,India,2000,2,67,190,6,1,367,874,21,300,684,15,17.476190476190474,<=30,IND,Away,Upto 2014
SM Pollock,SA,Pace,2000-03-02,Bengaluru,India,2000,2,66,249,3,1,357,999,12,291,750,9,29.75,<=30,IND,Away,Upto 2014
SM Pollock,SA,Pace,2000-07-20,Galle,Sri Lanka,2000,1,73,184,3,1,282,658,5,209,474,2,56.4,>30,SL,Away,Upto 2014
SM Pollock,SA,Pace,2000-07-30,Kandy,Sri Lanka,2000,2,121,210,4,1,362,832,17,241,622,13,21.294117647058822,<=30,SL,Away,Upto 2014
SM Pollock,SA,Pace,2000-08-06,Colombo (SSC),Sri Lanka,2000,2,53,170,4,1,430,969,14,377,799,10,30.714285714285715,>30,SL,Away,Upto 2014
SM Pollock,SA,Pace,2000-11-17,Bloemfontein,South Africa,2000,2,84,282,4,1,906,1955,31,822,1673,27,29.225806451612904,<=30,SA,Home,Upto 2014
SM Pollock,SA,Pace,2000-11-30,Gqeberha,South Africa,2000,2,108,282,6,1,698,1864,30,590,1582,24,23.266666666666666,<=30,SA,Home,Upto 2014
SM Pollock,SA,Pace,2000-12-08,Johannesburg,South Africa,2000,1,41,156,2,1,417,1127,13,376,971,11,32.07692307692308,>30,SA,Home,Upto 2014
SM Pollock,SA,Pace,2000-12-26,Durban,South Africa,2000,2,75,220,5,1,618,1336,17,543,1116,12,36.35294117647059,>30,SA,Home,Upto 2014
SM Pollock,SA,Pace,2001-01-02,Cape Town,South Africa,2001,2,59,136,7,1,537,948,18,478,812,11,29.833333333333332,<=30,SA,Home,Upto 2014
SM Pollock,SA,Pace,2001-01-20,Centurion,South Africa,2001,2,58,144,1,1,628,1061,26,570,917,25,24.153846153846153,<=30,SA,Home,Upto 2014
SM Pollock,SA,Pace,2001-03-09,Georgetown,West Indies,2001,2,105,210,1,1,709,1722,18,604,1512,17,39.388888888888886,>30,WI,Away,Upto 2014
SM Pollock,SA,Pace,2001-03-17,Port of Spain,West Indies,2001,2,90,307,5,1,814,1972,34,724,1665,29,23.941176470588236,<=30,WI,Away,Upto 2014
SM Pollock,SA,Pace,2001-03-29,Bridgetown,West Indies,2001,2,109,240,0,1,750,1752,22,641,1512,22,34.09090909090909,>30,WI,Away,Upto 2014
SM Pollock,SA,Pace,2001-04-06,St John's,West Indies,2001,2,66,247,5,1,374,1261,23,308,1014,18,16.26086956521739,<=30,WI,Away,Upto 2014
SM Pollock,SA,Pace,2001-04-19,Kingston,West Indies,2001,2,94,365,9,1,641,1770,33,547,1405,24,19.424242424242426,<=30,WI,Away,Upto 2014
SM Pollock,SA,Pace,2001-09-07,Harare,Zimbabwe,2001,2,129,309,4,1,919,1718,19,790,1409,15,48.36842105263158,>30,ZIM,Away,Upto 2014
SM Pollock,SA,Pace,2001-09-14,Bulawayo,Zimbabwe,2001,2,48,192,2,1,548,1308,7,500,1116,5,78.28571428571429,>30,ZIM,Away,Upto 2014
SM Pollock,SA,Pace,2001-11-03,Bloemfontein,South Africa,2001,2,147,292,10,1,966,1509,27,819,1217,17,35.77777777777778,>30,SA,Home,Upto 2014
SM Pollock,SA,Pace,2001-11-16,Gqeberha,South Africa,2001,2,79,252,6,1,644,1436,22,565,1184,16,29.272727272727273,<=30,SA,Home,Upto 2014
SM Pollock,SA,Pace,2001-12-14,Adelaide,Australia,2001,2,102,240,1,1,773,1644,20,671,1404,19,38.65,>30,AUS,Away,Upto 2014
SM Pollock,SA,Pace,2001-12-26,Melbourne,Australia,2001,2,90,192,4,1,710,1446,22,620,1254,18,32.27272727272727,>30,AUS,Away,Upto 2014
SM Pollock,SA,Pace,2002-01-02,Sydney,Australia,2002,2,120,240,3,1,596,1002,11,476,762,8,54.18181818181818,>30,AUS,Away,Upto 2014
SM Pollock,SA,Pace,2002-10-25,Potchefstroom,South Africa,2002,2,63,132,2,1,588,1047,21,525,915,19,28.0,<=30,SA,Home,Upto 2014
SM Pollock,SA,Pace,2002-11-08,Johannesburg,South Africa,2002,2,62,156,4,1,582,1139,26,520,983,22,22.384615384615383,<=30,SA,Home,Upto 2014
SM Pollock,SA,Pace,2002-11-15,Centurion,South Africa,2002,2,96,276,3,1,905,1840,32,809,1564,29,28.28125,<=30,SA,Home,Upto 2014
SM Pollock,SA,Pace,2002-12-26,Durban,South Africa,2002,2,52,189,3,1,631,1153,23,579,964,20,27.434782608695652,<=30,SA,Home,Upto 2014
SM Pollock,SA,Pace,2003-01-02,Cape Town,South Africa,2003,2,77,210,5,1,694,1175,21,617,965,16,33.04761904761905,>30,SA,Home,Upto 2014
SM Pollock,SA,Pace,2003-04-24,Chattogram,Bangladesh,2003,2,34,144,3,1,514,1056,11,480,912,8,46.72727272727273,>30,BAN,Away,Upto 2014
SM Pollock,SA,Pace,2003-05-01,Dhaka,Bangladesh,2003,2,42,96,4,1,304,666,13,262,570,9,23.384615384615383,<=30,BAN,Away,Upto 2014
SM Pollock,SA,Pace,2003-07-24,Birmingham,England,2003,2,57,208,2,1,873,1408,14,816,1200,12,62.357142857142854,>30,ENG,Away,Upto 2014
SM Pollock,SA,Pace,2003-07-31,Lord's,England,2003,2,133,262,4,1,967,1600,24,834,1338,20,40.291666666666664,>30,ENG,Away,Upto 2014
SM Pollock,SA,Pace,2003-08-14,Nottingham,England,2003,2,104,322,8,1,935,1991,38,831,1669,30,24.605263157894736,<=30,ENG,Away,Upto 2014
SM Pollock,SA,Pace,2003-09-04,The Oval,England,2003,2,126,270,3,1,1075,1870,24,949,1600,21,44.791666666666664,>30,ENG,Away,Upto 2014
SM Pollock,SA,Pace,2003-10-17,Lahore,Pakistan,2003,2,69,174,1,1,569,1080,10,500,906,9,56.9,>30,PAK,Away,Upto 2014
SM Pollock,SA,Pace,2003-10-24,Faisalabad,Pakistan,2003,2,105,308,7,1,604,1451,24,499,1143,17,25.166666666666668,<=30,PAK,Away,Upto 2014
SM Pollock,SA,Pace,2003-12-12,Johannesburg,South Africa,2003,2,96,282,5,1,1112,2121,34,1016,1839,29,32.705882352941174,>30,SA,Home,Upto 2014
SM Pollock,SA,Pace,2003-12-26,Durban,South Africa,2003,2,101,270,3,1,1030,1831,26,929,1561,23,39.61538461538461,>30,SA,Home,Upto 2014
SM Pollock,SA,Pace,2004-01-02,Cape Town,South Africa,2004,2,152,246,3,1,1140,1873,23,988,1627,20,49.56521739130435,>30,SA,Home,Upto 2014
SM Pollock,SA,Pace,2004-01-16,Centurion,South Africa,2004,2,115,290,5,1,1068,1800,24,953,1510,19,44.5,>30,SA,Home,Upto 2014
SM Pollock,SA,Pace,2004-03-10,Hamilton,New Zealand,2004,2,103,208,4,1,760,1661,15,657,1453,11,50.666666666666664,>30,NZ,Away,Upto 2014
SM Pollock,SA,Pace,2004-03-18,Auckland,New Zealand,2004,2,129,227,4,1,1016,1973,29,887,1746,25,35.03448275862069,>30,NZ,Away,Upto 2014
SM Pollock,SA,Pace,2004-03-26,Wellington,New Zealand,2004,2,150,306,5,1,820,1651,25,670,1345,20,32.8,>30,NZ,Away,Upto 2014
SM Pollock,SA,Pace,2004-08-04,Galle,Sri Lanka,2004,2,67,210,6,1,548,1192,14,481,982,8,39.142857142857146,>30,SL,Away,Upto 2014
SM Pollock,SA,Pace,2004-08-11,Colombo (SSC),Sri Lanka,2004,2,127,228,4,1,548,1014,21,421,786,17,26.095238095238095,<=30,SL,Away,Upto 2014
SM Pollock,SA,Pace,2004-11-20,Kanpur,India,2004,1,100,228,2,1,487,976,10,387,748,8,48.7,>30,IND,Away,Upto 2014
SM Pollock,SA,Pace,2004-11-28,Eden Gardens,India,2004,2,123,312,2,1,537,1338,17,414,1026,15,31.58823529411765,>30,IND,Away,Upto 2014
SM Pollock,SA,Pace,2004-12-17,Gqeberha,South Africa,2004,2,97,258,3,1,915,1720,27,818,1462,24,33.888888888888886,>30,SA,Home,Upto 2014
SM Pollock,SA,Pace,2004-12-26,Durban,South Africa,2004,2,111,307,5,1,968,1978,29,857,1671,24,33.37931034482759,>30,SA,Home,Upto 2014
SM Pollock,SA,Pace,2005-01-02,Cape Town,South Africa,2005,2,101,288,5,1,830,1832,29,729,1544,24,28.620689655172413,<=30,SA,Home,Upto 2014
SM Pollock,SA,Pace,2005-01-13,Johannesburg,South Africa,2005,2,155,312,5,1,1212,2062,34,1057,1750,29,35.64705882352941,>30,SA,Home,Upto 2014
SM Pollock,SA,Pace,2005-01-21,Centurion,South Africa,2005,2,39,168,3,1,788,1589,28,749,1421,25,28.142857142857142,<=30,SA,Home,Upto 2014
SM Pollock,SA,Pace,2005-03-04,Cape Town,South Africa,2005,2,23,78,3,1,443,710,15,420,632,12,29.533333333333335,<=30,SA,Home,Upto 2014
SM Pollock,SA,Pace,2005-04-29,St John's,West Indies,2005,1,111,204,0,1,1036,1736,12,925,1532,12,86.33333333333333,>30,WI,Away,Upto 2014
SM Pollock,SA,Pace,2005-12-16,W.A.C.A,Australia,2005,2,144,330,3,1,1099,2050,27,955,1720,24,40.7037037037037,>30,AUS,Away,Upto 2014
SM Pollock,SA,Pace,2005-12-26,Melbourne,Australia,2005,2,127,294,4,1,712,1466,23,585,1172,19,30.956521739130434,>30,AUS,Away,Upto 2014
SM Pollock,SA,Pace,2006-01-02,Sydney,Australia,2006,2,164,234,1,1,752,1301,17,588,1067,16,44.23529411764706,>30,AUS,Away,Upto 2014
SM Pollock,SA,Pace,2006-03-24,Durban,South Africa,2006,2,128,306,2,1,838,1637,23,710,1331,21,36.43478260869565,>30,SA,Home,Upto 2014
SM Pollock,SA,Pace,2006-03-31,Johannesburg,South Africa,2006,2,137,244,2,1,824,1490,30,687,1246,28,27.466666666666665,<=30,SA,Home,Upto 2014
SM Pollock,SA,Pace,2006-04-15,Centurion,South Africa,2006,2,65,120,2,1,858,1550,38,793,1430,36,22.57894736842105,<=30,SA,Home,Upto 2014
SM Pollock,SA,Pace,2006-05-05,Johannesburg,South Africa,2006,2,47,120,3,1,757,1280,36,710,1160,33,21.02777777777778,<=30,SA,Home,Upto 2014
SM Pollock,SA,Pace,2006-08-04,Colombo (PSS),Sri Lanka,2006,2,112,210,1,1,843,1453,20,731,1243,19,42.15,>30,SL,Away,Upto 2014
SM Pollock,SA,Pace,2006-12-15,Johannesburg,South Africa,2006,2,72,203,7,1,728,1389,33,656,1186,26,22.060606060606062,<=30,SA,Home,Upto 2014
SM Pollock,SA,Pace,2006-12-26,Durban,South Africa,2006,2,37,143,1,1,879,1470,33,842,1327,32,26.636363636363637,<=30,SA,Home,Upto 2014
SM Pollock,SA,Pace,2007-01-02,Cape Town,South Africa,2007,2,99,265,5,1,634,1285,20,535,1020,15,31.7,>30,SA,Home,Upto 2014
SM Pollock,SA,Pace,2007-01-11,Centurion,South Africa,2007,2,98,240,4,1,894,1492,25,796,1252,21,35.76,>30,SA,Home,Upto 2014
SM Pollock,SA,Pace,2007-01-19,Gqeberha,South Africa,2007,2,89,162,4,1,653,1296,27,564,1134,23,24.185185185185187,<=30,SA,Home,Upto 2014
SM Pollock,SA,Pace,2008-01-10,Durban,South Africa,2008,2,85,168,5,1,883,1304,22,798,1136,17,40.13636363636363,>30,SA,Home,Upto 2014
SM Warnapura,SL,Spin,2009-02-21,Karachi,Pakistan,2009,1,40,54,0,1,883,1568,9,843,1514,9,98.11111111111111,>30,PAK,Away,Upto 2014
SMH Kirmani,IND,Spin,1983-04-15,Bridgetown,West Indies,1983,1,0,1,0,1,302,625,5,302,624,5,60.4,>30,WI,Away,Upto 2014
SMH Kirmani,IND,Spin,1983-10-05,Nagpur,India,1983,1,9,12,1,1,396,1114,18,387,1102,17,22.0,<=30,IND,Home,Upto 2014
SMH Kirmani,IND,Spin,1983-12-24,Chennai,India,1983,1,4,6,0,1,365,891,7,361,885,7,52.142857142857146,>30,IND,Home,Upto 2014
SMJ Woods,AUS,Pace,1888-07-16,Lord's,England,1888,1,6,16,1,1,147,372,17,141,356,16,8.647058823529411,<=30,ENG,Away,After 1965
SMJ Woods,AUS,Pace,1888-08-13,The Oval,England,1888,1,80,128,2,1,274,691,16,194,563,14,17.125,<=30,ENG,Away,After 1965
SMJ Woods,AUS,Pace,1888-08-30,Manchester,England,1888,1,35,73,2,1,172,393,11,137,320,9,15.636363636363637,<=30,ENG,Away,After 1965
SMJ Woods,ENG,Pace,1896-03-02,Johannesburg,South Africa,1896,2,101,130,2,1,539,922,24,438,792,22,22.458333333333332,<=30,SA,Away,After 1965
SMJ Woods,ENG,Pace,1896-03-21,Cape Town,South Africa,1896,1,28,65,3,1,245,540,16,217,475,13,15.3125,<=30,SA,Away,After 1965
SMS Kaluperuma,SL,Spin,1984-03-09,Kandy,Sri Lanka,1984,2,24,60,2,1,410,807,17,386,747,15,24.11764705882353,<=30,SL,Home,Upto 2014
SMS Kaluperuma,SL,Spin,1984-03-16,Colombo (SSC),Sri Lanka,1984,2,13,42,0,1,166,567,3,153,525,3,55.333333333333336,>30,SL,Home,Upto 2014
SMS Kaluperuma,SL,Spin,1984-03-24,Colombo (CCC),Sri Lanka,1984,1,25,60,0,1,342,828,8,317,768,8,42.75,>30,SL,Home,Upto 2014
SMS Kaluperuma,SL,Spin,1988-02-12,W.A.C.A,Australia,1988,1,62,78,0,1,67,96,0,5,18,0,inf,>30,AUS,Away,Upto 2014
SMSM Senanayake,SL,Spin,2013-12-31,Abu Dhabi,UAE,2013,2,96,138,0,1,396,907,6,300,769,6,66.0,>30,UAE,Away,Upto 2014
SN Banerjee,IND,Pace,1949-02-04,Brabourne,India,1949,2,127,273,5,1,462,1177,18,335,904,13,25.666666666666668,<=30,IND,Home,Upto 2014
SN Thakur,IND,Pace,2018-10-12,Hyderabad,India,2018,1,9,10,0,1,322,529,18,313,519,18,17.88888888888889,<=30,IND,Home,After 1965
SN Thakur,IND,Pace,2021-01-15,Brisbane,Australia,2021,2,155,258,7,1,950,1738,30,795,1480,23,31.666666666666668,>30,AUS,Away,After 1965
SN Thakur,IND,Pace,2021-08-04,Nottingham,England,2021,2,78,156,4,1,737,1406,30,659,1250,26,24.566666666666666,<=30,ENG,Away,After 1965
SN Thakur,IND,Pace,2021-09-02,The Oval,England,2021,2,76,138,3,1,900,1837,30,824,1699,27,30.0,<=30,ENG,Away,After 1965
SN Thakur,IND,Pace,2021-12-26,Centurion,South Africa,2021,2,62,96,2,1,741,1479,38,679,1383,36,19.5,<=30,SA,Away,After 1965
SN Thakur,IND,Pace,2022-01-03,Johannesburg,South Africa,2022,2,108,203,8,1,818,1482,32,710,1279,24,25.5625,<=30,SA,Away,After 1965
SN Thakur,IND,Pace,2022-01-11,Cape Town,South Africa,2022,2,59,138,2,1,686,1515,32,627,1377,30,21.4375,<=30,SA,Away,After 1965
SN Thakur,IND,Pace,2022-07-01,Birmingham,England,2022,2,113,108,1,1,1049,1525,30,936,1417,29,34.96666666666667,>30,ENG,Away,After 1965
SN Thakur,IND,Pace,2023-06-07,The Oval,England,2023,2,104,186,2,1,1032,1672,28,928,1486,26,36.857142857142854,>30,ENG,Away,After 1965
SN Thakur,IND,Pace,2023-07-12,Roseau,West Indies,2023,1,15,42,1,1,260,590,5,245,548,4,52.0,>30,WI,Away,After 1965
SN Thakur,IND,Pace,2023-12-26,Centurion,South Africa,2023,1,101,114,1,1,718,1149,27,617,1035,26,26.59259259259259,<=30,SA,Away,After 1965
SNJ O'Keefe,AUS,Spin,2014-10-22,Dubai (DICS),UAE,2014,2,219,342,4,1,843,1550,22,624,1208,18,38.31818181818182,>30,UAE,Away,After 1965
SNJ O'Keefe,AUS,Spin,2016-01-03,Sydney,Australia,2016,1,63,157,3,1,265,547,8,202,390,5,33.125,>30,AUS,Home,After 1965
SNJ O'Keefe,AUS,Spin,2016-07-26,Pallekele,Sri Lanka,2016,2,74,160,3,1,503,1219,26,429,1059,23,19.346153846153847,<=30,SL,Away,After 1965
SNJ O'Keefe,AUS,Spin,2017-01-03,Sydney,Australia,2017,2,103,222,4,1,736,1038,13,633,816,9,56.61538461538461,>30,AUS,Home,After 1965
SNJ O'Keefe,AUS,Spin,2017-02-23,Pune,India,2017,2,70,169,12,1,566,1181,31,496,1012,19,18.258064516129032,<=30,IND,Away,After 1965
SNJ O'Keefe,AUS,Spin,2017-03-04,Bengaluru,India,2017,2,76,253,3,1,406,1139,26,330,886,23,15.615384615384615,<=30,IND,Away,After 1965
SNJ O'Keefe,AUS,Spin,2017-03-16,Ranchi,India,2017,1,199,462,3,1,755,1725,15,556,1263,12,50.333333333333336,>30,IND,Away,After 1965
SNJ O'Keefe,AUS,Spin,2017-03-25,Dharamsala,India,2017,2,97,191,1,1,468,1025,18,371,834,17,26.0,<=30,IND,Away,After 1965
SNJ O'Keefe,AUS,Spin,2017-09-04,Chattogram,Bangladesh,2017,2,128,272,2,1,709,1537,24,581,1265,22,29.541666666666668,<=30,BAN,Away,After 1965
SP Davis,AUS,Pace,1986-02-21,Wellington,New Zealand,1986,1,70,150,0,1,687,1390,14,617,1240,14,49.07142857142857,>30,NZ,Away,Upto 2014
SP Gupte,IND,Spin,1951-12-30,Eden Gardens,India,1951,2,57,108,0,1,698,1841,19,641,1733,19,36.73684210526316,>30,IND,Home,Upto 2014
SP Gupte,IND,Spin,1952-11-13,Brabourne,India,1952,2,119,254,5,1,433,1202,15,314,948,10,28.866666666666667,<=30,IND,Home,Upto 2014
SP Gupte,IND,Spin,1952-11-28,Chennai,India,1952,1,14,30,0,1,261,594,8,247,564,8,32.625,>30,IND,Home,Upto 2014
SP Gupte,IND,Spin,1953-01-21,Port of Spain,West Indies,1953,2,164,408,7,1,842,2177,19,678,1769,12,44.31578947368421,>30,WI,Away,Upto 2014
SP Gupte,IND,Spin,1953-02-07,Bridgetown,West Indies,1953,2,181,462,5,1,692,2028,31,511,1566,26,22.322580645161292,<=30,WI,Away,Upto 2014
SP Gupte,IND,Spin,1953-02-19,Port of Spain,West Indies,1953,2,126,330,6,1,777,2186,14,651,1856,8,55.5,>30,WI,Away,Upto 2014
SP Gupte,IND,Spin,1953-03-11,Georgetown,West Indies,1953,1,122,338,4,1,639,1831,18,517,1493,14,35.5,>30,WI,Away,Upto 2014
SP Gupte,IND,Spin,1953-03-28,Kingston,West Indies,1953,2,196,439,5,1,921,2154,20,725,1715,15,46.05,>30,WI,Away,Upto 2014
SP Gupte,IND,Spin,1955-01-01,Dhaka,Bangladesh,1955,2,97,312,6,1,438,1378,15,341,1066,9,29.2,<=30,BAN,Away,Upto 2014
SP Gupte,IND,Spin,1955-01-15,Bahawalpur,Pakistan,1955,1,49,102,1,1,306,1050,8,257,948,7,38.25,>30,PAK,Away,Upto 2014
SP Gupte,IND,Spin,1955-01-29,Lahore,Pakistan,1955,2,167,662,7,1,591,2024,18,424,1362,11,32.833333333333336,>30,PAK,Away,Upto 2014
SP Gupte,IND,Spin,1955-02-12,Peshawar,Pakistan,1955,2,115,459,6,1,400,1761,19,285,1302,13,21.05263157894737,<=30,PAK,Away,Upto 2014
SP Gupte,IND,Spin,1955-02-26,Karachi,Pakistan,1955,2,48,126,1,1,327,894,7,279,768,6,46.714285714285715,>30,PAK,Away,Upto 2014
SP Gupte,IND,Spin,1955-11-19,Hyderabad (Deccan),India,1955,2,156,568,8,1,665,1888,11,509,1320,3,60.45454545454545,>30,IND,Home,Upto 2014
SP Gupte,IND,Spin,1955-12-02,Brabourne,India,1955,2,128,502,8,1,470,1277,17,342,775,9,27.647058823529413,<=30,IND,Home,Upto 2014
SP Gupte,IND,Spin,1955-12-16,Delhi,India,1955,2,120,270,1,1,540,1398,4,420,1128,3,135.0,>30,IND,Home,Upto 2014
SP Gupte,IND,Spin,1955-12-28,Eden Gardens,India,1955,2,120,287,8,1,462,1292,19,342,1005,11,24.31578947368421,<=30,IND,Home,Upto 2014
SP Gupte,IND,Spin,1956-01-06,Chennai,India,1956,2,145,513,9,1,610,1887,20,465,1374,11,30.5,>30,IND,Home,Upto 2014
SP Gupte,IND,Spin,1956-10-19,Chennai,India,1956,1,89,171,3,1,458,1218,19,369,1047,16,24.105263157894736,<=30,IND,Home,Upto 2014
SP Gupte,IND,Spin,1956-10-26,Brabourne,India,1956,1,115,228,3,1,685,1650,12,570,1422,9,57.083333333333336,>30,IND,Home,Upto 2014
SP Gupte,IND,Spin,1956-11-02,Eden Gardens,India,1956,2,59,180,2,1,552,1533,35,493,1353,33,15.771428571428572,<=30,IND,Home,Upto 2014
SP Gupte,IND,Spin,1958-11-28,Brabourne,India,1958,2,197,408,6,1,512,1219,9,315,811,3,56.888888888888886,>30,IND,Home,Upto 2014
SP Gupte,IND,Spin,1958-12-12,Kanpur,India,1958,2,223,345,10,1,669,1431,13,446,1086,3,51.46153846153846,>30,IND,Home,Upto 2014
SP Gupte,IND,Spin,1958-12-31,Eden Gardens,India,1958,1,119,234,1,1,513,906,7,394,672,6,73.28571428571429,>30,IND,Home,Upto 2014
SP Gupte,IND,Spin,1959-01-21,Chennai,India,1959,2,244,528,5,1,586,1441,19,342,913,14,30.842105263157894,>30,IND,Home,Upto 2014
SP Gupte,IND,Spin,1959-02-06,Delhi,India,1959,1,144,360,0,1,775,1794,11,631,1434,11,70.45454545454545,>30,IND,Home,Upto 2014
SP Gupte,IND,Spin,1959-06-04,Nottingham,England,1959,1,102,229,4,1,354,956,10,252,727,6,35.4,>30,ENG,Away,Upto 2014
SP Gupte,IND,Spin,1959-06-18,Lord's,England,1959,2,83,150,2,1,208,491,11,125,341,9,18.90909090909091,<=30,ENG,Away,Upto 2014
SP Gupte,IND,Spin,1959-07-02,Leeds,England,1959,1,111,267,4,1,383,883,14,272,616,10,27.357142857142858,<=30,ENG,Away,Upto 2014
SP Gupte,IND,Spin,1959-07-23,Manchester,England,1959,2,174,324,6,1,721,1722,21,547,1398,15,34.333333333333336,>30,ENG,Away,Upto 2014
SP Gupte,IND,Spin,1959-08-20,The Oval,England,1959,1,119,228,1,1,323,930,8,204,702,7,40.375,>30,ENG,Away,Upto 2014
SP Gupte,IND,Spin,1960-12-02,Brabourne,India,1960,2,89,336,5,1,412,1324,9,323,988,4,45.77777777777778,>30,IND,Home,Upto 2014
SP Gupte,IND,Spin,1960-12-16,Kanpur,India,1960,2,113,358,3,1,619,1984,16,506,1626,13,38.6875,>30,IND,Home,Upto 2014
SP Gupte,IND,Spin,1960-12-30,Eden Gardens,India,1960,2,41,114,0,1,295,842,11,254,728,11,26.818181818181817,<=30,IND,Home,Upto 2014
SP Gupte,IND,Spin,1961-12-01,Kanpur,India,1961,2,179,438,6,1,792,2016,16,613,1578,10,49.5,>30,IND,Home,Upto 2014
SP Gupte,IND,Spin,1961-12-13,Delhi,India,1961,1,78,216,1,1,505,1242,8,427,1026,7,63.125,>30,IND,Home,Upto 2014
SP Jones,AUS,Pace,1882-02-17,Sydney,Australia,1882,1,19,44,1,1,195,434,9,176,390,8,21.666666666666668,<=30,AUS,Home,After 1965
SP Jones,AUS,Pace,1882-03-03,Sydney,Australia,1882,1,11,32,0,1,221,493,9,210,461,9,24.555555555555557,<=30,AUS,Home,After 1965
SP Jones,AUS,Pace,1885-01-01,Melbourne,Australia,1885,1,47,102,4,1,410,1218,21,363,1116,17,19.523809523809526,<=30,AUS,Home,After 1965
SP Jones,AUS,Pace,1885-02-20,Sydney,Australia,1885,1,9,12,0,1,367,1227,19,358,1215,19,19.31578947368421,<=30,AUS,Home,After 1965
SP Jones,AUS,Pace,1885-03-14,Sydney,Australia,1885,1,17,40,1,1,423,931,23,406,891,22,18.391304347826086,<=30,AUS,Home,After 1965
SP Jones,AUS,Pace,1885-03-21,Melbourne,Australia,1885,1,7,20,0,1,490,1192,20,483,1172,20,24.5,<=30,AUS,Home,After 1965
SP Jones,AUS,Pace,1886-07-19,Lord's,England,1886,1,2,12,0,1,322,1023,13,320,1011,13,24.76923076923077,<=30,ENG,Away,After 1965
SP Jones,ENG,Pace,2002-07-25,Lord's,England,2002,2,129,228,4,1,837,1449,22,708,1221,18,38.04545454545455,>30,ENG,Home,Upto 2014
SP Jones,ENG,Pace,2002-11-07,Brisbane,Australia,2002,1,32,42,1,1,677,1218,20,645,1176,19,33.85,>30,AUS,Away,Upto 2014
SP Jones,ENG,Pace,2004-03-11,Kingston,West Indies,2004,2,72,132,3,1,561,1123,25,489,991,22,22.44,<=30,WI,Away,Upto 2014
SP Jones,ENG,Pace,2004-03-19,Port of Spain,West Indies,2004,2,101,162,6,1,720,1489,29,619,1327,23,24.82758620689655,<=30,WI,Away,Upto 2014
SP Jones,ENG,Pace,2004-04-01,Bridgetown,West Indies,2004,1,55,96,1,1,550,1209,31,495,1113,30,17.741935483870968,<=30,WI,Away,Upto 2014
SP Jones,ENG,Pace,2004-04-10,St John's,West Indies,2004,1,146,174,1,1,955,1635,13,809,1461,12,73.46153846153847,>30,WI,Away,Upto 2014
SP Jones,ENG,Pace,2004-05-20,Lord's,England,2004,2,146,276,4,1,1118,2072,26,972,1796,22,43.0,>30,ENG,Home,Upto 2014
SP Jones,ENG,Pace,2004-07-22,Lord's,England,2004,2,99,150,1,1,966,1493,22,867,1343,21,43.90909090909091,>30,ENG,Home,Upto 2014
SP Jones,ENG,Pace,2004-12-17,Gqeberha,South Africa,2004,2,78,175,5,1,915,1720,27,837,1545,22,33.888888888888886,>30,SA,Away,Upto 2014
SP Jones,ENG,Pace,2004-12-26,Durban,South Africa,2004,2,117,192,2,1,968,1978,29,851,1786,27,33.37931034482759,>30,SA,Away,Upto 2014
SP Jones,ENG,Pace,2005-01-02,Cape Town,South Africa,2005,2,84,165,3,1,830,1832,29,746,1667,26,28.620689655172413,<=30,SA,Away,Upto 2014
SP Jones,ENG,Pace,2005-01-21,Centurion,South Africa,2005,2,121,207,5,1,788,1589,28,667,1382,23,28.142857142857142,<=30,SA,Away,Upto 2014
SP Jones,ENG,Pace,2005-05-26,Lord's,England,2005,2,33,102,4,1,522,823,21,489,721,17,24.857142857142858,<=30,ENG,Home,Upto 2014
SP Jones,ENG,Pace,2005-06-03,Chester-le-Street,England,2005,2,75,108,1,1,697,946,22,622,838,21,31.681818181818183,>30,ENG,Home,Upto 2014
SP Jones,ENG,Pace,2005-07-21,Lord's,England,2005,2,117,168,3,1,726,1256,32,609,1088,29,22.6875,<=30,ENG,Home,Upto 2014
SP Jones,ENG,Pace,2005-08-04,Birmingham,England,2005,2,92,126,3,1,817,1095,24,725,969,21,34.041666666666664,>30,ENG,Home,Upto 2014
SP Jones,ENG,Pace,2005-08-11,Manchester,England,2005,2,110,209,7,1,929,1432,27,819,1223,20,34.407407407407405,>30,ENG,Home,Upto 2014
SP Jones,ENG,Pace,2005-08-25,Nottingham,England,2005,2,59,109,5,1,944,1543,26,885,1434,21,36.30769230769231,>30,ENG,Home,Upto 2014
SP Narine,WI,Spin,2012-06-07,Birmingham,England,2012,1,70,90,0,1,184,300,1,114,210,1,184.0,>30,ENG,Away,Upto 2014
SP Narine,WI,Spin,2012-07-25,North Sound,West Indies,2012,2,223,510,8,1,474,1059,11,251,549,3,43.09090909090909,>30,WI,Home,Upto 2014
SP Narine,WI,Spin,2012-08-02,Kingston,West Indies,2012,2,85,228,4,1,213,524,11,128,296,7,19.363636363636363,<=30,WI,Home,Upto 2014
SP Narine,WI,Spin,2012-11-13,Mirpur,Bangladesh,2012,2,204,303,3,1,992,1679,19,788,1376,16,52.21052631578947,>30,BAN,Away,Upto 2014
SP Narine,WI,Spin,2012-11-21,Khulna,Bangladesh,2012,2,139,168,0,1,763,1327,11,624,1159,11,69.36363636363636,>30,BAN,Away,Upto 2014
SP Narine,WI,Spin,2013-12-19,Hamilton,New Zealand,2013,2,130,351,6,1,359,765,9,229,414,3,39.888888888888886,>30,NZ,Away,Upto 2014
SP O'Donnell,AUS,Pace,1985-06-13,Leeds,England,1985,2,114,256,4,1,1140,1931,28,1026,1675,24,40.714285714285715,>30,ENG,Away,Upto 2014
SP O'Donnell,AUS,Pace,1985-06-27,Lord's,England,1985,2,92,162,1,1,753,1358,25,661,1196,24,30.12,>30,ENG,Away,Upto 2014
SP O'Donnell,AUS,Pace,1985-07-11,Nottingham,England,1985,2,130,234,1,1,706,1344,15,576,1110,14,47.06666666666667,>30,ENG,Away,Upto 2014
SP O'Donnell,AUS,Pace,1985-08-01,Manchester,England,1985,1,82,126,0,1,622,1074,12,540,948,12,51.833333333333336,>30,ENG,Away,Upto 2014
SP O'Donnell,AUS,Pace,1985-08-15,Birmingham,England,1985,1,69,96,0,1,829,1344,20,760,1248,20,41.45,>30,ENG,Away,Upto 2014
SP O'Donnell,AUS,Pace,1985-11-22,Sydney,Australia,1985,2,17,66,0,1,241,652,9,224,586,9,26.77777777777778,<=30,AUS,Home,Upto 2014
SPD Smith,AUS,Spin,2010-07-13,Lord's,England,2010,1,51,126,3,1,298,547,14,247,421,11,21.285714285714285,<=30,ENG,Away,Upto 2014
SPD Smith,AUS,Spin,2010-07-21,Leeds,England,2010,2,31,60,0,1,114,192,2,83,132,2,57.0,>30,ENG,Away,Upto 2014
SPD Smith,AUS,Spin,2010-12-26,Melbourne,Australia,2010,1,71,108,0,1,144,302,2,73,194,2,72.0,>30,AUS,Home,Upto 2014
SPD Smith,AUS,Spin,2011-01-03,Sydney,Australia,2011,1,67,78,0,1,291,570,3,224,492,3,97.0,>30,AUS,Home,Upto 2014
SPD Smith,AUS,Spin,2013-03-14,Mohali,India,2013,1,63,60,1,1,752,1501,18,689,1441,17,41.77777777777778,>30,IND,Away,Upto 2014
SPD Smith,AUS,Spin,2013-07-18,Lord's,England,2013,2,83,120,4,1,356,726,15,273,606,11,23.733333333333334,<=30,ENG,Away,Upto 2014
SPD Smith,AUS,Spin,2013-08-01,Manchester,England,2013,1,6,12,0,1,362,618,7,356,606,7,51.714285714285715,>30,ENG,Away,Upto 2014
SPD Smith,AUS,Spin,2013-08-09,Chester-le-Street,England,2013,1,1,6,0,1,200,493,11,199,487,11,18.181818181818183,<=30,ENG,Away,Upto 2014
SPD Smith,AUS,Spin,2013-08-21,The Oval,England,2013,1,16,48,0,1,310,576,4,294,528,4,77.5,>30,ENG,Away,Upto 2014
SPD Smith,AUS,Spin,2013-11-21,Brisbane,Australia,2013,1,15,24,0,1,355,624,6,340,600,6,59.166666666666664,>30,AUS,Home,Upto 2014
SPD Smith,AUS,Spin,2013-12-05,Adelaide,Australia,2013,1,43,42,1,1,565,912,7,522,870,6,80.71428571428571,>30,AUS,Home,Upto 2014
SPD Smith,AUS,Spin,2014-02-20,Gqeberha,South Africa,2014,1,30,48,1,1,316,654,11,286,606,10,28.727272727272727,<=30,SA,Away,After 1965
SPD Smith,AUS,Spin,2014-03-01,Cape Town,South Africa,2014,2,50,90,1,1,386,690,6,336,600,5,64.33333333333333,>30,SA,Away,After 1965
SPD Smith,AUS,Spin,2014-10-22,Dubai (DICS),UAE,2014,1,50,36,1,1,843,1550,22,793,1514,21,38.31818181818182,>30,UAE,Away,After 1965
SPD Smith,AUS,Spin,2014-10-30,Abu Dhabi,UAE,2014,2,95,96,2,1,756,1259,18,661,1163,16,42.0,>30,UAE,Away,After 1965
SPD Smith,AUS,Spin,2014-12-09,Adelaide,Australia,2014,2,37,36,0,1,652,937,17,615,901,17,38.35294117647059,>30,AUS,Home,After 1965
SPD Smith,AUS,Spin,2014-12-17,Brisbane,Australia,2014,1,4,6,0,1,289,440,7,285,434,7,41.285714285714285,>30,AUS,Home,After 1965
SPD Smith,AUS,Spin,2014-12-26,Melbourne,Australia,2014,2,21,24,0,1,388,732,7,367,708,7,55.42857142857143,>30,AUS,Home,After 1965
SPD Smith,AUS,Spin,2015-01-06,Sydney,Australia,2015,2,24,36,0,1,575,1013,9,551,977,9,63.888888888888886,>30,AUS,Home,After 1965
SPD Smith,AUS,Spin,2015-06-03,Roseau,West Indies,2015,2,18,18,1,1,294,570,11,276,552,10,26.727272727272727,<=30,WI,Away,After 1965
SPD Smith,AUS,Spin,2015-07-16,Lord's,England,2015,1,9,12,0,1,392,582,8,383,570,8,49.0,>30,ENG,Away,After 1965
SPD Smith,AUS,Spin,2015-08-20,The Oval,England,2015,1,7,6,1,1,215,360,8,208,354,7,26.875,<=30,ENG,Away,After 1965
SPD Smith,AUS,Spin,2015-11-13,W.A.C.A,Australia,2015,1,16,24,0,1,404,593,6,388,569,6,67.33333333333333,>30,AUS,Home,After 1965
SPD Smith,AUS,Spin,2015-11-27,Adelaide,Australia,2015,1,3,12,0,1,218,366,7,215,354,7,31.142857142857142,>30,AUS,Home,After 1965
SPD Smith,AUS,Spin,2015-12-26,Melbourne,Australia,2015,2,26,30,0,1,415,654,8,389,624,8,51.875,>30,AUS,Home,After 1965
SPD Smith,AUS,Spin,2016-07-26,Pallekele,Sri Lanka,2016,1,1,6,0,1,503,1219,26,502,1213,26,19.346153846153847,<=30,SL,Away,After 1965
SPD Smith,AUS,Spin,2016-08-04,Galle,Sri Lanka,2016,1,13,24,0,1,555,873,24,542,849,24,23.125,<=30,SL,Away,After 1965
SPD Smith,AUS,Spin,2016-08-13,Colombo (SSC),Sri Lanka,2016,2,18,18,0,1,860,1808,28,842,1790,28,30.714285714285715,>30,SL,Away,After 1965
SPD Smith,AUS,Spin,2016-11-03,W.A.C.A,Australia,2016,1,3,7,1,1,396,754,8,393,747,7,49.5,>30,AUS,Home,After 1965
SPD Smith,AUS,Spin,2016-11-12,Hobart,Australia,2016,1,5,6,0,1,82,156,0,77,150,0,inf,>30,AUS,Home,After 1965
SPD Smith,AUS,Spin,2016-12-26,Melbourne,Australia,2016,1,9,18,0,1,417,534,7,408,516,7,59.57142857142857,>30,AUS,Home,After 1965
SPD Smith,AUS,Spin,2017-01-03,Sydney,Australia,2017,1,5,6,0,1,736,1038,13,731,1032,13,56.61538461538461,>30,AUS,Home,After 1965
SPD Smith,AUS,Spin,2017-11-23,Brisbane,Australia,2017,1,8,18,0,1,277,645,8,269,627,8,34.625,>30,AUS,Home,After 1965
SPD Smith,AUS,Spin,2017-12-14,W.A.C.A,Australia,2017,1,8,18,0,1,269,492,4,261,474,4,67.25,>30,AUS,Home,After 1965
SPD Smith,AUS,Spin,2017-12-26,Melbourne,Australia,2017,1,11,6,0,1,251,518,4,240,512,4,62.75,>30,AUS,Home,After 1965
SPD Smith,AUS,Spin,2018-01-04,Sydney,Australia,2018,1,6,12,0,1,530,1068,7,524,1056,7,75.71428571428571,>30,AUS,Home,After 1965
SPD Smith,AUS,Spin,2018-03-01,Durban,South Africa,2018,1,3,30,0,1,376,722,13,373,692,13,28.923076923076923,<=30,SA,Away,After 1965
SPD Smith,AUS,Spin,2018-03-22,Cape Town,South Africa,2018,2,6,12,0,1,218,461,7,212,449,7,31.142857142857142,>30,SA,Away,After 1965
SPD Smith,AUS,Spin,2019-08-01,Birmingham,England,2019,2,9,18,0,1,478,833,12,469,815,12,39.833333333333336,>30,ENG,Away,After 1965
SPD Smith,AUS,Spin,2019-08-14,Lord's,England,2019,1,6,12,0,1,239,466,7,233,454,7,34.142857142857146,>30,ENG,Away,After 1965
SPD Smith,AUS,Spin,2019-11-21,Brisbane,Australia,2019,1,6,6,0,1,515,790,8,509,784,8,64.375,>30,AUS,Home,After 1965
SPD Smith,AUS,Spin,2019-11-29,Adelaide,Australia,2019,1,6,6,0,1,462,654,5,456,648,5,92.4,>30,AUS,Home,After 1965
SPD Smith,AUS,Spin,2021-12-16,Adelaide,Australia,2021,1,0,6,0,1,255,630,10,255,624,10,25.5,<=30,AUS,Home,After 1965
SPD Smith,AUS,Spin,2022-01-05,Sydney,Australia,2022,1,10,24,1,1,414,683,10,404,659,9,41.4,>30,AUS,Home,After 1965
SPD Smith,AUS,Spin,2022-03-04,Rawalpindi,Pakistan,2022,2,20,24,0,1,676,1285,9,656,1261,9,75.11111111111111,>30,PAK,Away,After 1965
SPD Smith,AUS,Spin,2022-12-26,Melbourne,Australia,2022,1,9,17,1,1,255,472,5,246,455,4,51.0,>30,AUS,Home,After 1965
SPD Smith,AUS,Spin,2023-01-04,Sydney,Australia,2023,2,8,12,0,1,437,881,4,429,869,4,109.25,>30,AUS,Home,After 1965
SPD Smith,AUS,Spin,2023-06-28,Lord's,England,2023,1,1,6,0,1,95,198,5,94,192,5,19.0,<=30,ENG,Away,After 1965
SR Clark,AUS,Pace,2006-03-16,Cape Town,South Africa,2006,2,89,198,9,1,563,1099,28,474,901,19,20.107142857142858,<=30,SA,Away,Upto 2014
SR Clark,AUS,Pace,2006-03-24,Durban,South Africa,2006,2,83,234,4,1,838,1637,23,755,1403,19,36.43478260869565,>30,SA,Away,Upto 2014
SR Clark,AUS,Pace,2006-03-31,Johannesburg,South Africa,2006,2,145,276,7,1,824,1490,30,679,1214,23,27.466666666666665,<=30,SA,Away,Upto 2014
SR Clark,AUS,Pace,2006-04-09,Fatullah,Bangladesh,2006,2,77,174,1,1,364,804,10,287,630,9,36.4,>30,BAN,Away,Upto 2014
SR Clark,AUS,Pace,2006-11-23,Brisbane,Australia,2006,2,93,229,7,1,985,1659,24,892,1430,17,41.041666666666664,>30,AUS,Home,Upto 2014
SR Clark,AUS,Pace,2006-12-01,Adelaide,Australia,2006,2,97,282,4,1,876,1646,21,779,1364,17,41.714285714285715,>30,AUS,Home,Upto 2014
SR Clark,AUS,Pace,2006-12-14,W.A.C.A,Australia,2006,2,105,241,5,1,846,1471,19,741,1230,14,44.526315789473685,>30,AUS,Home,Upto 2014
SR Clark,AUS,Pace,2006-12-26,Melbourne,Australia,2006,2,57,198,5,1,551,1154,23,494,956,18,23.956521739130434,<=30,AUS,Home,Upto 2014
SR Clark,AUS,Pace,2007-01-02,Sydney,Australia,2007,2,91,216,5,1,646,1259,24,555,1043,19,26.916666666666668,<=30,AUS,Home,Upto 2014
SR Clark,AUS,Pace,2007-11-08,Brisbane,Australia,2007,2,121,230,4,1,668,1297,18,547,1067,14,37.111111111111114,>30,AUS,Home,Upto 2014
SR Clark,AUS,Pace,2007-11-16,Hobart,Australia,2007,2,135,240,3,1,932,1457,19,797,1217,16,49.05263157894737,>30,AUS,Home,Upto 2014
SR Clark,AUS,Pace,2007-12-26,Melbourne,Australia,2007,2,48,180,5,1,517,1047,21,469,867,16,24.61904761904762,<=30,AUS,Home,Upto 2014
SR Clark,AUS,Pace,2008-01-02,Sydney,Australia,2008,2,112,222,3,1,803,1292,17,691,1070,14,47.23529411764706,>30,AUS,Home,Upto 2014
SR Clark,AUS,Pace,2008-01-16,W.A.C.A,Australia,2008,2,106,216,6,1,844,1397,31,738,1181,25,27.225806451612904,<=30,AUS,Home,Upto 2014
SR Clark,AUS,Pace,2008-01-24,Adelaide,Australia,2008,2,129,258,0,1,710,1457,17,581,1199,17,41.76470588235294,>30,AUS,Home,Upto 2014
SR Clark,AUS,Pace,2008-05-22,Kingston,West Indies,2008,2,91,234,8,1,802,1720,34,711,1486,26,23.58823529411765,<=30,WI,Away,Upto 2014
SR Clark,AUS,Pace,2008-05-30,North Sound,West Indies,2008,2,61,192,1,1,984,1871,24,923,1679,23,41.0,>30,WI,Away,Upto 2014
SR Clark,AUS,Pace,2008-06-12,Bridgetown,West Indies,2008,2,99,234,4,1,809,1396,25,710,1162,21,32.36,>30,WI,Away,Upto 2014
SR Clark,AUS,Pace,2008-10-09,Bengaluru,India,2008,2,70,168,1,1,560,1289,24,490,1121,23,23.333333333333332,<=30,IND,Away,Upto 2014
SR Clark,AUS,Pace,2008-10-29,Delhi,India,2008,2,91,270,1,1,697,1278,10,606,1008,9,69.7,>30,IND,Away,Upto 2014
SR Clark,AUS,Pace,2008-11-20,Brisbane,Australia,2008,2,89,192,6,1,700,1373,36,611,1181,30,19.444444444444443,<=30,AUS,Home,Upto 2014
SR Clark,AUS,Pace,2008-11-28,Adelaide,Australia,2008,2,78,180,1,1,688,1276,20,610,1096,19,34.4,>30,AUS,Home,Upto 2014
SR Clark,AUS,Pace,2009-08-07,Leeds,England,2009,2,92,126,3,1,700,1101,30,608,975,27,23.333333333333332,<=30,ENG,Away,Upto 2014
SR Clark,AUS,Pace,2009-08-20,The Oval,England,2009,2,84,156,1,1,842,1408,23,758,1252,22,36.608695652173914,>30,ENG,Away,Upto 2014
SR Gillespie,NZ,Pace,1986-02-21,Wellington,New Zealand,1986,1,79,162,1,1,687,1390,14,608,1228,13,49.07142857142857,>30,NZ,Home,Upto 2014
SR Harmer,SA,Spin,2015-01-02,Cape Town,South Africa,2015,2,153,300,7,1,390,806,12,237,506,5,32.5,>30,SA,Home,After 1965
SR Harmer,SA,Spin,2015-07-21,Chattogram,Bangladesh,2015,1,105,210,3,1,318,607,10,213,397,7,31.8,>30,BAN,Away,After 1965
SR Harmer,SA,Spin,2015-07-30,Mirpur,Bangladesh,2015,1,76,138,0,1,125,270,4,49,132,4,31.25,>30,BAN,Away,After 1965
SR Harmer,SA,Spin,2015-11-05,Mohali,India,2015,2,112,228,5,1,466,1004,34,354,776,29,13.705882352941176,<=30,IND,Away,After 1965
SR Harmer,SA,Spin,2015-11-25,Nagpur,India,2015,2,142,272,5,1,483,1096,33,341,824,28,14.636363636363637,<=30,IND,Away,After 1965
SR Harmer,SA,Spin,2022-03-31,Durban,South Africa,2022,2,124,294,7,1,428,1068,20,304,774,13,21.4,<=30,SA,Home,After 1965
SR Harmer,SA,Spin,2022-04-08,Gqeberha,South Africa,2022,2,73,131,6,1,500,972,27,427,841,21,18.51851851851852,<=30,SA,Home,After 1965
SR Harmer,SA,Spin,2022-08-25,Manchester,England,2022,1,73,138,1,1,204,480,4,131,342,3,51.0,>30,ENG,Away,After 1965
SR Harmer,SA,Spin,2023-01-04,Sydney,Australia,2023,1,109,186,0,1,437,881,4,328,695,4,109.25,>30,AUS,Away,After 1965
SR Harmer,SA,Spin,2023-03-08,Johannesburg,South Africa,2023,2,108,208,5,1,406,700,11,298,492,6,36.90909090909091,>30,SA,Home,After 1965
SR Patel,ENG,Spin,2012-03-26,Galle,Sri Lanka,2012,2,36,108,2,1,607,1324,28,571,1216,26,21.678571428571427,<=30,SL,Away,Upto 2014
SR Patel,ENG,Spin,2012-04-03,Colombo (PSS),Sri Lanka,2012,2,86,246,1,1,698,1454,22,612,1208,21,31.727272727272727,>30,SL,Away,Upto 2014
SR Patel,ENG,Spin,2012-11-15,Ahmedabad,India,2012,2,120,222,1,1,729,1559,21,609,1337,20,34.714285714285715,>30,IND,Away,Upto 2014
SR Patel,ENG,Spin,2012-11-23,Wankhede,India,2012,1,6,24,0,1,747,1449,28,741,1425,28,26.678571428571427,<=30,IND,Away,Upto 2014
SR Patel,ENG,Spin,2012-12-05,Eden Gardens,India,2012,1,9,6,0,1,665,1360,18,656,1354,18,36.94444444444444,>30,IND,Away,Upto 2014
SR Patel,ENG,Spin,2015-11-01,Sharjah,UAE,2015,2,164,252,3,1,743,1504,24,579,1252,21,30.958333333333332,>30,UAE,Away,After 1965
SR Patil,IND,Pace,1955-12-02,Brabourne,India,1955,2,51,138,2,1,320,942,10,269,804,8,32.0,>30,IND,Home,Upto 2014
SR Tendulkar,IND,Spin,1989-11-15,Karachi,Pakistan,1989,2,25,30,0,1,349,576,2,324,546,2,174.5,>30,PAK,Away,Upto 2014
SR Tendulkar,IND,Spin,1991-11-29,Brisbane,Australia,1991,2,13,12,0,1,182,335,1,169,323,1,182.0,>30,AUS,Away,Upto 2014
SR Tendulkar,IND,Spin,1991-12-26,Melbourne,Australia,1991,1,16,24,0,1,193,372,3,177,348,3,64.33333333333333,>30,AUS,Away,Upto 2014
SR Tendulkar,IND,Spin,1992-01-02,Sydney,Australia,1992,1,2,6,1,1,301,666,6,299,660,5,50.166666666666664,>30,AUS,Away,Upto 2014
SR Tendulkar,IND,Spin,1992-01-25,Adelaide,Australia,1992,2,54,144,2,1,316,796,8,262,652,6,39.5,>30,AUS,Away,Upto 2014
SR Tendulkar,IND,Spin,1992-02-01,W.A.C.A,Australia,1992,1,9,30,0,1,143,312,2,134,282,2,71.5,>30,AUS,Away,Upto 2014
SR Tendulkar,IND,Spin,1992-10-18,Harare,Zimbabwe,1992,1,8,24,0,1,383,1070,9,375,1046,9,42.55555555555556,>30,ZIM,Away,Upto 2014
SR Tendulkar,IND,Spin,1992-11-13,Durban,South Africa,1992,1,3,12,0,1,210,547,7,207,535,7,30.0,<=30,SA,Away,Upto 2014
SR Tendulkar,IND,Spin,1992-11-26,Johannesburg,South Africa,1992,1,2,6,0,1,138,480,8,136,474,8,17.25,<=30,SA,Away,Upto 2014
SR Tendulkar,IND,Spin,1992-12-26,Gqeberha,South Africa,1992,2,9,24,1,1,329,957,7,320,933,6,47.0,>30,SA,Away,Upto 2014
SR Tendulkar,IND,Spin,1993-02-11,Chennai,India,1993,2,9,24,0,1,792,1720,20,783,1696,20,39.6,>30,IND,Home,Upto 2014
SR Tendulkar,IND,Spin,1993-03-13,Delhi,India,1993,1,11,30,0,1,645,1548,21,634,1518,21,30.714285714285715,>30,IND,Home,Upto 2014
SR Tendulkar,IND,Spin,1993-08-04,Colombo (PSS),Sri Lanka,1993,1,4,18,0,1,715,1623,16,711,1605,16,44.6875,>30,SL,Away,Upto 2014
SR Tendulkar,IND,Spin,1994-02-08,Ahmedabad,India,1994,1,7,24,0,1,473,1433,26,466,1409,26,18.192307692307693,<=30,IND,Home,Upto 2014
SR Tendulkar,IND,Spin,1994-11-18,Wankhede,India,1994,1,9,18,0,1,528,1096,17,519,1078,17,31.058823529411764,>30,IND,Home,Upto 2014
SR Tendulkar,IND,Spin,1994-12-10,Mohali,India,1994,1,10,6,0,1,470,841,10,460,835,10,47.0,>30,IND,Home,Upto 2014
SR Tendulkar,IND,Spin,1996-06-20,Lord's,England,1996,1,1,12,0,1,159,498,3,158,486,3,53.0,>30,ENG,Away,Upto 2014
SR Tendulkar,IND,Spin,1996-07-04,Nottingham,England,1996,1,28,42,0,1,381,828,3,353,786,3,127.0,>30,ENG,Away,Upto 2014
SR Tendulkar,IND,Spin,1996-12-26,Durban,South Africa,1996,1,0,16,0,1,87,204,2,87,188,2,43.5,>30,SA,Away,Upto 2014
SR Tendulkar,IND,Spin,1997-01-16,Johannesburg,South Africa,1997,1,18,12,0,1,289,570,8,271,558,8,36.125,>30,SA,Away,Upto 2014
SR Tendulkar,IND,Spin,1997-03-06,Kingston,West Indies,1997,1,9,12,0,1,464,982,9,455,970,9,51.55555555555556,>30,WI,Away,Upto 2014
SR Tendulkar,IND,Spin,1997-08-02,Colombo (RPS),Sri Lanka,1997,1,2,12,0,1,1044,2082,8,1042,2070,8,130.5,>30,SL,Away,Upto 2014
SR Tendulkar,IND,Spin,1997-12-03,Wankhede,India,1997,1,0,12,0,1,533,1312,21,533,1300,21,25.38095238095238,<=30,IND,Home,Upto 2014
SR Tendulkar,IND,Spin,1998-03-18,Eden Gardens,India,1998,1,6,12,0,1,634,1306,12,628,1294,12,52.833333333333336,>30,IND,Home,Upto 2014
SR Tendulkar,IND,Spin,1998-03-25,Bengaluru,India,1998,1,41,68,1,1,817,1511,22,776,1443,21,37.13636363636363,>30,IND,Home,Upto 2014
SR Tendulkar,IND,Spin,1998-12-26,Wellington,New Zealand,1998,2,15,54,2,1,442,922,12,427,868,10,36.833333333333336,>30,NZ,Away,Upto 2014
SR Tendulkar,IND,Spin,1999-01-02,Hamilton,New Zealand,1999,2,53,60,2,1,438,743,6,385,683,4,73.0,>30,NZ,Away,Upto 2014
SR Tendulkar,IND,Spin,1999-01-28,Chennai,India,1999,2,45,60,3,1,572,1226,24,527,1166,21,23.833333333333332,<=30,IND,Home,Upto 2014
SR Tendulkar,IND,Spin,1999-02-16,Eden Gardens,India,1999,2,18,30,1,1,375,758,8,357,728,7,46.875,>30,IND,Home,Upto 2014
SR Tendulkar,IND,Spin,1999-02-24,Colombo (SSC),Sri Lanka,1999,1,16,30,0,1,484,1002,12,468,972,12,40.333333333333336,>30,SL,Away,Upto 2014
SR Tendulkar,IND,Spin,1999-10-10,Mohali,India,1999,1,11,36,0,1,393,1249,10,382,1213,10,39.3,>30,IND,Home,Upto 2014
SR Tendulkar,IND,Spin,1999-10-29,Ahmedabad,India,1999,1,19,30,0,1,599,1348,12,580,1318,12,49.916666666666664,>30,IND,Home,Upto 2014
SR Tendulkar,IND,Spin,1999-12-10,Adelaide,Australia,1999,1,12,12,0,1,301,744,9,289,732,9,33.44444444444444,>30,AUS,Away,Upto 2014
SR Tendulkar,IND,Spin,2000-01-02,Sydney,Australia,2000,1,34,42,1,1,279,470,1,245,428,0,279.0,>30,AUS,Away,Upto 2014
SR Tendulkar,IND,Spin,2000-02-24,Wankhede,India,2000,2,14,36,3,1,274,666,12,260,630,9,22.833333333333332,<=30,IND,Home,Upto 2014
SR Tendulkar,IND,Spin,2000-03-02,Bengaluru,India,2000,1,33,60,0,1,474,1252,16,441,1192,16,29.625,<=30,IND,Home,Upto 2014
SR Tendulkar,IND,Spin,2000-11-10,Dhaka,Bangladesh,2000,1,34,60,1,1,558,1251,19,524,1191,18,29.36842105263158,<=30,BAN,Away,Upto 2014
SR Tendulkar,IND,Spin,2000-11-18,Delhi,India,2000,2,61,138,1,1,622,1309,9,561,1171,8,69.11111111111111,>30,IND,Home,Upto 2014
SR Tendulkar,IND,Spin,2000-11-25,Nagpur,India,2000,2,26,72,0,1,810,1427,12,784,1355,12,67.5,>30,IND,Home,Upto 2014
SR Tendulkar,IND,Spin,2001-02-27,Wankhede,India,2001,1,35,42,0,1,392,686,14,357,644,14,28.0,<=30,IND,Home,Upto 2014
SR Tendulkar,IND,Spin,2001-03-11,Eden Gardens,India,2001,2,38,78,3,1,625,1131,20,587,1053,17,31.25,>30,IND,Home,Upto 2014
SR Tendulkar,IND,Spin,2001-03-18,Chennai,India,2001,2,78,168,0,1,924,1783,26,846,1615,26,35.53846153846154,>30,IND,Home,Upto 2014
SR Tendulkar,IND,Spin,2001-06-07,Bulawayo,Zimbabwe,2001,1,23,36,0,1,315,644,5,292,608,5,63.0,>30,ZIM,Away,Upto 2014
SR Tendulkar,IND,Spin,2001-06-15,Harare,Zimbabwe,2001,2,26,30,1,1,185,428,8,159,398,7,23.125,<=30,ZIM,Away,Upto 2014
SR Tendulkar,IND,Spin,2001-11-03,Bloemfontein,South Africa,2001,1,27,42,0,1,225,426,4,198,384,4,56.25,>30,SA,Away,Upto 2014
SR Tendulkar,IND,Spin,2001-11-16,Gqeberha,South Africa,2001,2,32,48,1,1,330,708,5,298,660,4,66.0,>30,SA,Away,Upto 2014
SR Tendulkar,IND,Spin,2001-12-03,Mohali,India,2001,1,4,24,0,1,507,1147,21,503,1123,21,24.142857142857142,<=30,IND,Home,Upto 2014
SR Tendulkar,IND,Spin,2001-12-11,Ahmedabad,India,2001,1,27,60,1,1,727,1868,25,700,1808,24,29.08,<=30,IND,Home,Upto 2014
SR Tendulkar,IND,Spin,2001-12-19,Bengaluru,India,2001,1,19,18,0,1,308,742,5,289,724,5,61.6,>30,IND,Home,Upto 2014
SR Tendulkar,IND,Spin,2002-02-21,Nagpur,India,2002,1,11,36,0,1,556,1425,18,545,1389,18,30.88888888888889,>30,IND,Home,Upto 2014
SR Tendulkar,IND,Spin,2002-02-28,Delhi,India,2002,1,6,6,0,1,467,1232,22,461,1226,22,21.227272727272727,<=30,IND,Home,Upto 2014
SR Tendulkar,IND,Spin,2002-04-11,Georgetown,West Indies,2002,1,18,18,0,1,369,751,4,351,733,4,92.25,>30,WI,Away,Upto 2014
SR Tendulkar,IND,Spin,2002-04-19,Port of Spain,West Indies,2002,1,6,6,0,1,184,491,4,178,485,4,46.0,>30,WI,Away,Upto 2014
SR Tendulkar,IND,Spin,2002-05-02,Bridgetown,West Indies,2002,2,8,12,0,1,125,277,5,117,265,5,25.0,<=30,WI,Away,Upto 2014
SR Tendulkar,IND,Spin,2002-05-10,St John's,West Indies,2002,1,107,204,2,1,261,672,7,154,468,5,37.285714285714285,>30,WI,Away,Upto 2014
SR Tendulkar,IND,Spin,2002-07-25,Lord's,England,2002,1,14,12,0,1,509,942,14,495,930,14,36.357142857142854,>30,ENG,Away,Upto 2014
SR Tendulkar,IND,Spin,2002-08-08,Nottingham,England,2002,1,15,36,0,1,350,564,6,335,528,6,58.333333333333336,>30,ENG,Away,Upto 2014
SR Tendulkar,IND,Spin,2002-09-05,The Oval,England,2002,1,4,12,0,1,410,922,9,406,910,9,45.55555555555556,>30,ENG,Away,Upto 2014
SR Tendulkar,IND,Spin,2002-10-09,Wankhede,India,2002,1,2,6,0,1,416,1045,19,414,1039,19,21.894736842105264,<=30,IND,Home,Upto 2014
SR Tendulkar,IND,Spin,2002-10-30,Eden Gardens,India,2002,1,33,42,0,1,592,1269,12,559,1227,12,49.333333333333336,>30,IND,Home,Upto 2014
SR Tendulkar,IND,Spin,2003-10-08,Ahmedabad,India,2003,2,45,60,0,1,719,1566,18,674,1506,18,39.94444444444444,>30,IND,Home,Upto 2014
SR Tendulkar,IND,Spin,2003-10-16,Mohali,India,2003,1,55,132,1,1,664,1623,9,609,1491,8,73.77777777777777,>30,IND,Home,Upto 2014
SR Tendulkar,IND,Spin,2003-12-04,Brisbane,Australia,2003,1,9,12,0,1,333,445,5,324,433,5,66.6,>30,AUS,Away,Upto 2014
SR Tendulkar,IND,Spin,2003-12-12,Adelaide,Australia,2003,2,39,42,2,1,609,1006,16,570,964,14,38.0625,>30,AUS,Away,Upto 2014
SR Tendulkar,IND,Spin,2003-12-26,Melbourne,Australia,2003,1,57,78,1,1,455,739,13,398,661,12,35.0,>30,AUS,Away,Upto 2014
SR Tendulkar,IND,Spin,2004-01-02,Sydney,Australia,2004,1,36,36,0,1,831,1277,14,795,1241,14,59.357142857142854,>30,AUS,Away,Upto 2014
SR Tendulkar,IND,Spin,2004-03-28,Multan,Pakistan,2004,2,59,120,2,1,510,902,13,451,782,11,39.23076923076923,>30,PAK,Away,Upto 2014
SR Tendulkar,IND,Spin,2004-04-05,Lahore,Pakistan,2004,1,38,72,1,1,269,480,8,231,408,7,33.625,>30,PAK,Away,Upto 2014
SR Tendulkar,IND,Spin,2004-04-13,Rawalpindi,Pakistan,2004,1,1,6,1,1,324,559,10,323,553,9,32.4,>30,PAK,Away,Upto 2014
SR Tendulkar,IND,Spin,2004-10-26,Nagpur,India,2004,2,41,84,0,1,469,867,12,428,783,12,39.083333333333336,>30,IND,Home,Upto 2014
SR Tendulkar,IND,Spin,2004-11-20,Kanpur,India,2004,2,54,84,0,1,586,1360,13,532,1276,13,45.07692307692308,>30,IND,Home,Upto 2014
SR Tendulkar,IND,Spin,2004-11-28,Eden Gardens,India,2004,1,8,18,0,1,470,978,15,462,960,15,31.333333333333332,>30,IND,Home,Upto 2014
SR Tendulkar,IND,Spin,2004-12-17,Chattogram,Bangladesh,2004,2,39,30,1,1,442,811,15,403,781,14,29.466666666666665,<=30,BAN,Away,Upto 2014
SR Tendulkar,IND,Spin,2005-03-08,Mohali,India,2005,1,30,48,0,1,471,904,13,441,856,13,36.23076923076923,>30,IND,Home,Upto 2014
SR Tendulkar,IND,Spin,2005-03-24,Bengaluru,India,2005,2,76,108,1,1,834,1659,22,758,1551,21,37.90909090909091,>30,IND,Home,Upto 2014
SR Tendulkar,IND,Spin,2005-12-10,Delhi,India,2005,1,6,12,0,1,668,1353,25,662,1341,25,26.72,<=30,IND,Home,Upto 2014
SR Tendulkar,IND,Spin,2005-12-18,Ahmedabad,India,2005,1,13,24,0,1,765,1419,29,752,1395,29,26.379310344827587,<=30,IND,Home,Upto 2014
SR Tendulkar,IND,Spin,2006-01-13,Lahore,Pakistan,2006,1,16,12,0,1,588,687,2,572,675,2,294.0,>30,PAK,Away,Upto 2014
SR Tendulkar,IND,Spin,2006-01-29,Karachi,Pakistan,2006,1,40,54,0,1,322,481,6,282,427,6,53.666666666666664,>30,PAK,Away,Upto 2014
SR Tendulkar,IND,Spin,2006-03-01,Nagpur,India,2006,1,11,12,0,1,588,1296,7,577,1284,7,84.0,>30,IND,Home,Upto 2014
SR Tendulkar,IND,Spin,2007-01-02,Cape Town,South Africa,2007,2,33,79,1,1,487,1042,13,454,963,12,37.46153846153846,>30,SA,Away,Upto 2014
SR Tendulkar,IND,Spin,2007-05-18,Chattogram,Bangladesh,2007,2,22,42,1,1,447,726,13,425,684,12,34.38461538461539,>30,BAN,Away,Upto 2014
SR Tendulkar,IND,Spin,2007-05-25,Mirpur,Bangladesh,2007,1,35,39,2,1,453,725,12,418,686,10,37.75,>30,BAN,Away,Upto 2014
SR Tendulkar,IND,Spin,2007-07-19,Lord's,England,2007,2,10,18,0,1,243,486,5,233,468,5,48.6,>30,ENG,Away,Upto 2014
SR Tendulkar,IND,Spin,2007-07-27,Nottingham,England,2007,2,38,54,0,1,275,482,10,237,428,10,27.5,<=30,ENG,Away,Upto 2014
SR Tendulkar,IND,Spin,2007-08-09,The Oval,England,2007,2,104,156,1,1,584,973,9,480,817,8,64.88888888888889,>30,ENG,Away,Upto 2014
SR Tendulkar,IND,Spin,2007-11-22,Delhi,India,2007,2,8,24,0,1,425,937,15,417,913,15,28.333333333333332,<=30,IND,Home,Upto 2014
SR Tendulkar,IND,Spin,2007-11-30,Eden Gardens,India,2007,2,39,60,0,1,851,1606,18,812,1546,18,47.27777777777778,>30,IND,Home,Upto 2014
SR Tendulkar,IND,Spin,2007-12-26,Melbourne,Australia,2007,2,4,12,0,1,518,912,15,514,900,15,34.53333333333333,>30,AUS,Away,Upto 2014
SR Tendulkar,IND,Spin,2008-01-02,Sydney,Australia,2008,2,20,42,0,1,764,1280,20,744,1238,20,38.2,>30,AUS,Away,Upto 2014
SR Tendulkar,IND,Spin,2008-01-24,Adelaide,Australia,2008,1,6,6,0,1,579,1086,9,573,1080,9,64.33333333333333,>30,AUS,Away,Upto 2014
SR Tendulkar,IND,Spin,2008-10-29,Delhi,India,2008,1,2,6,0,1,668,1278,12,666,1272,12,55.666666666666664,>30,IND,Home,Upto 2014
SR Tendulkar,IND,Spin,2008-11-06,Nagpur,India,2008,1,13,12,0,1,751,1259,24,738,1247,24,31.291666666666668,>30,IND,Home,Upto 2014
SR Tendulkar,IND,Spin,2009-04-03,Wellington,New Zealand,2009,1,45,54,2,1,383,840,12,338,786,10,31.916666666666668,>30,NZ,Away,Upto 2014
SR Tendulkar,IND,Spin,2009-11-16,Ahmedabad,India,2009,1,20,42,0,1,904,1575,9,884,1533,9,100.44444444444444,>30,IND,Home,Upto 2014
SR Tendulkar,IND,Spin,2009-11-24,Kanpur,India,2009,1,6,6,0,1,718,1197,20,712,1191,20,35.9,>30,IND,Home,Upto 2014
SR Tendulkar,IND,Spin,2010-02-14,Eden Gardens,India,2010,1,1,12,0,1,547,1263,14,546,1251,14,39.07142857142857,>30,IND,Home,Upto 2014
SR Tendulkar,IND,Spin,2010-11-04,Ahmedabad,India,2010,1,16,12,0,1,781,1719,18,765,1707,18,43.388888888888886,>30,IND,Home,Upto 2014
SR Tendulkar,IND,Spin,2010-11-12,Hyderabad,India,2010,1,7,12,0,1,691,1414,15,684,1402,15,46.06666666666667,>30,IND,Home,Upto 2014
SR Tendulkar,IND,Spin,2010-12-16,Centurion,South Africa,2010,1,51,60,0,1,391,504,4,340,444,4,97.75,>30,SA,Away,Upto 2014
SR Tendulkar,IND,Spin,2010-12-26,Durban,South Africa,2010,1,6,6,0,1,148,356,7,142,350,7,21.142857142857142,<=30,SA,Away,Upto 2014
SR Tendulkar,IND,Spin,2011-01-02,Cape Town,South Africa,2011,1,9,12,1,1,346,804,9,337,792,8,38.44444444444444,>30,SA,Away,Upto 2014
SR Tendulkar,IND,Spin,2011-08-10,Birmingham,England,2011,1,17,24,0,1,372,564,6,355,540,6,62.0,>30,ENG,Away,Upto 2014
SR Tendulkar,IND,Spin,2011-08-18,The Oval,England,2011,1,11,12,0,1,491,822,11,480,810,11,44.63636363636363,>30,ENG,Away,Upto 2014
SR Tendulkar,IND,Spin,2011-11-22,Wankhede,India,2011,2,29,42,0,1,794,1593,24,765,1551,24,33.083333333333336,>30,IND,Home,Upto 2014
SR Tendulkar,IND,Spin,2012-08-23,Hyderabad,India,2012,1,6,6,0,1,326,884,22,320,878,22,14.818181818181818,<=30,IND,Home,Upto 2014
SR Tendulkar,IND,Spin,2012-11-15,Ahmedabad,India,2012,1,8,6,0,1,729,1559,21,721,1553,21,34.714285714285715,>30,IND,Home,Upto 2014
SR Tendulkar,IND,Spin,2013-03-14,Mohali,India,2013,1,2,12,0,1,752,1501,18,750,1489,18,41.77777777777778,>30,IND,Home,Upto 2014
SR Tendulkar,IND,Spin,2013-11-06,Eden Gardens,India,2013,2,23,30,1,1,456,988,15,433,958,14,30.4,>30,IND,Home,Upto 2014
SR Tendulkar,IND,Spin,2013-11-14,Wankhede,India,2013,1,8,12,0,1,497,770,24,489,758,24,20.708333333333332,<=30,IND,Home,Upto 2014
SR Thompson,IRE,Pace,2018-05-11,Dublin (Malahide),Ireland,2018,2,93,198,4,1,792,1625,28,699,1427,24,28.285714285714285,<=30,IRE,Home,After 1965
SR Thompson,IRE,Pace,2019-03-15,Dehradun,India,2019,2,37,111,3,1,244,549,10,207,438,7,24.4,<=30,IND,Away,After 1965
SR Thompson,IRE,Pace,2019-07-24,Lord's,England,2019,2,74,101,3,1,515,949,38,441,848,35,13.552631578947368,<=30,ENG,Away,After 1965
SR Watson,AUS,Pace,2005-01-02,Sydney,Australia,2005,2,60,114,1,1,541,846,9,481,732,8,60.111111111111114,>30,AUS,Home,Upto 2014
SR Watson,AUS,Pace,2005-10-14,Sydney,Australia,2005,1,38,36,0,1,422,699,17,384,663,17,24.823529411764707,<=30,AUS,Home,Upto 2014
SR Watson,AUS,Pace,2005-11-03,Brisbane,Australia,2005,1,25,36,1,1,772,1215,25,747,1179,24,30.88,>30,AUS,Home,Upto 2014
SR Watson,AUS,Pace,2008-10-09,Bengaluru,India,2008,2,53,144,3,1,560,1289,24,507,1145,21,23.333333333333332,<=30,IND,Away,Upto 2014
SR Watson,AUS,Pace,2008-10-17,Mohali,India,2008,2,91,174,0,1,846,1398,17,755,1224,17,49.76470588235294,>30,IND,Away,Upto 2014
SR Watson,AUS,Pace,2008-10-29,Delhi,India,2008,2,93,162,2,1,697,1278,10,604,1116,8,69.7,>30,IND,Away,Upto 2014
SR Watson,AUS,Pace,2008-11-06,Nagpur,India,2008,2,84,214,5,1,502,1096,12,418,882,7,41.833333333333336,>30,IND,Away,Upto 2014
SR Watson,AUS,Pace,2008-11-20,Brisbane,Australia,2008,2,54,90,2,1,700,1373,36,646,1283,34,19.444444444444443,<=30,AUS,Home,Upto 2014
SR Watson,AUS,Pace,2009-07-30,Birmingham,England,2009,1,23,18,0,1,806,1353,22,783,1335,22,36.63636363636363,>30,ENG,Away,Upto 2014
SR Watson,AUS,Pace,2009-08-20,The Oval,England,2009,1,26,30,0,1,842,1408,23,816,1378,23,36.608695652173914,>30,ENG,Away,Upto 2014
SR Watson,AUS,Pace,2009-11-26,Brisbane,Australia,2009,2,75,114,3,1,697,1123,21,622,1009,18,33.19047619047619,>30,AUS,Home,Upto 2014
SR Watson,AUS,Pace,2009-12-04,Adelaide,Australia,2009,2,72,138,3,1,930,1567,26,858,1429,23,35.76923076923077,>30,AUS,Home,Upto 2014
SR Watson,AUS,Pace,2009-12-16,W.A.C.A,Australia,2009,2,64,156,2,1,927,1486,27,863,1330,25,34.333333333333336,>30,AUS,Home,Upto 2014
SR Watson,AUS,Pace,2009-12-26,Melbourne,Australia,2009,1,30,78,1,1,736,1512,23,706,1434,22,32.0,>30,AUS,Home,Upto 2014
SR Watson,AUS,Pace,2010-01-03,Sydney,Australia,2010,1,40,102,2,1,640,1344,29,600,1242,27,22.06896551724138,<=30,AUS,Home,Upto 2014
SR Watson,AUS,Pace,2010-01-14,Hobart,Australia,2010,2,55,144,2,1,758,1508,15,703,1364,13,50.53333333333333,>30,AUS,Home,Upto 2014
SR Watson,AUS,Pace,2010-03-27,Hamilton,New Zealand,2010,2,48,66,0,1,795,1294,27,747,1228,27,29.444444444444443,<=30,NZ,Away,Upto 2014
SR Watson,AUS,Pace,2010-07-13,Lord's,England,2010,2,66,83,5,1,698,1252,26,632,1169,21,26.846153846153847,<=30,ENG,Away,Upto 2014
SR Watson,AUS,Pace,2010-07-21,Leeds,England,2010,2,51,96,6,1,714,1273,33,663,1177,27,21.636363636363637,<=30,ENG,Away,Upto 2014
SR Watson,AUS,Pace,2010-10-01,Mohali,India,2010,2,25,48,0,1,619,1051,25,594,1003,25,24.76,<=30,IND,Away,Upto 2014
SR Watson,AUS,Pace,2010-10-09,Bengaluru,India,2010,2,55,102,2,1,635,1166,15,580,1064,13,42.333333333333336,>30,IND,Away,Upto 2014
SR Watson,AUS,Pace,2010-11-25,Brisbane,Australia,2010,2,96,162,1,1,947,1750,17,851,1588,16,55.705882352941174,>30,AUS,Home,Upto 2014
SR Watson,AUS,Pace,2010-12-03,Adelaide,Australia,2010,1,44,114,1,1,745,1313,14,701,1199,13,53.214285714285715,>30,AUS,Home,Upto 2014
SR Watson,AUS,Pace,2010-12-26,Melbourne,Australia,2010,1,34,60,0,1,704,1424,26,670,1364,26,27.076923076923077,<=30,AUS,Home,Upto 2014
SR Watson,AUS,Pace,2011-01-03,Sydney,Australia,2011,1,49,120,1,1,873,1642,26,824,1522,25,33.57692307692308,>30,AUS,Home,Upto 2014
SR Watson,AUS,Pace,2011-08-31,Galle,Sri Lanka,2011,2,30,114,5,1,381,906,20,351,792,15,19.05,<=30,SL,Away,Upto 2014
SR Watson,AUS,Pace,2011-09-08,Pallekele,Sri Lanka,2011,2,60,180,1,1,526,1180,17,466,1000,16,30.941176470588236,>30,SL,Away,Upto 2014
SR Watson,AUS,Pace,2011-09-16,Colombo (SSC),Sri Lanka,2011,1,54,156,1,1,825,1634,20,771,1478,19,41.25,>30,SL,Away,Upto 2014
SR Watson,AUS,Pace,2011-11-09,Cape Town,South Africa,2011,2,61,90,5,1,597,929,31,536,839,26,19.258064516129032,<=30,SA,Away,Upto 2014
SR Watson,AUS,Pace,2011-11-17,Johannesburg,South Africa,2011,1,13,23,1,1,938,1680,27,925,1657,26,34.74074074074074,>30,SA,Away,Upto 2014
SR Watson,AUS,Pace,2012-04-07,Bridgetown,West Indies,2012,2,76,162,2,1,725,1642,25,649,1480,23,29.0,<=30,WI,Away,Upto 2014
SR Watson,AUS,Pace,2012-04-15,Port of Spain,West Indies,2012,2,29,90,0,1,412,924,17,383,834,17,24.235294117647058,<=30,WI,Away,Upto 2014
SR Watson,AUS,Pace,2012-04-23,Roseau,West Indies,2012,2,32,78,1,1,492,1142,12,460,1064,11,41.0,>30,WI,Away,Upto 2014
SR Watson,AUS,Pace,2012-11-30,W.A.C.A,Australia,2012,2,46,108,1,1,885,1522,30,839,1414,29,29.5,<=30,AUS,Home,Upto 2014
SR Watson,AUS,Pace,2012-12-14,Hobart,Australia,2012,2,109,286,2,1,927,1883,26,818,1597,24,35.65384615384615,>30,AUS,Home,Upto 2014
SR Watson,AUS,Pace,2012-12-26,Melbourne,Australia,2012,1,3,18,0,1,518,864,21,515,846,21,24.666666666666668,<=30,AUS,Home,Upto 2014
SR Watson,AUS,Pace,2013-07-10,Nottingham,England,2013,2,18,114,0,1,827,1665,33,809,1551,33,25.060606060606062,<=30,ENG,Away,Upto 2014
SR Watson,AUS,Pace,2013-07-18,Lord's,England,2013,2,70,150,1,1,669,1424,21,599,1274,20,31.857142857142858,>30,ENG,Away,Upto 2014
SR Watson,AUS,Pace,2013-08-01,Manchester,England,2013,2,26,102,0,1,710,1434,19,684,1332,19,37.36842105263158,>30,ENG,Away,Upto 2014
SR Watson,AUS,Pace,2013-08-09,Chester-le-Street,England,2013,2,43,117,1,1,823,1578,29,780,1461,28,28.379310344827587,<=30,ENG,Away,Upto 2014
SR Watson,AUS,Pace,2013-08-21,The Oval,England,2013,1,22,30,0,1,836,1443,25,814,1413,25,33.44,>30,ENG,Away,Upto 2014
SR Watson,AUS,Pace,2013-11-21,Brisbane,Australia,2013,1,0,12,0,1,625,1326,30,625,1314,30,20.833333333333332,<=30,AUS,Home,Upto 2014
SR Watson,AUS,Pace,2013-12-05,Adelaide,Australia,2013,2,6,54,1,1,606,1290,25,600,1236,24,24.24,<=30,AUS,Home,Upto 2014
SR Watson,AUS,Pace,2013-12-13,W.A.C.A,Australia,2013,2,87,138,2,1,995,1739,27,908,1601,25,36.851851851851855,>30,AUS,Home,Upto 2014
SR Watson,AUS,Pace,2013-12-26,Melbourne,Australia,2013,2,24,64,1,1,653,1410,24,629,1346,23,27.208333333333332,<=30,AUS,Home,Upto 2014
SR Watson,AUS,Pace,2014-01-03,Sydney,Australia,2014,1,5,18,0,1,663,1122,33,658,1104,33,20.09090909090909,<=30,AUS,Home,After 1965
SR Watson,AUS,Pace,2014-03-01,Cape Town,South Africa,2014,2,40,108,1,1,924,1728,25,884,1620,24,36.96,>30,SA,Away,After 1965
SR Watson,AUS,Pace,2014-12-09,Adelaide,Australia,2014,2,19,42,0,1,885,1420,15,866,1378,15,59.0,>30,AUS,Home,After 1965
SR Watson,AUS,Pace,2014-12-17,Brisbane,Australia,2014,2,66,166,1,1,959,1402,28,893,1236,27,34.25,>30,AUS,Home,After 1965
SR Watson,AUS,Pace,2014-12-26,Melbourne,Australia,2014,2,79,132,1,1,1069,1880,27,990,1748,26,39.592592592592595,>30,AUS,Home,After 1965
SR Watson,AUS,Pace,2015-01-06,Sydney,Australia,2015,2,80,168,3,1,942,1653,21,862,1485,18,44.857142857142854,>30,AUS,Home,After 1965
SR Watson,AUS,Pace,2015-06-03,Roseau,West Indies,2015,2,17,60,0,1,402,941,20,385,881,20,20.1,<=30,WI,Away,After 1965
SR Watson,AUS,Pace,2015-06-11,Kingston,West Indies,2015,2,13,36,1,1,528,1091,25,515,1055,24,21.12,<=30,WI,Away,After 1965
SR Watson,AUS,Pace,2015-07-08,Cardiff,England,2015,2,47,78,0,1,901,1488,27,854,1410,27,33.370370370370374,>30,ENG,Away,After 1965
SR Waugh,AUS,Pace,1985-12-26,Melbourne,Australia,1985,1,36,66,2,1,429,932,13,393,866,11,33.0,>30,AUS,Home,Upto 2014
SR Waugh,AUS,Pace,1986-01-02,Sydney,Australia,1986,1,33,42,0,1,382,756,4,349,714,4,95.5,>30,AUS,Home,Upto 2014
SR Waugh,AUS,Pace,1986-02-21,Wellington,New Zealand,1986,1,9,24,0,1,687,1390,14,678,1366,14,49.07142857142857,>30,NZ,Away,Upto 2014
SR Waugh,AUS,Pace,1986-02-28,Christchurch,New Zealand,1986,1,56,138,4,1,712,1681,22,656,1543,18,32.36363636363637,>30,NZ,Away,Upto 2014
SR Waugh,AUS,Pace,1986-03-13,Auckland,New Zealand,1986,2,18,54,1,1,481,1210,15,463,1156,14,32.06666666666667,>30,NZ,Away,Upto 2014
SR Waugh,AUS,Pace,1986-09-18,Chennai,India,1986,2,60,90,1,1,433,618,3,373,528,2,144.33333333333334,>30,IND,Away,Upto 2014
SR Waugh,AUS,Pace,1986-09-26,Delhi,India,1986,1,29,36,1,1,158,270,3,129,234,2,52.666666666666664,>30,IND,Away,Upto 2014
SR Waugh,AUS,Pace,1986-10-15,Wankhede,India,1986,1,41,84,0,1,351,666,3,310,582,3,117.0,>30,IND,Away,Upto 2014
SR Waugh,AUS,Pace,1986-11-14,Brisbane,Australia,1986,1,76,126,3,1,755,1483,27,679,1357,24,27.962962962962962,<=30,AUS,Home,Upto 2014
SR Waugh,AUS,Pace,1986-11-28,W.A.C.A,Australia,1986,2,159,273,5,1,963,1802,22,804,1529,17,43.77272727272727,>30,AUS,Home,Upto 2014
SR Waugh,AUS,Pace,1986-12-12,Adelaide,Australia,1986,2,66,132,1,1,567,1198,11,501,1066,10,51.54545454545455,>30,AUS,Home,Upto 2014
SR Waugh,AUS,Pace,1986-12-26,Melbourne,Australia,1986,1,16,48,0,1,497,1065,22,481,1017,22,22.59090909090909,<=30,AUS,Home,Upto 2014
SR Waugh,AUS,Pace,1987-01-10,Sydney,Australia,1987,2,19,72,1,1,483,1157,14,464,1085,13,34.5,>30,AUS,Home,Upto 2014
SR Waugh,AUS,Pace,1987-12-04,Brisbane,Australia,1987,2,37,144,2,1,634,1568,27,597,1424,25,23.48148148148148,<=30,AUS,Home,Upto 2014
SR Waugh,AUS,Pace,1987-12-11,Adelaide,Australia,1987,2,88,246,0,1,519,1199,13,431,953,13,39.92307692307692,>30,AUS,Home,Upto 2014
SR Waugh,AUS,Pace,1987-12-26,Melbourne,Australia,1987,1,44,60,0,1,846,1960,31,802,1900,31,27.29032258064516,<=30,AUS,Home,Upto 2014
SR Waugh,AUS,Pace,1988-01-29,Sydney,Australia,1988,1,51,137,3,1,421,1098,12,370,961,9,35.083333333333336,>30,AUS,Home,Upto 2014
SR Waugh,AUS,Pace,1988-02-12,W.A.C.A,Australia,1988,2,47,168,4,1,710,1536,29,663,1368,25,24.482758620689655,<=30,AUS,Home,Upto 2014
SR Waugh,AUS,Pace,1988-09-15,Karachi,Pakistan,1988,1,94,156,1,1,264,678,7,170,522,6,37.714285714285715,>30,PAK,Away,Upto 2014
SR Waugh,AUS,Pace,1988-09-23,Faisalabad,Pakistan,1988,2,80,174,1,1,528,1164,17,448,990,16,31.058823529411764,>30,PAK,Away,Upto 2014
SR Waugh,AUS,Pace,1988-10-07,Lahore,Pakistan,1988,2,42,138,0,1,344,894,11,302,756,11,31.272727272727273,>30,PAK,Away,Upto 2014
SR Waugh,AUS,Pace,1988-11-18,Brisbane,Australia,1988,2,75,144,2,1,708,1383,27,633,1239,25,26.22222222222222,<=30,AUS,Home,Upto 2014
SR Waugh,AUS,Pace,1988-12-02,W.A.C.A,Australia,1988,2,160,306,0,1,1183,2020,32,1023,1714,32,36.96875,>30,AUS,Home,Upto 2014
SR Waugh,AUS,Pace,1988-12-24,Melbourne,Australia,1988,2,169,270,8,1,897,2063,38,728,1793,30,23.605263157894736,<=30,AUS,Home,Upto 2014
SR Waugh,AUS,Pace,1989-01-26,Sydney,Australia,1989,2,28,42,0,1,305,911,11,277,869,11,27.727272727272727,<=30,AUS,Home,Upto 2014
SR Waugh,AUS,Pace,1989-02-03,Adelaide,Australia,1989,2,40,72,0,1,834,1481,18,794,1409,18,46.333333333333336,>30,AUS,Home,Upto 2014
SR Waugh,AUS,Pace,1989-06-08,Leeds,England,1989,1,27,36,0,1,1372,2385,30,1345,2349,30,45.733333333333334,>30,ENG,Away,Upto 2014
SR Waugh,AUS,Pace,1989-06-22,Lord's,England,1989,2,69,96,1,1,1092,2047,30,1023,1951,29,36.4,>30,ENG,Away,Upto 2014
SR Waugh,AUS,Pace,1989-07-06,Birmingham,England,1989,1,38,66,1,1,670,1413,17,632,1347,16,39.411764705882355,>30,ENG,Away,Upto 2014
SR Waugh,AUS,Pace,1989-07-27,Manchester,England,1989,2,40,60,0,1,673,1605,23,633,1545,23,29.26086956521739,<=30,ENG,Away,Upto 2014
SR Waugh,AUS,Pace,1989-08-10,Nottingham,England,1989,1,23,66,0,1,695,1373,18,672,1307,18,38.611111111111114,>30,ENG,Away,Upto 2014
SR Waugh,AUS,Pace,1989-08-24,The Oval,England,1989,1,11,18,0,1,921,1691,26,910,1673,26,35.42307692307692,>30,ENG,Away,Upto 2014
SR Waugh,AUS,Pace,1989-12-16,Hobart,Australia,1989,1,6,36,0,1,998,1920,27,992,1884,27,36.96296296296296,>30,AUS,Home,Upto 2014
SR Waugh,AUS,Pace,1990-01-12,Melbourne,Australia,1990,1,13,18,1,1,791,2097,34,778,2079,33,23.264705882352942,<=30,AUS,Home,Upto 2014
SR Waugh,AUS,Pace,1990-11-23,Brisbane,Australia,1990,2,27,66,1,1,544,1327,29,517,1261,28,18.75862068965517,<=30,AUS,Home,Upto 2014
SR Waugh,AUS,Pace,1990-12-26,Melbourne,Australia,1990,2,23,78,0,1,741,1809,29,718,1731,29,25.551724137931036,<=30,AUS,Home,Upto 2014
SR Waugh,AUS,Pace,1991-01-04,Sydney,Australia,1991,1,40,84,0,1,621,1201,14,581,1117,14,44.357142857142854,>30,AUS,Home,Upto 2014
SR Waugh,AUS,Pace,1991-04-05,Port of Spain,West Indies,1991,1,10,30,0,1,449,1209,20,439,1179,20,22.45,<=30,WI,Away,Upto 2014
SR Waugh,AUS,Pace,1991-04-19,Bridgetown,West Indies,1991,2,80,180,0,1,874,1849,33,794,1669,33,26.484848484848484,<=30,WI,Away,Upto 2014
SR Waugh,AUS,Pace,1992-11-27,Brisbane,Australia,1992,2,52,114,1,1,859,1899,30,807,1785,29,28.633333333333333,<=30,AUS,Home,Upto 2014
SR Waugh,AUS,Pace,1992-12-26,Melbourne,Australia,1992,1,14,24,1,1,743,1849,31,729,1825,30,23.967741935483872,<=30,AUS,Home,Upto 2014
SR Waugh,AUS,Pace,1993-01-02,Sydney,Australia,1993,1,43,66,0,1,568,1162,8,525,1096,8,71.0,>30,AUS,Home,Upto 2014
SR Waugh,AUS,Pace,1993-01-23,Adelaide,Australia,1993,2,45,108,1,1,644,1295,29,599,1187,28,22.20689655172414,<=30,AUS,Home,Upto 2014
SR Waugh,AUS,Pace,1993-01-30,W.A.C.A,Australia,1993,1,8,36,0,1,518,1062,27,510,1026,27,19.185185185185187,<=30,AUS,Home,Upto 2014
SR Waugh,AUS,Pace,1993-02-25,Christchurch,New Zealand,1993,2,9,36,0,1,651,1526,21,642,1490,21,31.0,>30,NZ,Away,Upto 2014
SR Waugh,AUS,Pace,1993-03-04,Wellington,New Zealand,1993,1,28,90,0,1,647,1552,21,619,1462,21,30.80952380952381,>30,NZ,Away,Upto 2014
SR Waugh,AUS,Pace,1993-03-12,Auckland,New Zealand,1993,2,34,120,2,1,620,1465,22,586,1345,20,28.181818181818183,<=30,NZ,Away,Upto 2014
SR Waugh,AUS,Pace,1993-06-17,Lord's,England,1993,2,18,36,0,1,536,1020,6,518,984,6,89.33333333333333,>30,ENG,Away,Upto 2014
SR Waugh,AUS,Pace,1993-07-01,Nottingham,England,1993,2,15,54,0,1,786,1563,21,771,1509,21,37.42857142857143,>30,ENG,Away,Upto 2014
SR Waugh,AUS,Pace,1993-08-05,Birmingham,England,1993,1,4,30,0,1,389,833,10,385,803,10,38.9,>30,ENG,Away,Upto 2014
SR Waugh,AUS,Pace,1993-08-19,The Oval,England,1993,1,45,72,2,1,872,1626,33,827,1554,31,26.424242424242426,<=30,ENG,Away,Upto 2014
SR Waugh,AUS,Pace,1993-11-12,W.A.C.A,Australia,1993,2,20,66,1,1,942,1817,19,922,1751,18,49.578947368421055,>30,AUS,Home,Upto 2014
SR Waugh,AUS,Pace,1993-11-26,Hobart,Australia,1993,1,8,24,0,1,577,1014,7,569,990,7,82.42857142857143,>30,AUS,Home,Upto 2014
SR Waugh,AUS,Pace,1993-12-03,Brisbane,Australia,1993,1,13,18,0,1,683,1440,13,670,1422,13,52.53846153846154,>30,AUS,Home,Upto 2014
SR Waugh,AUS,Pace,1994-01-28,Adelaide,Australia,1994,2,30,144,4,1,661,1638,23,631,1494,19,28.73913043478261,<=30,AUS,Home,Upto 2014
SR Waugh,AUS,Pace,1994-03-04,Johannesburg,South Africa,1994,2,42,114,2,1,852,1646,28,810,1532,26,30.428571428571427,>30,SA,Away,Upto 2014
SR Waugh,AUS,Pace,1994-03-17,Cape Town,South Africa,1994,2,48,189,5,1,830,1910,22,782,1721,17,37.72727272727273,>30,SA,Away,Upto 2014
SR Waugh,AUS,Pace,1994-03-25,Durban,South Africa,1994,1,40,164,3,1,810,2116,20,770,1952,17,40.5,>30,SA,Away,Upto 2014
SR Waugh,AUS,Pace,1994-09-28,Karachi,Pakistan,1994,2,37,102,1,1,553,1041,23,516,939,22,24.043478260869566,<=30,PAK,Away,Upto 2014
SR Waugh,AUS,Pace,1994-10-05,Rawalpindi,Pakistan,1994,1,41,78,0,1,838,1506,23,797,1428,23,36.43478260869565,>30,PAK,Away,Upto 2014
SR Waugh,AUS,Pace,1995-04-08,St John's,West Indies,1995,1,20,36,2,1,658,1384,24,638,1348,22,27.416666666666668,<=30,WI,Away,Upto 2014
SR Waugh,AUS,Pace,1995-04-21,Port of Spain,West Indies,1995,1,19,18,1,1,399,876,29,380,858,28,13.758620689655173,<=30,WI,Away,Upto 2014
SR Waugh,AUS,Pace,1995-04-29,Kingston,West Indies,1995,2,23,90,2,1,658,1221,21,635,1131,19,31.333333333333332,>30,WI,Away,Upto 2014
SR Waugh,AUS,Pace,1995-11-09,Brisbane,Australia,1995,1,3,12,0,1,520,1074,13,517,1062,13,40.0,>30,AUS,Home,Upto 2014
SR Waugh,AUS,Pace,1995-11-17,Hobart,Australia,1995,2,37,84,1,1,693,1398,29,656,1314,28,23.896551724137932,<=30,AUS,Home,Upto 2014
SR Waugh,AUS,Pace,1996-01-25,Adelaide,Australia,1996,1,34,114,4,1,886,1812,32,852,1698,28,27.6875,<=30,AUS,Home,Upto 2014
SR Waugh,AUS,Pace,1996-10-10,Delhi,India,1996,1,25,78,1,1,274,681,13,249,603,12,21.076923076923077,<=30,IND,Away,Upto 2014
SR Waugh,AUS,Pace,1996-11-22,Brisbane,Australia,1996,1,15,49,1,1,925,1944,28,910,1895,27,33.035714285714285,>30,AUS,Home,Upto 2014
SR Waugh,AUS,Pace,1996-12-26,Melbourne,Australia,1996,1,22,60,0,1,553,1299,28,531,1239,28,19.75,<=30,AUS,Home,Upto 2014
SR Waugh,AUS,Pace,1997-02-01,W.A.C.A,Australia,1997,1,26,42,0,1,699,1242,25,673,1200,25,27.96,<=30,AUS,Home,Upto 2014
SR Waugh,AUS,Pace,1997-02-28,Johannesburg,South Africa,1997,1,4,24,1,1,660,1282,14,656,1258,13,47.142857142857146,>30,SA,Away,Upto 2014
SR Waugh,AUS,Pace,1997-03-14,Gqeberha,South Africa,1997,1,16,27,0,1,528,1387,24,512,1360,24,22.0,<=30,SA,Away,Upto 2014
SR Waugh,AUS,Pace,1997-06-05,Birmingham,England,1997,1,45,72,0,1,837,1443,24,792,1371,24,34.875,>30,ENG,Away,Upto 2014
SR Waugh,AUS,Pace,1997-06-19,Lord's,England,1997,1,20,24,0,1,411,849,18,391,825,18,22.833333333333332,<=30,ENG,Away,Upto 2014
SR Waugh,AUS,Pace,1997-07-24,Leeds,England,1997,1,11,24,0,1,800,1403,28,789,1379,28,28.571428571428573,<=30,ENG,Away,Upto 2014
SR Waugh,AUS,Pace,1997-11-27,Hobart,Australia,1997,2,30,90,4,1,691,1411,18,661,1321,14,38.388888888888886,>30,AUS,Home,Upto 2014
SR Waugh,AUS,Pace,1997-12-26,Melbourne,Australia,1997,2,24,54,1,1,627,1621,23,603,1567,22,27.26086956521739,<=30,AUS,Home,Upto 2014
SR Waugh,AUS,Pace,1998-01-02,Sydney,Australia,1998,1,10,48,0,1,405,1054,13,395,1006,13,31.153846153846153,>30,AUS,Home,Upto 2014
SR Waugh,AUS,Pace,1998-01-30,Adelaide,Australia,1998,2,40,84,1,1,879,2002,24,839,1918,23,36.625,>30,AUS,Home,Upto 2014
SR Waugh,AUS,Pace,1998-03-06,Chennai,India,1998,2,38,72,0,1,310,705,5,272,633,5,62.0,>30,IND,Away,Upto 2014
SR Waugh,AUS,Pace,1998-10-01,Rawalpindi,Pakistan,1998,1,6,12,0,1,337,761,10,331,749,10,33.7,>30,PAK,Away,Upto 2014
SR Waugh,AUS,Pace,1998-10-15,Peshawar,Pakistan,1998,1,19,48,1,1,690,1183,11,671,1135,10,62.72727272727273,>30,PAK,Away,Upto 2014
SR Waugh,AUS,Pace,1998-10-22,Karachi,Pakistan,1998,2,16,60,0,1,309,770,9,293,710,9,34.333333333333336,>30,PAK,Away,Upto 2014
SR Waugh,AUS,Pace,1998-11-20,Brisbane,Australia,1998,1,17,18,0,1,919,1808,20,902,1790,20,45.95,>30,AUS,Home,Upto 2014
SR Waugh,AUS,Pace,1998-12-11,Adelaide,Australia,1998,1,3,12,0,1,622,1222,21,619,1210,21,29.61904761904762,<=30,AUS,Home,Upto 2014
SR Waugh,AUS,Pace,1998-12-26,Melbourne,Australia,1998,1,8,36,2,1,840,1515,33,832,1479,31,25.454545454545453,<=30,AUS,Home,Upto 2014
SR Waugh,AUS,Pace,1999-03-26,Bridgetown,West Indies,1999,1,19,30,0,1,815,1748,29,796,1718,29,28.103448275862068,<=30,WI,Away,Upto 2014
SR Waugh,AUS,Pace,1999-10-14,Harare,Zimbabwe,1999,1,17,24,0,1,535,1322,16,518,1298,16,33.4375,>30,ZIM,Away,Upto 2014
SR Waugh,AUS,Pace,1999-11-05,Brisbane,Australia,1999,1,1,6,0,1,895,1510,23,894,1504,23,38.91304347826087,>30,AUS,Home,Upto 2014
SR Waugh,AUS,Pace,1999-11-18,Hobart,Australia,1999,1,19,24,0,1,857,1577,19,838,1553,19,45.10526315789474,>30,AUS,Home,Upto 2014
SR Waugh,AUS,Pace,2000-03-24,Wellington,New Zealand,2000,1,10,24,0,1,802,1476,20,792,1452,20,40.1,>30,NZ,Away,Upto 2014
SR Waugh,AUS,Pace,2000-03-31,Hamilton,New Zealand,2000,1,10,18,0,1,633,1061,24,623,1043,24,26.375,<=30,NZ,Away,Upto 2014
SR Waugh,AUS,Pace,2002-03-08,Cape Town,South Africa,2002,1,16,18,0,1,927,1517,20,911,1499,20,46.35,>30,SA,Away,Upto 2014
SR Waugh,AUS,Pace,2002-11-07,Brisbane,Australia,2002,1,5,24,0,1,677,1218,20,672,1194,20,33.85,>30,AUS,Home,Upto 2014
SR Waugh,AUS,Pace,2002-11-21,Adelaide,Australia,2002,1,9,30,0,1,643,1143,16,634,1113,16,40.1875,>30,AUS,Home,Upto 2014
SR Waugh,AUS,Pace,2002-12-26,Melbourne,Australia,2002,2,22,36,1,1,740,1406,19,718,1370,18,38.94736842105263,>30,AUS,Home,Upto 2014
SR Waugh,AUS,Pace,2003-01-02,Sydney,Australia,2003,2,7,60,1,1,1004,1656,32,997,1596,31,31.375,>30,AUS,Home,Upto 2014
SR Waugh,AUS,Pace,2003-04-10,Georgetown,West Indies,2003,1,29,48,0,1,811,1248,21,782,1200,21,38.61904761904762,>30,WI,Away,Upto 2014
SR Waugh,AUS,Pace,2003-04-19,Port of Spain,West Indies,2003,1,16,42,0,1,913,1617,20,897,1575,20,45.65,>30,WI,Away,Upto 2014
SR Waugh,AUS,Pace,2003-05-01,Bridgetown,West Indies,2003,1,6,24,0,1,652,1455,15,646,1431,15,43.46666666666667,>30,WI,Away,Upto 2014
SR Waugh,AUS,Pace,2003-05-09,St John's,West Indies,2003,1,25,30,0,1,870,1573,29,845,1543,29,30.0,<=30,WI,Away,Upto 2014
SR Waugh,AUS,Pace,2003-07-25,Cairns,Australia,2003,1,4,30,0,1,637,1169,12,633,1139,12,53.083333333333336,>30,AUS,Home,Upto 2014
SR Waugh,AUS,Pace,2003-10-09,W.A.C.A,Australia,2003,2,36,78,0,1,658,1277,15,622,1199,15,43.86666666666667,>30,AUS,Home,Upto 2014
SR Waugh,AUS,Pace,2003-10-17,Sydney,Australia,2003,1,7,24,0,1,646,1058,15,639,1034,15,43.06666666666667,>30,AUS,Home,Upto 2014
SR Waugh,AUS,Pace,2003-12-04,Brisbane,Australia,2003,1,16,42,0,1,735,1213,18,719,1171,18,40.833333333333336,>30,AUS,Home,Upto 2014
SR Waugh,AUS,Pace,2003-12-12,Adelaide,Australia,2003,2,25,78,0,1,872,1501,19,847,1423,19,45.89473684210526,>30,AUS,Home,Upto 2014
SR Waugh,AUS,Pace,2003-12-26,Melbourne,Australia,2003,1,35,54,1,1,819,1520,17,784,1466,16,48.1764705882353,>30,AUS,Home,Upto 2014
SR Waugh,AUS,Pace,2004-01-02,Sydney,Australia,2004,1,6,12,0,1,876,1379,11,870,1367,11,79.63636363636364,>30,AUS,Home,Upto 2014
SS Cottrell,WI,Pace,2013-11-06,Eden Gardens,India,2013,1,72,108,1,1,366,583,13,294,475,12,28.153846153846153,<=30,IND,Away,Upto 2014
SS Cottrell,WI,Pace,2014-12-17,Centurion,South Africa,2014,1,124,168,1,1,587,1007,20,463,839,19,29.35,<=30,SA,Away,After 1965
SS Das,IND,Pace,2000-11-25,Nagpur,India,2000,1,7,18,0,1,629,1195,8,622,1177,8,78.625,>30,IND,Home,Upto 2014
SS Das,IND,Pace,2002-05-10,St John's,West Indies,2002,1,28,48,0,1,856,1992,11,828,1944,11,77.81818181818181,>30,WI,Away,Upto 2014
SS Iyer,IND,Spin,2023-03-09,Ahmedabad,India,2023,1,2,6,0,1,725,1892,17,723,1886,17,42.64705882352941,>30,IND,Home,After 1965
SS Schultz,ENG,Spin,1879-01-02,Melbourne,Australia,1879,2,26,34,1,1,184,410,8,158,376,7,23.0,<=30,AUS,Away,After 1965
ST Banerjee,IND,Pace,1992-01-02,Sydney,Australia,1992,1,47,108,3,1,641,1594,19,594,1486,16,33.73684210526316,>30,AUS,Away,Upto 2014
ST Callaway,AUS,Pace,1892-01-01,Melbourne,Australia,1892,2,46,108,1,1,677,2425,30,631,2317,29,22.566666666666666,<=30,AUS,Home,After 1965
ST Callaway,AUS,Pace,1892-01-29,Sydney,Australia,1892,2,40,162,0,1,735,2292,31,695,2130,31,23.70967741935484,<=30,AUS,Home,After 1965
ST Callaway,AUS,Pace,1895-01-11,Adelaide,Australia,1895,2,56,201,5,1,553,1201,23,497,1000,18,24.043478260869566,<=30,AUS,Home,After 1965
ST Clarke,WI,Pace,1978-03-31,Georgetown,West Indies,1978,2,141,294,6,1,786,1458,28,645,1164,22,28.071428571428573,<=30,WI,Home,Upto 2014
ST Clarke,WI,Pace,1978-12-01,Wankhede,India,1978,2,151,348,5,1,499,1002,13,348,654,8,38.38461538461539,>30,IND,Away,Upto 2014
ST Clarke,WI,Pace,1978-12-15,Bengaluru,India,1978,1,126,206,5,1,557,1034,19,431,828,14,29.31578947368421,<=30,IND,Away,Upto 2014
ST Clarke,WI,Pace,1978-12-29,Eden Gardens,India,1978,2,174,330,2,1,744,1474,17,570,1144,15,43.76470588235294,>30,IND,Away,Upto 2014
ST Clarke,WI,Pace,1979-01-12,Chennai,India,1979,2,121,303,6,1,433,993,27,312,690,21,16.037037037037038,<=30,IND,Away,Upto 2014
ST Clarke,WI,Pace,1979-01-24,Delhi,India,1979,1,139,216,3,1,605,998,12,466,782,9,50.416666666666664,>30,IND,Away,Upto 2014
ST Clarke,WI,Pace,1980-11-24,Lahore,Pakistan,1980,2,95,210,2,1,508,1109,13,413,899,11,39.07692307692308,>30,PAK,Away,Upto 2014
ST Clarke,WI,Pace,1980-12-08,Faisalabad,Pakistan,1980,2,64,150,4,1,265,580,15,201,430,11,17.666666666666668,<=30,PAK,Away,Upto 2014
ST Clarke,WI,Pace,1980-12-22,Karachi,Pakistan,1980,2,41,156,6,1,342,961,23,301,805,17,14.869565217391305,<=30,PAK,Away,Upto 2014
ST Clarke,WI,Pace,1980-12-30,Multan,Pakistan,1980,1,42,72,2,1,286,658,15,244,586,13,19.066666666666666,<=30,PAK,Away,Upto 2014
ST Clarke,WI,Pace,1982-01-02,Sydney,Australia,1982,2,76,192,1,1,792,1770,20,716,1578,19,39.6,>30,AUS,Away,Upto 2014
ST Finn,ENG,Pace,2010-03-12,Chattogram,Bangladesh,2010,2,95,192,2,1,497,924,10,402,732,8,49.7,>30,BAN,Away,Upto 2014
ST Finn,ENG,Pace,2010-03-20,Mirpur,Bangladesh,2010,2,82,114,2,1,503,828,9,421,714,7,55.888888888888886,>30,BAN,Away,Upto 2014
ST Finn,ENG,Pace,2010-05-27,Lord's,England,2010,2,187,294,9,1,777,1274,20,590,980,11,38.85,>30,ENG,Home,Upto 2014
ST Finn,ENG,Pace,2010-06-04,Manchester,England,2010,2,81,108,6,1,268,480,16,187,372,10,16.75,<=30,ENG,Home,Upto 2014
ST Finn,ENG,Pace,2010-07-29,Nottingham,England,2010,2,78,114,5,1,558,1225,33,480,1111,28,16.90909090909091,<=30,ENG,Home,Upto 2014
ST Finn,ENG,Pace,2010-08-06,Birmingham,England,2010,2,67,144,3,1,468,1160,20,401,1016,17,23.4,<=30,ENG,Home,Upto 2014
ST Finn,ENG,Pace,2010-08-18,The Oval,England,2010,2,92,138,1,1,645,1152,22,553,1014,21,29.318181818181817,<=30,ENG,Home,Upto 2014
ST Finn,ENG,Pace,2010-08-26,Lord's,England,2010,2,61,78,4,1,413,794,18,352,716,14,22.944444444444443,<=30,ENG,Home,Upto 2014
ST Finn,ENG,Pace,2010-11-25,Brisbane,Australia,2010,2,150,226,6,1,947,1750,17,797,1524,11,55.705882352941174,>30,AUS,Away,Upto 2014
ST Finn,ENG,Pace,2010-12-03,Adelaide,Australia,2010,2,131,204,3,1,745,1313,14,614,1109,11,53.214285714285715,>30,AUS,Away,Upto 2014
ST Finn,ENG,Pace,2010-12-16,W.A.C.A,Australia,2010,2,183,216,5,1,755,1419,38,572,1203,33,19.86842105263158,<=30,AUS,Away,Upto 2014
ST Finn,ENG,Pace,2011-06-03,Lord's,England,2011,2,139,246,4,1,1032,1597,21,893,1351,17,49.142857142857146,>30,ENG,Home,Upto 2014
ST Finn,ENG,Pace,2012-04-03,Colombo (PSS),Sri Lanka,2012,2,81,227,3,1,394,959,10,313,732,7,39.4,>30,SL,Away,Upto 2014
ST Finn,ENG,Pace,2012-06-07,Birmingham,England,2012,1,109,192,3,1,443,825,14,334,633,11,31.642857142857142,>30,ENG,Home,Upto 2014
ST Finn,ENG,Pace,2012-08-02,Leeds,England,2012,2,173,276,2,1,982,1920,23,809,1644,21,42.69565217391305,>30,ENG,Home,Upto 2014
ST Finn,ENG,Pace,2012-08-16,Lord's,England,2012,2,149,270,8,1,927,1840,33,778,1570,25,28.09090909090909,<=30,ENG,Home,Upto 2014
ST Finn,ENG,Pace,2012-12-05,Eden Gardens,India,2012,2,118,234,4,1,417,856,12,299,622,8,34.75,>30,IND,Away,Upto 2014
ST Finn,ENG,Pace,2013-03-06,Dunedin,New Zealand,2013,1,102,160,1,1,764,1468,18,662,1308,17,42.44444444444444,>30,NZ,Away,Upto 2014
ST Finn,ENG,Pace,2013-03-14,Wellington,New Zealand,2013,2,108,186,2,1,612,1184,15,504,998,13,40.8,>30,NZ,Away,Upto 2014
ST Finn,ENG,Pace,2013-03-22,Auckland,New Zealand,2013,2,182,303,7,1,822,1793,28,640,1490,21,29.357142857142858,<=30,NZ,Away,Upto 2014
ST Finn,ENG,Pace,2013-05-16,Lord's,England,2013,1,63,90,4,1,569,1283,36,506,1193,32,15.805555555555555,<=30,ENG,Home,Upto 2014
ST Finn,ENG,Pace,2013-05-24,Leeds,England,2013,2,98,186,4,1,701,1279,21,603,1093,17,33.38095238095238,>30,ENG,Home,Upto 2014
ST Finn,ENG,Pace,2013-07-10,Nottingham,England,2013,2,117,150,2,1,827,1665,33,710,1515,31,25.060606060606062,<=30,ENG,Home,Upto 2014
ST Finn,ENG,Pace,2015-07-29,Birmingham,England,2015,2,117,186,8,1,619,1035,28,502,849,20,22.107142857142858,<=30,ENG,Home,After 1965
ST Finn,ENG,Pace,2015-08-06,Nottingham,England,2015,2,63,108,1,1,542,945,29,479,837,28,18.689655172413794,<=30,ENG,Home,After 1965
ST Finn,ENG,Pace,2015-08-20,The Oval,England,2015,1,90,175,3,1,638,1293,22,548,1118,19,29.0,<=30,ENG,Home,After 1965
ST Finn,ENG,Pace,2015-12-26,Durban,South Africa,2015,2,91,184,6,1,593,1392,27,502,1208,21,21.962962962962962,<=30,SA,Away,After 1965
ST Finn,ENG,Pace,2016-01-02,Cape Town,South Africa,2016,1,132,234,2,1,994,1661,14,862,1427,12,71.0,>30,SA,Away,After 1965
ST Finn,ENG,Pace,2016-01-14,Johannesburg,South Africa,2016,2,64,126,3,1,692,1271,29,628,1145,26,23.862068965517242,<=30,SA,Away,After 1965
ST Finn,ENG,Pace,2016-05-19,Leeds,England,2016,2,45,90,3,1,468,901,27,423,811,24,17.333333333333332,<=30,ENG,Home,After 1965
ST Finn,ENG,Pace,2016-05-27,Chester-le-Street,England,2016,2,93,156,1,1,773,1433,25,680,1277,24,30.92,>30,ENG,Home,After 1965
ST Finn,ENG,Pace,2016-06-09,Lord's,England,2016,1,59,108,3,1,770,1481,24,711,1373,21,32.083333333333336,>30,ENG,Home,After 1965
ST Finn,ENG,Pace,2016-07-14,Lord's,England,2016,2,128,204,0,1,760,1521,27,632,1317,27,28.14814814814815,<=30,ENG,Home,After 1965
ST Finn,ENG,Pace,2016-08-03,Birmingham,England,2016,2,114,245,2,1,912,1860,29,798,1615,27,31.448275862068964,>30,ENG,Home,After 1965
ST Finn,ENG,Pace,2016-08-11,The Oval,England,2016,2,110,182,3,1,784,1374,21,674,1192,18,37.333333333333336,>30,ENG,Home,After 1965
ST Finn,ENG,Pace,2016-10-28,Mirpur,Bangladesh,2016,2,48,66,0,1,173,288,8,125,222,8,21.625,<=30,BAN,Away,After 1965
ST Gabriel,WI,Pace,2012-05-17,Lord's,England,2012,2,86,159,4,1,939,1916,29,853,1757,25,32.37931034482759,>30,ENG,Away,Upto 2014
ST Gabriel,WI,Pace,2013-03-12,Bridgetown,West Indies,2013,2,55,130,4,1,330,750,17,275,620,13,19.41176470588235,<=30,WI,Home,Upto 2014
ST Gabriel,WI,Pace,2013-03-20,Roseau,West Indies,2013,2,29,66,2,1,341,648,7,312,582,5,48.714285714285715,>30,WI,Home,Upto 2014
ST Gabriel,WI,Pace,2013-11-14,Wankhede,India,2013,1,85,96,1,1,332,492,5,247,396,4,66.4,>30,IND,Away,Upto 2014
ST Gabriel,WI,Pace,2013-12-03,Dunedin,New Zealand,2013,2,164,197,0,1,879,1520,20,715,1323,20,43.95,>30,NZ,Away,Upto 2014
ST Gabriel,WI,Pace,2013-12-11,Wellington,New Zealand,2013,1,86,151,2,1,603,1007,28,517,856,26,21.535714285714285,<=30,NZ,Away,Upto 2014
ST Gabriel,WI,Pace,2014-06-16,Port of Spain,West Indies,2014,2,109,212,4,1,611,1256,20,502,1044,16,30.55,>30,WI,Home,After 1965
ST Gabriel,WI,Pace,2014-09-05,Kingstown,West Indies,2014,2,75,180,3,1,442,907,11,367,727,8,40.18181818181818,>30,WI,Home,After 1965
ST Gabriel,WI,Pace,2014-09-13,Gros Islet,West Indies,2014,2,73,156,2,1,563,1240,21,490,1084,19,26.80952380952381,<=30,WI,Home,After 1965
ST Gabriel,WI,Pace,2014-12-26,Gqeberha,South Africa,2014,1,80,126,2,1,464,870,12,384,744,10,38.666666666666664,>30,SA,Away,After 1965
ST Gabriel,WI,Pace,2015-01-02,Cape Town,South Africa,2015,2,91,132,1,1,670,1234,16,579,1102,15,41.875,>30,SA,Away,After 1965
ST Gabriel,WI,Pace,2015-04-21,St George's,West Indies,2015,2,87,174,3,1,731,1499,18,644,1325,15,40.611111111111114,>30,WI,Home,After 1965
ST Gabriel,WI,Pace,2015-05-01,Bridgetown,West Indies,2015,2,63,132,3,1,388,896,26,325,764,23,14.923076923076923,<=30,WI,Home,After 1965
ST Gabriel,WI,Pace,2015-06-03,Roseau,West Indies,2015,2,63,102,1,1,402,941,20,339,839,19,20.1,<=30,WI,Home,After 1965
ST Gabriel,WI,Pace,2015-10-14,Galle,Sri Lanka,2015,1,76,120,1,1,384,801,11,308,681,10,34.90909090909091,>30,SL,Away,After 1965
ST Gabriel,WI,Pace,2015-12-10,Hobart,Australia,2015,1,59,60,1,1,634,903,16,575,843,15,39.625,>30,AUS,Away,After 1965
ST Gabriel,WI,Pace,2016-07-21,North Sound,West Indies,2016,1,65,126,2,1,466,972,12,401,846,10,38.833333333333336,>30,WI,Home,After 1965
ST Gabriel,WI,Pace,2016-07-30,Kingston,West Indies,2016,1,62,168,1,1,509,984,9,447,816,8,56.55555555555556,>30,WI,Home,After 1965
ST Gabriel,WI,Pace,2016-08-09,Gros Islet,West Indies,2016,2,103,156,2,1,570,1190,26,467,1034,24,21.923076923076923,<=30,WI,Home,After 1965
ST Gabriel,WI,Pace,2016-10-13,Dubai (DICS),UAE,2016,2,122,174,1,1,642,1209,9,520,1035,8,71.33333333333333,>30,UAE,Away,After 1965
ST Gabriel,WI,Pace,2016-10-21,Abu Dhabi,UAE,2016,2,132,211,6,1,485,1009,16,353,798,10,30.3125,>30,UAE,Away,After 1965
ST Gabriel,WI,Pace,2016-10-30,Sharjah,UAE,2016,2,103,216,3,1,508,1019,20,405,803,17,25.4,<=30,UAE,Away,After 1965
ST Gabriel,WI,Pace,2017-04-21,Kingston,West Indies,2017,2,99,192,4,1,500,1200,21,401,1008,17,23.80952380952381,<=30,WI,Home,After 1965
ST Gabriel,WI,Pace,2017-04-30,Bridgetown,West Indies,2017,2,92,258,9,1,469,1258,27,377,1000,18,17.37037037037037,<=30,WI,Home,After 1965
ST Gabriel,WI,Pace,2017-05-10,Roseau,West Indies,2017,2,91,252,2,1,472,1494,20,381,1242,18,23.6,<=30,WI,Home,After 1965
ST Gabriel,WI,Pace,2017-08-25,Leeds,England,2017,2,176,258,6,1,1027,1807,24,851,1549,18,42.791666666666664,>30,ENG,Away,After 1965
ST Gabriel,WI,Pace,2017-09-07,Lord's,England,2017,2,86,120,1,1,490,1083,30,404,963,29,16.333333333333332,<=30,ENG,Away,After 1965
ST Gabriel,WI,Pace,2017-10-21,Bulawayo,Zimbabwe,2017,2,74,129,1,1,377,855,10,303,726,9,37.7,>30,ZIM,Away,After 1965
ST Gabriel,WI,Pace,2017-10-29,Bulawayo,Zimbabwe,2017,2,98,258,4,1,339,949,11,241,691,7,30.818181818181817,>30,ZIM,Away,After 1965
ST Gabriel,WI,Pace,2017-12-01,Wellington,New Zealand,2017,1,90,174,1,1,782,1474,25,692,1300,24,31.28,>30,NZ,Away,After 1965
ST Gabriel,WI,Pace,2017-12-09,Hamilton,New Zealand,2017,2,171,240,6,1,876,1573,33,705,1333,27,26.545454545454547,<=30,NZ,Away,After 1965
ST Gabriel,WI,Pace,2018-06-06,Port of Spain,West Indies,2018,2,100,168,4,1,624,1324,21,524,1156,17,29.714285714285715,<=30,WI,Home,After 1965
ST Gabriel,WI,Pace,2018-06-14,Gros Islet,West Indies,2018,2,121,220,13,1,739,1498,33,618,1278,20,22.393939393939394,<=30,WI,Home,After 1965
ST Gabriel,WI,Pace,2018-06-23,Bridgetown,West Indies,2018,2,78,144,3,1,501,1108,32,423,964,29,15.65625,<=30,WI,Home,After 1965
ST Gabriel,WI,Pace,2018-07-04,North Sound,West Indies,2018,2,91,102,5,1,363,699,24,272,597,19,15.125,<=30,WI,Home,After 1965
ST Gabriel,WI,Pace,2018-07-12,Kingston,West Indies,2018,2,48,114,3,1,360,661,22,312,547,19,16.363636363636363,<=30,WI,Home,After 1965
ST Gabriel,WI,Pace,2018-10-04,Rajkot,India,2018,1,84,126,1,1,307,492,6,223,366,5,51.166666666666664,>30,IND,Away,After 1965
ST Gabriel,WI,Pace,2018-10-12,Hyderabad,India,2018,1,107,124,3,1,322,529,18,215,405,15,17.88888888888889,<=30,IND,Away,After 1965
ST Gabriel,WI,Pace,2018-11-22,Chattogram,Bangladesh,2018,2,94,138,5,1,183,270,6,89,132,1,30.5,>30,BAN,Away,After 1965
ST Gabriel,WI,Pace,2019-01-23,Bridgetown,West Indies,2019,2,70,143,2,1,635,1301,24,565,1158,22,26.458333333333332,<=30,WI,Home,After 1965
ST Gabriel,WI,Pace,2019-01-31,North Sound,West Indies,2019,2,67,150,3,1,523,1214,27,456,1064,24,19.37037037037037,<=30,WI,Home,After 1965
ST Gabriel,WI,Pace,2019-02-09,Gros Islet,West Indies,2019,2,144,284,4,1,684,1370,27,540,1086,23,25.333333333333332,<=30,WI,Home,After 1965
ST Gabriel,WI,Pace,2019-08-22,North Sound,West Indies,2019,2,134,228,4,1,576,1302,29,442,1074,25,19.862068965517242,<=30,WI,Home,After 1965
ST Gabriel,WI,Pace,2019-08-30,Kingston,West Indies,2019,2,92,168,0,1,512,1121,25,420,953,25,20.48,<=30,WI,Home,After 1965
ST Gabriel,WI,Pace,2020-07-08,Southampton,England,2020,2,137,221,9,1,825,1729,32,688,1508,23,25.78125,<=30,ENG,Away,After 1965
ST Gabriel,WI,Pace,2020-07-16,Manchester,England,2020,2,122,198,0,1,747,1583,23,625,1385,23,32.47826086956522,>30,ENG,Away,After 1965
ST Gabriel,WI,Pace,2020-07-24,Manchester,England,2020,2,96,170,2,1,625,1206,27,529,1036,25,23.14814814814815,<=30,ENG,Away,After 1965
ST Gabriel,WI,Pace,2020-12-03,Hamilton,New Zealand,2020,1,89,150,3,1,725,1439,25,636,1289,22,29.0,<=30,NZ,Away,After 1965
ST Gabriel,WI,Pace,2020-12-11,Wellington,New Zealand,2020,1,93,156,3,1,834,1421,28,741,1265,25,29.785714285714285,<=30,NZ,Away,After 1965
ST Gabriel,WI,Pace,2021-02-03,Chattogram,Bangladesh,2021,2,106,228,3,1,327,606,6,221,378,3,54.5,>30,BAN,Away,After 1965
ST Gabriel,WI,Pace,2021-02-11,Mirpur,Bangladesh,2021,2,78,138,3,1,347,599,12,269,461,9,28.916666666666668,<=30,BAN,Away,After 1965
ST Gabriel,WI,Pace,2021-03-21,North Sound,West Indies,2021,2,89,162,0,1,742,1672,25,653,1510,25,29.68,<=30,WI,Home,After 1965
ST Gabriel,WI,Pace,2021-03-29,North Sound,West Indies,2021,2,57,128,1,1,742,1513,23,685,1385,22,32.26086956521739,>30,WI,Home,After 1965
ST Gabriel,WI,Pace,2021-06-18,Gros Islet,West Indies,2021,2,93,132,2,1,606,1318,31,513,1186,29,19.548387096774192,<=30,WI,Home,After 1965
ST Gabriel,WI,Pace,2021-11-21,Galle,Sri Lanka,2021,2,92,138,2,1,180,408,3,88,270,1,60.0,>30,SL,Away,After 1965
ST Gabriel,WI,Pace,2023-02-12,Bulawayo,Zimbabwe,2023,2,39,90,1,1,266,519,11,227,429,10,24.181818181818183,<=30,ZIM,Away,After 1965
ST Gabriel,WI,Pace,2023-02-28,Centurion,South Africa,2023,2,75,90,2,1,738,1209,39,663,1119,37,18.923076923076923,<=30,SA,Away,After 1965
ST Gabriel,WI,Pace,2023-07-20,Port of Spain,West Indies,2023,2,107,144,2,1,656,1048,14,549,904,12,46.857142857142854,>30,WI,Home,After 1965
ST Jayasuriya,SL,Spin,1991-03-01,Auckland,New Zealand,1991,1,18,36,0,1,346,733,6,328,697,6,57.666666666666664,>30,NZ,Away,Upto 2014
ST Jayasuriya,SL,Spin,1991-08-22,Lord's,England,1991,1,1,6,0,1,298,574,10,297,568,10,29.8,<=30,ENG,Away,Upto 2014
ST Jayasuriya,SL,Spin,1992-09-08,Moratuwa,Sri Lanka,1992,2,26,54,0,1,347,775,4,321,721,4,86.75,>30,SL,Home,Upto 2014
ST Jayasuriya,SL,Spin,1993-03-13,Colombo (SSC),Sri Lanka,1993,2,99,168,2,1,805,1517,22,706,1349,20,36.59090909090909,>30,SL,Home,Upto 2014
ST Jayasuriya,SL,Spin,1993-08-04,Colombo (PSS),Sri Lanka,1993,1,30,48,0,1,715,1623,16,685,1575,16,44.6875,>30,SL,Home,Upto 2014
ST Jayasuriya,SL,Spin,1993-09-06,Colombo (SSC),Sri Lanka,1993,1,47,54,0,1,286,744,8,239,690,8,35.75,>30,SL,Home,Upto 2014
ST Jayasuriya,SL,Spin,1993-09-14,Colombo (PSS),Sri Lanka,1993,2,26,48,1,1,296,757,9,270,709,8,32.888888888888886,>30,SL,Home,Upto 2014
ST Jayasuriya,SL,Spin,1993-12-08,Moratuwa,Sri Lanka,1993,1,7,18,1,1,241,659,12,234,641,11,20.083333333333332,<=30,SL,Home,Upto 2014
ST Jayasuriya,SL,Spin,1994-01-26,Bengaluru,India,1994,1,26,48,0,1,625,1188,15,599,1140,15,41.666666666666664,>30,IND,Away,Upto 2014
ST Jayasuriya,SL,Spin,1994-08-09,Colombo (PSS),Sri Lanka,1994,1,53,78,0,1,791,1520,23,738,1442,23,34.391304347826086,>30,SL,Home,Upto 2014
ST Jayasuriya,SL,Spin,1994-10-26,Harare,Zimbabwe,1994,1,12,12,0,1,179,444,4,167,432,4,44.75,>30,ZIM,Away,Upto 2014
ST Jayasuriya,SL,Spin,1996-01-25,Adelaide,Australia,1996,1,41,78,0,1,356,732,3,315,654,3,118.66666666666667,>30,AUS,Away,Upto 2014
ST Jayasuriya,SL,Spin,1996-09-11,Colombo (RPS),Sri Lanka,1996,1,1,24,0,1,302,952,21,301,928,21,14.380952380952381,<=30,SL,Home,Upto 2014
ST Jayasuriya,SL,Spin,1996-09-18,Colombo (SSC),Sri Lanka,1996,1,16,42,2,1,399,1111,19,383,1069,17,21.0,<=30,SL,Home,Upto 2014
ST Jayasuriya,SL,Spin,1997-03-07,Dunedin,New Zealand,1997,1,34,48,0,1,364,612,5,330,564,5,72.8,>30,NZ,Away,Upto 2014
ST Jayasuriya,SL,Spin,1997-03-14,Hamilton,New Zealand,1997,1,5,6,0,1,413,1010,18,408,1004,18,22.944444444444443,<=30,NZ,Away,Upto 2014
ST Jayasuriya,SL,Spin,1997-04-19,Colombo (RPS),Sri Lanka,1997,1,15,18,0,1,757,2006,23,742,1988,23,32.91304347826087,>30,SL,Home,Upto 2014
ST Jayasuriya,SL,Spin,1997-06-13,St John's,West Indies,1997,2,25,30,0,1,220,504,11,195,474,11,20.0,<=30,WI,Away,Upto 2014
ST Jayasuriya,SL,Spin,1997-08-02,Colombo (RPS),Sri Lanka,1997,1,45,108,3,1,1044,2082,8,999,1974,5,130.5,>30,SL,Home,Upto 2014
ST Jayasuriya,SL,Spin,1997-08-09,Colombo (SSC),Sri Lanka,1997,2,39,120,0,1,450,1036,11,411,916,11,40.90909090909091,>30,SL,Home,Upto 2014
ST Jayasuriya,SL,Spin,1997-11-19,Mohali,India,1997,1,59,180,2,1,502,1356,8,443,1176,6,62.75,>30,IND,Away,Upto 2014
ST Jayasuriya,SL,Spin,1997-11-26,Nagpur,India,1997,1,32,96,2,1,254,546,2,222,450,0,127.0,>30,IND,Away,Upto 2014
ST Jayasuriya,SL,Spin,1997-12-03,Wankhede,India,1997,2,93,162,2,1,533,1312,21,440,1150,19,25.38095238095238,<=30,IND,Away,Upto 2014
ST Jayasuriya,SL,Spin,1998-01-07,Kandy,Sri Lanka,1998,2,38,102,0,1,546,1374,23,508,1272,23,23.73913043478261,<=30,SL,Home,Upto 2014
ST Jayasuriya,SL,Spin,1998-01-14,Colombo (SSC),Sri Lanka,1998,1,64,174,2,1,688,1695,18,624,1521,16,38.22222222222222,>30,SL,Home,Upto 2014
ST Jayasuriya,SL,Spin,1998-03-19,Cape Town,South Africa,1998,2,82,234,4,1,499,1068,16,417,834,12,31.1875,>30,SA,Away,Upto 2014
ST Jayasuriya,SL,Spin,1998-03-27,Centurion,South Africa,1998,2,72,144,3,1,345,671,12,273,527,9,28.75,<=30,SA,Away,Upto 2014
ST Jayasuriya,SL,Spin,1998-05-27,Colombo (RPS),Sri Lanka,1998,1,63,96,1,1,939,2077,27,876,1981,26,34.77777777777778,>30,SL,Home,Upto 2014
ST Jayasuriya,SL,Spin,1998-06-03,Galle,Sri Lanka,1998,1,8,24,0,1,443,1219,25,435,1195,25,17.72,<=30,SL,Home,Upto 2014
ST Jayasuriya,SL,Spin,1998-08-27,The Oval,England,1998,2,68,234,0,1,481,1390,17,413,1156,17,28.294117647058822,<=30,ENG,Away,Upto 2014
ST Jayasuriya,SL,Spin,1999-09-09,Kandy,Sri Lanka,1999,2,12,54,0,1,373,779,20,361,725,20,18.65,<=30,SL,Home,Upto 2014
ST Jayasuriya,SL,Spin,1999-09-22,Galle,Sri Lanka,1999,1,15,54,0,1,307,827,13,292,773,13,23.615384615384617,<=30,SL,Home,Upto 2014
ST Jayasuriya,SL,Spin,1999-09-30,Colombo (SSC),Sri Lanka,1999,1,14,54,0,1,278,654,6,264,600,6,46.333333333333336,>30,SL,Home,Upto 2014
ST Jayasuriya,SL,Spin,1999-11-18,Bulawayo,Zimbabwe,1999,2,12,48,0,1,248,534,3,236,486,3,82.66666666666667,>30,ZIM,Away,Upto 2014
ST Jayasuriya,SL,Spin,1999-11-26,Harare,Zimbabwe,1999,2,47,94,4,1,215,630,10,168,536,6,21.5,<=30,ZIM,Away,Upto 2014
ST Jayasuriya,SL,Spin,1999-12-04,Harare,Zimbabwe,1999,2,18,72,0,1,143,474,2,125,402,2,71.5,>30,ZIM,Away,Upto 2014
ST Jayasuriya,SL,Spin,2000-02-26,Rawalpindi,Pakistan,2000,1,12,18,0,1,401,1058,12,389,1040,12,33.416666666666664,>30,PAK,Away,Upto 2014
ST Jayasuriya,SL,Spin,2000-03-05,Peshawar,Pakistan,2000,2,37,48,2,1,411,991,20,374,943,18,20.55,<=30,PAK,Away,Upto 2014
ST Jayasuriya,SL,Spin,2000-03-12,Karachi,Pakistan,2000,2,43,95,1,1,344,671,14,301,576,13,24.571428571428573,<=30,PAK,Away,Upto 2014
ST Jayasuriya,SL,Spin,2000-06-14,Colombo (SSC),Sri Lanka,2000,1,6,24,0,1,317,840,16,311,816,16,19.8125,<=30,SL,Home,Upto 2014
ST Jayasuriya,SL,Spin,2000-06-21,Galle,Sri Lanka,2000,1,22,12,0,1,434,852,7,412,840,7,62.0,>30,SL,Home,Upto 2014
ST Jayasuriya,SL,Spin,2000-07-20,Galle,Sri Lanka,2000,2,25,48,1,1,705,1392,24,680,1344,23,29.375,<=30,SL,Home,Upto 2014
ST Jayasuriya,SL,Spin,2000-07-30,Kandy,Sri Lanka,2000,1,45,78,2,1,551,1139,19,506,1061,17,29.0,<=30,SL,Home,Upto 2014
ST Jayasuriya,SL,Spin,2000-08-06,Colombo (SSC),Sri Lanka,2000,2,65,162,2,1,525,1357,18,460,1195,16,29.166666666666668,<=30,SL,Home,Upto 2014
ST Jayasuriya,SL,Spin,2001-01-02,Cape Town,South Africa,2001,1,28,42,0,1,231,506,8,203,464,8,28.875,<=30,SA,Away,Upto 2014
ST Jayasuriya,SL,Spin,2001-01-20,Centurion,South Africa,2001,1,10,36,0,1,110,198,2,100,162,2,55.0,>30,SA,Away,Upto 2014
ST Jayasuriya,SL,Spin,2001-02-22,Galle,Sri Lanka,2001,2,94,354,8,1,636,1872,18,542,1518,10,35.333333333333336,>30,SL,Home,Upto 2014
ST Jayasuriya,SL,Spin,2001-03-07,Kandy,Sri Lanka,2001,2,98,301,4,1,679,1658,18,581,1357,14,37.72222222222222,>30,SL,Home,Upto 2014
ST Jayasuriya,SL,Spin,2001-03-15,Colombo (SSC),Sri Lanka,2001,2,44,105,4,1,375,1120,19,331,1015,15,19.736842105263158,<=30,SL,Home,Upto 2014
ST Jayasuriya,SL,Spin,2001-08-14,Galle,Sri Lanka,2001,1,10,42,1,1,169,548,10,159,506,9,16.9,<=30,SL,Home,Upto 2014
ST Jayasuriya,SL,Spin,2001-08-22,Kandy,Sri Lanka,2001,1,12,18,0,1,215,370,5,203,352,5,43.0,>30,SL,Home,Upto 2014
ST Jayasuriya,SL,Spin,2001-08-29,Colombo (SSC),Sri Lanka,2001,1,34,126,1,1,579,1257,16,545,1131,15,36.1875,>30,SL,Home,Upto 2014
ST Jayasuriya,SL,Spin,2001-09-06,Colombo (SSC),Sri Lanka,2001,1,52,96,1,1,422,724,14,370,628,13,30.142857142857142,>30,SL,Home,Upto 2014
ST Jayasuriya,SL,Spin,2001-11-13,Galle,Sri Lanka,2001,2,37,84,0,1,681,1597,17,644,1513,17,40.05882352941177,>30,SL,Home,Upto 2014
ST Jayasuriya,SL,Spin,2001-11-21,Kandy,Sri Lanka,2001,1,13,30,0,1,458,1038,19,445,1008,19,24.105263157894736,<=30,SL,Home,Upto 2014
ST Jayasuriya,SL,Spin,2001-11-29,Colombo (SSC),Sri Lanka,2001,1,11,18,0,1,542,1074,5,531,1056,5,108.4,>30,SL,Home,Upto 2014
ST Jayasuriya,SL,Spin,2001-12-27,Colombo (SSC),Sri Lanka,2001,2,26,48,0,1,311,756,12,285,708,12,25.916666666666668,<=30,SL,Home,Upto 2014
ST Jayasuriya,SL,Spin,2002-01-04,Kandy,Sri Lanka,2002,2,30,78,0,1,367,934,16,337,856,16,22.9375,<=30,SL,Home,Upto 2014
ST Jayasuriya,SL,Spin,2002-01-12,Galle,Sri Lanka,2002,2,74,282,9,1,515,1423,24,441,1141,15,21.458333333333332,<=30,SL,Home,Upto 2014
ST Jayasuriya,SL,Spin,2002-03-06,Lahore,Pakistan,2002,1,7,6,0,1,240,516,8,233,510,8,30.0,<=30,PAK,Away,Upto 2014
ST Jayasuriya,SL,Spin,2002-05-16,Lord's,England,2002,1,66,150,0,1,171,426,1,105,276,1,171.0,>30,ENG,Away,Upto 2014
ST Jayasuriya,SL,Spin,2002-05-30,Birmingham,England,2002,1,27,36,0,1,264,643,6,237,607,6,44.0,>30,ENG,Away,Upto 2014
ST Jayasuriya,SL,Spin,2002-06-13,Manchester,England,2002,1,15,48,0,1,309,728,8,294,680,8,38.625,>30,ENG,Away,Upto 2014
ST Jayasuriya,SL,Spin,2002-07-21,Colombo (PSS),Sri Lanka,2002,2,21,66,1,1,331,649,16,310,583,15,20.6875,<=30,SL,Home,Upto 2014
ST Jayasuriya,SL,Spin,2002-07-28,Colombo (SSC),Sri Lanka,2002,2,31,96,3,1,450,838,15,419,742,12,30.0,<=30,SL,Home,Upto 2014
ST Jayasuriya,SL,Spin,2003-04-25,Colombo (PSS),Sri Lanka,2003,1,29,36,0,1,714,1571,15,685,1535,15,47.6,>30,SL,Home,Upto 2014
ST Jayasuriya,SL,Spin,2003-05-03,Kandy,Sri Lanka,2003,2,44,90,0,1,468,1155,15,424,1065,15,31.2,>30,SL,Home,Upto 2014
ST Jayasuriya,SL,Spin,2003-12-02,Galle,Sri Lanka,2003,2,75,228,2,1,603,1823,28,528,1595,26,21.535714285714285,<=30,SL,Home,Upto 2014
ST Jayasuriya,SL,Spin,2003-12-10,Kandy,Sri Lanka,2003,2,77,246,1,1,692,1702,20,615,1456,19,34.6,>30,SL,Home,Upto 2014
ST Jayasuriya,SL,Spin,2003-12-18,Colombo (SSC),Sri Lanka,2003,2,6,66,2,1,552,1368,13,546,1302,11,42.46153846153846,>30,SL,Home,Upto 2014
ST Jayasuriya,SL,Spin,2004-03-08,Galle,Sri Lanka,2004,2,40,93,1,1,953,1791,32,913,1698,31,29.78125,<=30,SL,Home,Upto 2014
ST Jayasuriya,SL,Spin,2004-03-16,Kandy,Sri Lanka,2004,1,16,30,0,1,537,881,19,521,851,19,28.263157894736842,<=30,SL,Home,Upto 2014
ST Jayasuriya,SL,Spin,2004-03-24,Colombo (SSC),Sri Lanka,2004,2,40,90,1,1,844,1656,26,804,1566,25,32.46153846153846,>30,SL,Home,Upto 2014
ST Jayasuriya,SL,Spin,2004-05-06,Harare,Zimbabwe,2004,2,8,12,1,1,203,375,10,195,363,9,20.3,<=30,ZIM,Away,Upto 2014
ST Jayasuriya,SL,Spin,2004-05-14,Bulawayo,Zimbabwe,2004,2,48,84,2,1,302,532,8,254,448,6,37.75,>30,ZIM,Away,Upto 2014
ST Jayasuriya,SL,Spin,2004-07-01,Darwin,Australia,2004,2,30,102,1,1,223,419,7,193,317,6,31.857142857142858,>30,AUS,Away,Upto 2014
ST Jayasuriya,SL,Spin,2004-07-09,Cairns,Australia,2004,2,28,54,0,1,552,988,20,524,934,20,27.6,<=30,AUS,Away,Upto 2014
ST Jayasuriya,SL,Spin,2004-08-04,Galle,Sri Lanka,2004,2,70,252,2,1,688,1462,17,618,1210,15,40.470588235294116,>30,SL,Home,Upto 2014
ST Jayasuriya,SL,Spin,2004-08-11,Colombo (SSC),Sri Lanka,2004,2,56,139,5,1,470,988,13,414,849,8,36.15384615384615,>30,SL,Home,Upto 2014
ST Jayasuriya,SL,Spin,2004-10-20,Faisalabad,Pakistan,2004,2,6,48,1,1,395,875,14,389,827,13,28.214285714285715,<=30,PAK,Away,Upto 2014
ST Jayasuriya,SL,Spin,2004-10-28,Karachi,Pakistan,2004,2,41,84,1,1,509,1056,15,468,972,14,33.93333333333333,>30,PAK,Away,Upto 2014
ST Jayasuriya,SL,Spin,2005-04-04,Napier,New Zealand,2005,2,49,144,2,1,443,871,8,394,727,6,55.375,>30,NZ,Away,Upto 2014
ST Jayasuriya,SL,Spin,2005-04-11,Wellington,New Zealand,2005,1,34,54,0,1,233,396,0,199,342,0,inf,>30,NZ,Away,Upto 2014
ST Jayasuriya,SL,Spin,2005-07-13,Colombo (SSC),Sri Lanka,2005,2,35,66,0,1,301,612,9,266,546,9,33.44444444444444,>30,SL,Home,Upto 2014
ST Jayasuriya,SL,Spin,2005-07-22,Kandy,Sri Lanka,2005,1,26,66,1,1,292,585,15,266,519,14,19.466666666666665,<=30,SL,Home,Upto 2014
ST Jayasuriya,SL,Spin,2006-03-26,Colombo (SSC),Sri Lanka,2006,1,37,78,0,1,538,1125,13,501,1047,13,41.38461538461539,>30,SL,Home,Upto 2014
ST Jayasuriya,SL,Spin,2006-06-02,Nottingham,England,2006,2,73,203,3,1,298,834,19,225,631,16,15.68421052631579,<=30,ENG,Away,Upto 2014
ST Jayasuriya,SL,Spin,2006-07-27,Colombo (SSC),Sri Lanka,2006,1,76,204,1,1,531,1166,11,455,962,10,48.27272727272727,>30,SL,Home,Upto 2014
ST Jayasuriya,SL,Spin,2006-08-04,Colombo (PSS),Sri Lanka,2006,2,69,84,0,1,476,925,17,407,841,17,28.0,<=30,SL,Home,Upto 2014
ST Jayasuriya,SL,Spin,2006-12-15,Wellington,New Zealand,2006,1,10,36,0,1,311,653,20,301,617,20,15.55,<=30,NZ,Away,Upto 2014
ST Jayasuriya,SL,Spin,2007-11-08,Brisbane,Australia,2007,1,18,24,0,1,370,696,6,352,672,6,61.666666666666664,>30,AUS,Away,Upto 2014
ST Jayasuriya,SL,Spin,2007-11-16,Hobart,Australia,2007,2,30,66,1,1,453,768,6,423,702,5,75.5,>30,AUS,Away,Upto 2014
ST Jayasuriya,SL,Spin,2007-12-01,Kandy,Sri Lanka,2007,2,37,96,1,1,361,894,16,324,798,15,22.5625,<=30,SL,Home,Upto 2014
STR Binny,IND,Pace,2014-07-09,Nottingham,England,2014,1,37,60,0,1,984,1979,23,947,1919,23,42.78260869565217,>30,ENG,Away,After 1965
STR Binny,IND,Pace,2014-07-17,Lord's,England,2014,1,45,60,0,1,890,1823,32,845,1763,32,27.8125,<=30,ENG,Away,After 1965
STR Binny,IND,Pace,2014-08-15,The Oval,England,2014,1,58,72,0,1,613,1107,25,555,1035,25,24.52,<=30,ENG,Away,After 1965
STR Binny,IND,Pace,2015-08-20,Colombo (PSS),Sri Lanka,2015,1,44,108,1,1,525,996,16,481,888,15,32.8125,>30,SL,Away,After 1965
STR Binny,IND,Pace,2015-08-28,Colombo (SSC),Sri Lanka,2015,2,73,132,2,1,606,1122,27,533,990,25,22.444444444444443,<=30,SL,Away,After 1965
STR Binny,IND,Pace,2015-11-14,Bengaluru,India,2015,1,1,18,0,1,150,258,1,149,240,1,150.0,>30,IND,Home,After 1965
SV Bahutule,IND,Spin,2001-03-18,Chennai,India,2001,2,102,180,2,1,924,1783,26,822,1603,24,35.53846153846154,>30,IND,Home,Upto 2014
SV Bahutule,IND,Spin,2001-08-29,Colombo (SSC),Sri Lanka,2001,1,101,186,1,1,579,1257,16,478,1071,15,36.1875,>30,SL,Away,Upto 2014
SV Manjrekar,IND,Spin,1989-04-07,Bridgetown,West Indies,1989,1,7,6,0,1,380,726,8,373,720,8,47.5,>30,WI,Away,Upto 2014
SV Manjrekar,IND,Spin,1991-11-29,Brisbane,Australia,1991,1,4,5,0,1,182,335,1,178,330,1,182.0,>30,AUS,Away,Upto 2014
SV Manjrekar,IND,Spin,1992-11-13,Durban,South Africa,1992,1,4,6,0,1,210,547,7,206,541,7,30.0,<=30,SA,Away,Upto 2014
SV Nayak,IND,Spin,1982-06-24,Manchester,England,1982,1,50,72,0,1,341,811,11,291,739,11,31.0,>30,ENG,Away,Upto 2014
SV Nayak,IND,Spin,1982-07-08,The Oval,England,1982,2,82,159,1,1,576,1184,12,494,1025,11,48.0,>30,ENG,Away,Upto 2014
SV Samuelson,SA,Spin,1910-03-11,Cape Town,South Africa,1910,1,64,108,0,1,488,932,19,424,824,19,25.68421052631579,<=30,SA,Home,Upto 2014
SW Masakadza,ZIM,Pace,2012-01-26,Napier,New Zealand,2012,1,102,138,1,1,497,972,21,395,834,20,23.666666666666668,<=30,NZ,Away,Upto 2014
SW Masakadza,ZIM,Pace,2013-04-17,Harare,Zimbabwe,2013,2,58,145,5,1,550,1165,26,492,1020,21,21.153846153846153,<=30,ZIM,Home,Upto 2014
SW Masakadza,ZIM,Pace,2013-04-25,Harare,Zimbabwe,2013,2,110,246,5,1,755,1568,25,645,1322,20,30.2,>30,ZIM,Home,Upto 2014
SW Masakadza,ZIM,Pace,2013-09-03,Harare,Zimbabwe,2013,2,140,336,3,1,657,1465,18,517,1129,15,36.5,>30,ZIM,Home,Upto 2014
SW Masakadza,ZIM,Pace,2014-11-12,Chattogram,Bangladesh,2014,2,105,192,2,1,456,862,15,351,670,13,30.4,>30,BAN,Away,After 1965
SW Sohoni,IND,Pace,1946-07-20,Manchester,England,1946,1,31,66,0,1,495,1476,27,464,1410,27,18.333333333333332,<=30,ENG,Away,Upto 2014
SW Sohoni,IND,Pace,1946-08-17,The Oval,England,1946,1,2,24,0,1,220,560,7,218,536,7,31.428571428571427,>30,ENG,Away,Upto 2014
SW Sohoni,IND,Pace,1947-11-28,Brisbane,Australia,1947,1,81,184,0,1,345,994,21,264,810,21,16.428571428571427,<=30,AUS,Away,Upto 2014
SW Sohoni,IND,Pace,1951-12-14,Brabourne,India,1951,2,88,258,2,1,609,1495,17,521,1237,15,35.8235294117647,>30,IND,Home,Upto 2014
SW Tait,AUS,Pace,2005-08-25,Nottingham,England,2005,2,121,168,3,1,944,1543,26,823,1375,23,36.30769230769231,>30,ENG,Away,Upto 2014
SW Tait,AUS,Pace,2005-09-08,The Oval,England,2005,2,89,120,2,1,707,1205,18,618,1085,16,39.27777777777778,>30,ENG,Away,Upto 2014
SW Tait,AUS,Pace,2008-01-16,W.A.C.A,Australia,2008,2,92,126,0,1,844,1397,31,752,1271,31,27.225806451612904,<=30,AUS,Home,Upto 2014
Sabbir Rahman,BAN,Spin,2016-10-20,Chattogram,Bangladesh,2016,1,11,18,0,1,760,1579,30,749,1561,30,25.333333333333332,<=30,BAN,Home,After 1965
Sabbir Rahman,BAN,Spin,2016-10-28,Mirpur,Bangladesh,2016,1,12,30,0,1,691,1258,32,679,1228,32,21.59375,<=30,BAN,Home,After 1965
Sabbir Rahman,BAN,Spin,2017-02-09,Hyderabad,India,2017,1,10,18,0,1,881,1634,19,871,1616,19,46.36842105263158,>30,IND,Away,After 1965
Sabbir Rahman,BAN,Spin,2017-09-04,Chattogram,Bangladesh,2017,1,9,6,0,1,709,1537,24,700,1531,24,29.541666666666668,<=30,BAN,Home,After 1965
Sabbir Rahman,BAN,Spin,2017-09-28,Potchefstroom,South Africa,2017,2,40,60,0,1,504,803,10,464,743,10,50.4,>30,SA,Away,After 1965
Sabbir Rahman,BAN,Spin,2017-10-06,Bloemfontein,South Africa,2017,1,16,12,0,1,239,300,1,223,288,1,239.0,>30,SA,Away,After 1965
Sadiq Mohammad,PAK,Spin,1969-10-24,Karachi,Pakistan,1969,1,2,12,0,1,665,1813,26,663,1801,26,25.576923076923077,<=30,PAK,Home,Upto 2014
Sadiq Mohammad,PAK,Spin,1969-11-08,Dhaka,Bangladesh,1969,1,4,12,0,1,498,1577,22,494,1565,22,22.636363636363637,<=30,BAN,Away,Upto 2014
Sadiq Mohammad,PAK,Spin,1971-06-17,Lord's,England,1971,1,17,30,0,1,197,492,2,180,462,2,98.5,>30,ENG,Away,Upto 2014
Sadiq Mohammad,PAK,Spin,1973-02-02,Wellington,New Zealand,1973,1,13,24,0,1,304,776,6,291,752,6,50.666666666666664,>30,NZ,Away,Upto 2014
Sadiq Mohammad,PAK,Spin,1973-02-16,Auckland,New Zealand,1973,1,18,40,0,1,488,1070,18,470,1030,18,27.11111111111111,<=30,NZ,Away,Upto 2014
Sadiq Mohammad,PAK,Spin,1973-03-16,Hyderabad (Sind),Pakistan,1973,2,20,36,0,1,993,2402,21,973,2366,21,47.285714285714285,>30,PAK,Home,Upto 2014
Sadiq Mohammad,PAK,Spin,1976-10-30,Karachi,Pakistan,1976,2,4,16,0,1,499,1183,10,495,1167,10,49.9,>30,PAK,Home,Upto 2014
Sadiq Mohammad,PAK,Spin,1978-10-16,Faisalabad,Pakistan,1978,1,16,24,0,1,700,1410,15,684,1386,15,46.666666666666664,>30,PAK,Home,Upto 2014
Sadiq Mohammad,PAK,Spin,1980-01-15,Chennai,India,1980,1,4,6,0,1,236,570,6,232,564,6,39.333333333333336,>30,IND,Away,Upto 2014
Saeed Ahmed,PAK,Spin,1958-01-17,Bridgetown,West Indies,1958,1,0,12,0,1,679,1898,11,679,1886,11,61.72727272727273,>30,WI,Away,Upto 2014
Saeed Ahmed,PAK,Spin,1958-02-26,Kingston,West Indies,1958,1,24,36,0,1,450,846,3,426,810,3,150.0,>30,WI,Away,Upto 2014
Saeed Ahmed,PAK,Spin,1958-03-13,Georgetown,West Indies,1958,1,1,1,0,1,1032,2327,20,1031,2326,20,51.6,>30,WI,Away,Upto 2014
Saeed Ahmed,PAK,Spin,1959-03-26,Lahore,Pakistan,1959,1,19,66,1,1,360,902,15,341,836,14,24.0,<=30,PAK,Home,Upto 2014
Saeed Ahmed,PAK,Spin,1959-11-13,Dhaka,Bangladesh,1959,1,4,6,0,1,203,699,11,199,693,11,18.454545454545453,<=30,BAN,Away,Upto 2014
Saeed Ahmed,PAK,Spin,1959-12-04,Karachi,Pakistan,1959,1,6,18,0,1,235,677,9,229,659,9,26.11111111111111,<=30,PAK,Home,Upto 2014
Saeed Ahmed,PAK,Spin,1960-12-30,Eden Gardens,India,1960,1,2,6,0,1,295,842,11,293,836,11,26.818181818181817,<=30,IND,Away,Upto 2014
Saeed Ahmed,PAK,Spin,1961-10-21,Lahore,Pakistan,1961,2,28,78,1,1,702,1631,18,674,1553,17,39.0,>30,PAK,Home,Upto 2014
Saeed Ahmed,PAK,Spin,1962-01-19,Dhaka,Bangladesh,1962,2,20,96,0,1,862,2494,25,842,2398,25,34.48,>30,BAN,Away,Upto 2014
Saeed Ahmed,PAK,Spin,1962-02-02,Karachi,Pakistan,1962,1,12,18,0,1,769,2063,17,757,2045,17,45.23529411764706,>30,PAK,Home,Upto 2014
Saeed Ahmed,PAK,Spin,1962-05-31,Birmingham,England,1962,1,22,12,0,1,664,1386,13,642,1374,13,51.07692307692308,>30,ENG,Away,Upto 2014
Saeed Ahmed,PAK,Spin,1962-06-21,Lord's,England,1962,2,33,42,2,1,359,496,6,326,454,4,59.833333333333336,>30,ENG,Away,Upto 2014
Saeed Ahmed,PAK,Spin,1962-07-26,Nottingham,England,1962,1,5,12,0,1,232,572,3,227,560,3,77.33333333333333,>30,ENG,Away,Upto 2014
Saeed Ahmed,PAK,Spin,1962-08-16,The Oval,England,1962,1,1,6,0,1,452,1071,6,451,1065,6,75.33333333333333,>30,ENG,Away,Upto 2014
Saeed Ahmed,PAK,Spin,1964-10-24,Karachi,Pakistan,1964,2,69,192,3,1,840,2130,18,771,1938,15,46.666666666666664,>30,PAK,Home,Upto 2014
Saeed Ahmed,PAK,Spin,1964-12-04,Melbourne,Australia,1964,1,31,80,1,1,473,1030,6,442,950,5,78.83333333333333,>30,AUS,Away,Upto 2014
Saeed Ahmed,PAK,Spin,1965-01-22,Wellington,New Zealand,1965,2,40,102,1,1,356,1080,8,316,978,7,44.5,>30,NZ,Away,Upto 2014
Saeed Ahmed,PAK,Spin,1965-01-29,Auckland,New Zealand,1965,2,29,114,2,1,450,1734,24,421,1620,22,18.75,<=30,NZ,Away,Upto 2014
Saeed Ahmed,PAK,Spin,1965-02-12,Christchurch,New Zealand,1965,2,26,66,0,1,466,1098,16,440,1032,16,29.125,<=30,NZ,Away,Upto 2014
Saeed Ahmed,PAK,Spin,1965-04-02,Lahore,Pakistan,1965,1,1,6,0,1,697,1836,15,696,1830,15,46.46666666666667,>30,PAK,Home,Upto 2014
Saeed Ahmed,PAK,Spin,1965-04-09,Karachi,Pakistan,1965,1,29,60,1,1,606,1528,19,577,1468,18,31.894736842105264,>30,PAK,Home,Upto 2014
Saeed Ahmed,PAK,Spin,1967-07-27,Lord's,England,1967,1,29,66,0,1,583,1689,19,554,1623,19,30.68421052631579,>30,ENG,Away,Upto 2014
Saeed Ahmed,PAK,Spin,1967-08-10,Nottingham,England,1967,2,0,18,0,1,240,772,12,240,754,12,20.0,<=30,ENG,Away,Upto 2014
Saeed Ahmed,PAK,Spin,1967-08-24,The Oval,England,1967,2,76,138,0,1,475,1075,13,399,937,13,36.53846153846154,>30,ENG,Away,Upto 2014
Saeed Ahmed,PAK,Spin,1969-02-21,Lahore,Pakistan,1969,2,108,215,6,1,546,1362,17,438,1147,11,32.11764705882353,>30,PAK,Home,Upto 2014
Saeed Ahmed,PAK,Spin,1969-02-28,Dhaka,Bangladesh,1969,2,63,244,3,1,397,1246,15,334,1002,12,26.466666666666665,<=30,BAN,Away,Upto 2014
Saeed Ahmed,PAK,Spin,1969-03-06,Karachi,Pakistan,1969,1,53,132,0,1,302,679,5,249,547,5,60.4,>30,PAK,Home,Upto 2014
Saeed Ahmed,PAK,Spin,1971-07-08,Leeds,England,1971,2,43,114,1,1,601,1757,16,558,1643,15,37.5625,>30,ENG,Away,Upto 2014
Saeed Ahmed,PAK,Spin,1972-12-22,Adelaide,Australia,1972,1,28,24,0,1,497,880,15,469,856,15,33.13333333333333,>30,AUS,Away,Upto 2014
Saeed Ajmal,PAK,Spin,2009-07-04,Galle,Sri Lanka,2009,2,113,214,5,1,354,709,16,241,495,11,22.125,<=30,SL,Away,Upto 2014
Saeed Ajmal,PAK,Spin,2009-07-12,Colombo (PSS),Sri Lanka,2009,2,143,258,5,1,425,767,15,282,509,10,28.333333333333332,<=30,SL,Away,Upto 2014
Saeed Ajmal,PAK,Spin,2009-07-20,Colombo (SSC),Sri Lanka,2009,2,165,408,4,1,647,1311,18,482,903,14,35.94444444444444,>30,SL,Away,Upto 2014
Saeed Ajmal,PAK,Spin,2009-11-24,Dunedin,New Zealand,2009,2,117,329,2,1,232,575,6,115,246,4,38.666666666666664,>30,NZ,Away,Upto 2014
Saeed Ajmal,PAK,Spin,2009-12-26,Melbourne,Australia,2009,2,223,415,2,1,412,721,8,189,306,6,51.5,>30,AUS,Away,Upto 2014
Saeed Ajmal,PAK,Spin,2010-08-06,Birmingham,England,2010,2,124,244,5,1,211,502,11,87,258,6,19.181818181818183,<=30,ENG,Away,Upto 2014
Saeed Ajmal,PAK,Spin,2010-08-18,The Oval,England,2010,2,103,243,5,1,230,537,12,127,294,7,19.166666666666668,<=30,ENG,Away,Upto 2014
Saeed Ajmal,PAK,Spin,2010-08-26,Lord's,England,2010,1,126,264,2,1,226,461,11,100,197,9,20.545454545454547,<=30,ENG,Away,Upto 2014
Saeed Ajmal,PAK,Spin,2010-11-12,Dubai (DICS),UAE,2010,2,197,372,3,1,753,1614,13,556,1242,10,57.92307692307692,>30,UAE,Away,Upto 2014
Saeed Ajmal,PAK,Spin,2011-05-12,Providence,West Indies,2011,2,111,341,11,1,348,989,21,237,648,10,16.571428571428573,<=30,WI,Away,Upto 2014
Saeed Ajmal,PAK,Spin,2011-05-20,Basseterre,West Indies,2011,2,135,359,6,1,530,1213,20,395,854,14,26.5,<=30,WI,Away,Upto 2014
Saeed Ajmal,PAK,Spin,2011-09-01,Bulawayo,Zimbabwe,2011,2,196,456,6,1,525,1193,17,329,737,11,30.88235294117647,>30,ZIM,Away,Upto 2014
Saeed Ajmal,PAK,Spin,2011-10-18,Abu Dhabi,UAE,2011,2,223,480,3,1,499,1258,7,276,778,4,71.28571428571429,>30,UAE,Away,Upto 2014
Saeed Ajmal,PAK,Spin,2011-10-26,Dubai (DICS),UAE,2011,2,113,341,8,1,466,1189,19,353,848,11,24.526315789473685,<=30,UAE,Away,Upto 2014
Saeed Ajmal,PAK,Spin,2011-11-03,Sharjah,UAE,2011,2,182,402,7,1,589,1524,15,407,1122,8,39.266666666666666,>30,UAE,Away,Upto 2014
Saeed Ajmal,PAK,Spin,2011-12-09,Chattogram,Bangladesh,2011,2,114,258,5,1,717,1447,18,603,1189,13,39.833333333333336,>30,BAN,Away,Upto 2014
Saeed Ajmal,PAK,Spin,2011-12-17,Mirpur,Bangladesh,2011,2,119,285,4,1,690,1381,17,571,1096,13,40.588235294117645,>30,BAN,Away,Upto 2014
Saeed Ajmal,PAK,Spin,2012-01-17,Dubai (DICS),UAE,2012,2,97,252,10,1,302,659,19,205,407,9,15.894736842105264,<=30,UAE,Away,Upto 2014
Saeed Ajmal,PAK,Spin,2012-01-25,Abu Dhabi,UAE,2012,2,130,330,7,1,558,1443,31,428,1113,24,18.0,<=30,UAE,Away,Upto 2014
Saeed Ajmal,PAK,Spin,2012-02-03,Dubai (DICS),UAE,2012,2,126,300,7,1,528,1381,25,402,1081,18,21.12,<=30,UAE,Away,Upto 2014
Saeed Ajmal,PAK,Spin,2012-06-22,Galle,Sri Lanka,2012,2,193,378,7,1,621,1409,23,428,1031,16,27.0,<=30,SL,Away,Upto 2014
Saeed Ajmal,PAK,Spin,2012-06-30,Colombo (SSC),Sri Lanka,2012,2,140,246,2,1,609,1048,13,469,802,11,46.84615384615385,>30,SL,Away,Upto 2014
Saeed Ajmal,PAK,Spin,2012-07-08,Pallekele,Sri Lanka,2012,2,116,306,6,1,298,765,13,182,459,7,22.923076923076923,<=30,SL,Away,Upto 2014
Saeed Ajmal,PAK,Spin,2013-02-01,Johannesburg,South Africa,2013,2,142,246,1,1,230,410,6,88,164,5,38.333333333333336,>30,SA,Away,Upto 2014
Saeed Ajmal,PAK,Spin,2013-02-14,Cape Town,South Africa,2013,2,147,361,10,1,363,754,16,216,393,6,22.6875,<=30,SA,Away,Upto 2014
Saeed Ajmal,PAK,Spin,2013-02-22,Centurion,South Africa,2013,1,76,174,0,1,179,318,2,103,144,2,89.5,>30,SA,Away,Upto 2014
Saeed Ajmal,PAK,Spin,2013-09-03,Harare,Zimbabwe,2013,2,118,295,11,1,421,874,20,303,579,9,21.05,<=30,ZIM,Away,Upto 2014
Saeed Ajmal,PAK,Spin,2013-09-10,Harare,Zimbabwe,2013,2,148,294,3,1,357,809,10,209,515,7,35.7,>30,ZIM,Away,Upto 2014
Saeed Ajmal,PAK,Spin,2013-10-14,Abu Dhabi,UAE,2013,2,133,371,6,1,474,946,13,341,575,7,36.46153846153846,>30,UAE,Away,Upto 2014
Saeed Ajmal,PAK,Spin,2013-10-23,Dubai (DICS),UAE,2013,1,151,335,6,1,497,1052,19,346,717,13,26.157894736842106,<=30,UAE,Away,Upto 2014
Saeed Ajmal,PAK,Spin,2013-12-31,Abu Dhabi,UAE,2013,2,147,378,2,1,396,907,6,249,529,4,66.0,>30,UAE,Away,Upto 2014
Saeed Ajmal,PAK,Spin,2014-01-08,Dubai (DICS),UAE,2014,2,101,308,3,1,299,751,9,198,443,6,33.22222222222222,>30,UAE,Away,After 1965
Saeed Ajmal,PAK,Spin,2014-01-16,Sharjah,UAE,2014,2,173,484,5,1,637,1445,16,464,961,11,39.8125,>30,UAE,Away,After 1965
Saeed Ajmal,PAK,Spin,2014-08-06,Galle,Sri Lanka,2014,2,195,391,5,1,717,1430,22,522,1039,17,32.59090909090909,>30,SL,Away,After 1965
Saeed Ajmal,PAK,Spin,2014-08-14,Colombo (SSC),Sri Lanka,2014,2,166,474,4,1,617,1331,23,451,857,19,26.82608695652174,<=30,SL,Away,After 1965
Saeed Anwar,PAK,Spin,1994-02-24,Christchurch,New Zealand,1994,1,4,6,0,1,187,378,5,183,372,5,37.4,>30,NZ,Away,Upto 2014
Saeed Anwar,PAK,Spin,1994-10-05,Rawalpindi,Pakistan,1994,1,0,12,0,1,440,796,6,440,784,6,73.33333333333333,>30,PAK,Home,Upto 2014
Saeed Anwar,PAK,Spin,1998-03-14,Bulawayo,Zimbabwe,1998,2,19,30,0,1,364,712,5,345,682,5,72.8,>30,ZIM,Away,Upto 2014
Saif Hassan,BAN,Spin,2021-04-21,Pallekele,Sri Lanka,2021,1,5,12,0,1,649,1170,4,644,1158,4,162.25,>30,SL,Away,After 1965
Saif Hassan,BAN,Spin,2021-04-29,Pallekele,Sri Lanka,2021,1,22,24,1,1,753,1454,28,731,1430,27,26.892857142857142,<=30,SL,Away,After 1965
Saim Ayub,PAK,Spin,2024-08-21,Rawalpindi,Pakistan,2024,1,34,42,1,1,433,770,10,399,728,9,43.3,>30,PAK,Home,After 1965
Saim Ayub,PAK,Spin,2024-10-07,Multan,Pakistan,2024,1,101,84,2,1,918,1193,16,817,1109,14,57.375,>30,PAK,Home,After 1965
Saim Ayub,PAK,Spin,2024-10-24,Rawalpindi,Pakistan,2024,1,0,6,0,1,719,1161,29,719,1155,29,24.79310344827586,<=30,PAK,Home,After 1965
Saim Ayub,PAK,Spin,2024-12-26,Centurion,South Africa,2024,1,3,16,1,1,120,176,6,117,160,5,20.0,<=30,SA,Away,After 1965
Sajedul Islam,BAN,Pace,2008-01-04,Dunedin,New Zealand,2008,2,84,132,2,1,478,890,22,394,758,20,21.727272727272727,<=30,NZ,Away,Upto 2014
Sajedul Islam,BAN,Pace,2008-01-12,Wellington,New Zealand,2008,1,91,84,1,1,450,866,22,359,782,21,20.454545454545453,<=30,NZ,Away,Upto 2014
Sajedul Islam,BAN,Pace,2013-04-25,Harare,Zimbabwe,2013,2,57,114,0,1,755,1568,25,698,1454,25,30.2,>30,ZIM,Away,Upto 2014
Sajid Khan,PAK,Spin,2021-04-29,Harare,Zimbabwe,2021,2,44,90,0,1,256,510,4,212,420,4,64.0,>30,ZIM,Away,After 1965
Sajid Khan,PAK,Spin,2021-05-07,Harare,Zimbabwe,2021,2,71,112,2,1,364,605,9,293,493,7,40.44444444444444,>30,ZIM,Away,After 1965
Sajid Khan,PAK,Spin,2021-11-26,Chattogram,Bangladesh,2021,2,112,242,4,1,541,1197,14,429,955,10,38.642857142857146,>30,BAN,Away,After 1965
Sajid Khan,PAK,Spin,2021-12-04,Mirpur,Bangladesh,2021,2,128,286,12,1,366,844,15,238,558,3,24.4,<=30,BAN,Away,After 1965
Sajid Khan,PAK,Spin,2022-03-04,Rawalpindi,Pakistan,2022,1,122,270,1,1,676,1285,9,554,1015,8,75.11111111111111,>30,PAK,Home,After 1965
Sajid Khan,PAK,Spin,2022-03-12,Karachi,Pakistan,2022,2,198,372,2,1,673,1474,11,475,1102,9,61.18181818181818,>30,PAK,Home,After 1965
Sajid Khan,PAK,Spin,2022-03-21,Lahore,Pakistan,2022,2,157,294,1,1,557,1146,9,400,852,8,61.888888888888886,>30,PAK,Home,After 1965
Sajid Khan,PAK,Spin,2024-01-03,Sydney,Australia,2024,2,122,222,3,1,332,638,10,210,416,7,33.2,>30,AUS,Away,After 1965
Sajid Khan,PAK,Spin,2024-10-15,Multan,Pakistan,2024,2,204,260,9,1,831,1418,37,627,1158,28,22.45945945945946,<=30,PAK,Home,After 1965
Sajid Khan,PAK,Spin,2024-10-24,Rawalpindi,Pakistan,2024,2,197,284,10,1,719,1161,29,522,877,19,24.79310344827586,<=30,PAK,Home,After 1965
Sajid Khan,PAK,Spin,2025-01-17,Multan,Pakistan,2025,2,115,162,9,1,519,896,34,404,734,25,15.264705882352942,<=30,PAK,Home,After 1965
Sajid Khan,PAK,Spin,2025-01-25,Multan,Pakistan,2025,2,140,229,6,1,637,1154,37,497,925,31,17.216216216216218,<=30,PAK,Home,After 1965
Salahuddin,PAK,Spin,1965-03-27,Rawalpindi,Pakistan,1965,2,52,156,3,1,362,890,18,310,734,15,20.11111111111111,<=30,PAK,Home,Upto 2014
Salahuddin,PAK,Spin,1965-04-02,Lahore,Pakistan,1965,1,76,198,1,1,697,1836,15,621,1638,14,46.46666666666667,>30,PAK,Home,Upto 2014
Salahuddin,PAK,Spin,1965-04-09,Karachi,Pakistan,1965,2,59,192,3,1,606,1528,19,547,1336,16,31.894736842105264,>30,PAK,Home,Upto 2014
Saleem Altaf,PAK,Pace,1967-07-27,Lord's,England,1967,2,78,201,3,1,434,1150,13,356,949,10,33.38461538461539,>30,ENG,Away,Upto 2014
Saleem Altaf,PAK,Pace,1967-08-24,The Oval,England,1967,2,102,252,1,1,449,1200,19,347,948,18,23.63157894736842,<=30,ENG,Away,Upto 2014
Saleem Altaf,PAK,Pace,1969-10-30,Lahore,Pakistan,1969,2,45,126,3,1,161,587,12,116,461,9,13.416666666666666,<=30,PAK,Home,Upto 2014
Saleem Altaf,PAK,Pace,1969-11-08,Dhaka,Bangladesh,1969,2,45,183,2,1,262,729,8,217,546,6,32.75,>30,BAN,Away,Upto 2014
Saleem Altaf,PAK,Pace,1971-06-17,Lord's,England,1971,2,53,144,1,1,276,712,9,223,568,8,30.666666666666668,>30,ENG,Away,Upto 2014
Saleem Altaf,PAK,Pace,1971-07-08,Leeds,England,1971,2,57,208,5,1,442,1309,24,385,1101,19,18.416666666666668,<=30,ENG,Away,Upto 2014
Saleem Altaf,PAK,Pace,1972-12-22,Adelaide,Australia,1972,1,83,200,2,1,517,1131,14,434,931,12,36.92857142857143,>30,AUS,Away,Upto 2014
Saleem Altaf,PAK,Pace,1972-12-29,Melbourne,Australia,1972,2,99,184,2,1,925,1467,16,826,1283,14,57.8125,>30,AUS,Away,Upto 2014
Saleem Altaf,PAK,Pace,1973-01-06,Sydney,Australia,1973,2,131,333,7,1,767,1875,36,636,1542,29,21.305555555555557,<=30,AUS,Away,Upto 2014
Saleem Altaf,PAK,Pace,1973-02-02,Wellington,New Zealand,1973,2,85,180,5,1,687,1320,19,602,1140,14,36.1578947368421,>30,NZ,Away,Upto 2014
Saleem Altaf,PAK,Pace,1973-02-07,Dunedin,New Zealand,1973,2,34,72,0,1,333,648,6,299,576,6,55.5,>30,NZ,Away,Upto 2014
Saleem Altaf,PAK,Pace,1973-02-16,Auckland,New Zealand,1973,2,75,192,0,1,643,1420,15,568,1228,15,42.86666666666667,>30,NZ,Away,Upto 2014
Saleem Altaf,PAK,Pace,1973-03-02,Lahore,Pakistan,1973,2,104,234,3,1,401,966,6,297,732,3,66.83333333333333,>30,PAK,Home,Upto 2014
Saleem Altaf,PAK,Pace,1973-03-16,Hyderabad (Sind),Pakistan,1973,2,103,234,2,1,221,462,4,118,228,2,55.25,>30,PAK,Home,Upto 2014
Saleem Altaf,PAK,Pace,1973-03-24,Karachi,Pakistan,1973,2,54,120,1,1,291,630,3,237,510,2,97.0,>30,PAK,Home,Upto 2014
Saleem Altaf,PAK,Pace,1976-12-24,Adelaide,Australia,1976,1,71,120,0,1,783,1646,15,712,1526,15,52.2,>30,AUS,Away,Upto 2014
Saleem Altaf,PAK,Pace,1977-01-01,Melbourne,Australia,1977,2,145,184,0,1,882,1510,22,737,1326,22,40.09090909090909,>30,AUS,Away,Upto 2014
Saleem Altaf,PAK,Pace,1977-02-18,Bridgetown,West Indies,1977,2,103,252,5,1,1045,1954,34,942,1702,29,30.735294117647058,>30,WI,Away,Upto 2014
Saleem Altaf,PAK,Pace,1977-03-04,Port of Spain,West Indies,1977,2,102,234,2,1,520,1242,24,418,1008,22,21.666666666666668,<=30,WI,Away,Upto 2014
Saleem Altaf,PAK,Pace,1977-03-18,Georgetown,West Indies,1977,1,71,174,1,1,1085,2006,25,1014,1832,24,43.4,>30,WI,Away,Upto 2014
Saleem Altaf,PAK,Pace,1978-10-27,Lahore,Pakistan,1978,2,70,174,1,1,667,1298,21,597,1124,20,31.761904761904763,>30,PAK,Home,Upto 2014
Saleem Jaffar,PAK,Pace,1986-11-20,Karachi,Pakistan,1986,2,57,174,2,1,343,1168,21,286,994,19,16.333333333333332,<=30,PAK,Home,Upto 2014
Saleem Jaffar,PAK,Pace,1987-02-11,Eden Gardens,India,1987,2,148,258,2,1,698,1442,20,550,1184,18,34.9,>30,IND,Away,Upto 2014
Saleem Jaffar,PAK,Pace,1987-12-16,Karachi,Pakistan,1987,2,153,395,5,1,422,869,15,269,474,10,28.133333333333333,<=30,PAK,Home,Upto 2014
Saleem Jaffar,PAK,Pace,1988-04-22,Bridgetown,West Indies,1988,2,60,72,1,1,833,1467,30,773,1395,29,27.766666666666666,<=30,WI,Away,Upto 2014
Saleem Jaffar,PAK,Pace,1988-09-23,Faisalabad,Pakistan,1988,2,77,186,2,1,528,1164,17,451,978,15,31.058823529411764,>30,PAK,Home,Upto 2014
Saleem Jaffar,PAK,Pace,1988-10-07,Lahore,Pakistan,1988,2,142,282,3,1,344,894,11,202,612,8,31.272727272727273,>30,PAK,Home,Upto 2014
Saleem Jaffar,PAK,Pace,1989-02-10,Wellington,New Zealand,1989,2,134,306,8,1,750,1984,22,616,1678,14,34.09090909090909,>30,NZ,Away,Upto 2014
Saleem Jaffar,PAK,Pace,1989-02-24,Auckland,New Zealand,1989,2,62,156,1,1,397,1018,6,335,862,5,66.16666666666667,>30,NZ,Away,Upto 2014
Saleem Jaffar,PAK,Pace,1989-11-23,Faisalabad,Pakistan,1989,1,54,102,1,1,850,1756,23,796,1654,22,36.95652173913044,>30,PAK,Home,Upto 2014
Saleem Jaffar,PAK,Pace,1990-10-18,Lahore,Pakistan,1990,2,99,222,4,1,697,1583,26,598,1361,22,26.807692307692307,<=30,PAK,Home,Upto 2014
Saleem Jaffar,PAK,Pace,1990-10-26,Faisalabad,Pakistan,1990,2,98,228,4,1,725,1761,39,627,1533,35,18.58974358974359,<=30,PAK,Home,Upto 2014
Saleem Jaffar,PAK,Pace,1992-01-02,Faisalabad,Pakistan,1992,2,55,150,3,1,743,1706,36,688,1556,33,20.63888888888889,<=30,PAK,Home,Upto 2014
Saleem Malik,PAK,Spin,1983-10-05,Nagpur,India,1983,1,7,18,1,1,396,1114,18,389,1096,17,22.0,<=30,IND,Away,Upto 2014
Saleem Malik,PAK,Spin,1983-12-09,Adelaide,Australia,1983,1,3,6,1,1,433,870,5,430,864,4,86.6,>30,AUS,Away,Upto 2014
Saleem Malik,PAK,Spin,1983-12-26,Melbourne,Australia,1983,1,10,12,0,1,391,853,9,381,841,9,43.44444444444444,>30,AUS,Away,Upto 2014
Saleem Malik,PAK,Spin,1984-10-17,Lahore,Pakistan,1984,1,6,30,1,1,362,1073,9,356,1043,8,40.22222222222222,>30,PAK,Home,Upto 2014
Saleem Malik,PAK,Spin,1984-10-24,Faisalabad,Pakistan,1984,1,1,6,0,1,475,1147,7,474,1141,7,67.85714285714286,>30,PAK,Home,Upto 2014
Saleem Malik,PAK,Spin,1985-01-25,Auckland,New Zealand,1985,1,34,50,0,1,99,212,2,65,162,2,49.5,>30,NZ,Away,Upto 2014
Saleem Malik,PAK,Spin,1986-03-14,Colombo (CCC),Sri Lanka,1986,1,2,6,0,1,54,96,0,52,90,0,inf,>30,SL,Away,Upto 2014
Saleem Malik,PAK,Spin,1986-03-22,Colombo (PSS),Sri Lanka,1986,1,0,6,0,1,135,371,2,135,365,2,67.5,>30,SL,Away,Upto 2014
Saleem Malik,PAK,Spin,1987-12-16,Karachi,Pakistan,1987,2,23,72,1,1,450,1486,13,427,1414,12,34.61538461538461,>30,PAK,Home,Upto 2014
Saleem Malik,PAK,Spin,1988-04-02,Georgetown,West Indies,1988,1,6,6,0,1,306,558,9,300,552,9,34.0,>30,WI,Away,Upto 2014
Saleem Malik,PAK,Spin,1988-09-15,Karachi,Pakistan,1988,1,7,36,1,1,427,1461,22,420,1425,21,19.40909090909091,<=30,PAK,Home,Upto 2014
Saleem Malik,PAK,Spin,1989-12-01,Lahore,Pakistan,1989,1,2,6,0,1,665,1174,7,663,1168,7,95.0,>30,PAK,Home,Upto 2014
Saleem Malik,PAK,Spin,1990-11-15,Karachi,Pakistan,1990,1,5,6,0,1,289,648,5,284,642,5,57.8,>30,PAK,Home,Upto 2014
Saleem Malik,PAK,Spin,1991-12-12,Sialkot,Pakistan,1991,1,7,6,0,1,197,606,6,190,600,6,32.833333333333336,>30,PAK,Home,Upto 2014
Saleem Malik,PAK,Spin,1992-06-04,Birmingham,England,1992,1,5,6,0,1,247,450,2,242,444,2,123.5,>30,ENG,Away,Upto 2014
Saleem Malik,PAK,Spin,1994-02-17,Wellington,New Zealand,1994,1,13,12,0,1,228,416,2,215,404,2,114.0,>30,NZ,Away,Upto 2014
Saleem Malik,PAK,Spin,1994-02-24,Christchurch,New Zealand,1994,1,13,24,0,1,187,378,5,174,354,5,37.4,>30,NZ,Away,Upto 2014
Saleem Malik,PAK,Spin,1994-09-28,Karachi,Pakistan,1994,1,7,6,0,1,538,1117,15,531,1111,15,35.86666666666667,>30,PAK,Home,Upto 2014
Saleem Malik,PAK,Spin,1994-10-05,Rawalpindi,Pakistan,1994,1,4,6,0,1,440,796,6,436,790,6,73.33333333333333,>30,PAK,Home,Upto 2014
Saleem Malik,PAK,Spin,1995-01-19,Johannesburg,South Africa,1995,1,49,48,0,1,146,290,3,97,242,3,48.666666666666664,>30,SA,Away,Upto 2014
Saleem Malik,PAK,Spin,1995-01-31,Harare,Zimbabwe,1995,1,42,54,0,1,301,564,1,259,510,1,301.0,>30,ZIM,Away,Upto 2014
Saleem Malik,PAK,Spin,1996-07-25,Lord's,England,1996,1,1,6,0,1,309,758,8,308,752,8,38.625,>30,ENG,Away,Upto 2014
Saleem Malik,PAK,Spin,1996-10-17,Sheikhupura,Pakistan,1996,1,12,30,0,1,616,1340,14,604,1310,14,44.0,>30,PAK,Home,Upto 2014
Saleem Malik,PAK,Spin,1996-10-24,Faisalabad,Pakistan,1996,1,7,12,0,1,168,373,4,161,361,4,42.0,>30,PAK,Home,Upto 2014
Saleem Malik,PAK,Spin,1996-11-28,Rawalpindi,Pakistan,1996,2,22,24,0,1,194,426,8,172,402,8,24.25,<=30,PAK,Home,Upto 2014
Saleem Malik,PAK,Spin,1997-04-26,Colombo (SSC),Sri Lanka,1997,1,33,54,0,1,882,1775,14,849,1721,14,63.0,>30,SL,Away,Upto 2014
Saleem Malik,PAK,Spin,1998-10-15,Peshawar,Pakistan,1998,2,93,186,0,1,751,1422,7,658,1236,7,107.28571428571429,>30,PAK,Home,Upto 2014
Salman Butt,PAK,Spin,2006-08-04,Leeds,England,2006,1,18,24,0,1,443,837,10,425,813,10,44.3,>30,ENG,Away,Upto 2014
Salman Butt,PAK,Spin,2007-11-30,Eden Gardens,India,2007,2,41,47,1,1,851,1606,18,810,1559,17,47.27777777777778,>30,IND,Away,Upto 2014
Salman Butt,PAK,Spin,2007-12-08,Bengaluru,India,2007,1,36,60,0,1,712,1214,14,676,1154,14,50.857142857142854,>30,IND,Away,Upto 2014
Salman Butt,PAK,Spin,2009-02-21,Karachi,Pakistan,2009,1,11,6,0,1,883,1568,9,872,1562,9,98.11111111111111,>30,PAK,Home,Upto 2014
Sanuar Hossain,BAN,Spin,2002-10-18,East London,South Africa,2002,1,9,18,1,1,247,486,3,238,468,2,82.33333333333333,>30,SA,Away,Upto 2014
Sanuar Hossain,BAN,Spin,2002-10-25,Potchefstroom,South Africa,2002,1,98,120,1,1,189,281,2,91,161,1,94.5,>30,SA,Away,Upto 2014
Sanuar Hossain,BAN,Spin,2002-12-16,Chattogram,Bangladesh,2002,1,29,42,1,1,127,195,2,98,153,1,63.5,>30,BAN,Home,Upto 2014
Sanuar Hossain,BAN,Spin,2003-07-25,Cairns,Australia,2003,1,128,180,2,1,356,572,12,228,392,10,29.666666666666668,<=30,AUS,Away,Upto 2014
Sanuar Hossain,BAN,Spin,2003-08-20,Karachi,Pakistan,2003,2,46,84,0,1,435,1074,13,389,990,13,33.46153846153846,>30,PAK,Away,Upto 2014
Saqlain Mushtaq,PAK,Spin,1995-09-08,Peshawar,Pakistan,1995,2,107,264,4,1,297,708,12,190,444,8,24.75,<=30,PAK,Home,Upto 2014
Saqlain Mushtaq,PAK,Spin,1995-09-15,Faisalabad,Pakistan,1995,2,158,336,5,1,624,1381,17,466,1045,12,36.705882352941174,>30,PAK,Home,Upto 2014
Saqlain Mushtaq,PAK,Spin,1995-11-09,Brisbane,Australia,1995,1,130,264,2,1,256,659,16,126,395,14,16.0,<=30,AUS,Away,Upto 2014
Saqlain Mushtaq,PAK,Spin,1995-11-30,Sydney,Australia,1995,2,97,210,2,1,467,1214,20,370,1004,18,23.35,<=30,AUS,Away,Upto 2014
Saqlain Mushtaq,PAK,Spin,1996-10-17,Sheikhupura,Pakistan,1996,2,202,462,7,1,616,1340,14,414,878,7,44.0,>30,PAK,Home,Upto 2014
Saqlain Mushtaq,PAK,Spin,1996-10-24,Faisalabad,Pakistan,1996,2,62,132,1,1,168,373,4,106,241,3,42.0,>30,PAK,Home,Upto 2014
Saqlain Mushtaq,PAK,Spin,1996-11-21,Lahore,Pakistan,1996,2,119,206,3,1,322,664,17,203,458,14,18.941176470588236,<=30,PAK,Home,Upto 2014
Saqlain Mushtaq,PAK,Spin,1997-04-19,Colombo (RPS),Sri Lanka,1997,2,226,644,9,1,757,2006,23,531,1362,14,32.91304347826087,>30,SL,Away,Upto 2014
Saqlain Mushtaq,PAK,Spin,1997-04-26,Colombo (SSC),Sri Lanka,1997,2,286,527,5,1,882,1775,14,596,1248,9,63.0,>30,SL,Away,Upto 2014
Saqlain Mushtaq,PAK,Spin,1997-10-06,Rawalpindi,Pakistan,1997,1,129,372,5,1,443,1103,12,314,731,7,36.916666666666664,>30,PAK,Home,Upto 2014
Saqlain Mushtaq,PAK,Spin,1997-10-17,Sheikhupura,Pakistan,1997,1,120,192,1,1,314,555,8,194,363,7,39.25,>30,PAK,Home,Upto 2014
Saqlain Mushtaq,PAK,Spin,1997-10-24,Faisalabad,Pakistan,1997,2,73,150,3,1,337,693,15,264,543,12,22.466666666666665,<=30,PAK,Home,Upto 2014
Saqlain Mushtaq,PAK,Spin,1997-12-06,Karachi,Pakistan,1997,2,80,258,9,1,300,618,11,220,360,2,27.272727272727273,<=30,PAK,Home,Upto 2014
Saqlain Mushtaq,PAK,Spin,1998-02-14,Johannesburg,South Africa,1998,1,47,74,2,1,141,272,5,94,198,3,28.2,<=30,SA,Away,Upto 2014
Saqlain Mushtaq,PAK,Spin,1998-03-14,Bulawayo,Zimbabwe,1998,2,123,207,0,1,364,712,5,241,505,5,72.8,>30,ZIM,Away,Upto 2014
Saqlain Mushtaq,PAK,Spin,1998-10-01,Rawalpindi,Pakistan,1998,1,112,251,2,1,561,1319,19,449,1068,17,29.526315789473685,<=30,PAK,Home,Upto 2014
Saqlain Mushtaq,PAK,Spin,1998-12-10,Lahore,Pakistan,1998,2,37,89,5,1,77,131,7,40,42,2,11.0,<=30,PAK,Home,Upto 2014
Saqlain Mushtaq,PAK,Spin,1999-01-28,Chennai,India,1999,2,187,404,10,1,572,1226,24,385,822,14,23.833333333333332,<=30,IND,Away,Upto 2014
Saqlain Mushtaq,PAK,Spin,1999-02-04,Delhi,India,1999,2,216,495,10,1,634,1395,31,418,900,21,20.451612903225808,<=30,IND,Away,Upto 2014
Saqlain Mushtaq,PAK,Spin,1999-02-16,Eden Gardens,India,1999,2,100,228,4,1,375,758,8,275,530,4,46.875,>30,IND,Away,Upto 2014
Saqlain Mushtaq,PAK,Spin,1999-03-04,Lahore,Pakistan,1999,2,135,277,4,1,525,960,12,390,683,8,43.75,>30,PAK,Home,Upto 2014
Saqlain Mushtaq,PAK,Spin,1999-03-12,Dhaka,Bangladesh,1999,2,122,347,4,1,550,1176,20,428,829,16,27.5,<=30,BAN,Away,Upto 2014
Saqlain Mushtaq,PAK,Spin,1999-11-18,Hobart,Australia,1999,2,176,413,8,1,337,796,16,161,383,8,21.0625,<=30,AUS,Away,Upto 2014
Saqlain Mushtaq,PAK,Spin,1999-11-26,W.A.C.A,Australia,1999,1,75,156,2,1,137,252,3,62,96,1,45.666666666666664,>30,AUS,Away,Upto 2014
Saqlain Mushtaq,PAK,Spin,2000-02-26,Rawalpindi,Pakistan,2000,2,152,402,3,1,401,1058,12,249,656,9,33.416666666666664,>30,PAK,Home,Upto 2014
Saqlain Mushtaq,PAK,Spin,2000-05-05,Georgetown,West Indies,2000,1,24,60,0,1,162,360,3,138,300,3,54.0,>30,WI,Away,Upto 2014
Saqlain Mushtaq,PAK,Spin,2000-05-18,Bridgetown,West Indies,2000,2,149,432,5,1,391,966,10,242,534,5,39.1,>30,WI,Away,Upto 2014
Saqlain Mushtaq,PAK,Spin,2000-05-25,St John's,West Indies,2000,2,86,270,1,1,289,648,4,203,378,3,72.25,>30,WI,Away,Upto 2014
Saqlain Mushtaq,PAK,Spin,2000-11-15,Lahore,Pakistan,2000,2,178,504,9,1,697,1762,20,519,1258,11,34.85,>30,PAK,Home,Upto 2014
Saqlain Mushtaq,PAK,Spin,2000-11-29,Faisalabad,Pakistan,2000,2,88,298,4,1,641,1582,20,553,1284,16,32.05,>30,PAK,Home,Upto 2014
Saqlain Mushtaq,PAK,Spin,2000-12-07,Karachi,Pakistan,2000,2,165,418,5,1,624,1582,18,459,1164,13,34.666666666666664,>30,PAK,Home,Upto 2014
Saqlain Mushtaq,PAK,Spin,2001-03-08,Auckland,New Zealand,2001,2,72,274,8,1,297,718,10,225,444,2,29.7,<=30,NZ,Away,Upto 2014
Saqlain Mushtaq,PAK,Spin,2001-03-15,Christchurch,New Zealand,2001,2,178,432,3,1,390,912,6,212,480,3,65.0,>30,NZ,Away,Upto 2014
Saqlain Mushtaq,PAK,Spin,2001-03-27,Hamilton,New Zealand,2001,1,82,186,0,1,108,192,0,26,6,0,inf,>30,NZ,Away,Upto 2014
Saqlain Mushtaq,PAK,Spin,2001-05-31,Manchester,England,2001,2,154,464,6,1,175,476,6,21,12,0,29.166666666666668,<=30,ENG,Away,Upto 2014
Saqlain Mushtaq,PAK,Spin,2002-01-09,Dhaka,Bangladesh,2002,2,28,72,0,1,399,740,13,371,668,13,30.692307692307693,>30,BAN,Away,Upto 2014
Saqlain Mushtaq,PAK,Spin,2002-01-16,Chattogram,Bangladesh,2002,2,69,166,7,1,412,718,14,343,552,7,29.428571428571427,<=30,BAN,Away,Upto 2014
Saqlain Mushtaq,PAK,Spin,2002-01-31,Sharjah,UAE,2002,2,101,282,2,1,403,857,9,302,575,7,44.77777777777778,>30,UAE,Away,Upto 2014
Saqlain Mushtaq,PAK,Spin,2002-02-07,Sharjah,UAE,2002,2,117,245,5,1,492,929,10,375,684,5,49.2,>30,UAE,Away,Upto 2014
Saqlain Mushtaq,PAK,Spin,2002-05-01,Lahore,Pakistan,2002,2,59,141,4,1,466,722,13,407,581,9,35.84615384615385,>30,PAK,Home,Upto 2014
Saqlain Mushtaq,PAK,Spin,2002-10-03,Colombo (PSS),Sri Lanka,2002,2,182,340,8,1,409,724,19,227,384,11,21.526315789473685,<=30,SL,Away,Upto 2014
Saqlain Mushtaq,PAK,Spin,2002-10-11,Sharjah,UAE,2002,1,83,204,4,1,223,467,13,140,263,9,17.153846153846153,<=30,UAE,Away,Upto 2014
Saqlain Mushtaq,PAK,Spin,2002-10-19,Sharjah,UAE,2002,1,159,270,2,1,467,889,13,308,619,11,35.92307692307692,>30,UAE,Away,Upto 2014
Saqlain Mushtaq,PAK,Spin,2002-11-09,Harare,Zimbabwe,2002,2,168,300,5,1,290,546,9,122,246,4,32.22222222222222,>30,ZIM,Away,Upto 2014
Saqlain Mushtaq,PAK,Spin,2002-11-16,Bulawayo,Zimbabwe,2002,2,155,383,10,1,335,808,14,180,425,4,23.928571428571427,<=30,ZIM,Away,Upto 2014
Saqlain Mushtaq,PAK,Spin,2002-12-26,Durban,South Africa,2002,2,127,246,4,1,180,360,6,53,114,2,30.0,<=30,SA,Away,Upto 2014
Saqlain Mushtaq,PAK,Spin,2003-01-02,Cape Town,South Africa,2003,1,237,300,3,1,396,516,5,159,216,2,79.2,>30,SA,Away,Upto 2014
Saqlain Mushtaq,PAK,Spin,2003-09-03,Multan,Pakistan,2003,2,70,165,2,1,248,589,11,178,424,9,22.545454545454547,<=30,PAK,Home,Upto 2014
Saqlain Mushtaq,PAK,Spin,2004-03-28,Multan,Pakistan,2004,1,204,258,1,1,510,902,13,306,644,12,39.23076923076923,>30,PAK,Home,Upto 2014
Sarandeep Singh,IND,Spin,2000-11-25,Nagpur,India,2000,2,206,426,6,1,810,1427,12,604,1001,6,67.5,>30,IND,Home,Upto 2014
Sarandeep Singh,IND,Spin,2001-12-19,Bengaluru,India,2001,1,54,126,3,1,308,742,5,254,616,2,61.6,>30,IND,Home,Upto 2014
Sarandeep Singh,IND,Spin,2002-04-11,Georgetown,West Indies,2002,1,80,126,1,1,369,751,4,289,625,3,92.25,>30,WI,Away,Upto 2014
Sarfraz Nawaz,PAK,Pace,1969-03-06,Karachi,Pakistan,1969,1,78,204,0,1,172,372,2,94,168,2,86.0,>30,PAK,Home,Upto 2014
Sarfraz Nawaz,PAK,Pace,1972-12-29,Melbourne,Australia,1972,2,199,357,4,1,925,1467,16,726,1110,12,57.8125,>30,AUS,Away,Upto 2014
Sarfraz Nawaz,PAK,Pace,1973-01-06,Sydney,Australia,1973,2,109,320,8,1,767,1875,36,658,1555,28,21.305555555555557,<=30,AUS,Away,Upto 2014
Sarfraz Nawaz,PAK,Pace,1973-02-02,Wellington,New Zealand,1973,2,141,272,4,1,687,1320,19,546,1048,15,36.1578947368421,>30,NZ,Away,Upto 2014
Sarfraz Nawaz,PAK,Pace,1973-02-07,Dunedin,New Zealand,1973,2,36,72,1,1,333,648,6,297,576,5,55.5,>30,NZ,Away,Upto 2014
Sarfraz Nawaz,PAK,Pace,1973-02-16,Auckland,New Zealand,1973,2,98,160,0,1,643,1420,15,545,1260,15,42.86666666666667,>30,NZ,Away,Upto 2014
Sarfraz Nawaz,PAK,Pace,1973-03-02,Lahore,Pakistan,1973,2,92,288,1,1,401,966,6,309,678,5,66.83333333333333,>30,PAK,Home,Upto 2014
Sarfraz Nawaz,PAK,Pace,1973-03-24,Karachi,Pakistan,1973,2,64,156,0,1,291,630,3,227,474,3,97.0,>30,PAK,Home,Upto 2014
Sarfraz Nawaz,PAK,Pace,1974-07-25,Leeds,England,1974,2,107,348,7,1,703,1746,31,596,1398,24,22.677419354838708,<=30,ENG,Away,Upto 2014
Sarfraz Nawaz,PAK,Pace,1974-08-08,Lord's,England,1974,2,49,150,1,1,356,858,8,307,708,7,44.5,>30,ENG,Away,Upto 2014
Sarfraz Nawaz,PAK,Pace,1974-08-22,The Oval,England,1974,1,103,228,1,1,675,1389,8,572,1161,7,84.375,>30,ENG,Away,Upto 2014
Sarfraz Nawaz,PAK,Pace,1975-02-15,Lahore,Pakistan,1975,2,160,376,7,1,757,1707,25,597,1331,18,30.28,>30,PAK,Home,Upto 2014
Sarfraz Nawaz,PAK,Pace,1975-03-01,Karachi,Pakistan,1975,1,106,168,1,1,655,1306,12,549,1138,11,54.583333333333336,>30,PAK,Home,Upto 2014
Sarfraz Nawaz,PAK,Pace,1976-10-09,Lahore,Pakistan,1976,2,102,248,5,1,496,904,17,394,656,12,29.176470588235293,<=30,PAK,Home,Upto 2014
Sarfraz Nawaz,PAK,Pace,1976-10-23,Hyderabad (Sind),Pakistan,1976,2,98,227,5,1,398,904,11,300,677,6,36.18181818181818,>30,PAK,Home,Upto 2014
Sarfraz Nawaz,PAK,Pace,1976-10-30,Karachi,Pakistan,1976,1,84,160,3,1,1003,1506,20,919,1346,17,50.15,>30,PAK,Home,Upto 2014
Sarfraz Nawaz,PAK,Pace,1976-12-24,Adelaide,Australia,1976,2,99,256,2,1,783,1646,15,684,1390,13,52.2,>30,AUS,Away,Upto 2014
Sarfraz Nawaz,PAK,Pace,1977-01-14,Sydney,Australia,1977,2,119,248,6,1,681,1364,30,562,1116,24,22.7,<=30,AUS,Away,Upto 2014
Sarfraz Nawaz,PAK,Pace,1977-02-18,Bridgetown,West Indies,1977,2,204,378,7,1,1045,1954,34,841,1576,27,30.735294117647058,>30,WI,Away,Upto 2014
Sarfraz Nawaz,PAK,Pace,1977-03-18,Georgetown,West Indies,1977,2,163,324,2,1,1085,2006,25,922,1682,23,43.4,>30,WI,Away,Upto 2014
Sarfraz Nawaz,PAK,Pace,1977-04-01,Port of Spain,West Indies,1977,2,38,174,3,1,547,1241,19,509,1067,16,28.789473684210527,<=30,WI,Away,Upto 2014
Sarfraz Nawaz,PAK,Pace,1977-04-15,Kingston,West Indies,1977,2,174,309,4,1,849,1372,30,675,1063,26,28.3,<=30,WI,Away,Upto 2014
Sarfraz Nawaz,PAK,Pace,1977-12-14,Lahore,Pakistan,1977,1,68,272,4,1,359,1064,11,291,792,7,32.63636363636363,>30,PAK,Home,Upto 2014
Sarfraz Nawaz,PAK,Pace,1978-01-18,Karachi,Pakistan,1978,2,84,344,1,1,226,792,5,142,448,4,45.2,>30,PAK,Home,Upto 2014
Sarfraz Nawaz,PAK,Pace,1978-06-01,Birmingham,England,1978,1,12,36,0,1,618,1454,19,606,1418,19,32.526315789473685,>30,ENG,Away,Upto 2014
Sarfraz Nawaz,PAK,Pace,1978-06-29,Leeds,England,1978,1,39,120,5,1,225,754,16,186,634,11,14.0625,<=30,ENG,Away,Upto 2014
Sarfraz Nawaz,PAK,Pace,1978-10-16,Faisalabad,Pakistan,1978,2,108,234,2,1,508,904,5,400,670,3,101.6,>30,PAK,Home,Upto 2014
Sarfraz Nawaz,PAK,Pace,1978-10-27,Lahore,Pakistan,1978,2,158,324,6,1,667,1298,21,509,974,15,31.761904761904763,>30,PAK,Home,Upto 2014
Sarfraz Nawaz,PAK,Pace,1978-11-14,Karachi,Pakistan,1978,2,159,332,9,1,801,1525,25,642,1193,16,32.04,>30,PAK,Home,Upto 2014
Sarfraz Nawaz,PAK,Pace,1979-02-02,Christchurch,New Zealand,1979,2,89,256,1,1,652,1680,19,563,1424,18,34.31578947368421,>30,NZ,Away,Upto 2014
Sarfraz Nawaz,PAK,Pace,1979-02-16,Napier,New Zealand,1979,1,90,208,0,1,699,1749,19,609,1541,19,36.78947368421053,>30,NZ,Away,Upto 2014
Sarfraz Nawaz,PAK,Pace,1979-02-23,Auckland,New Zealand,1979,2,117,346,7,1,754,1863,27,637,1517,20,27.925925925925927,<=30,NZ,Away,Upto 2014
Sarfraz Nawaz,PAK,Pace,1979-03-10,Melbourne,Australia,1979,2,125,458,11,1,679,1863,29,554,1405,18,23.413793103448278,<=30,AUS,Away,Upto 2014
Sarfraz Nawaz,PAK,Pace,1979-03-24,W.A.C.A,Australia,1979,2,197,433,2,1,924,2172,25,727,1739,23,36.96,>30,AUS,Away,Upto 2014
Sarfraz Nawaz,PAK,Pace,1980-02-27,Karachi,Pakistan,1980,2,27,120,0,1,240,648,5,213,528,5,48.0,>30,PAK,Home,Upto 2014
Sarfraz Nawaz,PAK,Pace,1980-03-06,Faisalabad,Pakistan,1980,1,119,294,2,1,357,750,4,238,456,2,89.25,>30,PAK,Home,Upto 2014
Sarfraz Nawaz,PAK,Pace,1980-03-18,Lahore,Pakistan,1980,2,109,252,0,1,489,1014,8,380,762,8,61.125,>30,PAK,Home,Upto 2014
Sarfraz Nawaz,PAK,Pace,1980-11-24,Lahore,Pakistan,1980,1,40,78,1,1,508,1109,13,468,1031,12,39.07692307692308,>30,PAK,Home,Upto 2014
Sarfraz Nawaz,PAK,Pace,1980-12-30,Multan,Pakistan,1980,2,39,122,1,1,286,658,15,247,536,14,19.066666666666666,<=30,PAK,Home,Upto 2014
Sarfraz Nawaz,PAK,Pace,1981-11-13,W.A.C.A,Australia,1981,2,131,324,2,1,628,1440,27,497,1116,25,23.25925925925926,<=30,AUS,Away,Upto 2014
Sarfraz Nawaz,PAK,Pace,1981-11-27,Brisbane,Australia,1981,1,121,210,2,1,651,1292,22,530,1082,20,29.59090909090909,<=30,AUS,Away,Upto 2014
Sarfraz Nawaz,PAK,Pace,1981-12-11,Melbourne,Australia,1981,2,54,174,5,1,395,1019,11,341,845,6,35.90909090909091,>30,AUS,Away,Upto 2014
Sarfraz Nawaz,PAK,Pace,1982-08-12,Lord's,England,1982,2,78,222,3,1,700,1644,21,622,1422,18,33.333333333333336,>30,ENG,Away,Upto 2014
Sarfraz Nawaz,PAK,Pace,1982-12-10,Lahore,Pakistan,1982,1,63,191,4,1,700,1379,14,637,1188,10,50.0,>30,PAK,Home,Upto 2014
Sarfraz Nawaz,PAK,Pace,1982-12-23,Karachi,Pakistan,1982,2,72,156,2,1,510,865,22,438,709,20,23.181818181818183,<=30,PAK,Home,Upto 2014
Sarfraz Nawaz,PAK,Pace,1983-01-03,Faisalabad,Pakistan,1983,2,174,336,5,1,934,1450,28,760,1114,23,33.357142857142854,>30,PAK,Home,Upto 2014
Sarfraz Nawaz,PAK,Pace,1983-01-14,Hyderabad (Sind),Pakistan,1983,2,141,294,7,1,503,996,17,362,702,10,29.58823529411765,<=30,PAK,Home,Upto 2014
Sarfraz Nawaz,PAK,Pace,1983-01-23,Lahore,Pakistan,1983,1,46,140,0,1,359,745,10,313,605,10,35.9,>30,PAK,Home,Upto 2014
Sarfraz Nawaz,PAK,Pace,1983-01-30,Karachi,Pakistan,1983,2,137,330,1,1,655,1382,13,518,1052,12,50.38461538461539,>30,PAK,Home,Upto 2014
Sarfraz Nawaz,PAK,Pace,1983-12-09,Adelaide,Australia,1983,2,174,432,4,1,947,1786,20,773,1354,16,47.35,>30,AUS,Away,Upto 2014
Sarfraz Nawaz,PAK,Pace,1983-12-26,Melbourne,Australia,1983,1,106,306,2,1,818,1728,17,712,1422,15,48.11764705882353,>30,AUS,Away,Upto 2014
Sarfraz Nawaz,PAK,Pace,1984-01-02,Sydney,Australia,1984,2,139,336,2,1,768,1631,25,629,1295,23,30.72,>30,AUS,Away,Upto 2014
Sarfraz Nawaz,PAK,Pace,1984-03-02,Karachi,Pakistan,1984,2,69,245,6,1,284,740,10,215,495,4,28.4,<=30,PAK,Home,Upto 2014
Sarfraz Nawaz,PAK,Pace,1984-03-12,Faisalabad,Pakistan,1984,1,129,300,3,1,538,960,13,409,660,10,41.38461538461539,>30,PAK,Home,Upto 2014
Sarfraz Nawaz,PAK,Pace,1984-03-19,Lahore,Pakistan,1984,2,161,303,5,1,528,1035,19,367,732,14,27.789473684210527,<=30,PAK,Home,Upto 2014
Saud Shakeel,PAK,Spin,2022-12-01,Rawalpindi,Pakistan,2022,1,30,12,0,1,949,1152,16,919,1140,16,59.3125,>30,PAK,Home,After 1965
Saud Shakeel,PAK,Spin,2024-08-21,Rawalpindi,Pakistan,2024,1,9,12,0,1,433,770,10,424,758,10,43.3,>30,PAK,Home,After 1965
Saud Shakeel,PAK,Spin,2024-10-07,Multan,Pakistan,2024,1,14,12,0,1,918,1193,16,904,1181,16,57.375,>30,PAK,Home,After 1965
Saud Shakeel,PAK,Spin,2025-01-03,Cape Town,South Africa,2025,1,1,1,0,1,445,729,11,444,728,11,40.45454545454545,>30,SA,Away,After 1965
Sayed Shirzad,AFG,Pace,2021-03-10,Abu Dhabi,UAE,2021,2,97,252,3,1,415,797,6,318,545,3,69.16666666666667,>30,UAE,Away,After 1965
Shabbir Ahmed,PAK,Pace,2003-08-20,Karachi,Pakistan,2003,2,109,232,8,1,660,1252,19,551,1020,11,34.73684210526316,>30,PAK,Home,Upto 2014
Shabbir Ahmed,PAK,Pace,2003-08-27,Peshawar,Pakistan,2003,2,94,192,2,1,501,1075,20,407,883,18,25.05,<=30,PAK,Home,Upto 2014
Shabbir Ahmed,PAK,Pace,2003-09-03,Multan,Pakistan,2003,2,138,290,7,1,593,1160,25,455,870,18,23.72,<=30,PAK,Home,Upto 2014
Shabbir Ahmed,PAK,Pace,2003-10-24,Faisalabad,Pakistan,2003,2,144,363,6,1,604,1451,24,460,1088,18,25.166666666666668,<=30,PAK,Home,Upto 2014
Shabbir Ahmed,PAK,Pace,2003-12-19,Hamilton,New Zealand,2003,2,127,320,5,1,863,1591,23,736,1271,18,37.52173913043478,>30,NZ,Away,Upto 2014
Shabbir Ahmed,PAK,Pace,2003-12-26,Wellington,New Zealand,2003,2,107,324,5,1,696,1646,29,589,1322,24,24.0,<=30,NZ,Away,Upto 2014
Shabbir Ahmed,PAK,Pace,2004-03-28,Multan,Pakistan,2004,1,122,186,0,1,716,1290,10,594,1104,10,71.6,>30,PAK,Home,Upto 2014
Shabbir Ahmed,PAK,Pace,2005-05-26,Bridgetown,West Indies,2005,2,136,228,5,1,722,1198,25,586,970,20,28.88,<=30,WI,Away,Upto 2014
Shabbir Ahmed,PAK,Pace,2005-06-03,Kingston,West Indies,2005,2,119,245,8,1,832,1351,29,713,1106,21,28.689655172413794,<=30,WI,Away,Upto 2014
Shabbir Ahmed,PAK,Pace,2005-11-12,Multan,Pakistan,2005,2,79,196,5,1,730,1407,32,651,1211,27,22.8125,<=30,PAK,Home,Upto 2014
Shadab Kabir,PAK,Spin,1996-07-25,Lord's,England,1996,1,9,6,0,1,309,758,8,300,752,8,38.625,>30,ENG,Away,Upto 2014
Shadab Khan,PAK,Spin,2017-04-30,Bridgetown,West Indies,2017,2,145,240,1,1,516,1000,13,371,760,12,39.69230769230769,>30,WI,Away,After 1965
Shadab Khan,PAK,Spin,2018-05-11,Dublin (Malahide),Ireland,2018,2,94,264,4,1,106,282,4,12,18,0,26.5,<=30,IRE,Away,After 1965
Shadab Khan,PAK,Spin,2018-05-24,Lord's,England,2018,2,97,150,2,1,185,274,2,88,124,0,92.5,>30,ENG,Away,After 1965
Shadab Khan,PAK,Spin,2018-06-01,Leeds,England,2018,1,50,102,1,1,83,168,4,33,66,3,20.75,<=30,ENG,Away,After 1965
Shadab Khan,PAK,Spin,2019-01-11,Johannesburg,South Africa,2019,2,80,129,4,1,90,145,4,10,16,0,22.5,<=30,SA,Away,After 1965
Shadab Khan,PAK,Spin,2020-08-05,Manchester,England,2020,2,47,69,2,1,351,585,12,304,516,10,29.25,<=30,ENG,Away,After 1965
Shafiq Ahmed,PAK,Pace,1978-01-18,Karachi,Pakistan,1978,1,1,8,0,1,226,792,5,225,784,5,45.2,>30,PAK,Home,Upto 2014
Shafiul Islam,BAN,Pace,2010-01-17,Chattogram,Bangladesh,2010,2,128,144,1,1,609,842,14,481,698,13,43.5,>30,BAN,Home,Upto 2014
Shafiul Islam,BAN,Pace,2010-01-24,Mirpur,Bangladesh,2010,1,86,138,3,1,466,741,17,380,603,14,27.41176470588235,<=30,BAN,Home,Upto 2014
Shafiul Islam,BAN,Pace,2010-02-15,Hamilton,New Zealand,2010,2,158,270,1,1,762,1104,17,604,834,16,44.8235294117647,>30,NZ,Away,Upto 2014
Shafiul Islam,BAN,Pace,2010-03-20,Mirpur,Bangladesh,2010,2,67,120,0,1,503,828,9,436,708,9,55.888888888888886,>30,BAN,Home,Upto 2014
Shafiul Islam,BAN,Pace,2010-06-04,Manchester,England,2010,1,63,126,2,1,268,480,16,205,354,14,16.75,<=30,ENG,Away,Upto 2014
Shafiul Islam,BAN,Pace,2011-08-04,Harare,Zimbabwe,2011,2,67,198,1,1,850,1557,26,783,1359,25,32.69230769230769,>30,ZIM,Away,Upto 2014
Shafiul Islam,BAN,Pace,2014-09-13,Gros Islet,West Indies,2014,2,122,240,3,1,563,1240,21,441,1000,18,26.80952380952381,<=30,WI,Away,After 1965
Shafiul Islam,BAN,Pace,2014-11-12,Chattogram,Bangladesh,2014,2,67,162,4,1,456,862,15,389,700,11,30.4,>30,BAN,Home,After 1965
Shafiul Islam,BAN,Pace,2016-10-20,Chattogram,Bangladesh,2016,2,43,72,0,1,222,543,9,179,471,9,24.666666666666668,<=30,BAN,Home,After 1965
Shafiul Islam,BAN,Pace,2017-08-27,Mirpur,Bangladesh,2017,1,21,36,0,1,186,391,4,165,355,4,46.5,>30,BAN,Home,After 1965
Shafiul Islam,BAN,Pace,2017-09-28,Potchefstroom,South Africa,2017,2,120,228,2,1,634,1140,16,514,912,14,39.625,>30,SA,Away,After 1965
Shafqat Rana,PAK,Pace,1964-10-24,Karachi,Pakistan,1964,1,1,6,0,1,349,725,11,348,719,11,31.727272727272727,>30,PAK,Home,Upto 2014
Shafqat Rana,PAK,Pace,1969-02-21,Lahore,Pakistan,1969,1,6,12,0,1,347,758,16,341,746,16,21.6875,<=30,PAK,Home,Upto 2014
Shafqat Rana,PAK,Pace,1969-11-08,Dhaka,Bangladesh,1969,1,2,18,1,1,262,729,8,260,711,7,32.75,>30,BAN,Away,Upto 2014
Shahadat Hossain,BAN,Spin,2005-05-26,Lord's,England,2005,1,101,72,0,1,251,318,1,150,246,1,251.0,>30,ENG,Away,Upto 2014
Shahadat Hossain,BAN,Spin,2005-09-12,Colombo (RPS),Sri Lanka,2005,1,75,120,2,1,396,772,20,321,652,18,19.8,<=30,SL,Away,Upto 2014
Shahadat Hossain,BAN,Spin,2005-09-20,Colombo (PSS),Sri Lanka,2005,1,108,120,4,1,417,656,12,309,536,8,34.75,>30,SL,Away,Upto 2014
Shahadat Hossain,BAN,Spin,2006-02-28,Chattogram,Bangladesh,2006,2,122,180,4,1,666,1170,22,544,990,18,30.272727272727273,>30,BAN,Home,Upto 2014
Shahadat Hossain,BAN,Spin,2006-03-08,Bogra,Bangladesh,2006,2,129,177,5,1,552,1040,19,423,863,14,29.05263157894737,<=30,BAN,Home,Upto 2014
Shahadat Hossain,BAN,Spin,2006-04-09,Fatullah,Bangladesh,2006,2,115,204,1,1,739,1451,25,624,1247,24,29.56,<=30,BAN,Home,Upto 2014
Shahadat Hossain,BAN,Spin,2006-04-16,Chattogram,Bangladesh,2006,1,143,198,0,1,796,1393,18,653,1195,18,44.22222222222222,>30,BAN,Home,Upto 2014
Shahadat Hossain,BAN,Spin,2007-05-18,Chattogram,Bangladesh,2007,2,106,150,5,1,447,726,13,341,576,8,34.38461538461539,>30,BAN,Home,Upto 2014
Shahadat Hossain,BAN,Spin,2007-06-25,Colombo (SSC),Sri Lanka,2007,1,102,108,2,1,605,1005,14,503,897,12,43.214285714285715,>30,SL,Away,Upto 2014
Shahadat Hossain,BAN,Spin,2007-07-03,Colombo (PSS),Sri Lanka,2007,1,81,126,2,1,383,661,9,302,535,7,42.55555555555556,>30,SL,Away,Upto 2014
Shahadat Hossain,BAN,Spin,2007-07-11,Kandy,Sri Lanka,2007,1,71,96,0,1,353,551,12,282,455,12,29.416666666666668,<=30,SL,Away,Upto 2014
Shahadat Hossain,BAN,Spin,2008-01-04,Dunedin,New Zealand,2008,2,101,114,2,1,288,481,9,187,367,7,32.0,>30,NZ,Away,Upto 2014
Shahadat Hossain,BAN,Spin,2008-01-12,Wellington,New Zealand,2008,1,83,162,3,1,156,309,6,73,147,3,26.0,<=30,NZ,Away,Upto 2014
Shahadat Hossain,BAN,Spin,2008-02-22,Mirpur,Bangladesh,2008,2,97,207,9,1,350,752,16,253,545,7,21.875,<=30,BAN,Home,Upto 2014
Shahadat Hossain,BAN,Spin,2008-02-29,Chattogram,Bangladesh,2008,1,107,150,3,1,550,943,13,443,793,10,42.30769230769231,>30,BAN,Home,Upto 2014
Shahadat Hossain,BAN,Spin,2008-10-17,Chattogram,Bangladesh,2008,2,81,132,0,1,669,1820,29,588,1688,29,23.06896551724138,<=30,BAN,Home,Upto 2014
Shahadat Hossain,BAN,Spin,2008-10-25,Mirpur,Bangladesh,2008,2,59,84,1,1,361,720,10,302,636,9,36.1,>30,BAN,Home,Upto 2014
Shahadat Hossain,BAN,Spin,2008-11-19,Bloemfontein,South Africa,2008,1,125,150,1,1,324,498,7,199,348,6,46.285714285714285,>30,SA,Away,Upto 2014
Shahadat Hossain,BAN,Spin,2008-11-26,Centurion,South Africa,2008,1,89,134,2,1,253,380,8,164,246,6,31.625,>30,SA,Away,Upto 2014
Shahadat Hossain,BAN,Spin,2008-12-26,Mirpur,Bangladesh,2008,2,121,180,2,1,727,1408,21,606,1228,19,34.61904761904762,>30,BAN,Home,Upto 2014
Shahadat Hossain,BAN,Spin,2009-01-03,Chattogram,Bangladesh,2009,2,172,252,2,1,931,1570,27,759,1318,25,34.48148148148148,>30,BAN,Home,Upto 2014
Shahadat Hossain,BAN,Spin,2009-07-09,Kingstown,West Indies,2009,2,80,150,1,1,504,1195,18,424,1045,17,28.0,<=30,WI,Away,Upto 2014
Shahadat Hossain,BAN,Spin,2009-07-17,St George's,West Indies,2009,2,48,78,2,1,462,930,22,414,852,20,21.0,<=30,WI,Away,Upto 2014
Shahadat Hossain,BAN,Spin,2010-01-17,Chattogram,Bangladesh,2010,2,124,204,6,1,565,949,23,441,745,17,24.565217391304348,<=30,BAN,Home,Upto 2014
Shahadat Hossain,BAN,Spin,2010-01-24,Mirpur,Bangladesh,2010,1,91,132,1,1,600,1045,11,509,913,10,54.54545454545455,>30,BAN,Home,Upto 2014
Shahadat Hossain,BAN,Spin,2010-02-15,Hamilton,New Zealand,2010,2,168,210,0,1,711,1173,10,543,963,10,71.1,>30,NZ,Away,Upto 2014
Shahadat Hossain,BAN,Spin,2010-03-12,Chattogram,Bangladesh,2010,2,92,138,0,1,894,1491,22,802,1353,22,40.63636363636363,>30,BAN,Home,Upto 2014
Shahadat Hossain,BAN,Spin,2010-05-27,Lord's,England,2010,2,117,180,5,1,517,907,10,400,727,5,51.7,>30,ENG,Away,Upto 2014
Shahadat Hossain,BAN,Spin,2010-06-04,Manchester,England,2010,1,84,126,1,1,455,779,14,371,653,13,32.5,>30,ENG,Away,Upto 2014
Shahadat Hossain,BAN,Spin,2011-10-21,Chattogram,Bangladesh,2011,2,40,54,1,1,473,864,18,433,810,17,26.27777777777778,<=30,BAN,Home,Upto 2014
Shahadat Hossain,BAN,Spin,2011-10-29,Mirpur,Bangladesh,2011,2,133,162,0,1,846,1669,23,713,1507,23,36.78260869565217,>30,BAN,Home,Upto 2014
Shahadat Hossain,BAN,Spin,2011-12-09,Chattogram,Bangladesh,2011,1,113,162,1,1,717,1447,18,604,1285,17,39.833333333333336,>30,BAN,Home,Upto 2014
Shahadat Hossain,BAN,Spin,2011-12-17,Mirpur,Bangladesh,2011,2,108,120,0,1,690,1381,17,582,1261,17,40.588235294117645,>30,BAN,Home,Upto 2014
Shahadat Hossain,BAN,Spin,2012-11-13,Mirpur,Bangladesh,2012,2,119,168,1,1,992,1679,19,873,1511,18,52.21052631578947,>30,BAN,Home,Upto 2014
Shahadat Hossain,BAN,Spin,2013-03-08,Galle,Sri Lanka,2013,2,128,180,1,1,1160,1920,13,1032,1740,12,89.23076923076923,>30,SL,Away,Upto 2014
Shahadat Hossain,BAN,Spin,2014-10-25,Mirpur,Bangladesh,2014,2,70,132,2,1,460,898,22,390,766,20,20.90909090909091,<=30,BAN,Home,After 1965
Shahadat Hossain,BAN,Spin,2014-11-03,Khulna,Bangladesh,2014,1,24,66,0,1,829,1764,29,805,1698,29,28.586206896551722,<=30,BAN,Home,After 1965
Shahadat Hossain,BAN,Spin,2015-05-06,Mirpur,Bangladesh,2015,1,4,2,0,1,692,1014,18,688,1012,18,38.44444444444444,>30,BAN,Home,After 1965
Shaheen Shah Afridi,PAK,Pace,2018-12-03,Abu Dhabi,UAE,2018,2,137,258,3,1,467,990,12,330,732,9,38.916666666666664,>30,UAE,Away,After 1965
Shaheen Shah Afridi,PAK,Pace,2018-12-26,Centurion,South Africa,2018,2,117,198,5,1,620,1128,33,503,930,28,18.78787878787879,<=30,SA,Away,After 1965
Shaheen Shah Afridi,PAK,Pace,2019-01-03,Cape Town,South Africa,2019,1,123,163,4,1,809,1380,31,686,1217,27,26.096774193548388,<=30,SA,Away,After 1965
Shaheen Shah Afridi,PAK,Pace,2019-11-21,Brisbane,Australia,2019,1,96,204,2,1,600,1180,22,504,976,20,27.272727272727273,<=30,AUS,Away,After 1965
Shaheen Shah Afridi,PAK,Pace,2019-11-29,Adelaide,Australia,2019,1,88,180,3,1,654,1168,17,566,988,14,38.470588235294116,>30,AUS,Away,After 1965
Shaheen Shah Afridi,PAK,Pace,2019-12-11,Rawalpindi,Pakistan,2019,1,58,132,2,1,376,750,8,318,618,6,47.0,>30,PAK,Home,After 1965
Shaheen Shah Afridi,PAK,Pace,2019-12-19,Karachi,Pakistan,2019,2,128,245,6,1,653,1162,24,525,917,18,27.208333333333332,<=30,PAK,Home,After 1965
Shaheen Shah Afridi,PAK,Pace,2020-02-07,Rawalpindi,Pakistan,2020,2,92,227,5,1,527,1060,20,435,833,15,26.35,<=30,PAK,Home,After 1965
Shaheen Shah Afridi,PAK,Pace,2020-08-05,Manchester,England,2020,2,112,199,2,1,609,1268,24,497,1069,22,25.375,<=30,ENG,Away,After 1965
Shaheen Shah Afridi,PAK,Pace,2020-08-13,Southampton,England,2020,1,25,60,1,1,292,740,12,267,680,11,24.333333333333332,<=30,ENG,Away,After 1965
Shaheen Shah Afridi,PAK,Pace,2020-08-21,Southampton,England,2020,1,121,202,2,1,619,1361,14,498,1159,12,44.214285714285715,>30,ENG,Away,After 1965
Shaheen Shah Afridi,PAK,Pace,2020-12-26,Mount Maunganui,New Zealand,2020,2,156,282,4,1,873,2105,28,717,1823,24,31.178571428571427,>30,NZ,Away,After 1965
Shaheen Shah Afridi,PAK,Pace,2021-01-03,Christchurch,New Zealand,2021,1,101,215,2,1,918,1730,25,817,1515,23,36.72,>30,NZ,Away,After 1965
Shaheen Shah Afridi,PAK,Pace,2021-01-26,Karachi,Pakistan,2021,2,110,170,2,1,546,968,13,436,798,11,42.0,>30,PAK,Home,After 1965
Shaheen Shah Afridi,PAK,Pace,2021-02-04,Rawalpindi,Pakistan,2021,2,88,204,5,1,534,1105,24,446,901,19,22.25,<=30,PAK,Home,After 1965
Shaheen Shah Afridi,PAK,Pace,2021-04-29,Harare,Zimbabwe,2021,2,78,157,4,1,469,921,23,391,764,19,20.391304347826086,<=30,ZIM,Away,After 1965
Shaheen Shah Afridi,PAK,Pace,2021-05-07,Harare,Zimbabwe,2021,2,86,204,6,1,481,1050,18,395,846,12,26.72222222222222,<=30,ZIM,Away,After 1965
Shaheen Shah Afridi,PAK,Pace,2021-08-12,Kingston,West Indies,2021,2,109,232,8,1,661,1558,37,552,1326,29,17.864864864864863,<=30,WI,Away,After 1965
Shaheen Shah Afridi,PAK,Pace,2021-08-20,Kingston,West Indies,2021,2,94,209,10,1,688,1393,29,594,1184,19,23.724137931034484,<=30,WI,Away,After 1965
Shaheen Shah Afridi,PAK,Pace,2021-11-26,Chattogram,Bangladesh,2021,2,102,252,7,1,416,874,18,314,622,11,23.11111111111111,<=30,BAN,Away,After 1965
Shaheen Shah Afridi,PAK,Pace,2021-12-04,Mirpur,Bangladesh,2021,2,34,114,3,1,208,447,7,174,333,4,29.714285714285715,<=30,BAN,Away,After 1965
Shaheen Shah Afridi,PAK,Pace,2022-03-04,Rawalpindi,Pakistan,2022,1,88,180,2,1,479,990,4,391,810,2,119.75,>30,PAK,Home,After 1965
Shaheen Shah Afridi,PAK,Pace,2022-03-12,Karachi,Pakistan,2022,2,116,231,2,1,534,1143,14,418,912,12,38.142857142857146,>30,PAK,Home,After 1965
Shaheen Shah Afridi,PAK,Pace,2022-03-21,Lahore,Pakistan,2022,2,124,213,5,1,523,1268,24,399,1055,19,21.791666666666668,<=30,PAK,Home,After 1965
Shaheen Shah Afridi,PAK,Pace,2022-07-16,Galle,Sri Lanka,2022,2,79,127,4,1,258,511,10,179,384,6,25.8,<=30,SL,Away,After 1965
Shaheen Shah Afridi,PAK,Pace,2023-07-16,Galle,Sri Lanka,2023,2,150,222,5,1,424,660,10,274,438,5,42.4,>30,SL,Away,After 1965
Shaheen Shah Afridi,PAK,Pace,2023-07-24,Colombo (SSC),Sri Lanka,2023,2,74,138,1,1,369,580,10,295,442,9,36.9,>30,SL,Away,After 1965
Shaheen Shah Afridi,PAK,Pace,2023-12-14,Perth,Australia,2023,2,172,272,2,1,810,1410,28,638,1138,26,28.928571428571427,<=30,AUS,Away,After 1965
Shaheen Shah Afridi,PAK,Pace,2023-12-26,Melbourne,Australia,2023,2,161,324,6,1,818,1640,35,657,1316,29,23.37142857142857,<=30,AUS,Away,After 1965
Shaheen Shah Afridi,PAK,Pace,2024-08-21,Rawalpindi,Pakistan,2024,2,96,192,2,1,696,1287,16,600,1095,14,43.5,>30,PAK,Home,After 1965
Shaheen Shah Afridi,PAK,Pace,2024-10-07,Multan,Pakistan,2024,1,120,156,1,1,658,930,10,538,774,9,65.8,>30,PAK,Home,After 1965
Shahid Afridi,PAK,Spin,1998-10-22,Karachi,Pakistan,1998,2,101,249,5,1,832,1892,24,731,1643,19,34.666666666666664,>30,PAK,Home,Upto 2014
Shahid Afridi,PAK,Spin,1999-01-28,Chennai,India,1999,2,54,139,3,1,572,1226,24,518,1087,21,23.833333333333332,<=30,IND,Away,Upto 2014
Shahid Afridi,PAK,Spin,1999-02-04,Delhi,India,1999,2,38,72,0,1,634,1395,31,596,1323,31,20.451612903225808,<=30,IND,Away,Upto 2014
Shahid Afridi,PAK,Spin,1999-02-16,Eden Gardens,India,1999,2,17,36,0,1,375,758,8,358,722,8,46.875,>30,IND,Away,Upto 2014
Shahid Afridi,PAK,Spin,1999-03-04,Lahore,Pakistan,1999,1,71,120,1,1,525,960,12,454,840,11,43.75,>30,PAK,Home,Upto 2014
Shahid Afridi,PAK,Spin,1999-03-12,Dhaka,Bangladesh,1999,2,46,54,2,1,550,1176,20,504,1122,18,27.5,<=30,BAN,Away,Upto 2014
Shahid Afridi,PAK,Spin,2000-03-05,Peshawar,Pakistan,2000,1,31,42,0,1,411,991,20,380,949,20,20.55,<=30,PAK,Home,Upto 2014
Shahid Afridi,PAK,Spin,2000-03-12,Karachi,Pakistan,2000,2,90,120,5,1,344,671,14,254,551,9,24.571428571428573,<=30,PAK,Home,Upto 2014
Shahid Afridi,PAK,Spin,2000-11-15,Lahore,Pakistan,2000,2,40,115,1,1,697,1762,20,657,1647,19,34.85,>30,PAK,Home,Upto 2014
Shahid Afridi,PAK,Spin,2000-11-29,Faisalabad,Pakistan,2000,2,22,78,2,1,641,1582,20,619,1504,18,32.05,>30,PAK,Home,Upto 2014
Shahid Afridi,PAK,Spin,2000-12-07,Karachi,Pakistan,2000,2,74,162,1,1,624,1582,18,550,1420,17,34.666666666666664,>30,PAK,Home,Upto 2014
Shahid Afridi,PAK,Spin,2002-02-07,Sharjah,UAE,2002,2,48,102,1,1,492,929,10,444,827,9,49.2,>30,UAE,Away,Upto 2014
Shahid Afridi,PAK,Spin,2002-03-06,Lahore,Pakistan,2002,1,26,18,0,1,240,516,8,214,498,8,30.0,<=30,PAK,Home,Upto 2014
Shahid Afridi,PAK,Spin,2002-05-01,Lahore,Pakistan,2002,1,3,24,0,1,466,722,13,463,698,13,35.84615384615385,>30,PAK,Home,Upto 2014
Shahid Afridi,PAK,Spin,2005-01-02,Sydney,Australia,2005,2,115,174,0,1,684,1068,21,569,894,21,32.57142857142857,>30,AUS,Away,Upto 2014
Shahid Afridi,PAK,Spin,2005-03-16,Eden Gardens,India,2005,2,127,216,3,1,693,1450,23,566,1234,20,30.130434782608695,>30,IND,Away,Upto 2014
Shahid Afridi,PAK,Spin,2005-03-24,Bengaluru,India,2005,2,43,166,5,1,834,1659,22,791,1493,17,37.90909090909091,>30,IND,Away,Upto 2014
Shahid Afridi,PAK,Spin,2005-05-26,Bridgetown,West Indies,2005,2,81,138,3,1,401,552,13,320,414,10,30.846153846153847,>30,WI,Away,Upto 2014
Shahid Afridi,PAK,Spin,2005-06-03,Kingston,West Indies,2005,1,51,79,3,1,374,708,11,323,629,8,34.0,>30,WI,Away,Upto 2014
Shahid Afridi,PAK,Spin,2005-11-20,Faisalabad,Pakistan,2005,2,111,225,4,1,496,897,7,385,672,3,70.85714285714286,>30,PAK,Home,Upto 2014
Shahid Afridi,PAK,Spin,2006-01-13,Lahore,Pakistan,2006,1,55,66,0,1,588,687,2,533,621,2,294.0,>30,PAK,Home,Upto 2014
Shahid Afridi,PAK,Spin,2006-01-21,Faisalabad,Pakistan,2006,2,107,172,2,1,770,1194,9,663,1022,7,85.55555555555556,>30,PAK,Home,Upto 2014
Shahid Afridi,PAK,Spin,2006-01-29,Karachi,Pakistan,2006,2,22,30,1,1,322,481,6,300,451,5,53.666666666666664,>30,PAK,Home,Upto 2014
Shahid Afridi,PAK,Spin,2006-03-26,Colombo (SSC),Sri Lanka,2006,2,63,138,2,1,538,1125,13,475,987,11,41.38461538461539,>30,SL,Away,Upto 2014
Shahid Afridi,PAK,Spin,2006-07-13,Lord's,England,2006,2,128,231,2,1,515,1101,11,387,870,9,46.81818181818182,>30,ENG,Away,Upto 2014
Shahid Afridi,PAK,Spin,2006-07-27,Manchester,England,2006,1,76,126,1,1,286,568,10,210,442,9,28.6,<=30,ENG,Away,Upto 2014
Shahid Afridi,PAK,Spin,2010-07-13,Lord's,England,2010,2,69,102,1,1,298,547,14,229,445,13,21.285714285714285,<=30,ENG,Away,Upto 2014
Shahid Mahboob,PAK,Pace,1989-12-01,Lahore,Pakistan,1989,1,131,294,2,1,513,1118,6,382,824,4,85.5,>30,PAK,Home,Upto 2014
Shahid Mahmood,PAK,Pace,1962-07-26,Nottingham,England,1962,1,23,36,0,1,602,1369,18,579,1333,18,33.44444444444444,>30,ENG,Away,Upto 2014
Shahid Nazir,PAK,Pace,1996-10-17,Sheikhupura,Pakistan,1996,2,98,250,7,1,489,1024,12,391,774,5,40.75,>30,PAK,Home,Upto 2014
Shahid Nazir,PAK,Pace,1996-10-24,Faisalabad,Pakistan,1996,2,48,101,3,1,475,908,25,427,807,22,19.0,<=30,PAK,Home,Upto 2014
Shahid Nazir,PAK,Pace,1996-11-21,Lahore,Pakistan,1996,2,99,144,2,1,507,953,23,408,809,21,22.043478260869566,<=30,PAK,Home,Upto 2014
Shahid Nazir,PAK,Pace,1996-11-28,Rawalpindi,Pakistan,1996,2,42,96,1,1,614,1126,22,572,1030,21,27.90909090909091,<=30,PAK,Home,Upto 2014
Shahid Nazir,PAK,Pace,1997-04-19,Colombo (RPS),Sri Lanka,1997,2,98,180,1,1,337,618,3,239,438,2,112.33333333333333,>30,SL,Away,Upto 2014
Shahid Nazir,PAK,Pace,1997-04-26,Colombo (SSC),Sri Lanka,1997,1,50,48,0,1,378,693,12,328,645,12,31.5,>30,SL,Away,Upto 2014
Shahid Nazir,PAK,Pace,1997-11-17,Peshawar,Pakistan,1997,2,59,107,2,1,444,1004,18,385,897,16,24.666666666666668,<=30,PAK,Home,Upto 2014
Shahid Nazir,PAK,Pace,1999-03-04,Lahore,Pakistan,1999,2,72,114,1,1,638,1047,15,566,933,14,42.53333333333333,>30,PAK,Home,Upto 2014
Shahid Nazir,PAK,Pace,2006-08-04,Leeds,England,2006,2,133,252,4,1,1053,1569,26,920,1317,22,40.5,>30,ENG,Away,Upto 2014
Shahid Nazir,PAK,Pace,2006-08-17,The Oval,England,2006,2,70,114,2,1,700,1093,21,630,979,19,33.333333333333336,>30,ENG,Away,Upto 2014
Shahid Nazir,PAK,Pace,2006-11-11,Lahore,Pakistan,2006,2,105,204,6,1,669,1208,21,564,1004,15,31.857142857142858,>30,PAK,Home,Upto 2014
Shahid Nazir,PAK,Pace,2006-11-19,Multan,Pakistan,2006,1,103,174,2,1,741,1564,16,638,1390,14,46.3125,>30,PAK,Home,Upto 2014
Shahid Nazir,PAK,Pace,2006-11-27,Karachi,Pakistan,2006,2,107,210,3,1,841,1655,23,734,1445,20,36.56521739130435,>30,PAK,Home,Upto 2014
Shahid Nazir,PAK,Pace,2007-01-11,Centurion,South Africa,2007,2,109,138,0,1,894,1492,25,785,1354,25,35.76,>30,SA,Away,Upto 2014
Shahid Nazir,PAK,Pace,2007-01-26,Cape Town,South Africa,2007,2,79,102,2,1,527,865,27,448,763,25,19.51851851851852,<=30,SA,Away,Upto 2014
Shahid Saeed,PAK,Pace,1989-11-15,Karachi,Pakistan,1989,2,43,90,0,1,875,1711,26,832,1621,26,33.65384615384615,>30,PAK,Home,Upto 2014
Shahidullah,AFG,Spin,2021-03-10,Abu Dhabi,UAE,2021,1,6,30,0,1,842,1766,20,836,1736,20,42.1,>30,UAE,Away,After 1965
Shakeel Ahmed snr,PAK,Spin,1998-10-22,Karachi,Pakistan,1998,2,139,325,4,1,832,1892,24,693,1567,20,34.666666666666664,>30,PAK,Home,Upto 2014
Shakib Al Hasan,BAN,Spin,2007-05-18,Chattogram,Bangladesh,2007,1,29,78,0,1,447,726,13,418,648,13,34.38461538461539,>30,BAN,Home,Upto 2014
Shakib Al Hasan,BAN,Spin,2007-05-25,Mirpur,Bangladesh,2007,1,62,114,0,1,453,725,12,391,611,12,37.75,>30,BAN,Home,Upto 2014
Shakib Al Hasan,BAN,Spin,2007-06-25,Colombo (SSC),Sri Lanka,2007,1,57,96,0,1,605,1005,14,548,909,14,43.214285714285715,>30,SL,Away,Upto 2014
Shakib Al Hasan,BAN,Spin,2008-01-12,Wellington,New Zealand,2008,1,44,114,2,1,156,309,6,112,195,4,26.0,<=30,NZ,Away,Upto 2014
Shakib Al Hasan,BAN,Spin,2008-02-22,Mirpur,Bangladesh,2008,2,54,102,0,1,350,752,16,296,650,16,21.875,<=30,BAN,Home,Upto 2014
Shakib Al Hasan,BAN,Spin,2008-02-29,Chattogram,Bangladesh,2008,1,68,150,1,1,550,943,13,482,793,12,42.30769230769231,>30,BAN,Home,Upto 2014
Shakib Al Hasan,BAN,Spin,2008-10-17,Chattogram,Bangladesh,2008,2,115,424,9,1,669,1820,29,554,1396,20,23.06896551724138,<=30,BAN,Home,Upto 2014
Shakib Al Hasan,BAN,Spin,2008-10-25,Mirpur,Bangladesh,2008,2,63,150,1,1,361,720,10,298,570,9,36.1,>30,BAN,Home,Upto 2014
Shakib Al Hasan,BAN,Spin,2008-11-19,Bloemfontein,South Africa,2008,1,130,228,5,1,324,498,7,194,270,2,46.285714285714285,>30,SA,Away,Upto 2014
Shakib Al Hasan,BAN,Spin,2008-11-26,Centurion,South Africa,2008,1,99,168,6,1,253,380,8,154,212,2,31.625,>30,SA,Away,Upto 2014
Shakib Al Hasan,BAN,Spin,2008-12-26,Mirpur,Bangladesh,2008,2,204,412,6,1,727,1408,21,523,996,15,34.61904761904762,>30,BAN,Home,Upto 2014
Shakib Al Hasan,BAN,Spin,2009-01-03,Chattogram,Bangladesh,2009,2,188,300,5,1,931,1570,27,743,1270,22,34.48148148148148,>30,BAN,Home,Upto 2014
Shakib Al Hasan,BAN,Spin,2009-07-09,Kingstown,West Indies,2009,2,115,379,5,1,504,1195,18,389,816,13,28.0,<=30,WI,Away,Upto 2014
Shakib Al Hasan,BAN,Spin,2009-07-17,St George's,West Indies,2009,2,129,276,8,1,462,930,22,333,654,14,21.0,<=30,WI,Away,Upto 2014
Shakib Al Hasan,BAN,Spin,2010-01-17,Chattogram,Bangladesh,2010,2,174,341,7,1,565,949,23,391,608,16,24.565217391304348,<=30,BAN,Home,Upto 2014
Shakib Al Hasan,BAN,Spin,2010-01-24,Mirpur,Bangladesh,2010,2,118,206,2,1,600,1045,11,482,839,9,54.54545454545455,>30,BAN,Home,Upto 2014
Shakib Al Hasan,BAN,Spin,2010-02-15,Hamilton,New Zealand,2010,2,133,312,1,1,711,1173,10,578,861,9,71.1,>30,NZ,Away,Upto 2014
Shakib Al Hasan,BAN,Spin,2010-03-12,Chattogram,Bangladesh,2010,2,195,306,5,1,894,1491,22,699,1185,17,40.63636363636363,>30,BAN,Home,Upto 2014
Shakib Al Hasan,BAN,Spin,2010-03-20,Mirpur,Bangladesh,2010,2,155,444,4,1,865,1792,20,710,1348,16,43.25,>30,BAN,Home,Upto 2014
Shakib Al Hasan,BAN,Spin,2010-05-27,Lord's,England,2010,2,157,258,3,1,517,907,10,360,649,7,51.7,>30,ENG,Away,Upto 2014
Shakib Al Hasan,BAN,Spin,2010-06-04,Manchester,England,2010,1,121,225,5,1,455,779,14,334,554,9,32.5,>30,ENG,Away,Upto 2014
Shakib Al Hasan,BAN,Spin,2011-08-04,Harare,Zimbabwe,2011,2,122,264,4,1,318,704,9,196,440,5,35.333333333333336,>30,ZIM,Away,Upto 2014
Shakib Al Hasan,BAN,Spin,2011-10-21,Chattogram,Bangladesh,2011,2,87,144,4,1,473,864,18,386,720,14,26.27777777777778,<=30,BAN,Home,Upto 2014
Shakib Al Hasan,BAN,Spin,2011-10-29,Mirpur,Bangladesh,2011,2,142,334,6,1,846,1669,23,704,1335,17,36.78260869565217,>30,BAN,Home,Upto 2014
Shakib Al Hasan,BAN,Spin,2011-12-09,Chattogram,Bangladesh,2011,1,121,251,0,1,717,1447,18,596,1196,18,39.833333333333336,>30,BAN,Home,Upto 2014
Shakib Al Hasan,BAN,Spin,2011-12-17,Mirpur,Bangladesh,2011,2,129,305,7,1,690,1381,17,561,1076,10,40.588235294117645,>30,BAN,Home,Upto 2014
Shakib Al Hasan,BAN,Spin,2012-11-13,Mirpur,Bangladesh,2012,2,160,270,2,1,992,1679,19,832,1409,17,52.21052631578947,>30,BAN,Home,Upto 2014
Shakib Al Hasan,BAN,Spin,2012-11-21,Khulna,Bangladesh,2012,1,151,312,4,1,763,1327,11,612,1015,7,69.36363636363636,>30,BAN,Home,Upto 2014
Shakib Al Hasan,BAN,Spin,2013-04-17,Harare,Zimbabwe,2013,2,36,96,0,1,326,755,9,290,659,9,36.22222222222222,>30,ZIM,Away,Upto 2014
Shakib Al Hasan,BAN,Spin,2013-04-25,Harare,Zimbabwe,2013,2,118,183,4,1,425,789,13,307,606,9,32.69230769230769,>30,ZIM,Away,Upto 2014
Shakib Al Hasan,BAN,Spin,2013-10-09,Chattogram,Bangladesh,2013,2,108,198,2,1,1057,1946,22,949,1748,20,48.04545454545455,>30,BAN,Home,Upto 2014
Shakib Al Hasan,BAN,Spin,2013-10-21,Mirpur,Bangladesh,2013,1,103,258,5,1,460,965,12,357,707,7,38.333333333333336,>30,BAN,Home,Upto 2014
Shakib Al Hasan,BAN,Spin,2014-01-27,Mirpur,Bangladesh,2014,1,159,258,3,1,658,946,13,499,688,10,50.61538461538461,>30,BAN,Home,After 1965
Shakib Al Hasan,BAN,Spin,2014-02-04,Chattogram,Bangladesh,2014,2,228,336,6,1,1153,1976,25,925,1640,19,46.12,>30,BAN,Home,After 1965
Shakib Al Hasan,BAN,Spin,2014-10-25,Mirpur,Bangladesh,2014,2,103,209,7,1,460,898,22,357,689,15,20.90909090909091,<=30,BAN,Home,After 1965
Shakib Al Hasan,BAN,Spin,2014-11-03,Khulna,Bangladesh,2014,2,124,354,10,1,829,1764,29,705,1410,19,28.586206896551722,<=30,BAN,Home,After 1965
Shakib Al Hasan,BAN,Spin,2014-11-12,Chattogram,Bangladesh,2014,2,102,216,1,1,952,1674,19,850,1458,18,50.10526315789474,>30,BAN,Home,After 1965
Shakib Al Hasan,BAN,Spin,2015-04-28,Khulna,Bangladesh,2015,1,146,222,1,1,1092,1798,20,946,1576,19,54.6,>30,BAN,Home,After 1965
Shakib Al Hasan,BAN,Spin,2015-05-06,Mirpur,Bangladesh,2015,2,179,228,1,1,692,1014,18,513,786,17,38.44444444444444,>30,BAN,Home,After 1965
Shakib Al Hasan,BAN,Spin,2015-06-10,Fatullah,Bangladesh,2015,1,105,147,4,1,528,806,14,423,659,10,37.714285714285715,>30,BAN,Home,After 1965
Shakib Al Hasan,BAN,Spin,2015-07-21,Chattogram,Bangladesh,2015,2,64,114,1,1,318,607,10,254,493,9,31.8,>30,BAN,Home,After 1965
Shakib Al Hasan,BAN,Spin,2016-10-20,Chattogram,Bangladesh,2016,2,131,312,7,1,760,1579,30,629,1267,23,25.333333333333332,<=30,BAN,Home,After 1965
Shakib Al Hasan,BAN,Spin,2016-10-28,Mirpur,Bangladesh,2016,2,90,174,5,1,691,1258,32,601,1084,27,21.59375,<=30,BAN,Home,After 1965
Shakib Al Hasan,BAN,Spin,2017-01-12,Wellington,New Zealand,2017,2,108,222,2,1,423,748,8,315,526,6,52.875,>30,NZ,Away,After 1965
Shakib Al Hasan,BAN,Spin,2017-01-20,Christchurch,New Zealand,2017,2,78,100,4,1,177,254,6,99,154,2,29.5,<=30,NZ,Away,After 1965
Shakib Al Hasan,BAN,Spin,2017-02-09,Hyderabad,India,2017,2,154,198,2,1,881,1634,19,727,1436,17,46.36842105263158,>30,IND,Away,After 1965
Shakib Al Hasan,BAN,Spin,2017-03-07,Galle,Sri Lanka,2017,2,204,343,3,1,752,1277,25,548,934,22,30.08,>30,SL,Away,After 1965
Shakib Al Hasan,BAN,Spin,2017-03-15,Colombo (PSS),Sri Lanka,2017,2,154,416,6,1,916,1838,26,762,1422,20,35.23076923076923,>30,SL,Away,After 1965
Shakib Al Hasan,BAN,Spin,2017-08-27,Mirpur,Bangladesh,2017,2,153,323,10,1,693,1433,34,540,1110,24,20.38235294117647,<=30,BAN,Home,After 1965
Shakib Al Hasan,BAN,Spin,2017-09-04,Chattogram,Bangladesh,2017,2,117,222,2,1,709,1537,24,592,1315,22,29.541666666666668,<=30,BAN,Home,After 1965
Shakib Al Hasan,BAN,Spin,2018-07-04,North Sound,West Indies,2018,1,71,162,2,1,218,480,6,147,318,4,36.333333333333336,>30,WI,Away,After 1965
Shakib Al Hasan,BAN,Spin,2018-07-12,Kingston,West Indies,2018,2,93,234,6,1,399,810,18,306,576,12,22.166666666666668,<=30,WI,Away,After 1965
Shakib Al Hasan,BAN,Spin,2018-11-22,Chattogram,Bangladesh,2018,2,73,108,5,1,618,1097,34,545,989,29,18.176470588235293,<=30,BAN,Home,After 1965
Shakib Al Hasan,BAN,Spin,2018-11-30,Mirpur,Bangladesh,2018,2,92,178,4,1,676,1230,27,584,1052,23,25.037037037037038,<=30,BAN,Home,After 1965
Shakib Al Hasan,BAN,Spin,2019-09-05,Chattogram,Bangladesh,2019,2,122,246,5,1,903,1930,38,781,1684,33,23.763157894736842,<=30,BAN,Home,After 1965
Shakib Al Hasan,BAN,Spin,2021-02-03,Chattogram,Bangladesh,2021,1,16,36,0,1,955,2045,28,939,2009,28,34.107142857142854,>30,BAN,Home,After 1965
Shakib Al Hasan,BAN,Spin,2021-07-07,Harare,Zimbabwe,2021,2,126,359,5,1,544,1099,15,418,740,10,36.266666666666666,>30,ZIM,Away,After 1965
Shakib Al Hasan,BAN,Spin,2021-12-04,Mirpur,Bangladesh,2021,1,52,114,0,1,366,844,15,314,730,15,24.4,<=30,BAN,Home,After 1965
Shakib Al Hasan,BAN,Spin,2022-05-15,Chattogram,Bangladesh,2022,2,118,384,4,1,772,1873,17,654,1489,13,45.411764705882355,>30,BAN,Home,After 1965
Shakib Al Hasan,BAN,Spin,2022-05-23,Mirpur,Bangladesh,2022,2,103,247,5,1,553,1141,6,450,894,1,92.16666666666667,>30,BAN,Home,After 1965
Shakib Al Hasan,BAN,Spin,2022-06-16,North Sound,West Indies,2022,2,51,138,1,1,173,401,5,122,263,4,34.6,>30,WI,Away,After 1965
Shakib Al Hasan,BAN,Spin,2022-06-24,Gros Islet,West Indies,2022,1,46,108,0,1,137,342,3,91,234,3,45.666666666666664,>30,WI,Away,After 1965
Shakib Al Hasan,BAN,Spin,2022-12-14,Chattogram,Bangladesh,2022,1,26,72,0,1,800,1534,23,774,1462,23,34.78260869565217,>30,BAN,Home,After 1965
Shakib Al Hasan,BAN,Spin,2022-12-22,Mirpur,Bangladesh,2022,2,129,201,6,1,578,1084,25,449,883,19,23.12,<=30,BAN,Home,After 1965
Shakib Al Hasan,BAN,Spin,2023-04-04,Mirpur,Bangladesh,2023,2,34,96,2,1,595,1200,23,561,1104,21,25.869565217391305,<=30,BAN,Home,After 1965
Shakib Al Hasan,BAN,Spin,2024-03-30,Chattogram,Bangladesh,2024,2,149,282,4,1,649,1230,12,500,948,8,54.083333333333336,>30,BAN,Home,After 1965
Shakib Al Hasan,BAN,Spin,2024-08-21,Rawalpindi,Pakistan,2024,2,144,264,4,1,433,770,10,289,506,6,43.3,>30,PAK,Away,After 1965
Shakib Al Hasan,BAN,Spin,2024-08-30,Rawalpindi,Pakistan,2024,2,48,144,1,1,286,641,10,238,497,9,28.6,<=30,PAK,Away,After 1965
Shakib Al Hasan,BAN,Spin,2024-09-19,Chennai,India,2024,2,129,126,0,1,522,763,14,393,637,14,37.285714285714285,>30,IND,Away,After 1965
Shakib Al Hasan,BAN,Spin,2024-09-27,Kanpur,India,2024,2,96,84,4,1,428,548,20,332,464,16,21.4,<=30,IND,Away,After 1965
Shamsur Rahman,BAN,Spin,2014-02-04,Chattogram,Bangladesh,2014,1,5,6,0,1,1153,1976,25,1148,1970,25,46.12,>30,BAN,Home,After 1965
Shan Masood,PAK,Pace,2016-07-22,Manchester,England,2016,1,19,18,0,1,705,1279,22,686,1261,22,32.04545454545455,>30,ENG,Away,After 1965
Shan Masood,PAK,Pace,2017-09-28,Abu Dhabi,UAE,2017,1,0,6,0,1,437,1023,13,437,1017,13,33.61538461538461,>30,UAE,Away,After 1965
Shan Masood,PAK,Pace,2018-12-26,Centurion,South Africa,2018,1,6,18,1,1,620,1128,33,614,1110,32,18.78787878787879,<=30,SA,Away,After 1965
Shan Masood,PAK,Pace,2019-01-03,Cape Town,South Africa,2019,1,19,30,1,1,809,1380,31,790,1350,30,26.096774193548388,<=30,SA,Away,After 1965
Shan Masood,PAK,Pace,2019-12-11,Rawalpindi,Pakistan,2019,1,0,6,0,1,376,750,8,376,744,8,47.0,>30,PAK,Home,After 1965
Shan Masood,PAK,Pace,2020-08-13,Southampton,England,2020,1,14,18,0,1,292,740,12,278,722,12,24.333333333333332,<=30,ENG,Away,After 1965
Shan Masood,PAK,Pace,2020-08-21,Southampton,England,2020,1,11,18,0,1,619,1361,14,608,1343,14,44.214285714285715,>30,ENG,Away,After 1965
Shan Masood,PAK,Pace,2020-12-26,Mount Maunganui,New Zealand,2020,2,6,18,0,1,873,2105,28,867,2087,28,31.178571428571427,>30,NZ,Away,After 1965
Shan Masood,PAK,Pace,2021-01-03,Christchurch,New Zealand,2021,1,17,12,0,1,918,1730,25,901,1718,25,36.72,>30,NZ,Away,After 1965
Shoaib Akhtar,PAK,Pace,1997-11-29,Rawalpindi,Pakistan,1997,2,68,132,2,1,728,1434,26,660,1302,24,28.0,<=30,PAK,Home,Upto 2014
Shoaib Akhtar,PAK,Pace,1998-02-14,Johannesburg,South Africa,1998,2,106,156,1,1,551,982,15,445,826,14,36.733333333333334,>30,SA,Away,Upto 2014
Shoaib Akhtar,PAK,Pace,1998-02-26,Durban,South Africa,1998,2,63,138,5,1,733,1519,29,670,1381,24,25.275862068965516,<=30,SA,Away,Upto 2014
Shoaib Akhtar,PAK,Pace,1998-03-06,Gqeberha,South Africa,1998,2,88,174,0,1,625,1400,33,537,1226,33,18.939393939393938,<=30,SA,Away,Upto 2014
Shoaib Akhtar,PAK,Pace,1998-03-14,Bulawayo,Zimbabwe,1998,2,150,302,4,1,726,1690,25,576,1388,21,29.04,<=30,ZIM,Away,Upto 2014
Shoaib Akhtar,PAK,Pace,1998-10-15,Peshawar,Pakistan,1998,2,175,282,3,1,690,1183,11,515,901,8,62.72727272727273,>30,PAK,Home,Upto 2014
Shoaib Akhtar,PAK,Pace,1998-10-22,Karachi,Pakistan,1998,2,76,188,2,1,309,770,9,233,582,7,34.333333333333336,>30,PAK,Home,Upto 2014
Shoaib Akhtar,PAK,Pace,1998-12-10,Lahore,Pakistan,1998,2,63,120,1,1,457,1020,11,394,900,10,41.54545454545455,>30,PAK,Home,Upto 2014
Shoaib Akhtar,PAK,Pace,1999-02-16,Eden Gardens,India,1999,2,118,237,8,1,539,1227,30,421,990,22,17.966666666666665,<=30,IND,Away,Upto 2014
Shoaib Akhtar,PAK,Pace,1999-03-12,Dhaka,Bangladesh,1999,2,62,142,2,1,404,794,8,342,652,6,50.5,>30,BAN,Away,Upto 2014
Shoaib Akhtar,PAK,Pace,1999-11-05,Brisbane,Australia,1999,2,178,222,4,1,895,1510,23,717,1288,19,38.91304347826087,>30,AUS,Away,Upto 2014
Shoaib Akhtar,PAK,Pace,1999-11-18,Hobart,Australia,1999,2,154,240,1,1,857,1577,19,703,1337,18,45.10526315789474,>30,AUS,Away,Upto 2014
Shoaib Akhtar,PAK,Pace,1999-11-26,W.A.C.A,Australia,1999,1,74,96,1,1,717,1143,27,643,1047,26,26.555555555555557,<=30,AUS,Away,Upto 2014
Shoaib Akhtar,PAK,Pace,2000-03-05,Peshawar,Pakistan,2000,2,122,221,7,1,480,1060,20,358,839,13,24.0,<=30,PAK,Home,Upto 2014
Shoaib Akhtar,PAK,Pace,2000-03-12,Karachi,Pakistan,2000,2,116,186,4,1,750,1272,22,634,1086,18,34.09090909090909,>30,PAK,Home,Upto 2014
Shoaib Akhtar,PAK,Pace,2001-05-17,Lord's,England,2001,1,64,114,1,1,714,1443,30,650,1329,29,23.8,<=30,ENG,Away,Upto 2014
Shoaib Akhtar,PAK,Pace,2002-01-16,Chattogram,Bangladesh,2002,2,63,102,4,1,326,664,15,263,562,11,21.733333333333334,<=30,BAN,Away,Upto 2014
Shoaib Akhtar,PAK,Pace,2002-01-31,Sharjah,UAE,2002,2,92,204,5,1,822,1590,24,730,1386,19,34.25,>30,UAE,Away,Upto 2014
Shoaib Akhtar,PAK,Pace,2002-02-07,Sharjah,UAE,2002,2,86,156,5,1,615,1212,24,529,1056,19,25.625,<=30,UAE,Away,Upto 2014
Shoaib Akhtar,PAK,Pace,2002-03-06,Lahore,Pakistan,2002,2,131,182,3,1,853,1374,23,722,1192,20,37.08695652173913,>30,PAK,Home,Upto 2014
Shoaib Akhtar,PAK,Pace,2002-05-01,Lahore,Pakistan,2002,1,11,50,6,1,476,866,17,465,816,11,28.0,<=30,PAK,Home,Upto 2014
Shoaib Akhtar,PAK,Pace,2002-10-03,Colombo (PSS),Sri Lanka,2002,2,72,174,8,1,672,1175,21,600,1001,13,32.0,>30,SL,Away,Upto 2014
Shoaib Akhtar,PAK,Pace,2002-10-11,Sharjah,UAE,2002,1,42,84,1,1,167,426,14,125,342,13,11.928571428571429,<=30,UAE,Away,Upto 2014
Shoaib Akhtar,PAK,Pace,2002-11-09,Harare,Zimbabwe,2002,2,118,200,7,1,875,1422,31,757,1222,24,28.225806451612904,<=30,ZIM,Away,Upto 2014
Shoaib Akhtar,PAK,Pace,2002-11-16,Bulawayo,Zimbabwe,2002,2,100,168,3,1,555,1011,16,455,843,13,34.6875,>30,ZIM,Away,Upto 2014
Shoaib Akhtar,PAK,Pace,2003-08-20,Karachi,Pakistan,2003,2,115,258,3,1,660,1252,19,545,994,16,34.73684210526316,>30,PAK,Home,Upto 2014
Shoaib Akhtar,PAK,Pace,2003-08-27,Peshawar,Pakistan,2003,2,80,209,10,1,501,1075,20,421,866,10,25.05,<=30,PAK,Home,Upto 2014
Shoaib Akhtar,PAK,Pace,2003-10-17,Lahore,Pakistan,2003,2,98,171,6,1,569,1080,10,471,909,4,56.9,>30,PAK,Home,Upto 2014
Shoaib Akhtar,PAK,Pace,2003-12-26,Wellington,New Zealand,2003,2,78,231,11,1,696,1646,29,618,1415,18,24.0,<=30,NZ,Away,Upto 2014
Shoaib Akhtar,PAK,Pace,2004-03-28,Multan,Pakistan,2004,1,119,192,0,1,716,1290,10,597,1098,10,71.6,>30,PAK,Home,Upto 2014
Shoaib Akhtar,PAK,Pace,2004-04-05,Lahore,Pakistan,2004,2,131,198,4,1,744,1284,22,613,1086,18,33.81818181818182,>30,PAK,Home,Upto 2014
Shoaib Akhtar,PAK,Pace,2004-04-13,Rawalpindi,Pakistan,2004,1,47,128,3,1,687,1266,18,640,1138,15,38.166666666666664,>30,PAK,Home,Upto 2014
Shoaib Akhtar,PAK,Pace,2004-10-20,Faisalabad,Pakistan,2004,2,175,264,8,1,726,1252,21,551,988,13,34.57142857142857,>30,PAK,Home,Upto 2014
Shoaib Akhtar,PAK,Pace,2004-12-16,W.A.C.A,Australia,2004,2,121,171,6,1,677,1213,30,556,1042,24,22.566666666666666,<=30,AUS,Away,Upto 2014
Shoaib Akhtar,PAK,Pace,2004-12-26,Melbourne,Australia,2004,2,144,204,5,1,584,1094,18,440,890,13,32.44444444444444,>30,AUS,Away,Upto 2014
Shoaib Akhtar,PAK,Pace,2005-01-02,Sydney,Australia,2005,1,69,90,0,1,541,846,9,472,756,9,60.111111111111114,>30,AUS,Away,Upto 2014
Shoaib Akhtar,PAK,Pace,2005-11-12,Multan,Pakistan,2005,2,148,238,6,1,730,1407,32,582,1169,26,22.8125,<=30,PAK,Home,Upto 2014
Shoaib Akhtar,PAK,Pace,2005-11-20,Faisalabad,Pakistan,2005,2,154,228,5,1,802,1439,26,648,1211,21,30.846153846153847,>30,PAK,Home,Upto 2014
Shoaib Akhtar,PAK,Pace,2005-11-29,Lahore,Pakistan,2005,2,116,246,6,1,870,1496,17,754,1250,11,51.1764705882353,>30,PAK,Home,Upto 2014
Shoaib Akhtar,PAK,Pace,2006-01-13,Lahore,Pakistan,2006,1,46,98,0,1,476,638,4,430,540,4,119.0,>30,PAK,Home,Upto 2014
Shoaib Akhtar,PAK,Pace,2006-01-21,Faisalabad,Pakistan,2006,1,100,150,1,1,888,1366,17,788,1216,16,52.23529411764706,>30,PAK,Home,Upto 2014
Shoaib Akhtar,PAK,Pace,2006-01-29,Karachi,Pakistan,2006,2,107,144,3,1,991,1398,31,884,1254,28,31.967741935483872,>30,PAK,Home,Upto 2014
Shoaib Akhtar,PAK,Pace,2007-01-19,Gqeberha,South Africa,2007,1,36,66,4,1,653,1296,27,617,1230,23,24.185185185185187,<=30,SA,Away,Upto 2014
Shoaib Akhtar,PAK,Pace,2007-11-22,Delhi,India,2007,2,102,205,6,1,485,979,16,383,774,10,30.3125,>30,IND,Away,Upto 2014
Shoaib Akhtar,PAK,Pace,2007-11-30,Eden Gardens,India,2007,2,130,220,2,1,574,936,5,444,716,3,114.8,>30,IND,Away,Upto 2014
Shoaib Akhtar,PAK,Pace,2007-12-08,Bengaluru,India,2007,2,66,162,1,1,758,1372,19,692,1210,18,39.89473684210526,>30,IND,Away,Upto 2014
Shoaib Bashir,ENG,Spin,2024-02-02,Visakhapatnam,India,2024,2,196,318,4,1,935,1413,24,739,1095,20,38.958333333333336,>30,IND,Away,After 1965
Shoaib Bashir,ENG,Spin,2024-02-23,Ranchi,India,2024,2,198,420,8,1,670,1494,28,472,1074,20,23.928571428571427,<=30,IND,Away,After 1965
Shoaib Bashir,ENG,Spin,2024-03-07,Dharamsala,India,2024,1,173,277,5,1,589,972,25,416,695,20,23.56,<=30,IND,Away,After 1965
Shoaib Bashir,ENG,Spin,2024-07-18,Nottingham,England,2024,2,149,217,7,1,371,520,12,222,303,5,30.916666666666668,>30,ENG,Home,After 1965
Shoaib Bashir,ENG,Spin,2024-07-26,Birmingham,England,2024,2,96,151,2,1,163,267,3,67,116,1,54.333333333333336,>30,ENG,Home,After 1965
Shoaib Bashir,ENG,Spin,2024-08-21,Manchester,England,2024,2,132,258,3,1,370,678,9,238,420,6,41.111111111111114,>30,ENG,Home,After 1965
Shoaib Bashir,ENG,Spin,2024-08-29,Lord's,England,2024,2,99,180,2,1,342,540,5,243,360,3,68.4,>30,ENG,Home,After 1965
Shoaib Bashir,ENG,Spin,2024-09-06,The Oval,England,2024,2,65,89,1,1,123,161,3,58,72,2,41.0,>30,ENG,Home,After 1965
Shoaib Bashir,ENG,Spin,2024-10-07,Multan,Pakistan,2024,2,156,228,1,1,918,1193,16,762,965,15,57.375,>30,PAK,Away,After 1965
Shoaib Bashir,ENG,Spin,2024-10-15,Multan,Pakistan,2024,2,151,282,5,1,831,1418,37,680,1136,32,22.45945945945946,<=30,PAK,Away,After 1965
Shoaib Bashir,ENG,Spin,2024-10-24,Rawalpindi,Pakistan,2024,2,139,205,3,1,719,1161,29,580,956,26,24.79310344827586,<=30,PAK,Away,After 1965
Shoaib Bashir,ENG,Spin,2024-11-28,Christchurch,New Zealand,2024,2,134,192,4,1,459,659,17,325,467,13,27.0,<=30,NZ,Away,After 1965
Shoaib Bashir,ENG,Spin,2024-12-06,Wellington,New Zealand,2024,1,110,114,2,1,476,526,13,366,412,11,36.61538461538461,>30,NZ,Away,After 1965
Shoaib Bashir,ENG,Spin,2024-12-14,Hamilton,New Zealand,2024,1,170,216,2,1,463,592,15,293,376,13,30.866666666666667,>30,NZ,Away,After 1965
Shoaib Malik,PAK,Spin,2001-08-29,Multan,Pakistan,2001,2,26,37,2,1,304,445,14,278,408,12,21.714285714285715,<=30,PAK,Home,Upto 2014
Shoaib Malik,PAK,Spin,2002-03-06,Lahore,Pakistan,2002,1,55,84,0,1,240,516,8,185,432,8,30.0,<=30,PAK,Home,Upto 2014
Shoaib Malik,PAK,Spin,2003-08-27,Peshawar,Pakistan,2003,1,27,72,0,1,404,889,11,377,817,11,36.72727272727273,>30,PAK,Home,Upto 2014
Shoaib Malik,PAK,Spin,2003-10-17,Lahore,Pakistan,2003,2,94,186,4,1,515,1054,21,421,868,17,24.523809523809526,<=30,PAK,Home,Upto 2014
Shoaib Malik,PAK,Spin,2003-10-24,Faisalabad,Pakistan,2003,2,89,186,1,1,613,1195,9,524,1009,8,68.11111111111111,>30,PAK,Home,Upto 2014
Shoaib Malik,PAK,Spin,2004-10-20,Faisalabad,Pakistan,2004,2,81,120,1,1,395,875,14,314,755,13,28.214285714285715,<=30,PAK,Home,Upto 2014
Shoaib Malik,PAK,Spin,2004-10-28,Karachi,Pakistan,2004,1,45,96,0,1,509,1056,15,464,960,15,33.93333333333333,>30,PAK,Home,Upto 2014
Shoaib Malik,PAK,Spin,2005-06-03,Kingston,West Indies,2005,1,52,114,0,1,374,708,11,322,594,11,34.0,>30,WI,Away,Upto 2014
Shoaib Malik,PAK,Spin,2005-11-12,Multan,Pakistan,2005,2,65,114,1,1,438,798,8,373,684,7,54.75,>30,PAK,Home,Upto 2014
Shoaib Malik,PAK,Spin,2005-11-20,Faisalabad,Pakistan,2005,1,29,24,0,1,496,897,7,467,873,7,70.85714285714286,>30,PAK,Home,Upto 2014
Shoaib Malik,PAK,Spin,2005-11-29,Lahore,Pakistan,2005,2,67,108,3,1,258,469,10,191,361,7,25.8,<=30,PAK,Home,Upto 2014
Shoaib Malik,PAK,Spin,2006-01-13,Lahore,Pakistan,2006,1,70,72,0,1,588,687,2,518,615,2,294.0,>30,PAK,Home,Upto 2014
Shoaib Malik,PAK,Spin,2006-03-26,Colombo (SSC),Sri Lanka,2006,1,48,90,1,1,538,1125,13,490,1035,12,41.38461538461539,>30,SL,Away,Upto 2014
Shoaib Malik,PAK,Spin,2006-11-11,Lahore,Pakistan,2006,2,25,42,0,1,296,600,9,271,558,9,32.888888888888886,>30,PAK,Home,Upto 2014
Shoaib Malik,PAK,Spin,2006-11-19,Multan,Pakistan,2006,1,47,78,0,1,610,1072,9,563,994,9,67.77777777777777,>30,PAK,Home,Upto 2014
Shoaib Malik,PAK,Spin,2006-11-27,Karachi,Pakistan,2006,1,0,6,0,1,303,725,10,303,719,10,30.3,>30,PAK,Home,Upto 2014
Shoaib Malik,PAK,Spin,2007-10-01,Karachi,Pakistan,2007,1,31,48,0,1,692,1416,21,661,1368,21,32.95238095238095,>30,PAK,Home,Upto 2014
Shoaib Malik,PAK,Spin,2007-10-08,Lahore,Pakistan,2007,1,20,30,0,1,512,1276,13,492,1246,13,39.38461538461539,>30,PAK,Home,Upto 2014
Shoaib Malik,PAK,Spin,2009-02-21,Karachi,Pakistan,2009,2,143,222,2,1,883,1568,9,740,1346,7,98.11111111111111,>30,PAK,Home,Upto 2014
Shoaib Malik,PAK,Spin,2009-03-01,Lahore,Pakistan,2009,1,80,168,0,1,316,544,0,236,376,0,inf,>30,PAK,Home,Upto 2014
Shoaib Malik,PAK,Spin,2009-07-04,Galle,Sri Lanka,2009,1,8,18,0,1,354,709,16,346,691,16,22.125,<=30,SL,Away,Upto 2014
Shoaib Malik,PAK,Spin,2009-07-12,Colombo (PSS),Sri Lanka,2009,1,13,11,1,1,425,767,15,412,756,14,28.333333333333332,<=30,SL,Away,Upto 2014
Shoaib Malik,PAK,Spin,2009-07-20,Colombo (SSC),Sri Lanka,2009,1,38,84,1,1,647,1311,18,609,1227,17,35.94444444444444,>30,SL,Away,Upto 2014
Shoaib Malik,PAK,Spin,2009-12-03,Wellington,New Zealand,2009,1,5,6,0,1,206,510,10,201,504,10,20.6,<=30,NZ,Away,Upto 2014
Shoaib Malik,PAK,Spin,2010-01-14,Hobart,Australia,2010,2,43,70,2,1,458,793,15,415,723,13,30.533333333333335,>30,AUS,Away,Upto 2014
Shoaib Malik,PAK,Spin,2010-07-29,Nottingham,England,2010,2,70,129,2,1,267,351,3,197,222,1,89.0,>30,ENG,Away,Upto 2014
Shoaib Malik,PAK,Spin,2010-08-06,Birmingham,England,2010,1,20,30,0,1,211,502,11,191,472,11,19.181818181818183,<=30,ENG,Away,Upto 2014
Shoaib Malik,PAK,Spin,2015-10-13,Abu Dhabi,UAE,2015,2,122,234,4,1,740,1307,14,618,1073,10,52.857142857142854,>30,UAE,Away,After 1965
Shoaib Malik,PAK,Spin,2015-10-22,Dubai (DICS),UAE,2015,2,47,84,0,1,700,1353,17,653,1269,17,41.1764705882353,>30,UAE,Away,After 1965
Shoaib Malik,PAK,Spin,2015-11-01,Sharjah,UAE,2015,2,59,149,7,1,743,1504,24,684,1355,17,30.958333333333332,>30,UAE,Away,After 1965
Shoaib Mohammad,PAK,Spin,1985-01-18,Wellington,New Zealand,1985,1,4,6,0,1,422,1002,10,418,996,10,42.2,>30,NZ,Away,Upto 2014
Shoaib Mohammad,PAK,Spin,1985-10-16,Faisalabad,Pakistan,1985,1,4,12,0,1,278,675,3,274,663,3,92.66666666666667,>30,PAK,Home,Upto 2014
Shoaib Mohammad,PAK,Spin,1987-02-03,Chennai,India,1987,1,13,18,0,1,827,1860,14,814,1842,14,59.07142857142857,>30,IND,Away,Upto 2014
Shoaib Mohammad,PAK,Spin,1987-02-21,Jaipur,India,1987,2,19,36,1,1,591,1283,13,572,1247,12,45.46153846153846,>30,IND,Away,Upto 2014
Shoaib Mohammad,PAK,Spin,1987-12-07,Faisalabad,Pakistan,1987,1,0,6,0,1,479,1253,22,479,1247,22,21.772727272727273,<=30,PAK,Home,Upto 2014
Shoaib Mohammad,PAK,Spin,1988-04-02,Georgetown,West Indies,1988,1,8,12,2,1,306,558,9,298,546,7,34.0,>30,WI,Away,Upto 2014
Shoaib Mohammad,PAK,Spin,1988-04-14,Port of Spain,West Indies,1988,1,8,18,0,1,344,563,11,336,545,11,31.272727272727273,>30,WI,Away,Upto 2014
Shoaib Mohammad,PAK,Spin,1988-04-22,Bridgetown,West Indies,1988,1,6,18,0,1,257,510,4,251,492,4,64.25,>30,WI,Away,Upto 2014
Shoaib Mohammad,PAK,Spin,1988-09-15,Karachi,Pakistan,1988,1,1,12,0,1,427,1461,22,426,1449,22,19.40909090909091,<=30,PAK,Home,Upto 2014
Shoaib Mohammad,PAK,Spin,1988-09-23,Faisalabad,Pakistan,1988,1,2,6,1,1,520,1112,15,518,1106,14,34.666666666666664,>30,PAK,Home,Upto 2014
Shoaib Mohammad,PAK,Spin,1988-10-07,Lahore,Pakistan,1988,1,4,6,0,1,510,1394,19,506,1388,19,26.842105263157894,<=30,PAK,Home,Upto 2014
Shoaib Mohammad,PAK,Spin,1989-02-24,Auckland,New Zealand,1989,2,6,18,0,1,705,1609,10,699,1591,10,70.5,>30,NZ,Away,Upto 2014
Shoaib Mohammad,PAK,Spin,1989-11-23,Faisalabad,Pakistan,1989,1,7,18,0,1,216,414,1,209,396,1,216.0,>30,PAK,Home,Upto 2014
Shoaib Mohammad,PAK,Spin,1989-12-09,Sialkot,Pakistan,1989,1,0,6,0,1,4,24,0,4,18,0,inf,>30,PAK,Home,Upto 2014
Shoaib Mohammad,PAK,Spin,1990-01-19,Adelaide,Australia,1990,1,7,6,0,1,427,941,7,420,935,7,61.0,>30,AUS,Away,Upto 2014
Shoaib Mohammad,PAK,Spin,1990-10-18,Lahore,Pakistan,1990,1,8,12,0,1,149,339,4,141,327,4,37.25,>30,PAK,Home,Upto 2014
Shoaib Mohammad,PAK,Spin,1990-11-15,Karachi,Pakistan,1990,1,15,36,1,1,289,648,5,274,612,4,57.8,>30,PAK,Home,Upto 2014
Shoaib Mohammad,PAK,Spin,1990-12-06,Lahore,Pakistan,1990,1,1,6,0,1,232,389,5,231,383,5,46.4,>30,PAK,Home,Upto 2014
Shoaib Mohammad,PAK,Spin,1993-12-01,Karachi,Pakistan,1993,1,1,6,0,1,291,834,6,290,828,6,48.5,>30,PAK,Home,Upto 2014
Shoaib Mohammad,PAK,Spin,1993-12-09,Rawalpindi,Pakistan,1993,1,16,24,0,1,59,150,0,43,126,0,inf,>30,PAK,Home,Upto 2014
Shoaib Mohammad,PAK,Spin,1995-09-15,Faisalabad,Pakistan,1995,2,19,42,0,1,624,1381,17,605,1339,17,36.705882352941174,>30,PAK,Home,Upto 2014
Shoaib Mohammad,PAK,Spin,1995-09-22,Sialkot,Pakistan,1995,2,21,72,0,1,336,832,11,315,760,11,30.545454545454547,>30,PAK,Home,Upto 2014
Shoriful Islam,BAN,Pace,2021-04-29,Pallekele,Sri Lanka,2021,2,99,180,1,1,391,680,8,292,500,7,48.875,>30,SL,Away,After 1965
Shoriful Islam,BAN,Pace,2022-01-01,Mount Maunganui,New Zealand,2022,2,99,228,3,1,752,1693,25,653,1465,22,30.08,>30,NZ,Away,After 1965
Shoriful Islam,BAN,Pace,2022-01-09,Christchurch,New Zealand,2022,1,79,168,2,1,738,1267,23,659,1099,21,32.08695652173913,>30,NZ,Away,After 1965
Shoriful Islam,BAN,Pace,2022-05-15,Chattogram,Bangladesh,2022,1,55,120,0,1,332,607,7,277,487,7,47.42857142857143,>30,BAN,Home,After 1965
Shoriful Islam,BAN,Pace,2022-06-24,Gros Islet,West Indies,2022,1,76,114,2,1,658,1090,26,582,976,24,25.307692307692307,<=30,WI,Away,After 1965
Shoriful Islam,BAN,Pace,2023-04-04,Mirpur,Bangladesh,2023,2,57,96,2,1,400,606,10,343,510,8,40.0,>30,BAN,Home,After 1965
Shoriful Islam,BAN,Pace,2023-06-14,Mirpur,Bangladesh,2023,2,56,108,5,1,553,731,21,497,623,16,26.333333333333332,<=30,BAN,Home,After 1965
Shoriful Islam,BAN,Pace,2023-11-28,Sylhet,Bangladesh,2023,2,67,114,2,1,222,475,6,155,361,4,37.0,>30,BAN,Home,After 1965
Shoriful Islam,BAN,Pace,2023-12-06,Mirpur,Bangladesh,2023,2,24,54,3,1,57,146,5,33,92,2,11.4,<=30,BAN,Home,After 1965
Shoriful Islam,BAN,Pace,2024-03-22,Sylhet,Bangladesh,2024,2,134,210,2,1,733,1127,31,599,917,29,23.64516129032258,<=30,BAN,Home,After 1965
Shoriful Islam,BAN,Pace,2024-08-21,Rawalpindi,Pakistan,2024,2,97,204,3,1,696,1287,16,599,1083,13,43.5,>30,PAK,Away,After 1965
Shoriful Islam,BAN,Pace,2024-11-22,North Sound,West Indies,2024,2,62,150,1,1,670,1327,30,608,1177,29,22.333333333333332,<=30,WI,Away,After 1965
Shubman Gill,IND,Spin,2023-03-09,Ahmedabad,India,2023,1,1,7,0,1,725,1892,17,724,1885,17,42.64705882352941,>30,IND,Home,After 1965
Shujauddin,PAK,Spin,1954-07-22,Manchester,England,1954,1,127,288,3,1,192,600,11,65,312,8,17.454545454545453,<=30,ENG,Away,Upto 2014
Shujauddin,PAK,Spin,1954-08-12,The Oval,England,1954,2,33,78,1,1,187,540,10,154,462,9,18.7,<=30,ENG,Away,Upto 2014
Shujauddin,PAK,Spin,1955-01-01,Dhaka,Bangladesh,1955,2,32,108,0,1,438,1378,15,406,1270,15,29.2,<=30,BAN,Away,Upto 2014
Shujauddin,PAK,Spin,1955-01-15,Bahawalpur,Pakistan,1955,2,12,102,0,1,306,1050,8,294,948,8,38.25,>30,PAK,Home,Upto 2014
Shujauddin,PAK,Spin,1955-01-29,Lahore,Pakistan,1955,2,33,78,1,1,591,2024,18,558,1946,17,32.833333333333336,>30,PAK,Home,Upto 2014
Shujauddin,PAK,Spin,1955-10-13,Karachi,Pakistan,1955,2,35,198,4,1,294,1463,19,259,1265,15,15.473684210526315,<=30,PAK,Home,Upto 2014
Shujauddin,PAK,Spin,1955-10-26,Lahore,Pakistan,1955,2,163,486,2,1,672,1787,23,509,1301,21,29.217391304347824,<=30,PAK,Home,Upto 2014
Shujauddin,PAK,Spin,1955-11-07,Dhaka,Bangladesh,1955,1,1,54,0,1,131,558,6,130,504,6,21.833333333333332,<=30,BAN,Away,Upto 2014
Shujauddin,PAK,Spin,1959-02-20,Karachi,Pakistan,1959,1,18,78,3,1,375,1262,15,357,1184,12,25.0,<=30,PAK,Home,Upto 2014
Shujauddin,PAK,Spin,1959-03-06,Dhaka,Bangladesh,1959,1,13,36,0,1,170,591,9,157,555,9,18.88888888888889,<=30,BAN,Away,Upto 2014
Shujauddin,PAK,Spin,1959-03-26,Lahore,Pakistan,1959,1,81,207,2,1,360,902,15,279,695,13,24.0,<=30,PAK,Home,Upto 2014
Shujauddin,PAK,Spin,1959-11-13,Dhaka,Bangladesh,1959,2,21,66,0,1,203,699,11,182,633,11,18.454545454545453,<=30,BAN,Away,Upto 2014
Shujauddin,PAK,Spin,1959-11-21,Lahore,Pakistan,1959,2,74,138,1,1,563,1378,18,489,1240,17,31.27777777777778,>30,PAK,Home,Upto 2014
Shujauddin,PAK,Spin,1959-12-04,Karachi,Pakistan,1959,2,22,30,0,1,235,677,9,213,647,9,26.11111111111111,<=30,PAK,Home,Upto 2014
Shujauddin,PAK,Spin,1962-01-19,Dhaka,Bangladesh,1962,1,73,204,3,1,862,2494,25,789,2290,22,34.48,>30,BAN,Away,Upto 2014
Shujauddin,PAK,Spin,1962-02-02,Karachi,Pakistan,1962,1,63,162,0,1,769,2063,17,706,1901,17,45.23529411764706,>30,PAK,Home,Upto 2014
Shuvagata Hom,BAN,Spin,2014-09-05,Kingstown,West Indies,2014,1,104,222,1,1,510,1180,16,406,958,15,31.875,>30,WI,Away,After 1965
Shuvagata Hom,BAN,Spin,2014-11-03,Khulna,Bangladesh,2014,2,36,66,0,1,829,1764,29,793,1698,29,28.586206896551722,<=30,BAN,Home,After 1965
Shuvagata Hom,BAN,Spin,2014-11-12,Chattogram,Bangladesh,2014,2,67,102,2,1,952,1674,19,885,1572,17,50.10526315789474,>30,BAN,Home,After 1965
Shuvagata Hom,BAN,Spin,2015-04-28,Khulna,Bangladesh,2015,1,120,204,2,1,1092,1798,20,972,1594,18,54.6,>30,BAN,Home,After 1965
Shuvagata Hom,BAN,Spin,2015-05-06,Mirpur,Bangladesh,2015,2,94,108,3,1,692,1014,18,598,906,15,38.44444444444444,>30,BAN,Home,After 1965
Shuvagata Hom,BAN,Spin,2015-06-10,Fatullah,Bangladesh,2015,1,52,84,0,1,528,806,14,476,722,14,37.714285714285715,>30,BAN,Home,After 1965
Shuvagata Hom,BAN,Spin,2016-10-28,Mirpur,Bangladesh,2016,2,33,60,0,1,691,1258,32,658,1198,32,21.59375,<=30,BAN,Home,After 1965
Sikandar Raza,ZIM,Spin,2014-10-25,Mirpur,Bangladesh,2014,2,13,24,1,1,460,898,22,447,874,21,20.90909090909091,<=30,BAN,Away,After 1965
Sikandar Raza,ZIM,Spin,2014-11-03,Khulna,Bangladesh,2014,2,53,102,0,1,829,1764,29,776,1662,29,28.586206896551722,<=30,BAN,Away,After 1965
Sikandar Raza,ZIM,Spin,2014-11-12,Chattogram,Bangladesh,2014,2,237,366,4,1,952,1674,19,715,1308,15,50.10526315789474,>30,BAN,Away,After 1965
Sikandar Raza,ZIM,Spin,2016-07-28,Bulawayo,Zimbabwe,2016,1,106,155,1,1,461,827,6,355,672,5,76.83333333333333,>30,ZIM,Home,After 1965
Sikandar Raza,ZIM,Spin,2016-08-06,Bulawayo,Zimbabwe,2016,1,17,24,0,1,624,1160,15,607,1136,15,41.6,>30,ZIM,Home,After 1965
Sikandar Raza,ZIM,Spin,2017-07-14,Colombo (RPS),Sri Lanka,2017,2,118,186,0,1,1059,1917,28,941,1731,28,37.82142857142857,>30,SL,Away,After 1965
Sikandar Raza,ZIM,Spin,2017-10-21,Bulawayo,Zimbabwe,2017,2,95,180,2,1,674,1311,28,579,1131,26,24.071428571428573,<=30,ZIM,Home,After 1965
Sikandar Raza,ZIM,Spin,2017-10-29,Bulawayo,Zimbabwe,2017,1,99,288,5,1,706,1640,15,607,1352,10,47.06666666666667,>30,ZIM,Home,After 1965
Sikandar Raza,ZIM,Spin,2017-12-26,Gqeberha,South Africa,2017,1,25,30,0,1,150,243,7,125,213,7,21.428571428571427,<=30,SA,Away,After 1965
Sikandar Raza,ZIM,Spin,2018-11-03,Sylhet,Bangladesh,2018,2,76,174,6,1,549,1328,32,473,1154,26,17.15625,<=30,BAN,Away,After 1965
Sikandar Raza,ZIM,Spin,2018-11-11,Mirpur,Bangladesh,2018,2,150,174,1,1,819,1414,17,669,1240,16,48.1764705882353,>30,BAN,Away,After 1965
Sikandar Raza,ZIM,Spin,2020-01-19,Harare,Zimbabwe,2020,1,62,96,3,1,523,1058,12,461,962,9,43.583333333333336,>30,ZIM,Home,After 1965
Sikandar Raza,ZIM,Spin,2020-01-27,Harare,Zimbabwe,2020,2,176,450,8,1,658,1179,17,482,729,9,38.705882352941174,>30,ZIM,Home,After 1965
Sikandar Raza,ZIM,Spin,2020-02-22,Mirpur,Bangladesh,2020,1,111,180,1,1,601,1116,18,490,936,17,33.388888888888886,>30,BAN,Away,After 1965
Sikandar Raza,ZIM,Spin,2021-03-02,Abu Dhabi,UAE,2021,2,24,42,1,1,274,533,12,250,491,11,22.833333333333332,<=30,UAE,Away,After 1965
Sikandar Raza,ZIM,Spin,2021-03-10,Abu Dhabi,UAE,2021,1,79,186,1,1,842,1766,20,763,1580,19,42.1,>30,UAE,Away,After 1965
Sikandar Raza,ZIM,Spin,2025-01-02,Bulawayo,Zimbabwe,2025,2,109,252,4,1,588,1149,23,479,897,19,25.565217391304348,<=30,ZIM,Home,After 1965
Sikander Bakht,PAK,Pace,1976-10-30,Karachi,Pakistan,1976,2,106,192,3,1,1003,1506,20,897,1314,17,50.15,>30,PAK,Home,Upto 2014
Sikander Bakht,PAK,Pace,1977-04-15,Kingston,West Indies,1977,2,126,168,5,1,849,1372,30,723,1204,25,28.3,<=30,WI,Away,Upto 2014
Sikander Bakht,PAK,Pace,1978-01-02,Hyderabad (Sind),Pakistan,1978,2,57,208,0,1,260,806,5,203,598,5,52.0,>30,PAK,Home,Upto 2014
Sikander Bakht,PAK,Pace,1978-01-18,Karachi,Pakistan,1978,2,79,256,3,1,226,792,5,147,536,2,45.2,>30,PAK,Home,Upto 2014
Sikander Bakht,PAK,Pace,1978-06-01,Birmingham,England,1978,1,132,270,4,1,618,1454,19,486,1184,15,32.526315789473685,>30,ENG,Away,Upto 2014
Sikander Bakht,PAK,Pace,1978-06-15,Lord's,England,1978,1,115,162,2,1,397,739,22,282,577,20,18.045454545454547,<=30,ENG,Away,Upto 2014
Sikander Bakht,PAK,Pace,1978-06-29,Leeds,England,1978,1,26,90,1,1,225,754,16,199,664,15,14.0625,<=30,ENG,Away,Upto 2014
Sikander Bakht,PAK,Pace,1978-10-16,Faisalabad,Pakistan,1978,1,86,144,0,1,508,904,5,422,760,5,101.6,>30,PAK,Home,Upto 2014
Sikander Bakht,PAK,Pace,1978-11-14,Karachi,Pakistan,1978,2,118,192,3,1,801,1525,25,683,1333,22,32.04,>30,PAK,Home,Upto 2014
Sikander Bakht,PAK,Pace,1979-02-02,Christchurch,New Zealand,1979,2,102,216,4,1,652,1680,19,550,1464,15,34.31578947368421,>30,NZ,Away,Upto 2014
Sikander Bakht,PAK,Pace,1979-02-16,Napier,New Zealand,1979,1,67,136,4,1,699,1749,19,632,1613,15,36.78947368421053,>30,NZ,Away,Upto 2014
Sikander Bakht,PAK,Pace,1979-02-23,Auckland,New Zealand,1979,2,132,272,4,1,754,1863,27,622,1591,23,27.925925925925927,<=30,NZ,Away,Upto 2014
Sikander Bakht,PAK,Pace,1979-03-10,Melbourne,Australia,1979,2,58,136,0,1,679,1863,29,621,1727,29,23.413793103448278,<=30,AUS,Away,Upto 2014
Sikander Bakht,PAK,Pace,1979-03-24,W.A.C.A,Australia,1979,1,33,85,1,1,924,2172,25,891,2087,24,36.96,>30,AUS,Away,Upto 2014
Sikander Bakht,PAK,Pace,1979-12-04,Delhi,India,1979,2,190,354,11,1,647,1401,30,457,1047,19,21.566666666666666,<=30,IND,Away,Upto 2014
Sikander Bakht,PAK,Pace,1979-12-16,Wankhede,India,1979,2,85,235,7,1,330,772,18,245,537,11,18.333333333333332,<=30,IND,Away,Upto 2014
Sikander Bakht,PAK,Pace,1979-12-25,Kanpur,India,1979,2,119,284,5,1,450,1133,20,331,849,15,22.5,<=30,IND,Away,Upto 2014
Sikander Bakht,PAK,Pace,1980-01-15,Chennai,India,1980,2,142,228,1,1,708,1186,22,566,958,21,32.18181818181818,>30,IND,Away,Upto 2014
Sikander Bakht,PAK,Pace,1980-01-29,Eden Gardens,India,1980,2,105,168,0,1,644,1456,21,539,1288,21,30.666666666666668,>30,IND,Away,Upto 2014
Sikander Bakht,PAK,Pace,1980-12-08,Faisalabad,Pakistan,1980,2,31,66,0,1,265,580,15,234,514,15,17.666666666666668,<=30,PAK,Home,Upto 2014
Sikander Bakht,PAK,Pace,1981-11-13,W.A.C.A,Australia,1981,2,126,264,4,1,628,1440,27,502,1176,23,23.25925925925926,<=30,AUS,Away,Upto 2014
Sikander Bakht,PAK,Pace,1981-11-27,Brisbane,Australia,1981,2,82,150,1,1,651,1292,22,569,1142,21,29.59090909090909,<=30,AUS,Away,Upto 2014
Sikander Bakht,PAK,Pace,1981-12-11,Melbourne,Australia,1981,1,9,12,0,1,395,1019,11,386,1007,11,35.90909090909091,>30,AUS,Away,Upto 2014
Sikander Bakht,PAK,Pace,1982-07-29,Birmingham,England,1982,2,92,186,1,1,641,1313,30,549,1127,29,21.366666666666667,<=30,ENG,Away,Upto 2014
Sikander Bakht,PAK,Pace,1982-08-26,Leeds,England,1982,2,87,264,2,1,717,1887,34,630,1623,32,21.08823529411765,<=30,ENG,Away,Upto 2014
Sikander Bakht,PAK,Pace,1983-01-03,Faisalabad,Pakistan,1983,2,107,132,1,1,934,1450,28,827,1318,27,33.357142857142854,>30,PAK,Home,Upto 2014
Sir RJ Hadlee,NZ,Pace,1973-02-02,Wellington,New Zealand,1973,2,112,200,2,1,687,1320,19,575,1120,17,36.1578947368421,>30,NZ,Home,Upto 2014
Sir RJ Hadlee,NZ,Pace,1973-06-07,Nottingham,England,1973,2,143,270,1,1,817,1990,27,674,1720,26,30.25925925925926,>30,ENG,Away,Upto 2014
Sir RJ Hadlee,NZ,Pace,1973-12-29,Melbourne,Australia,1973,1,104,200,0,1,539,1189,14,435,989,14,38.5,>30,AUS,Away,Upto 2014
Sir RJ Hadlee,NZ,Pace,1974-01-05,Sydney,Australia,1974,2,49,111,6,1,618,1375,28,569,1264,22,22.071428571428573,<=30,AUS,Away,Upto 2014
Sir RJ Hadlee,NZ,Pace,1974-01-26,Adelaide,Australia,1974,1,102,224,1,1,505,1312,13,403,1088,12,38.84615384615385,>30,AUS,Away,Upto 2014
Sir RJ Hadlee,NZ,Pace,1974-03-08,Christchurch,New Zealand,1974,2,130,260,7,1,814,2050,32,684,1790,25,25.4375,<=30,NZ,Home,Upto 2014
Sir RJ Hadlee,NZ,Pace,1974-03-22,Auckland,New Zealand,1974,2,95,144,3,1,628,1262,29,533,1118,26,21.655172413793103,<=30,NZ,Home,Upto 2014
Sir RJ Hadlee,NZ,Pace,1976-02-05,Christchurch,New Zealand,1976,2,139,208,1,1,616,1431,23,477,1223,22,26.782608695652176,<=30,NZ,Home,Upto 2014
Sir RJ Hadlee,NZ,Pace,1976-02-13,Wellington,New Zealand,1976,2,58,179,11,1,457,1252,22,399,1073,11,20.772727272727273,<=30,NZ,Home,Upto 2014
Sir RJ Hadlee,NZ,Pace,1976-10-09,Lahore,Pakistan,1976,2,157,192,5,1,496,904,17,339,712,12,29.176470588235293,<=30,PAK,Away,Upto 2014
Sir RJ Hadlee,NZ,Pace,1976-10-23,Hyderabad (Sind),Pakistan,1976,1,77,152,1,1,398,904,11,321,752,10,36.18181818181818,>30,PAK,Away,Upto 2014
Sir RJ Hadlee,NZ,Pace,1976-10-30,Karachi,Pakistan,1976,2,213,258,4,1,1003,1506,20,790,1248,16,50.15,>30,PAK,Away,Upto 2014
Sir RJ Hadlee,NZ,Pace,1976-11-10,Wankhede,India,1976,2,171,270,5,1,455,894,10,284,624,5,45.5,>30,IND,Away,Upto 2014
Sir RJ Hadlee,NZ,Pace,1976-11-18,Kanpur,India,1976,2,177,264,3,1,425,720,6,248,456,3,70.83333333333333,>30,IND,Away,Upto 2014
Sir RJ Hadlee,NZ,Pace,1976-11-26,Chennai,India,1976,2,89,228,5,1,298,829,13,209,601,8,22.923076923076923,<=30,IND,Away,Upto 2014
Sir RJ Hadlee,NZ,Pace,1977-02-18,Christchurch,New Zealand,1977,2,196,336,4,1,990,2047,22,794,1711,18,45.0,>30,NZ,Home,Upto 2014
Sir RJ Hadlee,NZ,Pace,1977-02-25,Auckland,New Zealand,1977,2,158,240,2,1,733,1600,29,575,1360,27,25.275862068965516,<=30,NZ,Home,Upto 2014
Sir RJ Hadlee,NZ,Pace,1978-02-10,Wellington,New Zealand,1978,2,100,331,10,1,523,1920,38,423,1589,28,13.763157894736842,<=30,NZ,Home,Upto 2014
Sir RJ Hadlee,NZ,Pace,1978-02-24,Christchurch,New Zealand,1978,2,164,392,4,1,664,1812,24,500,1420,20,27.666666666666668,<=30,NZ,Home,Upto 2014
Sir RJ Hadlee,NZ,Pace,1978-03-04,Auckland,New Zealand,1978,1,107,248,1,1,754,2126,17,647,1878,16,44.35294117647059,>30,NZ,Home,Upto 2014
Sir RJ Hadlee,NZ,Pace,1978-07-27,The Oval,England,1978,2,61,200,2,1,503,1390,19,442,1190,17,26.473684210526315,<=30,ENG,Away,Upto 2014
Sir RJ Hadlee,NZ,Pace,1978-08-10,Nottingham,England,1978,1,94,252,4,1,554,1523,20,460,1271,16,27.7,<=30,ENG,Away,Upto 2014
Sir RJ Hadlee,NZ,Pace,1978-08-24,Lord's,England,1978,2,115,275,7,1,614,1515,29,499,1240,22,21.17241379310345,<=30,ENG,Away,Upto 2014
Sir RJ Hadlee,NZ,Pace,1979-02-02,Christchurch,New Zealand,1979,2,145,408,8,1,652,1680,19,507,1272,11,34.31578947368421,>30,NZ,Home,Upto 2014
Sir RJ Hadlee,NZ,Pace,1979-02-16,Napier,New Zealand,1979,2,157,312,5,1,699,1749,19,542,1437,14,36.78947368421053,>30,NZ,Home,Upto 2014
Sir RJ Hadlee,NZ,Pace,1979-02-23,Auckland,New Zealand,1979,2,112,222,5,1,754,1863,27,642,1641,22,27.925925925925927,<=30,NZ,Home,Upto 2014
Sir RJ Hadlee,NZ,Pace,1980-02-08,Dunedin,New Zealand,1980,2,102,336,11,1,533,1670,35,431,1334,24,15.228571428571428,<=30,NZ,Home,Upto 2014
Sir RJ Hadlee,NZ,Pace,1980-02-22,Christchurch,New Zealand,1980,2,122,273,3,1,946,1857,20,824,1584,17,47.3,>30,NZ,Home,Upto 2014
Sir RJ Hadlee,NZ,Pace,1980-02-29,Auckland,New Zealand,1980,2,137,360,5,1,786,1985,29,649,1625,24,27.103448275862068,<=30,NZ,Home,Upto 2014
Sir RJ Hadlee,NZ,Pace,1980-11-28,Brisbane,Australia,1980,2,111,258,3,1,530,1227,24,419,969,21,22.083333333333332,<=30,AUS,Away,Upto 2014
Sir RJ Hadlee,NZ,Pace,1980-12-12,W.A.C.A,Australia,1980,2,107,229,7,1,516,1220,27,409,991,20,19.11111111111111,<=30,AUS,Away,Upto 2014
Sir RJ Hadlee,NZ,Pace,1980-12-26,Melbourne,Australia,1980,2,146,398,9,1,683,1801,29,537,1403,20,23.551724137931036,<=30,AUS,Away,Upto 2014
Sir RJ Hadlee,NZ,Pace,1981-02-21,Wellington,New Zealand,1981,2,127,231,4,1,725,1705,33,598,1474,29,21.96969696969697,<=30,NZ,Home,Upto 2014
Sir RJ Hadlee,NZ,Pace,1981-03-06,Christchurch,New Zealand,1981,1,47,198,5,1,349,1020,11,302,822,6,31.727272727272727,>30,NZ,Home,Upto 2014
Sir RJ Hadlee,NZ,Pace,1981-03-13,Auckland,New Zealand,1981,2,114,288,1,1,366,1193,11,252,905,10,33.27272727272727,>30,NZ,Home,Upto 2014
Sir RJ Hadlee,NZ,Pace,1982-02-26,Wellington,New Zealand,1982,1,15,42,0,1,258,786,4,243,744,4,64.5,>30,NZ,Home,Upto 2014
Sir RJ Hadlee,NZ,Pace,1982-03-12,Auckland,New Zealand,1982,2,101,288,7,1,673,1668,23,572,1380,16,29.26086956521739,<=30,NZ,Home,Upto 2014
Sir RJ Hadlee,NZ,Pace,1982-03-19,Christchurch,New Zealand,1982,2,110,221,7,1,665,1336,24,555,1115,17,27.708333333333332,<=30,NZ,Home,Upto 2014
Sir RJ Hadlee,NZ,Pace,1983-03-04,Christchurch,New Zealand,1983,2,60,213,4,1,557,1256,25,497,1043,21,22.28,<=30,NZ,Home,Upto 2014
Sir RJ Hadlee,NZ,Pace,1983-03-11,Wellington,New Zealand,1983,2,81,252,6,1,592,1490,31,511,1238,25,19.096774193548388,<=30,NZ,Home,Upto 2014
Sir RJ Hadlee,NZ,Pace,1983-07-14,The Oval,England,1983,2,152,366,8,1,726,1662,20,574,1296,12,36.3,>30,ENG,Away,Upto 2014
Sir RJ Hadlee,NZ,Pace,1983-07-28,Leeds,England,1983,2,89,282,0,1,786,1782,32,697,1500,32,24.5625,<=30,ENG,Away,Upto 2014
Sir RJ Hadlee,NZ,Pace,1983-08-11,Lord's,England,1983,2,135,396,8,1,667,1618,29,532,1222,21,23.0,<=30,ENG,Away,Upto 2014
Sir RJ Hadlee,NZ,Pace,1983-08-25,Nottingham,England,1983,2,183,348,5,1,763,1600,21,580,1252,16,36.333333333333336,>30,ENG,Away,Upto 2014
Sir RJ Hadlee,NZ,Pace,1984-01-20,Wellington,New Zealand,1984,1,97,191,2,1,1002,2037,24,905,1846,22,41.75,>30,NZ,Home,Upto 2014
Sir RJ Hadlee,NZ,Pace,1984-02-03,Christchurch,New Zealand,1984,2,44,210,8,1,404,927,25,360,717,17,16.16,<=30,NZ,Home,Upto 2014
Sir RJ Hadlee,NZ,Pace,1984-02-10,Auckland,New Zealand,1984,1,91,258,2,1,656,1758,12,565,1500,10,54.666666666666664,>30,NZ,Home,Upto 2014
Sir RJ Hadlee,NZ,Pace,1984-03-09,Kandy,Sri Lanka,1984,2,43,167,8,1,359,767,20,316,600,12,17.95,<=30,SL,Away,Upto 2014
Sir RJ Hadlee,NZ,Pace,1984-03-16,Colombo (SSC),Sri Lanka,1984,2,85,312,5,1,563,1643,28,478,1331,23,20.107142857142858,<=30,SL,Away,Upto 2014
Sir RJ Hadlee,NZ,Pace,1984-03-24,Colombo (CCC),Sri Lanka,1984,2,102,228,10,1,479,1056,21,377,828,11,22.80952380952381,<=30,SL,Away,Upto 2014
Sir RJ Hadlee,NZ,Pace,1985-01-18,Wellington,New Zealand,1985,1,70,192,2,1,458,1096,12,388,904,10,38.166666666666664,>30,NZ,Home,Upto 2014
Sir RJ Hadlee,NZ,Pace,1985-01-25,Auckland,New Zealand,1985,2,126,221,6,1,673,1429,25,547,1208,19,26.92,<=30,NZ,Home,Upto 2014
Sir RJ Hadlee,NZ,Pace,1985-02-09,Dunedin,New Zealand,1985,2,110,300,8,1,862,2018,34,752,1718,26,25.352941176470587,<=30,NZ,Home,Upto 2014
Sir RJ Hadlee,NZ,Pace,1985-03-29,Port of Spain,West Indies,1985,2,140,249,4,1,784,1698,30,644,1449,26,26.133333333333333,<=30,WI,Away,Upto 2014
Sir RJ Hadlee,NZ,Pace,1985-04-06,Georgetown,West Indies,1985,2,115,251,4,1,825,1600,20,710,1349,16,41.25,>30,WI,Away,Upto 2014
Sir RJ Hadlee,NZ,Pace,1985-04-26,Bridgetown,West Indies,1985,1,86,156,3,1,558,1140,29,472,984,26,19.24137931034483,<=30,WI,Away,Upto 2014
Sir RJ Hadlee,NZ,Pace,1985-05-04,Kingston,West Indies,1985,2,68,202,4,1,691,1483,26,623,1281,22,26.576923076923077,<=30,WI,Away,Upto 2014
Sir RJ Hadlee,NZ,Pace,1985-11-08,Brisbane,Australia,1985,2,123,315,15,1,699,1580,23,576,1265,8,30.391304347826086,>30,AUS,Away,Upto 2014
Sir RJ Hadlee,NZ,Pace,1985-11-22,Sydney,Australia,1985,2,123,307,7,1,241,652,9,118,345,2,26.77777777777778,<=30,AUS,Away,Upto 2014
Sir RJ Hadlee,NZ,Pace,1985-11-30,W.A.C.A,Australia,1985,2,155,395,11,1,726,2093,28,571,1698,17,25.928571428571427,<=30,AUS,Away,Upto 2014
Sir RJ Hadlee,NZ,Pace,1986-02-21,Wellington,New Zealand,1986,1,116,223,3,1,687,1390,14,571,1167,11,49.07142857142857,>30,NZ,Home,Upto 2014
Sir RJ Hadlee,NZ,Pace,1986-02-28,Christchurch,New Zealand,1986,2,163,418,9,1,712,1681,22,549,1263,13,32.36363636363637,>30,NZ,Home,Upto 2014
Sir RJ Hadlee,NZ,Pace,1986-03-13,Auckland,New Zealand,1986,2,108,306,4,1,481,1210,15,373,904,11,32.06666666666667,>30,NZ,Home,Upto 2014
Sir RJ Hadlee,NZ,Pace,1986-07-24,Lord's,England,1986,2,158,389,7,1,599,1428,17,441,1039,10,35.23529411764706,>30,ENG,Away,Upto 2014
Sir RJ Hadlee,NZ,Pace,1986-08-07,Nottingham,England,1986,2,140,391,10,1,656,1476,21,516,1085,11,31.238095238095237,>30,ENG,Away,Upto 2014
Sir RJ Hadlee,NZ,Pace,1986-08-21,The Oval,England,1986,1,92,143,2,1,479,811,12,387,668,10,39.916666666666664,>30,ENG,Away,Upto 2014
Sir RJ Hadlee,NZ,Pace,1987-02-20,Wellington,New Zealand,1987,2,89,210,2,1,656,1620,18,567,1410,16,36.44444444444444,>30,NZ,Home,Upto 2014
Sir RJ Hadlee,NZ,Pace,1987-02-27,Auckland,New Zealand,1987,2,114,256,6,1,550,1311,24,436,1055,18,22.916666666666668,<=30,NZ,Home,Upto 2014
Sir RJ Hadlee,NZ,Pace,1987-03-12,Christchurch,New Zealand,1987,2,151,213,9,1,630,1188,33,479,975,24,19.09090909090909,<=30,NZ,Home,Upto 2014
Sir RJ Hadlee,NZ,Pace,1987-04-16,Colombo (CCC),Sri Lanka,1987,1,102,233,4,1,574,1325,10,472,1092,6,57.4,>30,SL,Away,Upto 2014
Sir RJ Hadlee,NZ,Pace,1987-12-04,Brisbane,Australia,1987,2,109,234,3,1,634,1568,27,525,1334,24,23.48148148148148,<=30,AUS,Away,Upto 2014
Sir RJ Hadlee,NZ,Pace,1987-12-11,Adelaide,Australia,1987,1,68,252,5,1,519,1199,13,451,947,8,39.92307692307692,>30,AUS,Away,Upto 2014
Sir RJ Hadlee,NZ,Pace,1987-12-26,Melbourne,Australia,1987,2,176,450,10,1,846,1960,31,670,1510,21,27.29032258064516,<=30,AUS,Away,Upto 2014
Sir RJ Hadlee,NZ,Pace,1988-02-12,Christchurch,New Zealand,1988,1,50,108,0,1,693,1999,33,643,1891,33,21.0,<=30,NZ,Home,Upto 2014
Sir RJ Hadlee,NZ,Pace,1988-11-12,Bengaluru,India,1988,1,65,180,5,1,219,525,9,154,345,4,24.333333333333332,<=30,IND,Away,Upto 2014
Sir RJ Hadlee,NZ,Pace,1988-11-24,Wankhede,India,1988,2,88,221,10,1,384,842,15,296,621,5,25.6,<=30,IND,Away,Upto 2014
Sir RJ Hadlee,NZ,Pace,1988-12-02,Hyderabad (Deccan),India,1988,1,99,204,3,1,410,867,17,311,663,14,24.11764705882353,<=30,IND,Away,Upto 2014
Sir RJ Hadlee,NZ,Pace,1989-02-10,Wellington,New Zealand,1989,1,101,324,4,1,750,1984,22,649,1660,18,34.09090909090909,>30,NZ,Home,Upto 2014
Sir RJ Hadlee,NZ,Pace,1989-02-24,Auckland,New Zealand,1989,1,68,168,1,1,397,1018,6,329,850,5,66.16666666666667,>30,NZ,Home,Upto 2014
Sir RJ Hadlee,NZ,Pace,1990-02-02,Christchurch,New Zealand,1990,2,114,221,7,1,683,1242,22,569,1021,15,31.045454545454547,>30,NZ,Home,Upto 2014
Sir RJ Hadlee,NZ,Pace,1990-02-09,Napier,New Zealand,1990,1,73,210,3,1,406,996,10,333,786,7,40.6,>30,NZ,Home,Upto 2014
Sir RJ Hadlee,NZ,Pace,1990-02-22,Auckland,New Zealand,1990,2,132,204,2,1,1075,1694,19,943,1490,17,56.578947368421055,>30,NZ,Home,Upto 2014
Sir RJ Hadlee,NZ,Pace,1990-03-15,Wellington,New Zealand,1990,2,109,248,7,1,504,1412,21,395,1164,14,24.0,<=30,NZ,Home,Upto 2014
Sir RJ Hadlee,NZ,Pace,1990-06-07,Nottingham,England,1990,1,89,198,4,1,425,1056,17,336,858,13,25.0,<=30,ENG,Away,Upto 2014
Sir RJ Hadlee,NZ,Pace,1990-06-21,Lord's,England,1990,2,145,252,4,1,748,1364,15,603,1112,11,49.86666666666667,>30,ENG,Away,Upto 2014
Sir RJ Hadlee,NZ,Pace,1990-07-05,Birmingham,England,1990,2,150,353,8,1,730,1539,27,580,1186,19,27.037037037037038,<=30,ENG,Away,Upto 2014
Sohag Gazi,BAN,Spin,2012-11-13,Mirpur,Bangladesh,2012,2,219,422,9,1,992,1679,19,773,1257,10,52.21052631578947,>30,BAN,Home,Upto 2014
Sohag Gazi,BAN,Spin,2012-11-21,Khulna,Bangladesh,2012,2,175,351,3,1,763,1327,11,588,976,8,69.36363636363636,>30,BAN,Home,Upto 2014
Sohag Gazi,BAN,Spin,2013-03-08,Galle,Sri Lanka,2013,2,222,390,3,1,1160,1920,13,938,1530,10,89.23076923076923,>30,SL,Away,Upto 2014
Sohag Gazi,BAN,Spin,2013-03-16,Colombo (RPS),Sri Lanka,2013,2,158,312,4,1,481,1042,18,323,730,14,26.72222222222222,<=30,SL,Away,Upto 2014
Sohag Gazi,BAN,Spin,2013-04-17,Harare,Zimbabwe,2013,2,79,189,2,1,326,755,9,247,566,7,36.22222222222222,>30,ZIM,Away,Upto 2014
Sohag Gazi,BAN,Spin,2013-04-25,Harare,Zimbabwe,2013,2,115,300,5,1,425,789,13,310,489,8,32.69230769230769,>30,ZIM,Away,Upto 2014
Sohag Gazi,BAN,Spin,2013-10-09,Chattogram,Bangladesh,2013,2,156,348,8,1,1057,1946,22,901,1598,14,48.04545454545455,>30,BAN,Home,Upto 2014
Sohag Gazi,BAN,Spin,2013-10-21,Mirpur,Bangladesh,2013,1,77,204,0,1,460,965,12,383,761,12,38.333333333333336,>30,BAN,Home,Upto 2014
Sohag Gazi,BAN,Spin,2014-01-27,Mirpur,Bangladesh,2014,1,130,234,2,1,658,946,13,528,712,11,50.61538461538461,>30,BAN,Home,After 1965
Sohag Gazi,BAN,Spin,2014-02-04,Chattogram,Bangladesh,2014,2,268,401,2,1,1153,1976,25,885,1575,23,46.12,>30,BAN,Home,After 1965
Sohail Khan,PAK,Pace,2009-02-21,Karachi,Pakistan,2009,2,164,162,0,1,650,1043,7,486,881,7,92.85714285714286,>30,PAK,Home,Upto 2014
Sohail Khan,PAK,Pace,2011-09-01,Bulawayo,Zimbabwe,2011,2,81,180,1,1,539,1117,15,458,937,14,35.93333333333333,>30,ZIM,Away,Upto 2014
Sohail Khan,PAK,Pace,2016-08-03,Birmingham,England,2016,2,207,312,7,1,912,1860,29,705,1548,22,31.448275862068964,>30,ENG,Away,After 1965
Sohail Khan,PAK,Pace,2016-08-11,The Oval,England,2016,2,118,214,6,1,784,1374,21,666,1160,15,37.333333333333336,>30,ENG,Away,After 1965
Sohail Khan,PAK,Pace,2016-10-13,Dubai (DICS),UAE,2016,2,78,156,1,1,642,1209,9,564,1053,8,71.33333333333333,>30,UAE,Away,After 1965
Sohail Khan,PAK,Pace,2016-10-21,Abu Dhabi,UAE,2016,2,79,198,2,1,485,1009,16,406,811,14,30.3125,>30,UAE,Away,After 1965
Sohail Khan,PAK,Pace,2016-11-17,Christchurch,New Zealand,2016,2,99,168,3,1,500,1232,31,401,1064,28,16.129032258064516,<=30,NZ,Away,After 1965
Sohail Khan,PAK,Pace,2016-11-25,Hamilton,New Zealand,2016,2,168,252,4,1,921,1796,32,753,1544,28,28.78125,<=30,NZ,Away,After 1965
Sohail Khan,PAK,Pace,2016-12-26,Melbourne,Australia,2016,1,131,186,3,1,778,1397,19,647,1211,16,40.94736842105263,>30,AUS,Away,After 1965
Sohail Tanvir,PAK,Pace,2007-11-22,Delhi,India,2007,2,109,216,3,1,485,979,16,376,763,13,30.3125,>30,IND,Away,Upto 2014
Sohail Tanvir,PAK,Pace,2007-11-30,Eden Gardens,India,2007,2,207,288,2,1,574,936,5,367,648,3,114.8,>30,IND,Away,Upto 2014
Sohrawordi Shuvo,BAN,Spin,2011-10-29,Mirpur,Bangladesh,2011,2,146,297,4,1,846,1669,23,700,1372,19,36.78260869565217,>30,BAN,Home,Upto 2014
Soumya Sarkar,BAN,Pace,2015-04-28,Khulna,Bangladesh,2015,1,2,6,0,1,401,750,6,399,744,6,66.83333333333333,>30,BAN,Home,After 1965
Soumya Sarkar,BAN,Pace,2015-05-06,Mirpur,Bangladesh,2015,2,102,160,1,1,464,771,14,362,611,13,33.142857142857146,>30,BAN,Home,After 1965
Soumya Sarkar,BAN,Pace,2015-06-10,Fatullah,Bangladesh,2015,1,11,18,0,1,199,300,1,188,282,1,199.0,>30,BAN,Home,After 1965
Soumya Sarkar,BAN,Pace,2017-01-20,Christchurch,New Zealand,2017,1,10,18,0,1,735,1238,24,725,1220,24,30.625,>30,NZ,Away,After 1965
Soumya Sarkar,BAN,Pace,2017-02-09,Hyderabad,India,2017,1,4,6,0,1,567,906,10,563,900,10,56.7,>30,IND,Away,After 1965
Soumya Sarkar,BAN,Pace,2017-03-07,Galle,Sri Lanka,2017,1,9,18,0,1,497,858,9,488,840,9,55.22222222222222,>30,SL,Away,After 1965
Soumya Sarkar,BAN,Pace,2017-10-06,Bloemfontein,South Africa,2017,1,21,30,0,1,638,933,23,617,903,23,27.73913043478261,<=30,SA,Away,After 1965
Soumya Sarkar,BAN,Pace,2019-02-28,Hamilton,New Zealand,2019,1,68,126,2,1,1009,1490,23,941,1364,21,43.869565217391305,>30,NZ,Away,After 1965
Soumya Sarkar,BAN,Pace,2019-03-08,Wellington,New Zealand,2019,1,35,36,0,1,692,1031,24,657,995,24,28.833333333333332,<=30,NZ,Away,After 1965
Soumya Sarkar,BAN,Pace,2019-09-05,Chattogram,Bangladesh,2019,1,26,24,0,1,61,108,1,35,84,1,61.0,>30,BAN,Home,After 1965
Soumya Sarkar,BAN,Pace,2021-02-11,Mirpur,Bangladesh,2021,1,48,66,1,1,347,599,12,299,533,11,28.916666666666668,<=30,BAN,Home,After 1965
Subashis Roy,BAN,Pace,2017-01-12,Wellington,New Zealand,2017,2,121,188,3,1,1047,1639,21,926,1451,18,49.857142857142854,>30,NZ,Away,After 1965
Subashis Roy,BAN,Pace,2017-03-07,Galle,Sri Lanka,2017,2,137,186,1,1,497,858,9,360,672,8,55.22222222222222,>30,SL,Away,After 1965
Subashis Roy,BAN,Pace,2017-03-15,Colombo (PSS),Sri Lanka,2017,2,89,201,2,1,356,675,9,267,474,7,39.55555555555556,>30,SL,Away,After 1965
Subashis Roy,BAN,Pace,2017-10-06,Bloemfontein,South Africa,2017,1,118,174,3,1,638,933,23,520,759,20,27.73913043478261,<=30,SA,Away,After 1965
Sunzamul Islam,BAN,Spin,2018-01-31,Chattogram,Bangladesh,2018,1,153,270,1,1,1210,2061,19,1057,1791,18,63.68421052631579,>30,BAN,Home,After 1965
Surendranath,IND,Pace,1958-12-31,Eden Gardens,India,1958,1,168,276,2,1,327,738,17,159,462,15,19.235294117647058,<=30,IND,Home,Upto 2014
Surendranath,IND,Pace,1959-01-21,Chennai,India,1959,2,90,198,0,1,372,990,12,282,792,12,31.0,>30,IND,Home,Upto 2014
Surendranath,IND,Pace,1959-06-04,Nottingham,England,1959,1,59,144,2,1,398,1106,18,339,962,16,22.11111111111111,<=30,ENG,Away,Upto 2014
Surendranath,IND,Pace,1959-06-18,Lord's,England,1959,2,78,246,4,1,428,1122,20,350,876,16,21.4,<=30,ENG,Away,Upto 2014
Surendranath,IND,Pace,1959-07-02,Leeds,England,1959,1,84,192,0,1,379,911,14,295,719,14,27.071428571428573,<=30,ENG,Away,Upto 2014
Surendranath,IND,Pace,1959-07-23,Manchester,England,1959,2,130,331,5,1,572,1208,15,442,877,10,38.13333333333333,>30,ENG,Away,Upto 2014
Surendranath,IND,Pace,1959-08-20,The Oval,England,1959,1,75,309,5,1,341,1038,21,266,729,16,16.238095238095237,<=30,ENG,Away,Upto 2014
Surendranath,IND,Pace,1959-12-12,Delhi,India,1959,1,101,228,2,1,410,963,10,309,735,8,41.0,>30,IND,Home,Upto 2014
Surendranath,IND,Pace,1959-12-19,Kanpur,India,1959,2,17,48,0,1,231,796,13,214,748,13,17.76923076923077,<=30,IND,Home,Upto 2014
Surendranath,IND,Pace,1960-12-30,Eden Gardens,India,1960,2,144,384,5,1,412,1155,15,268,771,10,27.466666666666665,<=30,IND,Home,Upto 2014
Surendranath,IND,Pace,1961-01-13,Chennai,India,1961,2,107,246,1,1,342,929,6,235,683,5,57.0,>30,IND,Home,Upto 2014
Syed Rasel,BAN,Pace,2005-09-12,Colombo (RPS),Sri Lanka,2005,1,67,116,2,1,228,320,8,161,204,6,28.5,<=30,SL,Away,Upto 2014
Syed Rasel,BAN,Pace,2005-09-20,Colombo (PSS),Sri Lanka,2005,1,129,129,4,1,387,537,17,258,408,13,22.764705882352942,<=30,SL,Away,Upto 2014
Syed Rasel,BAN,Pace,2006-02-28,Chattogram,Bangladesh,2006,2,93,156,2,1,293,539,9,200,383,7,32.55555555555556,>30,BAN,Home,Upto 2014
Syed Rasel,BAN,Pace,2006-03-08,Bogra,Bangladesh,2006,2,71,150,1,1,292,547,11,221,397,10,26.545454545454547,<=30,BAN,Home,Upto 2014
Syed Rasel,BAN,Pace,2007-05-25,Mirpur,Bangladesh,2007,1,109,142,0,1,511,762,11,402,620,11,46.45454545454545,>30,BAN,Home,Upto 2014
Syed Rasel,BAN,Pace,2007-07-11,Kandy,Sri Lanka,2007,1,104,186,3,1,437,738,11,333,552,8,39.72727272727273,>30,SL,Away,Upto 2014
T Armitage,ENG,Pace,1877-03-15,Melbourne,Australia,1877,1,15,12,0,1,194,465,7,179,453,7,27.714285714285715,<=30,AUS,Away,After 1965
T Bavuma,SA,Pace,2016-11-03,W.A.C.A,Australia,2016,1,29,42,1,1,937,1726,29,908,1684,28,32.310344827586206,>30,AUS,Away,After 1965
T Bavuma,SA,Pace,2016-11-24,Adelaide,Australia,2016,1,1,6,0,1,686,1407,24,685,1401,24,28.583333333333332,<=30,AUS,Away,After 1965
T Bavuma,SA,Pace,2017-03-25,Hamilton,New Zealand,2017,1,7,12,0,1,618,1215,19,611,1203,19,32.526315789473685,>30,NZ,Away,After 1965
T Bavuma,SA,Pace,2017-07-06,Lord's,England,2017,1,14,30,0,1,720,1257,22,706,1227,22,32.72727272727273,>30,ENG,Away,After 1965
T Bavuma,SA,Pace,2018-03-22,Cape Town,South Africa,2018,1,10,6,0,1,789,1457,31,779,1451,31,25.451612903225808,<=30,SA,Home,After 1965
T Bosch,SA,Pace,1992-04-18,Bridgetown,West Indies,1992,2,104,237,3,1,919,1991,34,815,1754,31,27.029411764705884,<=30,WI,Away,Upto 2014
T Emmett,ENG,Pace,1877-03-15,Melbourne,Australia,1877,1,13,48,0,1,194,465,7,181,417,7,27.714285714285715,<=30,AUS,Away,After 1965
T Emmett,ENG,Pace,1877-03-31,Melbourne,Australia,1877,1,23,52,0,1,269,577,12,246,525,12,22.416666666666668,<=30,AUS,Away,After 1965
T Emmett,ENG,Pace,1879-01-02,Melbourne,Australia,1879,1,68,236,7,1,316,788,22,248,552,15,14.363636363636363,<=30,AUS,Away,After 1965
T Emmett,ENG,Pace,1881-12-31,Melbourne,Australia,1881,2,80,204,2,1,185,448,5,105,244,3,37.0,>30,AUS,Away,After 1965
T Emmett,ENG,Pace,1882-02-17,Sydney,Australia,1882,2,41,48,0,1,195,434,9,154,386,9,21.666666666666668,<=30,AUS,Away,After 1965
T Emmett,ENG,Pace,1882-03-03,Sydney,Australia,1882,1,37,64,0,1,221,493,9,184,429,9,24.555555555555557,<=30,AUS,Away,After 1965
T Emmett,ENG,Pace,1882-03-10,Melbourne,Australia,1882,1,22,76,0,1,399,909,9,377,833,9,44.333333333333336,>30,AUS,Away,After 1965
T Greenhough,ENG,Spin,1959-06-04,Nottingham,England,1959,2,106,294,3,1,354,956,10,248,662,7,35.4,>30,ENG,Home,Upto 2014
T Greenhough,ENG,Spin,1959-06-18,Lord's,England,1959,2,66,205,7,1,208,491,11,142,286,4,18.90909090909091,<=30,ENG,Home,Upto 2014
T Greenhough,ENG,Spin,1959-08-20,The Oval,England,1959,2,83,336,4,1,323,930,8,240,594,4,40.375,>30,ENG,Home,Upto 2014
T Greenhough,ENG,Spin,1960-08-18,The Oval,England,1960,2,102,294,2,1,312,852,6,210,558,4,52.0,>30,ENG,Home,Upto 2014
T Gwandu,ZIM,Spin,2024-12-26,Bulawayo,Zimbabwe,2024,1,142,198,1,1,1189,1856,20,1047,1658,19,59.45,>30,ZIM,Home,After 1965
T Mupariwa,ZIM,Pace,2004-05-14,Bulawayo,Zimbabwe,2004,1,136,204,0,1,856,1362,13,720,1158,13,65.84615384615384,>30,ZIM,Home,Upto 2014
T Murphy,AUS,Spin,2023-02-09,Nagpur,India,2023,1,124,282,7,1,475,1061,24,351,779,17,19.791666666666668,<=30,IND,Away,After 1965
T Murphy,AUS,Spin,2023-02-17,Delhi,India,2023,2,75,148,3,1,582,1082,28,507,934,25,20.785714285714285,<=30,IND,Away,After 1965
T Murphy,AUS,Spin,2023-03-01,Indore,India,2023,2,41,120,1,1,438,973,26,397,853,25,16.846153846153847,<=30,IND,Away,After 1965
T Murphy,AUS,Spin,2023-03-09,Ahmedabad,India,2023,1,113,275,3,1,725,1892,17,612,1617,14,42.64705882352941,>30,IND,Away,After 1965
T Murphy,AUS,Spin,2023-07-06,Leeds,England,2023,2,49,57,1,1,127,219,3,78,162,2,42.333333333333336,>30,ENG,Away,After 1965
T Murphy,AUS,Spin,2023-07-27,The Oval,England,2023,2,132,173,6,1,267,408,11,135,235,5,24.272727272727273,<=30,ENG,Away,After 1965
T Murphy,AUS,Spin,2025-01-29,Galle,Sri Lanka,2025,2,85,102,1,1,941,1397,23,856,1295,22,40.91304347826087,>30,SL,Away,After 1965
T Natarajan,IND,Pace,2021-01-15,Brisbane,Australia,2021,2,119,230,3,1,950,1738,30,831,1508,27,31.666666666666668,>30,AUS,Away,After 1965
T Panyangara,ZIM,Pace,2004-05-06,Harare,Zimbabwe,2004,1,101,157,3,1,612,996,20,511,839,17,30.6,>30,ZIM,Home,Upto 2014
T Panyangara,ZIM,Pace,2004-05-14,Bulawayo,Zimbabwe,2004,1,120,150,1,1,856,1362,13,736,1212,12,65.84615384615384,>30,ZIM,Home,Upto 2014
T Panyangara,ZIM,Pace,2005-01-14,Dhaka,Bangladesh,2005,2,65,228,4,1,545,1416,17,480,1188,13,32.05882352941177,>30,BAN,Away,Upto 2014
T Panyangara,ZIM,Pace,2013-09-03,Harare,Zimbabwe,2013,2,113,300,5,1,657,1465,18,544,1165,13,36.5,>30,ZIM,Home,Upto 2014
T Panyangara,ZIM,Pace,2013-09-10,Harare,Zimbabwe,2013,2,86,228,4,1,558,1504,28,472,1276,24,19.928571428571427,<=30,ZIM,Home,Upto 2014
T Panyangara,ZIM,Pace,2014-08-09,Harare,Zimbabwe,2014,2,44,198,0,1,362,1164,16,318,966,16,22.625,<=30,ZIM,Home,After 1965
T Panyangara,ZIM,Pace,2014-10-25,Mirpur,Bangladesh,2014,2,89,186,7,1,227,561,12,138,375,5,18.916666666666668,<=30,BAN,Away,After 1965
T Panyangara,ZIM,Pace,2014-11-03,Khulna,Bangladesh,2014,2,94,246,3,1,338,810,9,244,564,6,37.55555555555556,>30,BAN,Away,After 1965
T Panyangara,ZIM,Pace,2014-11-12,Chattogram,Bangladesh,2014,2,101,196,4,1,456,862,15,355,666,11,30.4,>30,BAN,Away,After 1965
T Richardson,ENG,Pace,1893-08-24,Manchester,England,1893,2,156,339,10,1,557,1484,22,401,1145,12,25.318181818181817,<=30,ENG,Home,After 1965
T Richardson,ENG,Pace,1894-12-14,Sydney,Australia,1894,2,208,399,6,1,993,2418,24,785,2019,18,41.375,>30,AUS,Away,After 1965
T Richardson,ENG,Pace,1894-12-29,Melbourne,Australia,1894,2,157,378,7,1,653,1784,28,496,1406,21,23.321428571428573,<=30,AUS,Away,After 1965
T Richardson,ENG,Pace,1895-01-11,Adelaide,Australia,1895,2,164,315,8,1,553,1201,23,389,886,15,24.043478260869566,<=30,AUS,Away,After 1965
T Richardson,ENG,Pace,1895-02-01,Sydney,Australia,1895,1,78,132,2,1,216,539,18,138,407,16,12.0,<=30,AUS,Away,After 1965
T Richardson,ENG,Pace,1895-03-01,Melbourne,Australia,1895,2,242,524,9,1,615,1328,15,373,804,6,41.0,>30,AUS,Away,After 1965
T Richardson,ENG,Pace,1896-06-22,Lord's,England,1896,2,173,293,11,1,652,1288,29,479,995,18,22.482758620689655,<=30,ENG,Home,After 1965
T Richardson,ENG,Pace,1896-07-16,Manchester,England,1896,2,244,553,13,1,587,1233,20,343,680,7,29.35,<=30,ENG,Home,After 1965
T Richardson,ENG,Pace,1896-08-10,The Oval,England,1896,2,22,30,0,1,180,416,13,158,386,13,13.846153846153847,<=30,ENG,Home,After 1965
T Richardson,ENG,Pace,1897-12-13,Sydney,Australia,1897,2,192,408,5,1,722,1597,21,530,1189,16,34.38095238095238,>30,AUS,Away,After 1965
T Richardson,ENG,Pace,1898-01-01,Melbourne,Australia,1898,1,114,288,1,1,464,1032,7,350,744,6,66.28571428571429,>30,AUS,Away,After 1965
T Richardson,ENG,Pace,1898-01-14,Adelaide,Australia,1898,1,164,336,4,1,674,1910,19,510,1574,15,35.473684210526315,>30,AUS,Away,After 1965
T Richardson,ENG,Pace,1898-01-29,Melbourne,Australia,1898,1,102,156,2,1,528,1140,21,426,984,19,25.142857142857142,<=30,AUS,Away,After 1965
T Richardson,ENG,Pace,1898-02-26,Sydney,Australia,1898,2,204,347,10,1,648,1334,24,444,987,14,27.0,<=30,AUS,Away,After 1965
T Shamsi,SA,Spin,2016-11-24,Adelaide,Australia,2016,2,150,263,2,1,296,533,6,146,270,4,49.333333333333336,>30,AUS,Away,After 1965
T Shamsi,SA,Spin,2018-07-12,Galle,Sri Lanka,2018,2,128,220,4,1,416,921,25,288,701,21,16.64,<=30,SL,Away,After 1965
T Taibu,ZIM,Pace,2004-05-06,Harare,Zimbabwe,2004,1,27,48,1,1,612,996,20,585,948,19,30.6,>30,ZIM,Home,Upto 2014
T Thushara,SL,Pace,2003-06-27,Kingston,West Indies,2003,2,59,90,0,1,610,1045,26,551,955,26,23.46153846153846,<=30,WI,Away,Upto 2014
T Thushara,SL,Pace,2008-03-22,Providence,West Indies,2008,2,129,227,5,1,635,1249,22,506,1022,17,28.863636363636363,<=30,WI,Away,Upto 2014
T Thushara,SL,Pace,2008-04-03,Port of Spain,West Indies,2008,2,121,144,3,1,851,1278,24,730,1134,21,35.458333333333336,>30,WI,Away,Upto 2014
T Thushara,SL,Pace,2009-03-01,Lahore,Pakistan,2009,1,46,48,0,1,395,504,8,349,456,8,49.375,>30,PAK,Away,Upto 2014
T Thushara,SL,Pace,2009-07-04,Galle,Sri Lanka,2009,2,98,198,4,1,560,942,21,462,744,17,26.666666666666668,<=30,SL,Home,Upto 2014
T Thushara,SL,Pace,2009-07-12,Colombo (PSS),Sri Lanka,2009,2,71,126,2,1,365,700,17,294,574,15,21.470588235294116,<=30,SL,Home,Upto 2014
T Thushara,SL,Pace,2009-07-20,Colombo (SSC),Sri Lanka,2009,2,204,292,6,1,669,1180,14,465,888,8,47.785714285714285,>30,SL,Home,Upto 2014
T Thushara,SL,Pace,2009-08-18,Galle,Sri Lanka,2009,2,118,222,6,1,541,798,16,423,576,10,33.8125,>30,SL,Home,Upto 2014
T Thushara,SL,Pace,2009-08-26,Colombo (SSC),Sri Lanka,2009,2,115,195,2,1,574,917,8,459,722,6,71.75,>30,SL,Home,Upto 2014
T Thushara,SL,Pace,2010-11-15,Galle,Sri Lanka,2010,1,79,126,0,1,602,992,8,523,866,8,75.25,>30,SL,Home,Upto 2014
T Westley,ENG,Spin,2017-08-25,Leeds,England,2017,1,12,24,0,1,415,774,7,403,750,7,59.285714285714285,>30,ENG,Home,After 1965
T Yohannan,IND,Pace,2001-12-03,Mohali,India,2001,2,131,210,4,1,398,794,9,267,584,5,44.22222222222222,>30,IND,Home,Upto 2014
T Yohannan,IND,Pace,2001-12-11,Ahmedabad,India,2001,2,82,126,0,1,368,804,6,286,678,6,61.333333333333336,>30,IND,Home,Upto 2014
T Yohannan,IND,Pace,2002-12-19,Hamilton,New Zealand,2002,2,43,150,1,1,426,959,32,383,809,31,13.3125,<=30,NZ,Away,Upto 2014
TA Blundell,NZ,Spin,2019-12-26,Melbourne,Australia,2019,1,13,18,0,1,244,396,6,231,378,6,40.666666666666664,>30,AUS,Away,After 1965
TA Boult,NZ,Pace,2011-12-09,Hobart,Australia,2011,2,80,150,4,1,648,1341,37,568,1191,33,17.513513513513512,<=30,AUS,Away,Upto 2014
TA Boult,NZ,Pace,2012-01-26,Napier,New Zealand,2012,2,39,108,2,1,497,972,21,458,864,19,23.666666666666668,<=30,NZ,Home,Upto 2014
TA Boult,NZ,Pace,2012-03-07,Dunedin,New Zealand,2012,2,151,204,2,1,860,1498,21,709,1294,19,40.95238095238095,>30,NZ,Home,Upto 2014
TA Boult,NZ,Pace,2012-08-02,Kingston,West Indies,2012,2,104,174,4,1,597,1132,23,493,958,19,25.956521739130434,<=30,WI,Away,Upto 2014
TA Boult,NZ,Pace,2012-08-23,Hyderabad,India,2012,1,93,162,3,1,403,771,7,310,609,4,57.57142857142857,>30,IND,Away,Upto 2014
TA Boult,NZ,Pace,2012-08-31,Bengaluru,India,2012,2,154,239,2,1,733,1159,18,579,920,16,40.72222222222222,>30,IND,Away,Upto 2014
TA Boult,NZ,Pace,2012-11-17,Galle,Sri Lanka,2012,2,61,122,2,1,371,706,14,310,584,12,26.5,<=30,SL,Away,Upto 2014
TA Boult,NZ,Pace,2012-11-25,Colombo (PSS),Sri Lanka,2012,2,75,233,7,1,530,1109,22,455,876,15,24.09090909090909,<=30,SL,Away,Upto 2014
TA Boult,NZ,Pace,2013-01-02,Cape Town,South Africa,2013,1,78,126,3,1,547,1103,26,469,977,23,21.03846153846154,<=30,SA,Away,Upto 2014
TA Boult,NZ,Pace,2013-01-11,Gqeberha,South Africa,2013,1,108,192,1,1,619,1262,23,511,1070,22,26.91304347826087,<=30,SA,Away,Upto 2014
TA Boult,NZ,Pace,2013-03-06,Dunedin,New Zealand,2013,2,81,300,2,1,764,1468,18,683,1168,16,42.44444444444444,>30,NZ,Home,Upto 2014
TA Boult,NZ,Pace,2013-03-14,Wellington,New Zealand,2013,1,117,180,2,1,612,1184,15,495,1004,13,40.8,>30,NZ,Home,Upto 2014
TA Boult,NZ,Pace,2013-03-22,Auckland,New Zealand,2013,2,123,324,7,1,822,1793,28,699,1469,21,29.357142857142858,<=30,NZ,Home,Upto 2014
TA Boult,NZ,Pace,2013-05-16,Lord's,England,2013,2,104,252,3,1,569,1283,36,465,1031,33,15.805555555555555,<=30,ENG,Away,Upto 2014
TA Boult,NZ,Pace,2013-05-24,Leeds,England,2013,2,59,144,5,1,701,1279,21,642,1135,16,33.38095238095238,>30,ENG,Away,Upto 2014
TA Boult,NZ,Pace,2013-10-09,Chattogram,Bangladesh,2013,2,59,168,2,1,333,720,8,274,552,6,41.625,>30,BAN,Away,Upto 2014
TA Boult,NZ,Pace,2013-10-21,Mirpur,Bangladesh,2013,2,117,192,1,1,508,858,10,391,666,9,50.8,>30,BAN,Away,Upto 2014
TA Boult,NZ,Pace,2013-12-03,Dunedin,New Zealand,2013,2,121,318,5,1,879,1520,20,758,1202,15,43.95,>30,NZ,Home,Upto 2014
TA Boult,NZ,Pace,2013-12-11,Wellington,New Zealand,2013,2,80,167,10,1,603,1007,28,523,840,18,21.535714285714285,<=30,NZ,Home,Upto 2014
TA Boult,NZ,Pace,2013-12-19,Hamilton,New Zealand,2013,2,107,216,5,1,543,1073,23,436,857,18,23.608695652173914,<=30,NZ,Home,Upto 2014
TA Boult,NZ,Pace,2014-02-06,Auckland,New Zealand,2014,2,124,243,6,1,873,1527,37,749,1284,31,23.594594594594593,<=30,NZ,Home,After 1965
TA Boult,NZ,Pace,2014-02-14,Wellington,New Zealand,2014,2,146,252,4,1,1271,2109,30,1125,1857,26,42.36666666666667,>30,NZ,Home,After 1965
TA Boult,NZ,Pace,2014-06-08,Kingston,West Indies,2014,2,96,174,1,1,334,854,13,238,680,12,25.692307692307693,<=30,WI,Away,After 1965
TA Boult,NZ,Pace,2014-06-16,Port of Spain,West Indies,2014,2,102,198,3,1,611,1256,20,509,1058,17,30.55,>30,WI,Away,After 1965
TA Boult,NZ,Pace,2014-06-26,Bridgetown,West Indies,2014,2,119,236,5,1,620,1276,27,501,1040,22,22.962962962962962,<=30,WI,Away,After 1965
TA Boult,NZ,Pace,2014-11-09,Abu Dhabi,UAE,2014,2,87,198,0,1,447,927,10,360,729,10,44.7,>30,UAE,Away,After 1965
TA Boult,NZ,Pace,2014-11-17,Dubai (DICS),UAE,2014,2,81,240,4,1,426,1086,12,345,846,8,35.5,>30,UAE,Away,After 1965
TA Boult,NZ,Pace,2014-11-26,Sharjah,UAE,2014,2,92,216,4,1,429,804,9,337,588,5,47.666666666666664,>30,UAE,Away,After 1965
TA Boult,NZ,Pace,2014-12-26,Christchurch,New Zealand,2014,2,125,300,7,1,757,1417,28,632,1117,21,27.035714285714285,<=30,NZ,Home,After 1965
TA Boult,NZ,Pace,2015-01-03,Wellington,New Zealand,2015,2,130,270,4,1,987,1835,28,857,1565,24,35.25,>30,NZ,Home,After 1965
TA Boult,NZ,Pace,2015-05-21,Lord's,England,2015,2,164,378,9,1,1185,2044,33,1021,1666,24,35.90909090909091,>30,ENG,Away,After 1965
TA Boult,NZ,Pace,2015-05-29,Leeds,England,2015,2,159,318,4,1,1058,1587,28,899,1269,24,37.785714285714285,>30,ENG,Away,After 1965
TA Boult,NZ,Pace,2015-11-05,Brisbane,Australia,2015,2,188,222,2,1,1023,1505,20,835,1283,18,51.15,>30,AUS,Away,After 1965
TA Boult,NZ,Pace,2015-11-13,W.A.C.A,Australia,2015,2,200,270,4,1,1234,1914,22,1034,1644,18,56.09090909090909,>30,AUS,Away,After 1965
TA Boult,NZ,Pace,2015-11-27,Adelaide,Australia,2015,2,101,198,7,1,584,1142,29,483,944,22,20.137931034482758,<=30,AUS,Away,After 1965
TA Boult,NZ,Pace,2015-12-10,Dunedin,New Zealand,2015,2,110,222,4,1,942,1677,26,832,1455,22,36.23076923076923,>30,NZ,Home,After 1965
TA Boult,NZ,Pace,2015-12-18,Hamilton,New Zealand,2015,2,81,162,2,1,667,1250,30,586,1088,28,22.233333333333334,<=30,NZ,Home,After 1965
TA Boult,NZ,Pace,2016-02-12,Wellington,New Zealand,2016,1,101,198,2,1,769,1383,21,668,1185,19,36.61904761904762,>30,NZ,Home,After 1965
TA Boult,NZ,Pace,2016-02-20,Christchurch,New Zealand,2016,2,168,288,3,1,1247,2076,29,1079,1788,26,43.0,>30,NZ,Home,After 1965
TA Boult,NZ,Pace,2016-07-28,Bulawayo,Zimbabwe,2016,2,75,168,4,1,542,1115,20,467,947,16,27.1,<=30,ZIM,Away,After 1965
TA Boult,NZ,Pace,2016-08-06,Bulawayo,Zimbabwe,2016,2,71,234,2,1,578,1230,11,507,996,9,52.54545454545455,>30,ZIM,Away,After 1965
TA Boult,NZ,Pace,2016-08-19,Durban,South Africa,2016,1,52,130,3,1,247,526,10,195,396,7,24.7,<=30,SA,Away,After 1965
TA Boult,NZ,Pace,2016-08-27,Centurion,South Africa,2016,2,151,298,2,1,829,1709,31,678,1411,29,26.741935483870968,<=30,SA,Away,After 1965
TA Boult,NZ,Pace,2016-09-22,Kanpur,India,2016,2,101,174,3,1,304,612,8,203,438,5,38.0,>30,IND,Away,After 1965
TA Boult,NZ,Pace,2016-09-30,Eden Gardens,India,2016,2,84,232,5,1,483,1061,26,399,829,21,18.576923076923077,<=30,IND,Away,After 1965
TA Boult,NZ,Pace,2016-10-08,Indore,India,2016,2,148,234,2,1,519,876,3,371,642,1,173.0,>30,IND,Away,After 1965
TA Boult,NZ,Pace,2016-11-17,Christchurch,New Zealand,2016,2,76,198,5,1,500,1232,31,424,1034,26,16.129032258064516,<=30,NZ,Home,After 1965
TA Boult,NZ,Pace,2017-01-12,Wellington,New Zealand,2017,2,184,287,5,1,1047,1639,21,863,1352,16,49.857142857142854,>30,NZ,Home,After 1965
TA Boult,NZ,Pace,2017-01-20,Christchurch,New Zealand,2017,2,139,246,7,1,735,1238,24,596,992,17,30.625,>30,NZ,Home,After 1965
TA Boult,NZ,Pace,2017-03-08,Dunedin,New Zealand,2017,2,98,286,5,1,518,1198,16,420,912,11,32.375,>30,NZ,Home,After 1965
TA Boult,NZ,Pace,2017-12-01,Wellington,New Zealand,2017,2,123,234,4,1,782,1474,25,659,1240,21,31.28,>30,NZ,Home,After 1965
TA Boult,NZ,Pace,2017-12-09,Hamilton,New Zealand,2017,2,125,221,6,1,876,1573,33,751,1352,27,26.545454545454547,<=30,NZ,Home,After 1965
TA Boult,NZ,Pace,2018-03-22,Auckland,New Zealand,2018,2,99,226,9,1,669,1504,24,570,1278,15,27.875,<=30,NZ,Home,After 1965
TA Boult,NZ,Pace,2018-03-30,Christchurch,New Zealand,2018,2,176,341,6,1,933,2022,34,757,1681,28,27.441176470588236,<=30,NZ,Home,After 1965
TA Boult,NZ,Pace,2018-11-16,Abu Dhabi,UAE,2018,2,83,152,4,1,312,840,18,229,688,14,17.333333333333332,<=30,UAE,Away,After 1965
TA Boult,NZ,Pace,2018-11-24,Dubai (DICS),UAE,2018,1,106,204,1,1,331,924,7,225,720,6,47.285714285714285,>30,UAE,Away,After 1965
TA Boult,NZ,Pace,2018-12-03,Abu Dhabi,UAE,2018,2,73,192,2,1,467,990,12,394,798,10,38.916666666666664,>30,UAE,Away,After 1965
TA Boult,NZ,Pace,2018-12-15,Wellington,New Zealand,2018,2,145,312,2,1,859,1641,18,714,1329,16,47.72222222222222,>30,NZ,Home,After 1965
TA Boult,NZ,Pace,2018-12-26,Christchurch,New Zealand,2018,2,107,260,9,1,838,1658,30,731,1398,21,27.933333333333334,<=30,NZ,Home,After 1965
TA Boult,NZ,Pace,2019-02-28,Hamilton,New Zealand,2019,2,185,246,6,1,1009,1490,23,824,1244,17,43.869565217391305,>30,NZ,Home,After 1965
TA Boult,NZ,Pace,2019-03-08,Wellington,New Zealand,2019,2,90,162,7,1,692,1031,24,602,869,17,28.833333333333332,<=30,NZ,Home,After 1965
TA Boult,NZ,Pace,2019-08-14,Galle,Sri Lanka,2019,2,79,175,3,1,263,591,10,184,416,7,26.3,<=30,SL,Away,After 1965
TA Boult,NZ,Pace,2019-08-22,Colombo (PSS),Sri Lanka,2019,2,92,220,5,1,360,808,14,268,588,9,25.714285714285715,<=30,SL,Away,After 1965
TA Boult,NZ,Pace,2019-11-21,Mount Maunganui,New Zealand,2019,2,103,222,1,1,805,1856,23,702,1634,22,35.0,>30,NZ,Home,After 1965
TA Boult,NZ,Pace,2019-12-26,Melbourne,Australia,2019,2,121,240,1,1,729,1616,26,608,1376,25,28.03846153846154,<=30,AUS,Away,After 1965
TA Boult,NZ,Pace,2020-02-21,Wellington,New Zealand,2020,2,96,240,5,1,586,1297,26,490,1057,21,22.53846153846154,<=30,NZ,Home,After 1965
TA Boult,NZ,Pace,2020-02-29,Christchurch,New Zealand,2020,2,117,186,6,1,623,1219,30,506,1033,24,20.766666666666666,<=30,NZ,Home,After 1965
TA Boult,NZ,Pace,2020-12-03,Hamilton,New Zealand,2020,2,93,192,2,1,725,1439,25,632,1247,23,29.0,<=30,NZ,Home,After 1965
TA Boult,NZ,Pace,2020-12-11,Wellington,New Zealand,2020,2,130,210,3,1,834,1421,28,704,1211,25,29.785714285714285,<=30,NZ,Home,After 1965
TA Boult,NZ,Pace,2020-12-26,Mount Maunganui,New Zealand,2020,2,143,306,4,1,873,2105,28,730,1799,24,31.178571428571427,>30,NZ,Home,After 1965
TA Boult,NZ,Pace,2021-01-03,Christchurch,New Zealand,2021,2,125,237,5,1,918,1730,25,793,1493,20,36.72,>30,NZ,Home,After 1965
TA Boult,NZ,Pace,2021-06-10,Birmingham,England,2021,2,119,235,6,1,672,1387,27,553,1152,21,24.88888888888889,<=30,ENG,Away,After 1965
TA Boult,NZ,Pace,2021-06-18,Southampton,England,2021,2,86,217,5,1,643,1620,27,557,1403,22,23.814814814814813,<=30,ENG,Away,After 1965
TA Boult,NZ,Pace,2022-01-01,Mount Maunganui,New Zealand,2022,2,89,242,4,1,752,1693,25,663,1451,21,30.08,>30,NZ,Home,After 1965
TA Boult,NZ,Pace,2022-01-09,Christchurch,New Zealand,2022,2,85,176,5,1,738,1267,23,653,1091,18,32.08695652173913,>30,NZ,Home,After 1965
TA Boult,NZ,Pace,2022-06-02,Lord's,England,2022,2,94,227,4,1,722,1408,33,628,1181,29,21.87878787878788,<=30,ENG,Away,After 1965
TA Boult,NZ,Pace,2022-06-10,Nottingham,England,2022,2,200,297,8,1,1254,1921,26,1054,1624,18,48.23076923076923,>30,ENG,Away,After 1965
TA Boult,NZ,Pace,2022-06-23,Leeds,England,2022,2,169,204,4,1,862,1428,19,693,1224,15,45.36842105263158,>30,ENG,Away,After 1965
TA Copeland,AUS,Pace,2011-08-31,Galle,Sri Lanka,2011,2,44,168,1,1,381,906,20,337,738,19,19.05,<=30,SL,Away,Upto 2014
TA Copeland,AUS,Pace,2011-09-08,Pallekele,Sri Lanka,2011,2,87,234,3,1,526,1180,17,439,946,14,30.941176470588236,>30,SL,Away,Upto 2014
TA Copeland,AUS,Pace,2011-09-16,Colombo (SSC),Sri Lanka,2011,2,96,246,2,1,825,1634,20,729,1388,18,41.25,>30,SL,Away,Upto 2014
TA Munton,ENG,Pace,1992-07-02,Manchester,England,1992,2,138,282,1,1,841,1528,24,703,1246,23,35.041666666666664,>30,ENG,Home,Upto 2014
TA Munton,ENG,Pace,1992-07-23,Leeds,England,1992,2,62,123,3,1,719,1557,27,657,1434,24,26.62962962962963,<=30,ENG,Home,Upto 2014
TAM Siriwardana,SL,Spin,2015-10-14,Galle,Sri Lanka,2015,2,73,102,2,1,555,1017,18,482,915,16,30.833333333333332,>30,SL,Home,After 1965
TAM Siriwardana,SL,Spin,2015-10-22,Colombo (PSS),Sri Lanka,2015,2,51,138,5,1,448,1072,27,397,934,22,16.59259259259259,<=30,SL,Home,After 1965
TAM Siriwardana,SL,Spin,2015-12-10,Dunedin,New Zealand,2015,2,56,72,1,1,310,569,7,254,497,6,44.285714285714285,>30,NZ,Away,After 1965
TAM Siriwardana,SL,Spin,2015-12-18,Hamilton,New Zealand,2015,1,5,9,0,1,163,255,2,158,246,2,81.5,>30,NZ,Away,After 1965
TAM Siriwardana,SL,Spin,2016-05-27,Chester-le-Street,England,2016,2,72,92,3,1,355,530,5,283,438,2,71.0,>30,ENG,Away,After 1965
TAP Sekhar,IND,Pace,1983-01-23,Lahore,Pakistan,1983,1,86,120,0,1,359,745,10,273,625,10,35.9,>30,PAK,Away,Upto 2014
TAP Sekhar,IND,Pace,1983-01-30,Karachi,Pakistan,1983,1,43,84,0,1,655,1382,13,612,1298,13,50.38461538461539,>30,PAK,Away,Upto 2014
TB Burtt,NZ,Spin,1947-03-21,Christchurch,New Zealand,1947,1,55,84,0,1,205,294,0,150,210,0,inf,>30,NZ,Home,Upto 2014
TB Burtt,NZ,Spin,1949-06-11,Leeds,England,1949,2,153,327,5,1,545,1101,10,392,774,5,54.5,>30,ENG,Away,Upto 2014
TB Burtt,NZ,Spin,1949-06-25,Lord's,England,1949,2,160,432,6,1,624,1342,19,464,910,13,32.8421052631579,>30,ENG,Away,Upto 2014
TB Burtt,NZ,Spin,1949-07-23,Manchester,England,1949,1,162,270,6,1,586,1224,13,424,954,7,45.07692307692308,>30,ENG,Away,Upto 2014
TB Burtt,NZ,Spin,1949-08-13,The Oval,England,1949,1,93,144,0,1,597,1082,15,504,938,15,39.8,>30,ENG,Away,Upto 2014
TB Burtt,NZ,Spin,1951-03-17,Christchurch,New Zealand,1951,1,99,294,1,1,586,1337,15,487,1043,14,39.06666666666667,>30,NZ,Home,Upto 2014
TB Burtt,NZ,Spin,1951-03-24,Wellington,New Zealand,1951,2,82,290,5,1,366,1136,25,284,846,20,14.64,<=30,NZ,Home,Upto 2014
TB Burtt,NZ,Spin,1952-02-08,Christchurch,New Zealand,1952,2,106,272,7,1,593,1754,25,487,1482,18,23.72,<=30,NZ,Home,Upto 2014
TB Burtt,NZ,Spin,1952-02-15,Auckland,New Zealand,1952,1,120,216,1,1,442,1192,12,322,976,11,36.833333333333336,>30,NZ,Home,Upto 2014
TB Burtt,NZ,Spin,1953-03-06,Wellington,New Zealand,1953,1,140,264,2,1,540,1494,12,400,1230,10,45.0,>30,NZ,Home,Upto 2014
TB Mitchell,ENG,Spin,1933-02-10,Brisbane,Australia,1933,2,60,126,3,1,466,1558,15,406,1432,12,31.066666666666666,>30,AUS,Away,Upto 2014
TB Mitchell,ENG,Spin,1933-03-31,Auckland,New Zealand,1933,1,49,108,1,1,345,534,4,296,426,3,86.25,>30,NZ,Away,Upto 2014
TB Mitchell,ENG,Spin,1934-06-08,Nottingham,England,1934,2,108,204,1,1,499,1663,22,391,1459,21,22.681818181818183,<=30,ENG,Home,Upto 2014
TB Mitchell,ENG,Spin,1934-07-20,Leeds,England,1934,1,117,138,0,1,569,1652,17,452,1514,17,33.470588235294116,>30,ENG,Home,Upto 2014
TB Mitchell,ENG,Spin,1935-06-29,Lord's,England,1935,2,164,318,3,1,484,1320,22,320,1002,19,22.0,<=30,ENG,Home,Upto 2014
TB de Bruyn,SA,Pace,2017-07-06,Lord's,England,2017,1,30,30,0,1,720,1257,22,690,1227,22,32.72727272727273,>30,ENG,Away,After 1965
TB de Bruyn,SA,Pace,2017-08-04,Manchester,England,2017,1,18,30,0,1,698,1268,30,680,1238,30,23.266666666666666,<=30,ENG,Away,After 1965
TB de Bruyn,SA,Pace,2018-03-01,Durban,South Africa,2018,1,6,12,0,1,640,1256,26,634,1244,26,24.615384615384617,<=30,SA,Home,After 1965
TB de Bruyn,SA,Pace,2018-07-20,Colombo (SSC),Sri Lanka,2018,1,20,30,0,1,278,518,2,258,488,2,139.0,>30,SL,Away,After 1965
TBA May,AUS,Spin,1987-12-11,Adelaide,Australia,1987,2,202,504,4,1,613,1530,11,411,1026,7,55.72727272727273,>30,AUS,Home,Upto 2014
TBA May,AUS,Spin,1988-09-15,Karachi,Pakistan,1988,1,97,245,4,1,427,1461,22,330,1216,18,19.40909090909091,<=30,PAK,Away,Upto 2014
TBA May,AUS,Spin,1988-09-23,Faisalabad,Pakistan,1988,2,184,322,4,1,520,1112,15,336,790,11,34.666666666666664,>30,PAK,Away,Upto 2014
TBA May,AUS,Spin,1988-10-07,Lahore,Pakistan,1988,2,112,374,6,1,510,1394,19,398,1020,13,26.842105263157894,<=30,PAK,Away,Upto 2014
TBA May,AUS,Spin,1988-11-18,Brisbane,Australia,1988,1,90,174,3,1,172,348,4,82,174,1,43.0,>30,AUS,Home,Upto 2014
TBA May,AUS,Spin,1988-12-02,W.A.C.A,Australia,1988,2,108,144,2,1,185,288,3,77,144,1,61.666666666666664,>30,AUS,Home,Upto 2014
TBA May,AUS,Spin,1989-02-03,Adelaide,Australia,1989,2,102,234,2,1,439,1030,5,337,796,3,87.8,>30,AUS,Home,Upto 2014
TBA May,AUS,Spin,1993-01-23,Adelaide,Australia,1993,2,50,125,7,1,119,287,11,69,162,4,10.818181818181818,<=30,AUS,Home,Upto 2014
TBA May,AUS,Spin,1993-06-17,Lord's,England,1993,2,145,492,6,1,634,1745,17,489,1253,11,37.294117647058826,>30,ENG,Away,Upto 2014
TBA May,AUS,Spin,1993-07-01,Nottingham,England,1993,2,143,316,1,1,460,1186,11,317,870,10,41.81818181818182,>30,ENG,Away,Upto 2014
TBA May,AUS,Spin,1993-07-22,Leeds,England,1993,2,98,252,5,1,214,660,6,116,408,1,35.666666666666664,>30,ENG,Away,Upto 2014
TBA May,AUS,Spin,1993-08-05,Birmingham,England,1993,2,121,404,7,1,613,1738,21,492,1334,14,29.19047619047619,<=30,ENG,Away,Upto 2014
TBA May,AUS,Spin,1993-08-19,The Oval,England,1993,2,85,204,2,1,310,756,7,225,552,5,44.285714285714285,>30,ENG,Away,Upto 2014
TBA May,AUS,Spin,1993-11-26,Hobart,Australia,1993,2,110,339,7,1,270,782,19,160,443,12,14.210526315789474,<=30,AUS,Home,Upto 2014
TBA May,AUS,Spin,1993-12-03,Brisbane,Australia,1993,2,92,222,2,1,392,909,12,300,687,10,32.666666666666664,>30,AUS,Home,Upto 2014
TBA May,AUS,Spin,1993-12-26,Melbourne,Australia,1993,1,58,168,0,1,190,527,4,132,359,4,47.5,>30,AUS,Home,Upto 2014
TBA May,AUS,Spin,1994-01-02,Sydney,Australia,1994,2,87,192,0,1,327,960,14,240,768,14,23.357142857142858,<=30,AUS,Home,Upto 2014
TBA May,AUS,Spin,1994-01-28,Adelaide,Australia,1994,2,83,342,2,1,289,1015,8,206,673,6,36.125,>30,AUS,Home,Upto 2014
TBA May,AUS,Spin,1994-03-04,Johannesburg,South Africa,1994,2,169,366,4,1,318,779,9,149,413,5,35.333333333333336,>30,SA,Away,Upto 2014
TBA May,AUS,Spin,1994-09-28,Karachi,Pakistan,1994,2,122,228,2,1,538,1117,15,416,889,13,35.86666666666667,>30,PAK,Away,Upto 2014
TBA May,AUS,Spin,1994-11-01,Lahore,Pakistan,1994,2,129,324,4,1,660,1368,20,531,1044,16,33.0,>30,PAK,Away,Upto 2014
TBA May,AUS,Spin,1994-11-25,Brisbane,Australia,1994,2,93,312,1,1,405,1216,16,312,904,15,25.3125,<=30,AUS,Home,Upto 2014
TBA May,AUS,Spin,1994-12-24,Melbourne,Australia,1994,2,36,132,0,1,290,880,14,254,748,14,20.714285714285715,<=30,AUS,Home,Upto 2014
TBA May,AUS,Spin,1995-01-01,Sydney,Australia,1995,2,90,162,0,1,330,790,1,240,628,1,330.0,>30,AUS,Home,Upto 2014
TC Lowry,NZ,Spin,1930-02-21,Auckland,New Zealand,1930,1,0,6,0,1,488,1141,10,488,1135,10,48.8,>30,NZ,Home,Upto 2014
TC Lowry,NZ,Spin,1931-08-15,Manchester,England,1931,1,5,6,0,1,146,258,2,141,252,2,73.0,>30,ENG,Away,Upto 2014
TCB Fernando,SL,Pace,2001-11-13,Galle,Sri Lanka,2001,2,90,120,0,1,470,944,10,380,824,10,47.0,>30,SL,Home,Upto 2014
TCB Fernando,SL,Pace,2001-12-27,Colombo (SSC),Sri Lanka,2001,2,80,149,3,1,677,1297,14,597,1148,11,48.357142857142854,>30,SL,Home,Upto 2014
TCB Fernando,SL,Pace,2002-01-04,Kandy,Sri Lanka,2002,2,40,102,4,1,529,977,13,489,875,9,40.69230769230769,>30,SL,Home,Upto 2014
TCB Fernando,SL,Pace,2002-01-12,Galle,Sri Lanka,2002,2,39,78,0,1,402,843,7,363,765,7,57.42857142857143,>30,SL,Home,Upto 2014
TCB Fernando,SL,Pace,2002-03-06,Lahore,Pakistan,2002,2,152,180,3,1,853,1374,23,701,1194,20,37.08695652173913,>30,PAK,Away,Upto 2014
TCB Fernando,SL,Pace,2002-05-16,Lord's,England,2002,2,179,288,3,1,1188,2251,20,1009,1963,17,59.4,>30,ENG,Away,Upto 2014
TCB Fernando,SL,Pace,2002-05-30,Birmingham,England,2002,1,92,131,1,1,687,1192,22,595,1061,21,31.227272727272727,>30,ENG,Away,Upto 2014
TCB Fernando,SL,Pace,2002-07-21,Colombo (PSS),Sri Lanka,2002,2,72,102,2,1,532,738,12,460,636,10,44.333333333333336,>30,SL,Home,Upto 2014
TCB Fernando,SL,Pace,2002-07-28,Colombo (SSC),Sri Lanka,2002,2,48,120,2,1,518,934,16,470,814,14,32.375,>30,SL,Home,Upto 2014
TD Astle,NZ,Spin,2012-11-25,Colombo (PSS),Sri Lanka,2012,2,97,186,1,1,489,1212,15,392,1026,14,32.6,>30,SL,Away,Upto 2014
TD Astle,NZ,Spin,2016-11-17,Christchurch,New Zealand,2016,1,12,24,0,1,79,123,1,67,99,1,79.0,>30,NZ,Home,After 1965
TD Astle,NZ,Spin,2018-03-22,Auckland,New Zealand,2018,1,39,97,3,1,112,223,4,73,126,1,28.0,<=30,NZ,Home,After 1965
TD Astle,NZ,Spin,2019-02-28,Hamilton,New Zealand,2019,2,68,120,0,1,362,462,3,294,342,3,120.66666666666667,>30,NZ,Home,After 1965
TD Astle,NZ,Spin,2020-01-03,Sydney,Australia,2020,2,152,240,3,1,444,825,14,292,585,11,31.714285714285715,>30,AUS,Away,After 1965
TE Bailey,ENG,Pace,1949-06-11,Leeds,England,1949,2,169,249,6,1,597,1077,16,428,828,10,37.3125,>30,ENG,Home,Upto 2014
TE Bailey,ENG,Pace,1949-06-25,Lord's,England,1949,1,136,198,0,1,435,853,4,299,655,4,108.75,>30,ENG,Home,Upto 2014
TE Bailey,ENG,Pace,1949-07-23,Manchester,England,1949,2,155,278,7,1,464,974,13,309,696,6,35.69230769230769,>30,ENG,Home,Upto 2014
TE Bailey,ENG,Pace,1949-08-13,The Oval,England,1949,2,139,223,3,1,489,877,14,350,654,11,34.92857142857143,>30,ENG,Home,Upto 2014
TE Bailey,ENG,Pace,1950-06-08,Manchester,England,1950,2,37,78,1,1,157,402,3,120,324,2,52.333333333333336,>30,ENG,Home,Upto 2014
TE Bailey,ENG,Pace,1950-08-12,The Oval,England,1950,1,84,206,2,1,259,680,4,175,474,2,64.75,>30,ENG,Home,Upto 2014
TE Bailey,ENG,Pace,1950-12-01,Brisbane,Australia,1950,2,50,152,7,1,176,538,19,126,386,12,9.263157894736842,<=30,AUS,Away,Upto 2014
TE Bailey,ENG,Pace,1950-12-22,Melbourne,Australia,1950,2,87,257,6,1,311,916,19,224,659,13,16.36842105263158,<=30,AUS,Away,Upto 2014
TE Bailey,ENG,Pace,1951-02-23,Melbourne,Australia,1951,2,61,192,1,1,340,912,18,279,720,17,18.88888888888889,<=30,AUS,Away,Upto 2014
TE Bailey,ENG,Pace,1951-03-17,Christchurch,New Zealand,1951,1,51,180,2,1,365,1014,6,314,834,4,60.833333333333336,>30,NZ,Away,Upto 2014
TE Bailey,ENG,Pace,1951-03-24,Wellington,New Zealand,1951,2,61,152,5,1,192,572,8,131,420,3,24.0,<=30,NZ,Away,Upto 2014
TE Bailey,ENG,Pace,1951-06-07,Nottingham,England,1951,2,112,282,0,1,538,1446,18,426,1164,18,29.88888888888889,<=30,ENG,Home,Upto 2014
TE Bailey,ENG,Pace,1951-07-26,Leeds,England,1951,2,56,108,0,1,354,984,3,298,876,3,118.0,>30,ENG,Home,Upto 2014
TE Bailey,ENG,Pace,1953-06-11,Nottingham,England,1953,2,103,294,2,1,325,969,23,222,675,21,14.130434782608695,<=30,ENG,Home,Upto 2014
TE Bailey,ENG,Pace,1953-06-25,Lord's,England,1953,2,79,156,0,1,553,1514,19,474,1358,19,29.105263157894736,<=30,ENG,Home,Upto 2014
TE Bailey,ENG,Pace,1953-07-09,Manchester,England,1953,1,83,156,1,1,352,924,14,269,768,13,25.142857142857142,<=30,ENG,Home,Upto 2014
TE Bailey,ENG,Pace,1953-07-23,Leeds,England,1953,2,80,168,4,1,617,1986,30,537,1818,26,20.566666666666666,<=30,ENG,Home,Upto 2014
TE Bailey,ENG,Pace,1953-08-15,The Oval,England,1953,1,42,84,1,1,504,1206,15,462,1122,14,33.6,>30,ENG,Home,Upto 2014
TE Bailey,ENG,Pace,1954-01-15,Kingston,West Indies,1954,2,82,216,1,1,630,1500,20,548,1284,19,31.5,>30,WI,Away,Upto 2014
TE Bailey,ENG,Pace,1954-02-06,Bridgetown,West Indies,1954,2,111,204,1,1,376,820,10,265,616,9,37.6,>30,WI,Away,Upto 2014
TE Bailey,ENG,Pace,1954-02-24,Georgetown,West Indies,1954,2,54,162,2,1,302,702,8,248,540,6,37.75,>30,WI,Away,Upto 2014
TE Bailey,ENG,Pace,1954-03-17,Port of Spain,West Indies,1954,2,124,264,2,1,458,1100,10,334,836,8,45.8,>30,WI,Away,Upto 2014
TE Bailey,ENG,Pace,1954-03-30,Kingston,West Indies,1954,2,88,246,8,1,363,910,17,275,664,9,21.352941176470587,<=30,WI,Away,Upto 2014
TE Bailey,ENG,Pace,1954-06-10,Lord's,England,1954,2,14,54,1,1,164,348,14,150,294,13,11.714285714285714,<=30,ENG,Home,Upto 2014
TE Bailey,ENG,Pace,1954-07-01,Nottingham,England,1954,1,18,18,0,1,686,1378,19,668,1360,19,36.10526315789474,>30,ENG,Home,Upto 2014
TE Bailey,ENG,Pace,1954-11-26,Brisbane,Australia,1954,1,140,208,3,1,750,1616,15,610,1408,12,50.0,>30,AUS,Away,Upto 2014
TE Bailey,ENG,Pace,1954-12-17,Sydney,Australia,1954,2,80,188,4,1,649,1696,33,569,1508,29,19.666666666666668,<=30,AUS,Away,Upto 2014
TE Bailey,ENG,Pace,1954-12-31,Melbourne,Australia,1954,2,47,96,0,1,538,1484,30,491,1388,30,17.933333333333334,<=30,AUS,Away,Upto 2014
TE Bailey,ENG,Pace,1955-01-28,Adelaide,Australia,1955,1,39,96,3,1,511,1397,23,472,1301,20,22.217391304347824,<=30,AUS,Away,Upto 2014
TE Bailey,ENG,Pace,1955-03-11,Dunedin,New Zealand,1955,2,28,122,2,1,287,993,22,259,871,20,13.045454545454545,<=30,NZ,Away,Upto 2014
TE Bailey,ENG,Pace,1955-03-25,Auckland,New Zealand,1955,1,34,78,0,1,296,880,23,262,802,23,12.869565217391305,<=30,NZ,Away,Upto 2014
TE Bailey,ENG,Pace,1955-06-09,Nottingham,England,1955,2,29,132,2,1,443,1507,20,414,1375,18,22.15,<=30,ENG,Home,Upto 2014
TE Bailey,ENG,Pace,1955-06-23,Lord's,England,1955,1,56,96,1,1,632,1622,27,576,1526,26,23.40740740740741,<=30,ENG,Home,Upto 2014
TE Bailey,ENG,Pace,1955-07-07,Manchester,England,1955,1,102,222,1,1,835,1929,28,733,1707,27,29.821428571428573,<=30,ENG,Home,Upto 2014
TE Bailey,ENG,Pace,1955-07-21,Leeds,England,1955,2,120,341,4,1,618,1800,24,498,1459,20,25.75,<=30,ENG,Home,Upto 2014
TE Bailey,ENG,Pace,1955-08-13,The Oval,England,1955,2,21,66,1,1,283,1030,15,262,964,14,18.866666666666667,<=30,ENG,Home,Upto 2014
TE Bailey,ENG,Pace,1956-06-07,Nottingham,England,1956,2,24,72,0,1,363,976,12,339,904,12,30.25,>30,ENG,Home,Upto 2014
TE Bailey,ENG,Pace,1956-06-21,Lord's,England,1956,2,136,353,6,1,698,1897,33,562,1544,27,21.151515151515152,<=30,ENG,Home,Upto 2014
TE Bailey,ENG,Pace,1956-07-12,Leeds,England,1956,2,28,84,0,1,232,778,8,204,694,8,29.0,<=30,ENG,Home,Upto 2014
TE Bailey,ENG,Pace,1956-07-26,Manchester,England,1956,2,35,144,0,1,233,663,3,198,519,3,77.66666666666667,>30,ENG,Home,Upto 2014
TE Bailey,ENG,Pace,1956-12-24,Johannesburg,South Africa,1956,2,53,244,8,1,465,1730,29,412,1486,21,16.03448275862069,<=30,SA,Away,Upto 2014
TE Bailey,ENG,Pace,1957-01-01,Cape Town,South Africa,1957,1,13,88,0,1,496,1551,13,483,1463,13,38.15384615384615,>30,SA,Away,Upto 2014
TE Bailey,ENG,Pace,1957-01-25,Durban,South Africa,1957,1,38,136,1,1,495,1563,15,457,1427,14,33.0,>30,SA,Away,Upto 2014
TE Bailey,ENG,Pace,1957-02-15,Johannesburg,South Africa,1957,2,66,272,5,1,520,1730,17,454,1458,12,30.58823529411765,>30,SA,Away,Upto 2014
TE Bailey,ENG,Pace,1957-03-01,Gqeberha,South Africa,1957,2,62,399,5,1,275,1498,30,213,1099,25,9.166666666666666,<=30,SA,Away,Upto 2014
TE Bailey,ENG,Pace,1957-05-30,Birmingham,England,1957,1,80,204,0,1,447,978,10,367,774,10,44.7,>30,ENG,Home,Upto 2014
TE Bailey,ENG,Pace,1957-06-20,Lord's,England,1957,2,98,258,11,1,433,973,23,335,715,12,18.82608695652174,<=30,ENG,Home,Upto 2014
TE Bailey,ENG,Pace,1957-07-04,Nottingham,England,1957,2,99,240,1,1,642,1416,17,543,1176,16,37.76470588235294,>30,ENG,Home,Upto 2014
TE Bailey,ENG,Pace,1958-06-05,Birmingham,England,1958,2,40,240,4,1,493,1493,26,453,1253,22,18.96153846153846,<=30,ENG,Home,Upto 2014
TE Bailey,ENG,Pace,1958-06-19,Lord's,England,1958,2,11,36,1,1,233,706,14,222,670,13,16.642857142857142,<=30,ENG,Home,Upto 2014
TE Bailey,ENG,Pace,1958-07-03,Leeds,England,1958,2,10,36,0,1,193,612,2,183,576,2,96.5,>30,ENG,Home,Upto 2014
TE Bailey,ENG,Pace,1958-08-21,The Oval,England,1958,1,32,84,2,1,285,708,12,253,624,10,23.75,<=30,ENG,Home,Upto 2014
TE Bailey,ENG,Pace,1958-12-05,Brisbane,Australia,1958,2,56,144,3,1,361,1352,20,305,1208,17,18.05,<=30,AUS,Away,Upto 2014
TE Bailey,ENG,Pace,1958-12-31,Melbourne,Australia,1958,1,50,128,0,1,456,1361,29,406,1233,29,15.724137931034482,<=30,AUS,Away,Upto 2014
TE Bailey,ENG,Pace,1959-01-09,Sydney,Australia,1959,1,19,40,0,1,297,1016,5,278,976,5,59.4,>30,AUS,Away,Upto 2014
TE Bailey,ENG,Pace,1959-01-30,Adelaide,Australia,1959,1,91,176,1,1,681,1789,20,590,1613,19,34.05,>30,AUS,Away,Upto 2014
TE Bailey,ENG,Pace,1959-02-13,Melbourne,Australia,1959,1,43,112,0,1,613,1344,20,570,1232,20,30.65,>30,AUS,Away,Upto 2014
TE Kane,IRE,Pace,2018-05-11,Dublin (Malahide),Ireland,2018,2,103,156,0,1,792,1625,28,689,1469,28,28.285714285714285,<=30,IRE,Home,After 1965
TF Johnson,WI,Pace,1939-08-19,The Oval,England,1939,2,129,240,3,1,751,1240,17,622,1000,14,44.1764705882353,>30,ENG,Away,Upto 2014
TF Smailes,ENG,Pace,1946-06-22,Lord's,England,1946,2,62,120,3,1,522,1272,22,460,1152,19,23.727272727272727,<=30,ENG,Home,Upto 2014
TF van Woerkom,IRE,Spin,2024-02-28,Tolerance Oval,UAE,2024,2,55,108,1,1,298,624,8,243,516,7,37.25,>30,UAE,Away,After 1965
TG Hogan,AUS,Spin,1983-04-22,Kandy,Sri Lanka,1983,2,116,218,6,1,499,919,15,383,701,9,33.266666666666666,>30,SL,Away,Upto 2014
TG Hogan,AUS,Spin,1983-12-09,Adelaide,Australia,1983,1,107,222,1,1,433,870,5,326,648,4,86.6,>30,AUS,Home,Upto 2014
TG Hogan,AUS,Spin,1984-03-02,Georgetown,West Indies,1984,2,130,264,4,1,284,720,8,154,456,4,35.5,>30,WI,Away,Upto 2014
TG Hogan,AUS,Spin,1984-03-16,Port of Spain,West Indies,1984,1,123,168,2,1,293,601,6,170,433,4,48.833333333333336,>30,WI,Away,Upto 2014
TG Hogan,AUS,Spin,1984-03-30,Bridgetown,West Indies,1984,1,97,204,0,1,192,492,2,95,288,2,96.0,>30,WI,Away,Upto 2014
TG Hogan,AUS,Spin,1984-04-07,St John's,West Indies,1984,1,65,180,0,1,154,360,2,89,180,2,77.0,>30,WI,Away,Upto 2014
TG Hogan,AUS,Spin,1984-04-28,Kingston,West Indies,1984,1,68,180,2,1,133,378,4,65,198,2,33.25,>30,WI,Away,Upto 2014
TG Southee,NZ,Pace,2008-03-22,Napier,New Zealand,2008,2,139,283,5,1,793,1402,23,654,1119,18,34.47826086956522,>30,NZ,Home,Upto 2014
TG Southee,NZ,Pace,2008-05-15,Lord's,England,2008,1,59,96,0,1,640,1330,19,581,1234,19,33.68421052631579,>30,ENG,Away,Upto 2014
TG Southee,NZ,Pace,2008-11-20,Brisbane,Australia,2008,2,125,206,5,1,700,1373,36,575,1167,31,19.444444444444443,<=30,AUS,Away,Upto 2014
TG Southee,NZ,Pace,2008-11-28,Adelaide,Australia,2008,1,100,162,0,1,688,1276,20,588,1114,20,34.4,>30,AUS,Away,Upto 2014
TG Southee,NZ,Pace,2009-04-03,Wellington,New Zealand,2009,2,152,180,2,1,869,1366,23,717,1186,21,37.78260869565217,>30,NZ,Home,Upto 2014
TG Southee,NZ,Pace,2009-12-11,Napier,New Zealand,2009,2,126,288,3,1,858,1683,18,732,1395,15,47.666666666666664,>30,NZ,Home,Upto 2014
TG Southee,NZ,Pace,2010-02-15,Hamilton,New Zealand,2010,2,103,162,4,1,762,1104,17,659,942,13,44.8235294117647,>30,NZ,Home,Upto 2014
TG Southee,NZ,Pace,2010-03-19,Wellington,New Zealand,2010,1,68,114,0,1,767,1410,18,699,1296,18,42.611111111111114,>30,NZ,Home,Upto 2014
TG Southee,NZ,Pace,2010-03-27,Hamilton,New Zealand,2010,2,150,252,6,1,795,1294,27,645,1042,21,29.444444444444443,<=30,NZ,Home,Upto 2014
TG Southee,NZ,Pace,2010-11-12,Hyderabad,India,2010,2,130,222,3,1,606,1065,12,476,843,9,50.5,>30,IND,Away,Upto 2014
TG Southee,NZ,Pace,2010-11-20,Nagpur,India,2010,1,94,174,1,1,407,788,13,313,614,12,31.307692307692307,>30,IND,Away,Upto 2014
TG Southee,NZ,Pace,2011-01-07,Hamilton,New Zealand,2011,2,92,202,2,1,564,1033,21,472,831,19,26.857142857142858,<=30,NZ,Home,Upto 2014
TG Southee,NZ,Pace,2011-01-15,Wellington,New Zealand,2011,2,151,258,4,1,781,1511,23,630,1253,19,33.95652173913044,>30,NZ,Home,Upto 2014
TG Southee,NZ,Pace,2011-12-01,Brisbane,Australia,2011,2,114,176,2,1,653,1114,19,539,938,17,34.36842105263158,>30,AUS,Away,Upto 2014
TG Southee,NZ,Pace,2011-12-09,Hobart,Australia,2011,2,109,186,3,1,648,1341,37,539,1155,34,17.513513513513512,<=30,AUS,Away,Upto 2014
TG Southee,NZ,Pace,2012-01-26,Napier,New Zealand,2012,2,28,71,2,1,497,972,21,469,901,19,23.666666666666668,<=30,NZ,Home,Upto 2014
TG Southee,NZ,Pace,2012-03-07,Dunedin,New Zealand,2012,2,140,216,0,1,860,1498,21,720,1282,21,40.95238095238095,>30,NZ,Home,Upto 2014
TG Southee,NZ,Pace,2012-08-02,Kingston,West Indies,2012,2,100,198,3,1,597,1132,23,497,934,20,25.956521739130434,<=30,WI,Away,Upto 2014
TG Southee,NZ,Pace,2012-08-31,Bengaluru,India,2012,2,132,252,8,1,733,1159,18,601,907,10,40.72222222222222,>30,IND,Away,Upto 2014
TG Southee,NZ,Pace,2012-11-17,Galle,Sri Lanka,2012,1,46,108,4,1,371,706,14,325,598,10,26.5,<=30,SL,Away,Upto 2014
TG Southee,NZ,Pace,2012-11-25,Colombo (PSS),Sri Lanka,2012,2,120,252,8,1,530,1109,22,410,857,14,24.09090909090909,<=30,SL,Away,Upto 2014
TG Southee,NZ,Pace,2013-03-06,Dunedin,New Zealand,2013,2,139,306,1,1,764,1468,18,625,1162,17,42.44444444444444,>30,NZ,Home,Upto 2014
TG Southee,NZ,Pace,2013-03-14,Wellington,New Zealand,2013,1,77,192,0,1,612,1184,15,535,992,15,40.8,>30,NZ,Home,Upto 2014
TG Southee,NZ,Pace,2013-03-22,Auckland,New Zealand,2013,2,121,320,5,1,822,1793,28,701,1473,23,29.357142857142858,<=30,NZ,Home,Upto 2014
TG Southee,NZ,Pace,2013-05-16,Lord's,England,2013,2,108,284,10,1,569,1283,36,461,999,26,15.805555555555555,<=30,ENG,Away,Upto 2014
TG Southee,NZ,Pace,2013-05-24,Leeds,England,2013,2,127,246,2,1,701,1279,21,574,1033,19,33.38095238095238,>30,ENG,Away,Upto 2014
TG Southee,NZ,Pace,2013-12-03,Dunedin,New Zealand,2013,2,153,271,6,1,879,1520,20,726,1249,14,43.95,>30,NZ,Home,Upto 2014
TG Southee,NZ,Pace,2013-12-11,Wellington,New Zealand,2013,2,82,161,5,1,603,1007,28,521,846,23,21.535714285714285,<=30,NZ,Home,Upto 2014
TG Southee,NZ,Pace,2013-12-19,Hamilton,New Zealand,2013,2,91,221,7,1,543,1073,23,452,852,16,23.608695652173914,<=30,NZ,Home,Upto 2014
TG Southee,NZ,Pace,2014-02-06,Auckland,New Zealand,2014,2,119,252,6,1,873,1527,37,754,1275,31,23.594594594594593,<=30,NZ,Home,After 1965
TG Southee,NZ,Pace,2014-02-14,Wellington,New Zealand,2014,2,143,216,5,1,1271,2109,30,1128,1893,25,42.36666666666667,>30,NZ,Home,After 1965
TG Southee,NZ,Pace,2014-06-08,Kingston,West Indies,2014,2,51,152,6,1,334,854,13,283,702,7,25.692307692307693,<=30,WI,Away,After 1965
TG Southee,NZ,Pace,2014-06-16,Port of Spain,West Indies,2014,2,90,204,1,1,611,1256,20,521,1052,19,30.55,>30,WI,Away,After 1965
TG Southee,NZ,Pace,2014-06-26,Bridgetown,West Indies,2014,2,91,222,4,1,620,1276,27,529,1054,23,22.962962962962962,<=30,WI,Away,After 1965
TG Southee,NZ,Pace,2014-11-09,Abu Dhabi,UAE,2014,2,95,192,0,1,447,927,10,352,735,10,44.7,>30,UAE,Away,After 1965
TG Southee,NZ,Pace,2014-11-17,Dubai (DICS),UAE,2014,2,88,246,4,1,426,1086,12,338,840,8,35.5,>30,UAE,Away,After 1965
TG Southee,NZ,Pace,2014-11-26,Sharjah,UAE,2014,2,74,210,1,1,429,804,9,355,594,8,47.666666666666664,>30,UAE,Away,After 1965
TG Southee,NZ,Pace,2014-12-26,Christchurch,New Zealand,2014,2,108,294,6,1,757,1417,28,649,1123,22,27.035714285714285,<=30,NZ,Home,After 1965
TG Southee,NZ,Pace,2015-01-03,Wellington,New Zealand,2015,2,128,262,2,1,987,1835,28,859,1573,26,35.25,>30,NZ,Home,After 1965
TG Southee,NZ,Pace,2015-05-21,Lord's,England,2015,2,266,348,3,1,1185,2044,33,919,1696,30,35.90909090909091,>30,ENG,Away,After 1965
TG Southee,NZ,Pace,2015-05-29,Leeds,England,2015,2,126,288,5,1,1058,1587,28,932,1299,23,37.785714285714285,>30,ENG,Away,After 1965
TG Southee,NZ,Pace,2015-11-05,Brisbane,Australia,2015,1,70,144,1,1,1023,1505,20,953,1361,19,51.15,>30,AUS,Away,After 1965
TG Southee,NZ,Pace,2015-11-13,W.A.C.A,Australia,2015,2,185,324,4,1,1234,1914,22,1049,1590,18,56.09090909090909,>30,AUS,Away,After 1965
TG Southee,NZ,Pace,2015-11-27,Adelaide,Australia,2015,2,108,198,1,1,584,1142,29,476,944,28,20.137931034482758,<=30,AUS,Away,After 1965
TG Southee,NZ,Pace,2015-12-10,Dunedin,New Zealand,2015,2,123,288,6,1,942,1677,26,819,1389,20,36.23076923076923,>30,NZ,Home,After 1965
TG Southee,NZ,Pace,2015-12-18,Hamilton,New Zealand,2015,2,89,201,7,1,667,1250,30,578,1049,23,22.233333333333334,<=30,NZ,Home,After 1965
TG Southee,NZ,Pace,2016-02-12,Wellington,New Zealand,2016,1,87,186,2,1,769,1383,21,682,1197,19,36.61904761904762,>30,NZ,Home,After 1965
TG Southee,NZ,Pace,2016-02-20,Christchurch,New Zealand,2016,2,115,192,1,1,1247,2076,29,1132,1884,28,43.0,>30,NZ,Home,After 1965
TG Southee,NZ,Pace,2016-07-28,Bulawayo,Zimbabwe,2016,2,96,192,4,1,542,1115,20,446,923,16,27.1,<=30,ZIM,Away,After 1965
TG Southee,NZ,Pace,2016-08-06,Bulawayo,Zimbabwe,2016,2,108,252,2,1,578,1230,11,470,978,9,52.54545454545455,>30,ZIM,Away,After 1965
TG Southee,NZ,Pace,2016-08-19,Durban,South Africa,2016,1,80,138,1,1,247,526,10,167,388,9,24.7,<=30,SA,Away,After 1965
TG Southee,NZ,Pace,2016-08-27,Centurion,South Africa,2016,2,160,306,4,1,829,1709,31,669,1403,27,26.741935483870968,<=30,SA,Away,After 1965
TG Southee,NZ,Pace,2016-11-17,Christchurch,New Zealand,2016,2,73,256,5,1,500,1232,31,427,976,26,16.129032258064516,<=30,NZ,Home,After 1965
TG Southee,NZ,Pace,2016-11-25,Hamilton,New Zealand,2016,2,140,270,8,1,921,1796,32,781,1526,24,28.78125,<=30,NZ,Home,After 1965
TG Southee,NZ,Pace,2017-01-12,Wellington,New Zealand,2017,2,192,282,3,1,1047,1639,21,855,1357,18,49.857142857142854,>30,NZ,Home,After 1965
TG Southee,NZ,Pace,2017-01-20,Christchurch,New Zealand,2017,2,142,248,8,1,735,1238,24,593,990,16,30.625,>30,NZ,Home,After 1965
TG Southee,NZ,Pace,2017-03-16,Wellington,New Zealand,2017,2,115,198,3,1,662,1203,19,547,1005,16,34.8421052631579,>30,NZ,Home,After 1965
TG Southee,NZ,Pace,2017-12-09,Hamilton,New Zealand,2017,2,105,228,4,1,876,1573,33,771,1345,29,26.545454545454547,<=30,NZ,Home,After 1965
TG Southee,NZ,Pace,2018-03-22,Auckland,New Zealand,2018,2,111,216,5,1,669,1504,24,558,1288,19,27.875,<=30,NZ,Home,After 1965
TG Southee,NZ,Pace,2018-03-30,Christchurch,New Zealand,2018,2,127,270,7,1,933,2022,34,806,1752,27,27.441176470588236,<=30,NZ,Home,After 1965
TG Southee,NZ,Pace,2018-12-03,Abu Dhabi,UAE,2018,2,98,222,4,1,467,990,12,369,768,8,38.916666666666664,>30,UAE,Away,After 1965
TG Southee,NZ,Pace,2018-12-15,Wellington,New Zealand,2018,2,120,312,8,1,859,1641,18,739,1329,10,47.72222222222222,>30,NZ,Home,After 1965
TG Southee,NZ,Pace,2018-12-26,Christchurch,New Zealand,2018,2,96,252,5,1,838,1658,30,742,1406,25,27.933333333333334,<=30,NZ,Home,After 1965
TG Southee,NZ,Pace,2019-02-28,Hamilton,New Zealand,2019,2,174,228,6,1,1009,1490,23,835,1262,17,43.869565217391305,>30,NZ,Home,After 1965
TG Southee,NZ,Pace,2019-03-08,Wellington,New Zealand,2019,2,109,162,1,1,692,1031,24,583,869,23,28.833333333333332,<=30,NZ,Home,After 1965
TG Southee,NZ,Pace,2019-08-14,Galle,Sri Lanka,2019,2,50,114,1,1,263,591,10,213,477,9,26.3,<=30,SL,Away,After 1965
TG Southee,NZ,Pace,2019-08-22,Colombo (PSS),Sri Lanka,2019,2,78,246,6,1,360,808,14,282,562,8,25.714285714285715,<=30,SL,Away,After 1965
TG Southee,NZ,Pace,2019-11-21,Mount Maunganui,New Zealand,2019,2,148,312,5,1,805,1856,23,657,1544,18,35.0,>30,NZ,Home,After 1965
TG Southee,NZ,Pace,2019-11-29,Hamilton,New Zealand,2019,1,90,222,2,1,881,1878,20,791,1656,18,44.05,>30,NZ,Home,After 1965
TG Southee,NZ,Pace,2019-12-12,Perth,Australia,2019,2,162,309,9,1,626,1383,31,464,1074,22,20.193548387096776,<=30,AUS,Away,After 1965
TG Southee,NZ,Pace,2019-12-26,Melbourne,Australia,2019,2,147,289,3,1,729,1616,26,582,1327,23,28.03846153846154,<=30,AUS,Away,After 1965
TG Southee,NZ,Pace,2020-02-21,Wellington,New Zealand,2020,2,110,247,9,1,586,1297,26,476,1050,17,22.53846153846154,<=30,NZ,Home,After 1965
TG Southee,NZ,Pace,2020-02-29,Christchurch,New Zealand,2020,2,74,144,5,1,623,1219,30,549,1075,25,20.766666666666666,<=30,NZ,Home,After 1965
TG Southee,NZ,Pace,2020-12-03,Hamilton,New Zealand,2020,2,97,204,5,1,725,1439,25,628,1235,20,29.0,<=30,NZ,Home,After 1965
TG Southee,NZ,Pace,2020-12-11,Wellington,New Zealand,2020,2,128,238,7,1,834,1421,28,706,1183,21,29.785714285714285,<=30,NZ,Home,After 1965
TG Southee,NZ,Pace,2020-12-26,Mount Maunganui,New Zealand,2020,2,102,294,4,1,873,2105,28,771,1811,24,31.178571428571427,>30,NZ,Home,After 1965
TG Southee,NZ,Pace,2021-01-03,Christchurch,New Zealand,2021,2,106,258,2,1,918,1730,25,812,1472,23,36.72,>30,NZ,Home,After 1965
TG Southee,NZ,Pace,2021-06-02,Lord's,England,2021,2,80,253,7,1,792,1822,27,712,1569,20,29.333333333333332,<=30,ENG,Away,After 1965
TG Southee,NZ,Pace,2021-06-18,Southampton,England,2021,2,112,246,5,1,643,1620,27,531,1374,22,23.814814814814813,<=30,ENG,Away,After 1965
TG Southee,NZ,Pace,2021-11-25,Kanpur,India,2021,2,144,298,8,1,414,852,16,270,554,8,25.875,<=30,IND,Away,After 1965
TG Southee,NZ,Pace,2021-12-03,Wankhede,India,2021,2,74,210,0,1,192,474,3,118,264,3,64.0,>30,IND,Away,After 1965
TG Southee,NZ,Pace,2022-01-01,Mount Maunganui,New Zealand,2022,2,135,258,3,1,752,1693,25,617,1435,22,30.08,>30,NZ,Home,After 1965
TG Southee,NZ,Pace,2022-01-09,Christchurch,New Zealand,2022,2,82,174,4,1,738,1267,23,656,1093,19,32.08695652173913,>30,NZ,Home,After 1965
TG Southee,NZ,Pace,2022-02-17,Christchurch,New Zealand,2022,2,68,178,6,1,630,1205,28,562,1027,22,22.5,<=30,NZ,Home,After 1965
TG Southee,NZ,Pace,2022-02-25,Christchurch,New Zealand,2022,2,165,348,3,1,1098,2154,35,933,1806,32,31.37142857142857,>30,NZ,Home,After 1965
TG Southee,NZ,Pace,2022-06-02,Lord's,England,2022,2,142,227,4,1,722,1408,33,580,1181,29,21.87878787878788,<=30,ENG,Away,After 1965
TG Southee,NZ,Pace,2022-06-10,Nottingham,England,2022,2,221,258,1,1,1254,1921,26,1033,1663,25,48.23076923076923,>30,ENG,Away,After 1965
TG Southee,NZ,Pace,2022-06-23,Leeds,England,2022,2,168,252,4,1,862,1428,19,694,1176,15,45.36842105263158,>30,ENG,Away,After 1965
TG Southee,NZ,Pace,2022-12-26,Karachi,Pakistan,2022,2,108,245,3,1,287,569,4,179,324,1,71.75,>30,PAK,Away,After 1965
TG Southee,NZ,Pace,2023-01-02,Karachi,Pakistan,2023,2,105,270,3,1,583,1266,12,478,996,9,48.583333333333336,>30,PAK,Away,After 1965
TG Southee,NZ,Pace,2023-02-16,Mount Maunganui,New Zealand,2023,2,120,168,2,1,901,1216,34,781,1048,32,26.5,<=30,NZ,Home,After 1965
TG Southee,NZ,Pace,2023-02-24,Wellington,New Zealand,2023,2,138,265,4,1,965,1553,25,827,1288,21,38.6,>30,NZ,Home,After 1965
TG Southee,NZ,Pace,2023-03-09,Christchurch,New Zealand,2023,2,121,319,7,1,1067,1960,32,946,1641,25,33.34375,>30,NZ,Home,After 1965
TG Southee,NZ,Pace,2023-03-17,Wellington,New Zealand,2023,2,73,252,4,1,761,1427,16,688,1175,12,47.5625,>30,NZ,Home,After 1965
TG Southee,NZ,Pace,2023-11-28,Sylhet,Bangladesh,2023,2,76,175,2,1,222,475,6,146,300,4,37.0,>30,BAN,Away,After 1965
TG Southee,NZ,Pace,2023-12-06,Mirpur,Bangladesh,2023,2,25,68,2,1,57,146,5,32,78,3,11.4,<=30,BAN,Away,After 1965
TG Southee,NZ,Pace,2024-02-04,Mount Maunganui,New Zealand,2024,2,87,138,1,1,753,1368,17,666,1230,16,44.294117647058826,>30,NZ,Home,After 1965
TG Southee,NZ,Pace,2024-02-13,Hamilton,New Zealand,2024,2,96,204,1,1,507,1179,18,411,975,17,28.166666666666668,<=30,NZ,Home,After 1965
TG Southee,NZ,Pace,2024-02-29,Wellington,New Zealand,2024,2,138,229,2,1,689,1266,22,551,1037,20,31.318181818181817,>30,NZ,Home,After 1965
TG Southee,NZ,Pace,2024-03-08,Christchurch,New Zealand,2024,2,107,192,2,1,918,1490,33,811,1298,31,27.818181818181817,<=30,NZ,Home,After 1965
TG Southee,NZ,Pace,2024-09-18,Galle,Sri Lanka,2024,2,87,180,1,1,264,533,10,177,353,9,26.4,<=30,SL,Away,After 1965
TG Southee,NZ,Pace,2024-09-26,Galle,Sri Lanka,2024,1,70,114,1,1,205,300,2,135,186,1,102.5,>30,SL,Away,After 1965
TG Southee,NZ,Pace,2024-10-16,Bengaluru,India,2024,2,61,126,2,1,462,863,22,401,737,20,21.0,<=30,IND,Away,After 1965
TG Southee,NZ,Pace,2024-10-24,Pune,India,2024,2,33,48,1,1,141,192,1,108,144,0,141.0,>30,IND,Away,After 1965
TG Southee,NZ,Pace,2024-11-28,Christchurch,New Zealand,2024,2,112,138,2,1,709,1026,15,597,888,13,47.266666666666666,>30,NZ,Home,After 1965
TG Southee,NZ,Pace,2024-12-06,Wellington,New Zealand,2024,2,134,156,2,1,601,832,22,467,676,20,27.318181818181817,<=30,NZ,Home,After 1965
TG Southee,NZ,Pace,2024-12-14,Hamilton,New Zealand,2024,2,80,114,2,1,652,1099,24,572,985,22,27.166666666666668,<=30,NZ,Home,After 1965
TJ Friend,ZIM,Pace,2001-06-15,Harare,Zimbabwe,2001,2,95,254,3,1,726,1580,27,631,1326,24,26.88888888888889,<=30,ZIM,Home,Upto 2014
TJ Friend,ZIM,Pace,2001-09-07,Harare,Zimbabwe,2001,2,191,204,3,1,919,1718,19,728,1514,16,48.36842105263158,>30,ZIM,Home,Upto 2014
TJ Friend,ZIM,Pace,2001-09-14,Bulawayo,Zimbabwe,2001,1,87,182,3,1,548,1308,7,461,1126,4,78.28571428571429,>30,ZIM,Home,Upto 2014
TJ Friend,ZIM,Pace,2001-11-08,Dhaka,Bangladesh,2001,2,57,178,7,1,386,858,18,329,680,11,21.444444444444443,<=30,BAN,Away,Upto 2014
TJ Friend,ZIM,Pace,2001-11-15,Chattogram,Bangladesh,2001,2,116,246,1,1,536,1126,10,420,880,9,53.6,>30,BAN,Away,Upto 2014
TJ Friend,ZIM,Pace,2001-12-27,Colombo (SSC),Sri Lanka,2001,1,102,162,0,1,677,1297,14,575,1135,14,48.357142857142854,>30,SL,Away,Upto 2014
TJ Friend,ZIM,Pace,2002-01-04,Kandy,Sri Lanka,2002,1,97,156,3,1,529,977,13,432,821,10,40.69230769230769,>30,SL,Away,Upto 2014
TJ Friend,ZIM,Pace,2002-01-12,Galle,Sri Lanka,2002,2,97,198,2,1,402,843,7,305,645,5,57.42857142857143,>30,SL,Away,Upto 2014
TJ Friend,ZIM,Pace,2002-02-21,Nagpur,India,2002,1,61,132,0,1,439,839,7,378,707,7,62.714285714285715,>30,IND,Away,Upto 2014
TJ Friend,ZIM,Pace,2002-02-28,Delhi,India,2002,2,92,132,1,1,446,889,10,354,757,9,44.6,>30,IND,Away,Upto 2014
TJ Friend,ZIM,Pace,2003-05-22,Lord's,England,2003,1,49,78,1,1,641,1236,26,592,1158,25,24.653846153846153,<=30,ENG,Away,Upto 2014
TJ Friend,ZIM,Pace,2003-06-05,Chester-le-Street,England,2003,1,26,24,0,1,554,1098,27,528,1074,27,20.51851851851852,<=30,ENG,Away,Upto 2014
TJ Friend,ZIM,Pace,2004-02-26,Bulawayo,Zimbabwe,2004,1,20,54,1,1,218,510,6,198,456,5,36.333333333333336,>30,ZIM,Home,Upto 2014
TJ Jenner,AUS,Spin,1970-11-27,Brisbane,Australia,1970,2,95,230,2,1,461,1342,10,366,1112,8,46.1,>30,AUS,Home,Upto 2014
TJ Jenner,AUS,Spin,1971-02-12,Sydney,Australia,1971,2,81,296,4,1,385,1254,19,304,958,15,20.263157894736842,<=30,AUS,Home,Upto 2014
TJ Jenner,AUS,Spin,1973-03-09,Bridgetown,West Indies,1973,1,65,168,3,1,470,1314,10,405,1146,7,47.0,>30,WI,Away,Upto 2014
TJ Jenner,AUS,Spin,1973-03-23,Port of Spain,West Indies,1973,2,144,321,4,1,758,1913,26,614,1592,22,29.153846153846153,<=30,WI,Away,Upto 2014
TJ Jenner,AUS,Spin,1973-04-06,Georgetown,West Indies,1973,1,15,42,0,1,241,564,5,226,522,5,48.2,>30,WI,Away,Upto 2014
TJ Jenner,AUS,Spin,1973-04-21,Port of Spain,West Indies,1973,2,123,296,6,1,694,1730,21,571,1434,15,33.04761904761905,>30,WI,Away,Upto 2014
TJ Jenner,AUS,Spin,1974-11-29,Brisbane,Australia,1974,2,69,176,2,1,316,776,7,247,600,5,45.142857142857146,>30,AUS,Home,Upto 2014
TJ Jenner,AUS,Spin,1975-01-25,Adelaide,Australia,1975,2,67,160,1,1,485,1136,17,418,976,16,28.529411764705884,<=30,AUS,Home,Upto 2014
TJ Jenner,AUS,Spin,1975-11-28,Brisbane,Australia,1975,2,90,192,2,1,448,1067,12,358,875,10,37.333333333333336,>30,AUS,Home,Upto 2014
TJ Laughlin,AUS,Pace,1978-03-31,Georgetown,West Indies,1978,2,67,102,1,1,786,1458,28,719,1356,27,28.071428571428573,<=30,WI,Away,Upto 2014
TJ Laughlin,AUS,Pace,1978-04-28,Kingston,West Indies,1978,2,135,214,5,1,520,1042,12,385,828,7,43.333333333333336,>30,WI,Away,Upto 2014
TJ Laughlin,AUS,Pace,1978-12-01,Brisbane,Australia,1978,2,60,200,0,1,633,1750,28,573,1550,28,22.607142857142858,<=30,AUS,Home,Upto 2014
TJ Matthews,AUS,Spin,1912-01-12,Adelaide,Australia,1912,2,96,254,1,1,429,843,6,333,589,5,71.5,>30,AUS,Home,Upto 2014
TJ Matthews,AUS,Spin,1912-02-09,Melbourne,Australia,1912,1,68,132,0,1,357,761,7,289,629,7,51.0,>30,AUS,Home,Upto 2014
TJ Matthews,AUS,Spin,1912-05-27,Manchester,England,1912,2,54,120,6,1,525,1035,18,471,915,12,29.166666666666668,<=30,ENG,Away,Upto 2014
TJ Matthews,AUS,Spin,1912-06-24,Lord's,England,1912,1,26,78,0,1,243,530,6,217,452,6,40.5,>30,ENG,Away,Upto 2014
TJ Matthews,AUS,Spin,1912-07-15,Lord's,England,1912,2,61,156,5,1,501,1026,19,440,870,14,26.36842105263158,<=30,ENG,Away,Upto 2014
TJ Matthews,AUS,Spin,1912-07-29,Manchester,England,1912,1,23,72,2,1,128,395,6,105,323,4,21.333333333333332,<=30,ENG,Away,Upto 2014
TJ Matthews,AUS,Spin,1912-08-05,Nottingham,England,1912,1,27,125,2,1,399,1038,15,372,913,13,26.6,<=30,ENG,Away,Upto 2014
TJ Matthews,AUS,Spin,1912-08-19,The Oval,England,1912,2,64,144,0,1,252,792,19,188,648,19,13.263157894736842,<=30,ENG,Away,Upto 2014
TJ Murtagh,IRE,Pace,2018-05-11,Dublin (Malahide),Ireland,2018,2,100,246,6,1,792,1625,28,692,1379,22,28.285714285714285,<=30,IRE,Home,After 1965
TJ Murtagh,IRE,Pace,2019-03-15,Dehradun,India,2019,2,48,162,1,1,244,549,10,196,387,9,24.4,<=30,IND,Away,After 1965
TJ Murtagh,IRE,Pace,2019-07-24,Lord's,England,2019,2,65,162,6,1,515,949,38,450,787,32,13.552631578947368,<=30,ENG,Away,After 1965
TJE Andrews,AUS,Spin,1921-07-23,Manchester,England,1921,1,23,30,1,1,239,952,12,216,922,11,19.916666666666668,<=30,ENG,Away,Upto 2014
TJE Andrews,AUS,Spin,1921-08-13,The Oval,England,1921,1,44,48,0,1,509,810,8,465,762,8,63.625,>30,ENG,Away,Upto 2014
TJE Andrews,AUS,Spin,1926-07-10,Leeds,England,1926,1,36,24,0,1,810,1836,19,774,1812,19,42.63157894736842,>30,ENG,Away,Upto 2014
TJE Andrews,AUS,Spin,1926-07-24,Manchester,England,1926,1,13,54,0,1,479,1184,11,466,1130,11,43.54545454545455,>30,ENG,Away,Upto 2014
TK Curran,ENG,Pace,2017-12-26,Melbourne,Australia,2017,2,118,246,1,1,816,1807,20,698,1561,19,40.8,>30,AUS,Away,After 1965
TK Curran,ENG,Pace,2018-01-04,Sydney,Australia,2018,1,82,150,1,1,630,1294,17,548,1144,16,37.05882352941177,>30,AUS,Away,After 1965
TK Kendall,AUS,Spin,1877-03-15,Melbourne,Australia,1877,2,109,285,8,1,437,1296,31,328,1011,23,14.096774193548388,<=30,AUS,Home,After 1965
TK Kendall,AUS,Spin,1877-03-31,Melbourne,Australia,1877,2,106,278,6,1,437,1222,21,331,944,15,20.80952380952381,<=30,AUS,Home,After 1965
TL Best,WI,Pace,2003-05-01,Bridgetown,West Indies,2003,1,99,120,0,1,652,1455,15,553,1335,15,43.46666666666667,>30,WI,Home,Upto 2014
TL Best,WI,Pace,2004-03-11,Kingston,West Indies,2004,2,65,123,3,1,561,1123,25,496,1000,22,22.44,<=30,WI,Home,Upto 2014
TL Best,WI,Pace,2004-03-19,Port of Spain,West Indies,2004,2,98,192,4,1,720,1489,29,622,1297,25,24.82758620689655,<=30,WI,Home,Upto 2014
TL Best,WI,Pace,2004-04-01,Bridgetown,West Indies,2004,2,44,102,2,1,550,1209,31,506,1107,29,17.741935483870968,<=30,WI,Home,Upto 2014
TL Best,WI,Pace,2004-04-10,St John's,West Indies,2004,2,94,159,3,1,955,1635,13,861,1476,10,73.46153846153847,>30,WI,Home,Upto 2014
TL Best,WI,Pace,2004-05-28,Gros Islet,West Indies,2004,2,97,198,1,1,821,1459,16,724,1261,15,51.3125,>30,WI,Home,Upto 2014
TL Best,WI,Pace,2004-06-04,Kingston,West Indies,2004,2,85,180,2,1,592,1032,15,507,852,13,39.46666666666667,>30,WI,Home,Upto 2014
TL Best,WI,Pace,2004-07-22,Lord's,England,2004,2,118,144,1,1,966,1493,22,848,1349,21,43.90909090909091,>30,ENG,Away,Upto 2014
TL Best,WI,Pace,2005-04-29,St John's,West Indies,2005,2,148,186,2,1,1036,1736,12,888,1550,10,86.33333333333333,>30,WI,Home,Upto 2014
TL Best,WI,Pace,2005-06-03,Kingston,West Indies,2005,2,105,150,4,1,832,1351,29,727,1201,25,28.689655172413794,<=30,WI,Home,Upto 2014
TL Best,WI,Pace,2005-07-13,Colombo (SSC),Sri Lanka,2005,2,84,117,1,1,469,856,25,385,739,24,18.76,<=30,SL,Away,Upto 2014
TL Best,WI,Pace,2005-07-22,Kandy,Sri Lanka,2005,2,134,180,3,1,490,931,20,356,751,17,24.5,<=30,SL,Away,Upto 2014
TL Best,WI,Pace,2009-07-09,Kingstown,West Indies,2009,2,107,180,2,1,537,1048,20,430,868,18,26.85,<=30,WI,Home,Upto 2014
TL Best,WI,Pace,2009-07-17,St George's,West Indies,2009,2,85,156,0,1,424,759,14,339,603,14,30.285714285714285,>30,WI,Home,Upto 2014
TL Best,WI,Pace,2012-06-07,Birmingham,England,2012,1,37,72,2,1,443,825,14,406,753,12,31.642857142857142,>30,ENG,Away,Upto 2014
TL Best,WI,Pace,2012-08-02,Kingston,West Indies,2012,2,84,174,4,1,597,1132,23,513,958,19,25.956521739130434,<=30,WI,Home,Upto 2014
TL Best,WI,Pace,2012-11-13,Mirpur,Bangladesh,2012,2,101,213,6,1,489,849,15,388,636,9,32.6,>30,BAN,Away,Upto 2014
TL Best,WI,Pace,2012-11-21,Khulna,Bangladesh,2012,2,71,133,6,1,562,872,18,491,739,12,31.22222222222222,>30,BAN,Away,Upto 2014
TL Best,WI,Pace,2013-03-12,Bridgetown,West Indies,2013,2,59,120,0,1,330,750,17,271,630,17,19.41176470588235,<=30,WI,Home,Upto 2014
TL Best,WI,Pace,2013-03-20,Roseau,West Indies,2013,2,43,102,1,1,341,648,7,298,546,6,48.714285714285715,>30,WI,Home,Upto 2014
TL Best,WI,Pace,2013-11-06,Eden Gardens,India,2013,1,71,102,1,1,366,583,13,295,481,12,28.153846153846153,<=30,IND,Away,Upto 2014
TL Best,WI,Pace,2013-11-14,Wankhede,India,2013,1,93,108,1,1,332,492,5,239,384,4,66.4,>30,IND,Away,Upto 2014
TL Best,WI,Pace,2013-12-03,Dunedin,New Zealand,2013,2,174,253,3,1,879,1520,20,705,1267,17,43.95,>30,NZ,Away,Upto 2014
TL Best,WI,Pace,2013-12-11,Wellington,New Zealand,2013,1,110,126,4,1,603,1007,28,493,881,24,21.535714285714285,<=30,NZ,Away,Upto 2014
TL Best,WI,Pace,2013-12-19,Hamilton,New Zealand,2013,2,85,126,1,1,543,1073,23,458,947,22,23.608695652173914,<=30,NZ,Away,Upto 2014
TL Chatara,ZIM,Pace,2013-03-12,Bridgetown,West Indies,2013,2,67,126,3,1,330,750,17,263,624,14,19.41176470588235,<=30,WI,Away,Upto 2014
TL Chatara,ZIM,Pace,2013-03-20,Roseau,West Indies,2013,1,69,132,1,1,341,648,7,272,516,6,48.714285714285715,>30,WI,Away,Upto 2014
TL Chatara,ZIM,Pace,2013-09-03,Harare,Zimbabwe,2013,2,163,331,5,1,657,1465,18,494,1134,13,36.5,>30,ZIM,Home,Upto 2014
TL Chatara,ZIM,Pace,2013-09-10,Harare,Zimbabwe,2013,2,106,300,6,1,558,1504,28,452,1204,22,19.928571428571427,<=30,ZIM,Home,Upto 2014
TL Chatara,ZIM,Pace,2014-08-09,Harare,Zimbabwe,2014,2,39,174,2,1,362,1164,16,323,990,14,22.625,<=30,ZIM,Home,After 1965
TL Chatara,ZIM,Pace,2014-10-25,Mirpur,Bangladesh,2014,2,61,180,1,1,227,561,12,166,381,11,18.916666666666668,<=30,BAN,Away,After 1965
TL Chatara,ZIM,Pace,2014-11-03,Khulna,Bangladesh,2014,2,80,204,2,1,338,810,9,258,606,7,37.55555555555556,>30,BAN,Away,After 1965
TL Chatara,ZIM,Pace,2018-11-03,Sylhet,Bangladesh,2018,2,44,114,3,1,201,456,7,157,342,4,28.714285714285715,<=30,BAN,Away,After 1965
TL Chatara,ZIM,Pace,2018-11-11,Mirpur,Bangladesh,2018,1,34,134,1,1,422,1002,13,388,868,12,32.46153846153846,>30,BAN,Away,After 1965
TL Chatara,ZIM,Pace,2024-07-25,Belfast,Northern Ireland,2024,2,65,129,2,1,610,1116,26,545,987,24,23.46153846153846,<=30,Northern Ireland,Away,After 1965
TL Chivanga,ZIM,Pace,2023-02-12,Bulawayo,Zimbabwe,2023,1,59,84,0,1,266,519,11,207,435,11,24.181818181818183,<=30,ZIM,Home,After 1965
TL Chivanga,ZIM,Pace,2024-07-25,Belfast,Northern Ireland,2024,1,39,60,3,1,610,1116,26,571,1056,23,23.46153846153846,<=30,Northern Ireland,Away,After 1965
TL Goddard,SA,Pace,1955-06-09,Nottingham,England,1955,1,61,220,2,1,443,1507,20,382,1287,18,22.15,<=30,ENG,Away,Upto 2014
TL Goddard,SA,Pace,1955-06-23,Lord's,England,1955,2,155,458,7,1,632,1622,27,477,1164,20,23.40740740740741,<=30,ENG,Away,Upto 2014
TL Goddard,SA,Pace,1955-07-07,Manchester,England,1955,2,144,444,3,1,835,1929,28,691,1485,25,29.821428571428573,<=30,ENG,Away,Upto 2014
TL Goddard,SA,Pace,1955-07-21,Leeds,England,1955,2,108,522,7,1,618,1800,24,510,1278,17,25.75,<=30,ENG,Away,Upto 2014
TL Goddard,SA,Pace,1955-08-13,The Oval,England,1955,2,60,250,6,1,283,1030,15,223,780,9,18.866666666666667,<=30,ENG,Away,Upto 2014
TL Goddard,SA,Pace,1956-12-24,Johannesburg,South Africa,1956,2,65,341,4,1,465,1730,29,400,1389,25,16.03448275862069,<=30,SA,Home,Upto 2014
TL Goddard,SA,Pace,1957-01-01,Cape Town,South Africa,1957,2,136,445,4,1,496,1551,13,360,1106,9,38.15384615384615,>30,SA,Home,Upto 2014
TL Goddard,SA,Pace,1957-01-25,Durban,South Africa,1957,2,68,304,1,1,495,1563,15,427,1259,14,33.0,>30,SA,Home,Upto 2014
TL Goddard,SA,Pace,1957-02-15,Johannesburg,South Africa,1957,2,76,402,2,1,520,1730,17,444,1328,15,30.58823529411765,>30,SA,Home,Upto 2014
TL Goddard,SA,Pace,1957-03-01,Gqeberha,South Africa,1957,2,25,232,4,1,275,1498,30,250,1266,26,9.166666666666666,<=30,SA,Home,Upto 2014
TL Goddard,SA,Pace,1957-12-23,Johannesburg,South Africa,1957,2,81,224,0,1,682,1716,24,601,1492,24,28.416666666666668,<=30,SA,Home,Upto 2014
TL Goddard,SA,Pace,1957-12-31,Cape Town,South Africa,1957,1,57,232,1,1,357,1102,8,300,870,7,44.625,>30,SA,Home,Upto 2014
TL Goddard,SA,Pace,1958-01-24,Durban,South Africa,1958,2,87,520,3,1,460,1804,17,373,1284,14,27.058823529411764,<=30,SA,Home,Upto 2014
TL Goddard,SA,Pace,1958-02-07,Johannesburg,South Africa,1958,1,136,344,1,1,425,1453,14,289,1109,13,30.357142857142858,>30,SA,Home,Upto 2014
TL Goddard,SA,Pace,1958-02-28,Gqeberha,South Africa,1958,2,56,192,2,1,429,1409,18,373,1217,16,23.833333333333332,<=30,SA,Home,Upto 2014
TL Goddard,SA,Pace,1960-06-09,Birmingham,England,1960,2,79,258,1,1,549,1558,25,470,1300,24,21.96,<=30,ENG,Away,Upto 2014
TL Goddard,SA,Pace,1960-06-23,Lord's,England,1960,1,96,186,1,1,549,1209,28,453,1023,27,19.607142857142858,<=30,ENG,Away,Upto 2014
TL Goddard,SA,Pace,1960-07-07,Nottingham,England,1960,2,93,282,7,1,545,1319,26,452,1037,19,20.96153846153846,<=30,ENG,Away,Upto 2014
TL Goddard,SA,Pace,1960-07-21,Manchester,England,1960,2,52,240,5,1,475,1326,23,423,1086,18,20.652173913043477,<=30,ENG,Away,Upto 2014
TL Goddard,SA,Pace,1960-08-18,The Oval,England,1960,2,94,246,3,1,792,1752,24,698,1506,21,33.0,>30,ENG,Away,Upto 2014
TL Goddard,SA,Pace,1963-12-06,Brisbane,Australia,1963,2,86,248,2,1,562,1265,13,476,1017,11,43.23076923076923,>30,AUS,Away,Upto 2014
TL Goddard,SA,Pace,1964-01-01,Melbourne,Australia,1964,2,70,176,0,1,870,1955,24,800,1779,24,36.25,>30,AUS,Away,Upto 2014
TL Goddard,SA,Pace,1964-01-10,Sydney,Australia,1964,2,44,168,1,1,926,1995,29,882,1827,28,31.93103448275862,>30,AUS,Away,Upto 2014
TL Goddard,SA,Pace,1964-01-24,Adelaide,Australia,1964,2,124,366,5,1,1036,2074,26,912,1708,21,39.84615384615385,>30,AUS,Away,Upto 2014
TL Goddard,SA,Pace,1964-02-07,Sydney,Australia,1964,2,96,327,3,1,694,1880,20,598,1553,17,34.7,>30,AUS,Away,Upto 2014
TL Goddard,SA,Pace,1964-02-21,Wellington,New Zealand,1964,2,53,324,1,1,514,1667,18,461,1343,17,28.555555555555557,<=30,NZ,Away,Upto 2014
TL Goddard,SA,Pace,1964-02-28,Dunedin,New Zealand,1964,2,39,258,2,1,306,1085,13,267,827,11,23.53846153846154,<=30,NZ,Away,Upto 2014
TL Goddard,SA,Pace,1964-03-13,Auckland,New Zealand,1964,2,50,258,4,1,606,1729,24,556,1471,20,25.25,<=30,NZ,Away,Upto 2014
TL Goddard,SA,Pace,1964-12-04,Durban,South Africa,1964,1,79,192,1,1,364,1062,8,285,870,7,45.5,>30,SA,Home,Upto 2014
TL Goddard,SA,Pace,1964-12-23,Johannesburg,South Africa,1964,1,90,186,1,1,619,1341,11,529,1155,10,56.27272727272727,>30,SA,Home,Upto 2014
TL Goddard,SA,Pace,1965-01-01,Cape Town,South Africa,1965,1,64,222,1,1,647,1572,12,583,1350,11,53.916666666666664,>30,SA,Home,Upto 2014
TL Goddard,SA,Pace,1965-01-22,Johannesburg,South Africa,1965,2,40,132,1,1,754,1664,13,714,1532,12,58.0,>30,SA,Home,Upto 2014
TL Goddard,SA,Pace,1965-02-12,Gqeberha,South Africa,1965,2,37,245,2,1,624,1549,12,587,1304,10,52.0,>30,SA,Home,Upto 2014
TL Goddard,SA,Pace,1966-12-23,Johannesburg,South Africa,1966,2,92,353,8,1,809,1914,26,717,1561,18,31.115384615384617,>30,SA,Home,Upto 2014
TL Goddard,SA,Pace,1966-12-31,Cape Town,South Africa,1966,2,146,427,3,1,762,1783,22,616,1356,19,34.63636363636363,>30,SA,Home,Upto 2014
TL Goddard,SA,Pace,1967-01-20,Durban,South Africa,1967,2,49,264,3,1,725,1921,25,676,1657,22,29.0,<=30,SA,Home,Upto 2014
TL Goddard,SA,Pace,1967-02-03,Johannesburg,South Africa,1967,2,59,213,6,1,518,1312,23,459,1099,17,22.52173913043478,<=30,SA,Home,Upto 2014
TL Goddard,SA,Pace,1967-02-24,Gqeberha,South Africa,1967,2,76,276,6,1,655,1640,26,579,1364,20,25.192307692307693,<=30,SA,Home,Upto 2014
TL Goddard,SA,Pace,1970-01-22,Cape Town,South Africa,1970,2,95,310,2,1,471,1312,21,376,1002,19,22.428571428571427,<=30,SA,Home,Upto 2014
TL Goddard,SA,Pace,1970-02-05,Durban,South Africa,1970,2,40,144,3,1,686,1387,21,646,1243,18,32.666666666666664,>30,SA,Home,Upto 2014
TL Goddard,SA,Pace,1970-02-19,Johannesburg,South Africa,1970,2,68,305,4,1,766,1822,28,698,1517,24,27.357142857142858,<=30,SA,Home,Upto 2014
TL Moreki,SA,Pace,2024-02-04,Mount Maunganui,New Zealand,2024,2,126,210,1,1,753,1368,17,627,1158,16,44.294117647058826,>30,NZ,Away,After 1965
TL Moreki,SA,Pace,2024-02-13,Hamilton,New Zealand,2024,2,76,188,1,1,507,1179,18,431,991,17,28.166666666666668,<=30,NZ,Away,After 1965
TL Richmond,ENG,Spin,1921-05-28,Nottingham,England,1921,2,86,114,2,1,235,583,9,149,469,7,26.11111111111111,<=30,ENG,Home,Upto 2014
TM Alderman,AUS,Pace,1981-06-18,Nottingham,England,1981,2,130,258,9,1,571,1418,36,441,1160,27,15.86111111111111,<=30,ENG,Away,Upto 2014
TM Alderman,AUS,Pace,1981-07-02,Lord's,England,1981,2,121,284,2,1,755,1760,25,634,1476,23,30.2,>30,ENG,Away,Upto 2014
TM Alderman,AUS,Pace,1981-07-16,Leeds,England,1981,2,194,327,9,1,892,1859,38,698,1532,29,23.473684210526315,<=30,ENG,Away,Upto 2014
TM Alderman,AUS,Pace,1981-07-30,Birmingham,England,1981,2,107,271,8,1,525,1321,25,418,1050,17,21.0,<=30,ENG,Away,Upto 2014
TM Alderman,AUS,Pace,1981-08-13,Manchester,England,1981,2,197,486,9,1,887,1850,35,690,1364,26,25.34285714285714,<=30,ENG,Away,Upto 2014
TM Alderman,AUS,Pace,1981-08-27,The Oval,England,1981,2,144,324,5,1,972,2088,35,828,1764,30,27.771428571428572,<=30,ENG,Away,Upto 2014
TM Alderman,AUS,Pace,1981-11-13,W.A.C.A,Australia,1981,2,79,158,6,1,628,1440,27,549,1282,21,23.25925925925926,<=30,AUS,Home,Upto 2014
TM Alderman,AUS,Pace,1981-11-27,Brisbane,Australia,1981,2,111,240,2,1,651,1292,22,540,1052,20,29.59090909090909,<=30,AUS,Home,Upto 2014
TM Alderman,AUS,Pace,1981-12-11,Melbourne,Australia,1981,1,62,162,0,1,395,1019,11,333,857,11,35.90909090909091,>30,AUS,Home,Upto 2014
TM Alderman,AUS,Pace,1981-12-26,Melbourne,Australia,1981,2,77,162,4,1,642,1526,35,565,1364,31,18.34285714285714,<=30,AUS,Home,Upto 2014
TM Alderman,AUS,Pace,1982-01-02,Sydney,Australia,1982,2,119,252,1,1,792,1770,20,673,1518,19,39.6,>30,AUS,Home,Upto 2014
TM Alderman,AUS,Pace,1982-02-26,Wellington,New Zealand,1982,1,93,264,1,1,258,786,4,165,522,3,64.5,>30,NZ,Away,Upto 2014
TM Alderman,AUS,Pace,1982-03-12,Auckland,New Zealand,1982,2,89,189,3,1,673,1668,23,584,1479,20,29.26086956521739,<=30,NZ,Away,Upto 2014
TM Alderman,AUS,Pace,1982-03-19,Christchurch,New Zealand,1982,2,129,254,4,1,665,1336,24,536,1082,20,27.708333333333332,<=30,NZ,Away,Upto 2014
TM Alderman,AUS,Pace,1982-10-14,Lahore,Pakistan,1982,2,154,222,2,1,661,1346,22,507,1124,20,30.045454545454547,>30,PAK,Away,Upto 2014
TM Alderman,AUS,Pace,1982-11-12,W.A.C.A,Australia,1982,1,84,258,1,1,850,1760,19,766,1502,18,44.73684210526316,>30,AUS,Home,Upto 2014
TM Alderman,AUS,Pace,1984-03-02,Georgetown,West Indies,1984,2,107,192,1,1,692,1314,20,585,1122,19,34.6,>30,WI,Away,Upto 2014
TM Alderman,AUS,Pace,1984-03-16,Port of Spain,West Indies,1984,1,91,210,2,1,693,1381,19,602,1171,17,36.473684210526315,>30,WI,Away,Upto 2014
TM Alderman,AUS,Pace,1984-03-30,Bridgetown,West Indies,1984,2,170,266,1,1,810,1566,27,640,1300,26,30.0,<=30,WI,Away,Upto 2014
TM Alderman,AUS,Pace,1984-11-09,W.A.C.A,Australia,1984,1,128,234,6,1,700,1337,30,572,1103,24,23.333333333333332,<=30,AUS,Home,Upto 2014
TM Alderman,AUS,Pace,1984-11-23,Brisbane,Australia,1984,1,107,174,3,1,749,1407,30,642,1233,27,24.966666666666665,<=30,AUS,Home,Upto 2014
TM Alderman,AUS,Pace,1984-12-07,Adelaide,Australia,1984,2,104,186,0,1,771,1535,30,667,1349,30,25.7,<=30,AUS,Home,Upto 2014
TM Alderman,AUS,Pace,1988-12-24,Melbourne,Australia,1988,2,146,409,7,1,897,2063,38,751,1654,31,23.605263157894736,<=30,AUS,Home,Upto 2014
TM Alderman,AUS,Pace,1989-01-26,Sydney,Australia,1989,2,23,72,0,1,305,911,11,282,839,11,27.727272727272727,<=30,AUS,Home,Upto 2014
TM Alderman,AUS,Pace,1989-06-08,Leeds,England,1989,2,151,342,10,1,1372,2385,30,1221,2043,20,45.733333333333334,>30,ENG,Away,Upto 2014
TM Alderman,AUS,Pace,1989-06-22,Lord's,England,1989,2,188,353,9,1,1092,2047,30,904,1694,21,36.4,>30,ENG,Away,Upto 2014
TM Alderman,AUS,Pace,1989-07-06,Birmingham,England,1989,1,61,159,3,1,670,1413,17,609,1254,14,39.411764705882355,>30,ENG,Away,Upto 2014
TM Alderman,AUS,Pace,1989-07-27,Manchester,England,1989,2,115,312,5,1,673,1605,23,558,1293,18,29.26086956521739,<=30,ENG,Away,Upto 2014
TM Alderman,AUS,Pace,1989-08-10,Nottingham,England,1989,2,101,210,7,1,695,1373,18,594,1163,11,38.611111111111114,>30,ENG,Away,Upto 2014
TM Alderman,AUS,Pace,1989-08-24,The Oval,England,1989,2,96,240,7,1,921,1691,26,825,1451,19,35.42307692307692,>30,ENG,Away,Upto 2014
TM Alderman,AUS,Pace,1989-11-24,W.A.C.A,Australia,1989,2,132,346,4,1,939,2255,25,807,1909,21,37.56,>30,AUS,Home,Upto 2014
TM Alderman,AUS,Pace,1989-12-08,Brisbane,Australia,1989,1,81,240,3,1,901,1884,23,820,1644,20,39.17391304347826,>30,AUS,Home,Upto 2014
TM Alderman,AUS,Pace,1989-12-16,Hobart,Australia,1989,2,119,318,2,1,998,1920,27,879,1602,25,36.96296296296296,>30,AUS,Home,Upto 2014
TM Alderman,AUS,Pace,1990-01-12,Melbourne,Australia,1990,2,135,317,8,1,791,2097,34,656,1780,26,23.264705882352942,<=30,AUS,Home,Upto 2014
TM Alderman,AUS,Pace,1990-02-03,Sydney,Australia,1990,1,65,203,5,1,253,749,11,188,546,6,23.0,<=30,AUS,Home,Upto 2014
TM Alderman,AUS,Pace,1990-03-15,Wellington,New Zealand,1990,2,73,258,4,1,504,1412,21,431,1154,17,24.0,<=30,NZ,Away,Upto 2014
TM Alderman,AUS,Pace,1990-11-23,Brisbane,Australia,1990,2,91,240,8,1,544,1327,29,453,1087,21,18.75862068965517,<=30,AUS,Home,Upto 2014
TM Alderman,AUS,Pace,1990-12-26,Melbourne,Australia,1990,2,105,244,2,1,741,1809,29,636,1565,27,25.551724137931036,<=30,AUS,Home,Upto 2014
TM Alderman,AUS,Pace,1991-01-04,Sydney,Australia,1991,2,91,145,3,1,621,1201,14,530,1056,11,44.357142857142854,>30,AUS,Home,Upto 2014
TM Alderman,AUS,Pace,1991-02-01,W.A.C.A,Australia,1991,2,141,264,3,1,771,1442,29,630,1178,26,26.586206896551722,<=30,AUS,Home,Upto 2014
TM Alderman,AUS,Pace,1991-04-27,St John's,West Indies,1991,2,105,136,1,1,735,1397,30,630,1261,29,24.5,<=30,WI,Away,Upto 2014
TM Dilshan,SL,Spin,2003-12-10,Kandy,Sri Lanka,2003,1,10,18,0,1,692,1702,20,682,1684,20,34.6,>30,SL,Home,Upto 2014
TM Dilshan,SL,Spin,2004-03-08,Galle,Sri Lanka,2004,1,9,36,0,1,953,1791,32,944,1755,32,29.78125,<=30,SL,Home,Upto 2014
TM Dilshan,SL,Spin,2004-03-16,Kandy,Sri Lanka,2004,1,6,6,0,1,537,881,19,531,875,19,28.263157894736842,<=30,SL,Home,Upto 2014
TM Dilshan,SL,Spin,2004-03-24,Colombo (SSC),Sri Lanka,2004,1,0,6,0,1,844,1656,26,844,1650,26,32.46153846153846,>30,SL,Home,Upto 2014
TM Dilshan,SL,Spin,2004-07-09,Cairns,Australia,2004,1,4,12,2,1,552,988,20,548,976,18,27.6,<=30,AUS,Away,Upto 2014
TM Dilshan,SL,Spin,2004-08-04,Galle,Sri Lanka,2004,2,54,132,2,1,688,1462,17,634,1330,15,40.470588235294116,>30,SL,Home,Upto 2014
TM Dilshan,SL,Spin,2004-08-11,Colombo (SSC),Sri Lanka,2004,2,30,96,1,1,470,988,13,440,892,12,36.15384615384615,>30,SL,Home,Upto 2014
TM Dilshan,SL,Spin,2005-04-04,Napier,New Zealand,2005,1,5,6,0,1,443,871,8,438,865,8,55.375,>30,NZ,Away,Upto 2014
TM Dilshan,SL,Spin,2005-04-11,Wellington,New Zealand,2005,1,15,6,0,1,233,396,0,218,390,0,inf,>30,NZ,Away,Upto 2014
TM Dilshan,SL,Spin,2005-09-20,Colombo (PSS),Sri Lanka,2005,1,5,6,0,1,417,656,12,412,650,12,34.75,>30,SL,Home,Upto 2014
TM Dilshan,SL,Spin,2005-12-10,Delhi,India,2005,2,22,30,0,1,668,1353,25,646,1323,25,26.72,<=30,IND,Away,Upto 2014
TM Dilshan,SL,Spin,2005-12-18,Ahmedabad,India,2005,2,44,90,1,1,765,1419,29,721,1329,28,26.379310344827587,<=30,IND,Away,Upto 2014
TM Dilshan,SL,Spin,2006-02-28,Chattogram,Bangladesh,2006,1,12,12,0,1,666,1170,22,654,1158,22,30.272727272727273,>30,BAN,Away,Upto 2014
TM Dilshan,SL,Spin,2006-03-26,Colombo (SSC),Sri Lanka,2006,1,4,6,0,1,538,1125,13,534,1119,13,41.38461538461539,>30,SL,Home,Upto 2014
TM Dilshan,SL,Spin,2006-05-11,Lord's,England,2006,1,32,36,0,1,239,486,5,207,450,5,47.8,>30,ENG,Away,Upto 2014
TM Dilshan,SL,Spin,2006-05-25,Birmingham,England,2006,1,9,6,0,1,204,410,13,195,404,13,15.692307692307692,<=30,ENG,Away,Upto 2014
TM Dilshan,SL,Spin,2006-07-27,Colombo (SSC),Sri Lanka,2006,1,10,24,0,1,531,1166,11,521,1142,11,48.27272727272727,>30,SL,Home,Upto 2014
TM Dilshan,SL,Spin,2007-06-25,Colombo (SSC),Sri Lanka,2007,1,11,42,1,1,605,1005,14,594,963,13,43.214285714285715,>30,SL,Home,Upto 2014
TM Dilshan,SL,Spin,2007-07-03,Colombo (PSS),Sri Lanka,2007,1,10,36,0,1,383,661,9,373,625,9,42.55555555555556,>30,SL,Home,Upto 2014
TM Dilshan,SL,Spin,2007-07-11,Kandy,Sri Lanka,2007,1,6,24,0,1,353,551,12,347,527,12,29.416666666666668,<=30,SL,Home,Upto 2014
TM Dilshan,SL,Spin,2007-12-18,Galle,Sri Lanka,2007,1,8,18,0,1,195,456,4,187,438,4,48.75,>30,SL,Home,Upto 2014
TM Dilshan,SL,Spin,2008-03-22,Providence,West Indies,2008,1,2,6,0,1,634,1374,12,632,1368,12,52.833333333333336,>30,WI,Away,Upto 2014
TM Dilshan,SL,Spin,2008-12-26,Mirpur,Bangladesh,2008,2,6,24,0,1,727,1408,21,721,1384,21,34.61904761904762,>30,BAN,Away,Upto 2014
TM Dilshan,SL,Spin,2009-01-03,Chattogram,Bangladesh,2009,1,10,26,4,1,931,1570,27,921,1544,23,34.48148148148148,>30,BAN,Away,Upto 2014
TM Dilshan,SL,Spin,2009-02-21,Karachi,Pakistan,2009,1,82,114,0,1,883,1568,9,801,1454,9,98.11111111111111,>30,PAK,Away,Upto 2014
TM Dilshan,SL,Spin,2009-03-01,Lahore,Pakistan,2009,1,0,6,0,1,316,544,0,316,538,0,inf,>30,PAK,Away,Upto 2014
TM Dilshan,SL,Spin,2009-08-26,Colombo (SSC),Sri Lanka,2009,2,27,54,2,1,760,1587,27,733,1533,25,28.14814814814815,<=30,SL,Home,Upto 2014
TM Dilshan,SL,Spin,2009-11-16,Ahmedabad,India,2009,2,5,12,0,1,904,1575,9,899,1563,9,100.44444444444444,>30,IND,Away,Upto 2014
TM Dilshan,SL,Spin,2009-11-24,Kanpur,India,2009,1,17,18,0,1,718,1197,20,701,1179,20,35.9,>30,IND,Away,Upto 2014
TM Dilshan,SL,Spin,2009-12-02,Brabourne,India,2009,1,16,18,0,1,870,1403,18,854,1385,18,48.333333333333336,>30,IND,Away,Upto 2014
TM Dilshan,SL,Spin,2010-07-18,Galle,Sri Lanka,2010,2,36,66,0,1,643,1145,10,607,1079,10,64.3,>30,SL,Home,Upto 2014
TM Dilshan,SL,Spin,2010-07-26,Colombo (SSC),Sri Lanka,2010,1,56,162,3,1,926,1870,14,870,1708,11,66.14285714285714,>30,SL,Home,Upto 2014
TM Dilshan,SL,Spin,2010-08-03,Colombo (PSS),Sri Lanka,2010,2,27,30,0,1,813,1539,26,786,1509,26,31.26923076923077,>30,SL,Home,Upto 2014
TM Dilshan,SL,Spin,2010-11-15,Galle,Sri Lanka,2010,1,15,18,0,1,572,1048,14,557,1030,14,40.857142857142854,>30,SL,Home,Upto 2014
TM Dilshan,SL,Spin,2010-11-23,Colombo (RPS),Sri Lanka,2010,2,8,42,3,1,280,519,10,272,477,7,28.0,<=30,SL,Home,Upto 2014
TM Dilshan,SL,Spin,2010-12-01,Pallekele,Sri Lanka,2010,1,20,60,0,1,152,366,6,132,306,6,25.333333333333332,<=30,SL,Home,Upto 2014
TM Dilshan,SL,Spin,2011-05-26,Cardiff,England,2011,1,60,96,1,1,338,682,10,278,586,9,33.8,>30,ENG,Away,Upto 2014
TM Dilshan,SL,Spin,2011-06-03,Lord's,England,2011,1,30,42,0,1,315,597,8,285,555,8,39.375,>30,ENG,Away,Upto 2014
TM Dilshan,SL,Spin,2011-08-31,Galle,Sri Lanka,2011,2,48,108,3,1,441,845,19,393,737,16,23.210526315789473,<=30,SL,Home,Upto 2014
TM Dilshan,SL,Spin,2011-09-08,Pallekele,Sri Lanka,2011,1,32,84,0,1,335,684,6,303,600,6,55.833333333333336,>30,SL,Home,Upto 2014
TM Dilshan,SL,Spin,2011-09-16,Colombo (SSC),Sri Lanka,2011,2,96,186,1,1,436,882,9,340,696,8,48.44444444444444,>30,SL,Home,Upto 2014
TM Dilshan,SL,Spin,2011-10-18,Abu Dhabi,UAE,2011,1,84,192,0,1,499,1258,7,415,1066,7,71.28571428571429,>30,UAE,Away,Upto 2014
TM Dilshan,SL,Spin,2011-10-26,Dubai (DICS),UAE,2011,2,93,169,3,1,466,1189,19,373,1020,16,24.526315789473685,<=30,UAE,Away,Upto 2014
TM Dilshan,SL,Spin,2011-11-03,Sharjah,UAE,2011,2,30,66,0,1,589,1524,15,559,1458,15,39.266666666666666,>30,UAE,Away,Upto 2014
TM Dilshan,SL,Spin,2011-12-15,Centurion,South Africa,2011,1,17,42,1,1,95,240,3,78,198,2,31.666666666666668,>30,SA,Away,Upto 2014
TM Dilshan,SL,Spin,2011-12-26,Durban,South Africa,2011,2,35,72,1,1,329,669,13,294,597,12,25.307692307692307,<=30,SA,Away,Upto 2014
TM Dilshan,SL,Spin,2012-01-03,Cape Town,South Africa,2012,1,32,24,0,1,307,606,6,275,582,6,51.166666666666664,>30,SA,Away,Upto 2014
TM Dilshan,SL,Spin,2012-03-26,Galle,Sri Lanka,2012,1,25,72,0,1,607,1324,28,582,1252,28,21.678571428571427,<=30,SL,Home,Upto 2014
TM Dilshan,SL,Spin,2012-04-03,Colombo (PSS),Sri Lanka,2012,2,116,166,3,1,698,1454,22,582,1288,19,31.727272727272727,>30,SL,Home,Upto 2014
TM Dilshan,SL,Spin,2012-06-30,Colombo (SSC),Sri Lanka,2012,1,9,6,0,1,609,1048,13,600,1042,13,46.84615384615385,>30,SL,Home,Upto 2014
TM Dilshan,SL,Spin,2012-11-25,Colombo (PSS),Sri Lanka,2012,1,19,54,1,1,489,1212,15,470,1158,14,32.6,>30,SL,Home,Upto 2014
TM Dilshan,SL,Spin,2012-12-14,Hobart,Australia,2012,2,32,54,0,1,352,719,7,320,665,7,50.285714285714285,>30,AUS,Away,Upto 2014
TM Dilshan,SL,Spin,2012-12-26,Melbourne,Australia,2012,1,38,72,1,1,172,352,4,134,280,3,43.0,>30,AUS,Away,Upto 2014
TM Dilshan,SL,Spin,2013-01-03,Sydney,Australia,2013,2,115,222,2,1,392,713,11,277,491,9,35.63636363636363,>30,AUS,Away,Upto 2014
TM Dilshan,SL,Spin,2013-03-08,Galle,Sri Lanka,2013,2,86,180,2,1,1160,1920,13,1074,1740,11,89.23076923076923,>30,SL,Home,Upto 2014
TM Dilshan,SL,Spin,2013-03-16,Colombo (RPS),Sri Lanka,2013,2,81,174,1,1,481,1042,18,400,868,17,26.72222222222222,<=30,SL,Home,Upto 2014
TM Dowlin,WI,Spin,2010-06-18,Basseterre,West Indies,2010,1,3,6,0,1,665,1266,8,662,1260,8,83.125,>30,WI,Home,Upto 2014
TM Head,AUS,Spin,2018-10-07,Dubai (DICS),UAE,2018,1,6,6,0,1,793,1735,21,787,1729,21,37.76190476190476,>30,UAE,Away,After 1965
TM Head,AUS,Spin,2018-10-16,Abu Dhabi,UAE,2018,1,4,12,0,1,566,1108,20,562,1096,20,28.3,<=30,UAE,Away,After 1965
TM Head,AUS,Spin,2018-12-06,Adelaide,Australia,2018,2,15,24,0,1,390,1013,14,375,989,14,27.857142857142858,<=30,AUS,Home,After 1965
TM Head,AUS,Spin,2019-01-03,Sydney,Australia,2019,1,20,24,0,1,448,853,11,428,829,11,40.72727272727273,>30,AUS,Home,After 1965
TM Head,AUS,Spin,2019-08-01,Birmingham,England,2019,1,7,12,0,1,478,833,12,471,821,12,39.833333333333336,>30,ENG,Away,After 1965
TM Head,AUS,Spin,2019-09-04,Manchester,England,2019,1,0,6,0,1,337,685,7,337,679,7,48.142857142857146,>30,ENG,Away,After 1965
TM Head,AUS,Spin,2019-12-12,Perth,Australia,2019,1,13,30,0,1,325,635,8,312,605,8,40.625,>30,AUS,Home,After 1965
TM Head,AUS,Spin,2020-01-03,Sydney,Australia,2020,1,11,12,0,1,444,825,14,433,813,14,31.714285714285715,>30,AUS,Home,After 1965
TM Head,AUS,Spin,2021-12-16,Adelaide,Australia,2021,1,0,6,0,1,255,630,10,255,624,10,25.5,<=30,AUS,Home,After 1965
TM Head,AUS,Spin,2022-03-04,Rawalpindi,Pakistan,2022,2,48,96,0,1,676,1285,9,628,1189,9,75.11111111111111,>30,PAK,Away,After 1965
TM Head,AUS,Spin,2022-06-29,Galle,Sri Lanka,2022,1,10,17,4,1,491,729,25,481,712,21,19.64,<=30,SL,Away,After 1965
TM Head,AUS,Spin,2022-07-08,Galle,Sri Lanka,2022,1,27,48,0,1,757,1422,23,730,1374,23,32.91304347826087,>30,SL,Away,After 1965
TM Head,AUS,Spin,2022-11-30,Perth,Australia,2022,2,29,54,2,1,497,783,13,468,729,11,38.23076923076923,>30,AUS,Home,After 1965
TM Head,AUS,Spin,2023-01-04,Sydney,Australia,2023,2,25,54,1,1,437,881,4,412,827,3,109.25,>30,AUS,Home,After 1965
TM Head,AUS,Spin,2023-02-17,Delhi,India,2023,2,19,18,0,1,582,1082,28,563,1064,28,20.785714285714285,<=30,IND,Away,After 1965
TM Head,AUS,Spin,2023-03-09,Ahmedabad,India,2023,1,8,18,0,1,725,1892,17,717,1874,17,42.64705882352941,>30,IND,Away,After 1965
TM Head,AUS,Spin,2023-06-28,Lord's,England,2023,2,40,66,2,1,95,198,5,55,132,3,19.0,<=30,ENG,Away,After 1965
TM Head,AUS,Spin,2023-07-19,Manchester,England,2023,1,52,42,0,1,196,264,2,144,222,2,98.0,>30,ENG,Away,After 1965
TM Head,AUS,Spin,2023-12-14,Perth,Australia,2023,1,4,11,1,1,206,443,6,202,432,5,34.333333333333336,>30,AUS,Home,After 1965
TM Head,AUS,Spin,2024-01-03,Sydney,Australia,2024,2,20,42,1,1,332,638,10,312,596,9,33.2,>30,AUS,Home,After 1965
TM Head,AUS,Spin,2024-01-25,Brisbane,Australia,2024,1,14,18,0,1,191,372,6,177,354,6,31.833333333333332,>30,AUS,Home,After 1965
TM Head,AUS,Spin,2024-02-29,Wellington,New Zealand,2024,1,10,24,1,1,189,379,17,179,355,16,11.117647058823529,<=30,NZ,Away,After 1965
TM Head,AUS,Spin,2024-03-08,Christchurch,New Zealand,2024,1,7,12,0,1,112,230,4,105,218,4,28.0,<=30,NZ,Away,After 1965
TM Head,AUS,Spin,2024-11-22,Perth,Australia,2024,1,26,30,0,1,374,651,9,348,621,9,41.55555555555556,>30,AUS,Home,After 1965
TM Head,AUS,Spin,2024-12-14,Brisbane,Australia,2024,1,3,11,1,1,218,365,3,215,354,2,72.66666666666667,>30,AUS,Home,After 1965
TM Head,AUS,Spin,2024-12-26,Melbourne,Australia,2024,2,25,48,1,1,350,730,11,325,682,10,31.818181818181817,>30,AUS,Home,After 1965
TM Head,AUS,Spin,2025-01-29,Galle,Sri Lanka,2025,1,8,12,0,1,941,1397,23,933,1385,23,40.91304347826087,>30,SL,Away,After 1965
TM Moody,AUS,Pace,1989-11-24,W.A.C.A,Australia,1989,2,29,126,1,1,939,2255,25,910,2129,24,37.56,>30,AUS,Home,Upto 2014
TM Moody,AUS,Pace,1989-12-08,Brisbane,Australia,1989,1,15,96,0,1,901,1884,23,886,1788,23,39.17391304347826,>30,AUS,Home,Upto 2014
TM Moody,AUS,Pace,1989-12-16,Hobart,Australia,1989,1,9,12,0,1,998,1920,27,989,1908,27,36.96296296296296,>30,AUS,Home,Upto 2014
TM Moody,AUS,Pace,1992-02-01,W.A.C.A,Australia,1992,1,15,12,0,1,946,1994,34,931,1982,34,27.823529411764707,<=30,AUS,Home,Upto 2014
TM Moody,AUS,Pace,1992-08-17,Colombo (SSC),Sri Lanka,1992,2,54,132,0,1,793,1548,19,739,1416,19,41.73684210526316,>30,SL,Away,Upto 2014
TM Moody,AUS,Pace,1992-08-28,Colombo (RPS),Sri Lanka,1992,1,17,36,1,1,531,1227,20,514,1191,19,26.55,<=30,SL,Away,Upto 2014
TM Moody,AUS,Pace,1992-09-08,Moratuwa,Sri Lanka,1992,1,8,18,0,1,511,1044,22,503,1026,22,23.227272727272727,<=30,SL,Away,Upto 2014
TP Horan,AUS,Spin,1883-01-26,Sydney,Australia,1883,1,22,68,3,1,194,600,10,172,532,7,19.4,<=30,AUS,Home,After 1965
TP Horan,AUS,Spin,1883-02-17,Sydney,Australia,1883,2,41,84,2,1,484,1391,24,443,1307,22,20.166666666666668,<=30,AUS,Home,After 1965
TP Horan,AUS,Spin,1885-01-01,Melbourne,Australia,1885,1,0,4,0,1,372,1209,9,372,1205,9,41.333333333333336,>30,AUS,Home,After 1965
TP Horan,AUS,Spin,1885-02-20,Sydney,Australia,1885,2,63,185,6,1,276,897,19,213,712,13,14.526315789473685,<=30,AUS,Home,After 1965
TP Horan,AUS,Spin,1885-03-14,Sydney,Australia,1885,1,12,20,0,1,238,508,7,226,488,7,34.0,>30,AUS,Home,After 1965
TP Horan,AUS,Spin,1885-03-21,Melbourne,Australia,1885,1,5,12,0,1,142,528,10,137,516,10,14.2,<=30,AUS,Home,After 1965
TP Kamungozi,ZIM,Spin,2014-10-25,Mirpur,Bangladesh,2014,2,58,156,1,1,460,898,22,402,742,21,20.90909090909091,<=30,BAN,Away,After 1965
TPB Smith,ENG,Spin,1946-08-17,The Oval,England,1946,1,58,126,1,1,184,504,4,126,378,3,46.0,>30,ENG,Home,Upto 2014
TPB Smith,ENG,Spin,1946-12-13,Sydney,Australia,1946,1,172,296,2,1,831,1933,19,659,1637,17,43.73684210526316,>30,AUS,Away,Upto 2014
TPB Smith,ENG,Spin,1947-02-28,Sydney,Australia,1947,2,46,80,0,1,494,1134,15,448,1054,15,32.93333333333333,>30,AUS,Away,Upto 2014
TPB Smith,ENG,Spin,1947-03-21,Christchurch,New Zealand,1947,1,43,36,0,1,205,294,0,162,258,0,inf,>30,NZ,Away,Upto 2014
TR Gripper,ZIM,Spin,1999-10-14,Harare,Zimbabwe,1999,1,19,18,0,1,296,763,10,277,745,10,29.6,<=30,ZIM,Home,Upto 2014
TR Gripper,ZIM,Spin,1999-11-11,Harare,Zimbabwe,1999,1,28,48,1,1,131,233,4,103,185,3,32.75,>30,ZIM,Home,Upto 2014
TR Gripper,ZIM,Spin,1999-11-26,Harare,Zimbabwe,1999,1,6,6,0,1,215,630,10,209,624,10,21.5,<=30,ZIM,Home,Upto 2014
TR Gripper,ZIM,Spin,2000-03-16,Port of Spain,West Indies,2000,1,6,12,0,1,105,340,7,99,328,7,15.0,<=30,WI,Away,Upto 2014
TR Gripper,ZIM,Spin,2000-03-24,Kingston,West Indies,2000,2,22,40,0,1,234,532,3,212,492,3,78.0,>30,WI,Away,Upto 2014
TR Gripper,ZIM,Spin,2001-11-15,Chattogram,Bangladesh,2001,2,21,30,0,1,538,1183,18,517,1153,18,29.88888888888889,<=30,BAN,Away,Upto 2014
TR Gripper,ZIM,Spin,2001-12-27,Colombo (SSC),Sri Lanka,2001,1,91,132,2,1,311,756,12,220,624,10,25.916666666666668,<=30,SL,Away,Upto 2014
TR Gripper,ZIM,Spin,2002-01-04,Kandy,Sri Lanka,2002,1,38,84,0,1,367,934,16,329,850,16,22.9375,<=30,SL,Away,Upto 2014
TR Gripper,ZIM,Spin,2002-01-12,Galle,Sri Lanka,2002,1,41,54,0,1,515,1423,24,474,1369,24,21.458333333333332,<=30,SL,Away,Upto 2014
TR Gripper,ZIM,Spin,2002-02-21,Nagpur,India,2002,1,18,30,0,1,556,1425,18,538,1395,18,30.88888888888889,>30,IND,Away,Upto 2014
TR Gripper,ZIM,Spin,2002-02-28,Delhi,India,2002,1,6,6,0,1,467,1232,22,461,1226,22,21.227272727272727,<=30,IND,Away,Upto 2014
TR Gripper,ZIM,Spin,2003-10-09,W.A.C.A,Australia,2003,1,142,153,2,1,603,903,11,461,750,9,54.81818181818182,>30,AUS,Away,Upto 2014
TR Gripper,ZIM,Spin,2003-10-17,Sydney,Australia,2003,1,2,6,0,1,468,933,15,466,927,15,31.2,>30,AUS,Away,Upto 2014
TR Gripper,ZIM,Spin,2003-11-04,Harare,Zimbabwe,2003,2,44,120,1,1,313,784,11,269,664,10,28.454545454545453,<=30,ZIM,Home,Upto 2014
TR Gripper,ZIM,Spin,2003-11-12,Bulawayo,Zimbabwe,2003,1,17,30,0,1,453,841,14,436,811,14,32.357142857142854,>30,ZIM,Home,Upto 2014
TR Gripper,ZIM,Spin,2004-02-19,Harare,Zimbabwe,2004,2,8,24,0,1,538,1129,14,530,1105,14,38.42857142857143,>30,ZIM,Home,Upto 2014
TR McKibbin,AUS,Spin,1895-03-01,Melbourne,Australia,1895,2,120,258,2,1,689,1631,19,569,1373,17,36.26315789473684,>30,AUS,Home,After 1965
TR McKibbin,AUS,Spin,1896-07-16,Manchester,England,1896,2,106,200,6,1,461,941,15,355,741,9,30.733333333333334,>30,ENG,Away,After 1965
TR McKibbin,AUS,Spin,1896-08-10,The Oval,England,1896,2,56,148,5,1,198,633,25,142,485,20,7.92,<=30,ENG,Away,After 1965
TR McKibbin,AUS,Spin,1897-12-13,Sydney,Australia,1897,2,135,234,2,1,519,948,7,384,714,5,74.14285714285714,>30,AUS,Home,After 1965
TR McKibbin,AUS,Spin,1898-01-01,Melbourne,Australia,1898,2,79,192,2,1,483,1191,22,404,999,20,21.954545454545453,<=30,AUS,Home,After 1965
TR Veivers,AUS,Spin,1963-12-06,Brisbane,Australia,1963,1,48,272,1,1,346,1069,8,298,797,7,43.25,>30,AUS,Home,Upto 2014
TR Veivers,AUS,Spin,1964-01-01,Melbourne,Australia,1964,1,6,40,0,1,262,721,5,256,681,5,52.4,>30,AUS,Home,Upto 2014
TR Veivers,AUS,Spin,1964-02-07,Sydney,Australia,1964,2,116,344,2,1,341,1120,10,225,776,8,34.1,>30,AUS,Home,Upto 2014
TR Veivers,AUS,Spin,1964-06-04,Nottingham,England,1964,2,64,144,5,1,92,264,7,28,120,2,13.142857142857142,<=30,ENG,Away,Upto 2014
TR Veivers,AUS,Spin,1964-06-18,Lord's,England,1964,1,17,54,0,1,149,558,5,132,504,5,29.8,<=30,ENG,Away,Upto 2014
TR Veivers,AUS,Spin,1964-07-02,Leeds,England,1964,2,105,282,3,1,349,1116,11,244,834,8,31.727272727272727,>30,ENG,Away,Upto 2014
TR Veivers,AUS,Spin,1964-07-23,Manchester,England,1964,1,155,571,3,1,477,1315,3,322,744,0,159.0,>30,ENG,Away,Upto 2014
TR Veivers,AUS,Spin,1964-08-13,The Oval,England,1964,2,103,318,0,1,191,690,2,88,372,2,95.5,>30,ENG,Away,Upto 2014
TR Veivers,AUS,Spin,1964-10-02,Chennai,India,1964,2,38,120,2,1,735,1918,23,697,1798,21,31.956521739130434,>30,IND,Away,Upto 2014
TR Veivers,AUS,Spin,1964-10-10,Brabourne,India,1964,2,150,550,6,1,796,2173,26,646,1623,20,30.615384615384617,>30,IND,Away,Upto 2014
TR Veivers,AUS,Spin,1964-10-17,Eden Gardens,India,1964,1,81,312,3,1,407,1253,16,326,941,13,25.4375,<=30,IND,Away,Upto 2014
TR Veivers,AUS,Spin,1964-10-24,Karachi,Pakistan,1964,2,77,276,2,1,840,2130,18,763,1854,16,46.666666666666664,>30,PAK,Away,Upto 2014
TR Veivers,AUS,Spin,1964-12-04,Melbourne,Australia,1964,2,40,120,1,1,473,1030,6,433,910,5,78.83333333333333,>30,AUS,Home,Upto 2014
TR Veivers,AUS,Spin,1965-12-10,Brisbane,Australia,1965,2,86,184,0,1,514,1281,8,428,1097,8,64.25,>30,AUS,Home,Upto 2014
TR Veivers,AUS,Spin,1965-12-30,Melbourne,Australia,1965,1,46,96,2,1,661,1476,9,615,1380,7,73.44444444444444,>30,AUS,Home,Upto 2014
TR Veivers,AUS,Spin,1966-01-28,Adelaide,Australia,1966,2,40,135,2,1,423,991,7,383,856,5,60.42857142857143,>30,AUS,Home,Upto 2014
TR Veivers,AUS,Spin,1966-02-11,Melbourne,Australia,1966,1,78,120,0,1,369,880,3,291,760,3,123.0,>30,AUS,Home,Upto 2014
TR Veivers,AUS,Spin,1966-12-23,Johannesburg,South Africa,1966,2,72,162,0,1,549,1041,11,477,879,11,49.90909090909091,>30,SA,Away,Upto 2014
TR Veivers,AUS,Spin,1966-12-31,Cape Town,South Africa,1966,2,53,91,1,1,643,1501,10,590,1410,9,64.3,>30,SA,Away,Upto 2014
TS Chisoro,ZIM,Spin,2017-10-29,Bulawayo,Zimbabwe,2017,1,113,248,3,1,706,1640,15,593,1392,12,47.06666666666667,>30,ZIM,Home,After 1965
TS Chisoro,ZIM,Spin,2021-04-29,Harare,Zimbabwe,2021,1,89,204,1,1,256,510,4,167,306,3,64.0,>30,ZIM,Home,After 1965
TS Chisoro,ZIM,Spin,2021-05-07,Harare,Zimbabwe,2021,1,131,241,2,1,364,605,9,233,364,7,40.44444444444444,>30,ZIM,Home,After 1965
TS Curtis,ENG,Spin,1989-07-06,Birmingham,England,1989,1,7,18,0,1,123,408,3,116,390,3,41.0,>30,ENG,Home,Upto 2014
TS Roland-Jones,ENG,Pace,2017-07-27,The Oval,England,2017,2,129,208,8,1,850,1584,29,721,1376,21,29.310344827586206,<=30,ENG,Home,After 1965
TS Roland-Jones,ENG,Pace,2017-08-04,Manchester,England,2017,2,93,120,2,1,698,1268,30,605,1148,28,23.266666666666666,<=30,ENG,Home,After 1965
TS Roland-Jones,ENG,Pace,2017-08-17,Birmingham,England,2017,2,49,76,4,1,610,1081,19,561,1005,15,32.10526315789474,>30,ENG,Home,After 1965
TS Roland-Jones,ENG,Pace,2017-09-07,Lord's,England,2017,2,63,132,3,1,490,1083,30,427,951,27,16.333333333333332,<=30,ENG,Home,After 1965
TS Worthington,ENG,Pace,1930-01-10,Christchurch,New Zealand,1930,2,43,121,3,1,310,868,23,267,747,20,13.478260869565217,<=30,NZ,Away,Upto 2014
TS Worthington,ENG,Pace,1930-01-24,Wellington,New Zealand,1930,2,107,192,3,1,569,1265,15,462,1073,12,37.93333333333333,>30,NZ,Away,Upto 2014
TS Worthington,ENG,Pace,1930-02-14,Auckland,New Zealand,1930,1,11,36,0,1,146,336,1,135,300,1,146.0,>30,NZ,Away,Upto 2014
TS Worthington,ENG,Pace,1930-02-21,Auckland,New Zealand,1930,1,25,90,1,1,366,961,11,341,871,10,33.27272727272727,>30,NZ,Away,Upto 2014
TS Worthington,ENG,Pace,1936-07-25,Manchester,England,1936,2,42,102,1,1,650,1176,8,608,1074,7,81.25,>30,ENG,Home,Upto 2014
TS Worthington,ENG,Pace,1936-08-15,The Oval,England,1936,1,10,12,0,1,678,1230,17,668,1218,17,39.88235294117647,>30,ENG,Home,Upto 2014
TS Worthington,ENG,Pace,1937-01-01,Melbourne,Australia,1937,1,18,32,0,1,510,1173,17,492,1141,17,30.0,<=30,AUS,Away,Upto 2014
TS Worthington,ENG,Pace,1937-02-26,Melbourne,Australia,1937,1,60,48,0,1,632,1154,16,572,1106,16,39.5,>30,AUS,Away,Upto 2014
TT Bresnan,ENG,Pace,2009-05-06,Lord's,England,2009,1,17,42,0,1,625,1023,22,608,981,22,28.40909090909091,<=30,ENG,Home,Upto 2014
TT Bresnan,ENG,Pace,2009-05-14,Chester-le-Street,England,2009,2,80,144,3,1,746,1203,21,666,1059,18,35.523809523809526,>30,ENG,Home,Upto 2014
TT Bresnan,ENG,Pace,2010-03-12,Chattogram,Bangladesh,2010,2,135,294,4,1,497,924,10,362,630,6,49.7,>30,BAN,Away,Upto 2014
TT Bresnan,ENG,Pace,2010-03-20,Mirpur,Bangladesh,2010,2,91,204,3,1,503,828,9,412,624,6,55.888888888888886,>30,BAN,Away,Upto 2014
TT Bresnan,ENG,Pace,2010-05-27,Lord's,England,2010,2,169,302,4,1,777,1274,20,608,972,16,38.85,>30,ENG,Home,Upto 2014
TT Bresnan,ENG,Pace,2010-12-26,Melbourne,Australia,2010,2,75,208,6,1,704,1424,26,629,1216,20,27.076923076923077,<=30,AUS,Away,Upto 2014
TT Bresnan,ENG,Pace,2011-01-03,Sydney,Australia,2011,2,140,288,5,1,873,1642,26,733,1354,21,33.57692307692308,>30,AUS,Away,Upto 2014
TT Bresnan,ENG,Pace,2011-07-29,Nottingham,England,2011,2,96,198,7,1,899,1645,37,803,1447,30,24.2972972972973,<=30,ENG,Home,Upto 2014
TT Bresnan,ENG,Pace,2011-08-10,Birmingham,England,2011,2,81,183,5,1,731,1272,20,650,1089,15,36.55,>30,ENG,Home,Upto 2014
TT Bresnan,ENG,Pace,2011-08-18,The Oval,England,2011,2,84,168,4,1,633,1206,15,549,1038,11,42.2,>30,ENG,Home,Upto 2014
TT Bresnan,ENG,Pace,2012-04-03,Colombo (PSS),Sri Lanka,2012,2,71,210,2,1,394,959,10,323,749,8,39.4,>30,SL,Away,Upto 2014
TT Bresnan,ENG,Pace,2012-05-17,Lord's,England,2012,2,144,336,1,1,939,1916,29,795,1580,28,32.37931034482759,>30,ENG,Home,Upto 2014
TT Bresnan,ENG,Pace,2012-05-25,Nottingham,England,2012,2,141,264,8,1,765,1507,24,624,1243,16,31.875,>30,ENG,Home,Upto 2014
TT Bresnan,ENG,Pace,2012-06-07,Birmingham,England,2012,1,111,204,3,1,443,825,14,332,621,11,31.642857142857142,>30,ENG,Home,Upto 2014
TT Bresnan,ENG,Pace,2012-07-19,The Oval,England,2012,1,140,222,1,1,900,1787,18,760,1565,17,50.0,>30,ENG,Home,Upto 2014
TT Bresnan,ENG,Pace,2012-08-02,Leeds,England,2012,2,138,216,1,1,982,1920,23,844,1704,22,42.69565217391305,>30,ENG,Home,Upto 2014
TT Bresnan,ENG,Pace,2012-11-15,Ahmedabad,India,2012,1,73,114,0,1,421,867,8,348,753,8,52.625,>30,IND,Away,Upto 2014
TT Bresnan,ENG,Pace,2012-12-13,Nagpur,India,2012,1,69,156,0,1,243,612,7,174,456,7,34.714285714285715,>30,IND,Away,Upto 2014
TT Bresnan,ENG,Pace,2013-07-18,Lord's,England,2013,2,58,126,4,1,669,1424,21,611,1298,17,31.857142857142858,>30,ENG,Home,Upto 2014
TT Bresnan,ENG,Pace,2013-08-01,Manchester,England,2013,2,139,228,3,1,710,1434,19,571,1206,16,37.36842105263158,>30,ENG,Home,Upto 2014
TT Bresnan,ENG,Pace,2013-08-09,Chester-le-Street,England,2013,2,99,192,3,1,823,1578,29,724,1386,26,28.379310344827587,<=30,ENG,Home,Upto 2014
TT Bresnan,ENG,Pace,2013-12-13,W.A.C.A,Australia,2013,2,134,225,3,1,995,1739,27,861,1514,24,36.851851851851855,>30,AUS,Away,Upto 2014
TT Bresnan,ENG,Pace,2013-12-26,Melbourne,Australia,2013,2,72,150,2,1,653,1410,24,581,1260,22,27.208333333333332,<=30,AUS,Away,Upto 2014
TT Samaraweera,SL,Spin,2001-08-29,Colombo (SSC),Sri Lanka,2001,2,22,60,1,1,579,1257,16,557,1197,15,36.1875,>30,SL,Home,Upto 2014
TT Samaraweera,SL,Spin,2001-09-06,Colombo (SSC),Sri Lanka,2001,2,45,84,1,1,422,724,14,377,640,13,30.142857142857142,>30,SL,Home,Upto 2014
TT Samaraweera,SL,Spin,2001-11-13,Galle,Sri Lanka,2001,2,31,60,1,1,681,1597,17,650,1537,16,40.05882352941177,>30,SL,Home,Upto 2014
TT Samaraweera,SL,Spin,2001-11-21,Kandy,Sri Lanka,2001,2,26,54,0,1,458,1038,19,432,984,19,24.105263157894736,<=30,SL,Home,Upto 2014
TT Samaraweera,SL,Spin,2001-11-29,Colombo (SSC),Sri Lanka,2001,2,54,96,0,1,542,1074,5,488,978,5,108.4,>30,SL,Home,Upto 2014
TT Samaraweera,SL,Spin,2001-12-27,Colombo (SSC),Sri Lanka,2001,2,17,72,2,1,311,756,12,294,684,10,25.916666666666668,<=30,SL,Home,Upto 2014
TT Samaraweera,SL,Spin,2002-01-04,Kandy,Sri Lanka,2002,2,35,72,0,1,367,934,16,332,862,16,22.9375,<=30,SL,Home,Upto 2014
TT Samaraweera,SL,Spin,2002-01-12,Galle,Sri Lanka,2002,1,14,30,0,1,515,1423,24,501,1393,24,21.458333333333332,<=30,SL,Home,Upto 2014
TT Samaraweera,SL,Spin,2002-03-06,Lahore,Pakistan,2002,1,25,54,0,1,240,516,8,215,462,8,30.0,<=30,PAK,Away,Upto 2014
TT Samaraweera,SL,Spin,2002-07-28,Colombo (SSC),Sri Lanka,2002,2,67,142,6,1,450,838,15,383,696,9,30.0,<=30,SL,Home,Upto 2014
TT Samaraweera,SL,Spin,2003-06-20,Gros Islet,West Indies,2003,1,53,48,0,1,398,848,9,345,800,9,44.22222222222222,>30,WI,Away,Upto 2014
TT Samaraweera,SL,Spin,2003-12-02,Galle,Sri Lanka,2003,1,9,18,0,1,603,1823,28,594,1805,28,21.535714285714285,<=30,SL,Home,Upto 2014
TT Samaraweera,SL,Spin,2003-12-10,Kandy,Sri Lanka,2003,1,0,6,0,1,692,1702,20,692,1696,20,34.6,>30,SL,Home,Upto 2014
TT Samaraweera,SL,Spin,2003-12-18,Colombo (SSC),Sri Lanka,2003,1,11,24,0,1,552,1368,13,541,1344,13,42.46153846153846,>30,SL,Home,Upto 2014
TT Samaraweera,SL,Spin,2004-03-24,Colombo (SSC),Sri Lanka,2004,2,78,177,1,1,844,1656,26,766,1479,25,32.46153846153846,>30,SL,Home,Upto 2014
TT Samaraweera,SL,Spin,2004-07-01,Darwin,Australia,2004,1,43,54,1,1,223,419,7,180,365,6,31.857142857142858,>30,AUS,Away,Upto 2014
TT Samaraweera,SL,Spin,2004-07-09,Cairns,Australia,2004,2,105,168,1,1,552,988,20,447,820,19,27.6,<=30,AUS,Away,Upto 2014
TT Samaraweera,SL,Spin,2004-08-04,Galle,Sri Lanka,2004,1,13,18,0,1,688,1462,17,675,1444,17,40.470588235294116,>30,SL,Home,Upto 2014
TT Samaraweera,SL,Spin,2004-10-20,Faisalabad,Pakistan,2004,1,5,6,0,1,395,875,14,390,869,14,28.214285714285715,<=30,PAK,Away,Upto 2014
TT Samaraweera,SL,Spin,2004-10-28,Karachi,Pakistan,2004,1,12,36,0,1,509,1056,15,497,1020,15,33.93333333333333,>30,PAK,Away,Upto 2014
TT Samaraweera,SL,Spin,2005-04-04,Napier,New Zealand,2005,1,6,6,0,1,443,871,8,437,865,8,55.375,>30,NZ,Away,Upto 2014
TT Samaraweera,SL,Spin,2007-11-08,Brisbane,Australia,2007,1,8,6,0,1,370,696,6,362,690,6,61.666666666666664,>30,AUS,Away,Upto 2014
TT Samaraweera,SL,Spin,2011-09-08,Pallekele,Sri Lanka,2011,1,7,24,1,1,335,684,6,328,660,5,55.833333333333336,>30,SL,Home,Upto 2014
TT Samaraweera,SL,Spin,2011-12-26,Durban,South Africa,2011,1,1,6,0,1,329,669,13,328,663,13,25.307692307692307,<=30,SA,Away,Upto 2014
TT Samaraweera,SL,Spin,2012-07-08,Pallekele,Sri Lanka,2012,1,2,6,0,1,298,765,13,296,759,13,22.923076923076923,<=30,SL,Home,Upto 2014
TV Hohns,AUS,Spin,1989-01-26,Sydney,Australia,1989,2,118,348,4,1,632,1677,20,514,1329,16,31.6,>30,AUS,Home,Upto 2014
TV Hohns,AUS,Spin,1989-02-03,Adelaide,Australia,1989,2,162,376,2,1,439,1030,5,277,654,3,87.8,>30,AUS,Home,Upto 2014
TV Hohns,AUS,Spin,1989-06-22,Lord's,England,1989,2,42,120,0,1,161,444,4,119,324,4,40.25,>30,ENG,Away,Upto 2014
TV Hohns,AUS,Spin,1989-07-06,Birmingham,England,1989,1,18,96,1,1,123,408,3,105,312,2,41.0,>30,ENG,Away,Upto 2014
TV Hohns,AUS,Spin,1989-07-27,Manchester,England,1989,2,96,288,4,1,359,881,8,263,593,4,44.875,>30,ENG,Away,Upto 2014
TV Hohns,AUS,Spin,1989-08-10,Nottingham,England,1989,2,77,180,4,1,273,660,7,196,480,3,39.0,>30,ENG,Away,Upto 2014
TV Hohns,AUS,Spin,1989-08-24,The Oval,England,1989,2,67,120,2,1,165,312,2,98,192,0,82.5,>30,ENG,Away,Upto 2014
TW Cartwright,ENG,Pace,1964-07-23,Manchester,England,1964,1,118,462,2,1,759,1991,14,641,1529,12,54.214285714285715,>30,ENG,Home,Upto 2014
TW Cartwright,ENG,Pace,1964-08-13,The Oval,England,1964,1,110,372,3,1,732,1783,22,622,1411,19,33.27272727272727,>30,ENG,Home,Upto 2014
TW Cartwright,ENG,Pace,1965-01-22,Johannesburg,South Africa,1965,2,196,474,2,1,754,1664,13,558,1190,11,58.0,>30,SA,Away,Upto 2014
TW Cartwright,ENG,Pace,1965-05-27,Birmingham,England,1965,2,26,114,2,1,468,1202,15,442,1088,13,31.2,>30,ENG,Home,Upto 2014
TW Cartwright,ENG,Pace,1965-08-05,Nottingham,England,1965,1,94,189,6,1,718,1736,30,624,1547,24,23.933333333333334,<=30,ENG,Home,Upto 2014
TW Garrett,AUS,Pace,1877-03-15,Melbourne,Australia,1877,2,31,81,2,1,194,465,7,163,384,5,27.714285714285715,<=30,AUS,Home,After 1965
TW Garrett,AUS,Pace,1877-03-31,Melbourne,Australia,1877,2,17,24,0,1,269,577,12,252,553,12,22.416666666666668,<=30,AUS,Home,After 1965
TW Garrett,AUS,Pace,1879-01-02,Melbourne,Australia,1879,2,36,60,1,1,316,788,22,280,728,21,14.363636363636363,<=30,AUS,Home,After 1965
TW Garrett,AUS,Pace,1882-02-17,Sydney,Australia,1882,1,62,144,4,1,195,434,9,133,290,5,21.666666666666668,<=30,AUS,Home,After 1965
TW Garrett,AUS,Pace,1882-03-03,Sydney,Australia,1882,2,163,385,9,1,221,493,9,58,108,0,24.555555555555557,<=30,AUS,Home,After 1965
TW Garrett,AUS,Pace,1882-03-10,Melbourne,Australia,1882,2,142,326,5,1,399,909,9,257,583,4,44.333333333333336,>30,AUS,Home,After 1965
TW Garrett,AUS,Pace,1882-08-28,The Oval,England,1882,2,32,92,1,1,213,651,23,181,559,22,9.26086956521739,<=30,ENG,Away,After 1965
TW Garrett,AUS,Pace,1882-12-30,Melbourne,Australia,1882,2,48,116,1,1,380,1024,17,332,908,16,22.352941176470587,<=30,AUS,Home,After 1965
TW Garrett,AUS,Pace,1883-01-19,Melbourne,Australia,1883,1,35,136,0,1,335,900,10,300,764,10,33.5,>30,AUS,Home,After 1965
TW Garrett,AUS,Pace,1883-01-26,Sydney,Australia,1883,2,85,160,2,1,439,1288,28,354,1128,26,15.678571428571429,<=30,AUS,Home,After 1965
TW Garrett,AUS,Pace,1885-02-20,Sydney,Australia,1885,2,48,108,0,1,367,1227,19,319,1119,19,19.31578947368421,<=30,AUS,Home,After 1965
TW Garrett,AUS,Pace,1885-03-14,Sydney,Australia,1885,1,5,8,0,1,423,931,23,418,923,23,18.391304347826086,<=30,AUS,Home,After 1965
TW Garrett,AUS,Pace,1885-03-21,Melbourne,Australia,1885,1,12,32,0,1,490,1192,20,478,1160,20,24.5,<=30,AUS,Home,After 1965
TW Garrett,AUS,Pace,1886-07-05,Manchester,England,1886,2,57,248,3,1,434,1426,26,377,1178,23,16.692307692307693,<=30,ENG,Away,After 1965
TW Garrett,AUS,Pace,1886-07-19,Lord's,England,1886,1,77,288,2,1,322,1023,13,245,735,11,24.76923076923077,<=30,ENG,Away,After 1965
TW Garrett,AUS,Pace,1886-08-12,The Oval,England,1886,1,88,396,3,1,385,1143,19,297,747,16,20.263157894736842,<=30,ENG,Away,After 1965
TW Garrett,AUS,Pace,1887-01-28,Sydney,Australia,1887,1,8,48,2,1,241,1003,28,233,955,26,8.607142857142858,<=30,AUS,Home,After 1965
TW Garrett,AUS,Pace,1887-02-25,Sydney,Australia,1887,2,19,64,1,1,222,846,20,203,782,19,11.1,<=30,AUS,Home,After 1965
TW Garrett,AUS,Pace,1888-02-10,Sydney,Australia,1888,1,5,12,0,1,187,670,24,182,658,24,7.791666666666667,<=30,AUS,Home,After 1965
TW Graveney,ENG,Spin,1951-12-30,Eden Gardens,India,1951,1,9,6,0,1,698,1841,19,689,1835,19,36.73684210526316,>30,IND,Away,Upto 2014
TW Graveney,ENG,Spin,1954-03-17,Port of Spain,West Indies,1954,2,59,48,0,1,1025,1930,13,966,1882,13,78.84615384615384,>30,WI,Away,Upto 2014
TW Graveney,ENG,Spin,1955-02-25,Sydney,Australia,1955,1,34,48,1,1,313,666,14,279,618,13,22.357142857142858,<=30,AUS,Away,Upto 2014
TW Graveney,ENG,Spin,1956-06-07,Nottingham,England,1956,1,6,36,0,1,279,1027,11,273,991,11,25.363636363636363,<=30,ENG,Home,Upto 2014
TW Graveney,ENG,Spin,1957-07-04,Nottingham,England,1957,1,14,30,0,1,731,1812,9,717,1782,9,81.22222222222223,>30,ENG,Home,Upto 2014
TW Graveney,ENG,Spin,1962-12-29,Melbourne,Australia,1962,1,10,24,0,1,341,714,6,331,690,6,56.833333333333336,>30,AUS,Away,Upto 2014
TW Graveney,ENG,Spin,1963-02-15,Sydney,Australia,1963,1,24,32,0,1,588,2042,17,564,2010,17,34.588235294117645,>30,AUS,Away,Upto 2014
TW Graveney,ENG,Spin,1969-02-21,Lahore,Pakistan,1969,1,11,36,0,1,546,1362,17,535,1326,17,32.11764705882353,>30,PAK,Away,Upto 2014
TW Hartley,ENG,Spin,2024-01-25,Hyderabad,India,2024,2,193,308,9,1,1067,1778,32,874,1470,23,33.34375,>30,IND,Away,After 1965
TW Hartley,ENG,Spin,2024-02-02,Visakhapatnam,India,2024,2,151,270,5,1,935,1413,24,784,1143,19,38.958333333333336,>30,IND,Away,After 1965
TW Hartley,ENG,Spin,2024-02-15,Rajkot,India,2024,2,187,378,2,1,805,1288,20,618,910,18,40.25,>30,IND,Away,After 1965
TW Hartley,ENG,Spin,2024-02-23,Ranchi,India,2024,2,138,314,4,1,670,1494,28,532,1180,24,23.928571428571427,<=30,IND,Away,After 1965
TW Hartley,ENG,Spin,2024-03-07,Dharamsala,India,2024,1,126,234,2,1,589,972,25,463,738,23,23.56,<=30,IND,Away,After 1965
TW Hayward,ENG,Pace,1896-02-13,Gqeberha,South Africa,1896,2,7,25,2,1,376,688,29,369,663,27,12.96551724137931,<=30,SA,Away,After 1965
TW Hayward,ENG,Pace,1896-03-02,Johannesburg,South Africa,1896,1,21,20,0,1,539,922,24,518,902,24,22.458333333333332,<=30,SA,Away,After 1965
TW Hayward,ENG,Pace,1896-06-22,Lord's,England,1896,1,44,55,0,1,652,1288,29,608,1233,29,22.482758620689655,<=30,ENG,Home,After 1965
TW Hayward,ENG,Pace,1896-08-10,The Oval,England,1896,1,17,10,0,1,180,416,13,163,406,13,13.846153846153847,<=30,ENG,Home,After 1965
TW Hayward,ENG,Pace,1897-12-13,Sydney,Australia,1897,2,27,48,0,1,722,1597,21,695,1549,21,34.38095238095238,>30,AUS,Away,After 1965
TW Hayward,ENG,Pace,1898-01-01,Melbourne,Australia,1898,1,23,54,1,1,464,1032,7,441,978,6,66.28571428571429,>30,AUS,Away,After 1965
TW Hayward,ENG,Pace,1898-01-14,Adelaide,Australia,1898,1,36,54,0,1,674,1910,19,638,1856,19,35.473684210526315,>30,AUS,Away,After 1965
TW Hayward,ENG,Pace,1898-01-29,Melbourne,Australia,1898,2,48,120,2,1,528,1140,21,480,1020,19,25.142857142857142,<=30,AUS,Away,After 1965
TW Hayward,ENG,Pace,1898-02-26,Sydney,Australia,1898,2,30,42,1,1,648,1334,24,618,1292,23,27.0,<=30,AUS,Away,After 1965
TW Hayward,ENG,Pace,1899-06-01,Nottingham,England,1899,2,30,45,0,1,533,1449,20,503,1404,20,26.65,<=30,ENG,Home,After 1965
TW Hayward,ENG,Pace,1899-06-15,Lord's,England,1899,1,25,30,0,1,490,1002,18,465,972,18,27.22222222222222,<=30,ENG,Home,After 1965
TW Hayward,ENG,Pace,1899-06-29,Leeds,England,1899,1,45,50,2,1,374,834,15,329,784,13,24.933333333333334,<=30,ENG,Home,After 1965
TW Hayward,ENG,Pace,1899-07-17,Manchester,England,1899,1,10,15,0,1,742,1679,23,732,1664,23,32.26086956521739,>30,ENG,Home,After 1965
TW Hayward,ENG,Pace,1899-08-14,The Oval,England,1899,1,38,55,1,1,660,1288,13,622,1233,12,50.76923076923077,>30,ENG,Home,After 1965
TW Hayward,ENG,Pace,1902-01-17,Adelaide,Australia,1902,1,28,42,0,1,342,876,5,314,834,5,68.4,>30,AUS,Away,Upto 2014
TW Hayward,ENG,Pace,1902-02-28,Melbourne,Australia,1902,2,85,228,5,1,141,297,8,56,69,3,17.625,<=30,AUS,Away,Upto 2014
TW Jarvis,NZ,Spin,1966-03-11,Auckland,New Zealand,1966,1,3,6,0,1,300,776,10,297,770,10,30.0,<=30,NZ,Home,Upto 2014
TW Jarvis,NZ,Spin,1972-04-06,Georgetown,West Indies,1972,1,0,6,0,1,489,1488,3,489,1482,3,163.0,>30,WI,Away,Upto 2014
TW Wall,AUS,Pace,1929-03-08,Melbourne,Australia,1929,2,189,450,8,1,826,2351,25,637,1901,17,33.04,>30,AUS,Home,Upto 2014
TW Wall,AUS,Pace,1930-06-13,Nottingham,England,1930,2,114,258,4,1,383,898,10,269,640,6,38.3,>30,ENG,Away,Upto 2014
TW Wall,AUS,Pace,1930-06-27,Lord's,England,1930,2,198,328,3,1,579,1102,10,381,774,7,57.9,>30,ENG,Away,Upto 2014
TW Wall,AUS,Pace,1930-07-11,Leeds,England,1930,2,90,300,1,1,460,1116,6,370,816,5,76.66666666666667,>30,ENG,Away,Upto 2014
TW Wall,AUS,Pace,1930-07-25,Manchester,England,1930,1,70,198,3,1,183,630,11,113,432,8,16.636363636363637,<=30,ENG,Away,Upto 2014
TW Wall,AUS,Pace,1930-08-16,The Oval,England,1930,2,121,294,2,1,505,1314,10,384,1020,8,50.5,>30,ENG,Away,Upto 2014
TW Wall,AUS,Pace,1930-12-12,Adelaide,Australia,1930,2,84,156,0,1,453,957,5,369,801,5,90.6,>30,AUS,Home,Upto 2014
TW Wall,AUS,Pace,1931-11-27,Brisbane,Australia,1931,2,53,259,7,1,377,952,14,324,693,7,26.928571428571427,<=30,AUS,Home,Upto 2014
TW Wall,AUS,Pace,1931-12-18,Sydney,Australia,1931,2,77,216,3,1,383,911,14,306,695,11,27.357142857142858,<=30,AUS,Home,Upto 2014
TW Wall,AUS,Pace,1931-12-31,Melbourne,Australia,1931,2,133,300,3,1,596,1454,16,463,1154,13,37.25,>30,AUS,Home,Upto 2014
TW Wall,AUS,Pace,1932-12-02,Sydney,Australia,1932,1,104,228,3,1,694,1474,26,590,1246,23,26.692307692307693,<=30,AUS,Home,Upto 2014
TW Wall,AUS,Pace,1932-12-30,Melbourne,Australia,1932,2,75,174,5,1,475,1034,22,400,860,17,21.59090909090909,<=30,AUS,Home,Upto 2014
TW Wall,AUS,Pace,1933-01-13,Adelaide,Australia,1933,2,147,379,6,1,549,1333,23,402,954,17,23.869565217391305,<=30,AUS,Home,Upto 2014
TW Wall,AUS,Pace,1933-02-10,Brisbane,Australia,1933,2,83,240,2,1,508,1171,18,425,931,16,28.22222222222222,<=30,AUS,Home,Upto 2014
TW Wall,AUS,Pace,1934-06-08,Nottingham,England,1934,2,109,276,1,1,503,1268,16,394,992,15,31.4375,>30,ENG,Away,Upto 2014
TW Wall,AUS,Pace,1934-06-22,Lord's,England,1934,1,108,294,4,1,436,1038,10,328,744,6,43.6,>30,ENG,Away,Upto 2014
TW Wall,AUS,Pace,1934-07-06,Manchester,England,1934,2,162,270,0,1,754,1551,6,592,1281,6,125.66666666666667,>30,ENG,Away,Upto 2014
TW Wall,AUS,Pace,1934-07-20,Leeds,England,1934,2,93,192,1,1,418,900,7,325,708,6,59.714285714285715,>30,ENG,Away,Upto 2014
TWJ Goddard,ENG,Spin,1930-07-25,Manchester,England,1930,1,49,193,2,1,355,1021,7,306,828,5,50.714285714285715,>30,ENG,Home,Upto 2014
TWJ Goddard,ENG,Spin,1937-07-24,Manchester,England,1937,2,77,196,6,1,559,1166,19,482,970,13,29.42105263157895,<=30,ENG,Home,Upto 2014
TWJ Goddard,ENG,Spin,1937-08-14,The Oval,England,1937,2,66,168,2,1,331,715,12,265,547,10,27.583333333333332,<=30,ENG,Home,Upto 2014
TWJ Goddard,ENG,Spin,1938-12-24,Johannesburg,South Africa,1938,2,85,304,3,1,478,1422,15,393,1118,12,31.866666666666667,>30,SA,Away,Upto 2014
TWJ Goddard,ENG,Spin,1938-12-31,Cape Town,South Africa,1938,2,132,392,4,1,556,1422,11,424,1030,7,50.54545454545455,>30,SA,Away,Upto 2014
TWJ Goddard,ENG,Spin,1939-02-18,Johannesburg,South Africa,1939,1,65,144,1,1,359,773,7,294,629,6,51.285714285714285,>30,SA,Away,Upto 2014
TWJ Goddard,ENG,Spin,1939-07-22,Manchester,England,1939,2,58,70,3,1,184,368,9,126,298,6,20.444444444444443,<=30,ENG,Home,Upto 2014
TWJ Goddard,ENG,Spin,1939-08-19,The Oval,England,1939,1,56,96,1,1,434,768,4,378,672,3,108.5,>30,ENG,Home,Upto 2014
Tabish Khan,PAK,Pace,2021-05-07,Harare,Zimbabwe,2021,2,68,156,1,1,481,1050,18,413,894,17,26.72222222222222,<=30,ZIM,Away,After 1965
Tahir Naqqash,PAK,Pace,1982-03-05,Karachi,Pakistan,1982,2,117,246,5,1,440,708,10,323,462,5,44.0,>30,PAK,Home,Upto 2014
Tahir Naqqash,PAK,Pace,1982-03-14,Faisalabad,Pakistan,1982,2,161,234,2,1,305,474,6,144,240,4,50.833333333333336,>30,PAK,Home,Upto 2014
Tahir Naqqash,PAK,Pace,1982-03-22,Lahore,Pakistan,1982,2,76,96,0,1,456,794,20,380,698,20,22.8,<=30,PAK,Home,Upto 2014
Tahir Naqqash,PAK,Pace,1982-07-29,Birmingham,England,1982,2,86,198,6,1,641,1313,30,555,1115,24,21.366666666666667,<=30,ENG,Away,Upto 2014
Tahir Naqqash,PAK,Pace,1982-08-12,Lord's,England,1982,2,31,114,1,1,700,1644,21,669,1530,20,33.333333333333336,>30,ENG,Away,Upto 2014
Tahir Naqqash,PAK,Pace,1982-09-22,Karachi,Pakistan,1982,2,78,138,4,1,384,853,11,306,715,7,34.90909090909091,>30,PAK,Home,Upto 2014
Tahir Naqqash,PAK,Pace,1982-09-30,Faisalabad,Pakistan,1982,2,46,144,0,1,292,720,7,246,576,7,41.714285714285715,>30,PAK,Home,Upto 2014
Tahir Naqqash,PAK,Pace,1982-10-14,Lahore,Pakistan,1982,2,104,204,3,1,661,1346,22,557,1142,19,30.045454545454547,>30,PAK,Home,Upto 2014
Tahir Naqqash,PAK,Pace,1982-12-10,Lahore,Pakistan,1982,1,114,174,0,1,700,1379,14,586,1205,14,50.0,>30,PAK,Home,Upto 2014
Tahir Naqqash,PAK,Pace,1983-01-30,Karachi,Pakistan,1983,2,97,192,2,1,655,1382,13,558,1190,11,50.38461538461539,>30,PAK,Home,Upto 2014
Tahir Naqqash,PAK,Pace,1983-09-14,Bengaluru,India,1983,2,130,311,5,1,497,1170,18,367,859,13,27.61111111111111,<=30,IND,Away,Upto 2014
Tahir Naqqash,PAK,Pace,1983-09-24,Jalandhar,India,1983,1,74,162,2,1,450,936,11,376,774,9,40.90909090909091,>30,IND,Away,Upto 2014
Tahir Naqqash,PAK,Pace,1983-10-05,Nagpur,India,1983,2,127,255,1,1,439,897,10,312,642,9,43.9,>30,IND,Away,Upto 2014
Tahir Naqqash,PAK,Pace,1983-11-11,W.A.C.A,Australia,1983,1,76,132,0,1,628,1218,24,552,1086,24,26.166666666666668,<=30,AUS,Away,Upto 2014
Tahir Naqqash,PAK,Pace,1985-02-09,Dunedin,New Zealand,1985,2,81,200,3,1,862,2018,34,781,1818,31,25.352941176470587,<=30,NZ,Away,Upto 2014
Taijul Islam,BAN,Spin,2014-09-05,Kingstown,West Indies,2014,2,139,288,5,1,510,1180,16,371,892,11,31.875,>30,WI,Away,After 1965
Taijul Islam,BAN,Spin,2014-09-13,Gros Islet,West Indies,2014,2,170,300,3,1,411,807,13,241,507,10,31.615384615384617,>30,WI,Away,After 1965
Taijul Islam,BAN,Spin,2014-10-25,Mirpur,Bangladesh,2014,2,81,179,9,1,460,898,22,379,719,13,20.90909090909091,<=30,BAN,Home,After 1965
Taijul Islam,BAN,Spin,2014-11-03,Khulna,Bangladesh,2014,2,140,284,6,1,829,1764,29,689,1480,23,28.586206896551722,<=30,BAN,Home,After 1965
Taijul Islam,BAN,Spin,2014-11-12,Chattogram,Bangladesh,2014,2,148,312,2,1,952,1674,19,804,1362,17,50.10526315789474,>30,BAN,Home,After 1965
Taijul Islam,BAN,Spin,2015-04-28,Khulna,Bangladesh,2015,1,163,280,6,1,1092,1798,20,929,1518,14,54.6,>30,BAN,Home,After 1965
Taijul Islam,BAN,Spin,2015-05-06,Mirpur,Bangladesh,2015,2,235,366,4,1,692,1014,18,457,648,14,38.44444444444444,>30,BAN,Home,After 1965
Taijul Islam,BAN,Spin,2015-06-10,Fatullah,Bangladesh,2015,1,85,120,0,1,528,806,14,443,686,14,37.714285714285715,>30,BAN,Home,After 1965
Taijul Islam,BAN,Spin,2015-07-21,Chattogram,Bangladesh,2015,2,61,120,1,1,318,607,10,257,487,9,31.8,>30,BAN,Home,After 1965
Taijul Islam,BAN,Spin,2016-10-20,Chattogram,Bangladesh,2016,2,88,236,4,1,760,1579,30,672,1343,26,25.333333333333332,<=30,BAN,Home,After 1965
Taijul Islam,BAN,Spin,2016-10-28,Mirpur,Bangladesh,2016,2,72,183,3,1,691,1258,32,619,1075,29,21.59375,<=30,BAN,Home,After 1965
Taijul Islam,BAN,Spin,2017-02-09,Hyderabad,India,2017,2,185,318,3,1,881,1634,19,696,1316,16,46.36842105263158,>30,IND,Away,After 1965
Taijul Islam,BAN,Spin,2017-03-15,Colombo (PSS),Sri Lanka,2017,2,78,168,2,1,916,1838,26,838,1670,24,35.23076923076923,>30,SL,Away,After 1965
Taijul Islam,BAN,Spin,2017-08-27,Mirpur,Bangladesh,2017,2,92,167,4,1,693,1433,34,601,1266,30,20.38235294117647,<=30,BAN,Home,After 1965
Taijul Islam,BAN,Spin,2017-09-04,Chattogram,Bangladesh,2017,2,104,150,2,1,709,1537,24,605,1387,22,29.541666666666668,<=30,BAN,Home,After 1965
Taijul Islam,BAN,Spin,2017-10-06,Bloemfontein,South Africa,2017,1,145,162,0,1,239,300,1,94,138,1,239.0,>30,SA,Away,After 1965
Taijul Islam,BAN,Spin,2018-01-31,Chattogram,Bangladesh,2018,1,219,405,4,1,1210,2061,19,991,1656,15,63.68421052631579,>30,BAN,Home,After 1965
Taijul Islam,BAN,Spin,2018-02-08,Mirpur,Bangladesh,2018,2,159,272,8,1,561,1029,30,402,757,22,18.7,<=30,BAN,Home,After 1965
Taijul Islam,BAN,Spin,2018-07-12,Kingston,West Indies,2018,2,106,192,3,1,399,810,18,293,618,15,22.166666666666668,<=30,WI,Away,After 1965
Taijul Islam,BAN,Spin,2018-11-03,Sylhet,Bangladesh,2018,2,170,409,11,1,549,1328,32,379,919,21,17.15625,<=30,BAN,Home,After 1965
Taijul Islam,BAN,Spin,2018-11-11,Mirpur,Bangladesh,2018,2,200,465,7,1,819,1414,17,619,949,10,48.1764705882353,>30,BAN,Home,After 1965
Taijul Islam,BAN,Spin,2018-11-22,Chattogram,Bangladesh,2018,2,84,188,7,1,618,1097,34,534,909,27,18.176470588235293,<=30,BAN,Home,After 1965
Taijul Islam,BAN,Spin,2018-11-30,Mirpur,Bangladesh,2018,2,50,68,3,1,676,1230,27,626,1162,24,25.037037037037038,<=30,BAN,Home,After 1965
Taijul Islam,BAN,Spin,2019-03-08,Wellington,New Zealand,2019,1,99,126,2,1,140,180,2,41,54,0,70.0,>30,NZ,Away,After 1965
Taijul Islam,BAN,Spin,2019-09-05,Chattogram,Bangladesh,2019,2,202,414,6,1,903,1930,38,701,1516,32,23.763157894736842,<=30,BAN,Home,After 1965
Taijul Islam,BAN,Spin,2019-11-14,Indore,India,2019,1,120,168,0,1,411,632,6,291,464,6,68.5,>30,IND,Away,After 1965
Taijul Islam,BAN,Spin,2019-11-22,Eden Gardens,India,2019,1,80,150,1,1,112,192,1,32,42,0,112.0,>30,IND,Away,After 1965
Taijul Islam,BAN,Spin,2020-02-07,Rawalpindi,Pakistan,2020,1,139,246,2,1,309,548,8,170,302,6,38.625,>30,PAK,Away,After 1965
Taijul Islam,BAN,Spin,2020-02-22,Mirpur,Bangladesh,2020,2,168,312,6,1,601,1116,18,433,804,12,33.388888888888886,>30,BAN,Home,After 1965
Taijul Islam,BAN,Spin,2021-02-03,Chattogram,Bangladesh,2021,2,175,469,4,1,955,2045,28,780,1576,24,34.107142857142854,>30,BAN,Home,After 1965
Taijul Islam,BAN,Spin,2021-02-11,Mirpur,Bangladesh,2021,2,144,404,8,1,665,1522,28,521,1118,20,23.75,<=30,BAN,Home,After 1965
Taijul Islam,BAN,Spin,2021-04-21,Pallekele,Sri Lanka,2021,1,163,270,2,1,649,1170,4,486,900,2,162.25,>30,SL,Away,After 1965
Taijul Islam,BAN,Spin,2021-04-29,Pallekele,Sri Lanka,2021,2,155,344,6,1,753,1454,28,598,1110,22,26.892857142857142,<=30,SL,Away,After 1965
Taijul Islam,BAN,Spin,2021-11-26,Chattogram,Bangladesh,2021,2,205,436,8,1,541,1197,14,336,761,6,38.642857142857146,>30,BAN,Home,After 1965
Taijul Islam,BAN,Spin,2021-12-04,Mirpur,Bangladesh,2021,1,73,150,2,1,366,844,15,293,694,13,24.4,<=30,BAN,Home,After 1965
Taijul Islam,BAN,Spin,2022-04-08,Gqeberha,South Africa,2022,2,202,390,9,1,500,972,27,298,582,18,18.51851851851852,<=30,SA,Away,After 1965
Taijul Islam,BAN,Spin,2022-05-15,Chattogram,Bangladesh,2022,2,189,492,5,1,772,1873,17,583,1381,12,45.411764705882355,>30,BAN,Home,After 1965
Taijul Islam,BAN,Spin,2022-05-23,Mirpur,Bangladesh,2022,2,140,300,0,1,553,1141,6,413,841,6,92.16666666666667,>30,BAN,Home,After 1965
Taijul Islam,BAN,Spin,2022-12-14,Chattogram,Bangladesh,2022,2,204,418,4,1,800,1534,23,596,1116,19,34.78260869565217,>30,BAN,Home,After 1965
Taijul Islam,BAN,Spin,2022-12-22,Mirpur,Bangladesh,2022,2,88,216,4,1,578,1084,25,490,868,21,23.12,<=30,BAN,Home,After 1965
Taijul Islam,BAN,Spin,2023-04-04,Mirpur,Bangladesh,2023,2,148,420,9,1,595,1200,23,447,780,14,25.869565217391305,<=30,BAN,Home,After 1965
Taijul Islam,BAN,Spin,2023-06-14,Mirpur,Bangladesh,2023,2,26,60,2,1,497,697,11,471,637,9,45.18181818181818,>30,BAN,Home,After 1965
Taijul Islam,BAN,Spin,2023-11-28,Sylhet,Bangladesh,2023,2,184,421,10,1,883,1678,32,699,1257,22,27.59375,<=30,BAN,Home,After 1965
Taijul Islam,BAN,Spin,2023-12-06,Mirpur,Bangladesh,2023,2,122,181,5,1,542,923,30,420,742,25,18.066666666666666,<=30,BAN,Home,After 1965
Taijul Islam,BAN,Spin,2024-03-22,Sylhet,Bangladesh,2024,2,106,202,3,1,284,550,7,178,348,4,40.57142857142857,>30,BAN,Home,After 1965
Taijul Islam,BAN,Spin,2024-03-30,Chattogram,Bangladesh,2024,2,119,216,0,1,649,1230,12,530,1014,12,54.083333333333336,>30,BAN,Home,After 1965
Taijul Islam,BAN,Spin,2024-09-27,Kanpur,India,2024,2,90,74,1,1,428,548,20,338,474,19,21.4,<=30,IND,Away,After 1965
Taijul Islam,BAN,Spin,2024-10-21,Mirpur,Bangladesh,2024,2,165,282,8,1,586,1001,17,421,719,9,34.470588235294116,>30,BAN,Home,After 1965
Taijul Islam,BAN,Spin,2024-10-29,Chattogram,Bangladesh,2024,1,198,314,5,1,583,920,17,385,606,12,34.294117647058826,>30,BAN,Home,After 1965
Taijul Islam,BAN,Spin,2024-11-22,North Sound,West Indies,2024,2,136,258,2,1,296,631,6,160,373,4,49.333333333333336,>30,WI,Away,After 1965
Taijul Islam,BAN,Spin,2024-11-30,Kingston,West Indies,2024,2,74,204,6,1,139,318,7,65,114,1,19.857142857142858,<=30,WI,Away,After 1965
Talat Ali,PAK,Pace,1973-02-02,Wellington,New Zealand,1973,1,1,8,0,1,687,1320,19,686,1312,19,36.1578947368421,>30,NZ,Away,Upto 2014
Talat Ali,PAK,Pace,1973-03-16,Hyderabad (Sind),Pakistan,1973,1,6,12,0,1,221,462,4,215,450,4,55.25,>30,PAK,Home,Upto 2014
Talha Jubair,BAN,Pace,2002-07-21,Colombo (PSS),Sri Lanka,2002,1,120,126,2,1,532,738,12,412,612,10,44.333333333333336,>30,SL,Away,Upto 2014
Talha Jubair,BAN,Pace,2002-07-28,Colombo (SSC),Sri Lanka,2002,2,126,214,3,1,518,934,16,392,720,13,32.375,>30,SL,Away,Upto 2014
Talha Jubair,BAN,Pace,2002-10-18,East London,South Africa,2002,1,108,156,2,1,686,1167,21,578,1011,19,32.666666666666664,>30,SA,Away,Upto 2014
Talha Jubair,BAN,Pace,2002-10-25,Potchefstroom,South Africa,2002,1,109,156,2,1,588,1047,21,479,891,19,28.0,<=30,SA,Away,Upto 2014
Talha Jubair,BAN,Pace,2002-12-08,Dhaka,Bangladesh,2002,1,135,186,3,1,465,906,25,330,720,22,18.6,<=30,BAN,Home,Upto 2014
Talha Jubair,BAN,Pace,2002-12-16,Chattogram,Bangladesh,2002,2,78,138,2,1,655,1306,30,577,1168,28,21.833333333333332,<=30,BAN,Home,Upto 2014
Talha Jubair,BAN,Pace,2004-12-17,Chattogram,Bangladesh,2004,1,95,114,0,1,505,785,14,410,671,14,36.07142857142857,>30,BAN,Home,Upto 2014
Tamim Iqbal,BAN,Spin,2008-10-25,Mirpur,Bangladesh,2008,1,1,6,0,1,361,720,10,360,714,10,36.1,>30,BAN,Home,Upto 2014
Tamim Iqbal,BAN,Spin,2009-01-03,Chattogram,Bangladesh,2009,1,3,6,0,1,931,1570,27,928,1564,27,34.48148148148148,>30,BAN,Home,Upto 2014
Tamim Iqbal,BAN,Spin,2010-03-12,Chattogram,Bangladesh,2010,1,2,6,0,1,894,1491,22,892,1485,22,40.63636363636363,>30,BAN,Home,Upto 2014
Tamim Iqbal,BAN,Spin,2010-03-20,Mirpur,Bangladesh,2010,1,4,6,0,1,865,1792,20,861,1786,20,43.25,>30,BAN,Home,Upto 2014
Tamim Iqbal,BAN,Spin,2012-11-13,Mirpur,Bangladesh,2012,1,10,6,0,1,992,1679,19,982,1673,19,52.21052631578947,>30,BAN,Home,Upto 2014
Tanvir Ahmed,PAK,Pace,2010-11-20,Abu Dhabi,UAE,2010,2,149,198,6,1,798,1290,13,649,1092,7,61.38461538461539,>30,UAE,Away,Upto 2014
Tanvir Ahmed,PAK,Pace,2011-01-07,Hamilton,New Zealand,2011,2,83,137,4,1,564,1033,21,481,896,17,26.857142857142858,<=30,NZ,Away,Upto 2014
Tanvir Ahmed,PAK,Pace,2011-01-15,Wellington,New Zealand,2011,2,129,210,4,1,781,1511,23,652,1301,19,33.95652173913044,>30,NZ,Away,Upto 2014
Tanvir Ahmed,PAK,Pace,2011-05-20,Basseterre,West Indies,2011,2,32,72,2,1,547,1106,13,515,1034,11,42.07692307692308,>30,WI,Away,Upto 2014
Tanvir Ahmed,PAK,Pace,2013-02-14,Cape Town,South Africa,2013,2,60,90,1,1,620,1269,20,560,1179,19,31.0,>30,SA,Away,Upto 2014
Tapash Baisya,BAN,Pace,2002-07-28,Colombo (SSC),Sri Lanka,2002,2,109,120,1,1,518,934,16,409,814,15,32.375,>30,SL,Away,Upto 2014
Tapash Baisya,BAN,Pace,2002-10-18,East London,South Africa,2002,1,148,180,1,1,686,1167,21,538,987,20,32.666666666666664,>30,SA,Away,Upto 2014
Tapash Baisya,BAN,Pace,2002-10-25,Potchefstroom,South Africa,2002,1,103,168,1,1,588,1047,21,485,879,20,28.0,<=30,SA,Away,Upto 2014
Tapash Baisya,BAN,Pace,2002-12-08,Dhaka,Bangladesh,2002,1,117,204,2,1,465,906,25,348,702,23,18.6,<=30,BAN,Home,Upto 2014
Tapash Baisya,BAN,Pace,2002-12-16,Chattogram,Bangladesh,2002,2,117,183,6,1,655,1306,30,538,1123,24,21.833333333333332,<=30,BAN,Home,Upto 2014
Tapash Baisya,BAN,Pace,2003-04-24,Chattogram,Bangladesh,2003,1,70,138,1,1,514,1056,11,444,918,10,46.72727272727273,>30,BAN,Home,Upto 2014
Tapash Baisya,BAN,Pace,2003-05-01,Dhaka,Bangladesh,2003,1,67,114,1,1,304,666,13,237,552,12,23.384615384615383,<=30,BAN,Home,Upto 2014
Tapash Baisya,BAN,Pace,2003-07-18,Darwin,Australia,2003,1,69,131,1,1,496,985,17,427,854,16,29.176470588235293,<=30,AUS,Away,Upto 2014
Tapash Baisya,BAN,Pace,2003-07-25,Cairns,Australia,2003,1,96,156,1,1,637,1169,12,541,1013,11,53.083333333333336,>30,AUS,Away,Upto 2014
Tapash Baisya,BAN,Pace,2003-08-20,Karachi,Pakistan,2003,2,76,168,2,1,660,1252,19,584,1084,17,34.73684210526316,>30,PAK,Away,Upto 2014
Tapash Baisya,BAN,Pace,2003-09-03,Multan,Pakistan,2003,2,100,138,1,1,593,1160,25,493,1022,24,23.72,<=30,PAK,Away,Upto 2014
Tapash Baisya,BAN,Pace,2004-02-19,Harare,Zimbabwe,2004,2,198,312,5,1,617,1260,23,419,948,18,26.82608695652174,<=30,ZIM,Away,Upto 2014
Tapash Baisya,BAN,Pace,2004-02-26,Bulawayo,Zimbabwe,2004,1,43,90,2,1,218,510,6,175,420,4,36.333333333333336,>30,ZIM,Away,Upto 2014
Tapash Baisya,BAN,Pace,2004-05-28,Gros Islet,West Indies,2004,2,113,174,2,1,821,1459,16,708,1285,14,51.3125,>30,WI,Away,Upto 2014
Tapash Baisya,BAN,Pace,2004-06-04,Kingston,West Indies,2004,1,99,150,1,1,592,1032,15,493,882,14,39.46666666666667,>30,WI,Away,Upto 2014
Tapash Baisya,BAN,Pace,2004-10-19,Dhaka,Bangladesh,2004,1,112,168,1,1,301,659,9,189,491,8,33.44444444444444,>30,BAN,Home,Upto 2014
Tapash Baisya,BAN,Pace,2004-10-26,Chattogram,Bangladesh,2004,1,82,102,0,1,237,372,3,155,270,3,79.0,>30,BAN,Home,Upto 2014
Tapash Baisya,BAN,Pace,2004-12-10,Dhaka,Bangladesh,2004,1,114,174,2,1,566,884,20,452,710,18,28.3,<=30,BAN,Home,Upto 2014
Tapash Baisya,BAN,Pace,2005-01-06,Chattogram,Bangladesh,2005,2,107,204,3,1,681,1423,24,574,1219,21,28.375,<=30,BAN,Home,Upto 2014
Tapash Baisya,BAN,Pace,2005-01-14,Dhaka,Bangladesh,2005,2,117,206,2,1,545,1416,17,428,1210,15,32.05882352941177,>30,BAN,Home,Upto 2014
Tapash Baisya,BAN,Pace,2005-06-03,Chester-le-Street,England,2005,1,80,90,0,1,697,946,22,617,856,22,31.681818181818183,>30,ENG,Away,Upto 2014
Tareq Aziz,BAN,Pace,2004-05-28,Gros Islet,West Indies,2004,2,126,174,0,1,821,1459,16,695,1285,16,51.3125,>30,WI,Away,Upto 2014
Tareq Aziz,BAN,Pace,2004-06-04,Kingston,West Indies,2004,1,76,114,1,1,592,1032,15,516,918,14,39.46666666666667,>30,WI,Away,Upto 2014
Tareq Aziz,BAN,Pace,2004-10-19,Dhaka,Bangladesh,2004,1,59,72,0,1,301,659,9,242,587,9,33.44444444444444,>30,BAN,Home,Upto 2014
Taskin Ahmed,BAN,Pace,2017-01-12,Wellington,New Zealand,2017,2,179,210,1,1,1047,1639,21,868,1429,20,49.857142857142854,>30,NZ,Away,After 1965
Taskin Ahmed,BAN,Pace,2017-01-20,Christchurch,New Zealand,2017,2,107,162,1,1,735,1238,24,628,1076,23,30.625,>30,NZ,Away,After 1965
Taskin Ahmed,BAN,Pace,2017-02-09,Hyderabad,India,2017,2,170,192,3,1,567,906,10,397,714,7,56.7,>30,IND,Away,After 1965
Taskin Ahmed,BAN,Pace,2017-03-07,Galle,Sri Lanka,2017,2,109,174,2,1,497,858,9,388,684,7,55.22222222222222,>30,SL,Away,After 1965
Taskin Ahmed,BAN,Pace,2017-09-28,Potchefstroom,South Africa,2017,2,117,192,0,1,634,1140,16,517,948,16,39.625,>30,SA,Away,After 1965
Taskin Ahmed,BAN,Pace,2021-04-21,Pallekele,Sri Lanka,2021,1,112,180,3,1,611,1140,12,499,960,9,50.916666666666664,>30,SL,Away,After 1965
Taskin Ahmed,BAN,Pace,2021-04-29,Pallekele,Sri Lanka,2021,2,153,230,5,1,391,680,8,238,450,3,48.875,>30,SL,Away,After 1965
Taskin Ahmed,BAN,Pace,2021-07-07,Harare,Zimbabwe,2021,2,128,288,5,1,697,1302,16,569,1014,11,43.5625,>30,ZIM,Away,After 1965
Taskin Ahmed,BAN,Pace,2022-01-01,Mount Maunganui,New Zealand,2022,2,113,240,3,1,752,1693,25,639,1453,22,30.08,>30,NZ,Away,After 1965
Taskin Ahmed,BAN,Pace,2022-01-09,Christchurch,New Zealand,2022,1,117,197,0,1,738,1267,23,621,1070,23,32.08695652173913,>30,NZ,Away,After 1965
Taskin Ahmed,BAN,Pace,2022-03-31,Durban,South Africa,2022,2,93,204,2,1,457,911,16,364,707,14,28.5625,<=30,SA,Away,After 1965
Taskin Ahmed,BAN,Pace,2022-12-22,Mirpur,Bangladesh,2022,2,62,96,1,1,319,582,11,257,486,10,29.0,<=30,BAN,Home,After 1965
Taskin Ahmed,BAN,Pace,2023-06-14,Mirpur,Bangladesh,2023,2,85,96,4,1,553,731,21,468,635,17,26.333333333333332,<=30,BAN,Home,After 1965
Taskin Ahmed,BAN,Pace,2024-08-30,Rawalpindi,Pakistan,2024,2,97,162,4,1,585,958,24,488,796,20,24.375,<=30,PAK,Away,After 1965
Taskin Ahmed,BAN,Pace,2024-09-19,Chennai,India,2024,2,77,168,4,1,481,825,20,404,657,16,24.05,<=30,IND,Away,After 1965
Taskin Ahmed,BAN,Pace,2024-11-22,North Sound,West Indies,2024,2,140,241,8,1,670,1327,30,530,1086,22,22.333333333333332,<=30,WI,Away,After 1965
Taskin Ahmed,BAN,Pace,2024-11-30,Kingston,West Indies,2024,2,65,144,3,1,598,1162,33,533,1018,30,18.12121212121212,<=30,WI,Away,After 1965
Taslim Arif,PAK,Pace,1980-03-18,Lahore,Pakistan,1980,1,28,30,1,1,489,1014,8,461,984,7,61.125,>30,PAK,Home,Upto 2014
Taufeeq Umar,PAK,Spin,2002-01-31,Sharjah,UAE,2002,1,6,12,0,1,403,857,9,397,845,9,44.77777777777778,>30,UAE,Away,Upto 2014
Taufeeq Umar,PAK,Spin,2002-10-03,Colombo (PSS),Sri Lanka,2002,2,11,24,0,1,409,724,19,398,700,19,21.526315789473685,<=30,SL,Away,Upto 2014
Taufeeq Umar,PAK,Spin,2002-10-19,Sharjah,UAE,2002,1,7,12,0,1,467,889,13,460,877,13,35.92307692307692,>30,UAE,Away,Upto 2014
Taufeeq Umar,PAK,Spin,2002-11-09,Harare,Zimbabwe,2002,1,0,6,0,1,290,546,9,290,540,9,32.22222222222222,>30,ZIM,Away,Upto 2014
Taufeeq Umar,PAK,Spin,2002-11-16,Bulawayo,Zimbabwe,2002,1,12,12,0,1,335,808,14,323,796,14,23.928571428571427,<=30,ZIM,Away,Upto 2014
Taufeeq Umar,PAK,Spin,2006-08-04,Leeds,England,2006,1,8,12,0,1,443,837,10,435,825,10,44.3,>30,ENG,Away,Upto 2014
Tauseef Ahmed,PAK,Spin,1980-02-27,Karachi,Pakistan,1980,2,126,386,7,1,432,1328,28,306,942,21,15.428571428571429,<=30,PAK,Home,Upto 2014
Tauseef Ahmed,PAK,Spin,1980-03-06,Faisalabad,Pakistan,1980,1,77,198,3,1,592,1272,6,515,1074,3,98.66666666666667,>30,PAK,Home,Upto 2014
Tauseef Ahmed,PAK,Spin,1980-03-18,Lahore,Pakistan,1980,2,153,282,2,1,686,1374,15,533,1092,13,45.733333333333334,>30,PAK,Home,Upto 2014
Tauseef Ahmed,PAK,Spin,1982-03-05,Karachi,Pakistan,1982,2,103,202,3,1,669,1411,22,566,1209,19,30.40909090909091,>30,PAK,Home,Upto 2014
Tauseef Ahmed,PAK,Spin,1982-03-14,Faisalabad,Pakistan,1982,2,53,156,3,1,699,1740,27,646,1584,24,25.88888888888889,<=30,PAK,Home,Upto 2014
Tauseef Ahmed,PAK,Spin,1982-03-22,Lahore,Pakistan,1982,2,108,222,5,1,386,750,7,278,528,2,55.142857142857146,>30,PAK,Home,Upto 2014
Tauseef Ahmed,PAK,Spin,1984-03-02,Karachi,Pakistan,1984,2,70,270,4,1,352,1095,26,282,825,22,13.538461538461538,<=30,PAK,Home,Upto 2014
Tauseef Ahmed,PAK,Spin,1984-03-12,Faisalabad,Pakistan,1984,1,96,180,1,1,537,1272,7,441,1092,6,76.71428571428571,>30,PAK,Home,Upto 2014
Tauseef Ahmed,PAK,Spin,1984-10-17,Lahore,Pakistan,1984,2,112,378,1,1,362,1073,9,250,695,8,40.22222222222222,>30,PAK,Home,Upto 2014
Tauseef Ahmed,PAK,Spin,1984-11-16,Lahore,Pakistan,1984,2,26,36,0,1,445,1036,19,419,1000,19,23.42105263157895,<=30,PAK,Home,Upto 2014
Tauseef Ahmed,PAK,Spin,1985-11-07,Karachi,Pakistan,1985,2,104,272,6,1,327,706,13,223,434,7,25.153846153846153,<=30,PAK,Home,Upto 2014
Tauseef Ahmed,PAK,Spin,1986-02-23,Kandy,Sri Lanka,1986,2,77,168,9,1,188,445,14,111,277,5,13.428571428571429,<=30,SL,Away,Upto 2014
Tauseef Ahmed,PAK,Spin,1986-03-14,Colombo (CCC),Sri Lanka,1986,1,40,66,0,1,54,96,0,14,30,0,inf,>30,SL,Away,Upto 2014
Tauseef Ahmed,PAK,Spin,1986-10-24,Faisalabad,Pakistan,1986,1,50,132,2,1,160,446,11,110,314,9,14.545454545454545,<=30,PAK,Home,Upto 2014
Tauseef Ahmed,PAK,Spin,1986-11-07,Lahore,Pakistan,1986,1,27,114,1,1,133,342,6,106,228,5,22.166666666666668,<=30,PAK,Home,Upto 2014
Tauseef Ahmed,PAK,Spin,1986-11-20,Karachi,Pakistan,1986,2,63,174,2,1,383,1055,15,320,881,13,25.533333333333335,<=30,PAK,Home,Upto 2014
Tauseef Ahmed,PAK,Spin,1987-02-03,Chennai,India,1987,1,189,402,3,1,827,1860,14,638,1458,11,59.07142857142857,>30,IND,Away,Upto 2014
Tauseef Ahmed,PAK,Spin,1987-02-11,Eden Gardens,India,1987,2,89,168,1,1,258,750,5,169,582,4,51.6,>30,IND,Away,Upto 2014
Tauseef Ahmed,PAK,Spin,1987-02-21,Jaipur,India,1987,2,144,306,3,1,591,1283,13,447,977,10,45.46153846153846,>30,IND,Away,Upto 2014
Tauseef Ahmed,PAK,Spin,1987-03-13,Bengaluru,India,1987,2,139,437,9,1,527,1530,35,388,1093,26,15.057142857142857,<=30,IND,Away,Upto 2014
Tauseef Ahmed,PAK,Spin,1987-06-04,Manchester,England,1987,1,52,130,2,1,82,268,3,30,138,1,27.333333333333332,<=30,ENG,Away,Upto 2014
Tauseef Ahmed,PAK,Spin,1987-08-06,The Oval,England,1987,2,151,417,3,1,612,1585,13,461,1168,10,47.07692307692308,>30,ENG,Away,Upto 2014
Tauseef Ahmed,PAK,Spin,1987-11-25,Lahore,Pakistan,1987,2,66,260,4,1,424,1316,26,358,1056,22,16.307692307692307,<=30,PAK,Home,Upto 2014
Tauseef Ahmed,PAK,Spin,1987-12-07,Faisalabad,Pakistan,1987,1,62,168,1,1,479,1253,22,417,1085,21,21.772727272727273,<=30,PAK,Home,Upto 2014
Tauseef Ahmed,PAK,Spin,1988-09-15,Karachi,Pakistan,1988,2,44,286,3,1,427,1461,22,383,1175,19,19.40909090909091,<=30,PAK,Home,Upto 2014
Tauseef Ahmed,PAK,Spin,1988-09-23,Faisalabad,Pakistan,1988,2,90,276,4,1,520,1112,15,430,836,11,34.666666666666664,>30,PAK,Home,Upto 2014
Tauseef Ahmed,PAK,Spin,1988-10-07,Lahore,Pakistan,1988,2,133,402,4,1,510,1394,19,377,992,15,26.842105263157894,<=30,PAK,Home,Upto 2014
Tauseef Ahmed,PAK,Spin,1989-02-24,Auckland,New Zealand,1989,2,129,486,1,1,705,1609,10,576,1123,9,70.5,>30,NZ,Away,Upto 2014
Tauseef Ahmed,PAK,Spin,1990-01-12,Melbourne,Australia,1990,2,83,144,1,1,153,318,3,70,174,2,51.0,>30,AUS,Away,Upto 2014
Tauseef Ahmed,PAK,Spin,1990-01-19,Adelaide,Australia,1990,2,113,276,3,1,427,941,7,314,665,4,61.0,>30,AUS,Away,Upto 2014
Tauseef Ahmed,PAK,Spin,1990-02-03,Sydney,Australia,1990,1,62,114,1,1,105,210,1,43,96,0,105.0,>30,AUS,Away,Upto 2014
Tauseef Ahmed,PAK,Spin,1990-10-10,Karachi,Pakistan,1990,2,20,36,0,1,202,384,2,182,348,2,101.0,>30,PAK,Home,Upto 2014
Tauseef Ahmed,PAK,Spin,1990-10-26,Faisalabad,Pakistan,1990,1,37,60,1,1,81,132,1,44,72,0,81.0,>30,PAK,Home,Upto 2014
Tauseef Ahmed,PAK,Spin,1993-12-01,Karachi,Pakistan,1993,2,62,174,0,1,291,834,6,229,660,6,48.5,>30,PAK,Home,Upto 2014
Tushar Imran,BAN,Spin,2007-07-11,Kandy,Sri Lanka,2007,1,48,60,0,1,353,551,12,305,491,12,29.416666666666668,<=30,SL,Away,Upto 2014
U Afzaal,ENG,Spin,2001-08-23,The Oval,England,2001,1,49,54,1,1,630,1004,15,581,950,14,42.0,>30,ENG,Home,Upto 2014
U Ranchod,ZIM,Spin,1993-03-13,Delhi,India,1993,1,45,72,1,1,645,1548,21,600,1476,20,30.714285714285715,>30,IND,Away,Upto 2014
UC Hathurusingha,SL,Pace,1991-02-22,Hamilton,New Zealand,1991,1,15,12,0,1,916,2000,25,901,1988,25,36.64,>30,NZ,Away,Upto 2014
UC Hathurusingha,SL,Pace,1991-08-22,Lord's,England,1991,1,40,102,1,1,770,1537,23,730,1435,22,33.47826086956522,>30,ENG,Away,Upto 2014
UC Hathurusingha,SL,Pace,1991-12-12,Sialkot,Pakistan,1991,1,3,6,0,1,611,1329,14,608,1323,14,43.642857142857146,>30,PAK,Away,Upto 2014
UC Hathurusingha,SL,Pace,1991-12-20,Gujranwala,Pakistan,1991,1,6,12,0,1,97,210,2,91,198,2,48.5,>30,PAK,Away,Upto 2014
UC Hathurusingha,SL,Pace,1992-01-02,Faisalabad,Pakistan,1992,1,4,12,0,1,743,1706,36,739,1694,36,20.63888888888889,<=30,PAK,Away,Upto 2014
UC Hathurusingha,SL,Pace,1992-08-17,Colombo (SSC),Sri Lanka,1992,2,145,294,5,1,793,1548,19,648,1254,14,41.73684210526316,>30,SL,Home,Upto 2014
UC Hathurusingha,SL,Pace,1992-08-28,Colombo (RPS),Sri Lanka,1992,2,38,126,2,1,531,1227,20,493,1101,18,26.55,<=30,SL,Home,Upto 2014
UC Hathurusingha,SL,Pace,1992-09-08,Moratuwa,Sri Lanka,1992,2,53,150,1,1,511,1044,22,458,894,21,23.227272727272727,<=30,SL,Home,Upto 2014
UC Hathurusingha,SL,Pace,1992-11-27,Moratuwa,Sri Lanka,1992,2,34,108,1,1,602,1223,13,568,1115,12,46.30769230769231,>30,SL,Home,Upto 2014
UC Hathurusingha,SL,Pace,1992-12-06,Colombo (SSC),Sri Lanka,1992,2,16,60,0,1,402,864,12,386,804,12,33.5,>30,SL,Home,Upto 2014
UC Hathurusingha,SL,Pace,1993-03-13,Colombo (SSC),Sri Lanka,1993,1,22,48,0,1,382,857,11,360,809,11,34.72727272727273,>30,SL,Home,Upto 2014
UC Hathurusingha,SL,Pace,1993-07-27,Colombo (SSC),Sri Lanka,1993,2,83,174,2,1,627,1409,18,544,1235,16,34.833333333333336,>30,SL,Home,Upto 2014
UC Hathurusingha,SL,Pace,1993-08-04,Colombo (PSS),Sri Lanka,1993,1,53,120,1,1,384,1057,10,331,937,9,38.4,>30,SL,Home,Upto 2014
UC Hathurusingha,SL,Pace,1993-08-25,Moratuwa,Sri Lanka,1993,2,23,78,2,1,501,1154,19,478,1076,17,26.36842105263158,<=30,SL,Home,Upto 2014
UC Hathurusingha,SL,Pace,1993-09-06,Colombo (SSC),Sri Lanka,1993,1,12,42,0,1,464,972,21,452,930,21,22.095238095238095,<=30,SL,Home,Upto 2014
UC Hathurusingha,SL,Pace,1993-09-14,Colombo (PSS),Sri Lanka,1993,2,13,84,1,1,422,1175,13,409,1091,12,32.46153846153846,>30,SL,Home,Upto 2014
UC Hathurusingha,SL,Pace,1995-09-08,Peshawar,Pakistan,1995,1,29,108,0,1,562,1039,16,533,931,16,35.125,>30,PAK,Away,Upto 2014
UC Hathurusingha,SL,Pace,1995-09-15,Faisalabad,Pakistan,1995,1,10,36,0,1,465,1059,21,455,1023,21,22.142857142857142,<=30,PAK,Away,Upto 2014
UC Hathurusingha,SL,Pace,1995-12-08,W.A.C.A,Australia,1995,1,31,54,0,1,613,1126,16,582,1072,16,38.3125,>30,AUS,Away,Upto 2014
UC Hathurusingha,SL,Pace,1995-12-26,Melbourne,Australia,1995,1,23,54,0,1,608,1377,17,585,1323,17,35.76470588235294,>30,AUS,Away,Upto 2014
UC Hathurusingha,SL,Pace,1996-01-25,Adelaide,Australia,1996,1,15,24,0,1,886,1812,32,871,1788,32,27.6875,<=30,AUS,Away,Upto 2014
UC Hathurusingha,SL,Pace,1999-02-24,Colombo (SSC),Sri Lanka,1999,1,51,108,1,1,790,1434,9,739,1326,8,87.77777777777777,>30,SL,Home,Upto 2014
UC Hathurusingha,SL,Pace,1999-03-04,Lahore,Pakistan,1999,2,70,150,0,1,638,1047,15,568,897,15,42.53333333333333,>30,PAK,Away,Upto 2014
UDU Chandana,SL,Spin,1999-03-12,Dhaka,Bangladesh,1999,1,179,287,6,1,550,1176,20,371,889,14,27.5,<=30,BAN,Away,Upto 2014
UDU Chandana,SL,Spin,1999-09-09,Kandy,Sri Lanka,1999,2,48,62,1,1,373,779,20,325,717,19,18.65,<=30,SL,Home,Upto 2014
UDU Chandana,SL,Spin,2000-07-20,Galle,Sri Lanka,2000,2,134,258,4,1,705,1392,24,571,1134,20,29.375,<=30,SL,Home,Upto 2014
UDU Chandana,SL,Spin,2000-07-30,Kandy,Sri Lanka,2000,2,79,179,4,1,551,1139,19,472,960,15,29.0,<=30,SL,Home,Upto 2014
UDU Chandana,SL,Spin,2000-08-06,Colombo (SSC),Sri Lanka,2000,2,49,56,1,1,525,1357,18,476,1301,17,29.166666666666668,<=30,SL,Home,Upto 2014
UDU Chandana,SL,Spin,2002-01-12,Galle,Sri Lanka,2002,1,24,72,0,1,515,1423,24,491,1351,24,21.458333333333332,<=30,SL,Home,Upto 2014
UDU Chandana,SL,Spin,2002-07-28,Colombo (SSC),Sri Lanka,2002,2,36,90,2,1,450,838,15,414,748,13,30.0,<=30,SL,Home,Upto 2014
UDU Chandana,SL,Spin,2003-12-02,Galle,Sri Lanka,2003,2,48,144,0,1,603,1823,28,555,1679,28,21.535714285714285,<=30,SL,Home,Upto 2014
UDU Chandana,SL,Spin,2003-12-18,Colombo (SSC),Sri Lanka,2003,2,100,234,2,1,552,1368,13,452,1134,11,42.46153846153846,>30,SL,Home,Upto 2014
UDU Chandana,SL,Spin,2004-03-08,Galle,Sri Lanka,2004,2,161,231,2,1,953,1791,32,792,1560,30,29.78125,<=30,SL,Home,Upto 2014
UDU Chandana,SL,Spin,2004-07-01,Darwin,Australia,2004,2,60,102,2,1,223,419,7,163,317,5,31.857142857142858,>30,AUS,Away,Upto 2014
UDU Chandana,SL,Spin,2004-07-09,Cairns,Australia,2004,2,210,268,10,1,552,988,20,342,720,10,27.6,<=30,AUS,Away,Upto 2014
UDU Chandana,SL,Spin,2004-08-04,Galle,Sri Lanka,2004,2,128,216,1,1,688,1462,17,560,1246,16,40.470588235294116,>30,SL,Home,Upto 2014
UDU Chandana,SL,Spin,2004-08-11,Colombo (SSC),Sri Lanka,2004,2,47,78,0,1,470,988,13,423,910,13,36.15384615384615,>30,SL,Home,Upto 2014
UDU Chandana,SL,Spin,2005-04-04,Napier,New Zealand,2005,2,135,240,2,1,443,871,8,308,631,6,55.375,>30,NZ,Away,Upto 2014
UDU Chandana,SL,Spin,2005-04-11,Wellington,New Zealand,2005,1,97,168,0,1,233,396,0,136,228,0,inf,>30,NZ,Away,Upto 2014
UG Dowe,WI,Pace,1971-04-01,Bridgetown,West Indies,1971,2,91,204,5,1,478,1042,14,387,838,9,34.142857142857146,>30,WI,Home,Upto 2014
UG Dowe,WI,Pace,1971-04-13,Port of Spain,West Indies,1971,2,154,306,2,1,448,1056,11,294,750,9,40.72727272727273,>30,WI,Home,Upto 2014
UG Dowe,WI,Pace,1972-02-16,Kingston,West Indies,1972,2,121,252,4,1,643,1221,11,522,969,7,58.45454545454545,>30,WI,Home,Upto 2014
UG Dowe,WI,Pace,1973-02-16,Kingston,West Indies,1973,2,168,252,1,1,629,1295,15,461,1043,14,41.93333333333333,>30,WI,Home,Upto 2014
UN Kulkarni,IND,Pace,1967-12-23,Adelaide,Australia,1967,2,37,72,1,1,596,1119,26,559,1047,25,22.923076923076923,<=30,AUS,Away,Upto 2014
UN Kulkarni,IND,Pace,1968-01-19,Brisbane,Australia,1968,2,59,98,2,1,552,1226,17,493,1128,15,32.470588235294116,>30,AUS,Away,Upto 2014
UN Kulkarni,IND,Pace,1968-01-26,Sydney,Australia,1968,2,104,200,2,1,498,913,9,394,713,7,55.333333333333336,>30,AUS,Away,Upto 2014
UN Kulkarni,IND,Pace,1968-02-22,Christchurch,New Zealand,1968,1,38,78,0,1,471,977,17,433,899,17,27.705882352941178,<=30,NZ,Away,Upto 2014
UT Khawaja,AUS,Pace,2017-08-27,Mirpur,Bangladesh,2017,1,1,6,0,1,186,391,4,185,385,4,46.5,>30,BAN,Away,After 1965
UT Khawaja,AUS,Pace,2019-01-03,Sydney,Australia,2019,1,4,6,0,1,459,804,6,455,798,6,76.5,>30,AUS,Home,After 1965
UT Khawaja,AUS,Pace,2022-03-04,Rawalpindi,Pakistan,2022,1,3,6,0,1,479,990,4,476,984,4,119.75,>30,PAK,Away,After 1965
UT Yadav,IND,Pace,2011-11-06,Delhi,India,2011,2,88,156,2,1,494,839,13,406,683,11,38.0,>30,IND,Home,Upto 2014
UT Yadav,IND,Pace,2011-11-14,Eden Gardens,India,2011,2,103,147,7,1,531,767,14,428,620,7,37.92857142857143,>30,IND,Home,Upto 2014
UT Yadav,IND,Pace,2011-12-26,Melbourne,Australia,2011,2,176,276,7,1,739,1504,35,563,1228,28,21.114285714285714,<=30,AUS,Away,Upto 2014
UT Yadav,IND,Pace,2012-01-03,Sydney,Australia,2012,1,123,144,0,1,874,1376,22,751,1232,22,39.72727272727273,>30,AUS,Away,Upto 2014
UT Yadav,IND,Pace,2012-01-13,W.A.C.A,Australia,2012,1,93,102,5,1,668,1156,29,575,1054,24,23.03448275862069,<=30,AUS,Away,Upto 2014
UT Yadav,IND,Pace,2012-01-24,Adelaide,Australia,2012,2,159,186,2,1,749,1369,20,590,1183,18,37.45,>30,AUS,Away,Upto 2014
UT Yadav,IND,Pace,2012-08-23,Hyderabad,India,2012,2,56,108,2,1,403,771,7,347,663,5,57.57142857142857,>30,IND,Home,Upto 2014
UT Yadav,IND,Pace,2012-08-31,Bengaluru,India,2012,2,158,186,3,1,733,1159,18,575,973,15,40.72222222222222,>30,IND,Home,Upto 2014
UT Yadav,IND,Pace,2012-11-15,Ahmedabad,India,2012,2,84,180,4,1,421,867,8,337,687,4,52.625,>30,IND,Home,Upto 2014
UT Yadav,IND,Pace,2014-12-17,Brisbane,Australia,2014,2,147,204,5,1,959,1402,28,812,1198,23,34.25,>30,AUS,Away,After 1965
UT Yadav,IND,Pace,2014-12-26,Melbourne,Australia,2014,2,219,327,5,1,1069,1880,27,850,1553,22,39.592592592592595,>30,AUS,Away,After 1965
UT Yadav,IND,Pace,2015-01-06,Sydney,Australia,2015,2,182,180,1,1,942,1653,21,760,1473,20,44.857142857142854,>30,AUS,Away,After 1965
UT Yadav,IND,Pace,2015-06-10,Fatullah,Bangladesh,2015,2,49,54,0,1,199,300,1,150,246,1,199.0,>30,BAN,Away,After 1965
UT Yadav,IND,Pace,2015-08-20,Colombo (PSS),Sri Lanka,2015,2,85,156,2,1,525,996,16,440,840,14,32.8125,>30,SL,Away,After 1965
UT Yadav,IND,Pace,2015-08-28,Colombo (SSC),Sri Lanka,2015,2,129,168,3,1,606,1122,27,477,954,24,22.444444444444443,<=30,SL,Away,After 1965
UT Yadav,IND,Pace,2015-11-05,Mohali,India,2015,2,19,54,0,1,185,504,6,166,450,6,30.833333333333332,>30,IND,Home,After 1965
UT Yadav,IND,Pace,2015-12-03,Delhi,India,2015,2,41,198,5,1,288,947,15,247,749,10,19.2,<=30,IND,Home,After 1965
UT Yadav,IND,Pace,2016-07-21,North Sound,West Indies,2016,2,75,186,5,1,466,972,12,391,786,7,38.833333333333336,>30,WI,Away,After 1965
UT Yadav,IND,Pace,2016-07-30,Kingston,West Indies,2016,2,74,108,0,1,509,984,9,435,876,9,56.55555555555556,>30,WI,Away,After 1965
UT Yadav,IND,Pace,2016-09-22,Kanpur,India,2016,2,56,138,1,1,304,612,8,248,474,7,38.0,>30,IND,Home,After 1965
UT Yadav,IND,Pace,2016-10-08,Indore,India,2016,2,68,138,1,1,519,876,3,451,738,2,173.0,>30,IND,Home,After 1965
UT Yadav,IND,Pace,2016-11-09,Rajkot,India,2016,2,159,269,2,1,455,1020,7,296,751,5,65.0,>30,IND,Home,After 1965
UT Yadav,IND,Pace,2016-11-17,Visakhapatnam,India,2016,2,64,156,1,1,406,876,14,342,720,13,29.0,<=30,IND,Home,After 1965
UT Yadav,IND,Pace,2016-11-26,Mohali,India,2016,2,84,144,2,1,431,841,13,347,697,11,33.15384615384615,>30,IND,Home,After 1965
UT Yadav,IND,Pace,2016-12-08,Wankhede,India,2016,2,48,84,0,1,329,570,3,281,486,3,109.66666666666667,>30,IND,Home,After 1965
UT Yadav,IND,Pace,2016-12-16,Chennai,India,2016,2,109,210,3,1,437,846,9,328,636,6,48.55555555555556,>30,IND,Home,After 1965
UT Yadav,IND,Pace,2017-02-09,Hyderabad,India,2017,2,117,222,3,1,567,906,10,450,684,7,56.7,>30,IND,Home,After 1965
UT Yadav,IND,Pace,2017-02-23,Pune,India,2017,2,71,150,6,1,160,354,9,89,204,3,17.77777777777778,<=30,IND,Home,After 1965
UT Yadav,IND,Pace,2017-03-04,Bengaluru,India,2017,2,87,198,3,1,391,822,14,304,624,11,27.928571428571427,<=30,IND,Home,After 1965
UT Yadav,IND,Pace,2017-03-16,Ranchi,India,2017,2,142,276,3,1,451,960,9,309,684,6,50.111111111111114,>30,IND,Home,After 1965
UT Yadav,IND,Pace,2017-03-25,Dharamsala,India,2017,2,98,150,5,1,367,681,12,269,531,7,30.583333333333332,>30,IND,Home,After 1965
UT Yadav,IND,Pace,2017-07-26,Galle,Sri Lanka,2017,2,120,138,2,1,627,805,16,507,667,14,39.1875,>30,SL,Away,After 1965
UT Yadav,IND,Pace,2017-08-03,Colombo (SSC),Sri Lanka,2017,2,51,108,2,1,216,460,7,165,352,5,30.857142857142858,>30,SL,Away,After 1965
UT Yadav,IND,Pace,2017-08-12,Pallekele,Sri Lanka,2017,2,44,97,2,1,344,606,10,300,509,8,34.4,>30,SL,Away,After 1965
UT Yadav,IND,Pace,2017-11-16,Eden Gardens,India,2017,2,104,150,3,1,743,1322,32,639,1172,29,23.21875,<=30,IND,Home,After 1965
UT Yadav,IND,Pace,2017-11-24,Nagpur,India,2017,2,73,150,2,1,472,859,9,399,709,7,52.44444444444444,>30,IND,Home,After 1965
UT Yadav,IND,Pace,2018-06-14,Bengaluru,India,2018,2,44,78,4,1,280,456,13,236,378,9,21.53846153846154,<=30,IND,Home,After 1965
UT Yadav,IND,Pace,2018-08-01,Birmingham,England,2018,2,76,144,3,1,700,1284,29,624,1140,26,24.137931034482758,<=30,ENG,Away,After 1965
UT Yadav,IND,Pace,2018-10-04,Rajkot,India,2018,2,36,84,1,1,307,492,6,271,408,5,51.166666666666664,>30,IND,Home,After 1965
UT Yadav,IND,Pace,2018-10-12,Hyderabad,India,2018,2,133,233,10,1,322,529,18,189,296,8,17.88888888888889,<=30,IND,Home,After 1965
UT Yadav,IND,Pace,2018-12-14,Perth,Australia,2018,2,139,222,2,1,753,1685,30,614,1463,28,25.1,<=30,AUS,Away,After 1965
UT Yadav,IND,Pace,2019-10-10,Pune,India,2019,2,59,126,6,1,453,864,13,394,738,7,34.84615384615385,>30,IND,Home,After 1965
UT Yadav,IND,Pace,2019-10-19,Ranchi,India,2019,2,75,108,5,1,354,633,14,279,525,9,25.285714285714285,<=30,IND,Home,After 1965
UT Yadav,IND,Pace,2019-11-14,Indore,India,2019,2,98,171,4,1,430,819,19,332,648,15,22.63157894736842,<=30,IND,Home,After 1965
UT Yadav,IND,Pace,2019-11-22,Eden Gardens,India,2019,2,82,127,8,1,491,776,27,409,649,19,18.185185185185187,<=30,IND,Home,After 1965
UT Yadav,IND,Pace,2020-02-29,Christchurch,New Zealand,2020,2,91,192,2,1,623,1219,30,532,1027,28,20.766666666666666,<=30,NZ,Away,After 1965
UT Yadav,IND,Pace,2020-12-17,Adelaide,Australia,2020,2,89,145,3,1,408,970,22,319,825,19,18.545454545454547,<=30,AUS,Away,After 1965
UT Yadav,IND,Pace,2020-12-26,Melbourne,Australia,2020,2,44,93,1,1,523,1170,20,479,1077,19,26.15,<=30,AUS,Away,After 1965
UT Yadav,IND,Pace,2021-09-02,The Oval,England,2021,2,136,224,6,1,900,1837,30,764,1613,24,30.0,<=30,ENG,Away,After 1965
UT Yadav,IND,Pace,2021-11-25,Kanpur,India,2021,2,84,180,2,1,414,852,16,330,672,14,25.875,<=30,IND,Home,After 1965
UT Yadav,IND,Pace,2021-12-03,Wankhede,India,2021,2,26,60,0,1,192,474,3,166,414,3,64.0,>30,IND,Home,After 1965
UT Yadav,IND,Pace,2022-01-11,Cape Town,South Africa,2022,2,100,150,2,1,686,1515,32,586,1365,30,21.4375,<=30,SA,Away,After 1965
UT Yadav,IND,Pace,2022-12-14,Chattogram,Bangladesh,2022,2,60,138,2,1,311,654,9,251,516,7,34.55555555555556,>30,BAN,Away,After 1965
UT Yadav,IND,Pace,2022-12-22,Mirpur,Bangladesh,2022,2,57,144,5,1,319,582,11,262,438,6,29.0,<=30,BAN,Away,After 1965
UT Yadav,IND,Pace,2023-03-01,Indore,India,2023,2,22,42,3,1,84,162,4,62,120,1,21.0,<=30,IND,Home,After 1965
UT Yadav,IND,Pace,2023-03-09,Ahmedabad,India,2023,2,126,180,0,1,466,654,3,340,474,3,155.33333333333334,>30,IND,Home,After 1965
UT Yadav,IND,Pace,2023-06-07,The Oval,England,2023,2,131,240,2,1,1032,1672,28,901,1432,26,36.857142857142854,>30,ENG,Away,After 1965
UWMBCA Welegedara,SL,Pace,2007-12-18,Galle,Sri Lanka,2007,2,76,132,4,1,606,1192,16,530,1060,12,37.875,>30,SL,Home,Upto 2014
UWMBCA Welegedara,SL,Pace,2009-11-16,Ahmedabad,India,2009,2,163,258,5,1,648,1044,12,485,786,7,54.0,>30,IND,Away,Upto 2014
UWMBCA Welegedara,SL,Pace,2009-11-24,Kanpur,India,2009,1,103,156,0,1,388,624,8,285,468,8,48.5,>30,IND,Away,Upto 2014
UWMBCA Welegedara,SL,Pace,2009-12-02,Brabourne,India,2009,1,131,180,1,1,532,750,10,401,570,9,53.2,>30,IND,Away,Upto 2014
UWMBCA Welegedara,SL,Pace,2010-07-18,Galle,Sri Lanka,2010,2,112,126,2,1,560,768,16,448,642,14,35.0,>30,SL,Home,Upto 2014
UWMBCA Welegedara,SL,Pace,2010-08-03,Colombo (PSS),Sri Lanka,2010,2,122,141,0,1,534,849,8,412,708,8,66.75,>30,SL,Home,Upto 2014
UWMBCA Welegedara,SL,Pace,2011-06-03,Lord's,England,2011,2,172,228,5,1,1032,1597,21,860,1369,16,49.142857142857146,>30,ENG,Away,Upto 2014
UWMBCA Welegedara,SL,Pace,2011-06-16,Southampton,England,2011,1,90,144,2,1,719,1308,21,629,1164,19,34.23809523809524,>30,ENG,Away,Upto 2014
UWMBCA Welegedara,SL,Pace,2011-08-31,Galle,Sri Lanka,2011,2,74,126,3,1,381,906,20,307,780,17,19.05,<=30,SL,Home,Upto 2014
UWMBCA Welegedara,SL,Pace,2011-09-08,Pallekele,Sri Lanka,2011,1,74,138,1,1,526,1180,17,452,1042,16,30.941176470588236,>30,SL,Home,Upto 2014
UWMBCA Welegedara,SL,Pace,2011-09-16,Colombo (SSC),Sri Lanka,2011,2,163,270,4,1,825,1634,20,662,1364,16,41.25,>30,SL,Home,Upto 2014
UWMBCA Welegedara,SL,Pace,2011-10-18,Abu Dhabi,UAE,2011,2,89,210,3,1,689,1303,17,600,1093,14,40.529411764705884,>30,UAE,Away,Upto 2014
UWMBCA Welegedara,SL,Pace,2011-10-26,Dubai (DICS),UAE,2011,2,80,186,2,1,473,936,12,393,750,10,39.416666666666664,>30,UAE,Away,Upto 2014
UWMBCA Welegedara,SL,Pace,2011-11-03,Sharjah,UAE,2011,2,106,266,6,1,418,917,14,312,651,8,29.857142857142858,<=30,UAE,Away,Upto 2014
UWMBCA Welegedara,SL,Pace,2011-12-15,Centurion,South Africa,2011,1,96,186,3,1,635,1013,25,539,827,22,25.4,<=30,SA,Away,Upto 2014
UWMBCA Welegedara,SL,Pace,2011-12-26,Durban,South Africa,2011,2,85,196,5,1,674,1304,26,589,1108,21,25.923076923076923,<=30,SA,Away,Upto 2014
UWMBCA Welegedara,SL,Pace,2012-01-03,Cape Town,South Africa,2012,1,107,174,1,1,828,1318,18,721,1144,17,46.0,>30,SA,Away,Upto 2014
UWMBCA Welegedara,SL,Pace,2012-03-26,Galle,Sri Lanka,2012,2,86,144,1,1,355,636,9,269,492,8,39.44444444444444,>30,SL,Home,Upto 2014
UWMBCA Welegedara,SL,Pace,2012-12-14,Hobart,Australia,2012,2,219,288,6,1,927,1883,26,708,1595,20,35.65384615384615,>30,AUS,Away,Upto 2014
UWMBCA Welegedara,SL,Pace,2012-12-26,Melbourne,Australia,2012,1,38,88,0,1,518,864,21,480,776,21,24.666666666666668,<=30,AUS,Away,Upto 2014
UWMBCA Welegedara,SL,Pace,2014-08-14,Colombo (SSC),Sri Lanka,2014,2,87,162,1,1,441,792,14,354,630,13,31.5,>30,SL,Home,After 1965
Umar Amin,PAK,Pace,2010-07-21,Leeds,England,2010,2,19,48,2,1,714,1273,33,695,1225,31,21.636363636363637,<=30,ENG,Away,Upto 2014
Umar Amin,PAK,Pace,2010-07-29,Nottingham,England,2010,2,16,36,0,1,558,1225,33,542,1189,33,16.90909090909091,<=30,ENG,Away,Upto 2014
Umar Amin,PAK,Pace,2010-08-06,Birmingham,England,2010,1,28,48,1,1,468,1160,20,440,1112,19,23.4,<=30,ENG,Away,Upto 2014
Umar Gul,PAK,Pace,2003-08-20,Karachi,Pakistan,2003,2,148,234,2,1,660,1252,19,512,1018,17,34.73684210526316,>30,PAK,Home,Upto 2014
Umar Gul,PAK,Pace,2003-08-27,Peshawar,Pakistan,2003,2,83,191,5,1,501,1075,20,418,884,15,25.05,<=30,PAK,Home,Upto 2014
Umar Gul,PAK,Pace,2003-09-03,Multan,Pakistan,2003,2,144,282,8,1,593,1160,25,449,878,17,23.72,<=30,PAK,Home,Upto 2014
Umar Gul,PAK,Pace,2003-12-19,Hamilton,New Zealand,2003,2,143,235,4,1,863,1591,23,720,1356,19,37.52173913043478,>30,NZ,Away,Upto 2014
Umar Gul,PAK,Pace,2004-04-05,Lahore,Pakistan,2004,2,96,150,6,1,744,1284,22,648,1134,16,33.81818181818182,>30,PAK,Home,Upto 2014
Umar Gul,PAK,Pace,2006-03-26,Colombo (SSC),Sri Lanka,2006,2,114,192,2,1,568,1044,16,454,852,14,35.5,>30,SL,Away,Upto 2014
Umar Gul,PAK,Pace,2006-04-03,Kandy,Sri Lanka,2006,2,98,156,0,1,524,943,20,426,787,20,26.2,<=30,SL,Away,Upto 2014
Umar Gul,PAK,Pace,2006-07-13,Lord's,England,2006,2,203,312,3,1,919,1514,18,716,1202,15,51.05555555555556,>30,ENG,Away,Upto 2014
Umar Gul,PAK,Pace,2006-07-27,Manchester,England,2006,1,96,168,3,1,487,865,18,391,697,15,27.055555555555557,<=30,ENG,Away,Upto 2014
Umar Gul,PAK,Pace,2006-08-04,Leeds,England,2006,2,199,294,7,1,1053,1569,26,854,1275,19,40.5,>30,ENG,Away,Upto 2014
Umar Gul,PAK,Pace,2006-08-17,The Oval,England,2006,2,116,176,5,1,700,1093,21,584,917,16,33.333333333333336,>30,ENG,Away,Upto 2014
Umar Gul,PAK,Pace,2006-11-11,Lahore,Pakistan,2006,2,164,265,9,1,669,1208,21,505,943,12,31.857142857142858,>30,PAK,Home,Upto 2014
Umar Gul,PAK,Pace,2006-11-19,Multan,Pakistan,2006,1,96,228,1,1,741,1564,16,645,1336,15,46.3125,>30,PAK,Home,Upto 2014
Umar Gul,PAK,Pace,2006-11-27,Karachi,Pakistan,2006,2,168,258,6,1,841,1655,23,673,1397,17,36.56521739130435,>30,PAK,Home,Upto 2014
Umar Gul,PAK,Pace,2007-10-01,Karachi,Pakistan,2007,2,95,201,2,1,523,1031,16,428,830,14,32.6875,>30,PAK,Home,Upto 2014
Umar Gul,PAK,Pace,2007-10-08,Lahore,Pakistan,2007,2,151,270,4,1,635,1158,14,484,888,10,45.357142857142854,>30,PAK,Home,Upto 2014
Umar Gul,PAK,Pace,2009-02-21,Karachi,Pakistan,2009,2,133,198,3,1,650,1043,7,517,845,4,92.85714285714286,>30,PAK,Home,Upto 2014
Umar Gul,PAK,Pace,2009-03-01,Lahore,Pakistan,2009,1,135,222,6,1,395,504,8,260,282,2,49.375,>30,PAK,Home,Upto 2014
Umar Gul,PAK,Pace,2009-07-04,Galle,Sri Lanka,2009,2,107,144,2,1,560,942,21,453,798,19,26.666666666666668,<=30,SL,Away,Upto 2014
Umar Gul,PAK,Pace,2009-07-12,Colombo (PSS),Sri Lanka,2009,2,81,144,4,1,365,700,17,284,556,13,21.470588235294116,<=30,SL,Away,Upto 2014
Umar Gul,PAK,Pace,2009-07-20,Colombo (SSC),Sri Lanka,2009,2,120,132,1,1,669,1180,14,549,1048,13,47.785714285714285,>30,SL,Away,Upto 2014
Umar Gul,PAK,Pace,2009-11-24,Dunedin,New Zealand,2009,2,170,300,5,1,862,1655,33,692,1355,28,26.12121212121212,<=30,NZ,Away,Upto 2014
Umar Gul,PAK,Pace,2009-12-03,Wellington,New Zealand,2009,2,62,108,2,1,635,1257,30,573,1149,28,21.166666666666668,<=30,NZ,Away,Upto 2014
Umar Gul,PAK,Pace,2009-12-11,Napier,New Zealand,2009,2,138,216,1,1,858,1683,18,720,1467,17,47.666666666666664,>30,NZ,Away,Upto 2014
Umar Gul,PAK,Pace,2010-01-03,Sydney,Australia,2010,2,121,230,4,1,640,1344,29,519,1114,25,22.06896551724138,<=30,AUS,Away,Upto 2014
Umar Gul,PAK,Pace,2010-01-14,Hobart,Australia,2010,2,143,210,1,1,758,1508,15,615,1298,14,50.53333333333333,>30,AUS,Away,Upto 2014
Umar Gul,PAK,Pace,2010-07-13,Lord's,England,2010,2,93,228,5,1,698,1252,26,605,1024,21,26.846153846153847,<=30,ENG,Away,Upto 2014
Umar Gul,PAK,Pace,2010-07-21,Leeds,England,2010,2,96,147,3,1,714,1273,33,618,1126,30,21.636363636363637,<=30,ENG,Away,Upto 2014
Umar Gul,PAK,Pace,2010-07-29,Nottingham,England,2010,2,102,199,4,1,558,1225,33,456,1026,29,16.90909090909091,<=30,ENG,Away,Upto 2014
Umar Gul,PAK,Pace,2010-08-06,Birmingham,England,2010,1,24,54,0,1,468,1160,20,444,1106,20,23.4,<=30,ENG,Away,Upto 2014
Umar Gul,PAK,Pace,2010-11-12,Dubai (DICS),UAE,2010,2,173,288,3,1,500,966,12,327,678,9,41.666666666666664,>30,UAE,Away,Upto 2014
Umar Gul,PAK,Pace,2010-11-20,Abu Dhabi,UAE,2010,2,169,258,1,1,798,1290,13,629,1032,12,61.38461538461539,>30,UAE,Away,Upto 2014
Umar Gul,PAK,Pace,2011-01-07,Hamilton,New Zealand,2011,2,112,195,5,1,564,1033,21,452,838,16,26.857142857142858,<=30,NZ,Away,Upto 2014
Umar Gul,PAK,Pace,2011-01-15,Wellington,New Zealand,2011,2,148,317,8,1,781,1511,23,633,1194,15,33.95652173913044,>30,NZ,Away,Upto 2014
Umar Gul,PAK,Pace,2011-05-12,Providence,West Indies,2011,2,61,126,0,1,310,796,18,249,670,18,17.22222222222222,<=30,WI,Away,Upto 2014
Umar Gul,PAK,Pace,2011-10-18,Abu Dhabi,UAE,2011,2,101,216,6,1,689,1303,17,588,1087,11,40.529411764705884,>30,UAE,Away,Upto 2014
Umar Gul,PAK,Pace,2011-10-26,Dubai (DICS),UAE,2011,2,117,204,3,1,473,936,12,356,732,9,39.416666666666664,>30,UAE,Away,Upto 2014
Umar Gul,PAK,Pace,2011-11-03,Sharjah,UAE,2011,2,120,267,5,1,418,917,14,298,650,9,29.857142857142858,<=30,UAE,Away,Upto 2014
Umar Gul,PAK,Pace,2011-12-09,Chattogram,Bangladesh,2011,2,78,156,2,1,250,417,6,172,261,4,41.666666666666664,>30,BAN,Away,Upto 2014
Umar Gul,PAK,Pace,2011-12-17,Mirpur,Bangladesh,2011,2,136,246,5,1,436,810,14,300,564,9,31.142857142857142,>30,BAN,Away,Upto 2014
Umar Gul,PAK,Pace,2012-01-17,Dubai (DICS),UAE,2012,2,98,186,4,1,389,864,11,291,678,7,35.36363636363637,>30,UAE,Away,Upto 2014
Umar Gul,PAK,Pace,2012-01-25,Abu Dhabi,UAE,2012,2,58,96,1,1,271,622,9,213,526,8,30.11111111111111,>30,UAE,Away,Upto 2014
Umar Gul,PAK,Pace,2012-02-03,Dubai (DICS),UAE,2012,2,89,162,6,1,298,715,15,209,553,9,19.866666666666667,<=30,UAE,Away,Upto 2014
Umar Gul,PAK,Pace,2012-06-22,Galle,Sri Lanka,2012,2,87,186,0,1,350,768,9,263,582,9,38.888888888888886,>30,SL,Away,Upto 2014
Umar Gul,PAK,Pace,2012-07-08,Pallekele,Sri Lanka,2012,2,133,186,1,1,780,1418,19,647,1232,18,41.05263157894737,>30,SL,Away,Upto 2014
Umar Gul,PAK,Pace,2013-02-01,Johannesburg,South Africa,2013,2,114,198,4,1,592,1253,26,478,1055,22,22.76923076923077,<=30,SA,Away,Upto 2014
Umar Gul,PAK,Pace,2013-02-14,Cape Town,South Africa,2013,2,120,168,1,1,620,1269,20,500,1101,19,31.0,>30,SA,Away,Upto 2014
Usman Shinwari,PAK,Pace,2019-12-11,Rawalpindi,Pakistan,2019,1,54,90,1,1,376,750,8,322,660,7,47.0,>30,PAK,Home,After 1965
V Kohli,IND,Pace,2011-11-22,Wankhede,India,2011,1,9,12,0,1,622,1054,14,613,1042,14,44.42857142857143,>30,IND,Home,Upto 2014
V Kohli,IND,Pace,2012-01-03,Sydney,Australia,2012,1,23,48,0,1,874,1376,22,851,1328,22,39.72727272727273,>30,AUS,Away,Upto 2014
V Kohli,IND,Pace,2012-01-24,Adelaide,Australia,2012,1,3,6,0,1,749,1369,20,746,1363,20,37.45,>30,AUS,Away,Upto 2014
V Kohli,IND,Pace,2013-12-18,Johannesburg,South Africa,2013,1,18,36,0,1,1012,2037,30,994,2001,30,33.733333333333334,>30,SA,Away,Upto 2014
V Kohli,IND,Pace,2014-02-06,Auckland,New Zealand,2014,1,4,6,0,1,873,1527,37,869,1521,37,23.594594594594593,<=30,NZ,Away,After 1965
V Kohli,IND,Pace,2014-02-14,Wellington,New Zealand,2014,1,13,36,0,1,1271,2109,30,1258,2073,30,42.36666666666667,>30,NZ,Away,After 1965
V Kohli,IND,Pace,2015-12-03,Delhi,India,2015,1,0,6,0,1,288,947,15,288,941,15,19.2,<=30,IND,Home,After 1965
V Kohli,IND,Pace,2017-11-16,Eden Gardens,India,2017,1,5,7,0,1,743,1322,32,738,1315,32,23.21875,<=30,IND,Home,After 1965
V Kohli,IND,Pace,2017-12-02,Delhi,India,2017,1,1,6,0,1,549,946,10,548,940,10,54.9,>30,IND,Home,After 1965
V Kohli,IND,Pace,2019-10-10,Pune,India,2019,1,4,6,0,1,453,864,13,449,858,13,34.84615384615385,>30,IND,Home,After 1965
V Kohli,IND,Pace,2020-02-29,Christchurch,New Zealand,2020,1,4,6,0,1,623,1219,30,619,1213,30,20.766666666666666,<=30,NZ,Away,After 1965
V Permaul,WI,Spin,2012-11-13,Mirpur,Bangladesh,2012,2,107,222,4,1,992,1679,19,885,1457,15,52.21052631578947,>30,BAN,Away,Upto 2014
V Permaul,WI,Spin,2012-11-21,Khulna,Bangladesh,2012,2,146,234,4,1,763,1327,11,617,1093,7,69.36363636363636,>30,BAN,Away,Upto 2014
V Permaul,WI,Spin,2013-11-06,Eden Gardens,India,2013,1,67,142,2,1,456,988,15,389,846,13,30.4,>30,IND,Away,Upto 2014
V Permaul,WI,Spin,2013-12-19,Hamilton,New Zealand,2013,2,132,252,2,1,359,765,9,227,513,7,39.888888888888886,>30,NZ,Away,Upto 2014
V Permaul,WI,Spin,2015-05-01,Bridgetown,West Indies,2015,2,129,186,4,1,352,610,8,223,424,4,44.0,>30,WI,Home,After 1965
V Permaul,WI,Spin,2015-06-11,Kingston,West Indies,2015,2,207,335,2,1,355,671,7,148,336,5,50.714285714285715,>30,WI,Home,After 1965
V Permaul,WI,Spin,2021-11-29,Galle,Sri Lanka,2021,2,141,318,8,1,790,1806,36,649,1488,28,21.944444444444443,<=30,SL,Away,After 1965
V Permaul,WI,Spin,2022-03-08,North Sound,West Indies,2022,2,99,150,0,1,307,730,6,208,580,6,51.166666666666664,>30,WI,Home,After 1965
V Permaul,WI,Spin,2022-03-16,Bridgetown,West Indies,2022,2,155,275,5,1,465,1126,13,310,851,8,35.76923076923077,>30,WI,Home,After 1965
V Pollard,NZ,Spin,1965-02-27,Chennai,India,1965,2,122,288,4,1,616,1705,17,494,1417,13,36.23529411764706,>30,IND,Away,Upto 2014
V Pollard,NZ,Spin,1965-03-05,Eden Gardens,India,1965,1,50,90,0,1,632,1531,17,582,1441,17,37.1764705882353,>30,IND,Away,Upto 2014
V Pollard,NZ,Spin,1965-03-12,Brabourne,India,1965,2,99,186,1,1,545,1316,11,446,1130,10,49.54545454545455,>30,IND,Away,Upto 2014
V Pollard,NZ,Spin,1965-03-19,Delhi,India,1965,1,44,60,0,1,716,1840,21,672,1780,21,34.095238095238095,>30,IND,Away,Upto 2014
V Pollard,NZ,Spin,1965-03-27,Rawalpindi,Pakistan,1965,1,80,132,1,1,362,890,18,282,758,17,20.11111111111111,<=30,PAK,Away,Upto 2014
V Pollard,NZ,Spin,1965-04-02,Lahore,Pakistan,1965,2,117,366,2,1,697,1836,15,580,1470,13,46.46666666666667,>30,PAK,Away,Upto 2014
V Pollard,NZ,Spin,1965-04-09,Karachi,Pakistan,1965,2,93,270,2,1,606,1528,19,513,1258,17,31.894736842105264,>30,PAK,Away,Upto 2014
V Pollard,NZ,Spin,1965-05-27,Birmingham,England,1965,2,65,114,0,1,528,1355,15,463,1241,15,35.2,>30,ENG,Away,Upto 2014
V Pollard,NZ,Spin,1965-07-08,Leeds,England,1965,1,46,66,0,1,275,702,9,229,636,9,30.555555555555557,>30,ENG,Away,Upto 2014
V Pollard,NZ,Spin,1966-02-25,Christchurch,New Zealand,1966,1,27,30,1,1,245,648,5,218,618,4,49.0,>30,NZ,Home,Upto 2014
V Pollard,NZ,Spin,1966-03-04,Dunedin,New Zealand,1966,1,1,6,0,1,185,556,9,184,550,9,20.555555555555557,<=30,NZ,Home,Upto 2014
V Pollard,NZ,Spin,1966-03-11,Auckland,New Zealand,1966,2,33,114,3,1,300,776,10,267,662,7,30.0,<=30,NZ,Home,Upto 2014
V Pollard,NZ,Spin,1968-02-15,Dunedin,New Zealand,1968,2,85,174,0,1,642,1761,17,557,1587,17,37.76470588235294,>30,NZ,Home,Upto 2014
V Pollard,NZ,Spin,1968-02-22,Christchurch,New Zealand,1968,2,111,234,2,1,599,1533,16,488,1299,14,37.4375,>30,NZ,Home,Upto 2014
V Pollard,NZ,Spin,1968-02-29,Wellington,New Zealand,1968,2,69,156,0,1,408,1093,20,339,937,20,20.4,<=30,NZ,Home,Upto 2014
V Pollard,NZ,Spin,1968-03-07,Auckland,New Zealand,1968,2,51,174,2,1,303,1079,19,252,905,17,15.947368421052632,<=30,NZ,Home,Upto 2014
V Pollard,NZ,Spin,1969-02-27,Auckland,New Zealand,1969,2,90,256,3,1,637,1524,17,547,1268,14,37.470588235294116,>30,NZ,Home,Upto 2014
V Pollard,NZ,Spin,1969-03-07,Wellington,New Zealand,1969,1,19,16,0,1,243,621,7,224,605,7,34.714285714285715,>30,NZ,Home,Upto 2014
V Pollard,NZ,Spin,1969-03-13,Christchurch,New Zealand,1969,1,64,144,1,1,515,1459,16,451,1315,15,32.1875,>30,NZ,Home,Upto 2014
V Pollard,NZ,Spin,1969-07-24,Lord's,England,1969,2,51,102,2,1,319,1131,22,268,1029,20,14.5,<=30,ENG,Away,Upto 2014
V Pollard,NZ,Spin,1969-08-07,Nottingham,England,1969,1,26,60,0,1,236,642,5,210,582,5,47.2,>30,ENG,Away,Upto 2014
V Pollard,NZ,Spin,1969-08-21,The Oval,England,1969,2,36,60,0,1,310,1074,17,274,1014,17,18.235294117647058,<=30,ENG,Away,Upto 2014
V Pollard,NZ,Spin,1969-10-03,Nagpur,India,1969,2,57,187,5,1,677,1910,37,620,1723,32,18.2972972972973,<=30,IND,Away,Upto 2014
V Pollard,NZ,Spin,1969-10-24,Karachi,Pakistan,1969,2,84,276,0,1,665,1813,26,581,1537,26,25.576923076923077,<=30,PAK,Away,Upto 2014
V Pollard,NZ,Spin,1969-10-30,Lahore,Pakistan,1969,2,59,240,5,1,434,1339,23,375,1099,18,18.869565217391305,<=30,PAK,Away,Upto 2014
V Pollard,NZ,Spin,1969-11-08,Dhaka,Bangladesh,1969,2,58,90,2,1,498,1577,22,440,1487,20,22.636363636363637,<=30,BAN,Away,Upto 2014
V Pollard,NZ,Spin,1971-02-25,Christchurch,New Zealand,1971,2,54,96,0,1,395,1134,21,341,1038,21,18.80952380952381,<=30,NZ,Home,Upto 2014
V Pollard,NZ,Spin,1973-02-07,Dunedin,New Zealand,1973,1,64,104,0,1,480,1145,19,416,1041,19,25.263157894736842,<=30,NZ,Home,Upto 2014
V Pollard,NZ,Spin,1973-06-07,Nottingham,England,1973,1,24,54,2,1,224,617,9,200,563,7,24.88888888888889,<=30,ENG,Away,Upto 2014
V Pollard,NZ,Spin,1973-06-21,Lord's,England,1973,1,61,234,2,1,444,1278,9,383,1044,7,49.333333333333336,>30,ENG,Away,Upto 2014
V Pollard,NZ,Spin,1973-07-05,Leeds,England,1973,1,13,42,0,1,170,420,1,157,378,1,170.0,>30,ENG,Away,Upto 2014
V Razdan,IND,Pace,1989-11-23,Faisalabad,Pakistan,1989,1,62,78,0,1,850,1756,23,788,1678,23,36.95652173913044,>30,PAK,Away,Upto 2014
V Razdan,IND,Pace,1989-12-09,Sialkot,Pakistan,1989,1,79,162,5,1,741,1608,26,662,1446,21,28.5,<=30,PAK,Away,Upto 2014
V Sehwag,IND,Spin,2001-11-03,Bloemfontein,South Africa,2001,1,22,30,0,1,225,426,4,203,396,4,56.25,>30,SA,Away,Upto 2014
V Sehwag,IND,Spin,2001-12-11,Ahmedabad,India,2001,2,9,24,0,1,727,1868,25,718,1844,25,29.08,<=30,IND,Home,Upto 2014
V Sehwag,IND,Spin,2001-12-19,Bengaluru,India,2001,1,1,6,0,1,308,742,5,307,736,5,61.6,>30,IND,Home,Upto 2014
V Sehwag,IND,Spin,2002-02-28,Delhi,India,2002,1,6,6,0,1,467,1232,22,461,1226,22,21.227272727272727,<=30,IND,Home,Upto 2014
V Sehwag,IND,Spin,2002-07-25,Lord's,England,2002,2,42,72,1,1,509,942,14,467,870,13,36.357142857142854,>30,ENG,Away,Upto 2014
V Sehwag,IND,Spin,2002-08-08,Nottingham,England,2002,1,18,36,0,1,350,564,6,332,528,6,58.333333333333336,>30,ENG,Away,Upto 2014
V Sehwag,IND,Spin,2002-08-22,Leeds,England,2002,1,3,6,0,1,393,893,12,390,887,12,32.75,>30,ENG,Away,Upto 2014
V Sehwag,IND,Spin,2002-10-09,Wankhede,India,2002,1,7,12,0,1,416,1045,19,409,1033,19,21.894736842105264,<=30,IND,Home,Upto 2014
V Sehwag,IND,Spin,2002-10-17,Chennai,India,2002,2,17,18,0,1,464,965,17,447,947,17,27.294117647058822,<=30,IND,Home,Upto 2014
V Sehwag,IND,Spin,2002-10-30,Eden Gardens,India,2002,1,27,30,1,1,592,1269,12,565,1239,11,49.333333333333336,>30,IND,Home,Upto 2014
V Sehwag,IND,Spin,2003-10-08,Ahmedabad,India,2003,2,17,60,1,1,719,1566,18,702,1506,17,39.94444444444444,>30,IND,Home,Upto 2014
V Sehwag,IND,Spin,2003-10-16,Mohali,India,2003,1,22,33,0,1,664,1623,9,642,1590,9,73.77777777777777,>30,IND,Home,Upto 2014
V Sehwag,IND,Spin,2003-12-04,Brisbane,Australia,2003,1,21,30,0,1,333,445,5,312,415,5,66.6,>30,AUS,Away,Upto 2014
V Sehwag,IND,Spin,2003-12-12,Adelaide,Australia,2003,2,33,48,0,1,609,1006,16,576,958,16,38.0625,>30,AUS,Away,Upto 2014
V Sehwag,IND,Spin,2003-12-26,Melbourne,Australia,2003,1,7,18,0,1,455,739,13,448,721,13,35.0,>30,AUS,Away,Upto 2014
V Sehwag,IND,Spin,2004-01-02,Sydney,Australia,2004,1,10,12,0,1,831,1277,14,821,1265,14,59.357142857142854,>30,AUS,Away,Upto 2014
V Sehwag,IND,Spin,2004-03-28,Multan,Pakistan,2004,2,19,30,0,1,510,902,13,491,872,13,39.23076923076923,>30,PAK,Away,Upto 2014
V Sehwag,IND,Spin,2004-04-05,Lahore,Pakistan,2004,1,8,6,0,1,269,480,8,261,474,8,33.625,>30,PAK,Away,Upto 2014
V Sehwag,IND,Spin,2004-10-06,Bengaluru,India,2004,1,26,30,0,1,685,1243,20,659,1213,20,34.25,>30,IND,Home,Upto 2014
V Sehwag,IND,Spin,2004-10-14,Chennai,India,2004,2,13,18,0,1,557,1169,24,544,1151,24,23.208333333333332,<=30,IND,Home,Upto 2014
V Sehwag,IND,Spin,2004-10-26,Nagpur,India,2004,1,6,6,0,1,469,867,12,463,861,12,39.083333333333336,>30,IND,Home,Upto 2014
V Sehwag,IND,Spin,2005-03-08,Mohali,India,2005,2,14,30,0,1,471,904,13,457,874,13,36.23076923076923,>30,IND,Home,Upto 2014
V Sehwag,IND,Spin,2005-09-13,Bulawayo,Zimbabwe,2005,1,13,30,0,1,509,995,11,496,965,11,46.27272727272727,>30,ZIM,Away,Upto 2014
V Sehwag,IND,Spin,2005-12-18,Ahmedabad,India,2005,1,18,18,0,1,765,1419,29,747,1401,29,26.379310344827587,<=30,IND,Home,Upto 2014
V Sehwag,IND,Spin,2006-01-13,Lahore,Pakistan,2006,1,24,36,0,1,588,687,2,564,651,2,294.0,>30,PAK,Away,Upto 2014
V Sehwag,IND,Spin,2006-01-29,Karachi,Pakistan,2006,1,2,6,0,1,322,481,6,320,475,6,53.666666666666664,>30,PAK,Away,Upto 2014
V Sehwag,IND,Spin,2006-03-01,Nagpur,India,2006,1,14,6,0,1,588,1296,7,574,1290,7,84.0,>30,IND,Home,Upto 2014
V Sehwag,IND,Spin,2006-06-02,St John's,West Indies,2006,2,71,138,4,1,672,1196,20,601,1058,16,33.6,>30,WI,Away,Upto 2014
V Sehwag,IND,Spin,2006-06-10,Gros Islet,West Indies,2006,2,81,277,4,1,473,1177,17,392,900,13,27.823529411764707,<=30,WI,Away,Upto 2014
V Sehwag,IND,Spin,2006-06-22,Basseterre,West Indies,2006,1,47,96,1,1,722,1248,13,675,1152,12,55.53846153846154,>30,WI,Away,Upto 2014
V Sehwag,IND,Spin,2006-06-30,Kingston,West Indies,2006,1,10,24,0,1,275,517,14,265,493,14,19.642857142857142,<=30,WI,Away,Upto 2014
V Sehwag,IND,Spin,2006-12-26,Durban,South Africa,2006,1,7,16,1,1,106,283,5,99,267,4,21.2,<=30,SA,Away,Upto 2014
V Sehwag,IND,Spin,2007-01-02,Cape Town,South Africa,2007,2,39,78,1,1,487,1042,13,448,964,12,37.46153846153846,>30,SA,Away,Upto 2014
V Sehwag,IND,Spin,2008-01-16,W.A.C.A,Australia,2008,1,24,48,2,1,288,498,9,264,450,7,32.0,>30,AUS,Away,Upto 2014
V Sehwag,IND,Spin,2008-01-24,Adelaide,Australia,2008,1,51,114,2,1,579,1086,9,528,972,7,64.33333333333333,>30,AUS,Away,Upto 2014
V Sehwag,IND,Spin,2008-03-26,Chennai,India,2008,2,92,198,2,1,758,1458,16,666,1260,14,47.375,>30,IND,Home,Upto 2014
V Sehwag,IND,Spin,2008-04-11,Kanpur,India,2008,2,30,89,4,1,399,844,18,369,755,14,22.166666666666668,<=30,IND,Home,Upto 2014
V Sehwag,IND,Spin,2008-07-23,Colombo (SSC),Sri Lanka,2008,1,17,24,0,1,529,1031,21,512,1007,21,25.19047619047619,<=30,SL,Away,Upto 2014
V Sehwag,IND,Spin,2008-08-08,Colombo (PSS),Sri Lanka,2008,2,14,30,0,1,613,1402,20,599,1372,20,30.65,>30,SL,Away,Upto 2014
V Sehwag,IND,Spin,2008-10-09,Bengaluru,India,2008,2,31,78,0,1,536,1200,6,505,1122,6,89.33333333333333,>30,IND,Home,Upto 2014
V Sehwag,IND,Spin,2008-10-17,Mohali,India,2008,1,7,30,0,1,362,764,15,355,734,15,24.133333333333333,<=30,IND,Home,Upto 2014
V Sehwag,IND,Spin,2008-10-29,Delhi,India,2008,2,118,252,5,1,668,1278,12,550,1026,7,55.666666666666664,>30,IND,Home,Upto 2014
V Sehwag,IND,Spin,2008-11-06,Nagpur,India,2008,2,61,132,0,1,751,1259,24,690,1127,24,31.291666666666668,>30,IND,Home,Upto 2014
V Sehwag,IND,Spin,2008-12-11,Chennai,India,2008,2,30,42,0,1,742,1371,17,712,1329,17,43.64705882352941,>30,IND,Home,Upto 2014
V Sehwag,IND,Spin,2009-03-18,Hamilton,New Zealand,2009,1,18,18,0,1,359,787,15,341,769,15,23.933333333333334,<=30,NZ,Away,Upto 2014
V Sehwag,IND,Spin,2009-03-26,Napier,New Zealand,2009,1,73,72,0,1,685,1306,9,612,1234,9,76.11111111111111,>30,NZ,Away,Upto 2014
V Sehwag,IND,Spin,2009-04-03,Wellington,New Zealand,2009,1,25,42,0,1,383,840,12,358,798,12,31.916666666666668,>30,NZ,Away,Upto 2014
V Sehwag,IND,Spin,2009-11-16,Ahmedabad,India,2009,1,19,24,0,1,904,1575,9,885,1551,9,100.44444444444444,>30,IND,Home,Upto 2014
V Sehwag,IND,Spin,2009-11-24,Kanpur,India,2009,1,4,18,1,1,718,1197,20,714,1179,19,35.9,>30,IND,Home,Upto 2014
V Sehwag,IND,Spin,2009-12-02,Brabourne,India,2009,1,24,54,0,1,870,1403,18,846,1349,18,48.333333333333336,>30,IND,Home,Upto 2014
V Sehwag,IND,Spin,2010-01-17,Chattogram,Bangladesh,2010,1,7,24,1,1,565,949,23,558,925,22,24.565217391304348,<=30,BAN,Away,Upto 2014
V Sehwag,IND,Spin,2010-01-24,Mirpur,Bangladesh,2010,1,11,42,0,1,600,1045,11,589,1003,11,54.54545454545455,>30,BAN,Away,Upto 2014
V Sehwag,IND,Spin,2010-02-06,Nagpur,India,2010,1,55,108,1,1,517,1080,7,462,972,6,73.85714285714286,>30,IND,Home,Upto 2014
V Sehwag,IND,Spin,2010-02-14,Eden Gardens,India,2010,1,20,60,0,1,547,1263,14,527,1203,14,39.07142857142857,>30,IND,Home,Upto 2014
V Sehwag,IND,Spin,2010-07-18,Galle,Sri Lanka,2010,1,46,60,1,1,643,1145,10,597,1085,9,64.3,>30,SL,Away,Upto 2014
V Sehwag,IND,Spin,2010-07-26,Colombo (SSC),Sri Lanka,2010,2,88,174,2,1,926,1870,14,838,1696,12,66.14285714285714,>30,SL,Away,Upto 2014
V Sehwag,IND,Spin,2010-08-03,Colombo (PSS),Sri Lanka,2010,2,59,120,4,1,813,1539,26,754,1419,22,31.26923076923077,>30,SL,Away,Upto 2014
V Sehwag,IND,Spin,2010-10-01,Mohali,India,2010,1,23,56,0,1,557,1225,12,534,1169,12,46.416666666666664,>30,IND,Home,Upto 2014
V Sehwag,IND,Spin,2010-10-09,Bengaluru,India,2010,2,15,48,0,1,696,1271,17,681,1223,17,40.94117647058823,>30,IND,Home,Upto 2014
V Sehwag,IND,Spin,2010-11-04,Ahmedabad,India,2010,1,7,6,0,1,781,1719,18,774,1713,18,43.388888888888886,>30,IND,Home,Upto 2014
V Sehwag,IND,Spin,2011-11-06,Delhi,India,2011,1,5,12,0,1,434,957,21,429,945,21,20.666666666666668,<=30,IND,Home,Upto 2014
V Sehwag,IND,Spin,2011-11-14,Eden Gardens,India,2011,1,20,54,0,1,689,1188,12,669,1134,12,57.416666666666664,>30,IND,Home,Upto 2014
V Sehwag,IND,Spin,2011-11-22,Wankhede,India,2011,2,64,108,0,1,794,1593,24,730,1485,24,33.083333333333336,>30,IND,Home,Upto 2014
V Sehwag,IND,Spin,2011-12-26,Melbourne,Australia,2011,1,7,12,0,1,247,467,5,240,455,5,49.4,>30,AUS,Away,Upto 2014
V Sehwag,IND,Spin,2012-01-03,Sydney,Australia,2012,1,75,138,0,1,343,624,2,268,486,2,171.5,>30,AUS,Away,Upto 2014
V Sehwag,IND,Spin,2012-01-13,W.A.C.A,Australia,2012,1,20,44,1,1,20,44,1,0,0,0,20.0,<=30,AUS,Away,Upto 2014
V Sehwag,IND,Spin,2012-01-24,Adelaide,Australia,2012,1,55,96,0,1,465,838,10,410,742,10,46.5,>30,AUS,Away,Upto 2014
V Sehwag,IND,Spin,2012-08-23,Hyderabad,India,2012,1,4,12,0,1,326,884,22,322,872,22,14.818181818181818,<=30,IND,Home,Upto 2014
V Sehwag,IND,Spin,2012-11-15,Ahmedabad,India,2012,1,1,6,0,1,729,1559,21,728,1553,21,34.714285714285715,>30,IND,Home,Upto 2014
V Subramanya,IND,Pace,1965-03-19,Delhi,India,1965,2,35,126,2,1,283,544,9,248,418,7,31.444444444444443,>30,IND,Home,Upto 2014
V Subramanya,IND,Pace,1966-12-31,Eden Gardens,India,1966,1,9,36,0,1,232,474,6,223,438,6,38.666666666666664,>30,IND,Home,Upto 2014
V Subramanya,IND,Pace,1967-01-13,Chennai,India,1967,2,35,84,0,1,515,900,14,480,816,14,36.785714285714285,>30,IND,Home,Upto 2014
V Subramanya,IND,Pace,1967-06-22,Lord's,England,1967,1,20,42,0,1,257,628,10,237,586,10,25.7,<=30,ENG,Away,Upto 2014
V Subramanya,IND,Pace,1967-07-13,Birmingham,England,1967,2,50,84,1,1,150,354,6,100,270,5,25.0,<=30,ENG,Away,Upto 2014
V Subramanya,IND,Pace,1967-12-23,Adelaide,Australia,1967,2,19,24,0,1,596,1119,26,577,1095,26,22.923076923076923,<=30,AUS,Away,Upto 2014
V Subramanya,IND,Pace,1967-12-30,Melbourne,Australia,1967,1,18,24,0,1,704,1270,18,686,1246,18,39.111111111111114,>30,AUS,Away,Upto 2014
V Subramanya,IND,Pace,1968-02-29,Wellington,New Zealand,1968,1,10,12,0,1,330,661,9,320,649,9,36.666666666666664,>30,NZ,Away,Upto 2014
V Subramanya,IND,Pace,1968-03-07,Auckland,New Zealand,1968,2,5,12,0,1,377,874,14,372,862,14,26.928571428571427,<=30,NZ,Away,Upto 2014
VA Holder,WI,Pace,1969-06-12,Manchester,England,1969,2,102,245,1,1,490,1177,22,388,932,21,22.272727272727273,<=30,ENG,Away,Upto 2014
VA Holder,WI,Pace,1969-06-26,Lord's,England,1969,2,119,294,3,1,864,2111,25,745,1817,22,34.56,>30,ENG,Away,Upto 2014
VA Holder,WI,Pace,1969-07-10,Leeds,England,1969,2,114,354,5,1,581,1581,25,467,1227,20,23.24,<=30,ENG,Away,Upto 2014
VA Holder,WI,Pace,1971-02-18,Kingston,West Indies,1971,1,60,166,4,1,178,430,6,118,264,2,29.666666666666668,<=30,WI,Home,Upto 2014
VA Holder,WI,Pace,1971-03-06,Port of Spain,West Indies,1971,2,49,126,0,1,181,456,3,132,330,3,60.333333333333336,>30,WI,Home,Upto 2014
VA Holder,WI,Pace,1971-04-01,Bridgetown,West Indies,1971,2,83,202,2,1,478,1042,14,395,840,12,34.142857142857146,>30,WI,Home,Upto 2014
VA Holder,WI,Pace,1972-03-09,Port of Spain,West Indies,1972,2,77,282,4,1,314,919,14,237,637,10,22.428571428571427,<=30,WI,Home,Upto 2014
VA Holder,WI,Pace,1972-03-23,Bridgetown,West Indies,1972,1,91,240,3,1,605,1337,20,514,1097,17,30.25,>30,WI,Home,Upto 2014
VA Holder,WI,Pace,1972-04-06,Georgetown,West Indies,1972,1,39,144,0,1,457,1170,6,418,1026,6,76.16666666666667,>30,WI,Home,Upto 2014
VA Holder,WI,Pace,1972-04-20,Port of Spain,West Indies,1972,2,78,252,5,1,397,954,17,319,702,12,23.352941176470587,<=30,WI,Home,Upto 2014
VA Holder,WI,Pace,1973-02-16,Kingston,West Indies,1973,2,89,270,1,1,629,1295,15,540,1025,14,41.93333333333333,>30,WI,Home,Upto 2014
VA Holder,WI,Pace,1973-03-09,Bridgetown,West Indies,1973,2,101,252,2,1,508,1217,11,407,965,9,46.18181818181818,>30,WI,Home,Upto 2014
VA Holder,WI,Pace,1973-04-06,Georgetown,West Indies,1973,2,85,252,1,1,667,1551,23,582,1299,22,29.0,<=30,WI,Home,Upto 2014
VA Holder,WI,Pace,1973-08-09,Birmingham,England,1973,2,100,306,3,1,555,1416,18,455,1110,15,30.833333333333332,>30,ENG,Away,Upto 2014
VA Holder,WI,Pace,1973-08-23,Lord's,England,1973,2,74,174,4,1,497,984,19,423,810,15,26.157894736842106,<=30,ENG,Away,Upto 2014
VA Holder,WI,Pace,1974-03-06,Bridgetown,West Indies,1974,2,105,252,2,1,627,1356,14,522,1104,12,44.785714285714285,>30,WI,Home,Upto 2014
VA Holder,WI,Pace,1974-11-22,Bengaluru,India,1974,2,55,185,5,1,351,694,15,296,509,10,23.4,<=30,IND,Away,Upto 2014
VA Holder,WI,Pace,1974-12-27,Eden Gardens,India,1974,2,109,260,5,1,424,954,21,315,694,16,20.19047619047619,<=30,IND,Away,Upto 2014
VA Holder,WI,Pace,1975-01-11,Chennai,India,1975,2,66,198,1,1,381,795,19,315,597,18,20.05263157894737,<=30,IND,Away,Upto 2014
VA Holder,WI,Pace,1975-01-23,Wankhede,India,1975,2,85,259,6,1,510,1022,16,425,763,10,31.875,>30,IND,Away,Upto 2014
VA Holder,WI,Pace,1975-02-15,Lahore,Pakistan,1975,2,102,262,3,1,757,1707,25,655,1445,22,30.28,>30,PAK,Away,Upto 2014
VA Holder,WI,Pace,1975-03-01,Karachi,Pakistan,1975,2,85,200,2,1,655,1306,12,570,1106,10,54.583333333333336,>30,PAK,Away,Upto 2014
VA Holder,WI,Pace,1975-12-26,Melbourne,Australia,1975,1,123,216,1,1,804,1499,27,681,1283,26,29.77777777777778,<=30,AUS,Away,Upto 2014
VA Holder,WI,Pace,1976-01-23,Adelaide,Australia,1976,2,223,352,8,1,939,1486,26,716,1134,18,36.11538461538461,>30,AUS,Away,Upto 2014
VA Holder,WI,Pace,1976-01-31,Melbourne,Australia,1976,2,167,304,4,1,775,1378,27,608,1074,23,28.703703703703702,<=30,AUS,Away,Upto 2014
VA Holder,WI,Pace,1976-04-21,Kingston,West Indies,1976,2,70,198,0,1,382,807,9,312,609,9,42.44444444444444,>30,WI,Home,Upto 2014
VA Holder,WI,Pace,1976-06-03,Nottingham,England,1976,2,78,222,3,1,773,1761,21,695,1539,18,36.80952380952381,>30,ENG,Away,Upto 2014
VA Holder,WI,Pace,1976-06-17,Lord's,England,1976,2,85,226,5,1,584,1335,24,499,1109,19,24.333333333333332,<=30,ENG,Away,Upto 2014
VA Holder,WI,Pace,1976-07-22,Leeds,England,1976,2,100,249,4,1,969,1786,39,869,1537,35,24.846153846153847,<=30,ENG,Away,Upto 2014
VA Holder,WI,Pace,1976-08-12,The Oval,England,1976,2,104,251,3,1,768,1323,20,664,1072,17,38.4,>30,ENG,Away,Upto 2014
VA Holder,WI,Pace,1977-02-18,Bridgetown,West Indies,1977,1,13,24,0,1,1045,1954,34,1032,1930,34,30.735294117647058,>30,WI,Home,Upto 2014
VA Holder,WI,Pace,1978-03-31,Georgetown,West Indies,1978,2,95,222,1,1,786,1458,28,691,1236,27,28.071428571428573,<=30,WI,Home,Upto 2014
VA Holder,WI,Pace,1978-04-15,Port of Spain,West Indies,1978,2,44,144,7,1,408,786,17,364,642,10,24.0,<=30,WI,Home,Upto 2014
VA Holder,WI,Pace,1978-04-28,Kingston,West Indies,1978,2,109,294,3,1,520,1042,12,411,748,9,43.333333333333336,>30,WI,Home,Upto 2014
VA Holder,WI,Pace,1978-12-01,Wankhede,India,1978,2,109,204,4,1,499,1002,13,390,798,9,38.38461538461539,>30,IND,Away,Upto 2014
VA Holder,WI,Pace,1978-12-15,Bengaluru,India,1978,1,55,144,0,1,557,1034,19,502,890,19,29.31578947368421,<=30,IND,Away,Upto 2014
VA Holder,WI,Pace,1978-12-29,Eden Gardens,India,1978,2,107,246,1,1,744,1474,17,637,1228,16,43.76470588235294,>30,IND,Away,Upto 2014
VA Holder,WI,Pace,1979-01-12,Chennai,India,1979,2,50,126,3,1,433,993,27,383,867,24,16.037037037037038,<=30,IND,Away,Upto 2014
VA Holder,WI,Pace,1979-01-24,Delhi,India,1979,1,109,240,0,1,605,998,12,496,758,12,50.416666666666664,>30,IND,Away,Upto 2014
VA Holder,WI,Pace,1979-02-02,Kanpur,India,1979,1,118,258,0,1,581,990,8,463,732,8,72.625,>30,IND,Away,Upto 2014
VA Valentine,WI,Pace,1933-07-22,Manchester,England,1933,1,49,168,0,1,416,958,13,367,790,13,32.0,>30,ENG,Away,Upto 2014
VA Valentine,WI,Pace,1933-08-12,The Oval,England,1933,1,55,120,1,1,389,809,16,334,689,15,24.3125,<=30,ENG,Away,Upto 2014
VB John,SL,Pace,1983-03-04,Christchurch,New Zealand,1983,1,45,72,2,1,557,1256,25,512,1184,23,22.28,<=30,NZ,Away,Upto 2014
VB John,SL,Pace,1983-03-11,Wellington,New Zealand,1983,2,98,200,6,1,592,1490,31,494,1290,25,19.096774193548388,<=30,NZ,Away,Upto 2014
VB John,SL,Pace,1984-03-09,Kandy,Sri Lanka,1984,2,159,282,8,1,359,767,20,200,485,12,17.95,<=30,SL,Home,Upto 2014
VB John,SL,Pace,1984-03-16,Colombo (SSC),Sri Lanka,1984,2,115,270,5,1,563,1643,28,448,1373,23,20.107142857142858,<=30,SL,Home,Upto 2014
VB John,SL,Pace,1984-03-24,Colombo (CCC),Sri Lanka,1984,1,99,222,3,1,479,1056,21,380,834,18,22.80952380952381,<=30,SL,Home,Upto 2014
VB John,SL,Pace,1984-08-23,Lord's,England,1984,1,98,235,4,1,850,1633,19,752,1398,15,44.73684210526316,>30,ENG,Away,Upto 2014
VB Ranjane,IND,Pace,1958-12-12,Kanpur,India,1958,1,35,108,1,1,403,1061,19,368,953,18,21.210526315789473,<=30,IND,Home,Upto 2014
VB Ranjane,IND,Pace,1961-11-11,Brabourne,India,1961,2,129,204,5,1,444,942,9,315,738,4,49.333333333333336,>30,IND,Home,Upto 2014
VB Ranjane,IND,Pace,1961-12-01,Kanpur,India,1961,2,99,237,1,1,383,915,5,284,678,4,76.6,>30,IND,Home,Upto 2014
VB Ranjane,IND,Pace,1961-12-30,Eden Gardens,India,1961,2,90,210,3,1,412,930,9,322,720,6,45.77777777777778,>30,IND,Home,Upto 2014
VB Ranjane,IND,Pace,1962-04-13,Kingston,West Indies,1962,2,153,284,6,1,371,811,20,218,527,14,18.55,<=30,WI,Away,Upto 2014
VB Ranjane,IND,Pace,1964-01-10,Chennai,India,1964,2,60,108,1,1,259,498,2,199,390,1,129.5,>30,IND,Home,Upto 2014
VB Ranjane,IND,Pace,1964-10-02,Chennai,India,1964,2,83,114,2,1,256,741,16,173,627,14,16.0,<=30,IND,Home,Upto 2014
VC Drakes,WI,Pace,2002-12-08,Dhaka,Bangladesh,2002,2,80,162,7,1,465,906,25,385,744,18,18.6,<=30,BAN,Away,Upto 2014
VC Drakes,WI,Pace,2002-12-16,Chattogram,Bangladesh,2002,2,75,162,4,1,655,1306,30,580,1144,26,21.833333333333332,<=30,BAN,Away,Upto 2014
VC Drakes,WI,Pace,2003-04-10,Georgetown,West Indies,2003,2,121,205,5,1,811,1248,21,690,1043,16,38.61904761904762,>30,WI,Home,Upto 2014
VC Drakes,WI,Pace,2003-04-19,Port of Spain,West Indies,2003,2,173,318,2,1,913,1617,20,740,1299,18,45.65,>30,WI,Home,Upto 2014
VC Drakes,WI,Pace,2003-05-01,Bridgetown,West Indies,2003,1,85,180,2,1,652,1455,15,567,1275,13,43.46666666666667,>30,WI,Home,Upto 2014
VC Drakes,WI,Pace,2003-05-09,St John's,West Indies,2003,2,134,204,2,1,870,1573,29,736,1369,27,30.0,<=30,WI,Home,Upto 2014
VC Drakes,WI,Pace,2003-06-27,Kingston,West Indies,2003,2,83,174,1,1,610,1045,26,527,871,25,23.46153846153846,<=30,WI,Home,Upto 2014
VC Drakes,WI,Pace,2003-11-04,Harare,Zimbabwe,2003,2,152,324,5,1,904,1627,24,752,1303,19,37.666666666666664,>30,ZIM,Away,Upto 2014
VC Drakes,WI,Pace,2003-12-12,Johannesburg,South Africa,2003,2,113,234,2,1,1112,2121,34,999,1887,32,32.705882352941174,>30,SA,Away,Upto 2014
VC Drakes,WI,Pace,2003-12-26,Durban,South Africa,2003,1,113,180,2,1,1030,1831,26,917,1651,24,39.61538461538461,>30,SA,Away,Upto 2014
VC Drakes,WI,Pace,2004-01-02,Cape Town,South Africa,2004,2,132,276,1,1,1140,1873,23,1008,1597,22,49.56521739130435,>30,SA,Away,Upto 2014
VC Drakes,WI,Pace,2004-01-16,Centurion,South Africa,2004,1,101,198,0,1,1068,1800,24,967,1602,24,44.5,>30,SA,Away,Upto 2014
VD Philander,SA,Pace,2011-11-09,Cape Town,South Africa,2011,2,78,168,8,1,597,929,31,519,761,23,19.258064516129032,<=30,SA,Home,Upto 2014
VD Philander,SA,Pace,2011-11-17,Johannesburg,South Africa,2011,2,117,210,6,1,938,1680,27,821,1470,21,34.74074074074074,>30,SA,Home,Upto 2014
VD Philander,SA,Pace,2011-12-15,Centurion,South Africa,2011,2,102,145,10,1,635,1013,25,533,868,15,25.4,<=30,SA,Home,Upto 2014
VD Philander,SA,Pace,2012-01-03,Cape Town,South Africa,2012,2,100,234,6,1,828,1318,18,728,1084,12,46.0,>30,SA,Home,Upto 2014
VD Philander,SA,Pace,2012-03-07,Dunedin,New Zealand,2012,2,101,180,5,1,860,1498,21,759,1318,16,40.95238095238095,>30,NZ,Away,Upto 2014
VD Philander,SA,Pace,2012-03-15,Hamilton,New Zealand,2012,2,114,185,10,1,549,1079,27,435,894,17,20.333333333333332,<=30,NZ,Away,Upto 2014
VD Philander,SA,Pace,2012-03-23,Wellington,New Zealand,2012,2,110,244,6,1,873,1620,25,763,1376,19,34.92,>30,NZ,Away,Upto 2014
VD Philander,SA,Pace,2012-07-19,The Oval,England,2012,2,108,276,2,1,900,1787,18,792,1511,16,50.0,>30,ENG,Away,Upto 2014
VD Philander,SA,Pace,2012-08-02,Leeds,England,2012,2,98,216,3,1,982,1920,23,884,1704,20,42.69565217391305,>30,ENG,Away,Upto 2014
VD Philander,SA,Pace,2012-08-16,Lord's,England,2012,2,78,233,7,1,927,1840,33,849,1607,26,28.09090909090909,<=30,ENG,Away,Upto 2014
VD Philander,SA,Pace,2012-11-09,Brisbane,Australia,2012,1,103,180,0,1,917,1756,14,814,1576,14,65.5,>30,AUS,Away,Upto 2014
VD Philander,SA,Pace,2012-11-30,W.A.C.A,Australia,2012,2,96,222,4,1,885,1522,30,789,1300,26,29.5,<=30,AUS,Away,Upto 2014
VD Philander,SA,Pace,2013-01-02,Cape Town,South Africa,2013,2,83,180,7,1,547,1103,26,464,923,19,21.03846153846154,<=30,SA,Home,Upto 2014
VD Philander,SA,Pace,2013-02-01,Johannesburg,South Africa,2013,2,76,186,4,1,592,1253,26,516,1067,22,22.76923076923077,<=30,SA,Home,Upto 2014
VD Philander,SA,Pace,2013-02-14,Cape Town,South Africa,2013,2,99,270,9,1,620,1269,20,521,999,11,31.0,>30,SA,Home,Upto 2014
VD Philander,SA,Pace,2013-02-22,Centurion,South Africa,2013,2,62,150,2,1,578,1050,26,516,900,24,22.23076923076923,<=30,SA,Home,Upto 2014
VD Philander,SA,Pace,2013-10-14,Abu Dhabi,UAE,2013,2,95,186,5,1,476,1024,18,381,838,13,26.444444444444443,<=30,UAE,Away,Upto 2014
VD Philander,SA,Pace,2013-10-23,Dubai (DICS),UAE,2013,2,43,144,1,1,404,958,9,361,814,8,44.888888888888886,>30,UAE,Away,Upto 2014
VD Philander,SA,Pace,2013-12-18,Johannesburg,South Africa,2013,2,129,330,7,1,1012,2037,30,883,1707,23,33.733333333333334,>30,SA,Home,Upto 2014
VD Philander,SA,Pace,2013-12-26,Durban,South Africa,2013,2,99,222,3,1,714,1389,18,615,1167,15,39.666666666666664,>30,SA,Home,Upto 2014
VD Philander,SA,Pace,2014-02-12,Centurion,South Africa,2014,2,97,210,1,1,767,1417,27,670,1207,26,28.40740740740741,<=30,SA,Home,After 1965
VD Philander,SA,Pace,2014-02-20,Gqeberha,South Africa,2014,2,107,180,5,1,800,1419,22,693,1239,17,36.36363636363637,>30,SA,Home,After 1965
VD Philander,SA,Pace,2014-03-01,Cape Town,South Africa,2014,2,158,196,1,1,924,1728,25,766,1532,24,36.96,>30,SA,Home,After 1965
VD Philander,SA,Pace,2014-07-16,Galle,Sri Lanka,2014,2,65,156,0,1,420,962,20,355,806,20,21.0,<=30,SL,Away,After 1965
VD Philander,SA,Pace,2014-07-24,Colombo (SSC),Sri Lanka,2014,2,87,196,2,1,394,782,12,307,586,10,32.833333333333336,>30,SL,Away,After 1965
VD Philander,SA,Pace,2014-08-09,Harare,Zimbabwe,2014,2,76,168,1,1,362,1164,16,286,996,15,22.625,<=30,ZIM,Away,After 1965
VD Philander,SA,Pace,2014-12-17,Centurion,South Africa,2014,2,35,132,5,1,587,1007,20,552,875,15,29.35,<=30,SA,Home,After 1965
VD Philander,SA,Pace,2014-12-26,Gqeberha,South Africa,2014,1,41,108,1,1,464,870,12,423,762,11,38.666666666666664,>30,SA,Home,After 1965
VD Philander,SA,Pace,2015-01-02,Cape Town,South Africa,2015,2,100,210,0,1,670,1234,16,570,1024,16,41.875,>30,SA,Home,After 1965
VD Philander,SA,Pace,2015-07-21,Chattogram,Bangladesh,2015,1,40,120,2,1,297,719,10,257,599,8,29.7,<=30,BAN,Away,After 1965
VD Philander,SA,Pace,2015-07-30,Mirpur,Bangladesh,2015,1,25,66,0,1,105,259,4,80,193,4,26.25,<=30,BAN,Away,After 1965
VD Philander,SA,Pace,2015-11-05,Mohali,India,2015,2,61,162,3,1,185,504,6,124,342,3,30.833333333333332,>30,IND,Away,After 1965
VD Philander,SA,Pace,2016-08-19,Durban,South Africa,2016,1,12,36,0,1,247,526,10,235,490,10,24.7,<=30,SA,Home,After 1965
VD Philander,SA,Pace,2016-08-27,Centurion,South Africa,2016,2,77,174,4,1,829,1709,31,752,1535,27,26.741935483870968,<=30,SA,Home,After 1965
VD Philander,SA,Pace,2016-11-03,W.A.C.A,Australia,2016,2,111,248,5,1,937,1726,29,826,1478,24,32.310344827586206,>30,AUS,Away,After 1965
VD Philander,SA,Pace,2016-11-12,Hobart,Australia,2016,2,52,157,5,1,477,1007,29,425,850,24,16.448275862068964,<=30,AUS,Away,After 1965
VD Philander,SA,Pace,2016-11-24,Adelaide,Australia,2016,2,120,216,2,1,686,1407,24,566,1191,22,28.583333333333332,<=30,AUS,Away,After 1965
VD Philander,SA,Pace,2016-12-26,Gqeberha,South Africa,2016,2,110,252,6,1,798,1468,25,688,1216,19,31.92,>30,SA,Home,After 1965
VD Philander,SA,Pace,2017-01-02,Cape Town,South Africa,2017,2,75,156,7,1,701,1233,30,626,1077,23,23.366666666666667,<=30,SA,Home,After 1965
VD Philander,SA,Pace,2017-01-12,Johannesburg,South Africa,2017,2,63,144,4,1,621,1136,30,558,992,26,20.7,<=30,SA,Home,After 1965
VD Philander,SA,Pace,2017-03-08,Dunedin,New Zealand,2017,1,67,162,2,1,518,1198,16,451,1036,14,32.375,>30,NZ,Away,After 1965
VD Philander,SA,Pace,2017-03-16,Wellington,New Zealand,2017,2,57,162,0,1,662,1203,19,605,1041,19,34.8421052631579,>30,NZ,Away,After 1965
VD Philander,SA,Pace,2017-03-25,Hamilton,New Zealand,2017,1,79,198,0,1,618,1215,19,539,1017,19,32.526315789473685,>30,NZ,Away,After 1965
VD Philander,SA,Pace,2017-07-06,Lord's,England,2017,2,76,150,3,1,720,1257,22,644,1107,19,32.72727272727273,>30,ENG,Away,After 1965
VD Philander,SA,Pace,2017-07-14,Nottingham,England,2017,2,72,138,5,1,739,1395,28,667,1257,23,26.392857142857142,<=30,ENG,Away,After 1965
VD Philander,SA,Pace,2017-07-27,The Oval,England,2017,2,86,192,2,1,850,1584,29,764,1392,27,29.310344827586206,<=30,ENG,Away,After 1965
VD Philander,SA,Pace,2017-12-26,Gqeberha,South Africa,2017,2,31,102,2,1,327,664,21,296,562,19,15.571428571428571,<=30,SA,Home,After 1965
VD Philander,SA,Pace,2018-01-05,Cape Town,South Africa,2018,2,75,181,9,1,684,1276,37,609,1095,28,18.486486486486488,<=30,SA,Home,After 1965
VD Philander,SA,Pace,2018-01-13,Centurion,South Africa,2018,2,71,156,1,1,739,1521,29,668,1365,28,25.482758620689655,<=30,SA,Home,After 1965
VD Philander,SA,Pace,2018-01-24,Johannesburg,South Africa,2018,2,92,241,5,1,749,1777,40,657,1536,35,18.725,<=30,SA,Home,After 1965
VD Philander,SA,Pace,2018-03-01,Durban,South Africa,2018,2,94,246,3,1,640,1256,26,546,1010,23,24.615384615384617,<=30,SA,Home,After 1965
VD Philander,SA,Pace,2018-03-09,Gqeberha,South Africa,2018,2,81,216,2,1,673,1296,28,592,1080,26,24.035714285714285,<=30,SA,Home,After 1965
VD Philander,SA,Pace,2018-03-22,Cape Town,South Africa,2018,2,43,126,2,1,789,1457,31,746,1331,29,25.451612903225808,<=30,SA,Home,After 1965
VD Philander,SA,Pace,2018-03-30,Johannesburg,South Africa,2018,2,51,186,9,1,666,1427,26,615,1241,17,25.615384615384617,<=30,SA,Home,After 1965
VD Philander,SA,Pace,2018-07-12,Galle,Sri Lanka,2018,2,38,66,1,1,242,397,13,204,331,12,18.615384615384617,<=30,SL,Away,After 1965
VD Philander,SA,Pace,2019-01-03,Cape Town,South Africa,2019,2,87,180,2,1,809,1380,31,722,1200,29,26.096774193548388,<=30,SA,Home,After 1965
VD Philander,SA,Pace,2019-01-11,Johannesburg,South Africa,2019,2,84,162,4,1,906,1496,35,822,1334,31,25.885714285714286,<=30,SA,Home,After 1965
VD Philander,SA,Pace,2019-02-13,Durban,South Africa,2019,2,45,108,3,1,725,1312,28,680,1204,25,25.892857142857142,<=30,SA,Home,After 1965
VD Philander,SA,Pace,2019-10-02,Visakhapatnam,India,2019,2,89,204,2,1,350,737,9,261,533,7,38.888888888888886,>30,IND,Away,After 1965
VD Philander,SA,Pace,2019-10-10,Pune,India,2019,1,66,156,0,1,453,864,13,387,708,13,34.84615384615385,>30,IND,Away,After 1965
VD Philander,SA,Pace,2019-12-26,Centurion,South Africa,2019,2,51,206,4,1,888,1593,38,837,1387,34,23.36842105263158,<=30,SA,Home,After 1965
VD Philander,SA,Pace,2020-01-03,Cape Town,South Africa,2020,2,70,180,2,1,689,1635,31,619,1455,29,22.225806451612904,<=30,SA,Home,After 1965
VD Philander,SA,Pace,2020-01-16,Gqeberha,South Africa,2020,1,41,96,0,1,517,1029,13,476,933,13,39.76923076923077,>30,SA,Home,After 1965
VD Philander,SA,Pace,2020-01-24,Johannesburg,South Africa,2020,2,51,129,2,1,1022,1773,39,971,1644,37,26.205128205128204,<=30,SA,Home,After 1965
VI Smith,SA,Spin,1947-06-07,Nottingham,England,1947,2,189,469,7,1,885,2189,17,696,1720,10,52.05882352941177,>30,ENG,Away,Upto 2014
VI Smith,SA,Spin,1947-06-21,Lord's,England,1947,1,73,102,0,1,699,1857,18,626,1755,18,38.833333333333336,>30,ENG,Away,Upto 2014
VI Smith,SA,Spin,1947-07-26,Leeds,England,1947,1,82,216,1,1,420,1282,10,338,1066,9,42.0,>30,ENG,Away,Upto 2014
VI Smith,SA,Spin,1947-08-16,The Oval,England,1947,2,95,144,1,1,893,1980,23,798,1836,22,38.82608695652174,>30,ENG,Away,Upto 2014
VI Smith,SA,Spin,1949-12-24,Johannesburg,South Africa,1949,1,70,104,0,1,426,1143,20,356,1039,20,21.3,<=30,SA,Home,Upto 2014
VI Smith,SA,Spin,1949-12-31,Cape Town,South Africa,1949,1,111,200,0,1,803,1732,19,692,1532,19,42.26315789473684,>30,SA,Home,Upto 2014
VI Smith,SA,Spin,1950-01-20,Durban,South Africa,1950,1,32,40,0,1,552,1758,29,520,1718,29,19.03448275862069,<=30,SA,Home,Upto 2014
VI Smith,SA,Spin,1955-06-09,Nottingham,England,1955,1,62,180,1,1,185,768,8,123,588,7,23.125,<=30,ENG,Away,Upto 2014
VI Smith,SA,Spin,1957-12-23,Johannesburg,South Africa,1957,2,55,200,2,1,467,1272,8,412,1072,6,58.375,>30,SA,Home,Upto 2014
VJ Marks,ENG,Spin,1982-08-26,Leeds,England,1982,2,31,42,1,1,134,222,2,103,180,1,67.0,>30,ENG,Home,Upto 2014
VJ Marks,ENG,Spin,1983-07-14,The Oval,England,1983,1,78,258,3,1,330,901,10,252,643,7,33.0,>30,ENG,Home,Upto 2014
VJ Marks,ENG,Spin,1984-02-10,Auckland,New Zealand,1984,1,115,242,3,1,236,653,6,121,411,3,39.333333333333336,>30,NZ,Away,Upto 2014
VJ Marks,ENG,Spin,1984-03-02,Karachi,Pakistan,1984,2,63,150,1,1,352,1095,26,289,945,25,13.538461538461538,<=30,PAK,Away,Upto 2014
VJ Marks,ENG,Spin,1984-03-12,Faisalabad,Pakistan,1984,2,85,210,2,1,537,1272,7,452,1062,5,76.71428571428571,>30,PAK,Away,Upto 2014
VJ Marks,ENG,Spin,1984-03-19,Lahore,Pakistan,1984,2,112,180,1,1,562,1203,13,450,1023,12,43.23076923076923,>30,PAK,Away,Upto 2014
VJ Scott,NZ,Spin,1949-06-11,Leeds,England,1949,1,9,6,0,1,545,1101,10,536,1095,10,54.5,>30,ENG,Away,Upto 2014
VJ Scott,NZ,Spin,1951-03-17,Christchurch,New Zealand,1951,1,5,12,0,1,586,1337,15,581,1325,15,39.06666666666667,>30,NZ,Home,Upto 2014
VL Manjrekar,IND,Spin,1952-12-12,Eden Gardens,India,1952,1,6,12,0,1,455,1230,13,449,1218,13,35.0,>30,IND,Home,Upto 2014
VL Manjrekar,IND,Spin,1955-12-16,Delhi,India,1955,1,16,120,1,1,540,1398,4,524,1278,3,135.0,>30,IND,Home,Upto 2014
VL Manjrekar,IND,Spin,1960-12-16,Kanpur,India,1960,1,2,6,0,1,619,1984,16,617,1978,16,38.6875,>30,IND,Home,Upto 2014
VL Manjrekar,IND,Spin,1961-01-13,Chennai,India,1961,1,6,12,0,1,664,1638,11,658,1626,11,60.36363636363637,>30,IND,Home,Upto 2014
VL Manjrekar,IND,Spin,1964-01-10,Chennai,India,1964,1,3,18,0,1,876,2493,27,873,2475,27,32.44444444444444,>30,IND,Home,Upto 2014
VL Manjrekar,IND,Spin,1965-02-27,Chennai,India,1965,1,11,36,0,1,616,1705,17,605,1669,17,36.23529411764706,>30,IND,Home,Upto 2014
VL Mehra,IND,Spin,1955-12-16,Delhi,India,1955,1,3,18,0,1,540,1398,4,537,1380,4,135.0,>30,IND,Home,Upto 2014
VL Mehra,IND,Spin,1964-01-10,Chennai,India,1964,1,2,6,0,1,876,2493,27,874,2487,27,32.44444444444444,>30,IND,Home,Upto 2014
VL Mehra,IND,Spin,1964-01-21,Brabourne,India,1964,1,1,12,0,1,560,2208,16,559,2196,16,35.0,>30,IND,Home,Upto 2014
VM Merchant,IND,Pace,1936-07-25,Manchester,England,1936,1,17,18,0,1,650,1176,8,633,1158,8,81.25,>30,ENG,Away,Upto 2014
VM Merchant,IND,Pace,1936-08-15,The Oval,England,1936,1,23,36,0,1,678,1230,17,655,1194,17,39.88235294117647,>30,ENG,Away,Upto 2014
VM Muddiah,IND,Spin,1959-12-12,Delhi,India,1959,1,32,78,0,1,348,919,18,316,841,18,19.333333333333332,<=30,IND,Home,Upto 2014
VM Muddiah,IND,Spin,1960-12-16,Kanpur,India,1960,2,102,240,3,1,619,1984,16,517,1744,13,38.6875,>30,IND,Home,Upto 2014
VM Nyauchi,ZIM,Pace,2020-01-19,Harare,Zimbabwe,2020,2,75,198,3,1,521,1458,17,446,1260,14,30.647058823529413,>30,ZIM,Home,After 1965
VM Nyauchi,ZIM,Pace,2020-01-27,Harare,Zimbabwe,2020,2,83,209,2,1,441,1205,12,358,996,10,36.75,>30,ZIM,Home,After 1965
VM Nyauchi,ZIM,Pace,2020-02-22,Mirpur,Bangladesh,2020,1,87,162,1,1,385,792,7,298,630,6,55.0,>30,BAN,Away,After 1965
VM Nyauchi,ZIM,Pace,2021-03-02,Abu Dhabi,UAE,2021,2,64,102,6,1,239,474,18,175,372,12,13.277777777777779,<=30,UAE,Away,After 1965
VM Nyauchi,ZIM,Pace,2021-03-10,Abu Dhabi,UAE,2021,2,130,180,1,1,415,797,6,285,617,5,69.16666666666667,>30,UAE,Away,After 1965
VM Nyauchi,ZIM,Pace,2021-07-07,Harare,Zimbabwe,2021,2,128,162,2,1,697,1302,16,569,1140,14,43.5625,>30,ZIM,Home,After 1965
VM Nyauchi,ZIM,Pace,2023-02-04,Bulawayo,Zimbabwe,2023,2,111,258,0,1,562,1122,8,451,864,8,70.25,>30,ZIM,Home,After 1965
VM Nyauchi,ZIM,Pace,2023-02-12,Bulawayo,Zimbabwe,2023,1,56,105,5,1,266,519,11,210,414,6,24.181818181818183,<=30,ZIM,Home,After 1965
VM Nyauchi,ZIM,Pace,2024-07-25,Belfast,Northern Ireland,2024,1,7,6,0,1,610,1116,26,603,1110,26,23.46153846153846,<=30,Northern Ireland,Away,After 1965
VN Swamy,IND,Pace,1955-11-19,Hyderabad (Deccan),India,1955,2,45,108,0,1,344,973,5,299,865,5,68.8,>30,IND,Home,Upto 2014
VPFA Royle,ENG,Spin,1879-01-02,Melbourne,Australia,1879,1,6,16,0,1,184,410,8,178,394,8,23.0,<=30,AUS,Away,After 1965
VR Aaron,IND,Pace,2011-11-22,Wankhede,India,2011,2,129,192,3,1,622,1054,14,493,862,11,44.42857142857143,>30,IND,Home,Upto 2014
VR Aaron,IND,Pace,2014-08-07,Manchester,England,2014,1,97,156,3,1,546,928,23,449,772,20,23.73913043478261,<=30,ENG,Away,After 1965
VR Aaron,IND,Pace,2014-08-15,The Oval,England,2014,1,153,174,2,1,613,1107,25,460,933,23,24.52,<=30,ENG,Away,After 1965
VR Aaron,IND,Pace,2014-12-09,Adelaide,Australia,2014,2,179,198,3,1,885,1420,15,706,1222,12,59.0,>30,AUS,Away,After 1965
VR Aaron,IND,Pace,2014-12-17,Brisbane,Australia,2014,2,183,187,2,1,959,1402,28,776,1215,26,34.25,>30,AUS,Away,After 1965
VR Aaron,IND,Pace,2015-06-10,Fatullah,Bangladesh,2015,1,27,54,1,1,199,300,1,172,246,0,199.0,>30,BAN,Away,After 1965
VR Aaron,IND,Pace,2015-08-12,Galle,Sri Lanka,2015,2,107,108,2,1,393,630,9,286,522,7,43.666666666666664,>30,SL,Away,After 1965
VR Aaron,IND,Pace,2015-11-05,Mohali,India,2015,2,21,66,1,1,185,504,6,164,438,5,30.833333333333332,>30,IND,Home,After 1965
VR Aaron,IND,Pace,2015-11-14,Bengaluru,India,2015,1,51,54,1,1,150,258,1,99,204,0,150.0,>30,IND,Home,After 1965
VR Brown,NZ,Spin,1985-11-08,Brisbane,Australia,1985,2,113,222,1,1,336,547,4,223,325,3,84.0,>30,AUS,Away,Upto 2014
VR Brown,NZ,Spin,1985-11-22,Sydney,Australia,1985,2,63,120,0,1,694,1882,25,631,1762,25,27.76,<=30,AUS,Away,Upto 2014
VRV Singh,IND,Pace,2006-06-02,St John's,West Indies,2006,2,96,156,2,1,716,1427,15,620,1271,13,47.733333333333334,>30,WI,Away,Upto 2014
VRV Singh,IND,Pace,2006-06-10,Gros Islet,West Indies,2006,2,62,126,0,1,597,938,8,535,812,8,74.625,>30,WI,Away,Upto 2014
VRV Singh,IND,Pace,2006-12-15,Johannesburg,South Africa,2006,2,75,127,1,1,728,1389,33,653,1262,32,22.060606060606062,<=30,SA,Away,Upto 2014
VRV Singh,IND,Pace,2006-12-26,Durban,South Africa,2006,2,124,138,2,1,879,1470,33,755,1332,31,26.636363636363637,<=30,SA,Away,Upto 2014
VRV Singh,IND,Pace,2007-05-18,Chattogram,Bangladesh,2007,2,70,122,3,1,364,589,13,294,467,10,28.0,<=30,BAN,Away,Upto 2014
VS Hazare,IND,Pace,1946-06-22,Lord's,England,1946,2,107,232,2,1,522,1272,22,415,1040,20,23.727272727272727,<=30,ENG,Away,Upto 2014
VS Hazare,IND,Pace,1946-07-20,Manchester,England,1946,2,68,144,0,1,495,1476,27,427,1332,27,18.333333333333332,<=30,ENG,Away,Upto 2014
VS Hazare,IND,Pace,1946-08-17,The Oval,England,1946,1,4,12,0,1,220,560,7,216,548,7,31.428571428571427,>30,ENG,Away,Upto 2014
VS Hazare,IND,Pace,1947-11-28,Brisbane,Australia,1947,1,63,88,0,1,345,994,21,282,906,21,16.428571428571427,<=30,AUS,Away,Upto 2014
VS Hazare,IND,Pace,1947-12-12,Sydney,Australia,1947,1,29,106,4,1,133,474,10,104,368,6,13.3,<=30,AUS,Away,Upto 2014
VS Hazare,IND,Pace,1948-01-01,Melbourne,Australia,1948,2,117,217,0,1,380,833,9,263,616,9,42.22222222222222,>30,AUS,Away,Upto 2014
VS Hazare,IND,Pace,1948-01-23,Adelaide,Australia,1948,1,110,171,2,1,583,1360,19,473,1189,17,30.68421052631579,>30,AUS,Away,Upto 2014
VS Hazare,IND,Pace,1948-02-06,Melbourne,Australia,1948,1,63,112,1,1,469,1146,14,406,1034,13,33.5,>30,AUS,Away,Upto 2014
VS Hazare,IND,Pace,1948-11-10,Delhi,India,1948,1,62,102,0,1,457,956,11,395,854,11,41.54545454545455,>30,IND,Home,Upto 2014
VS Hazare,IND,Pace,1948-12-09,Brabourne,India,1948,1,74,252,1,1,410,1014,5,336,762,4,82.0,>30,IND,Home,Upto 2014
VS Hazare,IND,Pace,1948-12-31,Eden Gardens,India,1948,2,66,96,0,1,577,1272,12,511,1176,12,48.083333333333336,>30,IND,Home,Upto 2014
VS Hazare,IND,Pace,1949-01-27,Chennai,India,1949,1,44,72,0,1,442,1095,18,398,1023,18,24.555555555555557,<=30,IND,Home,Upto 2014
VS Hazare,IND,Pace,1949-02-04,Brabourne,India,1949,2,13,42,1,1,462,1177,18,449,1135,17,25.666666666666668,<=30,IND,Home,Upto 2014
VS Hazare,IND,Pace,1951-11-02,Delhi,India,1951,2,24,102,0,1,354,1056,2,330,954,2,177.0,>30,IND,Home,Upto 2014
VS Hazare,IND,Pace,1951-12-14,Brabourne,India,1951,1,30,102,1,1,609,1495,17,579,1393,16,35.8235294117647,>30,IND,Home,Upto 2014
VS Hazare,IND,Pace,1951-12-30,Eden Gardens,India,1951,2,20,72,0,1,283,907,5,263,835,5,56.6,>30,IND,Home,Upto 2014
VS Hazare,IND,Pace,1952-01-12,Kanpur,India,1952,1,5,12,0,1,37,120,0,32,108,0,inf,>30,IND,Home,Upto 2014
VS Hazare,IND,Pace,1952-02-06,Chennai,India,1952,1,15,60,1,1,228,540,4,213,480,3,57.0,>30,IND,Home,Upto 2014
VS Hazare,IND,Pace,1952-06-05,Leeds,England,1952,2,33,138,1,1,376,1124,14,343,986,13,26.857142857142858,<=30,ENG,Away,Upto 2014
VS Hazare,IND,Pace,1952-06-19,Lord's,England,1952,2,53,150,2,1,486,1206,17,433,1056,15,28.58823529411765,<=30,ENG,Away,Upto 2014
VS Hazare,IND,Pace,1952-07-17,Manchester,England,1952,1,23,42,0,1,188,520,17,165,478,17,11.058823529411764,<=30,ENG,Away,Upto 2014
VS Hazare,IND,Pace,1952-08-14,The Oval,England,1952,1,0,18,0,1,139,287,11,139,269,11,12.636363636363637,<=30,ENG,Away,Upto 2014
VS Hazare,IND,Pace,1952-10-16,Delhi,India,1952,1,3,36,0,1,227,672,5,224,636,5,45.4,>30,IND,Home,Upto 2014
VS Hazare,IND,Pace,1952-11-13,Brabourne,India,1952,2,34,78,1,1,405,896,8,371,818,7,50.625,>30,IND,Home,Upto 2014
VS Hazare,IND,Pace,1952-11-28,Chennai,India,1952,1,28,36,0,1,235,515,6,207,479,6,39.166666666666664,>30,IND,Home,Upto 2014
VS Hazare,IND,Pace,1953-01-21,Port of Spain,West Indies,1953,1,30,72,0,1,431,1261,9,401,1189,9,47.888888888888886,>30,WI,Away,Upto 2014
VS Hazare,IND,Pace,1953-02-07,Bridgetown,West Indies,1953,2,14,66,2,1,175,498,7,161,432,5,25.0,<=30,WI,Away,Upto 2014
VS Hazare,IND,Pace,1953-02-19,Port of Spain,West Indies,1953,2,18,24,0,1,346,1003,10,328,979,10,34.6,>30,WI,Away,Upto 2014
VS Hazare,IND,Pace,1953-03-11,Georgetown,West Indies,1953,1,22,72,1,1,150,444,4,128,372,3,37.5,>30,WI,Away,Upto 2014
VS Hazare,IND,Pace,1953-03-28,Kingston,West Indies,1953,2,48,114,0,1,439,1284,11,391,1170,11,39.90909090909091,>30,WI,Away,Upto 2014
VS Ransford,AUS,Spin,1911-03-03,Sydney,Australia,1911,1,9,24,1,1,638,1067,19,629,1043,18,33.578947368421055,>30,AUS,Home,Upto 2014
VS Ransford,AUS,Spin,1911-12-30,Melbourne,Australia,1911,1,11,7,0,1,222,429,6,211,422,6,37.0,>30,AUS,Home,Upto 2014
VS Ransford,AUS,Spin,1912-02-09,Melbourne,Australia,1912,1,8,12,0,1,357,761,7,349,749,7,51.0,>30,AUS,Home,Upto 2014
VT Trumper,AUS,Pace,1901-12-13,Sydney,Australia,1901,1,0,6,0,1,416,1027,14,416,1021,14,29.714285714285715,<=30,AUS,Home,Upto 2014
VT Trumper,AUS,Pace,1902-01-01,Melbourne,Australia,1902,1,1,12,0,1,229,661,13,228,649,13,17.615384615384617,<=30,AUS,Home,Upto 2014
VT Trumper,AUS,Pace,1902-01-17,Adelaide,Australia,1902,1,17,36,0,1,342,876,5,325,840,5,68.4,>30,AUS,Home,Upto 2014
VT Trumper,AUS,Pace,1902-05-29,Birmingham,England,1902,1,35,78,2,1,229,582,9,194,504,7,25.444444444444443,<=30,ENG,Away,Upto 2014
VT Trumper,AUS,Pace,1902-06-12,Lord's,England,1902,1,33,48,0,1,82,168,2,49,120,2,41.0,>30,ENG,Away,Upto 2014
VT Trumper,AUS,Pace,1902-07-03,Sheffield,England,1902,2,27,60,0,1,311,559,11,284,499,11,28.272727272727273,<=30,ENG,Away,Upto 2014
VT Trumper,AUS,Pace,1902-07-24,Manchester,England,1902,1,6,36,0,1,194,433,13,188,397,13,14.923076923076923,<=30,ENG,Away,Upto 2014
VT Trumper,AUS,Pace,1902-10-11,Johannesburg,South Africa,1902,1,62,72,2,1,545,690,15,483,618,13,36.333333333333336,>30,SA,Away,Upto 2014
VT Trumper,AUS,Pace,1902-10-18,Johannesburg,South Africa,1902,2,87,90,3,1,466,648,16,379,558,13,29.125,<=30,SA,Away,Upto 2014
VT Trumper,AUS,Pace,1902-11-08,Cape Town,South Africa,1902,1,26,36,1,1,317,563,15,291,527,14,21.133333333333333,<=30,SA,Away,Upto 2014
VT Trumper,AUS,Pace,1903-12-11,Sydney,Australia,1903,1,12,42,0,1,649,1476,14,637,1434,14,46.357142857142854,>30,AUS,Home,Upto 2014
VT Trumper,AUS,Pace,1904-01-01,Melbourne,Australia,1904,1,4,6,0,1,196,525,10,192,519,10,19.6,<=30,AUS,Home,Upto 2014
VT Trumper,AUS,Pace,1904-01-15,Adelaide,Australia,1904,1,7,24,0,1,683,1465,19,676,1441,19,35.94736842105263,>30,AUS,Home,Upto 2014
VV Kumar,IND,Spin,1961-02-08,Delhi,India,1961,2,132,443,7,1,386,1389,14,254,946,7,27.571428571428573,<=30,IND,Home,Upto 2014
VV Kumar,IND,Spin,1961-11-11,Brabourne,India,1961,1,70,162,0,1,727,1890,18,657,1728,18,40.388888888888886,>30,IND,Home,Upto 2014
VVS Laxman,IND,Spin,1997-03-06,Kingston,West Indies,1997,2,28,36,0,1,464,982,9,436,946,9,51.55555555555556,>30,WI,Away,Upto 2014
VVS Laxman,IND,Spin,1997-03-14,Port of Spain,West Indies,1997,1,21,54,0,1,443,1095,13,422,1041,13,34.07692307692308,>30,WI,Away,Upto 2014
VVS Laxman,IND,Spin,1998-03-18,Eden Gardens,India,1998,1,1,6,0,1,634,1306,12,633,1300,12,52.833333333333336,>30,IND,Home,Upto 2014
VVS Laxman,IND,Spin,1998-03-25,Bengaluru,India,1998,1,1,6,0,1,817,1511,22,816,1505,22,37.13636363636363,>30,IND,Home,Upto 2014
VVS Laxman,IND,Spin,1999-01-28,Chennai,India,1999,1,10,12,0,1,572,1226,24,562,1214,24,23.833333333333332,<=30,IND,Home,Upto 2014
VVS Laxman,IND,Spin,1999-02-16,Eden Gardens,India,1999,1,4,12,0,1,375,758,8,371,746,8,46.875,>30,IND,Home,Upto 2014
VVS Laxman,IND,Spin,1999-12-10,Adelaide,Australia,1999,1,2,18,0,1,301,744,9,299,726,9,33.44444444444444,>30,AUS,Away,Upto 2014
VVS Laxman,IND,Spin,2000-11-18,Delhi,India,2000,1,1,6,0,1,622,1309,9,621,1303,9,69.11111111111111,>30,IND,Home,Upto 2014
VVS Laxman,IND,Spin,2002-05-10,St John's,West Indies,2002,1,32,102,1,1,261,672,7,229,570,6,37.285714285714285,>30,WI,Away,Upto 2014
VVS Laxman,IND,Spin,2007-08-09,The Oval,England,2007,1,5,6,0,1,584,973,9,579,967,9,64.88888888888889,>30,ENG,Away,Upto 2014
VVS Laxman,IND,Spin,2007-11-30,Eden Gardens,India,2007,1,2,6,1,1,851,1606,18,849,1600,17,47.27777777777778,>30,IND,Home,Upto 2014
VVS Laxman,IND,Spin,2008-03-26,Chennai,India,2008,1,19,60,0,1,758,1458,16,739,1398,16,47.375,>30,IND,Home,Upto 2014
VWC Jupp,ENG,Spin,1921-05-28,Nottingham,England,1921,2,27,49,1,1,235,583,9,208,534,8,26.11111111111111,<=30,ENG,Home,Upto 2014
VWC Jupp,ENG,Spin,1921-07-02,Leeds,England,1921,2,115,186,4,1,678,1167,22,563,981,18,30.818181818181817,>30,ENG,Home,Upto 2014
VWC Jupp,ENG,Spin,1922-12-23,Johannesburg,South Africa,1922,2,146,312,7,1,279,546,8,133,234,1,34.875,>30,SA,Away,Upto 2014
VWC Jupp,ENG,Spin,1923-01-01,Cape Town,South Africa,1923,2,41,120,2,1,228,702,14,187,582,12,16.285714285714285,<=30,SA,Away,Upto 2014
VWC Jupp,ENG,Spin,1923-01-18,Durban,South Africa,1923,1,70,136,2,1,244,574,4,174,438,2,61.0,>30,SA,Away,Upto 2014
VWC Jupp,ENG,Spin,1923-02-09,Johannesburg,South Africa,1923,2,75,162,3,1,356,732,8,281,570,5,44.5,>30,SA,Away,Upto 2014
VWC Jupp,ENG,Spin,1928-06-23,Lord's,England,1928,2,103,228,7,1,284,808,17,181,580,10,16.705882352941178,<=30,ENG,Home,Upto 2014
VWC Jupp,ENG,Spin,1928-07-21,Manchester,England,1928,1,39,108,2,1,291,903,19,252,795,17,15.31578947368421,<=30,ENG,Home,Upto 2014
W Attewell,ENG,Pace,1884-12-12,Adelaide,Australia,1884,2,74,272,1,1,319,830,6,245,558,5,53.166666666666664,>30,AUS,Away,After 1965
W Attewell,ENG,Pace,1885-01-01,Melbourne,Australia,1885,2,61,264,2,1,410,1218,21,349,954,19,19.523809523809526,<=30,AUS,Away,After 1965
W Attewell,ENG,Pace,1885-02-20,Sydney,Australia,1885,2,107,516,6,1,367,1227,19,260,711,13,19.31578947368421,<=30,AUS,Away,After 1965
W Attewell,ENG,Pace,1885-03-14,Sydney,Australia,1885,2,26,84,0,1,423,931,23,397,847,23,18.391304347826086,<=30,AUS,Away,After 1965
W Attewell,ENG,Pace,1885-03-21,Melbourne,Australia,1885,2,42,165,4,1,490,1192,20,448,1027,16,24.5,<=30,AUS,Away,After 1965
W Attewell,ENG,Pace,1888-02-10,Sydney,Australia,1888,1,4,18,2,1,187,670,24,183,652,22,7.791666666666667,<=30,AUS,Away,After 1965
W Attewell,ENG,Pace,1890-07-21,Lord's,England,1890,2,96,372,5,1,361,1213,17,265,841,12,21.235294117647058,<=30,ENG,Home,After 1965
W Attewell,ENG,Pace,1892-01-01,Melbourne,Australia,1892,2,79,493,3,1,677,2425,30,598,1932,27,22.566666666666666,<=30,AUS,Away,After 1965
W Attewell,ENG,Pace,1892-01-29,Sydney,Australia,1892,2,68,462,2,1,735,2292,31,667,1830,29,23.70967741935484,<=30,AUS,Away,After 1965
W Attewell,ENG,Pace,1892-03-24,Adelaide,Australia,1892,1,69,204,3,1,529,1333,15,460,1129,12,35.266666666666666,>30,AUS,Away,After 1965
W Barber,ENG,Pace,1935-07-13,Leeds,England,1935,1,0,2,1,1,570,1397,20,570,1395,19,28.5,<=30,ENG,Home,Upto 2014
W Barnes,ENG,Pace,1880-09-06,The Oval,England,1880,1,17,35,1,1,186,458,12,169,423,11,15.5,<=30,ENG,Home,After 1965
W Barnes,ENG,Pace,1882-08-28,The Oval,England,1882,1,15,48,1,1,213,651,23,198,603,22,9.26086956521739,<=30,ENG,Home,After 1965
W Barnes,ENG,Pace,1882-12-30,Melbourne,Australia,1882,2,57,172,3,1,380,1024,17,323,852,14,22.352941176470587,<=30,AUS,Away,After 1965
W Barnes,ENG,Pace,1883-01-19,Melbourne,Australia,1883,2,36,104,2,1,335,900,10,299,796,8,33.5,>30,AUS,Away,After 1965
W Barnes,ENG,Pace,1883-01-26,Sydney,Australia,1883,1,22,52,1,1,439,1288,28,417,1236,27,15.678571428571429,<=30,AUS,Away,After 1965
W Barnes,ENG,Pace,1883-02-17,Sydney,Australia,1883,2,55,104,0,1,382,973,10,327,869,10,38.2,>30,AUS,Away,After 1965
W Barnes,ENG,Pace,1884-07-10,Manchester,England,1884,1,25,76,1,1,208,652,12,183,576,11,17.333333333333332,<=30,ENG,Home,After 1965
W Barnes,ENG,Pace,1884-08-11,The Oval,England,1884,1,81,208,2,1,468,1104,7,387,896,5,66.85714285714286,>30,ENG,Home,After 1965
W Barnes,ENG,Pace,1884-12-12,Adelaide,Australia,1884,2,88,180,3,1,319,830,6,231,650,3,53.166666666666664,>30,AUS,Away,After 1965
W Barnes,ENG,Pace,1885-01-01,Melbourne,Australia,1885,2,81,355,9,1,410,1218,21,329,863,12,19.523809523809526,<=30,AUS,Away,After 1965
W Barnes,ENG,Pace,1885-03-14,Sydney,Australia,1885,2,76,179,5,1,423,931,23,347,752,18,18.391304347826086,<=30,AUS,Away,After 1965
W Barnes,ENG,Pace,1885-03-21,Melbourne,Australia,1885,1,47,112,2,1,490,1192,20,443,1080,18,24.5,<=30,AUS,Away,After 1965
W Barnes,ENG,Pace,1886-07-19,Lord's,England,1886,2,43,99,4,1,322,1023,13,279,924,9,24.76923076923077,<=30,ENG,Home,After 1965
W Barnes,ENG,Pace,1886-08-12,The Oval,England,1886,1,10,28,0,1,385,1143,19,375,1115,19,20.263157894736842,<=30,ENG,Home,After 1965
W Barnes,ENG,Pace,1887-01-28,Sydney,Australia,1887,2,47,273,8,1,241,1003,28,194,730,20,8.607142857142858,<=30,AUS,Away,After 1965
W Barnes,ENG,Pace,1888-07-16,Lord's,England,1888,1,17,24,0,1,147,372,17,130,348,17,8.647058823529411,<=30,ENG,Home,After 1965
W Barnes,ENG,Pace,1888-08-13,The Oval,England,1888,2,50,180,7,1,274,691,16,224,511,9,17.125,<=30,ENG,Home,After 1965
W Barnes,ENG,Pace,1890-07-21,Lord's,England,1890,2,26,60,2,1,361,1213,17,335,1153,15,21.235294117647058,<=30,ENG,Home,After 1965
W Bates,ENG,Spin,1881-12-31,Melbourne,Australia,1881,2,86,216,4,1,812,2321,24,726,2105,20,33.833333333333336,>30,AUS,Away,After 1965
W Bates,ENG,Spin,1882-02-17,Sydney,Australia,1882,2,89,384,5,1,520,1846,24,431,1462,19,21.666666666666668,<=30,AUS,Away,After 1965
W Bates,ENG,Spin,1882-03-03,Sydney,Australia,1882,2,110,251,4,1,374,1277,25,264,1026,21,14.96,<=30,AUS,Away,After 1965
W Bates,ENG,Spin,1882-03-10,Melbourne,Australia,1882,1,49,113,3,1,397,773,12,348,660,9,33.083333333333336,>30,AUS,Away,After 1965
W Bates,ENG,Spin,1882-12-30,Melbourne,Australia,1882,2,53,137,1,1,291,692,13,238,555,12,22.384615384615383,<=30,AUS,Away,After 1965
W Bates,ENG,Spin,1883-01-19,Melbourne,Australia,1883,2,102,238,14,1,205,505,19,103,267,5,10.789473684210526,<=30,AUS,Away,After 1965
W Bates,ENG,Spin,1883-01-26,Sydney,Australia,1883,1,55,180,1,1,194,600,10,139,420,9,19.4,<=30,AUS,Away,After 1965
W Bates,ENG,Spin,1883-02-17,Sydney,Australia,1883,2,76,216,3,1,484,1391,24,408,1175,21,20.166666666666668,<=30,AUS,Away,After 1965
W Bates,ENG,Spin,1884-12-12,Adelaide,Australia,1884,2,57,133,5,1,511,1330,22,454,1197,17,23.227272727272727,<=30,AUS,Away,After 1965
W Bates,ENG,Spin,1885-01-01,Melbourne,Australia,1885,1,17,68,0,1,372,1209,9,355,1141,9,41.333333333333336,>30,AUS,Away,After 1965
W Bates,ENG,Spin,1885-02-20,Sydney,Australia,1885,2,30,104,5,1,276,897,19,246,793,14,14.526315789473685,<=30,AUS,Away,After 1965
W Bates,ENG,Spin,1885-03-14,Sydney,Australia,1885,1,44,68,0,1,238,508,7,194,440,7,34.0,>30,AUS,Away,After 1965
W Bates,ENG,Spin,1887-01-28,Sydney,Australia,1887,2,27,152,1,1,172,567,12,145,415,11,14.333333333333334,<=30,AUS,Away,After 1965
W Bates,ENG,Spin,1887-02-25,Sydney,Australia,1887,1,26,104,4,1,268,812,19,242,708,15,14.105263157894736,<=30,AUS,Away,After 1965
W Bell,NZ,Spin,1954-01-01,Cape Town,South Africa,1954,2,99,192,0,1,639,1815,13,540,1623,13,49.15384615384615,>30,SA,Away,Upto 2014
W Bell,NZ,Spin,1954-02-05,Gqeberha,South Africa,1954,2,136,299,2,1,529,1620,15,393,1321,13,35.266666666666666,>30,SA,Away,Upto 2014
W Brearley,ENG,Pace,1905-07-24,Manchester,England,1905,2,126,186,8,1,572,1050,20,446,864,12,28.6,<=30,ENG,Home,Upto 2014
W Brearley,ENG,Pace,1905-08-14,The Oval,England,1905,2,151,253,6,1,775,1333,24,624,1080,18,32.291666666666664,>30,ENG,Home,Upto 2014
W Brearley,ENG,Pace,1909-07-01,Leeds,England,1909,2,78,230,3,1,393,1142,20,315,912,17,19.65,<=30,ENG,Home,Upto 2014
W Brearley,ENG,Pace,1912-06-10,Lord's,England,1912,1,4,36,0,1,280,781,22,276,745,22,12.727272727272727,<=30,ENG,Home,Upto 2014
W Brockwell,ENG,Pace,1893-08-24,Manchester,England,1893,1,17,15,0,1,557,1484,22,540,1469,22,25.318181818181817,<=30,ENG,Home,After 1965
W Brockwell,ENG,Pace,1894-12-14,Sydney,Australia,1894,1,78,132,1,1,993,2418,24,915,2286,23,41.375,>30,AUS,Away,After 1965
W Brockwell,ENG,Pace,1894-12-29,Melbourne,Australia,1894,1,33,84,3,1,653,1784,28,620,1700,25,23.321428571428573,<=30,AUS,Away,After 1965
W Brockwell,ENG,Pace,1895-01-11,Adelaide,Australia,1895,2,80,180,1,1,553,1201,23,473,1021,22,24.043478260869566,<=30,AUS,Away,After 1965
W Brockwell,ENG,Pace,1895-02-01,Sydney,Australia,1895,1,25,30,0,1,216,539,18,191,509,18,12.0,<=30,AUS,Away,After 1965
W Brockwell,ENG,Pace,1895-03-01,Melbourne,Australia,1895,1,22,36,0,1,615,1328,15,593,1292,15,41.0,>30,AUS,Away,After 1965
W Brockwell,ENG,Pace,1899-07-17,Manchester,England,1899,2,54,105,0,1,742,1679,23,688,1574,23,32.26086956521739,>30,ENG,Home,After 1965
W Bruce,AUS,Pace,1885-01-01,Melbourne,Australia,1885,2,92,221,3,1,410,1218,21,318,997,18,19.523809523809526,<=30,AUS,Home,After 1965
W Bruce,AUS,Pace,1885-03-21,Melbourne,Australia,1885,1,99,204,3,1,490,1192,20,391,988,17,24.5,<=30,AUS,Home,After 1965
W Bruce,AUS,Pace,1886-07-05,Manchester,England,1886,1,9,40,0,1,434,1426,26,425,1386,26,16.692307692307693,<=30,ENG,Away,After 1965
W Bruce,AUS,Pace,1886-08-12,The Oval,England,1886,1,9,24,0,1,385,1143,19,376,1119,19,20.263157894736842,<=30,ENG,Away,After 1965
W Bruce,AUS,Pace,1892-01-01,Melbourne,Australia,1892,1,18,18,0,1,677,2425,30,659,2407,30,22.566666666666666,<=30,AUS,Home,After 1965
W Bruce,AUS,Pace,1892-03-24,Adelaide,Australia,1892,1,19,54,0,1,529,1333,15,510,1279,15,35.266666666666666,>30,AUS,Home,After 1965
W Bruce,AUS,Pace,1893-07-17,Lord's,England,1893,2,92,210,3,1,548,1355,26,456,1145,23,21.076923076923077,<=30,ENG,Away,After 1965
W Bruce,AUS,Pace,1893-08-14,The Oval,England,1893,1,19,15,0,1,575,1100,17,556,1085,17,33.8235294117647,>30,ENG,Away,After 1965
W Bruce,AUS,Pace,1893-08-24,Manchester,England,1893,2,45,130,2,1,557,1484,22,512,1354,20,25.318181818181817,<=30,ENG,Away,After 1965
W Bruce,AUS,Pace,1894-12-29,Melbourne,Australia,1894,1,21,24,1,1,653,1784,28,632,1760,27,23.321428571428573,<=30,AUS,Home,After 1965
W Bruce,AUS,Pace,1895-03-01,Melbourne,Australia,1895,2,17,48,0,1,615,1328,15,598,1280,15,41.0,>30,AUS,Home,After 1965
W Ferguson,WI,Spin,1948-01-21,Bridgetown,West Indies,1948,2,56,106,2,1,610,1348,22,554,1242,20,27.727272727272727,<=30,WI,Home,Upto 2014
W Ferguson,WI,Spin,1948-02-11,Port of Spain,West Indies,1948,2,229,440,11,1,644,1409,17,415,969,6,37.88235294117647,>30,WI,Home,Upto 2014
W Ferguson,WI,Spin,1948-03-03,Georgetown,West Indies,1948,2,139,330,8,1,451,1064,19,312,734,11,23.736842105263158,<=30,WI,Home,Upto 2014
W Ferguson,WI,Spin,1948-03-27,Kingston,West Indies,1948,2,143,420,2,1,658,1636,13,515,1216,11,50.61538461538461,>30,WI,Home,Upto 2014
W Ferguson,WI,Spin,1948-12-09,Brabourne,India,1948,2,231,576,5,1,780,1868,11,549,1292,6,70.9090909090909,>30,IND,Away,Upto 2014
W Ferguson,WI,Spin,1948-12-31,Eden Gardens,India,1948,2,101,228,3,1,677,1523,19,576,1295,16,35.63157894736842,>30,IND,Away,Upto 2014
W Ferguson,WI,Spin,1949-01-27,Chennai,India,1949,2,111,186,2,1,495,939,11,384,753,9,45.0,>30,IND,Away,Upto 2014
W Ferguson,WI,Spin,1954-03-17,Port of Spain,West Indies,1954,1,155,282,1,1,1025,1930,13,870,1648,12,78.84615384615384,>30,WI,Home,Upto 2014
W Flowers,ENG,Spin,1884-12-12,Adelaide,Australia,1884,2,54,104,0,1,511,1330,22,457,1226,22,23.227272727272727,<=30,AUS,Away,After 1965
W Flowers,ENG,Spin,1885-01-01,Melbourne,Australia,1885,2,57,160,2,1,372,1209,9,315,1049,7,41.333333333333336,>30,AUS,Away,After 1965
W Flowers,ENG,Spin,1885-02-20,Sydney,Australia,1885,2,65,264,5,1,276,897,19,211,633,14,14.526315789473685,<=30,AUS,Away,After 1965
W Flowers,ENG,Spin,1885-03-14,Sydney,Australia,1885,2,30,71,1,1,238,508,7,208,437,6,34.0,>30,AUS,Away,After 1965
W Flowers,ENG,Spin,1885-03-21,Melbourne,Australia,1885,2,43,120,3,1,142,528,10,99,408,7,14.2,<=30,AUS,Away,After 1965
W Flowers,ENG,Spin,1887-02-25,Sydney,Australia,1887,2,26,84,2,1,268,812,19,242,728,17,14.105263157894736,<=30,AUS,Away,After 1965
W Flowers,ENG,Spin,1893-07-17,Lord's,England,1893,1,21,55,1,1,216,425,2,195,370,1,108.0,>30,ENG,Home,After 1965
W Jaffer,IND,Spin,2002-05-10,St John's,West Indies,2002,1,18,66,2,1,261,672,7,243,606,5,37.285714285714285,>30,WI,Away,Upto 2014
W Madhevere,ZIM,Spin,2021-03-02,Abu Dhabi,UAE,2021,1,6,24,0,1,274,533,12,268,509,12,22.833333333333332,<=30,UAE,Away,After 1965
W Madhevere,ZIM,Spin,2021-03-10,Abu Dhabi,UAE,2021,1,36,54,0,1,842,1766,20,806,1712,20,42.1,>30,UAE,Away,After 1965
W Mathias,PAK,Pace,1958-02-26,Kingston,West Indies,1958,1,20,24,0,1,916,1594,17,896,1570,17,53.88235294117647,>30,WI,Away,Upto 2014
W Mead,ENG,Spin,1899-06-15,Lord's,England,1899,1,91,265,1,1,387,894,12,296,629,11,32.25,>30,ENG,Home,After 1965
W Mwayenga,ZIM,Pace,2005-09-20,Harare,Zimbabwe,2005,1,79,126,1,1,559,997,27,480,871,26,20.703703703703702,<=30,ZIM,Home,Upto 2014
W O'Rourke,NZ,Pace,2024-02-13,Hamilton,New Zealand,2024,2,93,193,9,1,507,1179,18,414,986,9,28.166666666666668,<=30,NZ,Home,After 1965
W O'Rourke,NZ,Pace,2024-02-29,Wellington,New Zealand,2024,2,98,209,2,1,689,1266,22,591,1057,20,31.318181818181817,>30,NZ,Home,After 1965
W O'Rourke,NZ,Pace,2024-09-18,Galle,Sri Lanka,2024,2,104,215,8,1,264,533,10,160,318,2,26.4,<=30,SL,Away,After 1965
W O'Rourke,NZ,Pace,2024-09-26,Galle,Sri Lanka,2024,1,81,102,0,1,205,300,2,124,198,2,102.5,>30,SL,Away,After 1965
W O'Rourke,NZ,Pace,2024-10-16,Bengaluru,India,2024,2,114,198,7,1,462,863,22,348,665,15,21.0,<=30,IND,Away,After 1965
W O'Rourke,NZ,Pace,2024-10-24,Pune,India,2024,2,10,24,0,1,141,192,1,131,168,1,141.0,>30,IND,Away,After 1965
W O'Rourke,NZ,Pace,2024-11-01,Wankhede,India,2024,1,5,12,0,1,89,174,4,84,162,4,22.25,<=30,IND,Away,After 1965
W O'Rourke,NZ,Pace,2024-11-28,Christchurch,New Zealand,2024,2,165,168,2,1,709,1026,15,544,858,13,47.266666666666666,>30,NZ,Home,After 1965
W O'Rourke,NZ,Pace,2024-12-06,Wellington,New Zealand,2024,2,153,183,4,1,601,832,22,448,649,18,27.318181818181817,<=30,NZ,Home,After 1965
W O'Rourke,NZ,Pace,2024-12-14,Hamilton,New Zealand,2024,2,70,120,4,1,652,1099,24,582,979,20,27.166666666666668,<=30,NZ,Home,After 1965
W Rhodes,ENG,Spin,1899-06-01,Nottingham,England,1899,2,118,277,7,1,270,732,12,152,455,5,22.5,<=30,ENG,Home,After 1965
W Rhodes,ENG,Spin,1899-06-15,Lord's,England,1899,2,117,220,3,1,387,894,12,270,674,9,32.25,>30,ENG,Home,After 1965
W Rhodes,ENG,Spin,1899-08-14,The Oval,England,1899,2,106,235,3,1,465,899,10,359,664,7,46.5,>30,ENG,Home,After 1965
W Rhodes,ENG,Spin,1902-05-29,Birmingham,England,1902,2,26,126,8,1,217,576,11,191,450,3,19.727272727272727,<=30,ENG,Home,Upto 2014
W Rhodes,ENG,Spin,1902-07-03,Sheffield,England,1902,2,96,181,6,1,486,1005,28,390,824,22,17.357142857142858,<=30,ENG,Home,Upto 2014
W Rhodes,ENG,Spin,1902-07-24,Manchester,England,1902,2,130,238,7,1,549,1292,26,419,1054,19,21.115384615384617,<=30,ENG,Home,Upto 2014
W Rhodes,ENG,Spin,1902-08-11,The Oval,England,1902,2,84,300,1,1,548,1222,24,464,922,23,22.833333333333332,<=30,ENG,Home,Upto 2014
W Rhodes,ENG,Spin,1903-12-11,Sydney,Australia,1903,2,135,346,7,1,839,1769,19,704,1423,12,44.1578947368421,>30,AUS,Away,Upto 2014
W Rhodes,ENG,Spin,1904-01-01,Melbourne,Australia,1904,2,124,182,15,1,442,925,27,318,743,12,16.37037037037037,<=30,AUS,Away,Upto 2014
W Rhodes,ENG,Spin,1904-01-15,Adelaide,Australia,1904,2,91,210,2,1,537,1176,17,446,966,15,31.58823529411765,>30,AUS,Away,Upto 2014
W Rhodes,ENG,Spin,1904-02-26,Sydney,Australia,1904,2,45,132,4,1,399,1183,23,354,1051,19,17.347826086956523,<=30,AUS,Away,Upto 2014
W Rhodes,ENG,Spin,1904-03-05,Melbourne,Australia,1904,2,93,162,3,1,273,552,23,180,390,20,11.869565217391305,<=30,AUS,Away,Upto 2014
W Rhodes,ENG,Spin,1905-05-29,Nottingham,England,1905,2,95,288,2,1,379,970,12,284,682,10,31.583333333333332,>30,ENG,Home,Upto 2014
W Rhodes,ENG,Spin,1905-06-15,Lord's,England,1905,1,70,97,3,1,233,619,9,163,522,6,25.88888888888889,<=30,ENG,Home,Upto 2014
W Rhodes,ENG,Spin,1905-07-24,Manchester,England,1905,2,61,104,5,1,187,487,8,126,383,3,23.375,<=30,ENG,Home,Upto 2014
W Rhodes,ENG,Spin,1905-08-14,The Oval,England,1905,2,88,174,0,1,332,711,4,244,537,4,83.0,>30,ENG,Home,Upto 2014
W Rhodes,ENG,Spin,1907-12-13,Sydney,Australia,1907,2,26,72,1,1,592,1308,17,566,1236,16,34.8235294117647,>30,AUS,Away,Upto 2014
W Rhodes,ENG,Spin,1908-01-01,Melbourne,Australia,1908,2,75,162,1,1,799,1914,21,724,1752,20,38.04761904761905,>30,AUS,Away,Upto 2014
W Rhodes,ENG,Spin,1908-01-10,Adelaide,Australia,1908,2,116,252,0,1,776,1611,17,660,1359,17,45.64705882352941,>30,AUS,Away,Upto 2014
W Rhodes,ENG,Spin,1908-02-07,Melbourne,Australia,1908,2,87,174,1,1,481,1034,24,394,860,23,20.041666666666668,<=30,AUS,Away,Upto 2014
W Rhodes,ENG,Spin,1908-02-21,Sydney,Australia,1908,2,117,286,4,1,812,1824,30,695,1538,26,27.066666666666666,<=30,AUS,Away,Upto 2014
W Rhodes,ENG,Spin,1909-05-27,Birmingham,England,1909,1,8,6,0,1,222,633,19,214,627,19,11.68421052631579,<=30,ENG,Home,Upto 2014
W Rhodes,ENG,Spin,1909-07-01,Leeds,England,1909,2,82,162,6,1,230,608,17,148,446,11,13.529411764705882,<=30,ENG,Home,Upto 2014
W Rhodes,ENG,Spin,1909-07-26,Manchester,England,1909,1,83,150,5,1,297,675,13,214,525,8,22.846153846153847,<=30,ENG,Home,Upto 2014
W Rhodes,ENG,Spin,1909-08-09,The Oval,England,1909,2,69,156,0,1,627,1104,11,558,948,11,57.0,>30,ENG,Home,Upto 2014
W Rhodes,ENG,Spin,1910-01-01,Johannesburg,South Africa,1910,2,59,108,1,1,593,1077,29,534,969,28,20.448275862068964,<=30,SA,Away,Upto 2014
W Rhodes,ENG,Spin,1910-01-21,Durban,South Africa,1910,2,54,144,0,1,565,1312,24,511,1168,24,23.541666666666668,<=30,SA,Away,Upto 2014
W Rhodes,ENG,Spin,1910-02-26,Johannesburg,South Africa,1910,2,10,30,1,1,662,1226,24,652,1196,23,27.583333333333332,<=30,SA,Away,Upto 2014
W Rhodes,ENG,Spin,1910-03-07,Cape Town,South Africa,1910,1,2,18,0,1,379,765,17,377,747,17,22.294117647058822,<=30,SA,Away,Upto 2014
W Rhodes,ENG,Spin,1910-03-11,Cape Town,South Africa,1910,1,22,42,0,1,488,932,19,466,890,19,25.68421052631579,<=30,SA,Away,Upto 2014
W Rhodes,ENG,Spin,1911-12-15,Sydney,Australia,1911,2,30,66,0,1,459,926,15,429,860,15,30.6,>30,AUS,Away,Upto 2014
W Rhodes,ENG,Spin,1911-12-30,Melbourne,Australia,1911,1,3,12,0,1,222,429,6,219,417,6,37.0,>30,AUS,Away,Upto 2014
W Rhodes,ENG,Spin,1912-01-12,Adelaide,Australia,1912,1,6,6,0,1,429,843,6,423,837,6,71.5,>30,AUS,Away,Upto 2014
W Rhodes,ENG,Spin,1912-02-09,Melbourne,Australia,1912,1,1,12,0,1,357,761,7,356,749,7,51.0,>30,AUS,Away,Upto 2014
W Rhodes,ENG,Spin,1912-02-23,Sydney,Australia,1912,1,17,12,0,1,473,1119,22,456,1107,22,21.5,<=30,AUS,Away,Upto 2014
W Rhodes,ENG,Spin,1912-06-24,Lord's,England,1912,1,59,116,3,1,243,530,6,184,414,3,40.5,>30,ENG,Home,Upto 2014
W Rhodes,ENG,Spin,1912-07-08,Leeds,England,1912,1,14,24,0,1,384,746,14,370,722,14,27.428571428571427,<=30,ENG,Home,Upto 2014
W Rhodes,ENG,Spin,1912-08-19,The Oval,England,1912,1,1,12,0,1,252,792,19,251,780,19,13.263157894736842,<=30,ENG,Home,Upto 2014
W Rhodes,ENG,Spin,1913-12-13,Durban,South Africa,1913,1,26,42,0,1,212,468,8,186,426,8,26.5,<=30,SA,Away,Upto 2014
W Rhodes,ENG,Spin,1913-12-26,Johannesburg,South Africa,1913,2,43,132,1,1,283,660,6,240,528,5,47.166666666666664,>30,SA,Away,Upto 2014
W Rhodes,ENG,Spin,1914-01-01,Johannesburg,South Africa,1914,2,26,59,1,1,388,857,18,362,798,17,21.555555555555557,<=30,SA,Away,Upto 2014
W Rhodes,ENG,Spin,1914-02-14,Durban,South Africa,1914,2,86,240,4,1,337,984,14,251,744,10,24.071428571428573,<=30,SA,Away,Upto 2014
W Rhodes,ENG,Spin,1914-02-27,Gqeberha,South Africa,1914,1,14,60,0,1,377,889,10,363,829,10,37.7,>30,SA,Away,Upto 2014
W Rhodes,ENG,Spin,1920-12-17,Sydney,Australia,1920,1,67,132,0,1,783,1682,19,716,1550,19,41.21052631578947,>30,AUS,Away,Upto 2014
W Rhodes,ENG,Spin,1920-12-31,Melbourne,Australia,1920,1,26,51,1,1,436,860,13,410,809,12,33.53846153846154,>30,AUS,Away,Upto 2014
W Rhodes,ENG,Spin,1921-01-14,Adelaide,Australia,1921,2,84,185,3,1,920,1706,23,836,1521,20,40.0,>30,AUS,Away,Upto 2014
W Rhodes,ENG,Spin,1921-02-11,Melbourne,Australia,1921,1,25,60,0,1,636,1301,23,611,1241,23,27.652173913043477,<=30,AUS,Away,Upto 2014
W Rhodes,ENG,Spin,1921-02-25,Sydney,Australia,1921,2,43,86,0,1,605,1063,17,562,977,17,35.588235294117645,>30,AUS,Away,Upto 2014
W Rhodes,ENG,Spin,1921-05-28,Nottingham,England,1921,1,33,78,2,1,235,583,9,202,505,7,26.11111111111111,<=30,ENG,Home,Upto 2014
W Rhodes,ENG,Spin,1926-08-14,The Oval,England,1926,2,79,270,6,1,808,2213,28,729,1943,22,28.857142857142858,<=30,ENG,Home,Upto 2014
W Rhodes,ENG,Spin,1930-01-11,Bridgetown,West Indies,1930,2,154,469,3,1,542,1217,16,388,748,13,33.875,>30,WI,Away,Upto 2014
W Rhodes,ENG,Spin,1930-02-01,Port of Spain,West Indies,1930,2,71,252,1,1,356,890,8,285,638,7,44.5,>30,WI,Away,Upto 2014
W Rhodes,ENG,Spin,1930-02-21,Georgetown,West Indies,1930,2,189,546,4,1,461,1269,13,272,723,9,35.46153846153846,>30,WI,Away,Upto 2014
W Rhodes,ENG,Spin,1930-04-03,Kingston,West Indies,1930,2,39,269,2,1,1040,2209,18,1001,1940,16,57.77777777777778,>30,WI,Away,Upto 2014
W Storer,ENG,Spin,1898-01-01,Melbourne,Australia,1898,1,55,96,1,1,483,1191,22,428,1095,21,21.954545454545453,<=30,AUS,Away,After 1965
W Storer,ENG,Spin,1898-01-14,Adelaide,Australia,1898,1,16,18,0,1,414,1001,10,398,983,10,41.4,>30,AUS,Away,After 1965
W Storer,ENG,Spin,1898-01-29,Melbourne,Australia,1898,1,24,24,1,1,328,761,11,304,737,10,29.818181818181817,<=30,AUS,Away,After 1965
W Storer,ENG,Spin,1898-02-26,Sydney,Australia,1898,1,13,30,0,1,340,888,10,327,858,10,34.0,>30,AUS,Away,After 1965
W Voce,ENG,Pace,1930-01-11,Bridgetown,West Indies,1930,2,135,180,2,1,797,1692,15,662,1512,13,53.13333333333333,>30,WI,Away,Upto 2014
W Voce,ENG,Pace,1930-02-01,Port of Spain,West Indies,1930,2,149,392,11,1,688,1491,29,539,1099,18,23.724137931034484,<=30,WI,Away,Upto 2014
W Voce,ENG,Pace,1930-02-21,Georgetown,West Indies,1930,2,125,252,2,1,688,1706,25,563,1454,23,27.52,<=30,WI,Away,Upto 2014
W Voce,ENG,Pace,1930-04-03,Kingston,West Indies,1930,2,175,306,2,1,684,1474,14,509,1168,12,48.857142857142854,>30,WI,Away,Upto 2014
W Voce,ENG,Pace,1930-12-24,Johannesburg,South Africa,1930,2,104,320,8,1,390,954,25,286,634,17,15.6,<=30,SA,Away,Upto 2014
W Voce,ENG,Pace,1931-01-01,Cape Town,South Africa,1931,1,95,198,0,1,323,942,8,228,744,8,40.375,>30,SA,Away,Upto 2014
W Voce,ENG,Pace,1931-01-16,Durban,South Africa,1931,2,72,248,6,1,276,836,9,204,588,3,30.666666666666668,>30,SA,Away,Upto 2014
W Voce,ENG,Pace,1931-02-13,Johannesburg,South Africa,1931,2,193,444,5,1,670,1471,21,477,1027,16,31.904761904761905,>30,SA,Away,Upto 2014
W Voce,ENG,Pace,1931-02-21,Durban,South Africa,1931,2,97,294,4,1,308,822,11,211,528,7,28.0,<=30,SA,Away,Upto 2014
W Voce,ENG,Pace,1931-06-27,Lord's,England,1931,2,100,252,0,1,463,1131,13,363,879,13,35.61538461538461,>30,ENG,Home,Upto 2014
W Voce,ENG,Pace,1932-06-25,Lord's,England,1932,2,51,174,5,1,543,1480,28,492,1306,23,19.392857142857142,<=30,ENG,Home,Upto 2014
W Voce,ENG,Pace,1932-12-02,Sydney,Australia,1932,2,164,279,6,1,694,1474,26,530,1195,20,26.692307692307693,<=30,AUS,Away,Upto 2014
W Voce,ENG,Pace,1932-12-30,Melbourne,Australia,1932,2,101,210,5,1,475,1034,22,374,824,17,21.59090909090909,<=30,AUS,Away,Upto 2014
W Voce,ENG,Pace,1933-01-13,Adelaide,Australia,1933,2,28,108,1,1,549,1333,23,521,1225,22,23.869565217391305,<=30,AUS,Away,Upto 2014
W Voce,ENG,Pace,1933-02-23,Sydney,Australia,1933,2,114,204,3,1,693,1194,12,579,990,9,57.75,>30,AUS,Away,Upto 2014
W Voce,ENG,Pace,1933-03-24,Christchurch,New Zealand,1933,2,40,127,3,1,467,920,9,427,793,6,51.888888888888886,>30,NZ,Away,Upto 2014
W Voce,ENG,Pace,1933-03-31,Auckland,New Zealand,1933,2,22,68,2,1,344,794,12,322,726,10,28.666666666666668,<=30,NZ,Away,Upto 2014
W Voce,ENG,Pace,1936-08-15,The Oval,England,1936,2,86,240,1,1,678,1230,17,592,990,16,39.88235294117647,>30,ENG,Home,Upto 2014
W Voce,ENG,Pace,1936-12-04,Brisbane,Australia,1936,2,57,217,10,1,297,839,25,240,622,15,11.88,<=30,AUS,Away,Upto 2014
W Voce,ENG,Pace,1936-12-18,Sydney,Australia,1936,2,76,216,7,1,331,936,17,255,720,10,19.470588235294116,<=30,AUS,Away,Upto 2014
W Voce,ENG,Pace,1937-01-01,Melbourne,Australia,1937,2,169,376,5,1,510,1173,17,341,797,12,30.0,<=30,AUS,Away,Upto 2014
W Voce,ENG,Pace,1937-01-29,Adelaide,Australia,1937,2,135,256,1,1,675,1448,20,540,1192,19,33.75,>30,AUS,Away,Upto 2014
W Voce,ENG,Pace,1937-02-26,Melbourne,Australia,1937,1,123,232,3,1,632,1154,16,509,922,13,39.5,>30,AUS,Away,Upto 2014
W Voce,ENG,Pace,1937-06-26,Lord's,England,1937,2,115,259,5,1,544,1216,20,429,957,15,27.2,<=30,ENG,Home,Upto 2014
W Voce,ENG,Pace,1946-07-20,Manchester,England,1946,2,46,156,1,1,495,1476,27,449,1320,26,18.333333333333332,<=30,ENG,Home,Upto 2014
W Voce,ENG,Pace,1946-11-29,Brisbane,Australia,1946,1,92,224,0,1,604,1516,23,512,1292,23,26.26086956521739,<=30,AUS,Away,Upto 2014
W Voce,ENG,Pace,1947-01-01,Melbourne,Australia,1947,2,69,128,0,1,922,1990,21,853,1862,21,43.904761904761905,>30,AUS,Away,Upto 2014
W Watson,NZ,Pace,1986-07-24,Lord's,England,1986,2,120,282,2,1,599,1428,17,479,1146,15,35.23529411764706,>30,ENG,Away,Upto 2014
W Watson,NZ,Pace,1986-08-07,Nottingham,England,1986,2,76,155,2,1,656,1476,21,580,1321,19,31.238095238095237,>30,ENG,Away,Upto 2014
W Watson,NZ,Pace,1989-11-24,W.A.C.A,Australia,1989,1,118,222,0,1,939,2255,25,821,2033,25,37.56,>30,AUS,Away,Upto 2014
W Watson,NZ,Pace,1990-10-10,Karachi,Pakistan,1990,1,125,240,1,1,575,1344,23,450,1104,22,25.0,<=30,PAK,Away,Upto 2014
W Watson,NZ,Pace,1990-10-18,Lahore,Pakistan,1990,2,90,228,6,1,697,1583,26,607,1355,20,26.807692307692307,<=30,PAK,Away,Upto 2014
W Watson,NZ,Pace,1990-10-26,Faisalabad,Pakistan,1990,2,106,357,4,1,725,1761,39,619,1404,35,18.58974358974359,<=30,PAK,Away,Upto 2014
W Watson,NZ,Pace,1991-01-31,Wellington,New Zealand,1991,1,121,277,4,1,940,1788,23,819,1511,19,40.869565217391305,>30,NZ,Home,Upto 2014
W Watson,NZ,Pace,1991-02-22,Hamilton,New Zealand,1991,2,140,382,5,1,916,2000,25,776,1618,20,36.64,>30,NZ,Home,Upto 2014
W Watson,NZ,Pace,1991-03-01,Auckland,New Zealand,1991,2,104,245,3,1,890,1772,29,786,1527,26,30.689655172413794,>30,NZ,Home,Upto 2014
W Watson,NZ,Pace,1992-01-30,Auckland,New Zealand,1992,2,100,300,3,1,740,1678,33,640,1378,30,22.424242424242426,<=30,NZ,Home,Upto 2014
W Watson,NZ,Pace,1992-11-01,Bulawayo,Zimbabwe,1992,2,31,84,0,1,481,878,7,450,794,7,68.71428571428571,>30,ZIM,Away,Upto 2014
W Watson,NZ,Pace,1992-11-07,Harare,Zimbabwe,1992,2,54,168,2,1,623,1378,20,569,1210,18,31.15,>30,ZIM,Away,Upto 2014
W Watson,NZ,Pace,1993-03-04,Wellington,New Zealand,1993,1,60,174,1,1,647,1552,21,587,1378,20,30.80952380952381,>30,NZ,Home,Upto 2014
W Watson,NZ,Pace,1993-03-12,Auckland,New Zealand,1993,2,90,228,6,1,620,1465,22,530,1237,16,28.181818181818183,<=30,NZ,Home,Upto 2014
W Watson,NZ,Pace,1993-11-12,W.A.C.A,Australia,1993,1,52,144,1,1,942,1817,19,890,1673,18,49.578947368421055,>30,AUS,Away,Upto 2014
WA Hunt,AUS,Spin,1932-01-29,Adelaide,Australia,1932,2,39,96,0,1,610,1508,19,571,1412,19,32.10526315789474,>30,AUS,Home,Upto 2014
WA Johnston,AUS,Spin,1947-11-28,Brisbane,Australia,1947,2,28,136,3,1,180,496,7,152,360,4,25.714285714285715,<=30,AUS,Home,Upto 2014
WA Johnston,AUS,Spin,1947-12-12,Sydney,Australia,1947,2,48,240,5,1,208,752,16,160,512,11,13.0,<=30,AUS,Home,Upto 2014
WA Johnston,AUS,Spin,1948-01-01,Melbourne,Australia,1948,2,77,176,6,1,660,1199,23,583,1023,17,28.695652173913043,<=30,AUS,Home,Upto 2014
WA Johnston,AUS,Spin,1948-02-06,Melbourne,Australia,1948,2,29,120,2,1,478,1056,12,449,936,10,39.833333333333336,>30,AUS,Home,Upto 2014
WA Johnston,AUS,Spin,1948-06-10,Nottingham,England,1948,2,183,504,9,1,552,1614,15,369,1110,6,36.8,>30,ENG,Away,Upto 2014
WA Johnston,AUS,Spin,1948-06-24,Lord's,England,1948,2,105,330,4,1,442,1043,11,337,713,7,40.18181818181818,>30,ENG,Away,Upto 2014
WA Johnston,AUS,Spin,1948-07-08,Manchester,England,1948,2,101,359,3,1,279,893,5,178,534,2,55.8,>30,ENG,Away,Upto 2014
WA Johnston,AUS,Spin,1948-07-22,Leeds,England,1948,2,181,402,5,1,708,1260,12,527,858,7,59.0,>30,ENG,Away,Upto 2014
WA Johnston,AUS,Spin,1948-08-14,The Oval,England,1948,2,60,261,6,1,359,1083,14,299,822,8,25.642857142857142,<=30,ENG,Away,Upto 2014
WA Johnston,AUS,Spin,1949-12-24,Johannesburg,South Africa,1949,2,65,257,8,1,426,1143,20,361,886,12,21.3,<=30,SA,Away,Upto 2014
WA Johnston,AUS,Spin,1949-12-31,Cape Town,South Africa,1949,2,123,328,3,1,803,1732,19,680,1404,16,42.26315789473684,>30,SA,Away,Upto 2014
WA Johnston,AUS,Spin,1950-01-20,Durban,South Africa,1950,2,114,396,8,1,552,1758,29,438,1362,21,19.03448275862069,<=30,SA,Away,Upto 2014
WA Johnston,AUS,Spin,1950-02-10,Johannesburg,South Africa,1950,1,68,232,1,1,517,1176,4,449,944,3,129.25,>30,SA,Away,Upto 2014
WA Johnston,AUS,Spin,1950-03-03,Gqeberha,South Africa,1950,2,22,72,3,1,463,890,16,441,818,13,28.9375,<=30,SA,Away,Upto 2014
WA Johnston,AUS,Spin,1950-12-01,Brisbane,Australia,1950,2,65,176,7,1,252,496,14,187,320,7,18.0,<=30,AUS,Home,Upto 2014
WA Johnston,AUS,Spin,1950-12-22,Melbourne,Australia,1950,2,54,183,6,1,357,991,20,303,808,14,17.85,<=30,AUS,Home,Upto 2014
WA Johnston,AUS,Spin,1951-01-05,Sydney,Australia,1951,2,81,272,1,1,426,1236,15,345,964,14,28.4,<=30,AUS,Home,Upto 2014
WA Johnston,AUS,Spin,1951-02-02,Adelaide,Australia,1951,2,131,416,7,1,793,1857,24,662,1441,17,33.041666666666664,>30,AUS,Home,Upto 2014
WA Johnston,AUS,Spin,1951-02-23,Melbourne,Australia,1951,2,91,184,1,1,462,1120,13,371,936,12,35.53846153846154,>30,AUS,Home,Upto 2014
WA Johnston,AUS,Spin,1951-11-09,Brisbane,Australia,1951,2,90,264,3,1,714,1815,27,624,1551,24,26.444444444444443,<=30,AUS,Home,Upto 2014
WA Johnston,AUS,Spin,1951-11-30,Sydney,Australia,1951,2,141,396,5,1,842,1964,19,701,1568,14,44.31578947368421,>30,AUS,Home,Upto 2014
WA Johnston,AUS,Spin,1951-12-22,Adelaide,Australia,1951,2,112,248,7,1,501,1145,26,389,897,19,19.26923076923077,<=30,AUS,Home,Upto 2014
WA Johnston,AUS,Spin,1951-12-31,Melbourne,Australia,1951,2,110,275,5,1,557,1523,18,447,1248,13,30.944444444444443,>30,AUS,Home,Upto 2014
WA Johnston,AUS,Spin,1952-01-25,Sydney,Australia,1952,2,55,192,3,1,474,1237,15,419,1045,12,31.6,>30,AUS,Home,Upto 2014
WA Johnston,AUS,Spin,1952-12-05,Brisbane,Australia,1952,2,83,270,3,1,592,1609,17,509,1339,14,34.8235294117647,>30,AUS,Home,Upto 2014
WA Johnston,AUS,Spin,1952-12-24,Melbourne,Australia,1952,2,114,344,2,1,730,1899,24,616,1555,22,30.416666666666668,>30,AUS,Home,Upto 2014
WA Johnston,AUS,Spin,1953-01-09,Sydney,Australia,1953,2,97,262,2,1,515,1280,12,418,1018,10,42.916666666666664,>30,AUS,Home,Upto 2014
WA Johnston,AUS,Spin,1953-01-24,Adelaide,Australia,1953,2,177,587,7,1,857,2379,23,680,1792,16,37.26086956521739,>30,AUS,Home,Upto 2014
WA Johnston,AUS,Spin,1953-02-06,Melbourne,Australia,1953,2,266,672,7,1,952,2221,20,686,1549,13,47.6,>30,AUS,Home,Upto 2014
WA Johnston,AUS,Spin,1953-06-11,Nottingham,England,1953,2,36,216,0,1,277,894,8,241,678,8,34.625,>30,ENG,Away,Upto 2014
WA Johnston,AUS,Spin,1953-06-25,Lord's,England,1953,2,161,384,4,1,753,1644,18,592,1260,14,41.833333333333336,>30,ENG,Away,Upto 2014
WA Johnston,AUS,Spin,1953-08-15,The Oval,England,1953,2,146,444,3,1,335,826,14,189,382,11,23.928571428571427,<=30,ENG,Away,Upto 2014
WA Johnston,AUS,Spin,1954-11-26,Brisbane,Australia,1954,2,106,297,3,1,261,746,11,155,449,8,23.727272727272727,<=30,AUS,Home,Upto 2014
WA Johnston,AUS,Spin,1954-12-17,Sydney,Australia,1954,2,126,262,6,1,179,446,7,53,184,1,25.571428571428573,<=30,AUS,Home,Upto 2014
WA Johnston,AUS,Spin,1954-12-31,Melbourne,Australia,1954,2,111,293,6,1,232,621,10,121,328,4,23.2,<=30,AUS,Home,Upto 2014
WA Johnston,AUS,Spin,1955-01-28,Adelaide,Australia,1955,2,80,280,4,1,330,1112,11,250,832,7,30.0,<=30,AUS,Home,Upto 2014
WA Johnston,AUS,Spin,1955-03-26,Kingston,West Indies,1955,2,129,234,2,1,550,1394,11,421,1160,9,50.0,>30,WI,Away,Upto 2014
WA Johnston,AUS,Spin,1955-04-11,Port of Spain,West Indies,1955,2,60,84,0,1,545,1044,8,485,960,8,68.125,>30,WI,Away,Upto 2014
WA Shalders,SA,Pace,1906-03-10,Johannesburg,South Africa,1906,1,6,48,1,1,542,1143,25,536,1095,24,21.68,<=30,SA,Home,Upto 2014
WB Rankin,ENG,Pace,2014-01-03,Sydney,Australia,2014,2,81,125,1,1,663,1122,33,582,997,32,20.09090909090909,<=30,AUS,Away,After 1965
WB Rankin,IRE,Pace,2018-05-11,Dublin (Malahide),Ireland,2018,2,132,198,3,1,792,1625,28,660,1427,25,28.285714285714285,<=30,IRE,Home,After 1965
WB Rankin,IRE,Pace,2019-07-24,Lord's,England,2019,2,91,120,4,1,515,949,38,424,829,34,13.552631578947368,<=30,ENG,Away,After 1965
WD Parnell,SA,Pace,2010-01-14,Johannesburg,South Africa,2010,2,35,66,2,1,644,1109,23,609,1043,21,28.0,<=30,SA,Home,Upto 2014
WD Parnell,SA,Pace,2010-02-06,Nagpur,India,2010,2,89,120,3,1,534,1007,19,445,887,16,28.105263157894736,<=30,IND,Away,Upto 2014
WD Parnell,SA,Pace,2010-02-14,Eden Gardens,India,2010,1,103,120,0,1,646,954,10,543,834,10,64.6,>30,IND,Away,Upto 2014
WD Parnell,SA,Pace,2014-02-20,Gqeberha,South Africa,2014,1,31,51,2,1,800,1419,22,769,1368,20,36.36363636363637,>30,SA,Home,After 1965
WD Parnell,SA,Pace,2017-01-12,Johannesburg,South Africa,2017,2,89,127,6,1,621,1136,30,532,1009,24,20.7,<=30,SA,Home,After 1965
WD Parnell,SA,Pace,2017-10-06,Bloemfontein,South Africa,2017,2,67,72,2,1,638,933,23,571,861,21,27.73913043478261,<=30,SA,Home,After 1965
WE Astill,ENG,Spin,1927-12-24,Johannesburg,South Africa,1927,2,28,84,0,1,312,867,11,284,783,11,28.363636363636363,<=30,SA,Away,Upto 2014
WE Astill,ENG,Spin,1927-12-31,Cape Town,South Africa,1927,2,80,222,4,1,504,1376,23,424,1154,19,21.91304347826087,<=30,SA,Away,Upto 2014
WE Astill,ENG,Spin,1928-01-21,Durban,South Africa,1928,2,49,162,2,1,719,1581,22,670,1419,20,32.68181818181818,>30,SA,Away,Upto 2014
WE Astill,ENG,Spin,1928-01-28,Johannesburg,South Africa,1928,2,65,86,3,1,407,779,13,342,693,10,31.307692307692307,>30,SA,Away,Upto 2014
WE Astill,ENG,Spin,1928-02-04,Durban,South Africa,1928,2,108,228,3,1,423,969,13,315,741,10,32.53846153846154,>30,SA,Away,Upto 2014
WE Astill,ENG,Spin,1930-01-11,Bridgetown,West Indies,1930,2,91,234,1,1,542,1217,16,451,983,15,33.875,>30,WI,Away,Upto 2014
WE Astill,ENG,Spin,1930-02-01,Port of Spain,West Indies,1930,2,92,266,4,1,356,890,8,264,624,4,44.5,>30,WI,Away,Upto 2014
WE Astill,ENG,Spin,1930-02-21,Georgetown,West Indies,1930,2,162,426,4,1,461,1269,13,299,843,9,35.46153846153846,>30,WI,Away,Upto 2014
WE Astill,ENG,Spin,1930-04-03,Kingston,West Indies,1930,2,181,474,4,1,1040,2209,18,859,1735,14,57.77777777777778,>30,WI,Away,Upto 2014
WE Bowes,ENG,Pace,1932-06-25,Lord's,England,1932,2,79,264,6,1,543,1480,28,464,1216,22,19.392857142857142,<=30,ENG,Home,Upto 2014
WE Bowes,ENG,Pace,1932-12-30,Melbourne,Australia,1932,2,70,138,1,1,475,1034,22,405,896,21,21.59090909090909,<=30,AUS,Away,Upto 2014
WE Bowes,ENG,Pace,1933-03-31,Auckland,New Zealand,1933,2,38,126,6,1,344,794,12,306,668,6,28.666666666666668,<=30,NZ,Away,Upto 2014
WE Bowes,ENG,Pace,1934-06-22,Lord's,England,1934,2,122,270,4,1,436,1038,10,314,768,6,43.6,>30,ENG,Home,Upto 2014
WE Bowes,ENG,Pace,1934-07-20,Leeds,England,1934,1,142,300,6,1,418,900,7,276,600,1,59.714285714285715,>30,ENG,Home,Upto 2014
WE Bowes,ENG,Pace,1934-08-18,The Oval,England,1934,2,219,297,9,1,874,1331,25,655,1034,16,34.96,>30,ENG,Home,Upto 2014
WE Bowes,ENG,Pace,1935-06-15,Nottingham,England,1935,2,33,156,0,1,248,671,10,215,515,10,24.8,<=30,ENG,Home,Upto 2014
WE Bowes,ENG,Pace,1935-07-13,Leeds,England,1935,2,93,288,4,1,570,1397,20,477,1109,16,28.5,<=30,ENG,Home,Upto 2014
WE Bowes,ENG,Pace,1935-07-27,Manchester,England,1935,2,134,306,5,1,592,1081,17,458,775,12,34.8235294117647,>30,ENG,Home,Upto 2014
WE Bowes,ENG,Pace,1935-08-17,The Oval,England,1935,2,152,322,5,1,741,1240,14,589,918,9,52.92857142857143,>30,ENG,Home,Upto 2014
WE Bowes,ENG,Pace,1938-07-22,Leeds,England,1938,2,114,280,3,1,285,715,10,171,435,7,28.5,<=30,ENG,Home,Upto 2014
WE Bowes,ENG,Pace,1938-08-20,The Oval,England,1938,2,74,174,7,1,391,703,13,317,529,6,30.076923076923077,>30,ENG,Home,Upto 2014
WE Bowes,ENG,Pace,1939-06-24,Lord's,England,1939,2,130,380,4,1,652,1327,16,522,947,12,40.75,>30,ENG,Home,Upto 2014
WE Bowes,ENG,Pace,1939-07-22,Manchester,England,1939,2,46,180,7,1,257,788,18,211,608,11,14.277777777777779,<=30,ENG,Home,Upto 2014
WE Bowes,ENG,Pace,1946-06-22,Lord's,England,1946,2,73,174,1,1,522,1272,22,449,1098,21,23.727272727272727,<=30,ENG,Home,Upto 2014
WE Hollies,ENG,Spin,1935-01-08,Bridgetown,West Indies,1935,1,36,96,2,1,82,234,6,46,138,4,13.666666666666666,<=30,WI,Away,Upto 2014
WE Hollies,ENG,Spin,1935-02-14,Georgetown,West Indies,1935,2,67,186,7,1,339,996,16,272,810,9,21.1875,<=30,WI,Away,Upto 2014
WE Hollies,ENG,Spin,1935-03-14,Kingston,West Indies,1935,1,114,276,1,1,453,1026,10,339,750,9,45.3,>30,WI,Away,Upto 2014
WE Hollies,ENG,Spin,1947-06-07,Nottingham,England,1947,2,156,386,5,1,885,2189,17,729,1803,12,52.05882352941177,>30,ENG,Home,Upto 2014
WE Hollies,ENG,Spin,1947-06-21,Lord's,England,1947,2,84,288,2,1,699,1857,18,615,1569,16,38.833333333333336,>30,ENG,Home,Upto 2014
WE Hollies,ENG,Spin,1947-07-05,Manchester,England,1947,2,91,222,2,1,418,900,10,327,678,8,41.8,>30,ENG,Home,Upto 2014
WE Hollies,ENG,Spin,1948-08-14,The Oval,England,1948,1,131,336,5,1,359,1083,14,228,747,9,25.642857142857142,<=30,ENG,Home,Upto 2014
WE Hollies,ENG,Spin,1949-06-11,Leeds,England,1949,2,90,216,0,1,545,1101,10,455,885,10,54.5,>30,ENG,Home,Upto 2014
WE Hollies,ENG,Spin,1949-06-25,Lord's,England,1949,1,133,348,5,1,624,1342,19,491,994,14,32.8421052631579,>30,ENG,Home,Upto 2014
WE Hollies,ENG,Spin,1949-07-23,Manchester,England,1949,2,81,264,2,1,586,1224,13,505,960,11,45.07692307692308,>30,ENG,Home,Upto 2014
WE Hollies,ENG,Spin,1949-08-13,The Oval,England,1949,2,81,222,3,1,597,1082,15,516,860,12,39.8,>30,ENG,Home,Upto 2014
WE Hollies,ENG,Spin,1950-06-08,Manchester,England,1950,2,133,410,8,1,787,2271,35,654,1861,27,22.485714285714284,<=30,ENG,Home,Upto 2014
WE Hollies,ENG,Spin,1950-07-20,Nottingham,England,1950,2,135,304,2,1,728,2103,19,593,1799,17,38.31578947368421,>30,ENG,Home,Upto 2014
WE Merritt,NZ,Spin,1930-01-10,Christchurch,New Zealand,1930,2,55,90,1,1,139,270,9,84,180,8,15.444444444444445,<=30,NZ,Home,Upto 2014
WE Merritt,NZ,Spin,1930-01-24,Wellington,New Zealand,1930,2,135,258,3,1,379,753,13,244,495,10,29.153846153846153,<=30,NZ,Home,Upto 2014
WE Merritt,NZ,Spin,1930-02-14,Auckland,New Zealand,1930,1,119,168,2,1,274,396,3,155,228,1,91.33333333333333,>30,NZ,Home,Upto 2014
WE Merritt,NZ,Spin,1930-02-21,Auckland,New Zealand,1930,1,127,204,2,1,488,1141,10,361,937,8,48.8,>30,NZ,Home,Upto 2014
WE Merritt,NZ,Spin,1931-06-27,Lord's,England,1931,2,106,144,4,1,753,1396,20,647,1252,16,37.65,>30,ENG,Away,Upto 2014
WE Merritt,NZ,Spin,1931-07-29,The Oval,England,1931,1,75,72,0,1,591,1465,18,516,1393,18,32.833333333333336,>30,ENG,Away,Upto 2014
WE Midwinter,AUS,Spin,1877-03-15,Melbourne,Australia,1877,2,101,292,6,1,437,1296,31,336,1004,25,14.096774193548388,<=30,AUS,Home,After 1965
WE Midwinter,AUS,Spin,1877-03-31,Melbourne,Australia,1877,2,55,137,2,1,437,1222,21,382,1085,19,20.80952380952381,<=30,AUS,Home,After 1965
WE Midwinter,AUS,Spin,1883-02-17,Sydney,Australia,1883,2,71,280,4,1,484,1391,24,413,1111,20,20.166666666666668,<=30,AUS,Home,After 1965
WE Midwinter,AUS,Spin,1884-07-21,Lord's,England,1884,1,29,52,0,1,320,694,15,291,642,15,21.333333333333332,<=30,ENG,Away,After 1965
WE Midwinter,AUS,Spin,1884-08-11,The Oval,England,1884,2,56,136,1,1,469,1036,14,413,900,13,33.5,>30,ENG,Away,After 1965
WE Midwinter,AUS,Spin,1887-01-28,Sydney,Australia,1887,1,10,16,0,1,172,567,12,162,551,12,14.333333333333334,<=30,AUS,Home,After 1965
WE Midwinter,AUS,Spin,1887-02-25,Sydney,Australia,1887,2,11,36,1,1,268,812,19,257,776,18,14.105263157894736,<=30,AUS,Home,After 1965
WE Midwinter,ENG,Spin,1881-12-31,Melbourne,Australia,1881,1,50,156,2,1,812,2321,24,762,2165,22,33.833333333333336,>30,AUS,Away,After 1965
WE Midwinter,ENG,Spin,1882-02-17,Sydney,Australia,1882,2,66,208,2,1,520,1846,24,454,1638,22,21.666666666666668,<=30,AUS,Away,After 1965
WE Midwinter,ENG,Spin,1882-03-03,Sydney,Australia,1882,1,75,248,2,1,374,1277,25,299,1029,23,14.96,<=30,AUS,Away,After 1965
WE Midwinter,ENG,Spin,1882-03-10,Melbourne,Australia,1882,1,81,164,4,1,397,773,12,316,609,8,33.083333333333336,>30,AUS,Away,After 1965
WE Russell,ENG,Pace,1961-10-21,Lahore,Pakistan,1961,1,25,114,0,1,400,1080,13,375,966,13,30.76923076923077,>30,PAK,Away,Upto 2014
WE Russell,ENG,Pace,1961-12-30,Eden Gardens,India,1961,1,19,30,0,1,412,930,9,393,900,9,45.77777777777778,>30,IND,Away,Upto 2014
WER Somerville,NZ,Spin,2018-12-03,Abu Dhabi,UAE,2018,2,127,336,7,1,612,1532,24,485,1196,17,25.5,<=30,UAE,Away,After 1965
WER Somerville,NZ,Spin,2019-08-14,Galle,Sri Lanka,2019,2,156,320,4,1,786,1622,23,630,1302,19,34.17391304347826,>30,SL,Away,After 1965
WER Somerville,NZ,Spin,2019-08-22,Colombo (PSS),Sri Lanka,2019,2,69,162,3,1,428,846,11,359,684,8,38.90909090909091,>30,SL,Away,After 1965
WER Somerville,NZ,Spin,2020-01-03,Sydney,Australia,2020,2,135,234,1,1,444,825,14,309,591,13,31.714285714285715,>30,AUS,Away,After 1965
WER Somerville,NZ,Spin,2021-11-25,Kanpur,India,2021,2,98,240,0,1,592,1744,20,494,1504,20,29.6,<=30,IND,Away,After 1965
WER Somerville,NZ,Spin,2021-12-03,Wankhede,India,2021,2,139,174,0,1,600,1113,33,461,939,33,18.181818181818183,<=30,IND,Away,After 1965
WFE Marx,SA,Pace,1921-11-05,Durban,South Africa,1921,2,26,54,1,1,645,1385,24,619,1331,23,26.875,<=30,SA,Home,Upto 2014
WFE Marx,SA,Pace,1921-11-12,Johannesburg,South Africa,1921,2,89,132,3,1,791,1453,15,702,1321,12,52.733333333333334,>30,SA,Home,Upto 2014
WFE Marx,SA,Pace,1921-11-26,Cape Town,South Africa,1921,1,29,42,0,1,368,882,11,339,840,11,33.45454545454545,>30,SA,Home,Upto 2014
WG Grace,ENG,Spin,1880-09-06,The Oval,England,1880,2,68,117,3,1,721,1528,21,653,1411,18,34.333333333333336,>30,ENG,Home,After 1965
WG Grace,ENG,Spin,1884-07-10,Manchester,England,1884,1,2,44,1,1,222,640,17,220,596,16,13.058823529411764,<=30,ENG,Home,After 1965
WG Grace,ENG,Spin,1884-07-21,Lord's,England,1884,1,13,28,1,1,320,694,15,307,666,14,21.333333333333332,<=30,ENG,Home,After 1965
WG Grace,ENG,Spin,1884-08-11,The Oval,England,1884,1,23,96,1,1,469,1036,14,446,940,13,33.5,>30,ENG,Home,After 1965
WG Grace,ENG,Spin,1886-07-05,Manchester,England,1886,2,22,40,1,1,205,538,9,183,498,8,22.77777777777778,<=30,ENG,Home,After 1965
WG Grace,ENG,Spin,1890-07-21,Lord's,England,1890,1,12,70,2,1,250,845,14,238,775,12,17.857142857142858,<=30,ENG,Home,After 1965
WG Grace,ENG,Spin,1892-01-29,Sydney,Australia,1892,1,34,96,0,1,229,676,7,195,580,7,32.714285714285715,>30,AUS,Away,After 1965
WG Grace,ENG,Spin,1896-06-22,Lord's,England,1896,1,14,30,0,1,123,265,4,109,235,4,30.75,>30,ENG,Home,After 1965
WG Grace,ENG,Spin,1896-07-16,Manchester,England,1896,1,11,35,0,1,461,941,15,450,906,15,30.733333333333334,>30,ENG,Home,After 1965
WG Grace,ENG,Spin,1899-06-01,Nottingham,England,1899,2,37,110,0,1,270,732,12,233,622,12,22.5,<=30,ENG,Home,After 1965
WG Jacks,ENG,Spin,2022-12-01,Rawalpindi,Pakistan,2022,2,199,279,6,1,949,1152,16,750,873,10,59.3125,>30,PAK,Away,After 1965
WG Jacks,ENG,Spin,2022-12-09,Multan,Pakistan,2022,2,33,48,0,1,774,1107,26,741,1059,26,29.76923076923077,<=30,PAK,Away,After 1965
WG Quaife,ENG,Spin,1899-07-17,Manchester,England,1899,1,6,15,0,1,220,480,7,214,465,7,31.428571428571427,>30,ENG,Home,After 1965
WH Ashley,SA,Pace,1889-03-25,Cape Town,South Africa,1889,1,95,173,7,1,290,589,13,195,416,6,22.307692307692307,<=30,SA,Home,After 1965
WH Cooper,AUS,Spin,1881-12-31,Melbourne,Australia,1881,2,200,374,9,1,812,2321,24,612,1947,15,33.833333333333336,>30,AUS,Home,After 1965
WH Cooper,AUS,Spin,1884-12-12,Adelaide,Australia,1884,1,26,72,0,1,511,1330,22,485,1258,22,23.227272727272727,<=30,AUS,Home,After 1965
WH Copson,ENG,Pace,1939-06-24,Lord's,England,1939,2,152,324,9,1,652,1327,16,500,1003,7,40.75,>30,ENG,Home,Upto 2014
WH Copson,ENG,Pace,1939-07-22,Manchester,England,1939,2,33,96,3,1,257,788,18,224,692,15,14.277777777777779,<=30,ENG,Home,Upto 2014
WH Copson,ENG,Pace,1947-08-16,The Oval,England,1947,2,112,342,3,1,526,1254,9,414,912,6,58.44444444444444,>30,ENG,Home,Upto 2014
WH Lockwood,ENG,Pace,1893-07-17,Lord's,England,1893,1,101,225,6,1,548,1355,26,447,1130,20,21.076923076923077,<=30,ENG,Home,After 1965
WH Lockwood,ENG,Pace,1893-08-14,The Oval,England,1893,2,133,240,8,1,575,1100,17,442,860,9,33.8235294117647,>30,ENG,Home,After 1965
WH Lockwood,ENG,Pace,1894-12-14,Sydney,Australia,1894,2,41,114,0,1,993,2418,24,952,2304,24,41.375,>30,AUS,Away,After 1965
WH Lockwood,ENG,Pace,1894-12-29,Melbourne,Australia,1894,2,77,180,1,1,653,1784,28,576,1604,27,23.321428571428573,<=30,AUS,Away,After 1965
WH Lockwood,ENG,Pace,1895-01-11,Adelaide,Australia,1895,2,103,138,2,1,553,1201,23,450,1063,21,24.043478260869566,<=30,AUS,Away,After 1965
WH Lockwood,ENG,Pace,1895-02-01,Sydney,Australia,1895,1,22,53,1,1,216,539,18,194,486,17,12.0,<=30,AUS,Away,After 1965
WH Lockwood,ENG,Pace,1895-03-01,Melbourne,Australia,1895,2,96,258,1,1,615,1328,15,519,1070,14,41.0,>30,AUS,Away,After 1965
WH Lockwood,ENG,Pace,1899-08-14,The Oval,England,1899,2,104,278,7,1,660,1288,13,556,1010,6,50.76923076923077,>30,ENG,Home,After 1965
WH Lockwood,ENG,Pace,1902-07-24,Manchester,England,1902,2,76,223,11,1,194,433,13,118,210,2,14.923076923076923,<=30,ENG,Home,Upto 2014
WH Lockwood,ENG,Pace,1902-08-11,The Oval,England,1902,2,130,264,6,1,298,648,14,168,384,8,21.285714285714285,<=30,ENG,Home,Upto 2014
WH Milton,SA,Spin,1889-03-12,Gqeberha,South Africa,1889,1,5,10,1,1,137,346,12,132,336,11,11.416666666666666,<=30,SA,Home,After 1965
WH Milton,SA,Spin,1889-03-25,Cape Town,South Africa,1889,1,16,24,0,1,74,207,15,58,183,15,4.933333333333334,<=30,SA,Home,After 1965
WH Milton,SA,Spin,1892-03-19,Cape Town,South Africa,1892,1,27,45,1,1,141,332,14,114,287,13,10.071428571428571,<=30,SA,Home,After 1965
WH Moule,AUS,Pace,1880-09-06,The Oval,England,1880,1,23,51,3,1,186,458,12,163,407,9,15.5,<=30,ENG,Away,After 1965
WH Scotton,ENG,Pace,1884-08-11,The Oval,England,1884,1,20,20,0,1,468,1104,7,448,1084,7,66.85714285714286,>30,ENG,Home,After 1965
WH St Hill,WI,Pace,1930-02-01,Port of Spain,West Indies,1930,1,9,12,0,1,688,1491,29,679,1479,29,23.724137931034484,<=30,WI,Home,Upto 2014
WHB Frank,SA,Pace,1896-03-02,Johannesburg,South Africa,1896,1,52,58,1,1,539,922,24,487,864,23,22.458333333333332,<=30,SA,Home,After 1965
WJ Cronje,SA,Pace,1992-11-26,Johannesburg,South Africa,1992,2,54,210,1,1,741,2035,23,687,1825,22,32.21739130434783,>30,SA,Home,Upto 2014
WJ Cronje,SA,Pace,1993-01-02,Cape Town,South Africa,1993,2,17,130,2,1,434,1582,19,417,1452,17,22.842105263157894,<=30,SA,Home,Upto 2014
WJ Cronje,SA,Pace,1993-08-25,Moratuwa,Sri Lanka,1993,2,59,204,1,1,501,1154,19,442,950,18,26.36842105263158,<=30,SL,Away,Upto 2014
WJ Cronje,SA,Pace,1993-12-26,Melbourne,Australia,1993,1,25,78,0,1,399,858,6,374,780,6,66.5,>30,AUS,Away,Upto 2014
WJ Cronje,SA,Pace,1994-01-28,Adelaide,Australia,1994,2,41,90,0,1,661,1638,23,620,1548,23,28.73913043478261,<=30,AUS,Away,Upto 2014
WJ Cronje,SA,Pace,1994-03-04,Johannesburg,South Africa,1994,1,0,3,1,1,852,1646,28,852,1643,27,30.428571428571427,>30,SA,Home,Upto 2014
WJ Cronje,SA,Pace,1994-03-17,Cape Town,South Africa,1994,2,13,78,0,1,830,1910,22,817,1832,22,37.72727272727273,>30,SA,Home,Upto 2014
WJ Cronje,SA,Pace,1994-03-25,Durban,South Africa,1994,2,48,138,0,1,810,2116,20,762,1978,20,40.5,>30,SA,Home,Upto 2014
WJ Cronje,SA,Pace,1994-07-21,Lord's,England,1994,1,1,6,0,1,636,1408,31,635,1402,31,20.516129032258064,<=30,ENG,Away,Upto 2014
WJ Cronje,SA,Pace,1994-08-04,Leeds,England,1994,2,77,168,0,1,1145,2209,21,1068,2041,21,54.523809523809526,>30,ENG,Away,Upto 2014
WJ Cronje,SA,Pace,1994-08-18,The Oval,England,1994,1,16,48,0,1,962,1490,30,946,1442,30,32.06666666666667,>30,ENG,Away,Upto 2014
WJ Cronje,SA,Pace,1994-11-25,Johannesburg,South Africa,1994,2,13,24,0,1,787,1709,30,774,1685,30,26.233333333333334,<=30,SA,Home,Upto 2014
WJ Cronje,SA,Pace,1994-12-26,Durban,South Africa,1994,2,18,84,1,1,610,1681,28,592,1597,27,21.785714285714285,<=30,SA,Home,Upto 2014
WJ Cronje,SA,Pace,1995-01-02,Cape Town,South Africa,1995,2,23,72,0,1,639,1598,22,616,1526,22,29.045454545454547,<=30,SA,Home,Upto 2014
WJ Cronje,SA,Pace,1995-01-19,Johannesburg,South Africa,1995,2,22,84,0,1,915,1724,33,893,1640,33,27.727272727272727,<=30,SA,Home,Upto 2014
WJ Cronje,SA,Pace,1995-03-04,Auckland,New Zealand,1995,2,66,120,2,1,789,1800,31,723,1680,29,25.451612903225808,<=30,NZ,Away,Upto 2014
WJ Cronje,SA,Pace,1995-10-13,Harare,Zimbabwe,1995,1,3,6,0,1,728,1549,32,725,1543,32,22.75,<=30,ZIM,Away,Upto 2014
WJ Cronje,SA,Pace,1995-11-16,Centurion,South Africa,1995,1,14,48,0,1,364,846,9,350,798,9,40.44444444444444,>30,SA,Home,Upto 2014
WJ Cronje,SA,Pace,1995-11-30,Johannesburg,South Africa,1995,1,2,18,0,1,999,2058,30,997,2040,30,33.3,>30,SA,Home,Upto 2014
WJ Cronje,SA,Pace,1995-12-26,Gqeberha,South Africa,1995,1,0,6,0,1,681,1783,21,681,1777,21,32.42857142857143,>30,SA,Home,Upto 2014
WJ Cronje,SA,Pace,1996-01-02,Cape Town,South Africa,1996,1,0,24,0,1,418,1109,22,418,1085,22,19.0,<=30,SA,Home,Upto 2014
WJ Cronje,SA,Pace,1996-11-20,Ahmedabad,India,1996,2,18,72,0,1,335,936,19,317,864,19,17.63157894736842,<=30,IND,Away,Upto 2014
WJ Cronje,SA,Pace,1996-11-27,Eden Gardens,India,1996,2,23,78,0,1,704,1315,23,681,1237,23,30.608695652173914,>30,IND,Away,Upto 2014
WJ Cronje,SA,Pace,1996-12-08,Kanpur,India,1996,2,42,150,2,1,443,1201,16,401,1051,14,27.6875,<=30,IND,Away,Upto 2014
WJ Cronje,SA,Pace,1997-01-02,Cape Town,South Africa,1997,1,16,54,0,1,897,1609,22,881,1555,22,40.77272727272727,>30,SA,Home,Upto 2014
WJ Cronje,SA,Pace,1997-01-16,Johannesburg,South Africa,1997,2,63,147,3,1,895,1774,26,832,1627,23,34.42307692307692,>30,SA,Home,Upto 2014
WJ Cronje,SA,Pace,1997-02-28,Johannesburg,South Africa,1997,1,32,100,1,1,660,1282,14,628,1182,13,47.142857142857146,>30,SA,Home,Upto 2014
WJ Cronje,SA,Pace,1997-03-14,Gqeberha,South Africa,1997,2,57,141,3,1,528,1387,24,471,1246,21,22.0,<=30,SA,Home,Upto 2014
WJ Cronje,SA,Pace,1997-03-21,Centurion,South Africa,1997,1,5,30,0,1,500,1229,28,495,1199,28,17.857142857142858,<=30,SA,Home,Upto 2014
WJ Cronje,SA,Pace,1997-10-06,Rawalpindi,Pakistan,1997,2,54,83,2,1,556,1227,14,502,1144,12,39.714285714285715,>30,PAK,Away,Upto 2014
WJ Cronje,SA,Pace,1997-10-24,Faisalabad,Pakistan,1997,1,6,30,2,1,482,896,25,476,866,23,19.28,<=30,PAK,Away,Upto 2014
WJ Cronje,SA,Pace,1997-12-26,Melbourne,Australia,1997,2,22,36,0,1,627,1621,23,605,1585,23,27.26086956521739,<=30,AUS,Away,Upto 2014
WJ Cronje,SA,Pace,1998-01-02,Sydney,Australia,1998,1,2,6,0,1,405,1054,13,403,1048,13,31.153846153846153,>30,AUS,Away,Upto 2014
WJ Cronje,SA,Pace,1998-01-30,Adelaide,Australia,1998,1,2,6,0,1,879,2002,24,877,1996,24,36.625,>30,AUS,Away,Upto 2014
WJ Cronje,SA,Pace,1998-02-26,Durban,South Africa,1998,1,20,30,0,1,733,1519,29,713,1489,29,25.275862068965516,<=30,SA,Home,Upto 2014
WJ Cronje,SA,Pace,1998-03-19,Cape Town,South Africa,1998,1,5,30,0,1,757,1378,22,752,1348,22,34.40909090909091,>30,SA,Home,Upto 2014
WJ Cronje,SA,Pace,1998-03-27,Centurion,South Africa,1998,2,34,135,5,1,463,1134,19,429,999,14,24.36842105263158,<=30,SA,Home,Upto 2014
WJ Cronje,SA,Pace,1998-06-04,Birmingham,England,1998,1,28,66,0,1,706,1575,23,678,1509,23,30.695652173913043,>30,ENG,Away,Upto 2014
WJ Cronje,SA,Pace,1998-06-18,Lord's,England,1998,1,6,24,0,1,618,1463,26,612,1439,26,23.76923076923077,<=30,ENG,Away,Upto 2014
WJ Cronje,SA,Pace,1998-07-02,Manchester,England,1998,1,15,36,0,1,671,1668,18,656,1632,18,37.27777777777778,>30,ENG,Away,Upto 2014
WJ Cronje,SA,Pace,1998-07-23,Nottingham,England,1998,1,12,24,0,1,995,2152,32,983,2128,32,31.09375,>30,ENG,Away,Upto 2014
WJ Cronje,SA,Pace,1998-08-06,Leeds,England,1998,1,4,24,0,1,826,2084,40,822,2060,40,20.65,<=30,ENG,Away,Upto 2014
WJ Cronje,SA,Pace,1998-11-26,Johannesburg,South Africa,1998,1,3,6,0,1,642,1519,31,639,1513,31,20.70967741935484,<=30,SA,Home,Upto 2014
WJ Cronje,SA,Pace,1998-12-26,Durban,South Africa,1998,1,19,25,3,1,645,1347,28,626,1322,25,23.035714285714285,<=30,SA,Home,Upto 2014
WJ Cronje,SA,Pace,1999-01-02,Cape Town,South Africa,1999,2,23,42,0,1,785,1771,27,762,1729,27,29.074074074074073,<=30,SA,Home,Upto 2014
WJ Cronje,SA,Pace,1999-01-15,Centurion,South Africa,1999,1,8,30,0,1,776,1416,26,768,1386,26,29.846153846153847,<=30,SA,Home,Upto 2014
WJ Cronje,SA,Pace,1999-02-27,Auckland,New Zealand,1999,2,30,90,1,1,841,1949,13,811,1859,12,64.6923076923077,>30,NZ,Away,Upto 2014
WJ Cronje,SA,Pace,1999-03-11,Christchurch,New Zealand,1999,2,10,61,0,1,581,1404,8,571,1343,8,72.625,>30,NZ,Away,Upto 2014
WJ Cronje,SA,Pace,1999-03-18,Wellington,New Zealand,1999,1,16,30,0,1,742,1762,20,726,1732,20,37.1,>30,NZ,Away,Upto 2014
WJ Cronje,SA,Pace,1999-11-11,Harare,Zimbabwe,1999,2,34,83,4,1,560,1277,25,526,1194,21,22.4,<=30,ZIM,Away,Upto 2014
WJ Cronje,SA,Pace,1999-11-25,Johannesburg,South Africa,1999,2,37,66,0,1,668,1442,28,631,1376,28,23.857142857142858,<=30,SA,Home,Upto 2014
WJ Cronje,SA,Pace,1999-12-09,Gqeberha,South Africa,1999,2,22,132,1,1,939,2119,25,917,1987,24,37.56,>30,SA,Home,Upto 2014
WJ Cronje,SA,Pace,1999-12-26,Durban,South Africa,1999,1,5,42,2,1,784,1865,22,779,1823,20,35.63636363636363,>30,SA,Home,Upto 2014
WJ Cronje,SA,Pace,2000-01-02,Cape Town,South Africa,2000,1,5,18,0,1,594,1440,24,589,1422,24,24.75,<=30,SA,Home,Upto 2014
WJ Cronje,SA,Pace,2000-01-14,Centurion,South Africa,2000,1,15,30,0,1,437,835,14,422,805,14,31.214285714285715,>30,SA,Home,Upto 2014
WJ Cronje,SA,Pace,2000-02-24,Wankhede,India,2000,2,49,114,5,1,367,874,21,318,760,16,17.476190476190474,<=30,IND,Away,Upto 2014
WJ Cronje,SA,Pace,2000-03-02,Bengaluru,India,2000,2,34,90,1,1,357,999,12,323,909,11,29.75,<=30,IND,Away,Upto 2014
WJ Edrich,ENG,Pace,1938-06-10,Nottingham,England,1938,1,39,78,1,1,464,954,6,425,876,5,77.33333333333333,>30,ENG,Home,Upto 2014
WJ Edrich,ENG,Pace,1938-06-24,Lord's,England,1938,2,32,56,2,1,661,1148,17,629,1092,15,38.88235294117647,>30,ENG,Home,Upto 2014
WJ Edrich,ENG,Pace,1938-07-22,Leeds,England,1938,1,13,18,0,1,285,715,10,272,697,10,28.5,<=30,ENG,Home,Upto 2014
WJ Edrich,ENG,Pace,1938-08-20,The Oval,England,1938,1,55,60,1,1,391,703,13,336,643,12,30.076923076923077,>30,ENG,Home,Upto 2014
WJ Edrich,ENG,Pace,1938-12-24,Johannesburg,South Africa,1938,2,51,96,0,1,680,1468,10,629,1372,10,68.0,>30,SA,Away,Upto 2014
WJ Edrich,ENG,Pace,1938-12-31,Cape Town,South Africa,1938,2,20,64,0,1,456,999,10,436,935,10,45.6,>30,SA,Away,Upto 2014
WJ Edrich,ENG,Pace,1939-01-20,Durban,South Africa,1939,2,25,88,2,1,487,999,14,462,911,12,34.785714285714285,>30,SA,Away,Upto 2014
WJ Edrich,ENG,Pace,1939-02-18,Johannesburg,South Africa,1939,1,11,32,0,1,381,1034,15,370,1002,15,25.4,<=30,SA,Away,Upto 2014
WJ Edrich,ENG,Pace,1939-03-03,Durban,South Africa,1939,2,47,120,0,1,1100,3449,18,1053,3329,18,61.111111111111114,>30,SA,Away,Upto 2014
WJ Edrich,ENG,Pace,1946-08-17,The Oval,England,1946,1,68,116,4,1,220,560,7,152,444,3,31.428571428571427,>30,ENG,Home,Upto 2014
WJ Edrich,ENG,Pace,1946-11-29,Brisbane,Australia,1946,1,107,200,3,1,604,1516,23,497,1316,20,26.26086956521739,<=30,AUS,Away,Upto 2014
WJ Edrich,ENG,Pace,1946-12-13,Sydney,Australia,1946,1,79,208,3,1,412,1072,9,333,864,6,45.77777777777778,>30,AUS,Away,Upto 2014
WJ Edrich,ENG,Pace,1947-01-01,Melbourne,Australia,1947,2,136,227,3,1,922,1990,21,786,1763,18,43.904761904761905,>30,AUS,Away,Upto 2014
WJ Edrich,ENG,Pace,1947-01-31,Adelaide,Australia,1947,2,113,216,0,1,774,1993,20,661,1777,20,38.7,>30,AUS,Away,Upto 2014
WJ Edrich,ENG,Pace,1947-02-28,Sydney,Australia,1947,2,48,72,0,1,392,1131,16,344,1059,16,24.5,<=30,AUS,Away,Upto 2014
WJ Edrich,ENG,Pace,1947-03-21,Christchurch,New Zealand,1947,1,35,66,1,1,372,820,16,337,754,15,23.25,<=30,NZ,Away,Upto 2014
WJ Edrich,ENG,Pace,1947-06-07,Nottingham,England,1947,2,64,144,1,1,512,1333,14,448,1189,13,36.57142857142857,>30,ENG,Home,Upto 2014
WJ Edrich,ENG,Pace,1947-06-21,Lord's,England,1947,2,53,132,3,1,440,1124,10,387,992,7,44.0,>30,ENG,Home,Upto 2014
WJ Edrich,ENG,Pace,1947-07-05,Manchester,England,1947,2,172,347,8,1,744,1735,22,572,1388,14,33.81818181818182,>30,ENG,Home,Upto 2014
WJ Edrich,ENG,Pace,1947-07-26,Leeds,England,1947,2,81,186,4,1,268,799,16,187,613,12,16.75,<=30,ENG,Home,Upto 2014
WJ Edrich,ENG,Pace,1948-06-10,Nottingham,England,1948,2,92,132,0,1,600,1427,17,508,1295,17,35.294117647058826,>30,ENG,Home,Upto 2014
WJ Edrich,ENG,Pace,1948-06-24,Lord's,England,1948,2,54,60,1,1,703,1601,26,649,1541,25,27.03846153846154,<=30,ENG,Home,Upto 2014
WJ Edrich,ENG,Pace,1948-07-08,Manchester,England,1948,2,35,54,1,1,513,1476,16,478,1422,15,32.0625,>30,ENG,Home,Upto 2014
WJ Edrich,ENG,Pace,1948-07-22,Leeds,England,1948,1,19,18,0,1,942,2038,19,923,2020,19,49.578947368421055,>30,ENG,Home,Upto 2014
WJ Edrich,ENG,Pace,1948-08-14,The Oval,England,1948,1,38,54,1,1,239,753,15,201,699,14,15.933333333333334,<=30,ENG,Home,Upto 2014
WJ Edrich,ENG,Pace,1949-06-11,Leeds,England,1949,2,31,66,2,1,597,1077,16,566,1011,14,37.3125,>30,ENG,Home,Upto 2014
WJ Edrich,ENG,Pace,1949-06-25,Lord's,England,1949,1,16,24,0,1,435,853,4,419,829,4,108.75,>30,ENG,Home,Upto 2014
WJ Edrich,ENG,Pace,1949-07-23,Manchester,England,1949,2,34,54,0,1,464,974,13,430,920,13,35.69230769230769,>30,ENG,Home,Upto 2014
WJ Edrich,ENG,Pace,1949-08-13,The Oval,England,1949,1,16,18,0,1,489,877,14,473,859,14,34.92857142857143,>30,ENG,Home,Upto 2014
WJ Edrich,ENG,Pace,1950-06-08,Manchester,England,1950,2,14,30,0,1,157,402,3,143,372,3,52.333333333333336,>30,ENG,Home,Upto 2014
WJ Edrich,ENG,Pace,1950-06-24,Lord's,England,1950,2,67,174,0,1,279,874,5,212,700,5,55.8,>30,ENG,Home,Upto 2014
WJ Edrich,ENG,Pace,1954-11-26,Brisbane,Australia,1954,1,28,24,0,1,750,1616,15,722,1592,15,50.0,>30,AUS,Away,Upto 2014
WJ O'Reilly,AUS,Spin,1932-01-29,Adelaide,Australia,1932,2,155,490,4,1,610,1508,19,455,1018,15,32.10526315789474,>30,AUS,Home,Upto 2014
WJ O'Reilly,AUS,Spin,1932-02-12,Melbourne,Australia,1932,1,19,54,3,1,112,305,17,93,251,14,6.588235294117647,<=30,AUS,Home,Upto 2014
WJ O'Reilly,AUS,Spin,1932-12-02,Sydney,Australia,1932,1,117,402,3,1,288,900,4,171,498,1,72.0,>30,AUS,Home,Upto 2014
WJ O'Reilly,AUS,Spin,1932-12-30,Melbourne,Australia,1932,2,129,351,10,1,223,670,15,94,319,5,14.866666666666667,<=30,AUS,Home,Upto 2014
WJ O'Reilly,AUS,Spin,1933-01-13,Adelaide,Australia,1933,2,161,603,6,1,546,1683,15,385,1080,9,36.4,>30,AUS,Home,Upto 2014
WJ O'Reilly,AUS,Spin,1933-02-10,Brisbane,Australia,1933,2,185,586,5,1,466,1558,15,281,972,10,31.066666666666666,>30,AUS,Home,Upto 2014
WJ O'Reilly,AUS,Spin,1933-02-23,Sydney,Australia,1933,2,132,360,3,1,492,1240,17,360,880,14,28.941176470588236,<=30,AUS,Home,Upto 2014
WJ O'Reilly,AUS,Spin,1934-06-08,Nottingham,England,1934,2,129,472,11,1,499,1663,22,370,1191,11,22.681818181818183,<=30,ENG,Away,Upto 2014
WJ O'Reilly,AUS,Spin,1934-06-22,Lord's,England,1934,1,70,228,1,1,377,1128,20,307,900,19,18.85,<=30,ENG,Away,Upto 2014
WJ O'Reilly,AUS,Spin,1934-07-06,Manchester,England,1934,2,214,432,7,1,477,1272,12,263,840,5,39.75,>30,ENG,Away,Upto 2014
WJ O'Reilly,AUS,Spin,1934-07-20,Leeds,England,1934,2,134,516,5,1,569,1652,17,435,1136,12,33.470588235294116,>30,ENG,Away,Upto 2014
WJ O'Reilly,AUS,Spin,1934-08-18,The Oval,England,1934,2,151,354,4,1,526,1194,12,375,840,8,43.833333333333336,>30,ENG,Away,Upto 2014
WJ O'Reilly,AUS,Spin,1935-12-14,Durban,South Africa,1935,2,104,302,8,1,684,1775,22,580,1473,14,31.09090909090909,>30,SA,Away,Upto 2014
WJ O'Reilly,AUS,Spin,1935-12-24,Johannesburg,South Africa,1935,2,145,335,5,1,577,1226,18,432,891,13,32.05555555555556,>30,SA,Away,Upto 2014
WJ O'Reilly,AUS,Spin,1936-01-01,Cape Town,South Africa,1936,2,59,216,5,1,468,1146,24,409,930,19,19.5,<=30,SA,Away,Upto 2014
WJ O'Reilly,AUS,Spin,1936-02-15,Johannesburg,South Africa,1936,2,46,186,5,1,374,819,19,328,633,14,19.68421052631579,<=30,SA,Away,Upto 2014
WJ O'Reilly,AUS,Spin,1936-02-28,Durban,South Africa,1936,2,106,463,4,1,543,1530,23,437,1067,19,23.608695652173914,<=30,SA,Away,Upto 2014
WJ O'Reilly,AUS,Spin,1936-12-04,Brisbane,Australia,1936,2,161,606,5,1,566,1790,14,405,1184,9,40.42857142857143,>30,AUS,Home,Upto 2014
WJ O'Reilly,AUS,Spin,1936-12-18,Sydney,Australia,1936,1,86,328,1,1,468,1160,7,382,832,6,66.85714285714286,>30,AUS,Home,Upto 2014
WJ O'Reilly,AUS,Spin,1937-01-01,Melbourne,Australia,1937,2,93,264,6,1,614,1405,21,521,1141,15,29.238095238095237,<=30,AUS,Home,Upto 2014
WJ O'Reilly,AUS,Spin,1937-01-29,Adelaide,Australia,1937,2,106,448,5,1,554,1660,17,448,1212,12,32.588235294117645,>30,AUS,Home,Upto 2014
WJ O'Reilly,AUS,Spin,1937-02-26,Melbourne,Australia,1937,2,109,336,8,1,349,938,13,240,602,5,26.846153846153847,<=30,AUS,Home,Upto 2014
WJ O'Reilly,AUS,Spin,1938-06-10,Nottingham,England,1938,1,164,336,3,1,958,2061,18,794,1725,15,53.22222222222222,>30,ENG,Away,Upto 2014
WJ O'Reilly,AUS,Spin,1938-06-24,Lord's,England,1938,2,146,396,6,1,622,1129,16,476,733,10,38.875,>30,ENG,Away,Upto 2014
WJ O'Reilly,AUS,Spin,1938-07-22,Leeds,England,1938,2,122,336,10,1,387,966,24,265,630,14,16.125,<=30,ENG,Away,Upto 2014
WJ O'Reilly,AUS,Spin,1938-08-20,The Oval,England,1938,1,178,510,3,1,776,1827,9,598,1317,6,86.22222222222223,>30,ENG,Away,Upto 2014
WJ O'Reilly,AUS,Spin,1946-03-29,Wellington,New Zealand,1946,2,33,114,8,1,63,182,11,30,68,3,5.7272727272727275,<=30,NZ,Away,Upto 2014
WJ Watson,AUS,Spin,1955-05-14,Bridgetown,West Indies,1955,1,5,6,0,1,1042,2444,22,1037,2438,22,47.36363636363637,>30,WI,Away,Upto 2014
WJ Whitty,AUS,Pace,1909-05-27,Birmingham,England,1909,2,61,132,0,1,206,487,10,145,355,10,20.6,<=30,ENG,Away,Upto 2014
WJ Whitty,AUS,Pace,1910-12-09,Sydney,Australia,1910,2,108,270,8,1,517,899,22,409,629,14,23.5,<=30,AUS,Home,Upto 2014
WJ Whitty,AUS,Pace,1910-12-31,Melbourne,Australia,1910,2,98,270,9,1,540,1002,17,442,732,8,31.764705882352942,>30,AUS,Home,Upto 2014
WJ Whitty,AUS,Pace,1911-01-07,Adelaide,Australia,1911,2,218,440,8,1,771,1501,18,553,1061,10,42.833333333333336,>30,AUS,Home,Upto 2014
WJ Whitty,AUS,Pace,1911-02-17,Melbourne,Australia,1911,2,110,186,6,1,399,623,10,289,437,4,39.9,>30,AUS,Home,Upto 2014
WJ Whitty,AUS,Pace,1911-03-03,Sydney,Australia,1911,2,98,229,6,1,447,806,13,349,577,7,34.38461538461539,>30,AUS,Home,Upto 2014
WJ Whitty,AUS,Pace,1911-12-15,Sydney,Australia,1911,2,101,288,1,1,824,1814,23,723,1526,22,35.82608695652174,>30,AUS,Home,Upto 2014
WJ Whitty,AUS,Pace,1911-12-30,Melbourne,Australia,1911,2,84,222,2,1,685,1483,24,601,1261,22,28.541666666666668,<=30,AUS,Home,Upto 2014
WJ Whitty,AUS,Pace,1912-05-27,Manchester,England,1912,2,70,240,7,1,239,566,12,169,326,5,19.916666666666668,<=30,ENG,Away,Upto 2014
WJ Whitty,AUS,Pace,1912-06-24,Lord's,England,1912,1,69,72,1,1,300,774,7,231,702,6,42.857142857142854,>30,ENG,Away,Upto 2014
WJ Whitty,AUS,Pace,1912-07-15,Lord's,England,1912,2,109,240,4,1,300,697,11,191,457,7,27.272727272727273,<=30,ENG,Away,Upto 2014
WJ Whitty,AUS,Pace,1912-07-29,Manchester,England,1912,1,43,162,4,1,68,240,4,25,78,0,17.0,<=30,ENG,Away,Upto 2014
WJ Whitty,AUS,Pace,1912-08-05,Nottingham,England,1912,1,64,180,2,1,106,300,3,42,120,1,35.333333333333336,>30,ENG,Away,Upto 2014
WJ Whitty,AUS,Pace,1912-08-19,The Oval,England,1912,2,140,426,7,1,291,877,20,151,451,13,14.55,<=30,ENG,Away,Upto 2014
WK Lees,NZ,Pace,1976-10-23,Hyderabad (Sind),Pakistan,1976,1,4,5,0,1,398,904,11,394,899,11,36.18181818181818,>30,PAK,Away,Upto 2014
WKM Benjamin,WI,Pace,1987-11-25,Delhi,India,1987,2,93,180,2,1,549,1170,28,456,990,26,19.607142857142858,<=30,IND,Away,Upto 2014
WKM Benjamin,WI,Pace,1988-04-02,Georgetown,West Indies,1988,1,99,186,1,1,579,1055,22,480,869,21,26.318181818181817,<=30,WI,Home,Upto 2014
WKM Benjamin,WI,Pace,1988-04-14,Port of Spain,West Indies,1988,2,105,240,6,1,692,1635,27,587,1395,21,25.62962962962963,<=30,WI,Home,Upto 2014
WKM Benjamin,WI,Pace,1988-04-22,Bridgetown,West Indies,1988,2,89,174,5,1,833,1467,30,744,1293,25,27.766666666666666,<=30,WI,Home,Upto 2014
WKM Benjamin,WI,Pace,1988-06-30,Manchester,England,1988,2,37,102,3,1,423,1051,26,386,949,23,16.26923076923077,<=30,ENG,Away,Upto 2014
WKM Benjamin,WI,Pace,1988-07-21,Leeds,England,1988,2,29,84,4,1,613,1328,28,584,1244,24,21.892857142857142,<=30,ENG,Away,Upto 2014
WKM Benjamin,WI,Pace,1988-08-04,The Oval,England,1988,2,85,216,5,1,629,1534,24,544,1318,19,26.208333333333332,<=30,ENG,Away,Upto 2014
WKM Benjamin,WI,Pace,1989-03-25,Georgetown,West Indies,1989,1,27,66,0,1,194,462,4,167,396,4,48.5,>30,WI,Home,Upto 2014
WKM Benjamin,WI,Pace,1993-04-23,Bridgetown,West Indies,1993,2,85,216,5,1,783,1460,25,698,1244,20,31.32,>30,WI,Home,Upto 2014
WKM Benjamin,WI,Pace,1993-05-01,St John's,West Indies,1993,1,53,120,3,1,577,1130,21,524,1010,18,27.476190476190474,<=30,WI,Home,Upto 2014
WKM Benjamin,WI,Pace,1993-12-08,Moratuwa,Sri Lanka,1993,2,51,156,5,1,179,537,9,128,381,4,19.88888888888889,<=30,SL,Away,Upto 2014
WKM Benjamin,WI,Pace,1994-02-19,Kingston,West Indies,1994,2,99,235,3,1,877,1820,28,778,1585,25,31.321428571428573,>30,WI,Home,Upto 2014
WKM Benjamin,WI,Pace,1994-03-17,Georgetown,West Indies,1994,2,106,252,1,1,724,1622,26,618,1370,25,27.846153846153847,<=30,WI,Home,Upto 2014
WKM Benjamin,WI,Pace,1994-03-25,Port of Spain,West Indies,1994,1,66,144,3,1,673,1600,36,607,1456,33,18.694444444444443,<=30,WI,Home,Upto 2014
WKM Benjamin,WI,Pace,1994-04-08,Bridgetown,West Indies,1994,2,134,264,3,1,996,1767,31,862,1503,28,32.12903225806452,>30,WI,Home,Upto 2014
WKM Benjamin,WI,Pace,1994-04-16,St John's,West Indies,1994,1,93,247,2,1,833,1731,12,740,1484,10,69.41666666666667,>30,WI,Home,Upto 2014
WKM Benjamin,WI,Pace,1995-02-03,Christchurch,New Zealand,1995,2,106,228,1,1,515,1143,17,409,915,16,30.294117647058822,>30,NZ,Away,Upto 2014
WKM Benjamin,WI,Pace,1995-03-31,Bridgetown,West Indies,1995,1,71,140,3,1,554,1046,24,483,906,21,23.083333333333332,<=30,WI,Home,Upto 2014
WKM Benjamin,WI,Pace,1995-04-08,St John's,West Indies,1995,2,112,234,4,1,658,1384,24,546,1150,20,27.416666666666668,<=30,WI,Home,Upto 2014
WKM Benjamin,WI,Pace,1995-04-21,Port of Spain,West Indies,1995,2,28,66,1,1,399,876,29,371,810,28,13.758620689655173,<=30,WI,Home,Upto 2014
WKM Benjamin,WI,Pace,1995-04-29,Kingston,West Indies,1995,1,80,144,1,1,658,1221,21,578,1077,20,31.333333333333332,>30,WI,Home,Upto 2014
WM Bradley,ENG,Pace,1899-07-17,Manchester,England,1899,2,149,395,6,1,742,1679,23,593,1284,17,32.26086956521739,>30,ENG,Home,After 1965
WM Bradley,ENG,Pace,1899-08-14,The Oval,England,1899,2,84,230,0,1,660,1288,13,576,1058,13,50.76923076923077,>30,ENG,Home,After 1965
WM Clark,AUS,Pace,1977-12-02,Brisbane,Australia,1977,2,147,352,8,1,540,1279,27,393,927,19,20.0,<=30,AUS,Home,Upto 2014
WM Clark,AUS,Pace,1977-12-16,W.A.C.A,Australia,1977,2,178,280,4,1,682,1283,21,504,1003,17,32.476190476190474,>30,AUS,Home,Upto 2014
WM Clark,AUS,Pace,1977-12-30,Melbourne,Australia,1977,2,169,386,8,1,588,1273,19,419,887,11,30.94736842105263,>30,AUS,Home,Upto 2014
WM Clark,AUS,Pace,1978-01-07,Sydney,Australia,1978,1,66,168,2,1,322,871,11,256,703,9,29.272727272727273,<=30,AUS,Home,Upto 2014
WM Clark,AUS,Pace,1978-01-28,Adelaide,Australia,1978,2,141,399,6,1,564,1391,22,423,992,16,25.636363636363637,<=30,AUS,Home,Upto 2014
WM Clark,AUS,Pace,1978-03-03,Port of Spain,West Indies,1978,1,41,96,0,1,396,789,19,355,693,19,20.842105263157894,<=30,WI,Away,Upto 2014
WM Clark,AUS,Pace,1978-03-17,Bridgetown,West Indies,1978,2,104,186,2,1,577,955,26,473,769,24,22.192307692307693,<=30,WI,Away,Upto 2014
WM Clark,AUS,Pace,1978-03-31,Georgetown,West Indies,1978,2,189,352,8,1,786,1458,28,597,1106,20,28.071428571428573,<=30,WI,Away,Upto 2014
WM Clark,AUS,Pace,1978-04-15,Port of Spain,West Indies,1978,2,127,270,5,1,408,786,17,281,516,12,24.0,<=30,WI,Away,Upto 2014
WM Clark,AUS,Pace,1979-03-10,Melbourne,Australia,1979,2,103,304,1,1,679,1863,29,576,1559,28,23.413793103448278,<=30,AUS,Home,Upto 2014
WM Lawry,AUS,Pace,1963-01-25,Adelaide,Australia,1963,1,0,8,0,1,686,1693,27,686,1685,27,25.40740740740741,<=30,AUS,Home,Upto 2014
WM Lawry,AUS,Pace,1969-11-15,Kanpur,India,1969,1,6,6,0,1,379,992,12,373,986,12,31.583333333333332,>30,IND,Away,Upto 2014
WM Wallace,NZ,Spin,1949-06-25,Lord's,England,1949,1,5,6,0,1,624,1342,19,619,1336,19,32.8421052631579,>30,ENG,Away,Upto 2014
WP Howell,AUS,Pace,1898-01-14,Adelaide,Australia,1898,2,130,564,4,1,674,1910,19,544,1346,15,35.473684210526315,>30,AUS,Home,After 1965
WP Howell,AUS,Pace,1898-01-29,Melbourne,Australia,1898,2,92,276,3,1,528,1140,21,436,864,18,25.142857142857142,<=30,AUS,Home,After 1965
WP Howell,AUS,Pace,1898-02-26,Sydney,Australia,1898,2,62,139,2,1,648,1334,24,586,1195,22,27.0,<=30,AUS,Home,After 1965
WP Howell,AUS,Pace,1899-06-01,Nottingham,England,1899,2,97,329,4,1,533,1449,20,436,1120,16,26.65,<=30,ENG,Away,After 1965
WP Howell,AUS,Pace,1899-06-15,Lord's,England,1899,2,110,225,2,1,490,1002,18,380,777,16,27.22222222222222,<=30,ENG,Away,After 1965
WP Howell,AUS,Pace,1899-06-29,Leeds,England,1899,1,29,65,0,1,374,834,15,345,769,15,24.933333333333334,<=30,ENG,Away,After 1965
WP Howell,AUS,Pace,1899-07-17,Manchester,England,1899,2,67,126,2,1,742,1679,23,675,1553,21,32.26086956521739,>30,ENG,Away,After 1965
WP Howell,AUS,Pace,1899-08-14,The Oval,England,1899,1,43,75,0,1,660,1288,13,617,1213,13,50.76923076923077,>30,ENG,Away,After 1965
WP Howell,AUS,Pace,1901-12-13,Sydney,Australia,1901,1,52,126,1,1,416,1027,14,364,901,13,29.714285714285715,<=30,AUS,Home,Upto 2014
WP Howell,AUS,Pace,1902-01-01,Melbourne,Australia,1902,1,23,90,0,1,229,661,13,206,571,13,17.615384615384617,<=30,AUS,Home,Upto 2014
WP Howell,AUS,Pace,1902-01-17,Adelaide,Australia,1902,2,136,378,2,1,342,876,5,206,498,3,68.4,>30,AUS,Home,Upto 2014
WP Howell,AUS,Pace,1902-02-14,Sydney,Australia,1902,1,40,132,0,1,131,330,4,91,198,4,32.75,>30,AUS,Home,Upto 2014
WP Howell,AUS,Pace,1902-05-29,Birmingham,England,1902,1,58,156,1,1,229,582,9,171,426,8,25.444444444444443,<=30,ENG,Away,Upto 2014
WP Howell,AUS,Pace,1902-10-18,Johannesburg,South Africa,1902,2,75,126,5,1,466,648,16,391,522,11,29.125,<=30,SA,Away,Upto 2014
WP Howell,AUS,Pace,1902-11-08,Cape Town,South Africa,1902,2,99,258,9,1,317,563,15,218,305,6,21.133333333333333,<=30,SA,Away,Upto 2014
WP Howell,AUS,Pace,1903-12-11,Sydney,Australia,1903,2,146,372,5,1,649,1476,14,503,1104,9,46.357142857142854,>30,AUS,Home,Upto 2014
WP Howell,AUS,Pace,1904-01-01,Melbourne,Australia,1904,2,68,257,6,1,196,525,10,128,268,4,19.6,<=30,AUS,Home,Upto 2014
WP Howell,AUS,Pace,1904-01-15,Adelaide,Australia,1904,2,80,198,3,1,683,1465,19,603,1267,16,35.94736842105263,>30,AUS,Home,Upto 2014
WP Masakadza,ZIM,Spin,2018-11-03,Sylhet,Bangladesh,2018,2,54,79,2,1,549,1328,32,495,1249,30,17.15625,<=30,BAN,Away,After 1965
WP Masakadza,ZIM,Spin,2023-02-04,Bulawayo,Zimbabwe,2023,2,156,324,4,1,573,1170,18,417,846,14,31.833333333333332,>30,ZIM,Home,After 1965
WP Masakadza,ZIM,Spin,2023-02-12,Bulawayo,Zimbabwe,2023,1,58,120,1,1,284,566,18,226,446,17,15.777777777777779,<=30,ZIM,Home,After 1965
WPA Crawford,AUS,Pace,1956-06-21,Lord's,England,1956,1,4,29,0,1,698,1897,33,694,1868,33,21.151515151515152,<=30,ENG,Away,Upto 2014
WPA Crawford,AUS,Pace,1956-10-19,Chennai,India,1956,2,50,228,4,1,145,569,11,95,341,7,13.181818181818182,<=30,IND,Away,Upto 2014
WPA Crawford,AUS,Pace,1956-10-26,Brabourne,India,1956,2,52,150,3,1,321,854,10,269,704,7,32.1,>30,IND,Away,Upto 2014
WPA Crawford,AUS,Pace,1956-11-02,Eden Gardens,India,1956,2,1,30,0,1,49,278,4,48,248,4,12.25,<=30,IND,Away,Upto 2014
WPUJC Vaas,SL,Pace,1994-08-26,Kandy,Sri Lanka,1994,1,80,132,0,1,485,782,21,405,650,21,23.095238095238095,<=30,SL,Home,Upto 2014
WPUJC Vaas,SL,Pace,1994-10-11,Harare,Zimbabwe,1994,1,74,222,4,1,445,1241,16,371,1019,12,27.8125,<=30,ZIM,Away,Upto 2014
WPUJC Vaas,SL,Pace,1994-10-20,Bulawayo,Zimbabwe,1994,1,85,267,4,1,524,1630,17,439,1363,13,30.823529411764707,>30,ZIM,Away,Upto 2014
WPUJC Vaas,SL,Pace,1994-10-26,Harare,Zimbabwe,1994,1,76,264,2,1,659,1576,19,583,1312,17,34.68421052631579,>30,ZIM,Away,Upto 2014
WPUJC Vaas,SL,Pace,1995-03-11,Napier,New Zealand,1995,2,90,273,10,1,717,1794,34,627,1521,24,21.08823529411765,<=30,NZ,Away,Upto 2014
WPUJC Vaas,SL,Pace,1995-03-18,Dunedin,New Zealand,1995,2,87,241,6,1,657,1600,18,570,1359,12,36.5,>30,NZ,Away,Upto 2014
WPUJC Vaas,SL,Pace,1995-09-08,Peshawar,Pakistan,1995,1,99,174,5,1,562,1039,16,463,865,11,35.125,>30,PAK,Away,Upto 2014
WPUJC Vaas,SL,Pace,1995-09-15,Faisalabad,Pakistan,1995,2,80,174,4,1,465,1059,21,385,885,17,22.142857142857142,<=30,PAK,Away,Upto 2014
WPUJC Vaas,SL,Pace,1995-09-22,Sialkot,Pakistan,1995,2,75,228,4,1,584,1401,24,509,1173,20,24.333333333333332,<=30,PAK,Away,Upto 2014
WPUJC Vaas,SL,Pace,1995-12-08,W.A.C.A,Australia,1995,1,103,186,2,1,613,1126,16,510,940,14,38.3125,>30,AUS,Away,Upto 2014
WPUJC Vaas,SL,Pace,1995-12-26,Melbourne,Australia,1995,2,118,262,1,1,608,1377,17,490,1115,16,35.76470588235294,>30,AUS,Away,Upto 2014
WPUJC Vaas,SL,Pace,1996-01-25,Adelaide,Australia,1996,2,150,378,6,1,886,1812,32,736,1434,26,27.6875,<=30,AUS,Away,Upto 2014
WPUJC Vaas,SL,Pace,1996-09-11,Colombo (RPS),Sri Lanka,1996,2,107,204,4,1,295,564,9,188,360,5,32.77777777777778,>30,SL,Home,Upto 2014
WPUJC Vaas,SL,Pace,1996-09-18,Colombo (SSC),Sri Lanka,1996,2,65,219,2,1,332,732,8,267,513,6,41.5,>30,SL,Home,Upto 2014
WPUJC Vaas,SL,Pace,1997-03-07,Dunedin,New Zealand,1997,1,144,210,4,1,739,1295,21,595,1085,17,35.19047619047619,>30,NZ,Away,Upto 2014
WPUJC Vaas,SL,Pace,1997-03-14,Hamilton,New Zealand,1997,2,66,166,2,1,399,988,18,333,822,16,22.166666666666668,<=30,NZ,Away,Upto 2014
WPUJC Vaas,SL,Pace,1997-04-19,Colombo (RPS),Sri Lanka,1997,1,75,192,1,1,337,618,3,262,426,2,112.33333333333333,>30,SL,Home,Upto 2014
WPUJC Vaas,SL,Pace,1997-04-26,Colombo (SSC),Sri Lanka,1997,2,100,258,6,1,378,693,12,278,435,6,31.5,>30,SL,Home,Upto 2014
WPUJC Vaas,SL,Pace,1997-08-02,Colombo (RPS),Sri Lanka,1997,1,80,138,1,1,398,549,5,318,411,4,79.6,>30,SL,Home,Upto 2014
WPUJC Vaas,SL,Pace,1997-08-09,Colombo (SSC),Sri Lanka,1997,2,111,264,3,1,927,1577,19,816,1313,16,48.78947368421053,>30,SL,Home,Upto 2014
WPUJC Vaas,SL,Pace,1997-11-19,Mohali,India,1997,1,107,221,2,1,565,1196,16,458,975,14,35.3125,>30,IND,Away,Upto 2014
WPUJC Vaas,SL,Pace,1997-11-26,Nagpur,India,1997,1,80,186,2,1,210,384,7,130,198,5,30.0,<=30,IND,Away,Upto 2014
WPUJC Vaas,SL,Pace,1997-12-03,Wankhede,India,1997,2,105,186,0,1,639,1269,12,534,1083,12,53.25,>30,IND,Away,Upto 2014
WPUJC Vaas,SL,Pace,1998-01-07,Kandy,Sri Lanka,1998,2,101,246,2,1,383,839,8,282,593,6,47.875,>30,SL,Home,Upto 2014
WPUJC Vaas,SL,Pace,1998-01-14,Colombo (SSC),Sri Lanka,1998,1,35,72,2,1,369,728,14,334,656,12,26.357142857142858,<=30,SL,Home,Upto 2014
WPUJC Vaas,SL,Pace,1998-03-19,Cape Town,South Africa,1998,2,116,192,4,1,757,1378,22,641,1186,18,34.40909090909091,>30,SA,Away,Upto 2014
WPUJC Vaas,SL,Pace,1999-02-24,Colombo (SSC),Sri Lanka,1999,2,166,294,1,1,790,1434,9,624,1140,8,87.77777777777777,>30,SL,Home,Upto 2014
WPUJC Vaas,SL,Pace,1999-03-12,Dhaka,Bangladesh,1999,1,101,192,0,1,404,794,8,303,602,8,50.5,>30,BAN,Away,Upto 2014
WPUJC Vaas,SL,Pace,1999-09-09,Kandy,Sri Lanka,1999,2,58,186,6,1,252,546,11,194,360,5,22.90909090909091,<=30,SL,Home,Upto 2014
WPUJC Vaas,SL,Pace,1999-09-22,Galle,Sri Lanka,1999,1,31,54,0,1,252,497,5,221,443,5,50.4,>30,SL,Home,Upto 2014
WPUJC Vaas,SL,Pace,1999-09-30,Colombo (SSC),Sri Lanka,1999,1,54,142,4,1,116,297,8,62,155,4,14.5,<=30,SL,Home,Upto 2014
WPUJC Vaas,SL,Pace,1999-11-18,Bulawayo,Zimbabwe,1999,2,115,246,3,1,569,1220,18,454,974,15,31.61111111111111,>30,ZIM,Away,Upto 2014
WPUJC Vaas,SL,Pace,1999-11-26,Harare,Zimbabwe,1999,2,128,372,4,1,681,1742,19,553,1370,15,35.8421052631579,>30,ZIM,Away,Upto 2014
WPUJC Vaas,SL,Pace,1999-12-04,Harare,Zimbabwe,1999,2,104,310,7,1,525,1358,25,421,1048,18,21.0,<=30,ZIM,Away,Upto 2014
WPUJC Vaas,SL,Pace,2000-02-26,Rawalpindi,Pakistan,2000,2,139,348,5,1,697,1541,24,558,1193,19,29.041666666666668,<=30,PAK,Away,Upto 2014
WPUJC Vaas,SL,Pace,2000-03-05,Peshawar,Pakistan,2000,2,113,216,5,1,480,1060,20,367,844,15,24.0,<=30,PAK,Away,Upto 2014
WPUJC Vaas,SL,Pace,2000-03-12,Karachi,Pakistan,2000,2,156,312,3,1,750,1272,22,594,960,19,34.09090909090909,>30,PAK,Away,Upto 2014
WPUJC Vaas,SL,Pace,2000-06-14,Colombo (SSC),Sri Lanka,2000,2,72,222,0,1,461,1090,17,389,868,17,27.11764705882353,<=30,SL,Home,Upto 2014
WPUJC Vaas,SL,Pace,2000-06-21,Galle,Sri Lanka,2000,1,82,204,0,1,578,1128,20,496,924,20,28.9,<=30,SL,Home,Upto 2014
WPUJC Vaas,SL,Pace,2000-07-20,Galle,Sri Lanka,2000,2,34,114,0,1,282,658,5,248,544,5,56.4,>30,SL,Home,Upto 2014
WPUJC Vaas,SL,Pace,2000-07-30,Kandy,Sri Lanka,2000,2,28,132,2,1,362,832,17,334,700,15,21.294117647058822,<=30,SL,Home,Upto 2014
WPUJC Vaas,SL,Pace,2000-08-06,Colombo (SSC),Sri Lanka,2000,2,107,276,4,1,430,969,14,323,693,10,30.714285714285715,>30,SL,Home,Upto 2014
WPUJC Vaas,SL,Pace,2000-12-26,Durban,South Africa,2000,2,109,210,0,1,618,1336,17,509,1126,17,36.35294117647059,>30,SA,Away,Upto 2014
WPUJC Vaas,SL,Pace,2001-01-02,Cape Town,South Africa,2001,1,109,192,1,1,537,948,18,428,756,17,29.833333333333332,<=30,SA,Away,Upto 2014
WPUJC Vaas,SL,Pace,2001-02-22,Galle,Sri Lanka,2001,2,82,234,4,1,243,606,5,161,372,1,48.6,>30,SL,Home,Upto 2014
WPUJC Vaas,SL,Pace,2001-03-07,Kandy,Sri Lanka,2001,2,78,246,6,1,362,762,19,284,516,13,19.05263157894737,<=30,SL,Home,Upto 2014
WPUJC Vaas,SL,Pace,2001-03-15,Colombo (SSC),Sri Lanka,2001,2,84,185,6,1,242,462,16,158,277,10,15.125,<=30,SL,Home,Upto 2014
WPUJC Vaas,SL,Pace,2001-08-14,Galle,Sri Lanka,2001,2,83,228,1,1,532,1132,18,449,904,17,29.555555555555557,<=30,SL,Home,Upto 2014
WPUJC Vaas,SL,Pace,2001-08-22,Kandy,Sri Lanka,2001,2,107,250,4,1,745,1357,27,638,1107,23,27.59259259259259,<=30,SL,Home,Upto 2014
WPUJC Vaas,SL,Pace,2001-08-29,Colombo (SSC),Sri Lanka,2001,2,122,306,4,1,542,1005,7,420,699,3,77.42857142857143,>30,SL,Home,Upto 2014
WPUJC Vaas,SL,Pace,2001-09-06,Colombo (SSC),Sri Lanka,2001,2,118,180,3,1,535,726,8,417,546,5,66.875,>30,SL,Home,Upto 2014
WPUJC Vaas,SL,Pace,2001-11-13,Galle,Sri Lanka,2001,2,115,288,6,1,470,944,10,355,656,4,47.0,>30,SL,Home,Upto 2014
WPUJC Vaas,SL,Pace,2001-11-21,Kandy,Sri Lanka,2001,2,95,210,6,1,410,847,17,315,637,11,24.11764705882353,<=30,SL,Home,Upto 2014
WPUJC Vaas,SL,Pace,2001-11-29,Colombo (SSC),Sri Lanka,2001,2,191,344,14,1,728,1313,22,537,969,8,33.09090909090909,>30,SL,Home,Upto 2014
WPUJC Vaas,SL,Pace,2001-12-27,Colombo (SSC),Sri Lanka,2001,2,139,272,3,1,677,1297,14,538,1025,11,48.357142857142854,>30,SL,Home,Upto 2014
WPUJC Vaas,SL,Pace,2002-01-04,Kandy,Sri Lanka,2002,2,93,210,3,1,529,977,13,436,767,10,40.69230769230769,>30,SL,Home,Upto 2014
WPUJC Vaas,SL,Pace,2002-01-12,Galle,Sri Lanka,2002,2,53,159,2,1,402,843,7,349,684,5,57.42857142857143,>30,SL,Home,Upto 2014
WPUJC Vaas,SL,Pace,2002-03-06,Lahore,Pakistan,2002,2,147,239,6,1,853,1374,23,706,1135,17,37.08695652173913,>30,PAK,Away,Upto 2014
WPUJC Vaas,SL,Pace,2002-05-16,Lord's,England,2002,2,164,391,1,1,1188,2251,20,1024,1860,19,59.4,>30,ENG,Away,Upto 2014
WPUJC Vaas,SL,Pace,2002-05-30,Birmingham,England,2002,1,141,246,1,1,687,1192,22,546,946,21,31.227272727272727,>30,ENG,Away,Upto 2014
WPUJC Vaas,SL,Pace,2002-06-13,Manchester,England,2002,2,129,234,2,1,775,1409,20,646,1175,18,38.75,>30,ENG,Away,Upto 2014
WPUJC Vaas,SL,Pace,2002-11-08,Johannesburg,South Africa,2002,1,79,132,3,1,582,1139,26,503,1007,23,22.384615384615383,<=30,SA,Away,Upto 2014
WPUJC Vaas,SL,Pace,2002-11-15,Centurion,South Africa,2002,2,109,249,3,1,905,1840,32,796,1591,29,28.28125,<=30,SA,Away,Upto 2014
WPUJC Vaas,SL,Pace,2003-04-25,Colombo (PSS),Sri Lanka,2003,2,100,216,1,1,412,858,7,312,642,6,58.857142857142854,>30,SL,Home,Upto 2014
WPUJC Vaas,SL,Pace,2003-05-03,Kandy,Sri Lanka,2003,2,79,225,5,1,352,866,14,273,641,9,25.142857142857142,<=30,SL,Home,Upto 2014
WPUJC Vaas,SL,Pace,2003-06-20,Gros Islet,West Indies,2003,1,116,234,1,1,539,1047,9,423,813,8,59.888888888888886,>30,WI,Away,Upto 2014
WPUJC Vaas,SL,Pace,2003-06-27,Kingston,West Indies,2003,2,87,162,3,1,610,1045,26,523,883,23,23.46153846153846,<=30,WI,Away,Upto 2014
WPUJC Vaas,SL,Pace,2003-12-02,Galle,Sri Lanka,2003,2,48,156,3,1,348,780,10,300,624,7,34.8,>30,SL,Home,Upto 2014
WPUJC Vaas,SL,Pace,2003-12-10,Kandy,Sri Lanka,2003,2,136,320,6,1,489,1010,13,353,690,7,37.61538461538461,>30,SL,Home,Upto 2014
WPUJC Vaas,SL,Pace,2003-12-18,Colombo (SSC),Sri Lanka,2003,2,89,144,4,1,444,738,12,355,594,8,37.0,>30,SL,Home,Upto 2014
WPUJC Vaas,SL,Pace,2004-03-08,Galle,Sri Lanka,2004,2,106,234,1,1,256,624,5,150,390,4,51.2,>30,SL,Home,Upto 2014
WPUJC Vaas,SL,Pace,2004-03-16,Kandy,Sri Lanka,2004,2,117,266,5,1,512,998,21,395,732,16,24.38095238095238,<=30,SL,Home,Upto 2014
WPUJC Vaas,SL,Pace,2004-03-24,Colombo (SSC),Sri Lanka,2004,2,154,282,5,1,527,998,13,373,716,8,40.53846153846154,>30,SL,Home,Upto 2014
WPUJC Vaas,SL,Pace,2004-05-06,Harare,Zimbabwe,2004,2,63,162,1,1,612,996,20,549,834,19,30.6,>30,ZIM,Away,Upto 2014
WPUJC Vaas,SL,Pace,2004-05-14,Bulawayo,Zimbabwe,2004,2,94,222,5,1,856,1362,13,762,1140,8,65.84615384615384,>30,ZIM,Away,Upto 2014
WPUJC Vaas,SL,Pace,2004-07-01,Darwin,Australia,2004,2,82,195,7,1,425,1034,30,343,839,23,14.166666666666666,<=30,AUS,Away,Upto 2014
WPUJC Vaas,SL,Pace,2004-07-09,Cairns,Australia,2004,2,154,240,0,1,844,1536,15,690,1296,15,56.266666666666666,>30,AUS,Away,Upto 2014
WPUJC Vaas,SL,Pace,2004-08-04,Galle,Sri Lanka,2004,2,70,210,2,1,548,1192,14,478,982,12,39.142857142857146,>30,SL,Home,Upto 2014
WPUJC Vaas,SL,Pace,2004-08-11,Colombo (SSC),Sri Lanka,2004,2,39,150,7,1,548,1014,21,509,864,14,26.095238095238095,<=30,SL,Home,Upto 2014
WPUJC Vaas,SL,Pace,2004-10-20,Faisalabad,Pakistan,2004,2,116,252,2,1,726,1252,21,610,1000,19,34.57142857142857,>30,PAK,Away,Upto 2014
WPUJC Vaas,SL,Pace,2004-10-28,Karachi,Pakistan,2004,2,151,282,5,1,689,1333,19,538,1051,14,36.26315789473684,>30,PAK,Away,Upto 2014
WPUJC Vaas,SL,Pace,2005-04-04,Napier,New Zealand,2005,2,163,300,2,1,832,1538,21,669,1238,19,39.61904761904762,>30,NZ,Away,Upto 2014
WPUJC Vaas,SL,Pace,2005-04-11,Wellington,New Zealand,2005,1,108,240,6,1,716,1428,28,608,1188,22,25.571428571428573,<=30,NZ,Away,Upto 2014
WPUJC Vaas,SL,Pace,2005-07-13,Colombo (SSC),Sri Lanka,2005,2,50,208,7,1,469,856,25,419,648,18,18.76,<=30,SL,Home,Upto 2014
WPUJC Vaas,SL,Pace,2005-07-22,Kandy,Sri Lanka,2005,1,22,90,6,1,490,931,20,468,841,14,24.5,<=30,SL,Home,Upto 2014
WPUJC Vaas,SL,Pace,2005-09-12,Colombo (RPS),Sri Lanka,2005,2,56,96,1,1,228,320,8,172,224,7,28.5,<=30,SL,Home,Upto 2014
WPUJC Vaas,SL,Pace,2005-09-20,Colombo (PSS),Sri Lanka,2005,2,67,138,3,1,387,537,17,320,399,14,22.764705882352942,<=30,SL,Home,Upto 2014
WPUJC Vaas,SL,Pace,2005-12-02,Chennai,India,2005,1,20,126,4,1,166,336,6,146,210,2,27.666666666666668,<=30,IND,Away,Upto 2014
WPUJC Vaas,SL,Pace,2005-12-10,Delhi,India,2005,2,142,258,3,1,417,906,10,275,648,7,41.7,>30,IND,Away,Upto 2014
WPUJC Vaas,SL,Pace,2006-05-11,Lord's,England,2006,1,124,216,2,1,982,1899,19,858,1683,17,51.68421052631579,>30,ENG,Away,Upto 2014
WPUJC Vaas,SL,Pace,2006-05-25,Birmingham,England,2006,2,42,138,1,1,504,1093,20,462,955,19,25.2,<=30,ENG,Away,Upto 2014
WPUJC Vaas,SL,Pace,2006-06-02,Nottingham,England,2006,2,99,210,2,1,634,1203,19,535,993,17,33.36842105263158,>30,ENG,Away,Upto 2014
WPUJC Vaas,SL,Pace,2006-08-04,Colombo (PSS),Sri Lanka,2006,2,124,222,1,1,843,1453,20,719,1231,19,42.15,>30,SL,Home,Upto 2014
WPUJC Vaas,SL,Pace,2006-12-07,Christchurch,New Zealand,2006,2,82,180,5,1,515,1047,25,433,867,20,20.6,<=30,NZ,Away,Upto 2014
WPUJC Vaas,SL,Pace,2006-12-15,Wellington,New Zealand,2006,2,72,132,1,1,700,1140,20,628,1008,19,35.0,>30,NZ,Away,Upto 2014
WPUJC Vaas,SL,Pace,2007-06-25,Colombo (SSC),Sri Lanka,2007,2,44,114,2,1,288,528,11,244,414,9,26.181818181818183,<=30,SL,Home,Upto 2014
WPUJC Vaas,SL,Pace,2007-07-03,Colombo (PSS),Sri Lanka,2007,2,61,152,4,1,411,758,15,350,606,11,27.4,<=30,SL,Home,Upto 2014
WPUJC Vaas,SL,Pace,2007-11-08,Brisbane,Australia,2007,1,102,168,1,1,668,1297,18,566,1129,17,37.111111111111114,>30,AUS,Away,Upto 2014
WPUJC Vaas,SL,Pace,2007-12-01,Kandy,Sri Lanka,2007,2,132,211,5,1,767,1367,21,635,1156,16,36.523809523809526,>30,SL,Home,Upto 2014
WPUJC Vaas,SL,Pace,2007-12-09,Colombo (SSC),Sri Lanka,2007,2,124,288,2,1,676,1421,13,552,1133,11,52.0,>30,SL,Home,Upto 2014
WPUJC Vaas,SL,Pace,2007-12-18,Galle,Sri Lanka,2007,2,65,167,4,1,606,1192,16,541,1025,12,37.875,>30,SL,Home,Upto 2014
WPUJC Vaas,SL,Pace,2008-03-22,Providence,West Indies,2008,2,109,284,8,1,635,1249,22,526,965,14,28.863636363636363,<=30,WI,Away,Upto 2014
WPUJC Vaas,SL,Pace,2008-04-03,Port of Spain,West Indies,2008,2,128,240,4,1,851,1278,24,723,1038,20,35.458333333333336,>30,WI,Away,Upto 2014
WPUJC Vaas,SL,Pace,2008-07-23,Colombo (SSC),Sri Lanka,2008,2,50,60,0,1,421,648,5,371,588,5,84.2,>30,SL,Home,Upto 2014
WPUJC Vaas,SL,Pace,2008-07-31,Galle,Sri Lanka,2008,2,106,192,4,1,302,510,9,196,318,5,33.55555555555556,>30,SL,Home,Upto 2014
WPUJC Vaas,SL,Pace,2008-08-08,Colombo (PSS),Sri Lanka,2008,2,64,102,1,1,381,610,11,317,508,10,34.63636363636363,>30,SL,Home,Upto 2014
WPUJC Vaas,SL,Pace,2008-12-26,Mirpur,Bangladesh,2008,2,107,216,3,1,517,896,12,410,680,9,43.083333333333336,>30,BAN,Away,Upto 2014
WPUJC Vaas,SL,Pace,2009-01-03,Chattogram,Bangladesh,2009,2,37,108,3,1,228,510,8,191,402,5,28.5,<=30,BAN,Away,Upto 2014
WPUJC Vaas,SL,Pace,2009-02-21,Karachi,Pakistan,2009,1,66,216,0,1,650,1043,7,584,827,7,92.85714285714286,>30,PAK,Away,Upto 2014
WPUJC Vaas,SL,Pace,2009-07-20,Colombo (SSC),Sri Lanka,2009,2,90,234,1,1,669,1180,14,579,946,13,47.785714285714285,>30,SL,Home,Upto 2014
WR Cuttell,ENG,Spin,1899-02-14,Johannesburg,South Africa,1899,2,59,245,5,1,466,1319,30,407,1074,25,15.533333333333333,<=30,SA,Away,After 1965
WR Cuttell,ENG,Spin,1899-04-01,Cape Town,South Africa,1899,1,14,40,1,1,347,777,19,333,737,18,18.263157894736842,<=30,SA,Away,After 1965
WR Hammond,ENG,Pace,1927-12-24,Johannesburg,South Africa,1927,2,57,176,5,1,371,971,19,314,795,14,19.526315789473685,<=30,SA,Away,Upto 2014
WR Hammond,ENG,Pace,1927-12-31,Cape Town,South Africa,1927,2,103,282,5,1,474,1145,15,371,863,10,31.6,>30,SA,Away,Upto 2014
WR Hammond,ENG,Pace,1928-01-21,Durban,South Africa,1928,2,91,192,0,1,482,1079,8,391,887,8,60.25,>30,SA,Away,Upto 2014
WR Hammond,ENG,Pace,1928-01-28,Johannesburg,South Africa,1928,2,82,186,4,1,503,1258,23,421,1072,19,21.869565217391305,<=30,SA,Away,Upto 2014
WR Hammond,ENG,Pace,1928-02-04,Durban,South Africa,1928,2,66,132,1,1,338,797,16,272,665,15,21.125,<=30,SA,Away,Upto 2014
WR Hammond,ENG,Pace,1928-06-23,Lord's,England,1928,1,20,90,1,1,399,886,12,379,796,11,33.25,>30,ENG,Home,Upto 2014
WR Hammond,ENG,Pace,1928-07-21,Manchester,England,1928,2,39,72,1,1,337,660,7,298,588,6,48.142857142857146,>30,ENG,Home,Upto 2014
WR Hammond,ENG,Pace,1928-08-11,The Oval,England,1928,2,44,72,1,1,476,809,16,432,737,15,29.75,<=30,ENG,Home,Upto 2014
WR Hammond,ENG,Pace,1928-11-30,Brisbane,Australia,1928,2,40,96,0,1,486,1018,12,446,922,12,40.5,>30,AUS,Away,Upto 2014
WR Hammond,ENG,Pace,1928-12-14,Sydney,Australia,1928,2,61,84,0,1,483,1249,14,422,1165,14,34.5,>30,AUS,Away,Upto 2014
WR Hammond,ENG,Pace,1928-12-29,Melbourne,Australia,1928,2,49,144,1,1,730,1882,14,681,1738,13,52.142857142857146,>30,AUS,Away,Upto 2014
WR Hammond,ENG,Pace,1929-02-01,Adelaide,Australia,1929,2,53,138,0,1,620,1906,12,567,1768,12,51.666666666666664,>30,AUS,Away,Upto 2014
WR Hammond,ENG,Pace,1929-03-08,Melbourne,Australia,1929,2,84,252,4,1,826,2351,25,742,2099,21,33.04,>30,AUS,Away,Upto 2014
WR Hammond,ENG,Pace,1929-06-15,Birmingham,England,1929,2,44,150,0,1,506,1355,18,462,1205,18,28.11111111111111,<=30,ENG,Home,Upto 2014
WR Hammond,ENG,Pace,1929-06-29,Lord's,England,1929,1,19,48,1,1,601,1182,21,582,1134,20,28.61904761904762,<=30,ENG,Home,Upto 2014
WR Hammond,ENG,Pace,1929-07-13,Leeds,England,1929,2,32,90,0,1,359,767,10,327,677,10,35.9,>30,ENG,Home,Upto 2014
WR Hammond,ENG,Pace,1930-06-13,Nottingham,England,1930,1,74,174,0,1,383,898,10,309,724,10,38.3,>30,ENG,Home,Upto 2014
WR Hammond,ENG,Pace,1930-06-27,Lord's,England,1930,2,88,236,1,1,579,1102,10,491,866,9,57.9,>30,ENG,Home,Upto 2014
WR Hammond,ENG,Pace,1930-07-11,Leeds,England,1930,1,46,102,1,1,460,1116,6,414,1014,5,76.66666666666667,>30,ENG,Home,Upto 2014
WR Hammond,ENG,Pace,1930-07-25,Manchester,England,1930,1,24,126,2,1,183,630,11,159,504,9,16.636363636363637,<=30,ENG,Home,Upto 2014
WR Hammond,ENG,Pace,1930-08-16,The Oval,England,1930,1,70,252,1,1,505,1314,10,435,1062,9,50.5,>30,ENG,Home,Upto 2014
WR Hammond,ENG,Pace,1930-12-24,Johannesburg,South Africa,1930,1,63,150,4,1,390,954,25,327,804,21,15.6,<=30,SA,Away,Upto 2014
WR Hammond,ENG,Pace,1931-01-01,Cape Town,South Africa,1931,1,27,60,0,1,323,942,8,296,882,8,40.375,>30,SA,Away,Upto 2014
WR Hammond,ENG,Pace,1931-01-16,Durban,South Africa,1931,1,9,66,2,1,276,836,9,267,770,7,30.666666666666668,>30,SA,Away,Upto 2014
WR Hammond,ENG,Pace,1931-02-13,Johannesburg,South Africa,1931,2,77,234,1,1,670,1471,21,593,1237,20,31.904761904761905,>30,SA,Away,Upto 2014
WR Hammond,ENG,Pace,1931-02-21,Durban,South Africa,1931,2,64,144,2,1,308,822,11,244,678,9,28.0,<=30,SA,Away,Upto 2014
WR Hammond,ENG,Pace,1931-06-27,Lord's,England,1931,2,58,189,2,1,463,1131,13,405,942,11,35.61538461538461,>30,ENG,Home,Upto 2014
WR Hammond,ENG,Pace,1931-07-29,The Oval,England,1931,1,10,6,0,1,180,402,5,170,396,5,36.0,>30,ENG,Home,Upto 2014
WR Hammond,ENG,Pace,1932-06-25,Lord's,England,1932,2,24,57,3,1,543,1480,28,519,1423,25,19.392857142857142,<=30,ENG,Home,Upto 2014
WR Hammond,ENG,Pace,1932-12-02,Sydney,Australia,1932,2,71,176,3,1,694,1474,26,623,1298,23,26.692307692307693,<=30,AUS,Away,Upto 2014
WR Hammond,ENG,Pace,1932-12-30,Melbourne,Australia,1932,2,42,125,3,1,475,1034,22,433,909,19,21.59090909090909,<=30,AUS,Away,Upto 2014
WR Hammond,ENG,Pace,1933-01-13,Adelaide,Australia,1933,2,57,160,1,1,549,1333,23,492,1173,22,23.869565217391305,<=30,AUS,Away,Upto 2014
WR Hammond,ENG,Pace,1933-02-10,Brisbane,Australia,1933,2,79,198,2,1,508,1171,18,429,973,16,28.22222222222222,<=30,AUS,Away,Upto 2014
WR Hammond,ENG,Pace,1933-02-23,Sydney,Australia,1933,2,42,66,0,1,693,1194,12,651,1128,12,57.75,>30,AUS,Away,Upto 2014
WR Hammond,ENG,Pace,1933-03-24,Christchurch,New Zealand,1933,1,2,12,0,1,467,920,9,465,908,9,51.888888888888886,>30,NZ,Away,Upto 2014
WR Hammond,ENG,Pace,1933-03-31,Auckland,New Zealand,1933,2,17,30,0,1,344,794,12,327,764,12,28.666666666666668,<=30,NZ,Away,Upto 2014
WR Hammond,ENG,Pace,1933-07-22,Manchester,England,1933,1,27,30,0,1,416,958,13,389,928,13,32.0,>30,ENG,Home,Upto 2014
WR Hammond,ENG,Pace,1934-06-08,Nottingham,England,1934,2,54,150,1,1,503,1268,16,449,1118,15,31.4375,>30,ENG,Home,Upto 2014
WR Hammond,ENG,Pace,1934-06-22,Lord's,England,1934,2,44,102,1,1,436,1038,10,392,936,9,43.6,>30,ENG,Home,Upto 2014
WR Hammond,ENG,Pace,1934-07-06,Manchester,England,1934,2,113,183,3,1,754,1551,6,641,1368,3,125.66666666666667,>30,ENG,Home,Upto 2014
WR Hammond,ENG,Pace,1934-07-20,Leeds,England,1934,1,82,174,0,1,418,900,7,336,726,7,59.714285714285715,>30,ENG,Home,Upto 2014
WR Hammond,ENG,Pace,1934-08-18,The Oval,England,1934,2,71,114,0,1,874,1331,25,803,1217,25,34.96,>30,ENG,Home,Upto 2014
WR Hammond,ENG,Pace,1935-01-08,Bridgetown,West Indies,1935,1,1,6,0,1,205,438,22,204,432,22,9.318181818181818,<=30,WI,Away,Upto 2014
WR Hammond,ENG,Pace,1935-01-24,Port of Spain,West Indies,1935,2,45,144,0,1,486,1307,22,441,1163,22,22.09090909090909,<=30,WI,Away,Upto 2014
WR Hammond,ENG,Pace,1935-06-29,Lord's,England,1935,2,34,121,3,1,344,844,15,310,723,12,22.933333333333334,<=30,ENG,Home,Upto 2014
WR Hammond,ENG,Pace,1935-07-13,Leeds,England,1935,2,23,114,2,1,570,1397,20,547,1283,18,28.5,<=30,ENG,Home,Upto 2014
WR Hammond,ENG,Pace,1935-07-27,Manchester,England,1935,2,64,132,1,1,592,1081,17,528,949,16,34.8235294117647,>30,ENG,Home,Upto 2014
WR Hammond,ENG,Pace,1935-08-17,The Oval,England,1935,1,25,54,0,1,741,1240,14,716,1186,14,52.92857142857143,>30,ENG,Home,Upto 2014
WR Hammond,ENG,Pace,1936-07-25,Manchester,England,1936,2,53,126,1,1,650,1176,8,597,1050,7,81.25,>30,ENG,Home,Upto 2014
WR Hammond,ENG,Pace,1936-08-15,The Oval,England,1936,2,41,90,0,1,678,1230,17,637,1140,17,39.88235294117647,>30,ENG,Home,Upto 2014
WR Hammond,ENG,Pace,1936-12-04,Brisbane,Australia,1936,1,12,32,0,1,297,839,25,285,807,25,11.88,<=30,AUS,Away,Upto 2014
WR Hammond,ENG,Pace,1936-12-18,Sydney,Australia,1936,2,35,159,3,1,331,936,17,296,777,14,19.470588235294116,<=30,AUS,Away,Upto 2014
WR Hammond,ENG,Pace,1937-01-01,Melbourne,Australia,1937,2,105,219,2,1,510,1173,17,405,954,15,30.0,<=30,AUS,Away,Upto 2014
WR Hammond,ENG,Pace,1937-01-29,Adelaide,Australia,1937,2,87,170,7,1,675,1448,20,588,1278,13,33.75,>30,AUS,Away,Upto 2014
WR Hammond,ENG,Pace,1937-02-26,Melbourne,Australia,1937,1,62,128,0,1,632,1154,16,570,1026,16,39.5,>30,AUS,Away,Upto 2014
WR Hammond,ENG,Pace,1937-06-26,Lord's,England,1937,1,12,36,0,1,544,1216,20,532,1180,20,27.2,<=30,ENG,Home,Upto 2014
WR Hammond,ENG,Pace,1937-07-24,Manchester,England,1937,2,45,126,1,1,359,941,19,314,815,18,18.894736842105264,<=30,ENG,Home,Upto 2014
WR Hammond,ENG,Pace,1937-08-14,The Oval,England,1937,2,44,108,3,1,359,810,13,315,702,10,27.615384615384617,<=30,ENG,Home,Upto 2014
WR Hammond,ENG,Pace,1938-06-10,Nottingham,England,1938,2,59,186,0,1,464,954,6,405,768,6,77.33333333333333,>30,ENG,Home,Upto 2014
WR Hammond,ENG,Pace,1938-08-20,The Oval,England,1938,1,8,12,0,1,391,703,13,383,691,13,30.076923076923077,>30,ENG,Home,Upto 2014
WR Hammond,ENG,Pace,1938-12-24,Johannesburg,South Africa,1938,2,40,128,1,1,680,1468,10,640,1340,9,68.0,>30,SA,Away,Upto 2014
WR Hammond,ENG,Pace,1938-12-31,Cape Town,South Africa,1938,1,25,72,0,1,456,999,10,431,927,10,45.6,>30,SA,Away,Upto 2014
WR Hammond,ENG,Pace,1939-01-20,Durban,South Africa,1939,2,13,40,1,1,487,999,14,474,959,13,34.785714285714285,>30,SA,Away,Upto 2014
WR Hammond,ENG,Pace,1939-02-18,Johannesburg,South Africa,1939,1,19,56,1,1,381,1034,15,362,978,14,25.4,<=30,SA,Away,Upto 2014
WR Hammond,ENG,Pace,1939-03-03,Durban,South Africa,1939,2,64,184,0,1,1100,3449,18,1036,3265,18,61.111111111111114,>30,SA,Away,Upto 2014
WR Hammond,ENG,Pace,1946-07-20,Manchester,England,1946,1,3,6,0,1,495,1476,27,492,1470,27,18.333333333333332,<=30,ENG,Home,Upto 2014
WR Robertson,AUS,Spin,1885-01-01,Melbourne,Australia,1885,1,24,44,0,1,372,1209,9,348,1165,9,41.333333333333336,>30,AUS,Home,After 1965
WRS de Silva,SL,Pace,2002-07-21,Colombo (PSS),Sri Lanka,2002,2,66,144,3,1,532,738,12,466,594,9,44.333333333333336,>30,SL,Home,Upto 2014
WRS de Silva,SL,Pace,2002-07-28,Colombo (SSC),Sri Lanka,2002,2,80,144,4,1,518,934,16,438,790,12,32.375,>30,SL,Home,Upto 2014
WRS de Silva,SL,Pace,2007-07-11,Kandy,Sri Lanka,2007,2,63,144,4,1,437,738,11,374,594,7,39.72727272727273,>30,SL,Home,Upto 2014
WS Lees,ENG,Pace,1906-01-02,Johannesburg,South Africa,1906,2,108,337,8,1,225,553,14,117,216,6,16.071428571428573,<=30,SA,Away,Upto 2014
WS Lees,ENG,Pace,1906-03-06,Johannesburg,South Africa,1906,2,63,180,2,1,275,764,15,212,584,13,18.333333333333332,<=30,SA,Away,Upto 2014
WS Lees,ENG,Pace,1906-03-10,Johannesburg,South Africa,1906,2,163,345,9,1,542,1143,25,379,798,16,21.68,<=30,SA,Away,Upto 2014
WS Lees,ENG,Pace,1906-03-24,Cape Town,South Africa,1906,2,69,246,5,1,316,931,16,247,685,11,19.75,<=30,SA,Away,Upto 2014
WS Lees,ENG,Pace,1906-03-30,Cape Town,South Africa,1906,1,64,148,2,1,242,576,14,178,428,12,17.285714285714285,<=30,SA,Away,Upto 2014
WV Raman,IND,Spin,1988-01-11,Chennai,India,1988,1,7,6,1,1,536,1127,23,529,1121,22,23.304347826086957,<=30,IND,Home,Upto 2014
WV Raman,IND,Spin,1988-11-12,Bengaluru,India,1988,2,31,114,1,1,620,1702,21,589,1588,20,29.523809523809526,<=30,IND,Home,Upto 2014
WV Raman,IND,Spin,1989-04-15,Port of Spain,West Indies,1989,1,5,24,0,1,406,1089,11,401,1065,11,36.90909090909091,>30,WI,Away,Upto 2014
WV Raman,IND,Spin,1990-02-22,Auckland,New Zealand,1990,1,23,114,0,1,382,711,6,359,597,6,63.666666666666664,>30,NZ,Away,Upto 2014
WV Raman,IND,Spin,1997-01-02,Cape Town,South Africa,1997,2,63,90,0,1,351,752,7,288,662,7,50.142857142857146,>30,SA,Away,Upto 2014
WV Rodriguez,WI,Spin,1962-03-07,Kingston,West Indies,1962,2,45,48,0,1,783,1924,16,738,1876,16,48.9375,>30,WI,Home,Upto 2014
WV Rodriguez,WI,Spin,1962-04-04,Port of Spain,West Indies,1962,2,98,171,3,1,911,2452,24,813,2281,21,37.958333333333336,>30,WI,Home,Upto 2014
WV Rodriguez,WI,Spin,1965-05-14,Port of Spain,West Indies,1965,2,52,84,0,1,396,885,11,344,801,11,36.0,>30,WI,Home,Upto 2014
WV Rodriguez,WI,Spin,1968-03-14,Port of Spain,West Indies,1968,2,179,270,4,1,721,1580,15,542,1310,11,48.06666666666667,>30,WI,Home,Upto 2014
WVS Ling,SA,Spin,1921-11-12,Johannesburg,South Africa,1921,1,20,18,0,1,332,785,12,312,767,12,27.666666666666668,<=30,SA,Home,Upto 2014
WW Armstrong,AUS,Spin,1902-01-01,Melbourne,Australia,1902,1,3,12,0,1,445,1043,26,442,1031,26,17.115384615384617,<=30,AUS,Home,Upto 2014
WW Armstrong,AUS,Spin,1902-01-17,Adelaide,Australia,1902,2,54,138,0,1,888,2292,24,834,2154,24,37.0,>30,AUS,Home,Upto 2014
WW Armstrong,AUS,Spin,1902-02-14,Sydney,Australia,1902,1,8,12,0,1,685,1842,29,677,1830,29,23.620689655172413,<=30,AUS,Home,Upto 2014
WW Armstrong,AUS,Spin,1902-05-29,Birmingham,England,1902,1,64,150,1,1,217,576,11,153,426,10,19.727272727272727,<=30,ENG,Away,Upto 2014
WW Armstrong,AUS,Spin,1902-06-12,Lord's,England,1902,1,5,30,0,1,20,60,0,15,30,0,inf,>30,ENG,Away,Upto 2014
WW Armstrong,AUS,Spin,1902-07-03,Sheffield,England,1902,1,7,30,0,1,486,1005,28,479,975,28,17.357142857142858,<=30,ENG,Away,Upto 2014
WW Armstrong,AUS,Spin,1902-07-24,Manchester,England,1902,1,19,30,0,1,549,1292,26,530,1262,26,21.115384615384617,<=30,ENG,Away,Upto 2014
WW Armstrong,AUS,Spin,1902-08-11,The Oval,England,1902,1,28,24,1,1,548,1222,24,520,1198,23,22.833333333333332,<=30,ENG,Away,Upto 2014
WW Armstrong,AUS,Spin,1902-10-11,Johannesburg,South Africa,1902,2,112,120,2,1,619,846,16,507,726,14,38.6875,>30,SA,Away,Upto 2014
WW Armstrong,AUS,Spin,1902-10-18,Johannesburg,South Africa,1902,1,16,12,0,1,315,623,23,299,611,23,13.695652173913043,<=30,SA,Away,Upto 2014
WW Armstrong,AUS,Spin,1903-12-11,Sydney,Australia,1903,2,75,246,2,1,839,1769,19,764,1523,17,44.1578947368421,>30,AUS,Home,Upto 2014
WW Armstrong,AUS,Spin,1904-01-01,Melbourne,Australia,1904,1,43,150,0,1,442,925,27,399,775,27,16.37037037037037,<=30,AUS,Home,Upto 2014
WW Armstrong,AUS,Spin,1904-01-15,Adelaide,Australia,1904,2,40,102,0,1,537,1176,17,497,1074,17,31.58823529411765,>30,AUS,Home,Upto 2014
WW Armstrong,AUS,Spin,1905-05-29,Nottingham,England,1905,2,71,348,1,1,379,970,12,308,622,11,31.583333333333332,>30,ENG,Away,Upto 2014
WW Armstrong,AUS,Spin,1905-06-15,Lord's,England,1905,2,71,240,5,1,233,619,9,162,379,4,25.88888888888889,<=30,ENG,Away,Upto 2014
WW Armstrong,AUS,Spin,1905-07-03,Leeds,England,1905,2,166,465,7,1,435,1029,13,269,564,6,33.46153846153846,>30,ENG,Away,Upto 2014
WW Armstrong,AUS,Spin,1905-07-24,Manchester,England,1905,1,93,288,1,1,187,487,8,94,199,7,23.375,<=30,ENG,Away,Upto 2014
WW Armstrong,AUS,Spin,1905-08-14,The Oval,England,1905,2,137,342,2,1,332,711,4,195,369,2,83.0,>30,ENG,Away,Upto 2014
WW Armstrong,AUS,Spin,1907-12-13,Sydney,Australia,1907,2,96,318,4,1,592,1308,17,496,990,13,34.8235294117647,>30,AUS,Home,Upto 2014
WW Armstrong,AUS,Spin,1908-01-01,Melbourne,Australia,1908,2,89,390,5,1,799,1914,21,710,1524,16,38.04761904761905,>30,AUS,Home,Upto 2014
WW Armstrong,AUS,Spin,1908-01-10,Adelaide,Australia,1908,2,98,168,2,1,776,1611,17,678,1443,15,45.64705882352941,>30,AUS,Home,Upto 2014
WW Armstrong,AUS,Spin,1908-02-07,Melbourne,Australia,1908,2,22,25,1,1,481,1034,24,459,1009,23,20.041666666666668,<=30,AUS,Home,Upto 2014
WW Armstrong,AUS,Spin,1908-02-21,Sydney,Australia,1908,2,56,180,2,1,812,1824,30,756,1644,28,27.066666666666666,<=30,AUS,Home,Upto 2014
WW Armstrong,AUS,Spin,1909-05-27,Birmingham,England,1909,2,54,171,5,1,222,633,19,168,462,14,11.68421052631579,<=30,ENG,Away,Upto 2014
WW Armstrong,AUS,Spin,1909-06-14,Lord's,England,1909,2,81,269,6,1,254,821,16,173,552,10,15.875,<=30,ENG,Away,Upto 2014
WW Armstrong,AUS,Spin,1909-07-01,Leeds,England,1909,2,41,114,0,1,230,608,17,189,494,17,13.529411764705882,<=30,ENG,Away,Upto 2014
WW Armstrong,AUS,Spin,1909-07-26,Manchester,England,1909,1,16,60,0,1,297,675,13,281,615,13,22.846153846153847,<=30,ENG,Away,Upto 2014
WW Armstrong,AUS,Spin,1909-08-09,The Oval,England,1909,2,101,228,3,1,627,1104,11,526,876,8,57.0,>30,ENG,Away,Upto 2014
WW Armstrong,AUS,Spin,1910-12-09,Sydney,Australia,1910,2,51,102,0,1,388,570,5,337,468,5,77.6,>30,AUS,Home,Upto 2014
WW Armstrong,AUS,Spin,1910-12-31,Melbourne,Australia,1910,2,138,294,4,1,675,1063,21,537,769,17,32.142857142857146,>30,AUS,Home,Upto 2014
WW Armstrong,AUS,Spin,1911-01-07,Adelaide,Australia,1911,2,193,454,4,1,814,1502,20,621,1048,16,40.7,>30,AUS,Home,Upto 2014
WW Armstrong,AUS,Spin,1911-02-17,Melbourne,Australia,1911,2,40,66,0,1,844,1322,23,804,1256,23,36.69565217391305,>30,AUS,Home,Upto 2014
WW Armstrong,AUS,Spin,1911-03-03,Sydney,Australia,1911,2,85,192,3,1,638,1067,19,553,875,16,33.578947368421055,>30,AUS,Home,Upto 2014
WW Armstrong,AUS,Spin,1911-12-15,Sydney,Australia,1911,2,67,144,0,1,459,926,15,392,782,15,30.6,>30,AUS,Home,Upto 2014
WW Armstrong,AUS,Spin,1911-12-30,Melbourne,Australia,1911,2,42,138,1,1,222,429,6,180,291,5,37.0,>30,AUS,Home,Upto 2014
WW Armstrong,AUS,Spin,1912-01-12,Adelaide,Australia,1912,2,55,120,1,1,429,843,6,374,723,5,71.5,>30,AUS,Home,Upto 2014
WW Armstrong,AUS,Spin,1912-02-09,Melbourne,Australia,1912,1,93,216,3,1,357,761,7,264,545,4,51.0,>30,AUS,Home,Upto 2014
WW Armstrong,AUS,Spin,1912-02-23,Sydney,Australia,1912,2,77,255,4,1,473,1119,22,396,864,18,21.5,<=30,AUS,Home,Upto 2014
WW Armstrong,AUS,Spin,1920-12-17,Sydney,Australia,1920,2,23,66,1,1,783,1682,19,760,1616,18,41.21052631578947,>30,AUS,Home,Upto 2014
WW Armstrong,AUS,Spin,1920-12-31,Melbourne,Australia,1920,2,76,239,6,1,436,860,13,360,621,7,33.53846153846154,>30,AUS,Home,Upto 2014
WW Armstrong,AUS,Spin,1921-01-14,Adelaide,Australia,1921,2,70,234,1,1,920,1706,23,850,1472,22,40.0,>30,AUS,Home,Upto 2014
WW Armstrong,AUS,Spin,1921-02-11,Melbourne,Australia,1921,1,9,30,0,1,636,1301,23,627,1271,23,27.652173913043477,<=30,AUS,Home,Upto 2014
WW Armstrong,AUS,Spin,1921-02-25,Sydney,Australia,1921,1,26,48,1,1,605,1063,17,579,1015,16,35.588235294117645,>30,AUS,Home,Upto 2014
WW Armstrong,AUS,Spin,1921-05-28,Nottingham,England,1921,2,33,180,1,1,235,583,9,202,403,8,26.11111111111111,<=30,ENG,Away,Upto 2014
WW Armstrong,AUS,Spin,1921-06-11,Lord's,England,1921,2,28,180,1,1,448,876,15,420,696,14,29.866666666666667,<=30,ENG,Away,Upto 2014
WW Armstrong,AUS,Spin,1921-07-02,Leeds,England,1921,2,50,132,4,1,678,1167,22,628,1035,18,30.818181818181817,>30,ENG,Away,Upto 2014
WW Armstrong,AUS,Spin,1921-07-23,Manchester,England,1921,1,57,198,2,1,239,952,12,182,754,10,19.916666666666668,<=30,ENG,Away,Upto 2014
WW Armstrong,AUS,Spin,1921-08-13,The Oval,England,1921,1,44,72,0,1,509,810,8,465,738,8,63.625,>30,ENG,Away,Upto 2014
WW Daniel,WI,Pace,1976-04-21,Kingston,West Indies,1976,2,64,140,2,1,382,807,9,318,667,7,42.44444444444444,>30,WI,Home,Upto 2014
WW Daniel,WI,Pace,1976-06-03,Nottingham,England,1976,2,73,198,4,1,773,1761,21,700,1563,17,36.80952380952381,>30,ENG,Away,Upto 2014
WW Daniel,WI,Pace,1976-07-08,Manchester,England,1976,2,52,138,4,1,437,1066,29,385,928,25,15.068965517241379,<=30,ENG,Away,Upto 2014
WW Daniel,WI,Pace,1976-07-22,Leeds,England,1976,2,162,252,5,1,969,1786,39,807,1534,34,24.846153846153847,<=30,ENG,Away,Upto 2014
WW Daniel,WI,Pace,1976-08-12,The Oval,England,1976,1,30,60,0,1,768,1323,20,738,1263,20,38.4,>30,ENG,Away,Upto 2014
WW Daniel,WI,Pace,1983-10-29,Delhi,India,1983,2,124,216,6,1,784,1399,23,660,1183,17,34.08695652173913,>30,IND,Away,Upto 2014
WW Daniel,WI,Pace,1983-11-12,Ahmedabad,India,1983,2,50,108,6,1,524,1257,33,474,1149,27,15.878787878787879,<=30,IND,Away,Upto 2014
WW Daniel,WI,Pace,1983-11-24,Wankhede,India,1983,2,158,264,2,1,698,1403,16,540,1139,14,43.625,>30,IND,Away,Upto 2014
WW Daniel,WI,Pace,1984-03-02,Georgetown,West Indies,1984,2,146,234,3,1,692,1314,20,546,1080,17,34.6,>30,WI,Home,Upto 2014
WW Daniel,WI,Pace,1984-03-16,Port of Spain,West Indies,1984,2,51,144,4,1,693,1381,19,642,1237,15,36.473684210526315,>30,WI,Home,Upto 2014
WW Davis,WI,Pace,1983-04-28,St John's,West Indies,1983,2,175,312,4,1,719,1355,18,544,1043,14,39.94444444444444,>30,WI,Home,Upto 2014
WW Davis,WI,Pace,1983-10-21,Kanpur,India,1983,2,103,177,5,1,584,1065,26,481,888,21,22.46153846153846,<=30,IND,Away,Upto 2014
WW Davis,WI,Pace,1983-10-29,Delhi,India,1983,2,132,222,1,1,784,1399,23,652,1177,22,34.08695652173913,>30,IND,Away,Upto 2014
WW Davis,WI,Pace,1983-11-12,Ahmedabad,India,1983,2,44,132,4,1,524,1257,33,480,1125,29,15.878787878787879,<=30,IND,Away,Upto 2014
WW Davis,WI,Pace,1983-11-24,Wankhede,India,1983,2,162,264,2,1,698,1403,16,536,1139,14,43.625,>30,IND,Away,Upto 2014
WW Davis,WI,Pace,1983-12-10,Eden Gardens,India,1983,2,46,96,1,1,475,988,25,429,892,24,19.0,<=30,IND,Away,Upto 2014
WW Davis,WI,Pace,1983-12-24,Chennai,India,1983,1,75,180,1,1,443,882,12,368,702,11,36.916666666666664,>30,IND,Away,Upto 2014
WW Davis,WI,Pace,1984-03-02,Georgetown,West Indies,1984,2,80,198,2,1,692,1314,20,612,1116,18,34.6,>30,WI,Home,Upto 2014
WW Davis,WI,Pace,1984-07-26,Manchester,England,1984,2,77,138,2,1,536,1172,18,459,1034,16,29.77777777777778,<=30,ENG,Away,Upto 2014
WW Davis,WI,Pace,1985-04-26,Bridgetown,West Indies,1985,2,94,172,6,1,558,1140,29,464,968,23,19.24137931034483,<=30,WI,Home,Upto 2014
WW Davis,WI,Pace,1985-05-04,Kingston,West Indies,1985,2,94,209,4,1,691,1483,26,597,1274,22,26.576923076923077,<=30,WI,Home,Upto 2014
WW Davis,WI,Pace,1987-11-25,Delhi,India,1987,2,80,186,3,1,549,1170,28,469,984,25,19.607142857142858,<=30,IND,Away,Upto 2014
WW Davis,WI,Pace,1987-12-11,Wankhede,India,1987,2,130,180,2,1,509,808,22,379,628,20,23.136363636363637,<=30,IND,Away,Upto 2014
WW Davis,WI,Pace,1987-12-26,Eden Gardens,India,1987,1,84,162,3,1,580,866,11,496,704,8,52.72727272727273,>30,IND,Away,Upto 2014
WW Davis,WI,Pace,1988-01-11,Chennai,India,1988,2,96,145,5,1,358,643,15,262,498,10,23.866666666666667,<=30,IND,Away,Upto 2014
WW Hall,WI,Pace,1958-11-28,Brabourne,India,1958,2,107,264,4,1,439,1262,18,332,998,14,24.38888888888889,<=30,IND,Away,Upto 2014
WW Hall,WI,Pace,1958-12-12,Kanpur,India,1958,2,126,364,11,1,403,1061,19,277,697,8,21.210526315789473,<=30,IND,Away,Upto 2014
WW Hall,WI,Pace,1958-12-31,Eden Gardens,India,1958,2,86,198,6,1,327,738,17,241,540,11,19.235294117647058,<=30,IND,Away,Upto 2014
WW Hall,WI,Pace,1959-01-21,Chennai,India,1959,2,106,270,5,1,372,990,12,266,720,7,31.0,>30,IND,Away,Upto 2014
WW Hall,WI,Pace,1959-02-06,Delhi,India,1959,2,105,234,4,1,501,1007,14,396,773,10,35.785714285714285,>30,IND,Away,Upto 2014
WW Hall,WI,Pace,1959-02-20,Karachi,Pakistan,1959,2,92,228,3,1,346,942,12,254,714,9,28.833333333333332,<=30,PAK,Away,Upto 2014
WW Hall,WI,Pace,1959-03-06,Dhaka,Bangladesh,1959,2,77,179,8,1,310,823,30,233,644,22,10.333333333333334,<=30,BAN,Away,Upto 2014
WW Hall,WI,Pace,1959-03-26,Lahore,Pakistan,1959,2,118,198,5,1,381,764,12,263,566,7,31.75,>30,PAK,Away,Upto 2014
WW Hall,WI,Pace,1960-01-06,Bridgetown,West Indies,1960,2,107,276,1,1,552,1376,10,445,1100,9,55.2,>30,WI,Home,Upto 2014
WW Hall,WI,Pace,1960-01-28,Port of Spain,West Indies,1960,2,142,340,5,1,471,1183,24,329,843,19,19.625,<=30,WI,Home,Upto 2014
WW Hall,WI,Pace,1960-02-17,Kingston,West Indies,1960,2,162,344,8,1,593,1359,23,431,1015,15,25.782608695652176,<=30,WI,Home,Upto 2014
WW Hall,WI,Pace,1960-03-09,Georgetown,West Indies,1960,2,169,290,6,1,483,950,12,314,660,6,40.25,>30,WI,Home,Upto 2014
WW Hall,WI,Pace,1960-03-25,Port of Spain,West Indies,1960,2,99,168,2,1,604,1109,11,505,941,9,54.90909090909091,>30,WI,Home,Upto 2014
WW Hall,WI,Pace,1960-12-09,Brisbane,Australia,1960,2,203,378,9,1,640,1184,22,437,806,13,29.09090909090909,<=30,AUS,Away,Upto 2014
WW Hall,WI,Pace,1960-12-30,Melbourne,Australia,1960,2,83,172,6,1,364,824,18,281,652,12,20.22222222222222,<=30,AUS,Away,Upto 2014
WW Hall,WI,Pace,1961-01-13,Sydney,Australia,1961,2,88,168,2,1,402,914,14,314,746,12,28.714285714285715,<=30,AUS,Away,Upto 2014
WW Hall,WI,Pace,1961-01-27,Adelaide,Australia,1961,2,146,280,3,1,414,757,8,268,477,5,51.75,>30,AUS,Away,Upto 2014
WW Hall,WI,Pace,1961-02-10,Melbourne,Australia,1961,2,96,160,1,1,407,855,11,311,695,10,37.0,>30,AUS,Away,Upto 2014
WW Hall,WI,Pace,1962-02-16,Port of Spain,West Indies,1962,2,49,168,5,1,231,520,12,182,352,7,19.25,<=30,WI,Home,Upto 2014
WW Hall,WI,Pace,1962-03-07,Kingston,West Indies,1962,2,128,293,9,1,392,737,11,264,444,2,35.63636363636363,>30,WI,Home,Upto 2014
WW Hall,WI,Pace,1962-03-23,Bridgetown,West Indies,1962,2,81,192,3,1,296,666,7,215,474,4,42.285714285714285,>30,WI,Home,Upto 2014
WW Hall,WI,Pace,1962-04-04,Port of Spain,West Indies,1962,2,94,162,6,1,296,552,7,202,390,1,42.285714285714285,>30,WI,Home,Upto 2014
WW Hall,WI,Pace,1962-04-13,Kingston,West Indies,1962,2,73,191,4,1,371,811,20,298,620,16,18.55,<=30,WI,Home,Upto 2014
WW Hall,WI,Pace,1963-06-06,Manchester,England,1963,2,90,186,3,1,370,899,6,280,713,3,61.666666666666664,>30,ENG,Away,Upto 2014
WW Hall,WI,Pace,1963-06-20,Lord's,England,1963,2,158,348,5,1,666,1730,31,508,1382,26,21.483870967741936,<=30,ENG,Away,Upto 2014
WW Hall,WI,Pace,1963-07-04,Birmingham,England,1963,2,103,196,2,1,467,1099,27,364,903,25,17.296296296296298,<=30,ENG,Away,Upto 2014
WW Hall,WI,Pace,1963-07-25,Leeds,England,1963,2,73,108,1,1,551,1254,21,478,1146,20,26.238095238095237,<=30,ENG,Away,Upto 2014
WW Hall,WI,Pace,1963-08-22,The Oval,England,1963,2,110,230,5,1,581,1365,22,471,1135,17,26.40909090909091,<=30,ENG,Away,Upto 2014
WW Hall,WI,Pace,1965-03-03,Kingston,West Indies,1965,2,105,258,9,1,497,1218,24,392,960,15,20.708333333333332,<=30,WI,Home,Upto 2014
WW Hall,WI,Pace,1965-03-26,Port of Spain,West Indies,1965,1,104,210,2,1,537,1194,10,433,984,8,53.7,>30,WI,Home,Upto 2014
WW Hall,WI,Pace,1965-04-14,Georgetown,West Indies,1965,2,44,90,2,1,434,874,16,390,784,14,27.125,<=30,WI,Home,Upto 2014
WW Hall,WI,Pace,1965-05-05,Bridgetown,West Indies,1965,2,148,210,3,1,670,1290,13,522,1080,10,51.53846153846154,>30,WI,Home,Upto 2014
WW Hall,WI,Pace,1965-05-14,Port of Spain,West Indies,1965,2,53,108,0,1,271,612,18,218,504,18,15.055555555555555,<=30,WI,Home,Upto 2014
WW Hall,WI,Pace,1966-06-02,Manchester,England,1966,2,71,114,0,1,402,732,5,331,618,5,80.4,>30,ENG,Away,Upto 2014
WW Hall,WI,Pace,1966-06-16,Lord's,England,1966,2,171,300,6,1,864,1752,24,693,1452,18,36.0,>30,ENG,Away,Upto 2014
WW Hall,WI,Pace,1966-06-30,Nottingham,England,1966,2,157,303,6,1,760,1648,27,603,1345,21,28.14814814814815,<=30,ENG,Away,Upto 2014
WW Hall,WI,Pace,1966-08-04,Leeds,England,1966,2,71,150,3,1,453,936,13,382,786,10,34.84615384615385,>30,ENG,Away,Upto 2014
WW Hall,WI,Pace,1966-08-18,The Oval,England,1966,1,85,186,3,1,459,1079,13,374,893,10,35.30769230769231,>30,ENG,Away,Upto 2014
WW Hall,WI,Pace,1966-12-13,Brabourne,India,1966,2,64,174,2,1,180,366,6,116,192,4,30.0,<=30,IND,Away,Upto 2014
WW Hall,WI,Pace,1966-12-31,Eden Gardens,India,1966,2,67,78,2,1,232,474,6,165,396,4,38.666666666666664,>30,IND,Away,Upto 2014
WW Hall,WI,Pace,1967-01-13,Chennai,India,1967,2,135,186,4,1,515,900,14,380,714,10,36.785714285714285,>30,IND,Away,Upto 2014
WW Hall,WI,Pace,1968-01-19,Port of Spain,West Indies,1968,1,92,168,0,1,435,1007,15,343,839,15,29.0,<=30,WI,Home,Upto 2014
WW Hall,WI,Pace,1968-02-08,Kingston,West Indies,1968,2,66,180,5,1,570,1419,25,504,1239,20,22.8,<=30,WI,Home,Upto 2014
WW Hall,WI,Pace,1968-02-29,Bridgetown,West Indies,1968,1,98,192,2,1,595,1213,17,497,1021,15,35.0,>30,WI,Home,Upto 2014
WW Hall,WI,Pace,1968-03-28,Georgetown,West Indies,1968,2,97,192,2,1,579,1118,16,482,926,14,36.1875,>30,WI,Home,Upto 2014
WW Hall,WI,Pace,1969-01-03,Sydney,Australia,1969,2,121,224,3,1,677,1377,20,556,1153,17,33.85,>30,AUS,Away,Upto 2014
WW Hall,WI,Pace,1969-02-14,Sydney,Australia,1969,2,204,383,5,1,820,1525,21,616,1142,16,39.04761904761905,>30,AUS,Away,Upto 2014
WW Hall,WI,Pace,1969-02-27,Auckland,New Zealand,1969,2,42,130,1,1,544,1153,15,502,1023,14,36.266666666666666,>30,NZ,Away,Upto 2014
WW Hinds,WI,Pace,2001-03-17,Port of Spain,West Indies,2001,1,23,30,2,1,814,1972,34,791,1942,32,23.941176470588236,<=30,WI,Home,Upto 2014
WW Hinds,WI,Pace,2001-03-29,Bridgetown,West Indies,2001,1,13,60,1,1,750,1752,22,737,1692,21,34.09090909090909,>30,WI,Home,Upto 2014
WW Hinds,WI,Pace,2001-04-06,St John's,West Indies,2001,1,14,21,0,1,374,1261,23,360,1240,23,16.26086956521739,<=30,WI,Home,Upto 2014
WW Hinds,WI,Pace,2002-01-31,Sharjah,UAE,2002,2,37,60,1,1,822,1590,24,785,1530,23,34.25,>30,UAE,Away,Upto 2014
WW Hinds,WI,Pace,2002-05-10,St John's,West Indies,2002,1,9,12,0,1,856,1992,11,847,1980,11,77.81818181818181,>30,WI,Home,Upto 2014
WW Hinds,WI,Pace,2002-10-09,Wankhede,India,2002,1,11,24,0,1,351,798,10,340,774,10,35.1,>30,IND,Away,Upto 2014
WW Hinds,WI,Pace,2003-04-19,Port of Spain,West Indies,2003,1,20,42,0,1,913,1617,20,893,1575,20,45.65,>30,WI,Home,Upto 2014
WW Hinds,WI,Pace,2003-06-20,Gros Islet,West Indies,2003,2,53,90,2,1,539,1047,9,486,957,7,59.888888888888886,>30,WI,Home,Upto 2014
WW Hinds,WI,Pace,2003-11-04,Harare,Zimbabwe,2003,1,40,90,1,1,904,1627,24,864,1537,23,37.666666666666664,>30,ZIM,Away,Upto 2014
WW Hinds,WI,Pace,2003-11-12,Bulawayo,Zimbabwe,2003,2,38,90,2,1,595,1210,25,557,1120,23,23.8,<=30,ZIM,Away,Upto 2014
WW Hinds,WI,Pace,2003-12-12,Johannesburg,South Africa,2003,2,134,172,5,1,1112,2121,34,978,1949,29,32.705882352941174,>30,SA,Away,Upto 2014
WW Hinds,WI,Pace,2003-12-26,Durban,South Africa,2003,1,50,78,0,1,1030,1831,26,980,1753,26,39.61538461538461,>30,SA,Away,Upto 2014
WW Hinds,WI,Pace,2004-01-02,Cape Town,South Africa,2004,1,31,42,0,1,1140,1873,23,1109,1831,23,49.56521739130435,>30,SA,Away,Upto 2014
WW Hinds,WI,Pace,2005-03-31,Georgetown,West Indies,2005,1,16,84,0,1,687,1530,15,671,1446,15,45.8,>30,WI,Home,Upto 2014
WW Hinds,WI,Pace,2005-04-08,Port of Spain,West Indies,2005,2,23,60,1,1,854,1820,25,831,1760,24,34.16,>30,WI,Home,Upto 2014
WW Hinds,WI,Pace,2005-04-21,Bridgetown,West Indies,2005,1,18,54,1,1,712,1449,24,694,1395,23,29.666666666666668,<=30,WI,Home,Upto 2014
WW Hinds,WI,Pace,2005-04-29,St John's,West Indies,2005,2,34,54,0,1,1036,1736,12,1002,1682,12,86.33333333333333,>30,WI,Home,Upto 2014
WW Hinds,WI,Pace,2005-05-26,Bridgetown,West Indies,2005,1,1,6,0,1,722,1198,25,721,1192,25,28.88,<=30,WI,Home,Upto 2014
WW Hinds,WI,Pace,2005-11-25,Adelaide,Australia,2005,1,25,54,0,1,853,1575,23,828,1521,23,37.08695652173913,>30,AUS,Away,Upto 2014
WW Read,ENG,Spin,1882-12-30,Melbourne,Australia,1882,1,27,32,0,1,291,692,13,264,660,13,22.384615384615383,<=30,AUS,Away,After 1965
WW Read,ENG,Spin,1884-08-11,The Oval,England,1884,1,36,28,0,1,469,1036,14,433,1008,14,33.5,>30,ENG,Home,After 1965
WW Whysall,ENG,Pace,1925-01-16,Adelaide,Australia,1925,1,9,16,0,1,326,857,11,317,841,11,29.636363636363637,<=30,AUS,Away,Upto 2014
Wafadar Momand,AFG,Pace,2018-06-14,Bengaluru,India,2018,1,100,126,2,1,280,456,13,180,330,11,21.53846153846154,<=30,IND,Away,After 1965
Wafadar Momand,AFG,Pace,2019-03-15,Dehradun,India,2019,2,55,96,0,1,244,549,10,189,453,10,24.4,<=30,IND,Away,After 1965
Wahab Riaz,PAK,Pace,2010-08-18,The Oval,England,2010,2,103,156,6,1,645,1152,22,542,996,16,29.318181818181817,<=30,ENG,Away,Upto 2014
Wahab Riaz,PAK,Pace,2010-08-26,Lord's,England,2010,1,92,164,1,1,413,794,18,321,630,17,22.944444444444443,<=30,ENG,Away,Upto 2014
Wahab Riaz,PAK,Pace,2010-11-12,Dubai (DICS),UAE,2010,1,61,108,2,1,500,966,12,439,858,10,41.666666666666664,>30,UAE,Away,Upto 2014
Wahab Riaz,PAK,Pace,2011-01-07,Hamilton,New Zealand,2011,2,85,168,3,1,564,1033,21,479,865,18,26.857142857142858,<=30,NZ,Away,Upto 2014
Wahab Riaz,PAK,Pace,2011-01-15,Wellington,New Zealand,2011,2,84,144,1,1,781,1511,23,697,1367,22,33.95652173913044,>30,NZ,Away,Upto 2014
Wahab Riaz,PAK,Pace,2011-05-12,Providence,West Indies,2011,2,57,120,2,1,310,796,18,253,676,16,17.22222222222222,<=30,WI,Away,Upto 2014
Wahab Riaz,PAK,Pace,2011-05-20,Basseterre,West Indies,2011,2,98,126,2,1,547,1106,13,449,980,11,42.07692307692308,>30,WI,Away,Upto 2014
Wahab Riaz,PAK,Pace,2014-08-14,Colombo (SSC),Sri Lanka,2014,2,164,270,6,1,441,792,14,277,522,8,31.5,>30,SL,Away,After 1965
Wahab Riaz,PAK,Pace,2015-04-28,Khulna,Bangladesh,2015,2,130,276,3,1,401,750,6,271,474,3,66.83333333333333,>30,BAN,Away,After 1965
Wahab Riaz,PAK,Pace,2015-05-06,Mirpur,Bangladesh,2015,2,109,156,4,1,464,771,14,355,615,10,33.142857142857146,>30,BAN,Away,After 1965
Wahab Riaz,PAK,Pace,2015-06-17,Galle,Sri Lanka,2015,2,120,252,5,1,383,708,10,263,456,5,38.3,>30,SL,Away,After 1965
Wahab Riaz,PAK,Pace,2015-06-25,Colombo (PSS),Sri Lanka,2015,1,19,54,0,1,390,800,14,371,746,14,27.857142857142858,<=30,SL,Away,After 1965
Wahab Riaz,PAK,Pace,2015-10-13,Abu Dhabi,UAE,2015,2,145,234,3,1,582,1249,16,437,1015,13,36.375,>30,UAE,Away,After 1965
Wahab Riaz,PAK,Pace,2015-10-22,Dubai (DICS),UAE,2015,2,144,264,5,1,554,1207,19,410,943,14,29.157894736842106,<=30,UAE,Away,After 1965
Wahab Riaz,PAK,Pace,2015-11-01,Sharjah,UAE,2015,2,58,150,0,1,278,841,14,220,691,14,19.857142857142858,<=30,UAE,Away,After 1965
Wahab Riaz,PAK,Pace,2016-07-14,Lord's,England,2016,2,113,187,2,1,760,1521,27,647,1334,25,28.14814814814815,<=30,ENG,Away,After 1965
Wahab Riaz,PAK,Pace,2016-07-22,Manchester,England,2016,1,106,158,3,1,705,1279,22,599,1121,19,32.04545454545455,>30,ENG,Away,After 1965
Wahab Riaz,PAK,Pace,2016-08-11,The Oval,England,2016,2,141,188,5,1,784,1374,21,643,1186,16,37.333333333333336,>30,ENG,Away,After 1965
Wahab Riaz,PAK,Pace,2016-10-13,Dubai (DICS),UAE,2016,2,112,243,3,1,642,1209,9,530,966,6,71.33333333333333,>30,UAE,Away,After 1965
Wahab Riaz,PAK,Pace,2016-10-30,Sharjah,UAE,2016,2,134,232,7,1,508,1019,20,374,787,13,25.4,<=30,UAE,Away,After 1965
Wahab Riaz,PAK,Pace,2016-11-25,Hamilton,New Zealand,2016,2,110,222,2,1,921,1796,32,811,1574,30,28.78125,<=30,NZ,Away,After 1965
Wahab Riaz,PAK,Pace,2016-12-15,Brisbane,Australia,2016,2,136,198,5,1,820,1566,28,684,1368,23,29.285714285714285,<=30,AUS,Away,After 1965
Wahab Riaz,PAK,Pace,2016-12-26,Melbourne,Australia,2016,1,147,192,2,1,778,1397,19,631,1205,17,40.94736842105263,>30,AUS,Away,After 1965
Wahab Riaz,PAK,Pace,2017-01-03,Sydney,Australia,2017,2,117,210,4,1,587,1109,15,470,899,11,39.13333333333333,>30,AUS,Away,After 1965
Wahab Riaz,PAK,Pace,2017-04-21,Kingston,West Indies,2017,2,95,174,2,1,500,1200,21,405,1026,19,23.80952380952381,<=30,WI,Away,After 1965
Wahab Riaz,PAK,Pace,2017-10-06,Dubai (DICS),UAE,2017,2,103,210,5,1,468,1044,16,365,834,11,29.25,<=30,UAE,Away,After 1965
Wahab Riaz,PAK,Pace,2018-10-07,Dubai (DICS),UAE,2018,2,81,162,0,1,373,938,11,292,776,11,33.90909090909091,>30,UAE,Away,After 1965
Wajahatullah Wasti,PAK,Spin,1999-03-04,Lahore,Pakistan,1999,1,8,6,0,1,525,960,12,517,954,12,43.75,>30,PAK,Home,Upto 2014
Wajahatullah Wasti,PAK,Spin,1999-11-26,W.A.C.A,Australia,1999,1,0,6,0,1,137,252,3,137,246,3,45.666666666666664,>30,AUS,Away,Upto 2014
Wajahatullah Wasti,PAK,Spin,2000-02-26,Rawalpindi,Pakistan,2000,1,0,6,0,1,401,1058,12,401,1052,12,33.416666666666664,>30,PAK,Home,Upto 2014
Waqar Hasan,PAK,Spin,1952-12-12,Eden Gardens,India,1952,1,10,6,0,1,455,1230,13,445,1224,13,35.0,>30,IND,Away,Upto 2014
Waqar Salamkheil,AFG,Spin,2019-03-15,Dehradun,India,2019,2,101,186,4,1,656,1295,22,555,1109,18,29.818181818181817,<=30,IND,Away,After 1965
Waqar Younis,PAK,Pace,1989-11-15,Karachi,Pakistan,1989,2,91,126,4,1,875,1711,26,784,1585,22,33.65384615384615,>30,PAK,Home,Upto 2014
Waqar Younis,PAK,Pace,1989-12-09,Sialkot,Pakistan,1989,2,146,222,2,1,741,1608,26,595,1386,24,28.5,<=30,PAK,Home,Upto 2014
Waqar Younis,PAK,Pace,1990-01-12,Melbourne,Australia,1990,2,95,204,0,1,791,2097,34,696,1893,34,23.264705882352942,<=30,AUS,Away,Upto 2014
Waqar Younis,PAK,Pace,1990-01-19,Adelaide,Australia,1990,2,108,240,3,1,759,1677,27,651,1437,24,28.11111111111111,<=30,AUS,Away,Upto 2014
Waqar Younis,PAK,Pace,1990-02-03,Sydney,Australia,1990,1,21,54,1,1,253,749,11,232,695,10,23.0,<=30,AUS,Away,Upto 2014
Waqar Younis,PAK,Pace,1990-10-10,Karachi,Pakistan,1990,2,79,226,7,1,575,1344,23,496,1118,16,25.0,<=30,PAK,Home,Upto 2014
Waqar Younis,PAK,Pace,1990-10-18,Lahore,Pakistan,1990,2,106,317,10,1,697,1583,26,591,1266,16,26.807692307692307,<=30,PAK,Home,Upto 2014
Waqar Younis,PAK,Pace,1990-10-26,Faisalabad,Pakistan,1990,2,130,325,12,1,725,1761,39,595,1436,27,18.58974358974359,<=30,PAK,Home,Upto 2014
Waqar Younis,PAK,Pace,1990-11-15,Karachi,Pakistan,1990,2,120,234,9,1,537,1280,27,417,1046,18,19.88888888888889,<=30,PAK,Home,Upto 2014
Waqar Younis,PAK,Pace,1990-11-23,Faisalabad,Pakistan,1990,2,87,150,5,1,499,862,28,412,712,23,17.821428571428573,<=30,PAK,Home,Upto 2014
Waqar Younis,PAK,Pace,1990-12-06,Lahore,Pakistan,1990,2,89,150,2,1,541,1248,30,452,1098,28,18.033333333333335,<=30,PAK,Home,Upto 2014
Waqar Younis,PAK,Pace,1991-12-12,Sialkot,Pakistan,1991,2,127,273,7,1,611,1329,14,484,1056,7,43.642857142857146,>30,PAK,Home,Upto 2014
Waqar Younis,PAK,Pace,1992-01-02,Faisalabad,Pakistan,1992,2,152,228,9,1,743,1706,36,591,1478,27,20.63888888888889,<=30,PAK,Home,Upto 2014
Waqar Younis,PAK,Pace,1992-06-04,Birmingham,England,1992,1,96,144,1,1,641,1086,9,545,942,8,71.22222222222223,>30,ENG,Away,Upto 2014
Waqar Younis,PAK,Pace,1992-06-18,Lord's,England,1992,2,131,204,7,1,607,1221,26,476,1017,19,23.346153846153847,<=30,ENG,Away,Upto 2014
Waqar Younis,PAK,Pace,1992-07-02,Manchester,England,1992,1,96,192,1,1,841,1528,24,745,1336,23,35.041666666666664,>30,ENG,Away,Upto 2014
Waqar Younis,PAK,Pace,1992-07-23,Leeds,England,1992,2,145,252,7,1,719,1557,27,574,1305,20,26.62962962962963,<=30,ENG,Away,Upto 2014
Waqar Younis,PAK,Pace,1992-08-06,The Oval,England,1992,2,89,204,6,1,546,1176,25,457,972,19,21.84,<=30,ENG,Away,Upto 2014
Waqar Younis,PAK,Pace,1993-01-02,Hamilton,New Zealand,1993,2,81,249,9,1,500,1200,33,419,951,24,15.151515151515152,<=30,NZ,Away,Upto 2014
Waqar Younis,PAK,Pace,1993-04-16,Port of Spain,West Indies,1993,2,125,204,6,1,566,1117,30,441,913,24,18.866666666666667,<=30,WI,Away,Upto 2014
Waqar Younis,PAK,Pace,1993-04-23,Bridgetown,West Indies,1993,1,132,155,4,1,783,1460,25,651,1305,21,31.32,>30,WI,Away,Upto 2014
Waqar Younis,PAK,Pace,1993-05-01,St John's,West Indies,1993,2,127,234,9,1,577,1130,21,450,896,12,27.476190476190474,<=30,WI,Away,Upto 2014
Waqar Younis,PAK,Pace,1993-12-01,Karachi,Pakistan,1993,2,135,336,13,1,605,1326,22,470,990,9,27.5,<=30,PAK,Home,Upto 2014
Waqar Younis,PAK,Pace,1993-12-09,Rawalpindi,Pakistan,1993,2,138,240,9,1,816,1939,40,678,1699,31,20.4,<=30,PAK,Home,Upto 2014
Waqar Younis,PAK,Pace,1993-12-16,Lahore,Pakistan,1993,1,100,208,5,1,467,1213,21,367,1005,16,22.238095238095237,<=30,PAK,Home,Upto 2014
Waqar Younis,PAK,Pace,1994-02-10,Auckland,New Zealand,1994,2,81,150,6,1,582,1070,31,501,920,25,18.774193548387096,<=30,NZ,Away,Upto 2014
Waqar Younis,PAK,Pace,1994-02-17,Wellington,New Zealand,1994,2,162,284,5,1,832,1382,22,670,1098,17,37.81818181818182,>30,NZ,Away,Upto 2014
Waqar Younis,PAK,Pace,1994-02-24,Christchurch,New Zealand,1994,2,162,276,7,1,835,1575,27,673,1299,20,30.925925925925927,>30,NZ,Away,Upto 2014
Waqar Younis,PAK,Pace,1994-08-09,Colombo (PSS),Sri Lanka,1994,2,112,138,3,1,293,474,11,181,336,8,26.636363636363637,<=30,SL,Away,Upto 2014
Waqar Younis,PAK,Pace,1994-08-26,Kandy,Sri Lanka,1994,2,119,192,11,1,485,782,21,366,590,10,23.095238095238095,<=30,SL,Away,Upto 2014
Waqar Younis,PAK,Pace,1994-09-28,Karachi,Pakistan,1994,2,144,224,7,1,553,1041,23,409,817,16,24.043478260869566,<=30,PAK,Home,Upto 2014
Waqar Younis,PAK,Pace,1994-10-05,Rawalpindi,Pakistan,1994,2,114,222,3,1,838,1506,23,724,1284,20,36.43478260869565,>30,PAK,Home,Upto 2014
Waqar Younis,PAK,Pace,1995-09-08,Peshawar,Pakistan,1995,2,86,120,1,1,562,1039,16,476,919,15,35.125,>30,PAK,Home,Upto 2014
Waqar Younis,PAK,Pace,1995-11-09,Brisbane,Australia,1995,1,101,179,3,1,520,1074,13,419,895,10,40.0,>30,AUS,Away,Upto 2014
Waqar Younis,PAK,Pace,1995-11-17,Hobart,Australia,1995,2,121,222,2,1,693,1398,29,572,1176,27,23.896551724137932,<=30,AUS,Away,Upto 2014
Waqar Younis,PAK,Pace,1995-11-30,Sydney,Australia,1995,2,41,103,3,1,445,1017,19,404,914,16,23.42105263157895,<=30,AUS,Away,Upto 2014
Waqar Younis,PAK,Pace,1995-12-08,Christchurch,New Zealand,1995,2,133,252,1,1,844,1657,28,711,1405,27,30.142857142857142,>30,NZ,Away,Upto 2014
Waqar Younis,PAK,Pace,1996-07-25,Lord's,England,1996,2,154,294,8,1,850,1771,26,696,1477,18,32.69230769230769,>30,ENG,Away,Upto 2014
Waqar Younis,PAK,Pace,1996-08-08,Leeds,England,1996,1,127,198,3,1,963,1933,22,836,1735,19,43.77272727272727,>30,ENG,Away,Upto 2014
Waqar Younis,PAK,Pace,1996-08-22,The Oval,England,1996,2,150,258,5,1,690,1195,17,540,937,12,40.588235294117645,>30,ENG,Away,Upto 2014
Waqar Younis,PAK,Pace,1996-10-17,Sheikhupura,Pakistan,1996,2,150,252,1,1,489,1024,12,339,772,11,40.75,>30,PAK,Home,Upto 2014
Waqar Younis,PAK,Pace,1996-10-24,Faisalabad,Pakistan,1996,2,67,156,5,1,475,908,25,408,752,20,19.0,<=30,PAK,Home,Upto 2014
Waqar Younis,PAK,Pace,1996-11-21,Lahore,Pakistan,1996,2,74,180,5,1,507,953,23,433,773,18,22.043478260869566,<=30,PAK,Home,Upto 2014
Waqar Younis,PAK,Pace,1997-10-06,Rawalpindi,Pakistan,1997,1,45,120,0,1,556,1227,14,511,1107,14,39.714285714285715,>30,PAK,Home,Upto 2014
Waqar Younis,PAK,Pace,1997-10-24,Faisalabad,Pakistan,1997,2,79,144,4,1,482,896,25,403,752,21,19.28,<=30,PAK,Home,Upto 2014
Waqar Younis,PAK,Pace,1997-11-29,Rawalpindi,Pakistan,1997,2,143,234,5,1,728,1434,26,585,1200,21,28.0,<=30,PAK,Home,Upto 2014
Waqar Younis,PAK,Pace,1997-12-06,Karachi,Pakistan,1997,2,52,90,2,1,528,879,18,476,789,16,29.333333333333332,<=30,PAK,Home,Upto 2014
Waqar Younis,PAK,Pace,1998-02-14,Johannesburg,South Africa,1998,2,98,171,3,1,551,982,15,453,811,12,36.733333333333334,>30,SA,Away,Upto 2014
Waqar Younis,PAK,Pace,1998-02-26,Durban,South Africa,1998,2,123,218,3,1,733,1519,29,610,1301,26,25.275862068965516,<=30,SA,Away,Upto 2014
Waqar Younis,PAK,Pace,1998-03-06,Gqeberha,South Africa,1998,2,133,244,10,1,625,1400,33,492,1156,23,18.939393939393938,<=30,SA,Away,Upto 2014
Waqar Younis,PAK,Pace,1998-03-14,Bulawayo,Zimbabwe,1998,2,124,236,7,1,726,1690,25,602,1454,18,29.04,<=30,ZIM,Away,Upto 2014
Waqar Younis,PAK,Pace,1998-03-21,Harare,Zimbabwe,1998,2,107,270,6,1,727,1780,29,620,1510,23,25.06896551724138,<=30,ZIM,Away,Upto 2014
Waqar Younis,PAK,Pace,1998-11-27,Peshawar,Pakistan,1998,2,129,189,4,1,700,1353,31,571,1164,27,22.580645161290324,<=30,PAK,Home,Upto 2014
Waqar Younis,PAK,Pace,1998-12-10,Lahore,Pakistan,1998,1,54,108,4,1,457,1020,11,403,912,7,41.54545454545455,>30,PAK,Home,Upto 2014
Waqar Younis,PAK,Pace,1999-01-28,Chennai,India,1999,2,74,144,2,1,432,740,16,358,596,14,27.0,<=30,IND,Away,Upto 2014
Waqar Younis,PAK,Pace,1999-02-04,Delhi,India,1999,2,79,150,0,1,268,588,7,189,438,7,38.285714285714285,>30,IND,Away,Upto 2014
Waqar Younis,PAK,Pace,1999-11-18,Hobart,Australia,1999,2,80,138,2,1,857,1577,19,777,1439,17,45.10526315789474,>30,AUS,Away,Upto 2014
Waqar Younis,PAK,Pace,2000-02-26,Rawalpindi,Pakistan,2000,2,181,329,6,1,697,1541,24,516,1212,18,29.041666666666668,<=30,PAK,Home,Upto 2014
Waqar Younis,PAK,Pace,2000-03-05,Peshawar,Pakistan,2000,2,58,126,3,1,480,1060,20,422,934,17,24.0,<=30,PAK,Home,Upto 2014
Waqar Younis,PAK,Pace,2000-03-12,Karachi,Pakistan,2000,2,71,126,4,1,750,1272,22,679,1146,18,34.09090909090909,>30,PAK,Home,Upto 2014
Waqar Younis,PAK,Pace,2000-05-05,Georgetown,West Indies,2000,1,46,90,1,1,344,903,13,298,813,12,26.46153846153846,<=30,WI,Away,Upto 2014
Waqar Younis,PAK,Pace,2000-05-18,Bridgetown,West Indies,2000,2,86,126,3,1,788,1618,23,702,1492,20,34.26086956521739,>30,WI,Away,Upto 2014
Waqar Younis,PAK,Pace,2000-05-25,St John's,West Indies,2000,2,80,192,1,1,652,1622,32,572,1430,31,20.375,<=30,WI,Away,Upto 2014
Waqar Younis,PAK,Pace,2000-06-14,Colombo (SSC),Sri Lanka,2000,2,71,140,4,1,461,1090,17,390,950,13,27.11764705882353,<=30,SL,Away,Upto 2014
Waqar Younis,PAK,Pace,2000-06-21,Galle,Sri Lanka,2000,2,79,193,7,1,578,1128,20,499,935,13,28.9,<=30,SL,Away,Upto 2014
Waqar Younis,PAK,Pace,2000-06-28,Kandy,Sri Lanka,2000,1,94,118,0,1,200,466,2,106,348,2,100.0,>30,SL,Away,Upto 2014
Waqar Younis,PAK,Pace,2000-12-07,Karachi,Pakistan,2000,2,115,252,5,1,458,1000,15,343,748,10,30.533333333333335,>30,PAK,Home,Upto 2014
Waqar Younis,PAK,Pace,2001-03-08,Auckland,New Zealand,2001,2,75,198,2,1,702,1474,24,627,1276,22,29.25,<=30,NZ,Away,Upto 2014
Waqar Younis,PAK,Pace,2001-03-15,Christchurch,New Zealand,2001,2,132,252,3,1,802,1722,12,670,1470,9,66.83333333333333,>30,NZ,Away,Upto 2014
Waqar Younis,PAK,Pace,2001-03-27,Hamilton,New Zealand,2001,1,98,186,1,1,506,942,23,408,756,22,22.0,<=30,NZ,Away,Upto 2014
Waqar Younis,PAK,Pace,2001-05-17,Lord's,England,2001,1,77,150,2,1,714,1443,30,637,1293,28,23.8,<=30,ENG,Away,Upto 2014
Waqar Younis,PAK,Pace,2001-05-31,Manchester,England,2001,2,172,277,5,1,1134,1996,31,962,1719,26,36.58064516129032,>30,ENG,Away,Upto 2014
Waqar Younis,PAK,Pace,2001-08-29,Multan,Pakistan,2001,2,44,79,6,1,512,738,9,468,659,3,56.888888888888886,>30,PAK,Home,Upto 2014
Waqar Younis,PAK,Pace,2002-01-09,Dhaka,Bangladesh,2002,2,82,152,7,1,377,686,15,295,534,8,25.133333333333333,<=30,BAN,Away,Upto 2014
Waqar Younis,PAK,Pace,2002-01-16,Chattogram,Bangladesh,2002,2,55,95,5,1,326,664,15,271,569,10,21.733333333333334,<=30,BAN,Away,Upto 2014
Waqar Younis,PAK,Pace,2002-01-31,Sharjah,UAE,2002,2,128,207,4,1,822,1590,24,694,1383,20,34.25,>30,UAE,Away,Upto 2014
Waqar Younis,PAK,Pace,2002-02-07,Sharjah,UAE,2002,2,68,114,4,1,615,1212,24,547,1098,20,25.625,<=30,UAE,Away,Upto 2014
Waqar Younis,PAK,Pace,2002-03-06,Lahore,Pakistan,2002,1,123,180,1,1,853,1374,23,730,1194,22,37.08695652173913,>30,PAK,Home,Upto 2014
Waqar Younis,PAK,Pace,2002-05-01,Lahore,Pakistan,2002,2,59,114,2,1,476,866,17,417,752,15,28.0,<=30,PAK,Home,Upto 2014
Waqar Younis,PAK,Pace,2002-10-03,Colombo (PSS),Sri Lanka,2002,2,109,144,2,1,672,1175,21,563,1031,19,32.0,>30,SL,Away,Upto 2014
Waqar Younis,PAK,Pace,2002-10-11,Sharjah,UAE,2002,1,25,48,0,1,167,426,14,142,378,14,11.928571428571429,<=30,UAE,Away,Upto 2014
Waqar Younis,PAK,Pace,2002-10-19,Sharjah,UAE,2002,1,55,105,4,1,365,713,15,310,608,11,24.333333333333332,<=30,UAE,Away,Upto 2014
Waqar Younis,PAK,Pace,2002-11-09,Harare,Zimbabwe,2002,2,131,180,3,1,875,1422,31,744,1242,28,28.225806451612904,<=30,ZIM,Away,Upto 2014
Waqar Younis,PAK,Pace,2002-11-16,Bulawayo,Zimbabwe,2002,2,98,206,5,1,555,1011,16,457,805,11,34.6875,>30,ZIM,Away,Upto 2014
Waqar Younis,PAK,Pace,2002-12-26,Durban,South Africa,2002,1,91,150,3,1,631,1153,23,540,1003,20,27.434782608695652,<=30,SA,Away,Upto 2014
Waqar Younis,PAK,Pace,2003-01-02,Cape Town,South Africa,2003,1,121,168,1,1,694,1175,21,573,1007,20,33.04761904761905,>30,SA,Away,Upto 2014
Washington Sundar,IND,Spin,2021-01-15,Brisbane,Australia,2021,2,169,294,4,1,324,661,7,155,367,3,46.285714285714285,>30,AUS,Away,After 1965
Washington Sundar,IND,Spin,2021-02-05,Chennai,India,2021,2,99,162,0,1,867,1480,24,768,1318,24,36.125,>30,IND,Home,After 1965
Washington Sundar,IND,Spin,2021-02-24,Ahmedabad,India,2021,1,1,4,1,1,247,614,28,246,610,27,8.821428571428571,<=30,IND,Home,After 1965
Washington Sundar,IND,Spin,2021-03-04,Ahmedabad,India,2021,2,30,66,1,1,456,994,20,426,928,19,22.8,<=30,IND,Home,After 1965
Washington Sundar,IND,Spin,2024-10-24,Pune,India,2024,2,115,253,11,1,741,1336,37,626,1083,26,20.027027027027028,<=30,IND,Home,After 1965
Washington Sundar,IND,Spin,2024-11-01,Wankhede,India,2024,2,111,172,5,1,671,1028,34,560,856,29,19.735294117647058,<=30,IND,Home,After 1965
Washington Sundar,IND,Spin,2024-11-22,Perth,Australia,2024,2,49,102,2,1,374,651,9,325,549,7,41.55555555555556,>30,AUS,Away,After 1965
Washington Sundar,IND,Spin,2024-12-26,Melbourne,Australia,2024,2,56,114,1,1,350,730,11,294,616,10,31.818181818181817,>30,AUS,Away,After 1965
Washington Sundar,IND,Spin,2025-01-03,Sydney,Australia,2025,1,11,6,0,1,137,216,4,126,210,4,34.25,>30,AUS,Away,After 1965
Wasim Akram,PAK,Pace,1985-01-25,Auckland,New Zealand,1985,1,105,208,2,1,673,1429,25,568,1221,23,26.92,<=30,NZ,Away,Upto 2014
Wasim Akram,PAK,Pace,1985-02-09,Dunedin,New Zealand,1985,2,128,354,10,1,862,2018,34,734,1664,24,25.352941176470587,<=30,NZ,Away,Upto 2014
Wasim Akram,PAK,Pace,1985-10-16,Faisalabad,Pakistan,1985,1,98,255,1,1,718,1505,9,620,1250,8,79.77777777777777,>30,PAK,Home,Upto 2014
Wasim Akram,PAK,Pace,1985-10-27,Sialkot,Pakistan,1985,2,112,200,4,1,662,1204,31,550,1004,27,21.35483870967742,<=30,PAK,Home,Upto 2014
Wasim Akram,PAK,Pace,1985-11-07,Karachi,Pakistan,1985,2,41,168,3,1,402,787,17,361,619,14,23.647058823529413,<=30,PAK,Home,Upto 2014
Wasim Akram,PAK,Pace,1986-02-23,Kandy,Sri Lanka,1986,2,26,78,2,1,238,611,14,212,533,12,17.0,<=30,SL,Away,Upto 2014
Wasim Akram,PAK,Pace,1986-03-14,Colombo (CCC),Sri Lanka,1986,2,65,201,4,1,530,1137,31,465,936,27,17.096774193548388,<=30,SL,Away,Upto 2014
Wasim Akram,PAK,Pace,1986-03-22,Colombo (PSS),Sri Lanka,1986,2,113,306,2,1,728,1538,20,615,1232,18,36.4,>30,SL,Away,Upto 2014
Wasim Akram,PAK,Pace,1986-10-24,Faisalabad,Pakistan,1986,2,96,168,6,1,582,1145,28,486,977,22,20.785714285714285,<=30,PAK,Home,Upto 2014
Wasim Akram,PAK,Pace,1986-11-07,Lahore,Pakistan,1986,1,16,54,0,1,247,794,22,231,740,22,11.227272727272727,<=30,PAK,Home,Upto 2014
Wasim Akram,PAK,Pace,1987-02-03,Chennai,India,1987,1,78,204,1,1,341,600,5,263,396,4,68.2,>30,IND,Away,Upto 2014
Wasim Akram,PAK,Pace,1987-02-11,Eden Gardens,India,1987,2,142,294,5,1,698,1442,20,556,1148,15,34.9,>30,IND,Away,Upto 2014
Wasim Akram,PAK,Pace,1987-02-21,Jaipur,India,1987,2,105,249,1,1,305,699,6,200,450,5,50.833333333333336,>30,IND,Away,Upto 2014
Wasim Akram,PAK,Pace,1987-03-04,Ahmedabad,India,1987,1,60,131,4,1,194,539,11,134,408,7,17.636363636363637,<=30,IND,Away,Upto 2014
Wasim Akram,PAK,Pace,1987-03-13,Bengaluru,India,1987,2,28,78,2,1,134,282,5,106,204,3,26.8,<=30,IND,Away,Upto 2014
Wasim Akram,PAK,Pace,1987-06-04,Manchester,England,1987,1,111,276,4,1,470,978,11,359,702,7,42.72727272727273,>30,ENG,Away,Upto 2014
Wasim Akram,PAK,Pace,1987-06-18,Lord's,England,1987,1,98,168,2,1,256,527,7,158,359,5,36.57142857142857,>30,ENG,Away,Upto 2014
Wasim Akram,PAK,Pace,1987-07-02,Leeds,England,1987,2,91,210,5,1,511,1279,29,420,1069,24,17.620689655172413,<=30,ENG,Away,Upto 2014
Wasim Akram,PAK,Pace,1987-07-23,Birmingham,England,1987,2,124,310,5,1,1037,2130,29,913,1820,24,35.758620689655174,>30,ENG,Away,Upto 2014
Wasim Akram,PAK,Pace,1987-08-06,The Oval,England,1987,2,40,120,0,1,607,1188,10,567,1068,10,60.7,>30,ENG,Away,Upto 2014
Wasim Akram,PAK,Pace,1987-11-25,Lahore,Pakistan,1987,2,38,96,0,1,221,462,3,183,366,3,73.66666666666667,>30,PAK,Home,Upto 2014
Wasim Akram,PAK,Pace,1987-12-16,Karachi,Pakistan,1987,1,64,145,2,1,422,869,15,358,724,13,28.133333333333333,<=30,PAK,Home,Upto 2014
Wasim Akram,PAK,Pace,1988-04-02,Georgetown,West Indies,1988,2,48,120,1,1,579,1055,22,531,935,21,26.318181818181817,<=30,WI,Away,Upto 2014
Wasim Akram,PAK,Pace,1988-04-14,Port of Spain,West Indies,1988,2,110,234,3,1,692,1635,27,582,1401,24,25.62962962962963,<=30,WI,Away,Upto 2014
Wasim Akram,PAK,Pace,1988-04-22,Bridgetown,West Indies,1988,2,161,348,7,1,833,1467,30,672,1119,23,27.766666666666666,<=30,WI,Away,Upto 2014
Wasim Akram,PAK,Pace,1989-11-15,Karachi,Pakistan,1989,2,151,308,5,1,875,1711,26,724,1403,21,33.65384615384615,>30,PAK,Home,Upto 2014
Wasim Akram,PAK,Pace,1989-11-23,Faisalabad,Pakistan,1989,2,193,414,5,1,850,1756,23,657,1342,18,36.95652173913044,>30,PAK,Home,Upto 2014
Wasim Akram,PAK,Pace,1989-12-01,Lahore,Pakistan,1989,1,65,144,1,1,513,1118,6,448,974,5,85.5,>30,PAK,Home,Upto 2014
Wasim Akram,PAK,Pace,1989-12-09,Sialkot,Pakistan,1989,2,142,362,7,1,741,1608,26,599,1246,19,28.5,<=30,PAK,Home,Upto 2014
Wasim Akram,PAK,Pace,1990-01-12,Melbourne,Australia,1990,2,160,430,11,1,791,2097,34,631,1667,23,23.264705882352942,<=30,AUS,Away,Upto 2014
Wasim Akram,PAK,Pace,1990-01-19,Adelaide,Australia,1990,2,129,324,6,1,759,1677,27,630,1353,21,28.11111111111111,<=30,AUS,Away,Upto 2014
Wasim Akram,PAK,Pace,1990-02-03,Sydney,Australia,1990,1,29,60,0,1,253,749,11,224,689,11,23.0,<=30,AUS,Away,Upto 2014
Wasim Akram,PAK,Pace,1990-10-10,Karachi,Pakistan,1990,2,104,323,8,1,575,1344,23,471,1021,15,25.0,<=30,PAK,Home,Upto 2014
Wasim Akram,PAK,Pace,1990-10-18,Lahore,Pakistan,1990,2,58,150,2,1,697,1583,26,639,1433,24,26.807692307692307,<=30,PAK,Home,Upto 2014
Wasim Akram,PAK,Pace,1990-11-15,Karachi,Pakistan,1990,2,100,264,6,1,537,1280,27,437,1016,21,19.88888888888889,<=30,PAK,Home,Upto 2014
Wasim Akram,PAK,Pace,1990-11-23,Faisalabad,Pakistan,1990,2,109,174,6,1,499,862,28,390,688,22,17.821428571428573,<=30,PAK,Home,Upto 2014
Wasim Akram,PAK,Pace,1990-12-06,Lahore,Pakistan,1990,2,89,198,9,1,541,1248,30,452,1050,21,18.033333333333335,<=30,PAK,Home,Upto 2014
Wasim Akram,PAK,Pace,1991-12-12,Sialkot,Pakistan,1991,2,78,270,1,1,611,1329,14,533,1059,13,43.642857142857146,>30,PAK,Home,Upto 2014
Wasim Akram,PAK,Pace,1992-01-02,Faisalabad,Pakistan,1992,2,133,240,5,1,743,1706,36,610,1466,31,20.63888888888889,<=30,PAK,Home,Upto 2014
Wasim Akram,PAK,Pace,1992-06-18,Lord's,England,1992,2,115,220,6,1,607,1221,26,492,1001,20,23.346153846153847,<=30,ENG,Away,Upto 2014
Wasim Akram,PAK,Pace,1992-07-02,Manchester,England,1992,1,128,216,5,1,841,1528,24,713,1312,19,35.041666666666664,>30,ENG,Away,Upto 2014
Wasim Akram,PAK,Pace,1992-07-23,Leeds,England,1992,2,116,318,1,1,719,1557,27,603,1239,26,26.62962962962963,<=30,ENG,Away,Upto 2014
Wasim Akram,PAK,Pace,1992-08-06,The Oval,England,1992,2,103,259,9,1,546,1176,25,443,917,16,21.84,<=30,ENG,Away,Upto 2014
Wasim Akram,PAK,Pace,1993-01-02,Hamilton,New Zealand,1993,2,111,318,8,1,500,1200,33,389,882,25,15.151515151515152,<=30,NZ,Away,Upto 2014
Wasim Akram,PAK,Pace,1993-04-16,Port of Spain,West Indies,1993,2,107,224,6,1,566,1117,30,459,893,24,18.866666666666667,<=30,WI,Away,Upto 2014
Wasim Akram,PAK,Pace,1993-04-23,Bridgetown,West Indies,1993,2,113,207,1,1,783,1460,25,670,1253,24,31.32,>30,WI,Away,Upto 2014
Wasim Akram,PAK,Pace,1993-05-01,St John's,West Indies,1993,2,138,218,2,1,577,1130,21,439,912,19,27.476190476190474,<=30,WI,Away,Upto 2014
Wasim Akram,PAK,Pace,1993-12-09,Rawalpindi,Pakistan,1993,2,133,266,7,1,816,1939,40,683,1673,33,20.4,<=30,PAK,Home,Upto 2014
Wasim Akram,PAK,Pace,1993-12-16,Lahore,Pakistan,1993,1,70,192,4,1,467,1213,21,397,1021,17,22.238095238095237,<=30,PAK,Home,Upto 2014
Wasim Akram,PAK,Pace,1994-02-10,Auckland,New Zealand,1994,2,93,232,9,1,582,1070,31,489,838,22,18.774193548387096,<=30,NZ,Away,Upto 2014
Wasim Akram,PAK,Pace,1994-02-17,Wellington,New Zealand,1994,2,179,366,11,1,832,1382,22,653,1016,11,37.81818181818182,>30,NZ,Away,Upto 2014
Wasim Akram,PAK,Pace,1994-02-24,Christchurch,New Zealand,1994,2,159,360,5,1,835,1575,27,676,1215,22,30.925925925925927,>30,NZ,Away,Upto 2014
Wasim Akram,PAK,Pace,1994-08-09,Colombo (PSS),Sri Lanka,1994,2,73,210,8,1,293,474,11,220,264,3,26.636363636363637,<=30,SL,Away,Upto 2014
Wasim Akram,PAK,Pace,1994-08-26,Kandy,Sri Lanka,1994,2,102,242,5,1,485,782,21,383,540,16,23.095238095238095,<=30,SL,Away,Upto 2014
Wasim Akram,PAK,Pace,1994-09-28,Karachi,Pakistan,1994,2,138,282,8,1,553,1041,23,415,759,15,24.043478260869566,<=30,PAK,Home,Upto 2014
Wasim Akram,PAK,Pace,1994-10-05,Rawalpindi,Pakistan,1994,1,62,143,1,1,838,1506,23,776,1363,22,36.43478260869565,>30,PAK,Home,Upto 2014
Wasim Akram,PAK,Pace,1995-01-19,Johannesburg,South Africa,1995,2,166,354,4,1,915,1724,33,749,1370,29,27.727272727272727,<=30,SA,Away,Upto 2014
Wasim Akram,PAK,Pace,1995-01-31,Harare,Zimbabwe,1995,1,95,239,1,1,693,1542,23,598,1303,22,30.130434782608695,>30,ZIM,Away,Upto 2014
Wasim Akram,PAK,Pace,1995-02-07,Bulawayo,Zimbabwe,1995,2,83,267,8,1,563,1357,30,480,1090,22,18.766666666666666,<=30,ZIM,Away,Upto 2014
Wasim Akram,PAK,Pace,1995-02-15,Harare,Zimbabwe,1995,2,135,288,4,1,795,1808,39,660,1520,35,20.384615384615383,<=30,ZIM,Away,Upto 2014
Wasim Akram,PAK,Pace,1995-09-08,Peshawar,Pakistan,1995,2,79,180,7,1,562,1039,16,483,859,9,35.125,>30,PAK,Home,Upto 2014
Wasim Akram,PAK,Pace,1995-09-15,Faisalabad,Pakistan,1995,1,31,78,2,1,465,1059,21,434,981,19,22.142857142857142,<=30,PAK,Home,Upto 2014
Wasim Akram,PAK,Pace,1995-11-09,Brisbane,Australia,1995,1,84,228,2,1,520,1074,13,436,846,11,40.0,>30,AUS,Away,Upto 2014
Wasim Akram,PAK,Pace,1995-11-17,Hobart,Australia,1995,2,114,268,6,1,693,1398,29,579,1130,23,23.896551724137932,<=30,AUS,Away,Upto 2014
Wasim Akram,PAK,Pace,1995-11-30,Sydney,Australia,1995,2,75,240,6,1,445,1017,19,370,777,13,23.42105263157895,<=30,AUS,Away,Upto 2014
Wasim Akram,PAK,Pace,1995-12-08,Christchurch,New Zealand,1995,2,84,215,5,1,844,1657,28,760,1442,23,30.142857142857142,>30,NZ,Away,Upto 2014
Wasim Akram,PAK,Pace,1996-07-25,Lord's,England,1996,2,94,259,2,1,850,1771,26,756,1512,24,32.69230769230769,>30,ENG,Away,Upto 2014
Wasim Akram,PAK,Pace,1996-08-08,Leeds,England,1996,1,106,239,3,1,963,1933,22,857,1694,19,43.77272727272727,>30,ENG,Away,Upto 2014
Wasim Akram,PAK,Pace,1996-08-22,The Oval,England,1996,2,150,270,6,1,690,1195,17,540,925,11,40.588235294117645,>30,ENG,Away,Upto 2014
Wasim Akram,PAK,Pace,1996-10-17,Sheikhupura,Pakistan,1996,2,74,198,1,1,489,1024,12,415,826,11,40.75,>30,PAK,Home,Upto 2014
Wasim Akram,PAK,Pace,1996-10-24,Faisalabad,Pakistan,1996,2,106,232,10,1,475,908,25,369,676,15,19.0,<=30,PAK,Home,Upto 2014
Wasim Akram,PAK,Pace,1997-10-17,Sheikhupura,Pakistan,1997,1,26,78,1,1,127,240,3,101,162,2,42.333333333333336,>30,PAK,Home,Upto 2014
Wasim Akram,PAK,Pace,1997-10-24,Faisalabad,Pakistan,1997,2,88,162,5,1,482,896,25,394,734,20,19.28,<=30,PAK,Home,Upto 2014
Wasim Akram,PAK,Pace,1997-11-17,Peshawar,Pakistan,1997,2,94,224,5,1,444,1004,18,350,780,13,24.666666666666668,<=30,PAK,Home,Upto 2014
Wasim Akram,PAK,Pace,1997-11-29,Rawalpindi,Pakistan,1997,2,82,216,5,1,728,1434,26,646,1218,21,28.0,<=30,PAK,Home,Upto 2014
Wasim Akram,PAK,Pace,1997-12-06,Karachi,Pakistan,1997,2,118,203,7,1,528,879,18,410,676,11,29.333333333333332,<=30,PAK,Home,Upto 2014
Wasim Akram,PAK,Pace,1998-03-06,Gqeberha,South Africa,1998,2,107,252,3,1,625,1400,33,518,1148,30,18.939393939393938,<=30,SA,Away,Upto 2014
Wasim Akram,PAK,Pace,1998-03-21,Harare,Zimbabwe,1998,2,137,323,4,1,727,1780,29,590,1457,25,25.06896551724138,<=30,ZIM,Away,Upto 2014
Wasim Akram,PAK,Pace,1998-10-01,Rawalpindi,Pakistan,1998,1,111,210,3,1,337,761,10,226,551,7,33.7,>30,PAK,Home,Upto 2014
Wasim Akram,PAK,Pace,1998-10-22,Karachi,Pakistan,1998,2,111,264,2,1,309,770,9,198,506,7,34.333333333333336,>30,PAK,Home,Upto 2014
Wasim Akram,PAK,Pace,1998-11-27,Peshawar,Pakistan,1998,2,99,240,8,1,700,1353,31,601,1113,23,22.580645161290324,<=30,PAK,Home,Upto 2014
Wasim Akram,PAK,Pace,1998-12-10,Lahore,Pakistan,1998,2,65,156,0,1,457,1020,11,392,864,11,41.54545454545455,>30,PAK,Home,Upto 2014
Wasim Akram,PAK,Pace,1999-01-28,Chennai,India,1999,2,140,252,5,1,432,740,16,292,488,11,27.0,<=30,IND,Away,Upto 2014
Wasim Akram,PAK,Pace,1999-02-04,Delhi,India,1999,2,66,204,4,1,268,588,7,202,384,3,38.285714285714285,>30,IND,Away,Upto 2014
Wasim Akram,PAK,Pace,1999-02-16,Eden Gardens,India,1999,2,129,288,5,1,539,1227,30,410,939,25,17.966666666666665,<=30,IND,Away,Upto 2014
Wasim Akram,PAK,Pace,1999-03-04,Lahore,Pakistan,1999,2,69,134,5,1,638,1047,15,569,913,10,42.53333333333333,>30,PAK,Home,Upto 2014
Wasim Akram,PAK,Pace,1999-03-12,Dhaka,Bangladesh,1999,2,78,126,5,1,404,794,8,326,668,3,50.5,>30,BAN,Away,Upto 2014
Wasim Akram,PAK,Pace,1999-11-05,Brisbane,Australia,1999,2,101,211,2,1,895,1510,23,794,1299,21,38.91304347826087,>30,AUS,Away,Upto 2014
Wasim Akram,PAK,Pace,1999-11-18,Hobart,Australia,1999,2,119,228,2,1,857,1577,19,738,1349,17,45.10526315789474,>30,AUS,Away,Upto 2014
Wasim Akram,PAK,Pace,1999-11-26,W.A.C.A,Australia,1999,1,55,102,1,1,717,1143,27,662,1041,26,26.555555555555557,<=30,AUS,Away,Upto 2014
Wasim Akram,PAK,Pace,2000-02-26,Rawalpindi,Pakistan,2000,1,8,13,0,1,697,1541,24,689,1528,24,29.041666666666668,<=30,PAK,Home,Upto 2014
Wasim Akram,PAK,Pace,2000-05-05,Georgetown,West Indies,2000,1,46,120,1,1,344,903,13,298,783,12,26.46153846153846,<=30,WI,Away,Upto 2014
Wasim Akram,PAK,Pace,2000-05-18,Bridgetown,West Indies,2000,2,108,240,3,1,788,1618,23,680,1378,20,34.26086956521739,>30,WI,Away,Upto 2014
Wasim Akram,PAK,Pace,2000-05-25,St John's,West Indies,2000,2,110,338,11,1,652,1622,32,542,1284,21,20.375,<=30,WI,Away,Upto 2014
Wasim Akram,PAK,Pace,2000-06-14,Colombo (SSC),Sri Lanka,2000,2,100,213,6,1,461,1090,17,361,877,11,27.11764705882353,<=30,SL,Away,Upto 2014
Wasim Akram,PAK,Pace,2000-06-21,Galle,Sri Lanka,2000,2,93,210,3,1,578,1128,20,485,918,17,28.9,<=30,SL,Away,Upto 2014
Wasim Akram,PAK,Pace,2000-06-28,Kandy,Sri Lanka,2000,1,41,150,0,1,200,466,2,159,316,2,100.0,>30,SL,Away,Upto 2014
Wasim Akram,PAK,Pace,2000-11-15,Lahore,Pakistan,2000,2,41,168,1,1,230,588,2,189,420,1,115.0,>30,PAK,Home,Upto 2014
Wasim Akram,PAK,Pace,2000-11-29,Faisalabad,Pakistan,2000,2,82,186,1,1,365,711,8,283,525,7,45.625,>30,PAK,Home,Upto 2014
Wasim Akram,PAK,Pace,2001-05-17,Lord's,England,2001,1,99,204,2,1,714,1443,30,615,1239,28,23.8,<=30,ENG,Away,Upto 2014
Wasim Akram,PAK,Pace,2001-05-31,Manchester,England,2001,2,148,318,3,1,1134,1996,31,986,1678,28,36.58064516129032,>30,ENG,Away,Upto 2014
Wasim Akram,PAK,Pace,2001-08-29,Multan,Pakistan,2001,2,49,114,0,1,512,738,9,463,624,9,56.888888888888886,>30,PAK,Home,Upto 2014
Wasim Akram,PAK,Pace,2002-01-09,Dhaka,Bangladesh,2002,1,5,16,0,1,377,686,15,372,670,15,25.133333333333333,<=30,BAN,Away,Upto 2014
Wasim Bari,PAK,Spin,1978-01-18,Karachi,Pakistan,1978,1,2,8,0,1,466,1665,20,464,1657,20,23.3,<=30,PAK,Home,Upto 2014
Wasim Raja,PAK,Spin,1973-02-02,Wellington,New Zealand,1973,1,10,32,0,1,304,776,6,294,744,6,50.666666666666664,>30,NZ,Away,Upto 2014
Wasim Raja,PAK,Spin,1973-02-07,Dunedin,New Zealand,1973,1,8,16,0,1,480,1145,19,472,1129,19,25.263157894736842,<=30,NZ,Away,Upto 2014
Wasim Raja,PAK,Spin,1973-02-16,Auckland,New Zealand,1973,2,41,78,4,1,488,1070,18,447,992,14,27.11111111111111,<=30,NZ,Away,Upto 2014
Wasim Raja,PAK,Spin,1973-03-02,Lahore,Pakistan,1973,2,105,210,1,1,766,1787,23,661,1577,22,33.30434782608695,>30,PAK,Home,Upto 2014
Wasim Raja,PAK,Spin,1974-08-08,Lord's,England,1974,1,8,12,0,1,263,688,20,255,676,20,13.15,<=30,ENG,Away,Upto 2014
Wasim Raja,PAK,Spin,1974-08-22,The Oval,England,1974,1,68,138,1,1,476,1138,12,408,1000,11,39.666666666666664,>30,ENG,Away,Upto 2014
Wasim Raja,PAK,Spin,1975-02-15,Lahore,Pakistan,1975,2,25,64,0,1,210,572,5,185,508,5,42.0,>30,PAK,Home,Upto 2014
Wasim Raja,PAK,Spin,1975-03-01,Karachi,Pakistan,1975,1,22,39,0,1,404,1072,11,382,1033,11,36.72727272727273,>30,PAK,Home,Upto 2014
Wasim Raja,PAK,Spin,1976-10-09,Lahore,Pakistan,1976,1,31,56,0,1,495,1028,17,464,972,17,29.11764705882353,<=30,PAK,Home,Upto 2014
Wasim Raja,PAK,Spin,1977-03-04,Port of Spain,West Indies,1977,2,44,90,1,1,450,1050,10,406,960,9,45.0,>30,WI,Away,Upto 2014
Wasim Raja,PAK,Spin,1977-04-01,Port of Spain,West Indies,1977,2,22,29,3,1,392,967,20,370,938,17,19.6,<=30,WI,Away,Upto 2014
Wasim Raja,PAK,Spin,1977-04-15,Kingston,West Indies,1977,1,65,126,3,1,227,438,8,162,312,5,28.375,<=30,WI,Away,Upto 2014
Wasim Raja,PAK,Spin,1977-12-14,Lahore,Pakistan,1977,1,21,80,0,1,395,1311,10,374,1231,10,39.5,>30,PAK,Home,Upto 2014
Wasim Raja,PAK,Spin,1978-01-02,Hyderabad (Sind),Pakistan,1978,2,16,110,2,1,585,1882,17,569,1772,15,34.411764705882355,>30,PAK,Home,Upto 2014
Wasim Raja,PAK,Spin,1978-01-18,Karachi,Pakistan,1978,1,31,104,1,1,466,1665,20,435,1561,19,23.3,<=30,PAK,Home,Upto 2014
Wasim Raja,PAK,Spin,1978-06-01,Birmingham,England,1978,1,32,60,0,1,153,396,7,121,336,7,21.857142857142858,<=30,ENG,Away,Upto 2014
Wasim Raja,PAK,Spin,1978-06-15,Lord's,England,1978,1,49,72,1,1,186,426,8,137,354,7,23.25,<=30,ENG,Away,Upto 2014
Wasim Raja,PAK,Spin,1979-02-02,Christchurch,New Zealand,1979,2,86,244,6,1,329,962,17,243,718,11,19.352941176470587,<=30,NZ,Away,Upto 2014
Wasim Raja,PAK,Spin,1979-02-16,Napier,New Zealand,1979,1,10,24,0,1,237,587,3,227,563,3,79.0,>30,NZ,Away,Upto 2014
Wasim Raja,PAK,Spin,1979-03-10,Melbourne,Australia,1979,2,34,64,2,1,258,519,6,224,455,4,43.0,>30,AUS,Away,Upto 2014
Wasim Raja,PAK,Spin,1979-11-21,Bengaluru,India,1979,1,30,48,0,1,552,1383,11,522,1335,11,50.18181818181818,>30,IND,Away,Upto 2014
Wasim Raja,PAK,Spin,1979-12-04,Delhi,India,1979,1,2,12,0,1,303,672,3,301,660,3,101.0,>30,IND,Away,Upto 2014
Wasim Raja,PAK,Spin,1979-12-16,Wankhede,India,1979,1,10,6,0,1,435,1053,22,425,1047,22,19.772727272727273,<=30,IND,Away,Upto 2014
Wasim Raja,PAK,Spin,1979-12-25,Kanpur,India,1979,1,25,54,1,1,100,282,2,75,228,1,50.0,>30,IND,Away,Upto 2014
Wasim Raja,PAK,Spin,1980-01-15,Chennai,India,1980,1,19,12,0,1,236,570,6,217,558,6,39.333333333333336,>30,IND,Away,Upto 2014
Wasim Raja,PAK,Spin,1980-01-29,Eden Gardens,India,1980,1,2,6,0,1,248,600,5,246,594,5,49.6,>30,IND,Away,Upto 2014
Wasim Raja,PAK,Spin,1980-02-27,Karachi,Pakistan,1980,2,11,36,0,1,432,1328,28,421,1292,28,15.428571428571429,<=30,PAK,Home,Upto 2014
Wasim Raja,PAK,Spin,1980-03-06,Faisalabad,Pakistan,1980,1,100,180,3,1,592,1272,6,492,1092,3,98.66666666666667,>30,PAK,Home,Upto 2014
Wasim Raja,PAK,Spin,1980-03-18,Lahore,Pakistan,1980,2,87,138,1,1,686,1374,15,599,1236,14,45.733333333333334,>30,PAK,Home,Upto 2014
Wasim Raja,PAK,Spin,1980-11-24,Lahore,Pakistan,1980,1,21,60,1,1,274,622,12,253,562,11,22.833333333333332,<=30,PAK,Home,Upto 2014
Wasim Raja,PAK,Spin,1980-12-08,Faisalabad,Pakistan,1980,1,13,24,0,1,460,1075,25,447,1051,25,18.4,<=30,PAK,Home,Upto 2014
Wasim Raja,PAK,Spin,1980-12-22,Karachi,Pakistan,1980,1,8,6,0,1,122,421,6,114,415,6,20.333333333333332,<=30,PAK,Home,Upto 2014
Wasim Raja,PAK,Spin,1980-12-30,Multan,Pakistan,1980,1,6,12,0,1,206,498,8,200,486,8,25.75,<=30,PAK,Home,Upto 2014
Wasim Raja,PAK,Spin,1981-11-13,W.A.C.A,Australia,1981,2,58,126,2,1,231,461,11,173,335,9,21.0,<=30,AUS,Away,Upto 2014
Wasim Raja,PAK,Spin,1981-11-27,Brisbane,Australia,1981,1,68,102,1,1,312,546,7,244,444,6,44.57142857142857,>30,AUS,Away,Upto 2014
Wasim Raja,PAK,Spin,1981-12-11,Melbourne,Australia,1981,2,107,300,1,1,491,1248,15,384,948,14,32.733333333333334,>30,AUS,Away,Upto 2014
Wasim Raja,PAK,Spin,1982-03-05,Karachi,Pakistan,1982,2,29,48,2,1,669,1411,22,640,1363,20,30.40909090909091,>30,PAK,Home,Upto 2014
Wasim Raja,PAK,Spin,1982-03-14,Faisalabad,Pakistan,1982,1,66,156,1,1,699,1740,27,633,1584,26,25.88888888888889,<=30,PAK,Home,Upto 2014
Wasim Raja,PAK,Spin,1982-03-22,Lahore,Pakistan,1982,2,22,66,0,1,386,750,7,364,684,7,55.142857142857146,>30,PAK,Home,Upto 2014
Wasim Raja,PAK,Spin,1982-07-29,Birmingham,England,1982,1,0,15,1,1,280,691,9,280,676,8,31.11111111111111,>30,ENG,Away,Upto 2014
Wasim Raja,PAK,Spin,1983-01-30,Karachi,Pakistan,1983,2,13,36,0,1,287,546,2,274,510,2,143.5,>30,PAK,Home,Upto 2014
Wasim Raja,PAK,Spin,1983-09-24,Jalandhar,India,1983,1,50,173,4,1,262,937,8,212,764,4,32.75,>30,IND,Away,Upto 2014
Wasim Raja,PAK,Spin,1983-10-05,Nagpur,India,1983,1,46,60,2,1,396,1114,18,350,1054,16,22.0,<=30,IND,Away,Upto 2014
Wasim Raja,PAK,Spin,1983-11-25,Brisbane,Australia,1983,1,11,18,0,1,302,612,4,291,594,4,75.5,>30,AUS,Away,Upto 2014
Wasim Raja,PAK,Spin,1984-03-02,Karachi,Pakistan,1984,2,3,39,2,1,352,1095,26,349,1056,24,13.538461538461538,<=30,PAK,Home,Upto 2014
Wasim Raja,PAK,Spin,1984-03-12,Faisalabad,Pakistan,1984,1,61,156,1,1,537,1272,7,476,1116,6,76.71428571428571,>30,PAK,Home,Upto 2014
Wasim Raja,PAK,Spin,1984-03-19,Lahore,Pakistan,1984,2,64,192,0,1,562,1203,13,498,1011,13,43.23076923076923,>30,PAK,Home,Upto 2014
Wasim Raja,PAK,Spin,1984-10-17,Lahore,Pakistan,1984,2,56,137,2,1,362,1073,9,306,936,7,40.22222222222222,>30,PAK,Home,Upto 2014
Wasim Raja,PAK,Spin,1984-12-10,Karachi,Pakistan,1984,1,97,198,1,1,562,1340,12,465,1142,11,46.833333333333336,>30,PAK,Home,Upto 2014
Wasim Raja,PAK,Spin,1985-01-18,Wellington,New Zealand,1985,1,10,12,0,1,422,1002,10,412,990,10,42.2,>30,NZ,Away,Upto 2014
Wasim Raja,PAK,Spin,1985-01-25,Auckland,New Zealand,1985,1,3,6,0,1,99,212,2,96,206,2,49.5,>30,NZ,Away,Upto 2014
Wazir Mohammad,PAK,Spin,1955-01-29,Lahore,Pakistan,1955,1,5,12,0,1,591,2024,18,586,2012,18,32.833333333333336,>30,PAK,Home,Upto 2014
Wazir Mohammad,PAK,Spin,1958-01-17,Bridgetown,West Indies,1958,1,2,6,0,1,679,1898,11,677,1892,11,61.72727272727273,>30,WI,Away,Upto 2014
Wazir Mohammad,PAK,Spin,1958-03-13,Georgetown,West Indies,1958,1,8,6,0,1,1032,2327,20,1024,2321,20,51.6,>30,WI,Away,Upto 2014
XC Balaskas,SA,Spin,1930-12-24,Johannesburg,South Africa,1930,1,7,12,0,1,386,746,13,379,734,13,29.692307692307693,<=30,SA,Home,Upto 2014
XC Balaskas,SA,Spin,1931-01-01,Cape Town,South Africa,1931,2,104,150,2,1,731,1678,19,627,1528,17,38.473684210526315,>30,SA,Home,Upto 2014
XC Balaskas,SA,Spin,1932-02-27,Christchurch,New Zealand,1932,1,15,24,0,1,356,669,15,341,645,15,23.733333333333334,<=30,NZ,Away,Upto 2014
XC Balaskas,SA,Spin,1932-03-04,Wellington,New Zealand,1932,1,14,42,2,1,627,1075,19,613,1033,17,33.0,>30,NZ,Away,Upto 2014
XC Balaskas,SA,Spin,1935-06-29,Lord's,England,1935,2,103,354,9,1,484,1320,22,381,966,13,22.0,<=30,ENG,Away,Upto 2014
XC Balaskas,SA,Spin,1936-01-01,Cape Town,South Africa,1936,1,126,228,4,1,468,1146,24,342,918,20,19.5,<=30,SA,Home,Upto 2014
XC Balaskas,SA,Spin,1936-02-15,Johannesburg,South Africa,1936,1,165,264,4,1,374,819,19,209,555,15,19.68421052631579,<=30,SA,Home,Upto 2014
XC Balaskas,SA,Spin,1936-02-28,Durban,South Africa,1936,1,157,306,1,1,543,1530,23,386,1224,22,23.608695652173914,<=30,SA,Home,Upto 2014
XC Balaskas,SA,Spin,1938-12-31,Cape Town,South Africa,1938,1,115,192,0,1,556,1422,11,441,1230,11,50.54545454545455,>30,SA,Home,Upto 2014
XJ Doherty,AUS,Spin,2010-11-25,Brisbane,Australia,2010,2,148,293,2,1,363,731,5,215,438,3,72.6,>30,AUS,Home,Upto 2014
XJ Doherty,AUS,Spin,2010-12-03,Adelaide,Australia,2010,1,158,162,1,1,391,709,9,233,547,8,43.44444444444444,>30,AUS,Home,Upto 2014
XJ Doherty,AUS,Spin,2013-03-02,Hyderabad,India,2013,1,131,277,3,1,504,1093,21,373,816,18,24.0,<=30,IND,Away,Upto 2014
XJ Doherty,AUS,Spin,2013-03-14,Mohali,India,2013,2,111,186,1,1,752,1501,18,641,1315,17,41.77777777777778,>30,IND,Away,Upto 2014
XM Marshall,WI,Spin,2008-06-12,Bridgetown,West Indies,2008,1,0,12,0,1,440,864,10,440,852,10,44.0,>30,WI,Home,Upto 2014
YBK Jaiswal,IND,Spin,2024-02-23,Ranchi,India,2024,1,6,6,0,1,670,1494,28,664,1488,28,23.928571428571427,<=30,IND,Home,After 1965
Yajurvindra Singh,IND,Pace,1977-01-28,Bengaluru,India,1977,1,2,6,0,1,275,606,12,273,600,12,22.916666666666668,<=30,IND,Home,Upto 2014
Yajurvindra Singh,IND,Pace,1979-08-30,The Oval,England,1979,2,19,60,0,1,700,1610,24,681,1550,24,29.166666666666668,<=30,ENG,Away,Upto 2014
Yajurvindra Singh,IND,Pace,1979-09-11,Chennai,India,1979,1,29,54,0,1,448,938,6,419,884,6,74.66666666666667,>30,IND,Home,Upto 2014
Yamin Ahmadzai,AFG,Pace,2018-06-14,Bengaluru,India,2018,1,51,114,3,1,280,456,13,229,342,10,21.53846153846154,<=30,IND,Away,After 1965
Yamin Ahmadzai,AFG,Pace,2019-03-15,Dehradun,India,2019,2,93,156,6,1,244,549,10,151,393,4,24.4,<=30,IND,Away,After 1965
Yamin Ahmadzai,AFG,Pace,2019-09-05,Chattogram,Bangladesh,2019,2,35,84,1,1,61,108,1,26,24,0,61.0,>30,BAN,Away,After 1965
Yamin Ahmadzai,AFG,Pace,2019-11-27,Lucknow,India,2019,2,32,66,0,1,112,277,5,80,211,5,22.4,<=30,IND,Away,After 1965
Yamin Ahmadzai,AFG,Pace,2021-03-02,Abu Dhabi,UAE,2021,2,53,111,1,1,239,474,18,186,363,17,13.277777777777779,<=30,UAE,Away,After 1965
Yamin Ahmadzai,AFG,Pace,2023-06-14,Mirpur,Bangladesh,2023,2,100,138,2,1,553,731,21,453,593,19,26.333333333333332,<=30,BAN,Away,After 1965
Yamin Ahmadzai,AFG,Pace,2025-01-02,Bulawayo,Zimbabwe,2025,2,86,180,3,1,331,653,15,245,473,12,22.066666666666666,<=30,ZIM,Away,After 1965
Yashpal Sharma,IND,Pace,1982-06-10,Lord's,England,1982,1,1,18,0,1,701,1384,31,700,1366,31,22.612903225806452,<=30,ENG,Away,Upto 2014
Yashpal Sharma,IND,Pace,1983-04-28,St John's,West Indies,1983,1,6,6,1,1,719,1355,18,713,1349,17,39.94444444444444,>30,WI,Away,Upto 2014
Yashpal Sharma,IND,Pace,1983-10-05,Nagpur,India,1983,1,10,6,0,1,439,897,10,429,891,10,43.9,>30,IND,Home,Upto 2014
Yasir Ali,BAN,Spin,2022-12-14,Chattogram,Bangladesh,2022,2,35,42,0,1,800,1534,23,765,1492,23,34.78260869565217,>30,BAN,Home,After 1965
Yasir Ali,PAK,Spin,2003-09-03,Multan,Pakistan,2003,2,55,120,2,1,248,589,11,193,469,9,22.545454545454547,<=30,PAK,Home,Upto 2014
Yasir Arafat,PAK,Pace,2007-12-08,Bengaluru,India,2007,2,210,315,7,1,758,1372,19,548,1057,12,39.89473684210526,>30,IND,Away,Upto 2014
Yasir Arafat,PAK,Pace,2009-02-21,Karachi,Pakistan,2009,2,122,192,1,1,650,1043,7,528,851,6,92.85714285714286,>30,PAK,Home,Upto 2014
Yasir Arafat,PAK,Pace,2009-03-01,Lahore,Pakistan,2009,1,106,120,1,1,395,504,8,289,384,7,49.375,>30,PAK,Home,Upto 2014
Yasir Hameed,PAK,Spin,2004-04-13,Rawalpindi,Pakistan,2004,1,5,6,0,1,324,559,10,319,553,10,32.4,>30,PAK,Home,Upto 2014
Yasir Hameed,PAK,Spin,2007-11-30,Eden Gardens,India,2007,1,24,24,0,1,851,1606,18,827,1582,18,47.27777777777778,>30,IND,Away,Upto 2014
Yasir Hameed,PAK,Spin,2007-12-08,Bengaluru,India,2007,1,43,42,0,1,712,1214,14,669,1172,14,50.857142857142854,>30,IND,Away,Upto 2014
Yasir Hameed,PAK,Spin,2010-08-26,Lord's,England,2010,1,0,6,0,1,226,461,11,226,455,11,20.545454545454547,<=30,ENG,Away,Upto 2014
Yasir Shah,PAK,Spin,2014-10-22,Dubai (DICS),UAE,2014,2,116,249,7,1,843,1550,22,727,1301,15,38.31818181818182,>30,UAE,Away,After 1965
Yasir Shah,PAK,Spin,2014-10-30,Abu Dhabi,UAE,2014,2,91,216,5,1,756,1259,18,665,1043,13,42.0,>30,UAE,Away,After 1965
Yasir Shah,PAK,Spin,2014-11-09,Abu Dhabi,UAE,2014,2,139,210,4,1,765,1282,14,626,1072,10,54.642857142857146,>30,UAE,Away,After 1965
Yasir Shah,PAK,Spin,2014-11-17,Dubai (DICS),UAE,2014,2,171,372,7,1,778,1523,22,607,1151,15,35.36363636363637,>30,UAE,Away,After 1965
Yasir Shah,PAK,Spin,2014-11-26,Sharjah,UAE,2014,1,193,265,4,1,856,1190,21,663,925,17,40.76190476190476,>30,UAE,Away,After 1965
Yasir Shah,PAK,Spin,2015-04-28,Khulna,Bangladesh,2015,2,209,348,3,1,1092,1798,20,883,1450,17,54.6,>30,BAN,Away,After 1965
Yasir Shah,PAK,Spin,2015-05-06,Mirpur,Bangladesh,2015,2,131,219,7,1,692,1014,18,561,795,11,38.44444444444444,>30,BAN,Away,After 1965
Yasir Shah,PAK,Spin,2015-06-17,Galle,Sri Lanka,2015,2,155,364,9,1,617,1159,20,462,795,11,30.85,>30,SL,Away,After 1965
Yasir Shah,PAK,Spin,2015-06-25,Colombo (PSS),Sri Lanka,2015,2,151,312,8,1,521,1055,17,370,743,9,30.647058823529413,>30,SL,Away,After 1965
Yasir Shah,PAK,Spin,2015-07-03,Pallekele,Sri Lanka,2015,2,158,383,7,1,413,744,13,255,361,6,31.76923076923077,>30,SL,Away,After 1965
Yasir Shah,PAK,Spin,2015-10-22,Dubai (DICS),UAE,2015,2,180,423,8,1,700,1353,17,520,930,9,41.1764705882353,>30,UAE,Away,After 1965
Yasir Shah,PAK,Spin,2015-11-01,Sharjah,UAE,2015,2,143,321,7,1,743,1504,24,600,1183,17,30.958333333333332,>30,UAE,Away,After 1965
Yasir Shah,PAK,Spin,2016-07-14,Lord's,England,2016,2,141,360,10,1,236,480,12,95,120,2,19.666666666666668,<=30,ENG,Away,After 1965
Yasir Shah,PAK,Spin,2016-07-22,Manchester,England,2016,2,266,378,1,1,470,620,7,204,242,6,67.14285714285714,>30,ENG,Away,After 1965
Yasir Shah,PAK,Spin,2016-08-03,Birmingham,England,2016,2,236,420,3,1,391,671,5,155,251,2,78.2,>30,ENG,Away,After 1965
Yasir Shah,PAK,Spin,2016-08-11,The Oval,England,2016,2,131,270,5,1,324,517,8,193,247,3,40.5,>30,ENG,Away,After 1965
Yasir Shah,PAK,Spin,2016-10-13,Dubai (DICS),UAE,2016,2,234,504,7,1,657,1312,22,423,808,15,29.863636363636363,<=30,UAE,Away,After 1965
Yasir Shah,PAK,Spin,2016-10-21,Abu Dhabi,UAE,2016,2,210,406,10,1,703,1324,15,493,918,5,46.86666666666667,>30,UAE,Away,After 1965
Yasir Shah,PAK,Spin,2016-10-30,Sharjah,UAE,2016,2,120,246,4,1,457,972,14,337,726,10,32.642857142857146,>30,UAE,Away,After 1965
Yasir Shah,PAK,Spin,2016-11-17,Christchurch,New Zealand,2016,2,61,81,0,1,79,123,1,18,42,1,79.0,>30,NZ,Away,After 1965
Yasir Shah,PAK,Spin,2016-12-15,Brisbane,Australia,2016,2,174,319,3,1,384,649,5,210,330,2,76.8,>30,AUS,Away,After 1965
Yasir Shah,PAK,Spin,2016-12-26,Melbourne,Australia,2016,1,207,246,3,1,417,534,7,210,288,4,59.57142857142857,>30,AUS,Away,After 1965
Yasir Shah,PAK,Spin,2017-01-03,Sydney,Australia,2017,2,291,324,2,1,736,1038,13,445,714,11,56.61538461538461,>30,AUS,Away,After 1965
Yasir Shah,PAK,Spin,2017-04-21,Kingston,West Indies,2017,2,154,274,8,1,338,583,11,184,309,3,30.727272727272727,>30,WI,Away,After 1965
Yasir Shah,PAK,Spin,2017-04-30,Bridgetown,West Indies,2017,2,177,394,9,1,516,1000,13,339,606,4,39.69230769230769,>30,WI,Away,After 1965
Yasir Shah,PAK,Spin,2017-05-10,Roseau,West Indies,2017,2,218,462,8,1,500,993,18,282,531,10,27.77777777777778,<=30,WI,Away,After 1965
Yasir Shah,PAK,Spin,2017-09-28,Abu Dhabi,UAE,2017,2,171,504,8,1,623,1568,26,452,1064,18,23.96153846153846,<=30,UAE,Away,After 1965
Yasir Shah,PAK,Spin,2017-10-06,Dubai (DICS),UAE,2017,2,231,407,8,1,608,1153,24,377,746,16,25.333333333333332,<=30,UAE,Away,After 1965
Yasir Shah,PAK,Spin,2018-10-07,Dubai (DICS),UAE,2018,2,194,431,4,1,793,1735,21,599,1304,17,37.76190476190476,>30,UAE,Away,After 1965
Yasir Shah,PAK,Spin,2018-10-16,Abu Dhabi,UAE,2018,2,104,244,4,1,566,1108,20,462,864,16,28.3,<=30,UAE,Away,After 1965
Yasir Shah,PAK,Spin,2018-11-16,Abu Dhabi,UAE,2018,2,164,321,8,1,468,1015,21,304,694,13,22.285714285714285,<=30,UAE,Away,After 1965
Yasir Shah,PAK,Spin,2018-11-24,Dubai (DICS),UAE,2018,2,184,344,14,1,473,968,16,289,624,2,29.5625,<=30,UAE,Away,After 1965
Yasir Shah,PAK,Spin,2018-12-03,Abu Dhabi,UAE,2018,2,204,480,7,1,612,1532,24,408,1052,17,25.5,<=30,UAE,Away,After 1965
Yasir Shah,PAK,Spin,2018-12-26,Centurion,South Africa,2018,2,44,70,1,1,88,154,1,44,84,0,88.0,>30,SA,Away,After 1965
Yasir Shah,PAK,Spin,2019-01-03,Cape Town,South Africa,2019,1,79,126,0,1,103,155,0,24,29,0,inf,>30,SA,Away,After 1965
Yasir Shah,PAK,Spin,2019-11-21,Brisbane,Australia,2019,1,205,292,4,1,515,790,8,310,498,4,64.375,>30,AUS,Away,After 1965
Yasir Shah,PAK,Spin,2019-11-29,Adelaide,Australia,2019,1,197,192,0,1,462,654,5,265,462,5,92.4,>30,AUS,Away,After 1965
Yasir Shah,PAK,Spin,2019-12-19,Karachi,Pakistan,2019,2,127,198,2,1,548,873,9,421,675,7,60.888888888888886,>30,PAK,Home,After 1965
Yasir Shah,PAK,Spin,2020-02-07,Rawalpindi,Pakistan,2020,2,141,236,4,1,309,548,8,168,312,4,38.625,>30,PAK,Home,After 1965
Yasir Shah,PAK,Spin,2020-08-05,Manchester,England,2020,2,165,288,8,1,351,585,12,186,297,4,29.25,<=30,ENG,Away,After 1965
Yasir Shah,PAK,Spin,2020-08-13,Southampton,England,2020,1,30,66,1,1,30,67,1,0,1,0,30.0,<=30,ENG,Away,After 1965
Yasir Shah,PAK,Spin,2020-08-21,Southampton,England,2020,1,173,234,2,1,389,624,7,216,390,5,55.57142857142857,>30,ENG,Away,After 1965
Yasir Shah,PAK,Spin,2020-12-26,Mount Maunganui,New Zealand,2020,2,134,258,3,1,211,453,5,77,195,2,42.2,>30,NZ,Away,After 1965
Yasir Shah,PAK,Spin,2021-01-26,Karachi,Pakistan,2021,2,133,330,7,1,369,904,18,236,574,11,20.5,<=30,PAK,Home,After 1965
Yasir Shah,PAK,Spin,2021-02-04,Rawalpindi,Pakistan,2021,2,110,214,1,1,496,1138,13,386,924,12,38.15384615384615,>30,PAK,Home,After 1965
Yasir Shah,PAK,Spin,2021-08-12,Kingston,West Indies,2021,2,59,96,0,1,139,246,0,80,150,0,inf,>30,WI,Away,After 1965
Yasir Shah,PAK,Spin,2022-07-16,Galle,Sri Lanka,2022,2,188,300,5,1,840,1795,26,652,1495,21,32.30769230769231,>30,SL,Away,After 1965
Yasir Shah,PAK,Spin,2022-07-24,Galle,Sri Lanka,2022,2,163,258,4,1,907,1657,29,744,1399,25,31.275862068965516,>30,SL,Away,After 1965
Younis Ahmed,PAK,Spin,1987-02-21,Jaipur,India,1987,1,6,6,0,1,591,1283,13,585,1277,13,45.46153846153846,>30,IND,Away,Upto 2014
Younis Khan,PAK,Spin,2001-03-15,Christchurch,New Zealand,2001,2,62,162,1,1,390,912,6,328,750,5,65.0,>30,NZ,Away,Upto 2014
Younis Khan,PAK,Spin,2001-03-27,Hamilton,New Zealand,2001,1,26,6,0,1,108,192,0,82,186,0,inf,>30,NZ,Away,Upto 2014
Younis Khan,PAK,Spin,2001-05-17,Lord's,England,2001,1,27,30,0,1,39,36,0,12,6,0,inf,>30,ENG,Away,Upto 2014
Younis Khan,PAK,Spin,2003-01-02,Cape Town,South Africa,2003,1,24,24,0,1,396,516,5,372,492,5,79.2,>30,SA,Away,Upto 2014
Younis Khan,PAK,Spin,2005-03-08,Mohali,India,2005,1,24,12,1,1,471,904,13,447,892,12,36.23076923076923,>30,IND,Away,Upto 2014
Younis Khan,PAK,Spin,2005-03-16,Eden Gardens,India,2005,1,1,6,0,1,693,1450,23,692,1444,23,30.130434782608695,>30,IND,Away,Upto 2014
Younis Khan,PAK,Spin,2006-01-21,Faisalabad,Pakistan,2006,1,5,24,0,1,770,1194,9,765,1170,9,85.55555555555556,>30,PAK,Home,Upto 2014
Younis Khan,PAK,Spin,2007-10-08,Lahore,Pakistan,2007,1,20,24,0,1,512,1276,13,492,1252,13,39.38461538461539,>30,PAK,Home,Upto 2014
Younis Khan,PAK,Spin,2007-12-08,Bengaluru,India,2007,1,14,12,0,1,712,1214,14,698,1202,14,50.857142857142854,>30,IND,Away,Upto 2014
Younis Khan,PAK,Spin,2009-02-21,Karachi,Pakistan,2009,1,6,6,0,1,883,1568,9,877,1562,9,98.11111111111111,>30,PAK,Home,Upto 2014
Younis Khan,PAK,Spin,2009-03-01,Lahore,Pakistan,2009,1,9,12,0,1,316,544,0,307,532,0,inf,>30,PAK,Home,Upto 2014
Younis Khan,PAK,Spin,2009-07-04,Galle,Sri Lanka,2009,2,50,102,4,1,354,709,16,304,607,12,22.125,<=30,SL,Away,Upto 2014
Younis Khan,PAK,Spin,2009-07-12,Colombo (PSS),Sri Lanka,2009,2,38,54,0,1,425,767,15,387,713,15,28.333333333333332,<=30,SL,Away,Upto 2014
Younis Khan,PAK,Spin,2009-07-20,Colombo (SSC),Sri Lanka,2009,2,35,66,1,1,647,1311,18,612,1245,17,35.94444444444444,>30,SL,Away,Upto 2014
Younis Khan,PAK,Spin,2010-11-12,Dubai (DICS),UAE,2010,2,26,60,0,1,753,1614,13,727,1554,13,57.92307692307692,>30,UAE,Away,Upto 2014
Younis Khan,PAK,Spin,2010-11-20,Abu Dhabi,UAE,2010,1,11,18,0,1,553,1225,14,542,1207,14,39.5,>30,UAE,Away,Upto 2014
Younis Khan,PAK,Spin,2011-01-07,Hamilton,New Zealand,2011,1,20,36,0,1,193,540,7,173,504,7,27.571428571428573,<=30,NZ,Away,Upto 2014
Younis Khan,PAK,Spin,2011-01-15,Wellington,New Zealand,2011,1,9,6,0,1,445,1147,12,436,1141,12,37.083333333333336,>30,NZ,Away,Upto 2014
Younis Khan,PAK,Spin,2011-12-17,Mirpur,Bangladesh,2011,1,3,6,0,1,690,1381,17,687,1375,17,40.588235294117645,>30,BAN,Away,Upto 2014
Younis Khan,PAK,Spin,2012-06-22,Galle,Sri Lanka,2012,1,2,12,0,1,621,1409,23,619,1397,23,27.0,<=30,SL,Away,Upto 2014
Younis Khan,PAK,Spin,2012-07-08,Pallekele,Sri Lanka,2012,1,9,18,0,1,298,765,13,289,747,13,22.923076923076923,<=30,SL,Away,Upto 2014
Younis Khan,PAK,Spin,2013-02-01,Johannesburg,South Africa,2013,2,16,30,1,1,230,410,6,214,380,5,38.333333333333336,>30,SA,Away,Upto 2014
Younis Khan,PAK,Spin,2013-02-22,Centurion,South Africa,2013,1,28,36,1,1,179,318,2,151,282,1,89.5,>30,SA,Away,Upto 2014
Younis Khan,PAK,Spin,2013-09-03,Harare,Zimbabwe,2013,1,19,24,0,1,421,874,20,402,850,20,21.05,<=30,ZIM,Away,Upto 2014
Younis Khan,PAK,Spin,2013-09-10,Harare,Zimbabwe,2013,1,7,18,0,1,357,809,10,350,791,10,35.7,>30,ZIM,Away,Upto 2014
Yuvraj Singh,IND,Spin,2003-10-16,Mohali,India,2003,1,1,6,0,1,664,1623,9,663,1617,9,73.77777777777777,>30,IND,Home,Upto 2014
Yuvraj Singh,IND,Spin,2004-03-28,Multan,Pakistan,2004,1,25,36,1,1,510,902,13,485,866,12,39.23076923076923,>30,PAK,Away,Upto 2014
Yuvraj Singh,IND,Spin,2004-04-05,Lahore,Pakistan,2004,1,7,18,0,1,269,480,8,262,462,8,33.625,>30,PAK,Away,Upto 2014
Yuvraj Singh,IND,Spin,2004-10-06,Bengaluru,India,2004,1,3,12,0,1,685,1243,20,682,1231,20,34.25,>30,IND,Home,Upto 2014
Yuvraj Singh,IND,Spin,2004-10-14,Chennai,India,2004,1,7,12,0,1,557,1169,24,550,1157,24,23.208333333333332,<=30,IND,Home,Upto 2014
Yuvraj Singh,IND,Spin,2006-01-21,Faisalabad,Pakistan,2006,1,46,54,0,1,770,1194,9,724,1140,9,85.55555555555556,>30,PAK,Away,Upto 2014
Yuvraj Singh,IND,Spin,2006-06-10,Gros Islet,West Indies,2006,1,1,6,0,1,473,1177,17,472,1171,17,27.823529411764707,<=30,WI,Away,Upto 2014
Yuvraj Singh,IND,Spin,2007-12-08,Bengaluru,India,2007,2,20,54,2,1,712,1214,14,692,1160,12,50.857142857142854,>30,IND,Home,Upto 2014
Yuvraj Singh,IND,Spin,2008-01-02,Sydney,Australia,2008,1,11,12,0,1,764,1280,20,753,1268,20,38.2,>30,AUS,Away,Upto 2014
Yuvraj Singh,IND,Spin,2008-04-11,Kanpur,India,2008,2,46,72,1,1,399,844,18,353,772,17,22.166666666666668,<=30,IND,Home,Upto 2014
Yuvraj Singh,IND,Spin,2008-12-11,Chennai,India,2008,2,45,108,2,1,742,1371,17,697,1263,15,43.64705882352941,>30,IND,Home,Upto 2014
Yuvraj Singh,IND,Spin,2008-12-19,Mohali,India,2008,1,20,36,0,1,508,989,13,488,953,13,39.07692307692308,>30,IND,Home,Upto 2014
Yuvraj Singh,IND,Spin,2009-03-18,Hamilton,New Zealand,2009,1,11,45,1,1,359,787,15,348,742,14,23.933333333333334,<=30,NZ,Away,Upto 2014
Yuvraj Singh,IND,Spin,2009-03-26,Napier,New Zealand,2009,1,59,72,0,1,685,1306,9,626,1234,9,76.11111111111111,>30,NZ,Away,Upto 2014
Yuvraj Singh,IND,Spin,2009-04-03,Wellington,New Zealand,2009,2,14,18,0,1,383,840,12,369,822,12,31.916666666666668,>30,NZ,Away,Upto 2014
Yuvraj Singh,IND,Spin,2009-11-16,Ahmedabad,India,2009,1,64,96,0,1,904,1575,9,840,1479,9,100.44444444444444,>30,IND,Home,Upto 2014
Yuvraj Singh,IND,Spin,2009-11-24,Kanpur,India,2009,2,8,18,1,1,718,1197,20,710,1179,19,35.9,>30,IND,Home,Upto 2014
Yuvraj Singh,IND,Spin,2009-12-02,Brabourne,India,2009,1,18,24,0,1,870,1403,18,852,1379,18,48.333333333333336,>30,IND,Home,Upto 2014
Yuvraj Singh,IND,Spin,2010-01-17,Chattogram,Bangladesh,2010,2,19,40,0,1,565,949,23,546,909,23,24.565217391304348,<=30,BAN,Away,Upto 2014
Yuvraj Singh,IND,Spin,2010-01-24,Mirpur,Bangladesh,2010,1,6,12,0,1,600,1045,11,594,1033,11,54.54545454545455,>30,BAN,Away,Upto 2014
Yuvraj Singh,IND,Spin,2011-07-29,Nottingham,England,2011,2,52,72,1,1,280,322,2,228,250,1,140.0,>30,ENG,Away,Upto 2014
Yuvraj Singh,IND,Spin,2011-11-06,Delhi,India,2011,2,4,12,0,1,434,957,21,430,945,21,20.666666666666668,<=30,IND,Home,Upto 2014
Yuvraj Singh,IND,Spin,2011-11-14,Eden Gardens,India,2011,1,14,18,0,1,689,1188,12,675,1170,12,57.416666666666664,>30,IND,Home,Upto 2014
Yuvraj Singh,IND,Spin,2012-11-15,Ahmedabad,India,2012,2,29,42,0,1,729,1559,21,700,1517,21,34.714285714285715,>30,IND,Home,Upto 2014
Yuvraj Singh,IND,Spin,2012-11-23,Wankhede,India,2012,1,8,18,0,1,747,1449,28,739,1431,28,26.678571428571427,<=30,IND,Home,Upto 2014
Yuvraj Singh,IND,Spin,2012-12-05,Eden Gardens,India,2012,1,9,18,0,1,665,1360,18,656,1342,18,36.94444444444444,>30,IND,Home,Upto 2014
Z Khan,IND,Pace,2000-11-10,Dhaka,Bangladesh,2000,2,69,156,3,1,382,888,12,313,732,9,31.833333333333332,>30,BAN,Away,Upto 2014
Z Khan,IND,Pace,2000-11-25,Nagpur,India,2000,2,126,228,2,1,629,1195,8,503,967,6,78.625,>30,IND,Home,Upto 2014
Z Khan,IND,Pace,2001-03-11,Eden Gardens,India,2001,2,119,220,2,1,800,1488,16,681,1268,14,50.0,>30,IND,Home,Upto 2014
Z Khan,IND,Pace,2001-03-18,Chennai,India,2001,2,70,114,1,1,331,733,10,261,619,9,33.1,>30,IND,Home,Upto 2014
Z Khan,IND,Pace,2001-06-07,Bulawayo,Zimbabwe,2001,2,98,198,4,1,658,1325,23,560,1127,19,28.608695652173914,<=30,ZIM,Away,Upto 2014
Z Khan,IND,Pace,2001-08-14,Galle,Sri Lanka,2001,2,95,161,3,1,532,1132,18,437,971,15,29.555555555555557,<=30,SL,Away,Upto 2014
Z Khan,IND,Pace,2001-08-22,Kandy,Sri Lanka,2001,2,138,270,7,1,745,1357,27,607,1087,20,27.59259259259259,<=30,SL,Away,Upto 2014
Z Khan,IND,Pace,2001-08-29,Colombo (SSC),Sri Lanka,2001,1,134,162,0,1,542,1005,7,408,843,7,77.42857142857143,>30,SL,Away,Upto 2014
Z Khan,IND,Pace,2001-11-03,Bloemfontein,South Africa,2001,2,107,172,0,1,966,1509,27,859,1337,27,35.77777777777778,>30,SA,Away,Upto 2014
Z Khan,IND,Pace,2002-02-21,Nagpur,India,2002,2,78,132,4,1,439,839,7,361,707,3,62.714285714285715,>30,IND,Home,Upto 2014
Z Khan,IND,Pace,2002-02-28,Delhi,India,2002,2,88,150,2,1,446,889,10,358,739,8,44.6,>30,IND,Home,Upto 2014
Z Khan,IND,Pace,2002-04-11,Georgetown,West Indies,2002,1,97,192,2,1,506,1071,12,409,879,10,42.166666666666664,>30,WI,Away,Upto 2014
Z Khan,IND,Pace,2002-04-19,Port of Spain,West Indies,2002,2,102,211,4,1,849,1915,33,747,1704,29,25.727272727272727,<=30,WI,Away,Upto 2014
Z Khan,IND,Pace,2002-05-02,Bridgetown,West Indies,2002,1,83,174,2,1,655,1356,22,572,1182,20,29.772727272727273,<=30,WI,Away,Upto 2014
Z Khan,IND,Pace,2002-05-10,St John's,West Indies,2002,1,129,288,2,1,856,1992,11,727,1704,9,77.81818181818181,>30,WI,Away,Upto 2014
Z Khan,IND,Pace,2002-05-18,Kingston,West Indies,2002,2,157,264,5,1,844,1737,30,687,1473,25,28.133333333333333,<=30,WI,Away,Upto 2014
Z Khan,IND,Pace,2002-07-25,Lord's,England,2002,2,131,282,3,1,837,1449,22,706,1167,19,38.04545454545455,>30,ENG,Away,Upto 2014
Z Khan,IND,Pace,2002-08-08,Nottingham,England,2002,1,110,156,3,1,996,1602,22,886,1446,19,45.27272727272727,>30,ENG,Away,Upto 2014
Z Khan,IND,Pace,2002-08-22,Leeds,England,2002,2,122,246,3,1,769,1387,15,647,1141,12,51.266666666666666,>30,ENG,Away,Upto 2014
Z Khan,IND,Pace,2002-09-05,The Oval,England,2002,2,120,198,2,1,664,1200,10,544,1002,8,66.4,>30,ENG,Away,Upto 2014
Z Khan,IND,Pace,2002-10-09,Wankhede,India,2002,2,67,120,4,1,351,798,10,284,678,6,35.1,>30,IND,Home,Upto 2014
Z Khan,IND,Pace,2002-10-17,Chennai,India,2002,2,44,136,4,1,288,754,13,244,618,9,22.153846153846153,<=30,IND,Home,Upto 2014
Z Khan,IND,Pace,2002-12-12,Wellington,New Zealand,2002,2,66,168,5,1,505,1071,28,439,903,23,18.035714285714285,<=30,NZ,Away,Upto 2014
Z Khan,IND,Pace,2002-12-19,Hamilton,New Zealand,2002,2,85,158,6,1,426,959,32,341,801,26,13.3125,<=30,NZ,Away,Upto 2014
Z Khan,IND,Pace,2003-10-08,Ahmedabad,India,2003,2,104,198,4,1,553,1086,9,449,888,5,61.44444444444444,>30,IND,Home,Upto 2014
Z Khan,IND,Pace,2003-10-16,Mohali,India,2003,1,95,156,0,1,470,1014,9,375,858,9,52.22222222222222,>30,IND,Home,Upto 2014
Z Khan,IND,Pace,2003-12-04,Brisbane,Australia,2003,2,110,156,5,1,735,1213,18,625,1057,13,40.833333333333336,>30,AUS,Away,Upto 2014
Z Khan,IND,Pace,2003-12-26,Melbourne,Australia,2003,1,103,150,0,1,819,1520,17,716,1370,17,48.1764705882353,>30,AUS,Away,Upto 2014
Z Khan,IND,Pace,2004-03-28,Multan,Pakistan,2004,1,76,138,1,1,716,1290,10,640,1152,9,71.6,>30,PAK,Away,Upto 2014
Z Khan,IND,Pace,2004-10-06,Bengaluru,India,2004,2,105,210,1,1,461,1068,18,356,858,17,25.61111111111111,<=30,IND,Home,Upto 2014
Z Khan,IND,Pace,2004-10-14,Chennai,India,2004,2,80,198,1,1,378,888,4,298,690,3,94.5,>30,IND,Home,Upto 2014
Z Khan,IND,Pace,2004-10-26,Nagpur,India,2004,2,159,285,6,1,596,1196,23,437,911,17,25.91304347826087,<=30,IND,Home,Upto 2014
Z Khan,IND,Pace,2004-11-03,Wankhede,India,2004,2,24,48,2,1,204,507,11,180,459,9,18.545454545454547,<=30,IND,Home,Upto 2014
Z Khan,IND,Pace,2004-11-20,Kanpur,India,2004,2,85,222,0,1,487,976,10,402,754,10,48.7,>30,IND,Home,Upto 2014
Z Khan,IND,Pace,2004-11-28,Eden Gardens,India,2004,2,86,192,3,1,537,1338,17,451,1146,14,31.58823529411765,>30,IND,Home,Upto 2014
Z Khan,IND,Pace,2004-12-10,Dhaka,Bangladesh,2004,2,111,170,3,1,566,884,20,455,714,17,28.3,<=30,BAN,Away,Upto 2014
Z Khan,IND,Pace,2004-12-17,Chattogram,Bangladesh,2004,2,104,144,2,1,505,785,14,401,641,12,36.07142857142857,>30,BAN,Away,Upto 2014
Z Khan,IND,Pace,2005-03-08,Mohali,India,2005,2,163,234,1,1,866,1468,17,703,1234,16,50.94117647058823,>30,IND,Home,Upto 2014
Z Khan,IND,Pace,2005-09-13,Bulawayo,Zimbabwe,2005,2,102,180,4,1,492,794,18,390,614,14,27.333333333333332,<=30,ZIM,Away,Upto 2014
Z Khan,IND,Pace,2005-09-20,Harare,Zimbabwe,2005,2,82,156,5,1,559,997,27,477,841,22,20.703703703703702,<=30,ZIM,Away,Upto 2014
Z Khan,IND,Pace,2006-01-21,Faisalabad,Pakistan,2006,2,196,310,7,1,888,1366,17,692,1056,10,52.23529411764706,>30,PAK,Away,Upto 2014
Z Khan,IND,Pace,2006-01-29,Karachi,Pakistan,2006,2,178,258,3,1,991,1398,31,813,1140,28,31.967741935483872,>30,PAK,Away,Upto 2014
Z Khan,IND,Pace,2006-12-15,Johannesburg,South Africa,2006,2,111,197,5,1,728,1389,33,617,1192,28,22.060606060606062,<=30,SA,Away,Upto 2014
Z Khan,IND,Pace,2006-12-26,Durban,South Africa,2006,2,148,258,3,1,879,1470,33,731,1212,30,26.636363636363637,<=30,SA,Away,Upto 2014
Z Khan,IND,Pace,2007-01-02,Cape Town,South Africa,2007,2,136,246,5,1,634,1285,20,498,1039,15,31.7,>30,SA,Away,Upto 2014
Z Khan,IND,Pace,2007-05-18,Chattogram,Bangladesh,2007,2,87,132,1,1,364,589,13,277,457,12,28.0,<=30,BAN,Away,Upto 2014
Z Khan,IND,Pace,2007-05-25,Mirpur,Bangladesh,2007,2,88,108,7,1,511,762,11,423,654,4,46.45454545454545,>30,BAN,Away,Upto 2014
Z Khan,IND,Pace,2007-07-19,Lord's,England,2007,2,141,278,6,1,762,1573,34,621,1295,28,22.41176470588235,<=30,ENG,Away,Upto 2014
Z Khan,IND,Pace,2007-07-27,Nottingham,England,2007,2,134,288,9,1,762,1633,23,628,1345,14,33.130434782608695,>30,ENG,Away,Upto 2014
Z Khan,IND,Pace,2007-08-09,The Oval,England,2007,2,91,252,3,1,888,1674,23,797,1422,20,38.608695652173914,>30,ENG,Away,Upto 2014
Z Khan,IND,Pace,2007-11-22,Delhi,India,2007,2,90,228,4,1,485,979,16,395,751,12,30.3125,>30,IND,Home,Upto 2014
Z Khan,IND,Pace,2007-11-30,Eden Gardens,India,2007,2,101,200,1,1,574,936,5,473,736,4,114.8,>30,IND,Home,Upto 2014
Z Khan,IND,Pace,2007-12-26,Melbourne,Australia,2007,2,187,262,5,1,517,1047,21,330,785,16,24.61904761904762,<=30,AUS,Away,Upto 2014
Z Khan,IND,Pace,2008-07-23,Colombo (SSC),Sri Lanka,2008,1,156,222,2,1,421,648,5,265,426,3,84.2,>30,SL,Away,Upto 2014
Z Khan,IND,Pace,2008-07-31,Galle,Sri Lanka,2008,2,69,102,2,1,302,510,9,233,408,7,33.55555555555556,>30,SL,Away,Upto 2014
Z Khan,IND,Pace,2008-08-08,Colombo (PSS),Sri Lanka,2008,2,127,228,4,1,381,610,11,254,382,7,34.63636363636363,>30,SL,Away,Upto 2014
Z Khan,IND,Pace,2008-10-09,Bengaluru,India,2008,2,137,281,6,1,560,1289,24,423,1008,18,23.333333333333332,<=30,IND,Home,Upto 2014
Z Khan,IND,Pace,2008-10-17,Mohali,India,2008,2,127,240,4,1,846,1398,17,719,1158,13,49.76470588235294,>30,IND,Home,Upto 2014
Z Khan,IND,Pace,2008-10-29,Delhi,India,2008,1,86,138,0,1,697,1278,10,611,1140,10,69.7,>30,IND,Home,Upto 2014
Z Khan,IND,Pace,2008-11-06,Nagpur,India,2008,2,125,216,1,1,502,1096,12,377,880,11,41.833333333333336,>30,IND,Home,Upto 2014
Z Khan,IND,Pace,2008-12-11,Chennai,India,2008,2,81,288,5,1,452,1045,16,371,757,11,28.25,<=30,IND,Home,Upto 2014
Z Khan,IND,Pace,2008-12-19,Mohali,India,2008,2,87,144,3,1,522,1070,12,435,926,9,43.5,>30,IND,Home,Upto 2014
Z Khan,IND,Pace,2009-03-18,Hamilton,New Zealand,2009,2,149,264,3,1,743,1246,14,594,982,11,53.07142857142857,>30,NZ,Away,Upto 2014
Z Khan,IND,Pace,2009-03-26,Napier,New Zealand,2009,1,129,204,3,1,682,1265,13,553,1061,10,52.46153846153846,>30,NZ,Away,Upto 2014
Z Khan,IND,Pace,2009-04-03,Wellington,New Zealand,2009,2,122,225,7,1,869,1366,23,747,1141,16,37.78260869565217,>30,NZ,Away,Upto 2014
Z Khan,IND,Pace,2009-11-16,Ahmedabad,India,2009,1,109,216,2,1,648,1044,12,539,828,10,54.0,>30,IND,Home,Upto 2014
Z Khan,IND,Pace,2009-11-24,Kanpur,India,2009,2,114,168,2,1,388,624,8,274,456,6,48.5,>30,IND,Home,Upto 2014
Z Khan,IND,Pace,2009-12-02,Brabourne,India,2009,2,142,240,6,1,532,750,10,390,510,4,53.2,>30,IND,Home,Upto 2014
Z Khan,IND,Pace,2010-01-17,Chattogram,Bangladesh,2010,2,144,240,5,1,609,842,14,465,602,9,43.5,>30,BAN,Away,Upto 2014
Z Khan,IND,Pace,2010-01-24,Mirpur,Bangladesh,2010,2,149,237,10,1,466,741,17,317,504,7,27.41176470588235,<=30,BAN,Away,Upto 2014
Z Khan,IND,Pace,2010-02-06,Nagpur,India,2010,1,96,186,3,1,534,1007,19,438,821,16,28.105263157894736,<=30,IND,Home,Upto 2014
Z Khan,IND,Pace,2010-02-14,Eden Gardens,India,2010,2,122,168,4,1,646,954,10,524,786,6,64.6,>30,IND,Home,Upto 2014
Z Khan,IND,Pace,2010-10-01,Mohali,India,2010,2,137,251,8,1,619,1051,25,482,800,17,24.76,<=30,IND,Home,Upto 2014
Z Khan,IND,Pace,2010-10-09,Bengaluru,India,2010,2,125,206,4,1,635,1166,15,510,960,11,42.333333333333336,>30,IND,Home,Upto 2014
Z Khan,IND,Pace,2010-11-04,Ahmedabad,India,2010,2,77,196,3,1,415,862,12,338,666,9,34.583333333333336,>30,IND,Home,Upto 2014
Z Khan,IND,Pace,2010-11-12,Hyderabad,India,2010,2,90,207,4,1,606,1065,12,516,858,8,50.5,>30,IND,Home,Upto 2014
Z Khan,IND,Pace,2010-12-26,Durban,South Africa,2010,2,93,180,6,1,613,1119,31,520,939,25,19.774193548387096,<=30,SA,Away,Upto 2014
Z Khan,IND,Pace,2011-01-02,Cape Town,South Africa,2011,2,153,299,4,1,846,1680,22,693,1381,18,38.45454545454545,>30,SA,Away,Upto 2014
Z Khan,IND,Pace,2011-07-21,Lord's,England,2011,1,18,81,2,1,813,1712,30,795,1631,28,27.1,<=30,ENG,Away,Upto 2014
Z Khan,IND,Pace,2011-12-26,Melbourne,Australia,2011,2,130,306,7,1,739,1504,35,609,1198,28,21.114285714285714,<=30,AUS,Away,Upto 2014
Z Khan,IND,Pace,2012-01-03,Sydney,Australia,2012,1,122,186,3,1,874,1376,22,752,1190,19,39.72727272727273,>30,AUS,Away,Upto 2014
Z Khan,IND,Pace,2012-01-13,W.A.C.A,Australia,2012,1,91,126,2,1,668,1156,29,577,1030,27,23.03448275862069,<=30,AUS,Away,Upto 2014
Z Khan,IND,Pace,2012-01-24,Adelaide,Australia,2012,2,134,264,3,1,749,1369,20,615,1105,17,37.45,>30,AUS,Away,Upto 2014
Z Khan,IND,Pace,2012-08-23,Hyderabad,India,2012,2,50,144,0,1,403,771,7,353,627,7,57.57142857142857,>30,IND,Home,Upto 2014
Z Khan,IND,Pace,2012-08-31,Bengaluru,India,2012,2,129,218,3,1,733,1159,18,604,941,15,40.72222222222222,>30,IND,Home,Upto 2014
Z Khan,IND,Pace,2012-11-15,Ahmedabad,India,2012,2,82,255,3,1,421,867,8,339,612,5,52.625,>30,IND,Home,Upto 2014
Z Khan,IND,Pace,2012-11-23,Wankhede,India,2012,1,37,90,0,1,167,294,1,130,204,1,167.0,>30,IND,Home,Upto 2014
Z Khan,IND,Pace,2012-12-05,Eden Gardens,India,2012,1,94,186,1,1,417,856,12,323,670,11,34.75,>30,IND,Home,Upto 2014
Z Khan,IND,Pace,2013-12-18,Johannesburg,South Africa,2013,2,223,363,5,1,1012,2037,30,789,1674,25,33.733333333333334,>30,SA,Away,Upto 2014
Z Khan,IND,Pace,2013-12-26,Durban,South Africa,2013,1,97,168,2,1,714,1389,18,617,1221,16,39.666666666666664,>30,SA,Away,Upto 2014
Z Khan,IND,Pace,2014-02-06,Auckland,New Zealand,2014,2,155,234,4,1,873,1527,37,718,1293,33,23.594594594594593,<=30,NZ,Away,After 1965
Z Khan,IND,Pace,2014-02-14,Wellington,New Zealand,2014,2,227,408,5,1,1271,2109,30,1044,1701,25,42.36666666666667,>30,NZ,Away,After 1965
Z de Bruyn,SA,Pace,2004-11-20,Kanpur,India,2004,1,29,66,1,1,487,976,10,458,910,9,48.7,>30,IND,Away,Upto 2014
Z de Bruyn,SA,Pace,2004-11-28,Eden Gardens,India,2004,1,32,96,2,1,537,1338,17,505,1242,15,31.58823529411765,>30,IND,Away,Upto 2014
Z de Bruyn,SA,Pace,2004-12-17,Gqeberha,South Africa,2004,1,31,54,0,1,915,1720,27,884,1666,27,33.888888888888886,>30,SA,Home,Upto 2014
ZS Ansari,ENG,Spin,2016-10-28,Mirpur,Bangladesh,2016,2,112,150,2,1,691,1258,32,579,1108,30,21.59375,<=30,BAN,Away,After 1965
ZS Ansari,ENG,Spin,2016-11-09,Rajkot,India,2016,2,118,186,3,1,954,1677,22,836,1491,19,43.36363636363637,>30,IND,Away,After 1965
ZS Ansari,ENG,Spin,2016-11-17,Visakhapatnam,India,2016,1,45,72,0,1,632,1483,25,587,1411,25,25.28,<=30,IND,Away,After 1965
Zafar Gohar,PAK,Spin,2021-01-03,Christchurch,New Zealand,2021,1,159,192,0,1,177,216,1,18,24,1,177.0,>30,NZ,Away,After 1965
Zaheer Abbas,PAK,Spin,1971-06-17,Lord's,England,1971,1,1,6,0,1,197,492,2,196,486,2,98.5,>30,ENG,Away,Upto 2014
Zaheer Abbas,PAK,Spin,1973-03-16,Hyderabad (Sind),Pakistan,1973,1,1,6,0,1,993,2402,21,992,2396,21,47.285714285714285,>30,PAK,Home,Upto 2014
Zaheer Abbas,PAK,Spin,1975-03-01,Karachi,Pakistan,1975,1,0,8,0,1,404,1072,11,404,1064,11,36.72727272727273,>30,PAK,Home,Upto 2014
Zaheer Abbas,PAK,Spin,1982-09-30,Faisalabad,Pakistan,1982,1,5,18,0,1,662,1534,17,657,1516,17,38.94117647058823,>30,PAK,Home,Upto 2014
Zaheer Abbas,PAK,Spin,1982-10-14,Lahore,Pakistan,1982,2,3,18,0,1,305,636,6,302,618,6,50.833333333333336,>30,PAK,Home,Upto 2014
Zaheer Abbas,PAK,Spin,1983-01-30,Karachi,Pakistan,1983,1,24,48,0,1,287,546,2,263,498,2,143.5,>30,PAK,Home,Upto 2014
Zaheer Abbas,PAK,Spin,1983-09-14,Bengaluru,India,1983,1,3,6,0,1,224,589,2,221,583,2,112.0,>30,IND,Away,Upto 2014
Zaheer Abbas,PAK,Spin,1983-09-24,Jalandhar,India,1983,1,14,36,1,1,262,937,8,248,901,7,32.75,>30,IND,Away,Upto 2014
Zaheer Abbas,PAK,Spin,1983-10-05,Nagpur,India,1983,1,0,6,0,1,396,1114,18,396,1108,18,22.0,<=30,IND,Away,Upto 2014
Zaheer Abbas,PAK,Spin,1983-12-26,Melbourne,Australia,1983,1,42,132,0,1,391,853,9,349,721,9,43.44444444444444,>30,AUS,Away,Upto 2014
Zaheer Abbas,PAK,Spin,1984-11-25,Hyderabad (Sind),Pakistan,1984,2,26,54,2,1,706,1491,27,680,1437,25,26.14814814814815,<=30,PAK,Home,Upto 2014
Zaheer Abbas,PAK,Spin,1984-12-10,Karachi,Pakistan,1984,1,13,32,0,1,562,1340,12,549,1308,12,46.833333333333336,>30,PAK,Home,Upto 2014
Zahid Mahmood,PAK,Spin,2022-12-01,Rawalpindi,Pakistan,2022,2,319,264,6,1,949,1152,16,630,888,10,59.3125,>30,PAK,Home,After 1965
Zahid Mahmood,PAK,Spin,2022-12-09,Multan,Pakistan,2022,2,115,111,6,1,774,1107,26,659,996,20,29.76923076923077,<=30,PAK,Home,After 1965
Zahid Mahmood,PAK,Spin,2024-10-15,Multan,Pakistan,2024,1,27,36,0,1,831,1418,37,804,1382,37,22.45945945945946,<=30,PAK,Home,After 1965
Zahid Mahmood,PAK,Spin,2024-10-24,Rawalpindi,Pakistan,2024,1,44,60,1,1,719,1161,29,675,1101,28,24.79310344827586,<=30,PAK,Home,After 1965
Zahir Khan,AFG,Spin,2019-09-05,Chattogram,Bangladesh,2019,2,105,144,3,1,903,1930,38,798,1786,35,23.763157894736842,<=30,BAN,Away,After 1965
Zahir Khan,AFG,Spin,2019-11-27,Lucknow,India,2019,1,53,78,2,1,473,932,25,420,854,23,18.92,<=30,IND,Away,After 1965
Zahir Khan,AFG,Spin,2021-03-02,Abu Dhabi,UAE,2021,1,81,114,2,1,274,533,12,193,419,10,22.833333333333332,<=30,UAE,Away,After 1965
Zahir Khan,AFG,Spin,2023-06-14,Mirpur,Bangladesh,2023,2,210,234,3,1,497,697,11,287,463,8,45.18181818181818,>30,BAN,Away,After 1965
Zahir Khan,AFG,Spin,2024-02-28,Tolerance Oval,UAE,2024,2,80,102,1,1,298,624,8,218,522,7,37.25,>30,UAE,Away,After 1965
Zahir Khan,AFG,Spin,2024-12-26,Bulawayo,Zimbabwe,2024,2,170,228,4,1,1189,1856,20,1019,1628,16,59.45,>30,ZIM,Away,After 1965
Zakir Khan,PAK,Pace,1986-03-22,Colombo (PSS),Sri Lanka,1986,2,150,270,3,1,728,1538,20,578,1268,17,36.4,>30,SL,Away,Upto 2014
Zakir Khan,PAK,Pace,1989-12-09,Sialkot,Pakistan,1989,2,109,174,2,1,741,1608,26,632,1434,24,28.5,<=30,PAK,Home,Upto 2014
Zia-ur-Rehman,AFG,Spin,2024-02-02,Colombo (SSC),Sri Lanka,2024,2,102,186,0,1,432,854,10,330,668,10,43.2,>30,SL,Away,After 1965
Zia-ur-Rehman,AFG,Spin,2024-02-28,Tolerance Oval,UAE,2024,2,97,246,6,1,298,624,8,201,378,2,37.25,>30,UAE,Away,After 1965
Zia-ur-Rehman,AFG,Spin,2024-12-26,Bulawayo,Zimbabwe,2024,2,129,210,2,1,1189,1856,20,1060,1646,18,59.45,>30,ZIM,Away,After 1965
Zia-ur-Rehman,AFG,Spin,2025-01-02,Bulawayo,Zimbabwe,2025,2,76,150,3,1,588,1149,23,512,999,20,25.565217391304348,<=30,ZIM,Away,After 1965
Ziaur Rahman,BAN,Pace,2013-04-25,Harare,Zimbabwe,2013,2,71,180,4,1,755,1568,25,684,1388,21,30.2,>30,ZIM,Away,Upto 2014
Zulfiqar Ahmed,PAK,Spin,1952-10-23,Lucknow,India,1952,1,17,30,0,1,185,666,5,168,636,5,37.0,>30,IND,Away,Upto 2014
Zulfiqar Ahmed,PAK,Spin,1954-08-12,The Oval,England,1954,2,43,114,1,1,187,540,10,144,426,9,18.7,<=30,ENG,Away,Upto 2014
Zulfiqar Ahmed,PAK,Spin,1955-10-13,Karachi,Pakistan,1955,2,79,503,11,1,294,1463,19,215,960,8,15.473684210526315,<=30,PAK,Home,Upto 2014
Zulfiqar Ahmed,PAK,Spin,1955-10-26,Lahore,Pakistan,1955,2,185,470,6,1,672,1787,23,487,1317,17,29.217391304347824,<=30,PAK,Home,Upto 2014
Zulfiqar Ahmed,PAK,Spin,1955-11-07,Dhaka,Bangladesh,1955,2,24,114,2,1,131,558,6,107,444,4,21.833333333333332,<=30,BAN,Away,Upto 2014
Zulfiqar Ahmed,PAK,Spin,1956-10-11,Karachi,Pakistan,1956,1,18,54,0,1,132,398,5,114,344,5,26.4,<=30,PAK,Home,Upto 2014
Zulfiqar Babar,PAK,Spin,2013-10-14,Abu Dhabi,UAE,2013,2,140,276,5,1,474,946,13,334,670,8,36.46153846153846,>30,UAE,Away,Upto 2014
Zulfiqar Babar,PAK,Spin,2013-10-23,Dubai (DICS),UAE,2013,1,124,218,1,1,497,1052,19,373,834,18,26.157894736842106,<=30,UAE,Away,Upto 2014
Zulfiqar Babar,PAK,Spin,2014-10-22,Dubai (DICS),UAE,2014,2,155,349,7,1,843,1550,22,688,1201,15,38.31818181818182,>30,UAE,Away,After 1965
Zulfiqar Babar,PAK,Spin,2014-10-30,Abu Dhabi,UAE,2014,2,214,345,7,1,756,1259,18,542,914,11,42.0,>30,UAE,Away,After 1965
Zulfiqar Babar,PAK,Spin,2014-11-09,Abu Dhabi,UAE,2014,2,127,309,5,1,765,1282,14,638,973,9,54.642857142857146,>30,UAE,Away,After 1965
Zulfiqar Babar,PAK,Spin,2014-11-17,Dubai (DICS),UAE,2014,2,233,437,8,1,778,1523,22,545,1086,14,35.36363636363637,>30,UAE,Away,After 1965
Zulfiqar Babar,PAK,Spin,2014-11-26,Sharjah,UAE,2014,1,135,138,0,1,856,1190,21,721,1052,21,40.76190476190476,>30,UAE,Away,After 1965
Zulfiqar Babar,PAK,Spin,2015-04-28,Khulna,Bangladesh,2015,2,224,384,3,1,1092,1798,20,868,1414,17,54.6,>30,BAN,Away,After 1965
Zulfiqar Babar,PAK,Spin,2015-06-17,Galle,Sri Lanka,2015,2,95,246,4,1,617,1159,20,522,913,16,30.85,>30,SL,Away,After 1965
Zulfiqar Babar,PAK,Spin,2015-06-25,Colombo (PSS),Sri Lanka,2015,2,124,240,2,1,521,1055,17,397,815,15,30.647058823529413,>30,SL,Away,After 1965
Zulfiqar Babar,PAK,Spin,2015-10-13,Abu Dhabi,UAE,2015,2,210,462,3,1,740,1307,14,530,845,11,52.857142857142854,>30,UAE,Away,After 1965
Zulfiqar Babar,PAK,Spin,2015-10-22,Dubai (DICS),UAE,2015,2,88,342,3,1,700,1353,17,612,1011,14,41.1764705882353,>30,UAE,Away,After 1965
Zulfiqar Babar,PAK,Spin,2015-11-01,Sharjah,UAE,2015,2,111,330,3,1,743,1504,24,632,1174,21,30.958333333333332,>30,UAE,Away,After 1965
Zulfiqar Babar,PAK,Spin,2016-10-21,Abu Dhabi,UAE,2016,2,90,258,2,1,703,1324,15,613,1066,13,46.86666666666667,>30,UAE,Away,After 1965
Zulfiqar Babar,PAK,Spin,2016-10-30,Sharjah,UAE,2016,2,59,144,1,1,457,972,14,398,828,13,32.642857142857146,>30,UAE,Away,After 1965
